index,Account_No,DATE,TRANSACTION_DETAILS,WITHDRAWAL_AMT,DEPOSIT_AMT,BALANCE_AMT,year,month,day,type,AMOUNT,receiver_Account
0,409000611074',2018-01-01,INDO GIBL Indiaforensic STL31121,14000.0,0.0,697823.0,2018,1,1,PAYEMENT,14000.0,M1979787155
1,409000611074',2018-01-01,INDO GIBL Indiaforensic STL30121,54250.0,0.0,643573.0,2018,1,1,DEBIT,54250.0,M2044282225
2,409000611074',2018-01-02,INDO GIBL Indiaforensic STL01011,147500.0,0.0,496073.0,2018,1,2,PAYEMENT,147500.0,C553264065
3,409000611074',2018-01-03,FDRL/INTERNAL FUND TRANSFE,0.0,500000.0,996073.0,2018,1,3,TRANSFER,500000.0,C38997010
4,409000611074',2018-01-03,INDO GIBL Indiaforensic STL02011,323500.0,0.0,672573.0,2018,1,3,PAYEMENT,323500.0,M1230701703
5,409000611074',2018-01-04,INDO GIBL Indiaforensic STL03011,180300.0,0.0,492273.0,2018,1,4,PAYEMENT,180300.0,M573487274
6,409000611074',2018-01-05,FDRL/INTERNAL FUND TRANSFE,0.0,500000.0,992273.0,2018,1,5,TRANSFER,500000.0,M408069119
7,409000611074',2018-01-05,FDRL/INTERNAL FUND TRANSFE,0.0,500000.0,1492273.0,2018,1,5,CHECK_CASHING,500000.0,M633326333
8,409000611074',2018-01-05,INDO GIBL Indiaforensic STL04011,222800.0,0.0,1269473.0,2018,1,5,CASH_OUT,222800.0,M1176932104
9,409000611074',2018-01-06,INDO GIBL Indiaforensic STL05011,145450.0,0.0,1124023.0,2018,1,6,CASH_OUT,145450.0,C195600860
10,409000611074',2018-01-09,INDO GIBL Indiaforensic STL06011,182000.0,0.0,942023.0,2018,1,9,DEBIT,182000.0,C997608398
11,409000611074',2018-01-09,INDO GIBL Indiaforensic STL07011,205075.0,0.0,736948.0,2018,1,9,CASH_OUT,205075.0,M2096539129
12,409000611074',2018-01-09,INDO GIBL Indiaforensic STL08011,170500.0,0.0,566448.0,2018,1,9,DEBIT,170500.0,M972865270
13,409000611074',2018-01-09,FDRL/INTERNAL FUND TRANSFE,0.0,500000.0,1066448.0,2018,1,9,CASH_IN,500000.0,M801569151
14,409000611074',2018-01-10,INDO GIBL Indiaforensic STL09011,495252.0,0.0,571196.0,2018,1,10,CHECK_WITHDRAWAL,495252.0,M1635378213
15,409000611074',2018-01-11,INDO GIBL Indiaforensic STL10011,256600.0,0.0,314596.0,2018,1,11,CASH_OUT,256600.0,C476402209
16,409000611074',2018-01-12,FDRL/INTERNAL FUND TRANSFE,0.0,500000.0,814596.0,2018,1,12,CASH_IN,500000.0,M1731217984
17,409000611074',2018-01-12,FDRL/INTERNAL FUND TRANSFE,0.0,500000.0,1314596.0,2018,1,12,TRANSFER,500000.0,M1877062907
18,409000611074',2018-01-12,FDRL/INTERNAL FUND TRANSFE,0.0,500000.0,1814596.0,2018,1,12,CHECK_CASHING,500000.0,M473053293
19,409000611074',2018-01-12,FDRL/INTERNAL FUND TRANSFE,0.0,500000.0,2314596.0,2018,1,12,CASH_IN,500000.0,C1100439041
20,409000611074',2018-01-15,INDO GIBL Indiaforensic STL14011,5000.0,0.0,2309596.0,2018,1,15,CHECK_WITHDRAWAL,5000.0,M1344519051
21,409000611074',2018-01-15,INDO GIBL Indiaforensic STL11011,348200.0,0.0,1961396.0,2018,1,15,DEBIT,348200.0,C1973538135
22,409000611074',2018-01-15,INDO GIBL Indiaforensic STL13011,112900.0,0.0,1848496.0,2018,1,15,CASH_OUT,112900.0,C515132998
23,409000611074',2018-01-15,INDO GIBL Indiaforensic STL12011,392251.0,0.0,1456245.0,2018,1,15,CASH_OUT,392251.0,M1404932042
24,409000611074',2018-01-16,INDO GIBL Indiaforensic STL15011,412300.0,0.0,1043945.0,2018,1,16,DEBIT,412300.0,C932583850
25,409000611074',2018-01-17,INDO GIBL Indiaforensic STL16011,518375.0,0.0,525570.0,2018,1,17,CHECK_WITHDRAWAL,518375.0,M1558079303
26,409000611074',2018-01-20,INDO GIBL Indiaforensic STL19011,296450.0,0.0,229120.0,2018,1,20,CHECK_WITHDRAWAL,296450.0,M58488213
27,409000611074',2018-01-22,FDRL/INTERNAL FUND TRANSFE,0.0,500000.0,729120.0,2018,1,22,CASH_IN,500000.0,M295304806
28,409000611074',2018-01-22,FDRL/INTERNAL FUND TRANSFE,0.0,500000.0,1229120.0,2018,1,22,CASH_IN,500000.0,M33419717
29,409000611074',2018-01-23,INDO GIBL Indiaforensic STL22011,274600.0,0.0,954520.0,2018,1,23,CHECK_WITHDRAWAL,274600.0,M1940055334
30,409000611074',2018-01-23,INDO GIBL Indiaforensic STL20011,159725.0,0.0,794795.0,2018,1,23,CHECK_WITHDRAWAL,159725.0,M335107734
31,409000611074',2018-01-23,INDO GIBL Indiaforensic STL21011,69000.0,0.0,725795.0,2018,1,23,PAYEMENT,69000.0,M1757317128
32,409000611074',2018-01-23,INDO GIBL Indiaforensic STL18011,244350.0,0.0,481445.0,2018,1,23,PAYEMENT,244350.0,M1804441305
33,409000611074',2018-01-24,INDO GIBL Indiaforensic STL23011,224800.0,0.0,256645.0,2018,1,24,CASH_OUT,224800.0,M1971783162
34,409000611074',2018-01-29,FDRL/INTERNAL FUND TRANSFE,0.0,500000.0,756645.0,2018,1,29,CASH_IN,500000.0,M151442075
35,409000611074',2018-01-29,FDRL/INTERNAL FUND TRANSFE,0.0,500000.0,1256645.0,2018,1,29,CASH_IN,500000.0,M70695990
36,409000611074',2018-01-29,FDRL/INTERNAL FUND TRANSFE,0.0,500000.0,1756645.0,2018,1,29,CASH_IN,500000.0,M1615617512
37,409000611074',2018-01-29,INDO GIBL Indiaforensic STL25011,135050.0,0.0,1621595.0,2018,1,29,CHECK_WITHDRAWAL,135050.0,M107994825
38,409000611074',2018-01-29,INDO GIBL Indiaforensic STL26011,31300.0,0.0,1590295.0,2018,1,29,DEBIT,31300.0,M1426725223
39,409000611074',2018-01-29,INDO GIBL Indiaforensic STL27011,20500.0,0.0,1569795.0,2018,1,29,CHECK_WITHDRAWAL,20500.0,M1384454980
40,409000611074',2018-01-29,INDO GIBL Indiaforensic STL28011,5500.0,0.0,1564295.0,2018,1,29,PAYEMENT,5500.0,M1569435561
41,409000611074',2018-01-29,INDO GIBL Indiaforensic STL24011,204900.0,0.0,1359395.0,2018,1,29,CHECK_WITHDRAWAL,204900.0,C1297685781
42,409000611074',2018-01-29,INDO GIBL Indiaforensic STL17011,563250.0,0.0,796145.0,2018,1,29,DEBIT,563250.0,C1509514333
43,409000611074',2018-01-30,INDO GIBL Indiaforensic STL29011,207100.0,0.0,589045.0,2018,1,30,PAYEMENT,207100.0,M267814113
44,409000611074',2018-01-31,INDO GIBL Indiaforensic STL30011,138250.0,0.0,450795.0,2018,1,31,CHECK_WITHDRAWAL,138250.0,M1593224710
45,409000611074',2018-02-01,INDO GIBL Indiaforensic STL31011,196150.0,0.0,254645.0,2018,2,1,CHECK_WITHDRAWAL,196150.0,M1849015357
46,409000611074',2018-02-02,FDRL/INTERNAL FUND TRANSFE,0.0,500000.0,754645.0,2018,2,2,TRANSFER,500000.0,M2008106788
47,409000611074',2018-02-02,FDRL/INTERNAL FUND TRANSFE,0.0,500000.0,1254645.0,2018,2,2,CASH_IN,500000.0,C824009085
48,409000611074',2018-02-02,FDRL/INTERNAL FUND TRANSFE,0.0,500000.0,1754645.0,2018,2,2,TRANSFER,500000.0,C248609774
49,409000611074',2018-02-03,INDO GIBL Indiaforensic STL02021,119675.0,0.0,1634970.0,2018,2,3,DEBIT,119675.0,M490391704
50,409000611074',2018-02-03,INDO GIBL Indiaforensic STL01021,137775.0,0.0,1497195.0,2018,2,3,DEBIT,137775.0,M1653361344
51,409000611074',2018-02-07,INDO GIBL Indiaforensic STL03021,61500.0,0.0,1435695.0,2018,2,7,PAYEMENT,61500.0,C2001112025
52,409000611074',2018-02-07,INDO GIBL Indiaforensic STL05021,138350.0,0.0,1297345.0,2018,2,7,CHECK_WITHDRAWAL,138350.0,M909132503
53,409000611074',2018-02-07,INDO GIBL Indiaforensic STL06021,239400.0,0.0,1057945.0,2018,2,7,CASH_OUT,239400.0,M1792384402
54,409000611074',2018-02-08,FDRL/INTERNAL FUND TRANSFE,0.0,500000.0,1557945.0,2018,2,8,CHECK_CASHING,500000.0,M1658980982
55,409000611074',2018-02-08,FDRL/INTERNAL FUND TRANSFE,0.0,500000.0,2057945.0,2018,2,8,TRANSFER,500000.0,M1152606315
56,409000611074',2018-02-09,INDO GIBL Indiaforensic STL07021,271124.0,0.0,1786821.0,2018,2,9,CHECK_WITHDRAWAL,271124.0,M1714688478
57,409000611074',2018-02-09,INDO GIBL Indiaforensic STL08021,300799.0,0.0,1486022.0,2018,2,9,PAYEMENT,300799.0,M1506951181
58,409000611074',2018-02-16,INDO GIBL Indiaforensic STL09021,334900.0,0.0,1151122.0,2018,2,16,DEBIT,334900.0,C1937962514
59,409000611074',2018-02-16,INDO GIBL Indiaforensic STL10021,68250.0,0.0,1082872.0,2018,2,16,CHECK_WITHDRAWAL,68250.0,C242131142
60,409000611074',2018-02-16,INDO GIBL Indiaforensic STL13021,307125.0,0.0,775747.0,2018,2,16,PAYEMENT,307125.0,C476800120
61,409000611074',2018-02-16,INDO GIBL Indiaforensic STL14021,475300.0,0.0,300447.0,2018,2,16,PAYEMENT,475300.0,C1254526270
62,409000611074',2018-02-16,FDRL/INTERNAL FUND TRANSFE,0.0,500000.0,800447.0,2018,2,16,TRANSFER,500000.0,C1129670968
63,409000611074',2018-02-16,FDRL/INTERNAL FUND TRANSFE,0.0,500000.0,1300447.0,2018,2,16,CHECK_CASHING,500000.0,M1860591867
64,409000611074',2018-02-16,FDRL/INTERNAL FUND TRANSFE,0.0,500000.0,1800447.0,2018,2,16,TRANSFER,500000.0,C1971489295
65,409000611074',2018-02-17,INDO GIBL Indiaforensic STL12021,594328.0,0.0,1206119.0,2018,2,17,CASH_OUT,594328.0,M516875052
66,409000611074',2018-02-17,INDO GIBL Indiaforensic STL15021,387100.0,0.0,819019.0,2018,2,17,DEBIT,387100.0,M589987187
67,409000611074',2018-02-19,FDRL/INTERNAL FUND TRANSFE,0.0,500000.0,1319019.0,2018,2,19,CASH_IN,500000.0,M587180314
68,409000611074',2018-02-21,INDO GIBL Indiaforensic STL16021,710800.0,0.0,608219.0,2018,2,21,CASH_OUT,710800.0,C1330106945
69,409000611074',2018-02-21,INDO GIBL Indiaforensic STL17021,385400.0,0.0,222819.0,2018,2,21,DEBIT,385400.0,M1082411691
70,409000611074',2018-02-22,FDRL/INTERNAL FUND TRANSFE,0.0,500000.0,722819.0,2018,2,22,CHECK_CASHING,500000.0,C2096057945
71,409000611074',2018-02-22,FDRL/INTERNAL FUND TRANSFE,0.0,500000.0,1222819.0,2018,2,22,TRANSFER,500000.0,C766572210
72,409000611074',2018-02-22,INDO GIBL Indiaforensic STL18021,79350.0,0.0,1143469.0,2018,2,22,CHECK_WITHDRAWAL,79350.0,C977993101
73,409000611074',2018-02-22,INDO GIBL Indiaforensic STL19021,385200.0,0.0,758269.0,2018,2,22,DEBIT,385200.0,M2134271532
74,409000611074',2018-02-22,INDO GIBL Indiaforensic STL20021,299950.0,0.0,458319.0,2018,2,22,CHECK_WITHDRAWAL,299950.0,M1831010686
75,409000611074',2018-02-22,FDRL/INTERNAL FUND TRANSFE,0.0,500000.0,958319.0,2018,2,22,CHECK_CASHING,500000.0,M404222443
76,409000611074',2018-02-23,FDRL/INTERNAL FUND TRANSFE,0.0,500000.0,1458319.0,2018,2,23,CASH_IN,500000.0,M61073295
77,409000611074',2018-02-26,INDO GIBL Indiaforensic STL21021,273500.0,0.0,1184819.0,2018,2,26,CHECK_WITHDRAWAL,273500.0,M396485834
78,409000611074',2018-02-26,INDO GIBL Indiaforensic STL22021,237500.0,0.0,947319.0,2018,2,26,DEBIT,237500.0,C1330106945
79,409000611074',2018-02-26,INDO GIBL Indiaforensic STL23021,277753.0,0.0,669566.0,2018,2,26,CASH_OUT,277753.0,C1761291320
80,409000611074',2018-02-26,INDO GIBL Indiaforensic STL24021,70300.0,0.0,599266.0,2018,2,26,CASH_OUT,70300.0,C783286238
81,409000611074',2018-02-26,INDO GIBL Indiaforensic STL25021,62400.0,0.0,536866.0,2018,2,26,CASH_OUT,62400.0,C1749186397
82,409000611074',2018-02-26,FDRL/INTERNAL FUND TRANSFE,0.0,500000.0,1036866.0,2018,2,26,CASH_IN,500000.0,C766572210
83,409000611074',2018-02-26,FDRL/INTERNAL FUND TRANSFE,0.0,500000.0,1536866.0,2018,2,26,CASH_IN,500000.0,C392292416
84,409000611074',2018-02-27,INDO GIBL Indiaforensic STL26021,103300.0,0.0,1433566.0,2018,2,27,PAYEMENT,103300.0,C1590550415
85,409000611074',2018-02-28,INDO GIBL Indiaforensic STL27021,182450.0,0.0,1251116.0,2018,2,28,DEBIT,182450.0,C665576141
86,409000611074',2018-03-01,FDRL/INTERNAL FUND TRANSFE,0.0,500000.0,1751116.0,2018,3,1,TRANSFER,500000.0,C766572210
87,409000611074',2018-03-01,FDRL/INTERNAL FUND TRANSFE,0.0,500000.0,2251116.0,2018,3,1,CHECK_CASHING,500000.0,C1359044626
88,409000611074',2018-03-05,INDO GIBL Indiaforensic STL03031,155500.0,0.0,2095616.0,2018,3,5,CASH_OUT,155500.0,C1590550415
89,409000611074',2018-03-07,INDO GIBL Indiaforensic STL28021,244350.0,0.0,1851266.0,2018,3,7,CASH_OUT,244350.0,C1590550415
90,409000611074',2018-03-07,INDO GIBL Indiaforensic STL01031,202799.0,0.0,1648467.0,2018,3,7,CASH_OUT,202799.0,C392292416
91,409000611074',2018-03-07,INDO GIBL Indiaforensic STL03031,155500.0,0.0,1492967.0,2018,3,7,CASH_OUT,155500.0,C1359044626
92,409000611074',2018-03-07,INDO GIBL Indiaforensic STL05031,153300.0,0.0,1339667.0,2018,3,7,PAYEMENT,153300.0,C1509514333
93,409000611074',2018-03-07,INDO GIBL Indiaforensic STL06031,350150.0,0.0,989517.0,2018,3,7,PAYEMENT,350150.0,C1286084959
94,409000611074',2018-03-08,INDO GIBL Indiaforensic STL07031,371900.0,0.0,617617.0,2018,3,8,CASH_OUT,371900.0,C1590550415
95,409000611074',2018-03-09,INDO GIBL Indiaforensic STL08031,345930.0,0.0,271687.0,2018,3,9,CHECK_WITHDRAWAL,345930.0,C1359044626
96,409000611074',2018-03-09,FDRL/INTERNAL FUND TRANSFE,0.0,500000.0,771687.0,2018,3,9,CASH_IN,500000.0,C1590550415
97,409000611074',2018-03-09,FDRL/INTERNAL FUND TRANSFE,0.0,500000.0,1271687.0,2018,3,9,CASH_IN,500000.0,C1225616405
98,409000611074',2018-03-12,INDO GIBL Indiaforensic STL09031,390850.0,0.0,880837.0,2018,3,12,DEBIT,390850.0,M1651262695
99,409000611074',2018-03-12,INDO GIBL Indiaforensic STL1003,85800.0,0.0,795037.0,2018,3,12,CASH_OUT,85800.0,M494077446
100,409000611074',2018-03-12,INDO GIBL Indiaforensic STL11031,45000.0,0.0,750037.0,2018,3,12,PAYEMENT,45000.0,M989889899
101,409000611074',2018-03-12,FDRL/INTERNAL FUND TRANSFE,0.0,500000.0,1250037.0,2018,3,12,TRANSFER,500000.0,M902860396
102,409000611074',2018-03-12,FDRL/INTERNAL FUND TRANSFE,0.0,500000.0,1750037.0,2018,3,12,CHECK_CASHING,500000.0,M1816522350
103,409000611074',2018-03-13,INDO GIBL Indiaforensic STL12031,577493.0,0.0,1172544.0,2018,3,13,CASH_OUT,577493.0,M1521238608
104,409000611074',2018-03-14,INDO GIBL Indiaforensic STL13031,556224.0,0.0,616320.0,2018,3,14,CHECK_WITHDRAWAL,556224.0,M1111897955
105,409000611074',2018-03-14,FDRL/INTERNAL FUND TRANSFE,0.0,500000.0,1116320.0,2018,3,14,CASH_IN,500000.0,M1643141512
106,409000611074',2018-03-14,FDRL/INTERNAL FUND TRANSFE,0.0,500000.0,1616320.0,2018,3,14,CASH_IN,500000.0,C1282788025
107,409000611074',2018-03-15,INDO GIBL Indiaforensic STL14031,425700.0,0.0,1190620.0,2018,3,15,DEBIT,425700.0,C1870252780
108,409000611074',2018-03-16,INDO GIBL Indiaforensic STL15031,213463.0,0.0,977157.0,2018,3,16,PAYEMENT,213463.0,C97730845
109,409000611074',2018-03-16,FDRL/INTERNAL FUND TRANSFE,0.0,500000.0,1477157.0,2018,3,16,CHECK_CASHING,500000.0,C100555887
110,409000611074',2018-03-17,INDO GIBL Indiaforensic STL16031,199983.0,0.0,1277174.0,2018,3,17,CHECK_WITHDRAWAL,199983.0,C1983747920
111,409000611074',2018-03-19,INDO GIBL Indiaforensic STL17031,230510.0,0.0,1046664.0,2018,3,19,DEBIT,230510.0,C736709391
112,409000611074',2018-03-19,INDO GIBL Indiaforensic STL18031,10000.0,0.0,1036664.0,2018,3,19,PAYEMENT,10000.0,C401424608
113,409000611074',2018-03-20,INDO GIBL Indiaforensic STL19031,335250.0,0.0,701414.0,2018,3,20,DEBIT,335250.0,C1590550415
114,409000611074',2018-03-20,FDRL/INTERNAL FUND TRANSFE,0.0,500000.0,1201414.0,2018,3,20,TRANSFER,500000.0,C985934102
115,409000611074',2018-03-20,Indfor INCM INDO REVREMI0303,0.0,1320.0,1202734.0,2018,3,20,TRANSFER,1320.0,M25764044
116,409000611074',2018-03-20,INDO GIBLOXGN REVSTL03031,0.0,155500.0,1358234.0,2018,3,20,TRANSFER,155500.0,M1925352804
117,409000611074',2018-03-20,Indfor INCM INDO REVREMI0103,0.0,202799.0,1561033.0,2018,3,20,CHECK_CASHING,202799.0,C33524623
118,409000611074',2018-03-20,INDO GIBL Indiaforensic STL01031,200799.0,0.0,1360234.0,2018,3,20,CASH_OUT,200799.0,C575335780
119,409000611074',2018-03-22,INDO GIBL Indiaforensic STL20031,434450.0,0.0,925784.0,2018,3,22,CHECK_WITHDRAWAL,434450.0,M1600594643
120,409000611074',2018-03-22,INDO GIBL Indiaforensic STL21031,292175.0,0.0,633609.0,2018,3,22,CHECK_WITHDRAWAL,292175.0,M692998280
121,409000611074',2018-03-22,FDRL/INTERNAL FUND TRANSFE,0.0,500000.0,1133609.0,2018,3,22,CHECK_CASHING,500000.0,C20671747
122,409000611074',2018-03-22,FDRL/INTERNAL FUND TRANSFE,0.0,500000.0,1633609.0,2018,3,22,CHECK_CASHING,500000.0,M33563464
123,409000611074',2018-03-23,INDO GIBL Indiaforensic STL22031,301200.0,0.0,1332409.0,2018,3,23,CHECK_WITHDRAWAL,301200.0,C564160838
124,409000611074',2018-03-23,FDRL/INTERNAL FUND TRANSFE,0.0,500000.0,1832409.0,2018,3,23,TRANSFER,500000.0,M30699728
125,409000611074',2018-03-26,INDO GIBL Indiaforensic STL23031,218975.0,0.0,1613434.0,2018,3,26,CASH_OUT,218975.0,M1422273905
126,409000611074',2018-03-26,INDO GIBL Indiaforensic STL24031,44800.0,0.0,1568634.0,2018,3,26,DEBIT,44800.0,C801197928
127,409000611074',2018-03-26,INDO GIBL Indiaforensic STL25031,12000.0,0.0,1556634.0,2018,3,26,CASH_OUT,12000.0,M756936249
128,409000611074',2018-03-27,INDO GIBL Indiaforensic STL26031,259150.0,0.0,1297484.0,2018,3,27,CASH_OUT,259150.0,M264394929
129,409000611074',2018-03-28,INDO GIBL Indiaforensic STL27031,139650.0,0.0,1157834.0,2018,3,28,CASH_OUT,139650.0,M769132147
130,409000611074',2018-03-31,INDO GIBL Indiaforensic STL28031,164600.0,0.0,993234.0,2018,3,31,PAYEMENT,164600.0,M1474957626
131,409000611074',2018-03-31,INDO GIBL Indiaforensic STL29031,81675.0,0.0,911559.0,2018,3,31,PAYEMENT,81675.0,M1733022752
132,409000611074',2018-03-31,INDO GIBL Indiaforensic STL30031,85750.0,0.0,825809.0,2018,3,31,DEBIT,85750.0,C451111351
133,409000611074',2018-03-31,FDRL/INTERNAL FUND TRANSFE,0.0,500000.0,1325809.0,2018,3,31,TRANSFER,500000.0,C716157500
134,409000611074',2018-04-05,FDRL/INTERNAL FUND TRANSFE,0.0,500000.0,1825809.0,2018,4,5,CASH_IN,500000.0,M1914108708
135,409000611074',2018-04-05,FDRL/INTERNAL FUND TRANSFE,0.0,500000.0,2325809.0,2018,4,5,TRANSFER,500000.0,M1357700757
136,409000611074',2018-04-06,INDO GIBL Indiaforensic STL31031,150950.0,0.0,2174859.0,2018,4,6,CASH_OUT,150950.0,M1889757798
137,409000611074',2018-04-06,INDO GIBL Indiaforensic STL01041,20000.0,0.0,2154859.0,2018,4,6,DEBIT,20000.0,M1932470703
138,409000611074',2018-04-06,INDO GIBL Indiaforensic STL02041,26400.0,0.0,2128459.0,2018,4,6,CHECK_WITHDRAWAL,26400.0,M1713568869
139,409000611074',2018-04-06,INDO GIBL Indiaforensic STL03041,109650.0,0.0,2018809.0,2018,4,6,CHECK_WITHDRAWAL,109650.0,C1688019098
140,409000611074',2018-04-06,INDO GIBL Indiaforensic STL04041,318100.0,0.0,1700709.0,2018,4,6,CHECK_WITHDRAWAL,318100.0,M1689924104
141,409000611074',2018-04-06,INDO GIBL Indiaforensic STL05041,309200.0,0.0,1391509.0,2018,4,6,CHECK_WITHDRAWAL,309200.0,M631673932
142,409000611074',2018-04-07,INDO GIBL Indiaforensic STL06041,303600.0,0.0,1087909.0,2018,4,7,PAYEMENT,303600.0,C1321640594
143,409000611074',2018-04-09,INDO GIBL Indiaforensic STL07041,48800.0,0.0,1039109.0,2018,4,9,CASH_OUT,48800.0,M790094605
144,409000611074',2018-04-09,FDRL/INTERNAL FUND TRANSFE,0.0,500000.0,1539109.0,2018,4,9,CHECK_CASHING,500000.0,M487792155
145,409000611074',2018-04-10,INDO GIBL Indiaforensic STL09041,305950.0,0.0,1233159.0,2018,4,10,DEBIT,305950.0,M1632670136
146,409000611074',2018-04-11,FDRL/INTERNAL FUND TRANSFE,0.0,500000.0,1733159.0,2018,4,11,CHECK_CASHING,500000.0,C1170794006
147,409000611074',2018-04-11,INDO GIBL Indiaforensic STL10041,162600.0,0.0,1570559.0,2018,4,11,CASH_OUT,162600.0,C1509514333
148,409000611074',2018-04-12,INDO GIBL Indiaforensic STL11041,639700.0,0.0,930859.0,2018,4,12,DEBIT,639700.0,M638486177
149,409000611074',2018-04-12,FDRL/INTERNAL FUND TRANSFE,0.0,500000.0,1430859.0,2018,4,12,TRANSFER,500000.0,M314411620
150,409000611074',2018-04-13,INDO GIBL Indiaforensic STL12041,363900.0,0.0,1066959.0,2018,4,13,PAYEMENT,363900.0,C564160838
151,409000611074',2018-04-13,FDRL/INTERNAL FUND TRANSFE,0.0,500000.0,1566959.0,2018,4,13,CHECK_CASHING,500000.0,C392292416
152,409000611074',2018-04-13,FDRL/INTERNAL FUND TRANSFE,0.0,500000.0,2066959.0,2018,4,13,TRANSFER,500000.0,C1297685781
153,409000611074',2018-04-16,INDO GIBL Indiaforensic STL13041,347950.0,0.0,1719009.0,2018,4,16,CASH_OUT,347950.0,C1297685781
154,409000611074',2018-04-16,INDO GIBL Indiaforensic STL14041,76900.0,0.0,1642109.0,2018,4,16,PAYEMENT,76900.0,C747464370
155,409000611074',2018-04-16,INDO GIBL Indiaforensic STL15041,48000.0,0.0,1594109.0,2018,4,16,CASH_OUT,48000.0,C1509514333
156,409000611074',2018-04-17,INDO GIBL Indiaforensic STL16041,555650.0,0.0,1038459.0,2018,4,17,CASH_OUT,555650.0,C1590550415
157,409000611074',2018-04-18,FDRL/INTERNAL FUND TRANSFE,0.0,500000.0,1538459.0,2018,4,18,CHECK_CASHING,500000.0,C288665596
158,409000611074',2018-04-18,INDO GIBL Indiaforensic STL17041,574150.0,0.0,964309.0,2018,4,18,CHECK_WITHDRAWAL,574150.0,C1749186397
159,409000611074',2018-04-19,INDO GIBL Indiaforensic STL18041,388550.0,0.0,575759.0,2018,4,19,CHECK_WITHDRAWAL,388550.0,C453211571
160,409000611074',2018-04-19,FDRL/INTERNAL FUND TRANSFE,0.0,500000.0,1075759.0,2018,4,19,CASH_IN,500000.0,C757108857
161,409000611074',2018-04-20,INDO GIBL Indiaforensic STL19041,276300.0,0.0,799459.0,2018,4,20,CHECK_WITHDRAWAL,276300.0,C1023714065
162,409000611074',2018-04-21,INDO GIBL Indiaforensic STL20041,167591.0,0.0,631868.0,2018,4,21,CHECK_WITHDRAWAL,167591.0,C401424608
163,409000611074',2018-04-21,FDRL/INTERNAL FUND TRANSFE,0.0,500000.0,1131868.0,2018,4,21,CASH_IN,500000.0,C240650537
164,409000611074',2018-04-21,FDRL/INTERNAL FUND TRANSFE,0.0,500000.0,1631868.0,2018,4,21,CASH_IN,500000.0,C1971489295
165,409000611074',2018-04-25,INDO GIBL Indiaforensic STL21041,242700.0,0.0,1389168.0,2018,4,25,CHECK_WITHDRAWAL,242700.0,C766572210
166,409000611074',2018-04-25,INDO GIBL Indiaforensic STL22041,92900.0,0.0,1296268.0,2018,4,25,PAYEMENT,92900.0,C401424608
167,409000611074',2018-04-25,INDO GIBL Indiaforensic STL23041,315750.0,0.0,980518.0,2018,4,25,CASH_OUT,315750.0,C476800120
168,409000611074',2018-04-25,INDO GIBL Indiaforensic STL24041,377300.0,0.0,603218.0,2018,4,25,CASH_OUT,377300.0,C1209271652
169,409000611074',2018-04-26,FDRL/INTERNAL FUND TRANSFE,0.0,500000.0,1103218.0,2018,4,26,CHECK_CASHING,500000.0,C2083562754
170,409000611074',2018-04-26,FDRL/INTERNAL FUND TRANSFE,0.0,500000.0,1603218.0,2018,4,26,TRANSFER,500000.0,C557041912
171,409000611074',2018-04-27,INDO GIBL Indiaforensic STL25041,414276.0,0.0,1188942.0,2018,4,27,DEBIT,414276.0,C1590550415
172,409000611074',2018-04-27,INDO GIBL Indiaforensic STL26041,351100.0,0.0,837842.0,2018,4,27,CHECK_WITHDRAWAL,351100.0,C1435804085
173,409000611074',2018-04-27,FDRL/INTERNAL FUND TRANSFE,0.0,500000.0,1337842.0,2018,4,27,CASH_IN,500000.0,C736709391
174,409000611074',2018-05-01,FDRL/INTERNAL FUND TRANSFE,0.0,500000.0,1837842.0,2018,5,1,TRANSFER,500000.0,C240650537
175,409000611074',2018-05-02,INDO GIBL Indiaforensic STL27041,229949.0,0.0,1607893.0,2018,5,2,CASH_OUT,229949.0,C1854778591
176,409000611074',2018-05-02,INDO GIBL Indiaforensic STL28041,160300.0,0.0,1447593.0,2018,5,2,DEBIT,160300.0,C885951223
177,409000611074',2018-05-02,INDO GIBL Indiaforensic STL29041,76000.0,0.0,1371593.0,2018,5,2,CASH_OUT,76000.0,C1590550415
178,409000611074',2018-05-02,INDO GIBL Indiaforensic STL30041,60449.0,0.0,1311144.0,2018,5,2,DEBIT,60449.0,C1060830840
179,409000611074',2018-05-02,INDO GIBL Indiaforensic STL01051,259075.0,0.0,1052069.0,2018,5,2,CHECK_WITHDRAWAL,259075.0,C920011586
180,409000611074',2018-05-02,FDRL/INTERNAL FUND TRANSFE,0.0,500000.0,1552069.0,2018,5,2,CASH_IN,500000.0,C1360767589
181,409000611074',2018-05-03,INDO GIBL Indiaforensic STL02051,206700.0,0.0,1345369.0,2018,5,3,CASH_OUT,206700.0,C824009085
182,409000611074',2018-05-03,FDRL/INTERNAL FUND TRANSFE,0.0,500000.0,1845369.0,2018,5,3,TRANSFER,500000.0,C1531333864
183,409000611074',2018-05-04,INDO GIBL Indiaforensic STL03051,237000.0,0.0,1608369.0,2018,5,4,DEBIT,237000.0,C434091818
184,409000611074',2018-05-05,INDO GIBL Indiaforensic STL04051,272000.0,0.0,1336369.0,2018,5,5,PAYEMENT,272000.0,C1023714065
185,409000611074',2018-05-07,INDO GIBL Indiaforensic STL05051,387749.0,0.0,948620.0,2018,5,7,DEBIT,387749.0,C1225616405
186,409000611074',2018-05-07,INDO GIBL Indiaforensic STL06051,101050.0,0.0,847570.0,2018,5,7,PAYEMENT,101050.0,C1504109395
187,409000611074',2018-05-07,FDRL/INTERNAL FUND TRANSFE,0.0,500000.0,1347570.0,2018,5,7,CASH_IN,500000.0,C1531333864
188,409000611074',2018-05-08,INDO GIBL Indiaforensic STL07051,392900.0,0.0,954670.0,2018,5,8,DEBIT,392900.0,C985934102
189,409000611074',2018-05-09,INDO GIBL Indiaforensic STL08051,290350.0,0.0,664320.0,2018,5,9,CASH_OUT,290350.0,C564160838
190,409000611074',2018-05-09,FDRL/INTERNAL FUND TRANSFE,0.0,500000.0,1164320.0,2018,5,9,CHECK_CASHING,500000.0,C453211571
191,409000611074',2018-05-09,FDRL/INTERNAL FUND TRANSFE,0.0,500000.0,1664320.0,2018,5,9,CHECK_CASHING,500000.0,C932583850
192,409000611074',2018-05-10,INDO GIBL Indiaforensic STL09051,365625.0,0.0,1298695.0,2018,5,10,CHECK_WITHDRAWAL,365625.0,C1971489295
193,409000611074',2018-05-11,INDO GIBL Indiaforensic STL10051,352850.0,0.0,945845.0,2018,5,11,CHECK_WITHDRAWAL,352850.0,C2083562754
194,409000611074',2018-05-11,FDRL/INTERNAL FUND TRANSFE,0.0,500000.0,1445845.0,2018,5,11,CHECK_CASHING,500000.0,C985934102
195,409000611074',2018-05-14,INDO GIBL Indiaforensic STL11051,345749.0,0.0,1100096.0,2018,5,14,PAYEMENT,345749.0,C1170794006
196,409000611074',2018-05-14,INDO GIBL Indiaforensic STL12051,225300.0,0.0,874796.0,2018,5,14,CASH_OUT,225300.0,C1740000325
197,409000611074',2018-05-14,INDO GIBL Indiaforensic STL13051,10000.0,0.0,864796.0,2018,5,14,CHECK_WITHDRAWAL,10000.0,C248609774
198,409000611074',2018-05-14,FDRL/INTERNAL FUND TRANSFE,0.0,500000.0,1364796.0,2018,5,14,CHECK_CASHING,500000.0,C453211571
199,409000611074',2018-05-15,INDO GIBL Indiaforensic STL14051,823240.0,0.0,541556.0,2018,5,15,DEBIT,823240.0,C1360767589
200,409000611074',2018-05-15,FDRL/INTERNAL FUND TRANSFE,0.0,500000.0,1041556.0,2018,5,15,TRANSFER,500000.0,C451111351
201,409000611074',2018-05-15,FDRL/INTERNAL FUND TRANSFE,0.0,500000.0,1541556.0,2018,5,15,TRANSFER,500000.0,C747464370
202,409000611074',2018-05-16,INDO GIBL Indiaforensic STL15051,785049.0,0.0,756507.0,2018,5,16,DEBIT,785049.0,C796533847
203,409000611074',2018-05-17,FDRL/INTERNAL FUND TRANSFE,0.0,500000.0,1256507.0,2018,5,17,TRANSFER,500000.0,C240650537
204,409000611074',2018-05-17,INDO GIBL Indiaforensic STL16051,403100.0,0.0,853407.0,2018,5,17,CASH_OUT,403100.0,C357863579
205,409000611074',2018-05-17,FDRL/INTERNAL FUND TRANSFE,0.0,500000.0,1353407.0,2018,5,17,CHECK_CASHING,500000.0,C401424608
206,409000611074',2018-05-18,INDO GIBL Indiaforensic STL17051,459800.0,0.0,893607.0,2018,5,18,PAYEMENT,459800.0,C757108857
207,409000611074',2018-05-18,FDRL/INTERNAL FUND TRANSFE,0.0,500000.0,1393607.0,2018,5,18,TRANSFER,500000.0,C1688019098
208,409000611074',2018-05-19,INDO GIBL Indiaforensic STL18051,373850.0,0.0,1019757.0,2018,5,19,DEBIT,373850.0,C1789550256
209,409000611074',2018-05-21,INDO GIBL Indiaforensic STL19051,265500.0,0.0,754257.0,2018,5,21,DEBIT,265500.0,C476402209
210,409000611074',2018-05-21,INDO GIBL Indiaforensic STL20051,25700.0,0.0,728557.0,2018,5,21,CASH_OUT,25700.0,C985934102
211,409000611074',2018-05-21,FDRL/INTERNAL FUND TRANSFE,0.0,500000.0,1228557.0,2018,5,21,CASH_IN,500000.0,C557041912
212,409000611074',2018-05-22,INDO GIBL Indiaforensic STL21051,376125.0,0.0,852432.0,2018,5,22,DEBIT,376125.0,C401424608
213,409000611074',2018-05-22,FDRL/INTERNAL FUND TRANSFE,0.0,500000.0,1352432.0,2018,5,22,CASH_IN,500000.0,C1360767589
214,409000611074',2018-05-23,INDO GIBL Indiaforensic STL22051,265250.0,0.0,1087182.0,2018,5,23,DEBIT,265250.0,C747464370
215,409000611074',2018-05-24,INDO GIBL Indiaforensic STL23051,119100.0,0.0,968082.0,2018,5,24,DEBIT,119100.0,C33524623
216,409000611074',2018-05-24,FDRL/INTERNAL FUND TRANSFE,0.0,500000.0,1468082.0,2018,5,24,TRANSFER,500000.0,C1297685781
217,409000611074',2018-05-25,INDO GIBL Indiaforensic STL24051,93350.0,0.0,1374732.0,2018,5,25,CHECK_WITHDRAWAL,93350.0,C451111351
218,409000611074',2018-05-28,INDO GIBL Indiaforensic STL25051,201000.0,0.0,1173732.0,2018,5,28,PAYEMENT,201000.0,M1555990397
219,409000611074',2018-05-28,INDO GIBL Indiaforensic STL26051,80475.0,0.0,1093257.0,2018,5,28,CHECK_WITHDRAWAL,80475.0,M1291367132
220,409000611074',2018-05-28,INDO GIBL Indiaforensic STL27051,27200.0,0.0,1066057.0,2018,5,28,CHECK_WITHDRAWAL,27200.0,M1479140596
221,409000611074',2018-05-28,FDRL/INTERNAL FUND TRANSFE,0.0,500000.0,1566057.0,2018,5,28,TRANSFER,500000.0,M1275028674
222,409000611074',2018-05-29,INDO GIBL Indiaforensic STL28051,364100.0,0.0,1201957.0,2018,5,29,PAYEMENT,364100.0,M204805934
223,409000611074',2018-05-30,INDO GIBL Indiaforensic STL29051,341200.0,0.0,860757.0,2018,5,30,CASH_OUT,341200.0,M1019484860
224,409000611074',2018-05-30,FDRL/INTERNAL FUND TRANSFE,0.0,500000.0,1360757.0,2018,5,30,CHECK_CASHING,500000.0,M1640899500
225,409000611074',2018-05-31,INDO GIBL Indiaforensic STL30051,234600.0,0.0,1126157.0,2018,5,31,PAYEMENT,234600.0,M473666452
226,409000611074',2018-06-01,FDRL/INTERNAL FUND TRANSFE,0.0,500000.0,1626157.0,2018,6,1,CASH_IN,500000.0,M2138005960
227,409000611074',2018-06-01,INDO GIBL Indiaforensic STL31051,78000.0,0.0,1548157.0,2018,6,1,CASH_OUT,78000.0,C510113906
228,409000611074',2018-06-02,INDO GIBL Indiaforensic STL01061,353500.0,0.0,1194657.0,2018,6,2,PAYEMENT,353500.0,M67730604
229,409000611074',2018-06-04,FDRL/INTERNAL FUND TRANSFE,0.0,500000.0,1694657.0,2018,6,4,CASH_IN,500000.0,M710623214
230,409000611074',2018-06-04,INDO GIBL Indiaforensic STL02061,402850.0,0.0,1291807.0,2018,6,4,PAYEMENT,402850.0,C1810132623
231,409000611074',2018-06-05,INDO GIBL Indiaforensic STL04061,578750.0,0.0,713057.0,2018,6,5,PAYEMENT,578750.0,C476402209
232,409000611074',2018-06-06,INDO GIBL Indiaforensic STL05061,251200.0,0.0,461857.0,2018,6,6,DEBIT,251200.0,C1096283470
233,409000611074',2018-06-06,FDRL/INTERNAL FUND TRANSFE,0.0,500000.0,961857.0,2018,6,6,CASH_IN,500000.0,C75457651
234,409000611074',2018-06-06,FDRL/INTERNAL FUND TRANSFE,0.0,500000.0,1461857.0,2018,6,6,CHECK_CASHING,500000.0,M1896552614
235,409000611074',2018-06-07,INDO GIBL Indiaforensic STL06061,217075.0,0.0,1244782.0,2018,6,7,CASH_OUT,217075.0,M1033856359
236,409000611074',2018-06-08,INDO GIBL Indiaforensic STL07061,491005.0,0.0,753777.0,2018,6,8,CHECK_WITHDRAWAL,491005.0,C451111351
237,409000611074',2018-06-11,FDRL/INTERNAL FUND TRANSFE,0.0,500000.0,1253777.0,2018,6,11,CHECK_CASHING,500000.0,M904253669
238,409000611074',2018-06-11,FDRL/INTERNAL FUND TRANSFE,0.0,500000.0,1753777.0,2018,6,11,CASH_IN,500000.0,M1431710377
239,409000611074',2018-06-11,INDO GIBL Indiaforensic STL08061,626600.0,0.0,1127177.0,2018,6,11,PAYEMENT,626600.0,M2116511124
240,409000611074',2018-06-11,INDO GIBL Indiaforensic STL09061,340074.0,0.0,787103.0,2018,6,11,DEBIT,340074.0,M1348916831
241,409000611074',2018-06-11,INDO GIBL Indiaforensic STL10061,24176.0,0.0,762927.0,2018,6,11,CHECK_WITHDRAWAL,24176.0,M125644421
242,409000611074',2018-06-12,FDRL/INTERNAL FUND TRANSFE,0.0,500000.0,1262927.0,2018,6,12,CHECK_CASHING,500000.0,M1493158871
243,409000611074',2018-06-12,FDRL/INTERNAL FUND TRANSFE,0.0,500000.0,1762927.0,2018,6,12,TRANSFER,500000.0,M1806880779
244,409000611074',2018-06-12,INDO GIBL Indiaforensic STL11061,793251.0,0.0,969676.0,2018,6,12,CASH_OUT,793251.0,M446445803
245,409000611074',2018-06-13,FDRL/INTERNAL FUND TRANSFE,0.0,500000.0,1469676.0,2018,6,13,CHECK_CASHING,500000.0,M1280603381
246,409000611074',2018-06-13,INDO GIBL Indiaforensic STL12061,717850.0,0.0,751826.0,2018,6,13,PAYEMENT,717850.0,M1424108509
247,409000611074',2018-06-13,INDO GIBL Indiaforensic STL27041,32000.0,0.0,719826.0,2018,6,13,CHECK_WITHDRAWAL,32000.0,M1414013111
248,409000611074',2018-06-13,FDRL/INTERNAL FUND TRANSFE,0.0,500000.0,1219826.0,2018,6,13,CASH_IN,500000.0,M778162712
249,409000611074',2018-06-14,FDRL/INTERNAL FUND TRANSFE,0.0,1000000.0,2219826.0,2018,6,14,CASH_IN,1000000.0,M548482954
250,409000611074',2018-06-14,INDO GIBL Indiaforensic STL13061,533800.0,0.0,1686026.0,2018,6,14,DEBIT,533800.0,M777341499
251,409000611074',2018-06-15,INDO GIBL Indiaforensic STL14061,559730.0,0.0,1126296.0,2018,6,15,CASH_OUT,559730.0,C972765878
252,409000611074',2018-06-15,FDRL/INTERNAL FUND TRANSFE,0.0,1000000.0,2126296.0,2018,6,15,TRANSFER,1000000.0,C1007251739
253,409000611074',2018-06-18,INDO GIBL Indiaforensic STL17061,52250.0,0.0,2074046.0,2018,6,18,CASH_OUT,52250.0,M1378497201
254,409000611074',2018-06-18,INDO GIBL Indiaforensic STL16061,140750.0,0.0,1933296.0,2018,6,18,CASH_OUT,140750.0,M1577167234
255,409000611074',2018-06-18,INDO GIBL Indiaforensic STL15061,325200.0,0.0,1608096.0,2018,6,18,CHECK_WITHDRAWAL,325200.0,M1591916281
256,409000611074',2018-06-19,FDRL/INTERNAL FUND TRANSFE,0.0,500000.0,2108096.0,2018,6,19,CHECK_CASHING,500000.0,M1884231057
257,409000611074',2018-06-19,INDO GIBL Indiaforensic STL18061,709200.0,0.0,1398896.0,2018,6,19,DEBIT,709200.0,M333793193
258,409000611074',2018-06-20,FDRL/INTERNAL FUND TRANSFE,0.0,500000.0,1898896.0,2018,6,20,TRANSFER,500000.0,M937277082
259,409000611074',2018-06-20,INDO GIBL Indiaforensic STL19061,689650.0,0.0,1209246.0,2018,6,20,CHECK_WITHDRAWAL,689650.0,M234740890
260,409000611074',2018-06-21,FDRL/INTERNAL FUND TRANSFE,0.0,500000.0,1709246.0,2018,6,21,TRANSFER,500000.0,C1076835071
261,409000611074',2018-06-21,INDO GIBL Indiaforensic STL20061,386200.0,0.0,1323046.0,2018,6,21,CASH_OUT,386200.0,M179294202
262,409000611074',2018-06-22,INDO GIBL Indiaforensic STL21061,434905.0,0.0,888141.0,2018,6,22,CASH_OUT,434905.0,M593103894
263,409000611074',2018-06-22,FDRL/INTERNAL FUND TRANSFE,0.0,1000000.0,1888141.0,2018,6,22,CHECK_CASHING,1000000.0,M1601935322
264,409000611074',2018-06-25,INDO GIBL Indiaforensic STL24061,6050.0,0.0,1882091.0,2018,6,25,CASH_OUT,6050.0,M1803093683
265,409000611074',2018-06-25,INDO GIBL Indiaforensic STL23061,115051.0,0.0,1767040.0,2018,6,25,CASH_OUT,115051.0,M962287291
266,409000611074',2018-06-25,INDO GIBL Indiaforensic STL22061,242750.0,0.0,1524290.0,2018,6,25,DEBIT,242750.0,M109069556
267,409000611074',2018-06-25,TRF FROM  Indiaforensic SERVICES,0.0,500000.0,2024290.0,2018,6,25,TRANSFER,500000.0,M828326869
268,409000611074',2018-06-26,INDO GIBL Indiaforensic STL25061,261438.0,0.0,1762852.0,2018,6,26,PAYEMENT,261438.0,M1817789863
269,409000611074',2018-06-27,INDO GIBL Indiaforensic STL26061,528175.0,0.0,1234677.0,2018,6,27,CASH_OUT,528175.0,M1678709153
270,409000611074',2018-06-28,FDRL/INTERNAL FUND TRANSFE,0.0,500000.0,1734677.0,2018,6,28,TRANSFER,500000.0,C1297685781
271,409000611074',2018-06-28,GIBLRBL INC INDO REM27061,2640.0,0.0,1732037.0,2018,6,28,DEBIT,2640.0,M2016828666
272,409000611074',2018-06-28,INDO MFL STL270618,344750.0,0.0,1387287.0,2018,6,28,PAYEMENT,344750.0,M1064154107
273,409000611074',2018-06-29,Indfor INCOME INDO REMI28061,2160.0,0.0,1385127.0,2018,6,29,CASH_OUT,2160.0,M415565467
274,409000611074',2018-06-29,INDO GIBL Indiaforensic STL28061,410181.0,0.0,974946.0,2018,6,29,DEBIT,410181.0,C1335050193
275,409000611074',2018-06-29,FDRL/INTERNAL FUND TRANSFE,0.0,500000.0,1474946.0,2018,6,29,CHECK_CASHING,500000.0,M1214133948
276,409000611074',2018-06-30,Indfor INCOME INDO REMI29061,1320.0,0.0,1473626.0,2018,6,30,CASH_OUT,1320.0,C1335050193
277,409000611074',2018-06-30,INDO GIBL Indiaforensic STL29061,176050.0,0.0,1297576.0,2018,6,30,CASH_OUT,176050.0,M782228073
278,409000611074',2018-07-02,FDRL/INTERNAL FUND TRANSFE,0.0,500000.0,1797576.0,2018,7,2,CHECK_CASHING,500000.0,M391506011
279,409000611074',2018-07-02,Indfor INCOME INDO REMI30061,960.0,0.0,1796616.0,2018,7,2,DEBIT,960.0,C1789550256
280,409000611074',2018-07-02,INDO GIBL Indiaforensic STL30061,200250.0,0.0,1596366.0,2018,7,2,DEBIT,200250.0,C75457651
281,409000611074',2018-07-02,Indfor INCOME INDO REMI01071,120.0,0.0,1596246.0,2018,7,2,PAYEMENT,120.0,C920011586
282,409000611074',2018-07-02,INDO GIBL Indiaforensic STL01071,10000.0,0.0,1586246.0,2018,7,2,CASH_OUT,10000.0,C1740000325
283,409000611074',2018-07-04,Indfor INCOME INDO REMI02071,2280.0,0.0,1583966.0,2018,7,4,DEBIT,2280.0,C2083562754
284,409000611074',2018-07-04,INDO GIBL Indiaforensic STL02071,282208.0,0.0,1301758.0,2018,7,4,CHECK_WITHDRAWAL,282208.0,C1740000325
285,409000611074',2018-07-04,FDRL/INTERNAL FUND TRANSFE,0.0,500000.0,1801758.0,2018,7,4,TRANSFER,500000.0,C985934102
286,409000611074',2018-07-04,Indfor INCOME INDO REMI03071,2280.0,0.0,1799478.0,2018,7,4,CHECK_WITHDRAWAL,2280.0,C1335050193
287,409000611074',2018-07-04,INDO GIBL Indiaforensic STL03071,323700.0,0.0,1475778.0,2018,7,4,PAYEMENT,323700.0,C757108857
288,409000611074',2018-07-05,Indfor INCOME INDO REMI04071,3840.0,0.0,1471938.0,2018,7,5,PAYEMENT,3840.0,C1360767589
289,409000611074',2018-07-05,INDO GIBL Indiaforensic STL04071,528300.0,0.0,943638.0,2018,7,5,CHECK_WITHDRAWAL,528300.0,C1590550415
290,409000611074',2018-07-06,Indfor INCOME INDO REMI05071,2520.0,0.0,941118.0,2018,7,6,PAYEMENT,2520.0,C1360767589
291,409000611074',2018-07-06,INDO GIBL Indiaforensic STL05071,431899.0,0.0,509219.0,2018,7,6,DEBIT,431899.0,M352776719
292,409000611074',2018-07-06,FDRL/INTERNAL FUND TRANSFE,0.0,500000.0,1009219.0,2018,7,6,CASH_IN,500000.0,M1112527632
293,409000611074',2018-07-07,Indfor INCOME INDO REMI06071,2640.0,0.0,1006579.0,2018,7,7,DEBIT,2640.0,M955324150
294,409000611074',2018-07-07,INDO GIBL Indiaforensic STL06071,295000.0,0.0,711579.0,2018,7,7,CASH_OUT,295000.0,M1852661033
295,409000611074',2018-07-07,FDRL/INTERNAL FUND TRANSFE,0.0,500000.0,1211579.0,2018,7,7,TRANSFER,500000.0,M1814423236
296,409000611074',2018-07-09,Indfor INCOME INDO REMI08071,120.0,0.0,1211459.0,2018,7,9,CASH_OUT,120.0,C1688019098
297,409000611074',2018-07-09,INDO GIBL Indiaforensic STL08071,30700.0,0.0,1180759.0,2018,7,9,CASH_OUT,30700.0,M1218519094
298,409000611074',2018-07-09,Indfor INCOME INDO REMI07071,1200.0,0.0,1179559.0,2018,7,9,PAYEMENT,1200.0,M1894758168
299,409000611074',2018-07-09,INDO GIBL Indiaforensic STL07071,213225.0,0.0,966334.0,2018,7,9,DEBIT,213225.0,M1242688388
300,409000611074',2018-07-09,FDRL/INTERNAL FUND TRANSFE,0.0,500000.0,1466334.0,2018,7,9,CHECK_CASHING,500000.0,C665576141
301,409000611074',2018-07-10,Indfor INCOME INDO REMI09071,4800.0,0.0,1461534.0,2018,7,10,CASH_OUT,4800.0,M1316005672
302,409000611074',2018-07-10,INDO GIBL Indiaforensic STL09071,809926.0,0.0,651608.0,2018,7,10,PAYEMENT,809926.0,C401424608
303,409000611074',2018-07-10,FDRL/INTERNAL FUND TRANSFE,0.0,500000.0,1151608.0,2018,7,10,CASH_IN,500000.0,M1463022229
304,409000611074',2018-07-11,Indfor INCOME INDO REMI10071,2640.0,0.0,1148968.0,2018,7,11,CHECK_WITHDRAWAL,2640.0,M1455855843
305,409000611074',2018-07-11,INDO GIBL Indiaforensic STL10071,435225.0,0.0,713743.0,2018,7,11,DEBIT,435225.0,M256346753
306,409000611074',2018-07-11,FDRL/INTERNAL FUND TRANSFE,0.0,500000.0,1213743.0,2018,7,11,CHECK_CASHING,500000.0,C466505482
307,409000611074',2018-07-12,FDRL/INTERNAL FUND TRANSFE,0.0,500000.0,1713743.0,2018,7,12,CASH_IN,500000.0,M2145896000
308,409000611074',2018-07-12,Indfor INCOME INDO REMI11071,4560.0,0.0,1709183.0,2018,7,12,PAYEMENT,4560.0,C1750905143
309,409000611074',2018-07-12,INDO GIBL Indiaforensic STL11071,828988.0,0.0,880195.0,2018,7,12,PAYEMENT,828988.0,M852026681
310,409000611074',2018-07-12,FDRL/INTERNAL FUND TRANSFE,0.0,500000.0,1380195.0,2018,7,12,CASH_IN,500000.0,M94919826
311,409000611074',2018-07-13,Indfor INCOME INDO REMI12071,3120.0,0.0,1377075.0,2018,7,13,PAYEMENT,3120.0,M1201004240
312,409000611074',2018-07-13,INDO GIBL Indiaforensic STL12071,447455.0,0.0,929620.0,2018,7,13,CHECK_WITHDRAWAL,447455.0,M349259569
313,409000611074',2018-07-13,FDRL/INTERNAL FUND TRANSFE,0.0,500000.0,1429620.0,2018,7,13,TRANSFER,500000.0,M1204088028
314,409000611074',2018-07-13,FDRL/INTERNAL FUND TRANSFE,0.0,200000.0,1629620.0,2018,7,13,TRANSFER,200000.0,M1552221437
315,409000611074',2018-07-16,Indfor INCOME INDO REMI15071,360.0,0.0,1629260.0,2018,7,16,CHECK_WITHDRAWAL,360.0,M1685407532
316,409000611074',2018-07-16,INDO GIBL Indiaforensic STL15071,69800.0,0.0,1559460.0,2018,7,16,CHECK_WITHDRAWAL,69800.0,M1272051933
317,409000611074',2018-07-16,Indfor INCOME INDO REMI14071,840.0,0.0,1558620.0,2018,7,16,CASH_OUT,840.0,M1041547629
318,409000611074',2018-07-16,INDO GIBL Indiaforensic STL14071,121300.0,0.0,1437320.0,2018,7,16,PAYEMENT,121300.0,M2018220300
319,409000611074',2018-07-16,Indfor INCOME INDO REMI13071,3000.0,0.0,1434320.0,2018,7,16,CHECK_WITHDRAWAL,3000.0,M633079302
320,409000611074',2018-07-16,INDO GIBL Indiaforensic STL13071,505300.0,0.0,929020.0,2018,7,16,DEBIT,505300.0,M2033268925
321,409000611074',2018-07-17,FDRL/INTERNAL FUND TRANSFE,0.0,200000.0,1129020.0,2018,7,17,CASH_IN,200000.0,M1545077099
322,409000611074',2018-07-17,FDRL/INTERNAL FUND TRANSFE,0.0,500000.0,1629020.0,2018,7,17,CASH_IN,500000.0,M1135278099
323,409000611074',2018-07-17,Indfor INCOME INDO REMI16071,4080.0,0.0,1624940.0,2018,7,17,CASH_OUT,4080.0,M1268974304
324,409000611074',2018-07-17,INDO GIBL Indiaforensic STL16071,717000.0,0.0,907940.0,2018,7,17,DEBIT,717000.0,M451312813
325,409000611074',2018-07-17,FDRL/INTERNAL FUND TRANSFE,0.0,200000.0,1107940.0,2018,7,17,CASH_IN,200000.0,M2081000371
326,409000611074',2018-07-17,FDRL/INTERNAL FUND TRANSFE,0.0,200000.0,1307940.0,2018,7,17,CASH_IN,200000.0,C655381473
327,409000611074',2018-07-18,Indfor INCOME INDO REMI17071,3960.0,0.0,1303980.0,2018,7,18,CASH_OUT,3960.0,M1178290888
328,409000611074',2018-07-18,INDO GIBL Indiaforensic STL17071,581900.0,0.0,722080.0,2018,7,18,DEBIT,581900.0,C1291286504
329,409000611074',2018-07-18,FDRL/INTERNAL FUND TRANSFE,0.0,200000.0,922080.0,2018,7,18,CHECK_CASHING,200000.0,M251664534
330,409000611074',2018-07-18,FDRL/INTERNAL FUND TRANSFE,0.0,200000.0,1122080.0,2018,7,18,CHECK_CASHING,200000.0,C485041780
331,409000611074',2018-07-18,FDRL/INTERNAL FUND TRANSFE,0.0,200000.0,1322080.0,2018,7,18,CHECK_CASHING,200000.0,C476800120
332,409000611074',2018-07-18,FDRL/INTERNAL FUND TRANSFE,0.0,200000.0,1522080.0,2018,7,18,CHECK_CASHING,200000.0,M1141500277
333,409000611074',2018-07-19,FDRL/INTERNAL FUND TRANSFE,0.0,200000.0,1722080.0,2018,7,19,CHECK_CASHING,200000.0,M712410791
334,409000611074',2018-07-19,FDRL/INTERNAL FUND TRANSFE,0.0,200000.0,1922080.0,2018,7,19,CASH_IN,200000.0,M2126723403
335,409000611074',2018-07-19,Indfor INCOME INDO REMI18071,3600.0,0.0,1918480.0,2018,7,19,PAYEMENT,3600.0,C747464370
336,409000611074',2018-07-19,INDO GIBL Indiaforensic STL18071,663350.0,0.0,1255130.0,2018,7,19,CASH_OUT,663350.0,M824881806
337,409000611074',2018-07-20,Indfor INCOME INDO REMI19071,1440.0,0.0,1253690.0,2018,7,20,CHECK_WITHDRAWAL,1440.0,C20671747
338,409000611074',2018-07-20,INDO GIBL Indiaforensic STL19071,135800.0,0.0,1117890.0,2018,7,20,CHECK_WITHDRAWAL,135800.0,M663466110
339,409000611074',2018-07-20,FDRL/INTERNAL FUND TRANSFE,0.0,300000.0,1417890.0,2018,7,20,CASH_IN,300000.0,M864138492
340,409000611074',2018-07-21,Indfor INCOME INDO REMI20071,3600.0,0.0,1414290.0,2018,7,21,CHECK_WITHDRAWAL,3600.0,M295180183
341,409000611074',2018-07-21,INDO GIBL Indiaforensic STL20071,712099.0,0.0,702191.0,2018,7,21,CHECK_WITHDRAWAL,712099.0,M1650113431
342,409000611074',2018-07-21,FDRL/INTERNAL FUND TRANSFE,0.0,1000000.0,1702191.0,2018,7,21,CASH_IN,1000000.0,M183155105
343,409000611074',2018-07-23,FDRL/INTERNAL FUND TRANSFE,0.0,300000.0,2002191.0,2018,7,23,TRANSFER,300000.0,M2001115307
344,409000611074',2018-07-23,Indfor INCOME INDO REMI22071,840.0,0.0,2001351.0,2018,7,23,CASH_OUT,840.0,M172794870
345,409000611074',2018-07-23,INDO GIBL Indiaforensic STL22071,145400.0,0.0,1855951.0,2018,7,23,CHECK_WITHDRAWAL,145400.0,C1234776885
346,409000611074',2018-07-23,Indfor INCOME INDO REMI21071,1920.0,0.0,1854031.0,2018,7,23,PAYEMENT,1920.0,C1330106945
347,409000611074',2018-07-23,INDO GIBL Indiaforensic STL21071,240535.0,0.0,1613496.0,2018,7,23,DEBIT,240535.0,M707531688
348,409000611074',2018-07-24,Indfor INCOME INDO REMI23071,3840.0,0.0,1609656.0,2018,7,24,DEBIT,3840.0,M1799635803
349,409000611074',2018-07-24,INDO GIBL Indiaforensic STL23071,610100.0,0.0,999556.0,2018,7,24,PAYEMENT,610100.0,M1723290893
350,409000611074',2018-07-25,FDRL/INTERNAL FUND TRANSFE,0.0,500000.0,1499556.0,2018,7,25,CASH_IN,500000.0,M2085886997
351,409000611074',2018-07-25,Indfor INCOME INDO REMI24071,3360.0,0.0,1496196.0,2018,7,25,CASH_OUT,3360.0,M1770070706
352,409000611074',2018-07-25,INDO GIBL Indiaforensic STL24071,518500.0,0.0,977696.0,2018,7,25,CASH_OUT,518500.0,C1983747920
353,409000611074',2018-07-25,FDRL/INTERNAL FUND TRANSFE,0.0,300000.0,1277696.0,2018,7,25,CASH_IN,300000.0,C1899073220
354,409000611074',2018-07-25,FDRL/INTERNAL FUND TRANSFE,0.0,300000.0,1577696.0,2018,7,25,CASH_IN,300000.0,C1749186397
355,409000611074',2018-07-26,Indfor INCOME INDO REMI25071,3240.0,0.0,1574456.0,2018,7,26,PAYEMENT,3240.0,C564160838
356,409000611074',2018-07-26,INDO GIBL Indiaforensic STL25071,442250.0,0.0,1132206.0,2018,7,26,PAYEMENT,442250.0,C1531333864
357,409000611074',2018-07-26,FDRL/INTERNAL FUND TRANSFE,0.0,300000.0,1432206.0,2018,7,26,CASH_IN,300000.0,C453211571
358,409000611074',2018-07-27,Indfor INCOME INDO REMI26071,3240.0,0.0,1428966.0,2018,7,27,DEBIT,3240.0,C1590550415
359,409000611074',2018-07-27,INDO GIBL Indiaforensic STL26071,389600.0,0.0,1039366.0,2018,7,27,CHECK_WITHDRAWAL,389600.0,C1590550415
360,409000611074',2018-07-27,FDRL/INTERNAL FUND TRANSFE,0.0,1000000.0,2039366.0,2018,7,27,TRANSFER,1000000.0,C665576141
361,409000611074',2018-07-30,Indfor INCOME INDO REMI27071,2760.0,0.0,2036606.0,2018,7,30,DEBIT,2760.0,C1789550256
362,409000611074',2018-07-30,INDO GIBL Indiaforensic STL27071,457875.0,0.0,1578731.0,2018,7,30,DEBIT,457875.0,C1590550415
363,409000611074',2018-07-30,Indfor INCOME INDO REMI28071,600.0,0.0,1578131.0,2018,7,30,DEBIT,600.0,C1359044626
364,409000611074',2018-07-30,INDO GIBL Indiaforensic STL28071,66800.0,0.0,1511331.0,2018,7,30,PAYEMENT,66800.0,C1531333864
365,409000611074',2018-07-31,Indfor INCOME INDO REMI30071,2280.0,0.0,1509051.0,2018,7,31,PAYEMENT,2280.0,C451111351
366,409000611074',2018-07-31,INDO GIBL Indiaforensic STL30071,341400.0,0.0,1167651.0,2018,7,31,CHECK_WITHDRAWAL,341400.0,C998351292
367,409000611074',2018-07-31,FDRL/INTERNAL FUND TRANSFE,0.0,300000.0,1467651.0,2018,7,31,CASH_IN,300000.0,C1286084959
368,409000611074',2018-08-01,Indfor INCOME INDO REMI31071,2760.0,0.0,1464891.0,2018,8,1,DEBIT,2760.0,C909295153
369,409000611074',2018-08-01,INDO GIBL Indiaforensic STL31071,372350.0,0.0,1092541.0,2018,8,1,DEBIT,372350.0,C240650537
370,409000611074',2018-08-01,FDRL/INTERNAL FUND TRANSFE,0.0,300000.0,1392541.0,2018,8,1,CHECK_CASHING,300000.0,C1318822808
371,409000611074',2018-08-02,Indfor INCOME INDO REMI01081,1080.0,0.0,1391461.0,2018,8,2,DEBIT,1080.0,C392292416
372,409000611074',2018-08-02,INDO GIBL Indiaforensic STL01081,145500.0,0.0,1245961.0,2018,8,2,CHECK_WITHDRAWAL,145500.0,C248609774
373,409000611074',2018-08-02,FDRL/INTERNAL FUND TRANSFE,0.0,300000.0,1545961.0,2018,8,2,CASH_IN,300000.0,C985934102
374,409000611074',2018-08-03,Indfor INCOME INDO REMI02081,840.0,0.0,1545121.0,2018,8,3,DEBIT,840.0,C1170794006
375,409000611074',2018-08-03,INDO GIBL Indiaforensic STL02081,110550.0,0.0,1434571.0,2018,8,3,DEBIT,110550.0,C1590550415
376,409000611074',2018-08-04,Indfor INCOME INDO REMI03081,1200.0,0.0,1433371.0,2018,8,4,DEBIT,1200.0,C1590550415
377,409000611074',2018-08-04,INDO GIBL Indiaforensic STL03081,220801.0,0.0,1212570.0,2018,8,4,CHECK_WITHDRAWAL,220801.0,C1170794006
378,409000611074',2018-08-06,Indfor INCOME INDO REMI04081,1560.0,0.0,1211010.0,2018,8,6,CASH_OUT,1560.0,C747464370
379,409000611074',2018-08-06,INDO GIBL Indiaforensic STL04081,269850.0,0.0,941160.0,2018,8,6,DEBIT,269850.0,C1170794006
380,409000611074',2018-08-06,Indfor INCOME INDO REMI05081,240.0,0.0,940920.0,2018,8,6,CHECK_WITHDRAWAL,240.0,C564160838
381,409000611074',2018-08-06,INDO GIBL Indiaforensic STL05081,17500.0,0.0,923420.0,2018,8,6,CASH_OUT,17500.0,C932583850
382,409000611074',2018-08-07,FDRL/INTERNAL FUND TRANSFE,0.0,500000.0,1423420.0,2018,8,7,TRANSFER,500000.0,C985934102
383,409000611074',2018-08-07,Indfor INCOME INDO REMI06081,3720.0,0.0,1419700.0,2018,8,7,PAYEMENT,3720.0,C248609774
384,409000611074',2018-08-07,INDO GIBL Indiaforensic STL06081,457050.0,0.0,962650.0,2018,8,7,DEBIT,457050.0,C1870252780
385,409000611074',2018-08-07,FDRL/INTERNAL FUND TRANSFE,0.0,300000.0,1262650.0,2018,8,7,TRANSFER,300000.0,M1964434661
386,409000611074',2018-08-07,FDRL/INTERNAL FUND TRANSFE,0.0,300000.0,1562650.0,2018,8,7,CHECK_CASHING,300000.0,M1585571244
387,409000611074',2018-08-08,Indfor INCOME INDO REMI07081,3840.0,0.0,1558810.0,2018,8,8,CHECK_WITHDRAWAL,3840.0,M66724371
388,409000611074',2018-08-08,INDO GIBL Indiaforensic STL07081,662025.0,0.0,896785.0,2018,8,8,PAYEMENT,662025.0,C1286084959
389,409000611074',2018-08-08,FDRL/INTERNAL FUND TRANSFE,0.0,500000.0,1396785.0,2018,8,8,CHECK_CASHING,500000.0,C1688019098
390,409000611074',2018-08-09,Indfor INCOME INDO REMI08081,3480.0,0.0,1393305.0,2018,8,9,DEBIT,3480.0,C2083562754
391,409000611074',2018-08-09,INDO GIBL Indiaforensic STL08081,556450.0,0.0,836855.0,2018,8,9,CHECK_WITHDRAWAL,556450.0,C2001112025
392,409000611074',2018-08-09,FDRL/INTERNAL FUND TRANSFE,0.0,500000.0,1336855.0,2018,8,9,CHECK_CASHING,500000.0,C33524623
393,409000611074',2018-08-10,Indfor INCOME INDO REMI09081,2280.0,0.0,1334575.0,2018,8,10,CASH_OUT,2280.0,C1330106945
394,409000611074',2018-08-10,INDO GIBL Indiaforensic STL09081,336850.0,0.0,997725.0,2018,8,10,DEBIT,336850.0,C1531333864
395,409000611074',2018-08-10,FDRL/INTERNAL FUND TRANSFE,0.0,1000000.0,1997725.0,2018,8,10,CHECK_CASHING,1000000.0,C488044861
396,409000611074',2018-08-13,Indfor INCOME INDO REMI10081,2520.0,0.0,1995205.0,2018,8,13,CHECK_WITHDRAWAL,2520.0,C564160838
397,409000611074',2018-08-13,INDO GIBL Indiaforensic STL10081,351200.0,0.0,1644005.0,2018,8,13,CASH_OUT,351200.0,C909295153
398,409000611074',2018-08-13,Indfor INCOME INDO REMI11081,1320.0,0.0,1642685.0,2018,8,13,CASH_OUT,1320.0,C453211571
399,409000611074',2018-08-13,INDO GIBL Indiaforensic STL11081,200700.0,0.0,1441985.0,2018,8,13,PAYEMENT,200700.0,C401424608
400,409000611074',2018-08-13,Indfor INCOME INDO REMI12081,840.0,0.0,1441145.0,2018,8,13,CASH_OUT,840.0,C401424608
401,409000611074',2018-08-13,INDO GIBL Indiaforensic STL12081,116260.0,0.0,1324885.0,2018,8,13,CHECK_WITHDRAWAL,116260.0,C766572210
402,409000611074',2018-08-14,Indfor INCOME INDO REMI13081,3480.0,0.0,1321405.0,2018,8,14,CHECK_WITHDRAWAL,3480.0,C920011586
403,409000611074',2018-08-14,INDO GIBL Indiaforensic STL13081,517655.0,0.0,803750.0,2018,8,14,DEBIT,517655.0,C1297685781
404,409000611074',2018-08-14,FDRL/INTERNAL FUND TRANSFE,0.0,1000000.0,1803750.0,2018,8,14,TRANSFER,1000000.0,C451111351
405,409000611074',2018-08-16,Indfor INCOME INDO REMI14081,3600.0,0.0,1800150.0,2018,8,16,DEBIT,3600.0,C485041780
406,409000611074',2018-08-16,INDO GIBL Indiaforensic STL14081,561995.0,0.0,1238155.0,2018,8,16,PAYEMENT,561995.0,C1509514333
407,409000611074',2018-08-16,Indfor INCOME INDO REMI15081,1320.0,0.0,1236835.0,2018,8,16,CASH_OUT,1320.0,C601893033
408,409000611074',2018-08-16,INDO GIBL Indiaforensic STL15081,212000.0,0.0,1024835.0,2018,8,16,CASH_OUT,212000.0,C75457651
409,409000611074',2018-08-16,FDRL/INTERNAL FUND TRANSFE,0.0,500000.0,1524835.0,2018,8,16,CHECK_CASHING,500000.0,C985934102
410,409000611074',2018-08-17,Indfor INCOME INDO REMI16081,4440.0,0.0,1520395.0,2018,8,17,PAYEMENT,4440.0,C1749186397
411,409000611074',2018-08-17,INDO GIBL Indiaforensic STL16081,755505.0,0.0,764890.0,2018,8,17,DEBIT,755505.0,C985934102
412,409000611074',2018-08-17,FDRL/INTERNAL FUND TRANSFE,0.0,400000.0,1164890.0,2018,8,17,CASH_IN,400000.0,C575335780
413,409000611074',2018-08-18,Indfor INCOME INDO REMI17081,3960.0,0.0,1160930.0,2018,8,18,CHECK_WITHDRAWAL,3960.0,C1651855867
414,409000611074',2018-08-18,INDO GIBL Indiaforensic STL17081,615328.0,0.0,545602.0,2018,8,18,PAYEMENT,615328.0,C660143728
415,409000611074',2018-08-18,FDRL/INTERNAL FUND TRANSFE,0.0,500000.0,1045602.0,2018,8,18,CHECK_CASHING,500000.0,C100555887
416,409000611074',2018-08-18,FDRL/INTERNAL FUND TRANSFE,0.0,500000.0,1545602.0,2018,8,18,CHECK_CASHING,500000.0,C1100439041
417,409000611074',2018-08-20,Indfor INCOME INDO REMI18081,1920.0,0.0,1543682.0,2018,8,20,DEBIT,1920.0,C357863579
418,409000611074',2018-08-20,INDO GIBL Indiaforensic STL18081,262900.0,0.0,1280782.0,2018,8,20,DEBIT,262900.0,C503195940
419,409000611074',2018-08-20,Indfor INCOME INDO REMI19081,360.0,0.0,1280422.0,2018,8,20,PAYEMENT,360.0,C985934102
420,409000611074',2018-08-20,INDO GIBL Indiaforensic STL19081,18000.0,0.0,1262422.0,2018,8,20,CHECK_WITHDRAWAL,18000.0,C401424608
421,409000611074',2018-08-21,FDRL/INTERNAL FUND TRANSFE,0.0,400000.0,1662422.0,2018,8,21,CASH_IN,400000.0,C1761291320
422,409000611074',2018-08-21,Indfor INCOME INDO REMI20081,4200.0,0.0,1658222.0,2018,8,21,CHECK_WITHDRAWAL,4200.0,C1870252780
423,409000611074',2018-08-21,INDO GIBL Indiaforensic STL20081,554751.0,0.0,1103471.0,2018,8,21,PAYEMENT,554751.0,C564160838
424,409000611074',2018-08-23,FDRL/INTERNAL FUND TRANSFE,0.0,400000.0,1503471.0,2018,8,23,CHECK_CASHING,400000.0,C575335780
425,409000611074',2018-08-23,FDRL/INTERNAL FUND TRANSFE,0.0,400000.0,1903471.0,2018,8,23,CASH_IN,400000.0,C215145189
426,409000611074',2018-08-23,Indfor INCOME INDO REMI21081,5280.0,0.0,1898191.0,2018,8,23,CASH_OUT,5280.0,C1750905143
427,409000611074',2018-08-23,INDO GIBL Indiaforensic STL21081,912000.0,0.0,986191.0,2018,8,23,DEBIT,912000.0,C1282788025
428,409000611074',2018-08-23,Indfor INCOME INDO REMI22081,1800.0,0.0,984391.0,2018,8,23,CHECK_WITHDRAWAL,1800.0,C824009085
429,409000611074',2018-08-23,INDO GIBL Indiaforensic STL22081,335601.0,0.0,648790.0,2018,8,23,CASH_OUT,335601.0,C392292416
430,409000611074',2018-08-23,FDRL/INTERNAL FUND TRANSFE,0.0,400000.0,1048790.0,2018,8,23,TRANSFER,400000.0,C747464370
431,409000611074',2018-08-24,Indfor INCOME INDO REMI23081,2400.0,0.0,1046390.0,2018,8,24,CHECK_WITHDRAWAL,2400.0,C990398217
432,409000611074',2018-08-24,INDO GIBL Indiaforensic STL23081,338131.0,0.0,708259.0,2018,8,24,PAYEMENT,338131.0,C1590550415
433,409000611074',2018-08-24,FDRL/INTERNAL FUND TRANSFE,0.0,400000.0,1108259.0,2018,8,24,CHECK_CASHING,400000.0,C1335050193
434,409000611074',2018-08-24,FDRL/INTERNAL FUND TRANSFE,0.0,400000.0,1508259.0,2018,8,24,CASH_IN,400000.0,C1359044626
435,409000611074',2018-08-27,Indfor INCOME INDO REMI24081,1560.0,0.0,1506699.0,2018,8,27,CHECK_WITHDRAWAL,1560.0,C33524623
436,409000611074',2018-08-27,INDO GIBL Indiaforensic STL24081,230300.0,0.0,1276399.0,2018,8,27,CHECK_WITHDRAWAL,230300.0,C11003494
437,409000611074',2018-08-27,Indfor INCOME INDO REMI25081,720.0,0.0,1275679.0,2018,8,27,CHECK_WITHDRAWAL,720.0,C716157500
438,409000611074',2018-08-27,INDO GIBL Indiaforensic STL25081,71080.0,0.0,1204599.0,2018,8,27,CASH_OUT,71080.0,C1360767589
439,409000611074',2018-08-27,FDRL/INTERNAL FUND TRANSFE,0.0,400000.0,1604599.0,2018,8,27,CASH_IN,400000.0,C1068824137
440,409000611074',2018-08-28,Indfor INCOME INDO REMI27081,4320.0,0.0,1600279.0,2018,8,28,DEBIT,4320.0,C2083117811
441,409000611074',2018-08-28,INDO GIBL Indiaforensic STL27081,518401.0,0.0,1081878.0,2018,8,28,PAYEMENT,518401.0,M1732663543
442,409000611074',2018-08-28,FDRL/INTERNAL FUND TRANSFE,0.0,400000.0,1481878.0,2018,8,28,TRANSFER,400000.0,C985934102
443,409000611074',2018-08-29,Indfor INCOME INDO REMI28081,2160.0,0.0,1479718.0,2018,8,29,CHECK_WITHDRAWAL,2160.0,C1225616405
444,409000611074',2018-08-29,INDO GIBL Indiaforensic STL28081,254584.0,0.0,1225134.0,2018,8,29,DEBIT,254584.0,C1568059495
445,409000611074',2018-08-29,FDRL/INTERNAL FUND TRANSFE,0.0,400000.0,1625134.0,2018,8,29,CHECK_CASHING,400000.0,C564160838
446,409000611074',2018-08-30,Indfor INCOME INDO REMI29081,2760.0,0.0,1622374.0,2018,8,30,CHECK_WITHDRAWAL,2760.0,C1297685781
447,409000611074',2018-08-30,INDO GIBL Indiaforensic STL29081,350585.0,0.0,1271789.0,2018,8,30,CHECK_WITHDRAWAL,350585.0,C985934102
448,409000611074',2018-08-31,Indfor INCOME INDO REMI30081,2280.0,0.0,1269509.0,2018,8,31,CHECK_WITHDRAWAL,2280.0,C195600860
449,409000611074',2018-08-31,INDO GIBL Indiaforensic STL30081,360425.0,0.0,909084.0,2018,8,31,CASH_OUT,360425.0,C736709391
450,409000611074',2018-08-31,FDRL/INTERNAL FUND TRANSFE,0.0,500000.0,1409084.0,2018,8,31,CHECK_CASHING,500000.0,C1170794006
451,409000611074',2018-09-01,Indfor INCOME INDO REMI31081,3000.0,0.0,1406084.0,2018,9,1,CASH_OUT,3000.0,C1023714065
452,409000611074',2018-09-01,INDO WEIZ STL310818,414101.0,0.0,991983.0,2018,9,1,CHECK_WITHDRAWAL,414101.0,C977993101
453,409000611074',2018-09-01,FDRL/INTERNAL FUND TRANSFE,0.0,500000.0,1491983.0,2018,9,1,TRANSFER,500000.0,C1870252780
454,409000611074',2018-09-03,Indfor INCOME INDO REMI01091,1440.0,0.0,1490543.0,2018,9,3,CASH_OUT,1440.0,C665576141
455,409000611074',2018-09-03,INDO GIBL Indiaforensic STL01091,236300.0,0.0,1254243.0,2018,9,3,CASH_OUT,236300.0,C1096283470
456,409000611074',2018-09-03,Indfor INCOME INDO REMI02091,120.0,0.0,1254123.0,2018,9,3,CHECK_WITHDRAWAL,120.0,C1816757085
457,409000611074',2018-09-03,INDO GIBL Indiaforensic STL02091,9800.0,0.0,1244323.0,2018,9,3,CHECK_WITHDRAWAL,9800.0,C1100439041
458,409000611074',2018-09-04,Indfor INCOME INDO REMI03091,1920.0,0.0,1242403.0,2018,9,4,PAYEMENT,1920.0,C85777802
459,409000611074',2018-09-04,INDO GIBL Indiaforensic STL03091,228025.0,0.0,1014378.0,2018,9,4,PAYEMENT,228025.0,C985934102
460,409000611074',2018-09-04,FDRL/INTERNAL FUND TRANSFE,0.0,500000.0,1514378.0,2018,9,4,CHECK_CASHING,500000.0,C564160838
461,409000611074',2018-09-05,Indfor INCOME INDO REMI04091,2880.0,0.0,1511498.0,2018,9,5,CASH_OUT,2880.0,C1531333864
462,409000611074',2018-09-05,INDO WEIZ STL040918,368300.0,0.0,1143198.0,2018,9,5,CHECK_WITHDRAWAL,368300.0,C985934102
463,409000611074',2018-09-06,Indfor INCOME INDO REMI05091,2880.0,0.0,1140318.0,2018,9,6,CASH_OUT,2880.0,C1590550415
464,409000611074',2018-09-06,INDO GIBL Indiaforensic STL05091,406628.0,0.0,733690.0,2018,9,6,DEBIT,406628.0,C1335050193
465,409000611074',2018-09-06,FDRL/INTERNAL FUND TRANSFE,0.0,500000.0,1233690.0,2018,9,6,CASH_IN,500000.0,C1359044626
466,409000611074',2018-09-07,Indfor INCOME INDO REMI06091,2760.0,0.0,1230930.0,2018,9,7,DEBIT,2760.0,C1170794006
467,409000611074',2018-09-07,INDO GIBL Indiaforensic STL06091,377198.0,0.0,853732.0,2018,9,7,DEBIT,377198.0,C1454031203
468,409000611074',2018-09-10,FDRL/INTERNAL FUND TRANSFE,0.0,500000.0,1353732.0,2018,9,10,TRANSFER,500000.0,C1511785794
469,409000611074',2018-09-10,Indfor INCOME INDO REMI07091,3240.0,0.0,1350492.0,2018,9,10,CHECK_WITHDRAWAL,3240.0,C1297685781
470,409000611074',2018-09-10,INDO GIBL Indiaforensic STL07091,441750.0,0.0,908742.0,2018,9,10,DEBIT,441750.0,C215145189
471,409000611074',2018-09-10,Indfor INCOME INDO REMI08091,2040.0,0.0,906702.0,2018,9,10,DEBIT,2040.0,C1286084959
472,409000611074',2018-09-10,INDO GIBL Indiaforensic STL08091,274751.0,0.0,631951.0,2018,9,10,PAYEMENT,274751.0,C451111351
473,409000611074',2018-09-10,Indfor INCOME INDO REMI09091,360.0,0.0,631591.0,2018,9,10,CHECK_WITHDRAWAL,360.0,C1068824137
474,409000611074',2018-09-10,INDO GIBL Indiaforensic STL09091,61600.0,0.0,569991.0,2018,9,10,PAYEMENT,61600.0,C240650537
475,409000611074',2018-09-10,FDRL/INTERNAL FUND TRANSFE,0.0,500000.0,1069991.0,2018,9,10,TRANSFER,500000.0,C766572210
476,409000611074',2018-09-10,FDRL/INTERNAL FUND TRANSFE,0.0,500000.0,1569991.0,2018,9,10,CHECK_CASHING,500000.0,C716157500
477,409000611074',2018-09-11,Indfor INCOME INDO REMI10091,4200.0,0.0,1565791.0,2018,9,11,CASH_OUT,4200.0,C766572210
478,409000611074',2018-09-11,INDO GIBL Indiaforensic STL10091,537776.0,0.0,1028015.0,2018,9,11,DEBIT,537776.0,C1209271652
479,409000611074',2018-09-12,FDRL/INTERNAL FUND TRANSFE,0.0,1000000.0,2028015.0,2018,9,12,CASH_IN,1000000.0,C985934102
480,409000611074',2018-09-12,Indfor INCOME INDO REMI11091,5160.0,0.0,2022855.0,2018,9,12,CHECK_WITHDRAWAL,5160.0,C1023714065
481,409000611074',2018-09-12,INDO GIBL Indiaforensic STL11091,776577.0,0.0,1246278.0,2018,9,12,CHECK_WITHDRAWAL,776577.0,C736709391
482,409000611074',2018-09-14,Indfor INCOME INDO REMI12091,1800.0,0.0,1244478.0,2018,9,14,CHECK_WITHDRAWAL,1800.0,C451111351
483,409000611074',2018-09-14,INDO GIBL Indiaforensic STL12091,252025.0,0.0,992453.0,2018,9,14,PAYEMENT,252025.0,C1789550256
484,409000611074',2018-09-14,Indfor INCOME INDO REMI13091,2520.0,0.0,989933.0,2018,9,14,DEBIT,2520.0,C1509514333
485,409000611074',2018-09-14,INDO GIBL Indiaforensic STL13091,395501.0,0.0,594432.0,2018,9,14,DEBIT,395501.0,C1531333864
486,409000611074',2018-09-14,FDRL/INTERNAL FUND TRANSFE,0.0,1000000.0,1594432.0,2018,9,14,TRANSFER,1000000.0,C575335780
487,409000611074',2018-09-15,Indfor INCOME INDO REMI14091,3720.0,0.0,1590712.0,2018,9,15,CASH_OUT,3720.0,C1854778591
488,409000611074',2018-09-15,INDO GIBL Indiaforensic STL14091,543351.0,0.0,1047361.0,2018,9,15,CASH_OUT,543351.0,C1531333864
489,409000611074',2018-09-17,FDRL/INTERNAL FUND TRANSFE,0.0,500000.0,1547361.0,2018,9,17,CHECK_CASHING,500000.0,C564160838
490,409000611074',2018-09-17,FDRL/INTERNAL FUND TRANSFE,0.0,500000.0,2047361.0,2018,9,17,CHECK_CASHING,500000.0,C459857341
491,409000611074',2018-09-17,Indfor INCOME INDO REMI15091,1200.0,0.0,2046161.0,2018,9,17,DEBIT,1200.0,C1435804085
492,409000611074',2018-09-17,INDO GIBL Indiaforensic STL15091,223150.0,0.0,1823011.0,2018,9,17,DEBIT,223150.0,C757108857
493,409000611074',2018-09-17,Indfor INCOME INDO REMI16091,120.0,0.0,1822891.0,2018,9,17,CASH_OUT,120.0,C1749186397
494,409000611074',2018-09-17,INDO GIBL Indiaforensic STL16091,12500.0,0.0,1810391.0,2018,9,17,CHECK_WITHDRAWAL,12500.0,C1750905143
495,409000611074',2018-09-18,Indfor INCOME INDO REMI17091,3960.0,0.0,1806431.0,2018,9,18,CASH_OUT,3960.0,C33524623
496,409000611074',2018-09-18,INDO GIBL Indiaforensic STL17091,546674.0,0.0,1259757.0,2018,9,18,DEBIT,546674.0,C75457651
497,409000611074',2018-09-19,Indfor INCOME INDO REMI18091,3720.0,0.0,1256037.0,2018,9,19,CHECK_WITHDRAWAL,3720.0,C1860513229
498,409000611074',2018-09-19,INDO GIBL Indiaforensic STL18091,533052.0,0.0,722985.0,2018,9,19,CHECK_WITHDRAWAL,533052.0,C451111351
499,409000611074',2018-09-20,FDRL/INTERNAL FUND TRANSFE,0.0,500000.0,1222985.0,2018,9,20,CHECK_CASHING,500000.0,M1479909053
500,409000611074',2018-09-21,Indfor INCOME INDO REMI19091,2640.0,0.0,1220345.0,2018,9,21,CASH_OUT,2640.0,C811587677
501,409000611074',2018-09-21,INDO GIBL Indiaforensic STL19091,497477.0,0.0,722868.0,2018,9,21,CASH_OUT,497477.0,M733461760
502,409000611074',2018-09-24,FDRL/INTERNAL FUND TRANSFE,0.0,500000.0,1222868.0,2018,9,24,TRANSFER,500000.0,M1323531427
503,409000611074',2018-09-24,FDRL/INTERNAL FUND TRANSFE,0.0,500000.0,1722868.0,2018,9,24,CHECK_CASHING,500000.0,M1400973979
504,409000611074',2018-09-24,Indfor INCOME INDO REMI20091,3120.0,0.0,1719748.0,2018,9,24,CASH_OUT,3120.0,M1105416433
505,409000611074',2018-09-24,INDO GIBL Indiaforensic STL20091,503006.0,0.0,1216742.0,2018,9,24,CASH_OUT,503006.0,M404947798
506,409000611074',2018-09-24,Indfor INCOME INDO REMI21091,1800.0,0.0,1214942.0,2018,9,24,PAYEMENT,1800.0,M1455204443
507,409000611074',2018-09-24,INDO GIBL Indiaforensic STL21091,255052.0,0.0,959890.0,2018,9,24,PAYEMENT,255052.0,M1978209605
508,409000611074',2018-09-24,Indfor INCOME INDO REMI22091,600.0,0.0,959290.0,2018,9,24,CASH_OUT,600.0,M1394356510
509,409000611074',2018-09-24,INDO GIBL Indiaforensic STL22091,78250.0,0.0,881040.0,2018,9,24,PAYEMENT,78250.0,C1971489295
510,409000611074',2018-09-24,Indfor INCOME INDO REMI23091,120.0,0.0,880920.0,2018,9,24,DEBIT,120.0,M1919834117
511,409000611074',2018-09-24,INDO GIBL Indiaforensic STL23091,6250.0,0.0,874670.0,2018,9,24,PAYEMENT,6250.0,C1182461167
512,409000611074',2018-09-24,FDRL/INTERNAL FUND TRANSFE,0.0,500000.0,1374670.0,2018,9,24,TRANSFER,500000.0,M246003654
513,409000611074',2018-09-25,Indfor INCOME INDO REMI24091,2280.0,0.0,1372390.0,2018,9,25,PAYEMENT,2280.0,M248710794
514,409000611074',2018-09-25,INDO GIBL Indiaforensic STL24091,345725.0,0.0,1026665.0,2018,9,25,PAYEMENT,345725.0,M1073741635
515,409000611074',2018-09-26,FDRL/INTERNAL FUND TRANSFE,0.0,500000.0,1526665.0,2018,9,26,TRANSFER,500000.0,C1123629720
516,409000611074',2018-09-26,Indfor INCOME INDO REMI25091,2520.0,0.0,1524145.0,2018,9,26,CHECK_WITHDRAWAL,2520.0,C1032986144
517,409000611074',2018-09-26,INDO GIBL Indiaforensic STL25091,407252.0,0.0,1116893.0,2018,9,26,CASH_OUT,407252.0,C1282788025
518,409000611074',2018-09-27,Indfor INCOME INDO REMI26091,1320.0,0.0,1115573.0,2018,9,27,CASH_OUT,1320.0,C662736689
519,409000611074',2018-09-27,INDO GIBL Indiaforensic STL26091,256050.0,0.0,859523.0,2018,9,27,PAYEMENT,256050.0,M1625090026
520,409000611074',2018-09-28,FDRL/INTERNAL FUND TRANSFE,0.0,500000.0,1359523.0,2018,9,28,CHECK_CASHING,500000.0,M265824587
521,409000611074',2018-09-28,Indfor INCOME INDO REMI27091,2040.0,0.0,1357483.0,2018,9,28,DEBIT,2040.0,M41092582
522,409000611074',2018-09-28,INDO GIBL Indiaforensic STL27091,327001.0,0.0,1030482.0,2018,9,28,PAYEMENT,327001.0,M1345265484
523,409000611074',2018-09-29,Indfor INCOME INDO REMI28091,1920.0,0.0,1028562.0,2018,9,29,PAYEMENT,1920.0,C1360767589
524,409000611074',2018-09-29,INDO GIBL Indiaforensic STL28091,231275.0,0.0,797287.0,2018,9,29,CHECK_WITHDRAWAL,231275.0,M1950800085
525,409000611074',2018-10-01,FDRL/INTERNAL FUND TRANSFE,0.0,500000.0,1297287.0,2018,10,1,CHECK_CASHING,500000.0,M1337829755
526,409000611074',2018-10-01,Indfor INCOME INDO REMI29091,2040.0,0.0,1295247.0,2018,10,1,PAYEMENT,2040.0,C1740000325
527,409000611074',2018-10-01,INDO GIBL Indiaforensic STL29091,333800.0,0.0,961447.0,2018,10,1,DEBIT,333800.0,C2083562754
528,409000611074',2018-10-01,Indfor INCOME INDO REMI30091,120.0,0.0,961327.0,2018,10,1,CASH_OUT,120.0,M314364096
529,409000611074',2018-10-01,INDO GIBL Indiaforensic STL30091,5000.0,0.0,956327.0,2018,10,1,CASH_OUT,5000.0,M1205559205
530,409000611074',2018-10-03,FDRL/INTERNAL FUND TRANSFE,0.0,500000.0,1456327.0,2018,10,3,TRANSFER,500000.0,M1098986569
531,409000611074',2018-10-03,Indfor INCOME INDO REMI01101,3720.0,0.0,1452607.0,2018,10,3,CASH_OUT,3720.0,C1540270363
532,409000611074',2018-10-03,INDO GIBL Indiaforensic STL01101,529105.0,0.0,923502.0,2018,10,3,PAYEMENT,529105.0,M276869158
533,409000611074',2018-10-03,Indfor INCOME INDO REMI02101,1200.0,0.0,922302.0,2018,10,3,PAYEMENT,1200.0,M1527214863
534,409000611074',2018-10-03,INDO GIBL Indiaforensic STL02101,225300.0,0.0,697002.0,2018,10,3,DEBIT,225300.0,M172699023
535,409000611074',2018-10-03,FDRL/INTERNAL FUND TRANSFE,0.0,500000.0,1197002.0,2018,10,3,CASH_IN,500000.0,M1831882653
536,409000611074',2018-10-03,FDRL/INTERNAL FUND TRANSFE,0.0,500000.0,1697002.0,2018,10,3,CASH_IN,500000.0,M1552400354
537,409000611074',2018-10-04,Indfor INCOME INDO REMI03101,3120.0,0.0,1693882.0,2018,10,4,CHECK_WITHDRAWAL,3120.0,M1078566479
538,409000611074',2018-10-04,INDO GIBL Indiaforensic STL03101,545402.0,0.0,1148480.0,2018,10,4,DEBIT,545402.0,M819245704
539,409000611074',2018-10-05,Indfor INCOME INDO REMI04101,1440.0,0.0,1147040.0,2018,10,5,CHECK_WITHDRAWAL,1440.0,M1089584667
540,409000611074',2018-10-05,INDO GIBL Indiaforensic STL04101,156313.0,0.0,990727.0,2018,10,5,PAYEMENT,156313.0,M1865201235
541,409000611074',2018-10-06,Indfor INCOME INDO REMI05101,1320.0,0.0,989407.0,2018,10,6,DEBIT,1320.0,M1493988307
542,409000611074',2018-10-06,INDO GIBL Indiaforensic STL05101,230751.0,0.0,758656.0,2018,10,6,CASH_OUT,230751.0,M1636322481
543,409000611074',2018-10-06,FDRL/INTERNAL FUND TRANSFE,0.0,500000.0,1258656.0,2018,10,6,CASH_IN,500000.0,M1338368149
544,409000611074',2018-10-08,Indfor INCOME INDO REMI07101,480.0,0.0,1258176.0,2018,10,8,CASH_OUT,480.0,M1620459733
545,409000611074',2018-10-08,INDO GIBL Indiaforensic STL07101,56000.0,0.0,1202176.0,2018,10,8,CHECK_WITHDRAWAL,56000.0,M435914790
546,409000611074',2018-10-08,Indfor INCOME INDO REMI06101,2280.0,0.0,1199896.0,2018,10,8,DEBIT,2280.0,M1273958371
547,409000611074',2018-10-08,INDO GIBL Indiaforensic STL06101,282452.0,0.0,917444.0,2018,10,8,PAYEMENT,282452.0,C1629911510
548,409000611074',2018-10-08,FDRL/INTERNAL FUND TRANSFE,0.0,500000.0,1417444.0,2018,10,8,TRANSFER,500000.0,M1433208870
549,409000611074',2018-10-09,Indfor INCOME INDO REMI08101,4080.0,0.0,1413364.0,2018,10,9,PAYEMENT,4080.0,M1437988306
550,409000611074',2018-10-09,INDO GIBL Indiaforensic STL08101,530352.0,0.0,883012.0,2018,10,9,PAYEMENT,530352.0,M1718322084
551,409000611074',2018-10-09,FDRL/INTERNAL FUND TRANSFE,0.0,500000.0,1383012.0,2018,10,9,TRANSFER,500000.0,M251520863
552,409000611074',2018-10-10,Indfor INCOME INDO REMI09101,1920.0,0.0,1381092.0,2018,10,10,CHECK_WITHDRAWAL,1920.0,C33524623
553,409000611074',2018-10-10,INDO GIBL Indiaforensic STL09101,315083.0,0.0,1066009.0,2018,10,10,CHECK_WITHDRAWAL,315083.0,M731243659
554,409000611074',2018-10-11,FDRL/INTERNAL FUND TRANSFE,0.0,500000.0,1566009.0,2018,10,11,CHECK_CASHING,500000.0,M1037955032
555,409000611074',2018-10-11,Indfor INCOME INDO REMI10101,3720.0,0.0,1562289.0,2018,10,11,DEBIT,3720.0,M314562573
556,409000611074',2018-10-11,INDO GIBL Indiaforensic STL10101,584951.0,0.0,977338.0,2018,10,11,CASH_OUT,584951.0,M333693383
557,409000611074',2018-10-12,FDRL/INTERNAL FUND TRANSFE,0.0,500000.0,1477338.0,2018,10,12,CASH_IN,500000.0,C1590550415
558,409000611074',2018-10-12,Indfor INCOME INDO REMI11101,4080.0,0.0,1473258.0,2018,10,12,DEBIT,4080.0,M1819038759
559,409000611074',2018-10-12,INDO GIBL Indiaforensic STL11101,599251.0,0.0,874007.0,2018,10,12,DEBIT,599251.0,C2050019814
560,409000611074',2018-10-15,FDRL/INTERNAL FUND TRANSFE,0.0,500000.0,1374007.0,2018,10,15,TRANSFER,500000.0,M331596257
561,409000611074',2018-10-15,FDRL/INTERNAL FUND TRANSFE,0.0,500000.0,1874007.0,2018,10,15,CASH_IN,500000.0,M509864971
562,409000611074',2018-10-15,Indfor INCOME INDO REMI12101,3840.0,0.0,1870167.0,2018,10,15,CHECK_WITHDRAWAL,3840.0,M911501858
563,409000611074',2018-10-15,INDO GIBL Indiaforensic STL12101,730425.0,0.0,1139742.0,2018,10,15,DEBIT,730425.0,M694069884
564,409000611074',2018-10-15,Indfor INCOME INDO REMI13101,1440.0,0.0,1138302.0,2018,10,15,CASH_OUT,1440.0,M747158012
565,409000611074',2018-10-15,INDO GIBL Indiaforensic STL13101,173350.0,0.0,964952.0,2018,10,15,DEBIT,173350.0,M948675904
566,409000611074',2018-10-15,Indfor INCOME INDO REMI14101,360.0,0.0,964592.0,2018,10,15,CHECK_WITHDRAWAL,360.0,M785271142
567,409000611074',2018-10-15,INDO GIBL Indiaforensic STL14101,34500.0,0.0,930092.0,2018,10,15,DEBIT,34500.0,M2023026843
568,409000611074',2018-10-16,FDRL/INTERNAL FUND TRANSFE,0.0,500000.0,1430092.0,2018,10,16,CASH_IN,500000.0,M1628551735
569,409000611074',2018-10-16,Indfor INCOME INDO REMI15101,5160.0,0.0,1424932.0,2018,10,16,CASH_OUT,5160.0,M606775513
570,409000611074',2018-10-16,INDO GIBL Indiaforensic STL15101,780576.0,0.0,644356.0,2018,10,16,CASH_OUT,780576.0,M935160003
571,409000611074',2018-10-17,FDRL/INTERNAL FUND TRANSFE,0.0,200000.0,844356.0,2018,10,17,TRANSFER,200000.0,M300604602
572,409000611074',2018-10-17,FDRL/INTERNAL FUND TRANSFE,0.0,300000.0,1144356.0,2018,10,17,CASH_IN,300000.0,M453398853
573,409000611074',2018-10-17,FDRL/INTERNAL FUND TRANSFE,0.0,200000.0,1344356.0,2018,10,17,TRANSFER,200000.0,M34073107
574,409000611074',2018-10-17,FDRL/INTERNAL FUND TRANSFE,0.0,300000.0,1644356.0,2018,10,17,CASH_IN,300000.0,M1658512704
575,409000611074',2018-10-17,Indfor INCOME INDO REMI16101,4080.0,0.0,1640276.0,2018,10,17,DEBIT,4080.0,M1699578227
576,409000611074',2018-10-17,INDO GIBL Indiaforensic STL16101,673628.0,0.0,966648.0,2018,10,17,CHECK_WITHDRAWAL,673628.0,M1661777060
577,409000611074',2018-10-17,FDRL/INTERNAL FUND TRANSFE,0.0,500000.0,1466648.0,2018,10,17,TRANSFER,500000.0,M259630944
578,409000611074',2018-10-19,Indfor INCOME INDO REMI17101,1200.0,0.0,1465448.0,2018,10,19,PAYEMENT,1200.0,M316335490
579,409000611074',2018-10-19,INDO GIBL Indiaforensic STL17101,119200.0,0.0,1346248.0,2018,10,19,CASH_OUT,119200.0,M1637613097
580,409000611074',2018-10-19,Indfor INCOME INDO REMI18101,1200.0,0.0,1345048.0,2018,10,19,PAYEMENT,1200.0,M515273883
581,409000611074',2018-10-19,INDO GIBL Indiaforensic STL18101,149802.0,0.0,1195246.0,2018,10,19,CASH_OUT,149802.0,M1535026957
582,409000611074',2018-10-20,Indfor INCOME INDO REMI19101,480.0,0.0,1194766.0,2018,10,20,CHECK_WITHDRAWAL,480.0,M105966264
583,409000611074',2018-10-20,INDO GIBL Indiaforensic STL19101,56000.0,0.0,1138766.0,2018,10,20,DEBIT,56000.0,M505231702
584,409000611074',2018-10-22,Indfor INCOME INDO REMI20101,1200.0,0.0,1137566.0,2018,10,22,DEBIT,1200.0,M1311292881
585,409000611074',2018-10-22,INDO GIBL Indiaforensic STL20101,223600.0,0.0,913966.0,2018,10,22,PAYEMENT,223600.0,M617928649
586,409000611074',2018-10-22,Indfor INCOME INDO REMI21101,120.0,0.0,913846.0,2018,10,22,CASH_OUT,120.0,M79919963
587,409000611074',2018-10-22,INDO GIBL Indiaforensic STL21101,10500.0,0.0,903346.0,2018,10,22,CHECK_WITHDRAWAL,10500.0,M1907604549
588,409000611074',2018-10-22,FDRL/INTERNAL FUND TRANSFE,0.0,500000.0,1403346.0,2018,10,22,CHECK_CASHING,500000.0,M353023213
589,409000611074',2018-10-23,Indfor INCOME INDO REMI22101,2760.0,0.0,1400586.0,2018,10,23,DEBIT,2760.0,C451111351
590,409000611074',2018-10-23,INDO GIBL Indiaforensic STL22101,436678.0,0.0,963908.0,2018,10,23,CASH_OUT,436678.0,M979550238
591,409000611074',2018-10-23,FDRL/INTERNAL FUND TRANSFE,0.0,200000.0,1163908.0,2018,10,23,CHECK_CASHING,200000.0,M1558395480
592,409000611074',2018-10-24,Indfor INCOME INDO REMI23101,2040.0,0.0,1161868.0,2018,10,24,CHECK_WITHDRAWAL,2040.0,M1416415959
593,409000611074',2018-10-24,INDO GIBL Indiaforensic STL23101,432150.0,0.0,729718.0,2018,10,24,CASH_OUT,432150.0,M371397455
594,409000611074',2018-10-24,FDRL/INTERNAL FUND TRANSFE,0.0,500000.0,1229718.0,2018,10,24,TRANSFER,500000.0,C614685048
595,409000611074',2018-10-25,Indfor INCOME INDO REMI24101,1320.0,0.0,1228398.0,2018,10,25,CASH_OUT,1320.0,C434091818
596,409000611074',2018-10-25,INDO GIBL Indiaforensic STL24101,156401.0,0.0,1071997.0,2018,10,25,CASH_OUT,156401.0,C832279283
597,409000611074',2018-10-26,Indfor INCOME INDO REMI25101,1320.0,0.0,1070677.0,2018,10,26,CASH_OUT,1320.0,C985934102
598,409000611074',2018-10-26,INDO GIBL Indiaforensic STL25101,232683.0,0.0,837994.0,2018,10,26,PAYEMENT,232683.0,C1359044626
599,409000611074',2018-10-29,FDRL/INTERNAL FUND TRANSFE,0.0,200000.0,1037994.0,2018,10,29,CASH_IN,200000.0,C838411509
600,409000611074',2018-10-29,FDRL/INTERNAL FUND TRANSFE,0.0,200000.0,1237994.0,2018,10,29,CASH_IN,200000.0,C1359044626
601,409000611074',2018-10-29,FDRL/INTERNAL FUND TRANSFE,0.0,200000.0,1437994.0,2018,10,29,TRANSFER,200000.0,C451111351
602,409000611074',2018-10-29,Indfor INCOME INDO REMI26101,1560.0,0.0,1436434.0,2018,10,29,DEBIT,1560.0,C1262822392
603,409000611074',2018-10-29,INDO GIBL Indiaforensic STL26101,224800.0,0.0,1211634.0,2018,10,29,PAYEMENT,224800.0,C1360767589
604,409000611074',2018-10-29,Indfor INCOME INDO REMI27101,1200.0,0.0,1210434.0,2018,10,29,DEBIT,1200.0,C476800120
605,409000611074',2018-10-29,INDO GIBL Indiaforensic STL27101,254250.0,0.0,956184.0,2018,10,29,CHECK_WITHDRAWAL,254250.0,C1182461167
606,409000611074',2018-10-30,Indfor INCOME INDO REMI29101,3360.0,0.0,952824.0,2018,10,30,CHECK_WITHDRAWAL,3360.0,C476402209
607,409000611074',2018-10-30,INDO GIBL Indiaforensic STL29101,364175.0,0.0,588649.0,2018,10,30,CHECK_WITHDRAWAL,364175.0,C2096057945
608,409000611074',2018-10-30,FDRL/INTERNAL FUND TRANSFE,0.0,200000.0,788649.0,2018,10,30,TRANSFER,200000.0,C1170794006
609,409000611074',2018-10-30,FDRL/INTERNAL FUND TRANSFE,0.0,300000.0,1088649.0,2018,10,30,CASH_IN,300000.0,C564160838
610,409000611074',2018-10-31,Indfor INCOME INDO REMI30101,2520.0,0.0,1086129.0,2018,10,31,CHECK_WITHDRAWAL,2520.0,C1509514333
611,409000611074',2018-10-31,INDO GIBL Indiaforensic STL30101,274602.0,0.0,811527.0,2018,10,31,CASH_OUT,274602.0,C453211571
612,409000611074',2018-10-31,FDRL/INTERNAL FUND TRANSFE,0.0,200000.0,1011527.0,2018,10,31,CASH_IN,200000.0,C1816757085
613,409000611074',2018-10-31,FDRL/INTERNAL FUND TRANSFE,0.0,300000.0,1311527.0,2018,10,31,CASH_IN,300000.0,C766572210
614,409000611074',2018-11-01,Indfor INCOME INDO REMI31101,1920.0,0.0,1309607.0,2018,11,1,DEBIT,1920.0,C1381128261
615,409000611074',2018-11-01,INDO GIBL Indiaforensic STL31101,239305.0,0.0,1070302.0,2018,11,1,DEBIT,239305.0,C1688019098
616,409000611074',2018-11-02,Indfor INCOME INDO REMI01111,1680.0,0.0,1068622.0,2018,11,2,CASH_OUT,1680.0,C1590550415
617,409000611074',2018-11-02,INDO GIBL Indiaforensic STL01111,192675.0,0.0,875947.0,2018,11,2,CHECK_WITHDRAWAL,192675.0,C673068808
618,409000611074',2018-11-03,Indfor INCOME INDO REMI02111,2640.0,0.0,873307.0,2018,11,3,CHECK_WITHDRAWAL,2640.0,C1262822392
619,409000611074',2018-11-03,INDO GIBL Indiaforensic STL02111,369251.0,0.0,504056.0,2018,11,3,DEBIT,369251.0,C1225616405
620,409000611074',2018-11-03,FDRL/INTERNAL FUND TRANSFE,0.0,500000.0,1004056.0,2018,11,3,CASH_IN,500000.0,C1234776885
621,409000611074',2018-11-05,Indfor INCOME INDO REMI03111,2280.0,0.0,1001776.0,2018,11,5,DEBIT,2280.0,C2083562754
622,409000611074',2018-11-05,INDO GIBL Indiaforensic STL03111,323726.0,0.0,678050.0,2018,11,5,DEBIT,323726.0,C1256728724
623,409000611074',2018-11-05,Indfor INCOME INDO REMI04111,840.0,0.0,677210.0,2018,11,5,DEBIT,840.0,C1832580921
624,409000611074',2018-11-05,INDO GIBL Indiaforensic STL04111,129000.0,0.0,548210.0,2018,11,5,CASH_OUT,129000.0,C736709391
625,409000611074',2018-11-05,FDRL/INTERNAL FUND TRANSFE,0.0,500000.0,1048210.0,2018,11,5,TRANSFER,500000.0,C451111351
626,409000611074',2018-11-06,FDRL/INTERNAL FUND TRANSFE,0.0,500000.0,1548210.0,2018,11,6,CASH_IN,500000.0,C1509514333
627,409000611074',2018-11-06,Indfor INCOME INDO REMI05111,4920.0,0.0,1543290.0,2018,11,6,DEBIT,4920.0,C1170794006
628,409000611074',2018-11-06,INDO GIBL Indiaforensic STL05111,807502.0,0.0,735788.0,2018,11,6,DEBIT,807502.0,C1262822392
629,409000611074',2018-11-06,FDRL/INTERNAL FUND TRANSFE,0.0,500000.0,1235788.0,2018,11,6,TRANSFER,500000.0,C766572210
630,409000611074',2018-11-08,FDRL/INTERNAL FUND TRANSFE,0.0,500000.0,1735788.0,2018,11,8,CHECK_CASHING,500000.0,C665576141
631,409000611074',2018-11-09,Indfor INCOME INDO REMI06111,4920.0,0.0,1730868.0,2018,11,9,CHECK_WITHDRAWAL,4920.0,C1359044626
632,409000611074',2018-11-09,INDO GIBL Indiaforensic STL06111,780026.0,0.0,950842.0,2018,11,9,PAYEMENT,780026.0,C33524623
633,409000611074',2018-11-09,Indfor INCOME INDO REMI07111,1320.0,0.0,949522.0,2018,11,9,PAYEMENT,1320.0,C766572210
634,409000611074',2018-11-09,INDO GIBL Indiaforensic STL07111,153513.0,0.0,796009.0,2018,11,9,DEBIT,153513.0,C1262822392
635,409000611074',2018-11-09,Indfor INCOME INDO REMI08111,600.0,0.0,795409.0,2018,11,9,PAYEMENT,600.0,C1749186397
636,409000611074',2018-11-09,INDO GIBL Indiaforensic STL08111,102725.0,0.0,692684.0,2018,11,9,DEBIT,102725.0,C1590550415
637,409000611074',2018-11-09,FDRL/INTERNAL FUND TRANSFE,0.0,500000.0,1192684.0,2018,11,9,CHECK_CASHING,500000.0,C1023714065
638,409000611074',2018-11-12,FDRL/INTERNAL FUND TRANSFE,0.0,200000.0,1392684.0,2018,11,12,CASH_IN,200000.0,C1971489295
639,409000611074',2018-11-12,FDRL/INTERNAL FUND TRANSFE,0.0,200000.0,1592684.0,2018,11,12,CHECK_CASHING,200000.0,C1023714065
640,409000611074',2018-11-12,Indfor INCOME INDO REMI09111,2040.0,0.0,1590644.0,2018,11,12,PAYEMENT,2040.0,C796533847
641,409000611074',2018-11-12,INDO GIBL Indiaforensic STL09111,478599.0,0.0,1112045.0,2018,11,12,PAYEMENT,478599.0,C146305349
642,409000611074',2018-11-12,Indfor INCOME INDO REMI11111,120.0,0.0,1111925.0,2018,11,12,CASH_OUT,120.0,C1286084959
643,409000611074',2018-11-12,INDO GIBL Indiaforensic STL11111,8000.0,0.0,1103925.0,2018,11,12,DEBIT,8000.0,C1740000325
644,409000611074',2018-11-12,Indfor INCOME INDO REMI10111,2040.0,0.0,1101885.0,2018,11,12,DEBIT,2040.0,C932583850
645,409000611074',2018-11-12,INDO GIBL Indiaforensic STL10111,284926.0,0.0,816959.0,2018,11,12,DEBIT,284926.0,C33524623
646,409000611074',2018-11-12,FDRL/INTERNAL FUND TRANSFE,0.0,200000.0,1016959.0,2018,11,12,CASH_IN,200000.0,C747464370
647,409000611074',2018-11-13,Indfor INCOME INDO REMI12111,2280.0,0.0,1014679.0,2018,11,13,PAYEMENT,2280.0,C22805895
648,409000611074',2018-11-13,INDO GIBL Indiaforensic STL12111,354000.0,0.0,660679.0,2018,11,13,CHECK_WITHDRAWAL,354000.0,C564160838
649,409000611074',2018-11-13,FDRL/INTERNAL FUND TRANSFE,0.0,200000.0,860679.0,2018,11,13,CASH_IN,200000.0,C2083562754
650,409000611074',2018-11-13,FDRL/INTERNAL FUND TRANSFE,0.0,300000.0,1160679.0,2018,11,13,TRANSFER,300000.0,C1023714065
651,409000611074',2018-11-14,FDRL/INTERNAL FUND TRANSFE,0.0,300000.0,1460679.0,2018,11,14,CHECK_CASHING,300000.0,C288665596
652,409000611074',2018-11-14,FDRL/INTERNAL FUND TRANSFE,0.0,200000.0,1660679.0,2018,11,14,CASH_IN,200000.0,C1740000325
653,409000611074',2018-11-14,Indfor INCOME INDO REMI13111,4080.0,0.0,1656599.0,2018,11,14,CASH_OUT,4080.0,C97730845
654,409000611074',2018-11-14,INDO GIBL Indiaforensic STL13111,800876.0,0.0,855723.0,2018,11,14,PAYEMENT,800876.0,C747464370
655,409000611074',2018-11-15,FDRL/INTERNAL FUND TRANSFE,0.0,300000.0,1155723.0,2018,11,15,CASH_IN,300000.0,C1971489295
656,409000611074',2018-11-15,Indfor INCOME INDO REMI14111,2160.0,0.0,1153563.0,2018,11,15,DEBIT,2160.0,C1883840933
657,409000611074',2018-11-15,INDO GIBL Indiaforensic STL14111,404700.0,0.0,748863.0,2018,11,15,DEBIT,404700.0,C20671747
658,409000611074',2018-11-15,FDRL/INTERNAL FUND TRANSFE,0.0,300000.0,1048863.0,2018,11,15,TRANSFER,300000.0,C1789550256
659,409000611074',2018-11-16,Indfor INCOME INDO REMI15111,3000.0,0.0,1045863.0,2018,11,16,PAYEMENT,3000.0,C1286084959
660,409000611074',2018-11-16,INDO GIBL Indiaforensic STL15111,580226.0,0.0,465637.0,2018,11,16,CASH_OUT,580226.0,C1749186397
661,409000611074',2018-11-16,FDRL/INTERNAL FUND TRANSFE,0.0,500000.0,965637.0,2018,11,16,CASH_IN,500000.0,C1789550256
662,409000611074',2018-11-17,FDRL/INTERNAL FUND TRANSFE,0.0,300000.0,1265637.0,2018,11,17,CHECK_CASHING,300000.0,C1816757085
663,409000611074',2018-11-17,Indfor INCOME INDO REMI16111,3000.0,0.0,1262637.0,2018,11,17,DEBIT,3000.0,M365056339
664,409000611074',2018-11-17,INDO GIBL Indiaforensic STL16111,583076.0,0.0,679561.0,2018,11,17,PAYEMENT,583076.0,M166536076
665,409000611074',2018-11-17,FDRL/INTERNAL FUND TRANSFE,0.0,400000.0,1079561.0,2018,11,17,CASH_IN,400000.0,C1023714065
666,409000611074',2018-11-17,FDRL/INTERNAL FUND TRANSFE,0.0,400000.0,1479561.0,2018,11,17,CASH_IN,400000.0,C33524623
667,409000611074',2018-11-19,Indfor INCOME INDO REMI18111,360.0,0.0,1479201.0,2018,11,19,CHECK_WITHDRAWAL,360.0,M912747546
668,409000611074',2018-11-19,INDO GIBL Indiaforensic STL18111,59700.0,0.0,1419501.0,2018,11,19,CASH_OUT,59700.0,M1292472219
669,409000611074',2018-11-19,Indfor INCOME INDO REMI17111,1320.0,0.0,1418181.0,2018,11,19,DEBIT,1320.0,C20671747
670,409000611074',2018-11-19,INDO GIBL Indiaforensic STL17111,207463.0,0.0,1210718.0,2018,11,19,DEBIT,207463.0,C240650537
671,409000611074',2018-11-20,FDRL/INTERNAL FUND TRANSFE,0.0,300000.0,1510718.0,2018,11,20,TRANSFER,300000.0,M2117099736
672,409000611074',2018-11-20,Indfor INCOME INDO REMI19111,3600.0,0.0,1507118.0,2018,11,20,PAYEMENT,3600.0,C1321640594
673,409000611074',2018-11-20,INDO GIBL Indiaforensic STL19111,613175.0,0.0,893943.0,2018,11,20,CASH_OUT,613175.0,M2070160397
674,409000611074',2018-11-20,FDRL/INTERNAL FUND TRANSFE,0.0,400000.0,1293943.0,2018,11,20,CHECK_CASHING,400000.0,M1205580258
675,409000611074',2018-11-22,FDRL/INTERNAL FUND TRANSFE,0.0,400000.0,1693943.0,2018,11,22,TRANSFER,400000.0,M777313177
676,409000611074',2018-11-22,Indfor INCOME INDO REMI20111,3960.0,0.0,1689983.0,2018,11,22,PAYEMENT,3960.0,M1327895505
677,409000611074',2018-11-22,INDO GIBL Indiaforensic STL20111,628403.0,0.0,1061580.0,2018,11,22,CASH_OUT,628403.0,M1705277839
678,409000611074',2018-11-22,Indfor INCOME INDO REMI21111,1800.0,0.0,1059780.0,2018,11,22,DEBIT,1800.0,M142099757
679,409000611074',2018-11-22,INDO GIBL Indiaforensic STL21111,250951.0,0.0,808829.0,2018,11,22,CASH_OUT,250951.0,M80026551
680,409000611074',2018-11-22,FDRL/INTERNAL FUND TRANSFE,0.0,300000.0,1108829.0,2018,11,22,CHECK_CASHING,300000.0,C1848415041
681,409000611074',2018-11-22,FDRL/INTERNAL FUND TRANSFE,0.0,300000.0,1408829.0,2018,11,22,TRANSFER,300000.0,C339924917
682,409000611074',2018-11-23,FDRL/INTERNAL FUND TRANSFE,0.0,400000.0,1808829.0,2018,11,23,TRANSFER,400000.0,M2000469839
683,409000611074',2018-11-26,Indfor INCOME INDO REMI25111,480.0,0.0,1808349.0,2018,11,26,CHECK_WITHDRAWAL,480.0,C1825027294
684,409000611074',2018-11-26,INDO GIBL Indiaforensic STL25111,63600.0,0.0,1744749.0,2018,11,26,CASH_OUT,63600.0,M2100572327
685,409000611074',2018-11-26,Indfor INCOME INDO REMI24111,360.0,0.0,1744389.0,2018,11,26,CASH_OUT,360.0,M659996839
686,409000611074',2018-11-26,INDO GIBL Indiaforensic STL24111,49700.0,0.0,1694689.0,2018,11,26,PAYEMENT,49700.0,C1531333864
687,409000611074',2018-11-26,Indfor INCOME INDO REMI23111,1560.0,0.0,1693129.0,2018,11,26,CASH_OUT,1560.0,C1234776885
688,409000611074',2018-11-26,INDO GIBL Indiaforensic STL23111,220402.0,0.0,1472727.0,2018,11,26,PAYEMENT,220402.0,C1590550415
689,409000611074',2018-11-26,Indfor INCOME INDO REMI22111,2280.0,0.0,1470447.0,2018,11,26,PAYEMENT,2280.0,C1629911510
690,409000611074',2018-11-26,INDO GIBL Indiaforensic STL22111,334100.0,0.0,1136347.0,2018,11,26,CASH_OUT,334100.0,C297927961
691,409000611074',2018-11-26,FDRL/INTERNAL FUND TRANSFE,0.0,400000.0,1536347.0,2018,11,26,CHECK_CASHING,400000.0,C1023714065
692,409000611074',2018-11-27,Indfor INCOME INDO REMI26111,4440.0,0.0,1531907.0,2018,11,27,DEBIT,4440.0,C1740000325
693,409000611074',2018-11-27,INDO GIBL Indiaforensic STL26111,615817.0,0.0,916090.0,2018,11,27,DEBIT,615817.0,C1789550256
694,409000611074',2018-11-27,FDRL/INTERNAL FUND TRANSFE,0.0,300000.0,1216090.0,2018,11,27,CHECK_CASHING,300000.0,C33524623
695,409000611074',2018-11-27,FDRL/INTERNAL FUND TRANSFE,0.0,400000.0,1616090.0,2018,11,27,TRANSFER,400000.0,C1234776885
696,409000611074',2018-11-28,Indfor INCOME INDO REMI27111,2760.0,0.0,1613330.0,2018,11,28,CHECK_WITHDRAWAL,2760.0,C1810132623
697,409000611074',2018-11-28,INDO GIBL Indiaforensic STL27111,508126.0,0.0,1105204.0,2018,11,28,PAYEMENT,508126.0,C1789550256
698,409000611074',2018-11-28,FDRL/INTERNAL FUND TRANSFE,0.0,400000.0,1505204.0,2018,11,28,TRANSFER,400000.0,C1318822808
699,409000611074',2018-11-29,Indfor INCOME INDO REMI28111,2160.0,0.0,1503044.0,2018,11,29,DEBIT,2160.0,C1789550256
700,409000611074',2018-11-29,INDO GIBL Indiaforensic STL28111,326783.0,0.0,1176261.0,2018,11,29,PAYEMENT,326783.0,C1983025922
701,409000611074',2018-11-30,Indfor INCOME INDO REMI29111,1800.0,0.0,1174461.0,2018,11,30,CASH_OUT,1800.0,C1286084959
702,409000611074',2018-11-30,INDO GIBL Indiaforensic STL29111,247700.0,0.0,926761.0,2018,11,30,CASH_OUT,247700.0,C33524623
703,409000611074',2018-11-30,FDRL/INTERNAL FUND TRANSFE,0.0,400000.0,1326761.0,2018,11,30,TRANSFER,400000.0,C1234776885
704,409000611074',2018-12-01,Indfor INCOME INDO REMI30111,3360.0,0.0,1323401.0,2018,12,1,CASH_OUT,3360.0,C1568059495
705,409000611074',2018-12-01,INDO GIBL Indiaforensic STL30111,510703.0,0.0,812698.0,2018,12,1,CHECK_WITHDRAWAL,510703.0,C1816757085
706,409000611074',2018-12-01,FDRL/INTERNAL FUND TRANSFE,0.0,400000.0,1212698.0,2018,12,1,TRANSFER,400000.0,C824208363
707,409000611074',2018-12-03,Indfor INCOME INDO REMI02121,120.0,0.0,1212578.0,2018,12,3,DEBIT,120.0,C1122805102
708,409000611074',2018-12-03,INDO GIBL Indiaforensic STL02121,5000.0,0.0,1207578.0,2018,12,3,DEBIT,5000.0,C2083562754
709,409000611074',2018-12-03,Indfor INCOME INDO REMI01121,840.0,0.0,1206738.0,2018,12,3,DEBIT,840.0,C985934102
710,409000611074',2018-12-03,INDO GIBL Indiaforensic STL01121,135500.0,0.0,1071238.0,2018,12,3,CASH_OUT,135500.0,M1367672657
711,409000611074',2018-12-03,FDRL/INTERNAL FUND TRANSFE,0.0,500000.0,1571238.0,2018,12,3,TRANSFER,500000.0,C998351292
712,409000611074',2018-12-04,Indfor INCOME INDO REMI03121,1560.0,0.0,1569678.0,2018,12,4,PAYEMENT,1560.0,M2002790740
713,409000611074',2018-12-04,INDO GIBL Indiaforensic STL03121,244750.0,0.0,1324928.0,2018,12,4,PAYEMENT,244750.0,M742255664
714,409000611074',2018-12-05,Indfor INCOME INDO REMI04121,1920.0,0.0,1323008.0,2018,12,5,DEBIT,1920.0,M1115013644
715,409000611074',2018-12-05,INDO GIBL Indiaforensic STL04121,233851.0,0.0,1089157.0,2018,12,5,CHECK_WITHDRAWAL,233851.0,M1070194629
716,409000611074',2018-12-06,FDRL/INTERNAL FUND TRANSFE,0.0,500000.0,1589157.0,2018,12,6,CASH_IN,500000.0,C306206744
717,409000611074',2018-12-06,Indfor INCOME INDO REMI05121,2760.0,0.0,1586397.0,2018,12,6,CASH_OUT,2760.0,C885951223
718,409000611074',2018-12-06,INDO GIBL Indiaforensic STL05121,437150.0,0.0,1149247.0,2018,12,6,DEBIT,437150.0,M385332399
719,409000611074',2018-12-07,Indfor INCOME INDO REMI06121,2640.0,0.0,1146607.0,2018,12,7,DEBIT,2640.0,M883020319
720,409000611074',2018-12-07,INDO GIBL Indiaforensic STL06121,397925.0,0.0,748682.0,2018,12,7,PAYEMENT,397925.0,M1942356772
721,409000611074',2018-12-07,FDRL/INTERNAL FUND TRANSFE,0.0,500000.0,1248682.0,2018,12,7,CHECK_CASHING,500000.0,C1971489295
722,409000611074',2018-12-07,FDRL/INTERNAL FUND TRANSFE,0.0,500000.0,1748682.0,2018,12,7,CHECK_CASHING,500000.0,M1863100050
723,409000611074',2018-12-10,Indfor INCOME INDO REMI07121,1680.0,0.0,1747002.0,2018,12,10,CHECK_WITHDRAWAL,1680.0,C306206744
724,409000611074',2018-12-10,INDO GIBL Indiaforensic STL07121,228177.0,0.0,1518825.0,2018,12,10,DEBIT,228177.0,C667346055
725,409000611074',2018-12-10,Indfor INCOME INDO REMI08121,2160.0,0.0,1516665.0,2018,12,10,PAYEMENT,2160.0,M1155757579
726,409000611074',2018-12-10,INDO GIBL Indiaforensic STL08121,240752.0,0.0,1275913.0,2018,12,10,CHECK_WITHDRAWAL,240752.0,M1482748887
727,409000611074',2018-12-10,Indfor INCOME INDO REMI09121,360.0,0.0,1275553.0,2018,12,10,CHECK_WITHDRAWAL,360.0,M1123226989
728,409000611074',2018-12-10,INDO GIBL Indiaforensic STL09121,48000.0,0.0,1227553.0,2018,12,10,CHECK_WITHDRAWAL,48000.0,M1115381650
729,409000611074',2018-12-11,FDRL/INTERNAL FUND TRANSFE,0.0,500000.0,1727553.0,2018,12,11,TRANSFER,500000.0,M2118096382
730,409000611074',2018-12-11,Indfor INCOME INDO REMI10121,4560.0,0.0,1722993.0,2018,12,11,CASH_OUT,4560.0,M746394140
731,409000611074',2018-12-11,INDO GIBL Indiaforensic STL10121,776851.0,0.0,946142.0,2018,12,11,PAYEMENT,776851.0,M1731763384
732,409000611074',2018-12-12,FDRL/INTERNAL FUND TRANSFE,0.0,500000.0,1446142.0,2018,12,12,CHECK_CASHING,500000.0,M87242619
733,409000611074',2018-12-12,Indfor INCOME INDO REMI11121,3360.0,0.0,1442782.0,2018,12,12,CASH_OUT,3360.0,M285074186
734,409000611074',2018-12-12,INDO GIBL Indiaforensic STL11121,358750.0,0.0,1084032.0,2018,12,12,DEBIT,358750.0,M484841769
735,409000611074',2018-12-12,FDRL/INTERNAL FUND TRANSFE,0.0,500000.0,1584032.0,2018,12,12,TRANSFER,500000.0,M1274247563
736,409000611074',2018-12-13,Indfor INCOME INDO REMI12121,3360.0,0.0,1580672.0,2018,12,13,CASH_OUT,3360.0,M1961129028
737,409000611074',2018-12-13,INDO GIBL Indiaforensic STL12121,596375.0,0.0,984297.0,2018,12,13,PAYEMENT,596375.0,M1506938939
738,409000611074',2018-12-13,FDRL/INTERNAL FUND TRANSFE,0.0,500000.0,1484297.0,2018,12,13,CHECK_CASHING,500000.0,M1850597787
739,409000611074',2018-12-14,Indfor INCOME INDO REMI13121,2880.0,0.0,1481417.0,2018,12,14,CHECK_WITHDRAWAL,2880.0,M1190566357
740,409000611074',2018-12-14,INDO GIBL Indiaforensic STL13121,419450.0,0.0,1061967.0,2018,12,14,CASH_OUT,419450.0,M428996455
741,409000611074',2018-12-14,FDRL/INTERNAL FUND TRANSFE,0.0,500000.0,1561967.0,2018,12,14,TRANSFER,500000.0,M80141040
742,409000611074',2018-12-15,Indfor INCOME INDO REMI14121,2400.0,0.0,1559567.0,2018,12,15,PAYEMENT,2400.0,M106557175
743,409000611074',2018-12-15,INDO GIBL Indiaforensic STL14121,423385.0,0.0,1136182.0,2018,12,15,DEBIT,423385.0,M612937843
744,409000611074',2018-12-17,FDRL/INTERNAL FUND TRANSFE,0.0,400000.0,1536182.0,2018,12,17,CASH_IN,400000.0,M1433956626
745,409000611074',2018-12-17,FDRL/INTERNAL FUND TRANSFE,0.0,400000.0,1936182.0,2018,12,17,CASH_IN,400000.0,M2109219177
746,409000611074',2018-12-17,Indfor INCOME INDO REMI16121,360.0,0.0,1935822.0,2018,12,17,CHECK_WITHDRAWAL,360.0,M259319861
747,409000611074',2018-12-17,INDO GIBL Indiaforensic STL16121,33549.0,0.0,1902273.0,2018,12,17,CHECK_WITHDRAWAL,33549.0,M1059634518
748,409000611074',2018-12-17,Indfor INCOME INDO REMI15121,1680.0,0.0,1900593.0,2018,12,17,PAYEMENT,1680.0,M436094532
749,409000611074',2018-12-17,INDO GIBL Indiaforensic STL15121,288851.0,0.0,1611742.0,2018,12,17,CASH_OUT,288851.0,M1541433310
750,409000611074',2018-12-18,Indfor INCOME INDO REMI17121,4440.0,0.0,1607302.0,2018,12,18,CASH_OUT,4440.0,M405036720
751,409000611074',2018-12-18,INDO GIBL Indiaforensic STL17121,662777.0,0.0,944525.0,2018,12,18,DEBIT,662777.0,M620456576
752,409000611074',2018-12-18,FDRL/INTERNAL FUND TRANSFE,0.0,500000.0,1444525.0,2018,12,18,CHECK_CASHING,500000.0,M1923634801
753,409000611074',2018-12-19,Indfor INCOME INDO REMI18121,3480.0,0.0,1441045.0,2018,12,19,CASH_OUT,3480.0,M418513504
754,409000611074',2018-12-19,INDO GIBL Indiaforensic STL18121,616950.0,0.0,824095.0,2018,12,19,CASH_OUT,616950.0,C665576141
755,409000611074',2018-12-19,FDRL/INTERNAL FUND TRANSFE,0.0,400000.0,1224095.0,2018,12,19,TRANSFER,400000.0,M188791662
756,409000611074',2018-12-20,Indfor INCOME INDO REMI19121,3120.0,0.0,1220975.0,2018,12,20,CASH_OUT,3120.0,M1347016882
757,409000611074',2018-12-20,INDO GIBL Indiaforensic STL19121,428150.0,0.0,792825.0,2018,12,20,CASH_OUT,428150.0,M1662912171
758,409000611074',2018-12-20,FDRL/INTERNAL FUND TRANSFE,0.0,500000.0,1292825.0,2018,12,20,TRANSFER,500000.0,M883380345
759,409000611074',2018-12-21,Indfor INCOME INDO REMI20121,2640.0,0.0,1290185.0,2018,12,21,CASH_OUT,2640.0,M276748028
760,409000611074',2018-12-21,INDO GIBL Indiaforensic STL20121,425752.0,0.0,864433.0,2018,12,21,PAYEMENT,425752.0,C1568059495
761,409000611074',2018-12-21,FDRL/INTERNAL FUND TRANSFE,0.0,500000.0,1364433.0,2018,12,21,CHECK_CASHING,500000.0,M771923297
762,409000611074',2018-12-24,Indfor INCOME INDO REMI23121,120.0,0.0,1364313.0,2018,12,24,DEBIT,120.0,C1335050193
763,409000611074',2018-12-24,INDO GIBL Indiaforensic STL23121,20000.0,0.0,1344313.0,2018,12,24,PAYEMENT,20000.0,M321772459
764,409000611074',2018-12-24,Indfor INCOME INDO REMI22121,960.0,0.0,1343353.0,2018,12,24,DEBIT,960.0,M181078353
765,409000611074',2018-12-24,INDO GIBL Indiaforensic STL22121,130600.0,0.0,1212753.0,2018,12,24,DEBIT,130600.0,M645875534
766,409000611074',2018-12-24,Indfor INCOME INDO REMI21121,2760.0,0.0,1209993.0,2018,12,24,DEBIT,2760.0,M673672784
767,409000611074',2018-12-24,INDO GIBL Indiaforensic STL21121,422577.0,0.0,787416.0,2018,12,24,DEBIT,422577.0,M1056862342
768,409000611074',2018-12-24,FDRL/INTERNAL FUND TRANSFE,0.0,500000.0,1287416.0,2018,12,24,CHECK_CASHING,500000.0,C832279283
769,409000611074',2018-12-24,FDRL/INTERNAL FUND TRANSFE,0.0,400000.0,1687416.0,2018,12,24,CASH_IN,400000.0,C1789550256
770,409000611074',2018-12-26,Indfor INCOME INDO REMI25121,1320.0,0.0,1686096.0,2018,12,26,CASH_OUT,1320.0,M1667534569
771,409000611074',2018-12-26,INDO GIBL Indiaforensic STL25121,173441.0,0.0,1512655.0,2018,12,26,DEBIT,173441.0,M1170111701
772,409000611074',2018-12-26,Indfor INCOME INDO REMI24121,4680.0,0.0,1507975.0,2018,12,26,PAYEMENT,4680.0,M830863979
773,409000611074',2018-12-26,INDO GIBL Indiaforensic STL24121,692917.0,0.0,815058.0,2018,12,26,PAYEMENT,692917.0,C1335050193
774,409000611074',2018-12-26,FDRL/INTERNAL FUND TRANSFE,0.0,500000.0,1315058.0,2018,12,26,TRANSFER,500000.0,M620423816
775,409000611074',2018-12-27,Indfor INCOME INDO REMI26121,1320.0,0.0,1313738.0,2018,12,27,CASH_OUT,1320.0,M1690233783
776,409000611074',2018-12-27,INDO GIBL Indiaforensic STL26121,250849.0,0.0,1062889.0,2018,12,27,DEBIT,250849.0,C932583850
777,409000611074',2018-12-27,FDRL/INTERNAL FUND TRANSFE,0.0,500000.0,1562889.0,2018,12,27,CASH_IN,500000.0,M553672556
778,409000611074',2018-12-28,Indfor INCOME INDO REMI27121,4080.0,0.0,1558809.0,2018,12,28,DEBIT,4080.0,M1415439780
779,409000611074',2018-12-28,INDO GIBL Indiaforensic STL27121,625478.0,0.0,933331.0,2018,12,28,PAYEMENT,625478.0,M179808568
780,409000611074',2018-12-28,FDRL/INTERNAL FUND TRANSFE,0.0,400000.0,1333331.0,2018,12,28,CHECK_CASHING,400000.0,M73698537
781,409000611074',2018-12-29,Indfor INCOME INDO REMI28121,1320.0,0.0,1332011.0,2018,12,29,CHECK_WITHDRAWAL,1320.0,C997608398
782,409000611074',2018-12-29,INDO GIBL Indiaforensic STL28121,153500.0,0.0,1178511.0,2018,12,29,PAYEMENT,153500.0,M659059448
783,409000611074',2018-12-29,FDRL/INTERNAL FUND TRANSFE,0.0,400000.0,1578511.0,2018,12,29,CASH_IN,400000.0,M246826139
784,409000611074',2018-12-31,Indfor INCOME INDO REMI30121,240.0,0.0,1578271.0,2018,12,31,CHECK_WITHDRAWAL,240.0,M403598020
785,409000611074',2018-12-31,INDO GIBL Indiaforensic STL30121,68700.0,0.0,1509571.0,2018,12,31,CHECK_WITHDRAWAL,68700.0,C1122805102
786,409000611074',2018-12-31,Indfor INCOME INDO REMI29121,1200.0,0.0,1508371.0,2018,12,31,CHECK_WITHDRAWAL,1200.0,M708443754
787,409000611074',2018-12-31,INDO GIBL Indiaforensic STL29121,200550.0,0.0,1307821.0,2018,12,31,DEBIT,200550.0,M832145584
788,409000611074',2018-12-31,FDRL/INTERNAL FUND TRANSFE,0.0,400000.0,1707821.0,2018,12,31,CASH_IN,400000.0,M1752535057
789,409000493201',2018-01-01,BBPS SETMNT FOR DT 010120,199758.22,0.0,914559.209999999,2018,1,1,CASH_OUT,199758.22,C1466073198
790,409000493201',2018-01-02,BBPS SETMNT FOR DT 020120,61493.58,0.0,853065.6299999991,2018,1,2,PAYEMENT,61493.58,C1526298704
791,409000493201',2018-01-02,FDRL/INTERNAL FUND TRANSFE,0.0,200000.0,1053065.629999999,2018,1,2,TRANSFER,200000.0,C1740000325
792,409000493201',2018-01-02,FDRL/INTERNAL FUND TRANSFE,0.0,200000.0,1253065.629999999,2018,1,2,TRANSFER,200000.0,C380242442
793,409000493201',2018-01-03,BBPS SETMNT FOR DT 030120,131874.52,0.0,1121191.1099999992,2018,1,3,DEBIT,131874.52,C660143728
794,409000493201',2018-01-04,BBPS SETMNT FOR DT 040120,107971.83,0.0,1013219.2799999992,2018,1,4,DEBIT,107971.83,C1789550256
795,409000493201',2018-01-05,BBPS SETMNT FOR DT 050120,119145.09,0.0,894074.189999999,2018,1,5,CASH_OUT,119145.09,C392292416
796,409000493201',2018-01-06,BBPS SETMNT FOR DT 060120,115908.12,0.0,778166.069999999,2018,1,6,CHECK_WITHDRAWAL,115908.12,C1291286504
797,409000493201',2018-01-08,BBPS SETMNT FOR DT 080120,174434.5,0.0,603731.569999999,2018,1,8,DEBIT,174434.5,C665576141
798,409000493201',2018-01-08,FDRL/INTERNAL FUND TRANSFE,0.0,200000.0,803731.569999999,2018,1,8,CHECK_CASHING,200000.0,C1590550415
799,409000493201',2018-01-08,FDRL/INTERNAL FUND TRANSFE,0.0,200000.0,1003731.569999999,2018,1,8,CHECK_CASHING,200000.0,C306206744
800,409000493201',2018-01-09,BBPS SETMNT FOR DT 090012,165694.99,0.0,838036.579999999,2018,1,9,CHECK_WITHDRAWAL,165694.99,C1590550415
801,409000493201',2018-01-10,BBPS SETMNT FOR DT 100120,187584.02,0.0,650452.559999999,2018,1,10,DEBIT,187584.02,C306206744
802,409000493201',2018-01-11,BBPS SETMNT FOR DT 110120,124081.29,0.0,526371.269999999,2018,1,11,CHECK_WITHDRAWAL,124081.29,C248609774
803,409000493201',2018-01-12,BBPS SETMNT FOR DT 120120,175473.28,0.0,350897.9899999989,2018,1,12,PAYEMENT,175473.28,C1286084959
804,409000493201',2018-01-12,FDRL/INTERNAL FUND TRANSFE,0.0,300000.0,650897.989999999,2018,1,12,CHECK_CASHING,300000.0,C564160838
805,409000493201',2018-01-12,FDRL/INTERNAL FUND TRANSFE,0.0,300000.0,950897.9899999992,2018,1,12,TRANSFER,300000.0,C1259769769
806,409000493201',2018-01-15,BBPS SETMNT FOR DT 150120,239083.95,0.0,711814.0399999989,2018,1,15,CHECK_WITHDRAWAL,239083.95,M1971152916
807,409000493201',2018-01-16,BBPS SETMNT FOR DT 160120,199639.98,0.0,512174.0599999989,2018,1,16,PAYEMENT,199639.98,C997608398
808,409000493201',2018-01-17,BBPS SETMNT FOR DT 170120,184162.48,0.0,328011.5799999989,2018,1,17,CHECK_WITHDRAWAL,184162.48,M1276544608
809,409000493201',2018-01-17,FDRL/INTERNAL FUND TRANSFE,0.0,300000.0,628011.5799999989,2018,1,17,CASH_IN,300000.0,M265348534
810,409000493201',2018-01-18,BBPS SETMNT FOR DT 180120,164097.27,0.0,463914.3099999989,2018,1,18,CASH_OUT,164097.27,M917568725
811,409000493201',2018-01-19,BBPS SETMNT FOR DT 190120,160649.42,0.0,303264.88999999885,2018,1,19,CASH_OUT,160649.42,C13329486
812,409000493201',2018-01-19,FDRL/INTERNAL FUND TRANSFE,0.0,200000.0,503264.8899999989,2018,1,19,CASH_IN,200000.0,C1262822392
813,409000493201',2018-01-19,FDRL/INTERNAL FUND TRANSFE,0.0,300000.0,803264.8899999987,2018,1,19,CHECK_CASHING,300000.0,M1380044647
814,409000493201',2018-01-20,BBPS SETMNT FOR DT 200120,193939.03,0.0,609325.8599999988,2018,1,20,CHECK_WITHDRAWAL,193939.03,M1998137093
815,409000493201',2018-01-22,BBPS SETMNT FOR DT 220120,153880.37,0.0,455445.4899999988,2018,1,22,DEBIT,153880.37,M2122357625
816,409000493201',2018-01-23,BBPS SETMNT FOR DT 230120,104333.66,0.0,351111.8299999988,2018,1,23,DEBIT,104333.66,M1650332494
817,409000493201',2018-01-23,FDRL/INTERNAL FUND TRANSFE,0.0,300000.0,651111.8299999988,2018,1,23,CHECK_CASHING,300000.0,C1318822808
818,409000493201',2018-01-24,BBPS SETMNT FOR DT 240120,137310.84,0.0,513800.9899999988,2018,1,24,CASH_OUT,137310.84,C998351292
819,409000493201',2018-01-25,BBPS SETMNT FOR DT 250120,108268.42,0.0,405532.5699999989,2018,1,25,PAYEMENT,108268.42,M1340644388
820,409000493201',2018-01-25,FDRL/INTERNAL FUND TRANSFE,0.0,300000.0,705532.5699999989,2018,1,25,CHECK_CASHING,300000.0,M1023996917
821,409000493201',2018-01-25,FDRL/INTERNAL FUND TRANSFE,0.0,300000.0,1005532.5699999988,2018,1,25,TRANSFER,300000.0,C557041912
822,409000493201',2018-01-29,BBPS SETMNT FOR DT 290120,252550.92,0.0,752981.6499999989,2018,1,29,CHECK_WITHDRAWAL,252550.92,C846947180
823,409000493201',2018-01-30,BBPS SETMNT FOR DT 300120,117287.45,0.0,635694.1999999989,2018,1,30,CASH_OUT,117287.45,M2144644334
824,409000493201',2018-01-31,BBPS SETMNT FOR DT 310120,82482.93,0.0,553211.2699999989,2018,1,31,DEBIT,82482.93,M1635082651
825,409000493201',2018-02-01,BBPS SETMNT FOR DT 010220,78571.0,0.0,474640.2699999989,2018,2,1,CHECK_WITHDRAWAL,78571.0,M1970073944
826,409000493201',2018-02-02,BBPS SETMNT FOR DT 020220,87199.44,0.0,387440.8299999989,2018,2,2,PAYEMENT,87199.44,M1964847681
827,409000493201',2018-02-02,FDRL/INTERNAL FUND TRANSFE,0.0,200000.0,587440.8299999989,2018,2,2,CHECK_CASHING,200000.0,M1681094402
828,409000493201',2018-02-02,FDRL/INTERNAL FUND TRANSFE,0.0,300000.0,887440.8299999989,2018,2,2,CHECK_CASHING,300000.0,M820677667
829,409000493201',2018-02-03,BBPS SETMNT FOR DT 030220,38505.91,0.0,848934.9199999989,2018,2,3,PAYEMENT,38505.91,C655381473
830,409000493201',2018-02-05,BBPS SETMNT FOR DT 050220,70066.41,0.0,778868.5099999987,2018,2,5,DEBIT,70066.41,C1782113663
831,409000493201',2018-02-06,BBPS DT 06022018,87969.6,0.0,690898.9099999989,2018,2,6,DEBIT,87969.6,M99808631
832,409000493201',2018-02-07,BBPS DT 07022018,91827.28,0.0,599071.6299999988,2018,2,7,CASH_OUT,91827.28,M1564892747
833,409000493201',2018-02-08,BBPS DT 08022018,55919.43,0.0,543152.1999999988,2018,2,8,DEBIT,55919.43,C1526298704
834,409000493201',2018-02-09,BBPS DT 09022018,153450.94,0.0,389701.2599999989,2018,2,9,CHECK_WITHDRAWAL,153450.94,C248609774
835,409000493201',2018-02-09,FDRL/INTERNAL FUND TRANSFE,0.0,200000.0,589701.2599999988,2018,2,9,CASH_IN,200000.0,C667346055
836,409000493201',2018-02-09,FDRL/INTERNAL FUND TRANSFE,0.0,300000.0,889701.2599999987,2018,2,9,CASH_IN,300000.0,C932583850
837,409000493201',2018-02-12,BBPS DT 12022018,171840.28,0.0,717860.9799999987,2018,2,12,CASH_OUT,171840.28,C998351292
838,409000493201',2018-02-13,BBPS DT 13022018,37837.59,0.0,680023.3899999988,2018,2,13,CHECK_WITHDRAWAL,37837.59,C215145189
839,409000493201',2018-02-14,BBPS DT 14022018,29484.1,0.0,650539.2899999989,2018,2,14,DEBIT,29484.1,C451111351
840,409000493201',2018-02-15,BBPS DT 15022018,61110.96,0.0,589428.3299999989,2018,2,15,CHECK_WITHDRAWAL,61110.96,C932583850
841,409000493201',2018-02-16,BBPS DT 16022018,102212.77,0.0,487215.5599999989,2018,2,16,DEBIT,102212.77,C1286084959
842,409000493201',2018-02-16,FDRL/INTERNAL FUND TRANSFE,0.0,300000.0,787215.5599999989,2018,2,16,CASH_IN,300000.0,C1023714065
843,409000493201',2018-02-17,BBPS DT 17022018,107049.16,0.0,680166.3999999989,2018,2,17,DEBIT,107049.16,C932583850
844,409000493201',2018-02-19,BBPS DT 19022018,88031.13,0.0,592135.2699999989,2018,2,19,PAYEMENT,88031.13,C932583850
845,409000493201',2018-02-20,BBPS DT 20022018,80144.06,0.0,511991.2099999989,2018,2,20,PAYEMENT,80144.06,C1816757085
846,409000493201',2018-02-21,BBPS DT 21022018,134293.53,0.0,377697.6799999989,2018,2,21,PAYEMENT,134293.53,C1971489295
847,409000493201',2018-02-22,BBPS DT 22022018,100015.35,0.0,277682.3299999989,2018,2,22,CASH_OUT,100015.35,C885951223
848,409000493201',2018-02-22,FDRL/INTERNAL FUND TRANSFE,0.0,300000.0,577682.3299999989,2018,2,22,TRANSFER,300000.0,C1360767589
849,409000493201',2018-02-22,FDRL/INTERNAL FUND TRANSFE,0.0,200000.0,777682.3299999989,2018,2,22,TRANSFER,200000.0,C1782113663
850,409000493201',2018-02-23,BBPS DT 23022018,110202.4,0.0,667479.9299999989,2018,2,23,PAYEMENT,110202.4,C2083562754
851,409000493201',2018-02-26,BBPS DT 26022018,94909.73,0.0,572570.1999999989,2018,2,26,PAYEMENT,94909.73,C392292416
852,409000493201',2018-02-27,BBPS DT 27022018,83883.09,0.0,488687.1099999989,2018,2,27,DEBIT,83883.09,C1653844940
853,409000493201',2018-02-28,BBPS DT 28022018,53685.02,0.0,435002.0899999989,2018,2,28,PAYEMENT,53685.02,C575335780
854,409000493201',2018-03-01,BBPS DT 01032018,92260.68,0.0,342741.4099999989,2018,3,1,PAYEMENT,92260.68,C1789550256
855,409000493201',2018-03-01,FDRL/INTERNAL FUND TRANSFE,0.0,300000.0,642741.409999999,2018,3,1,TRANSFER,300000.0,C564160838
856,409000493201',2018-03-01,FDRL/INTERNAL FUND TRANSFE,0.0,200000.0,842741.4099999991,2018,3,1,TRANSFER,200000.0,C1291286504
857,409000493201',2018-03-02,BBPS DT 02032018,22018.4,0.0,820723.0099999991,2018,3,2,DEBIT,22018.4,C451111351
858,409000493201',2018-03-03,BBPS DT 03032018,0.0,35851.19,856574.199999999,2018,3,3,TRANSFER,35851.19,C597190999
859,409000493201',2018-03-05,BBPS DT 05032018,77952.12,0.0,778622.079999999,2018,3,5,PAYEMENT,77952.12,C1531333864
860,409000493201',2018-03-06,BBPS DT 06032018,78194.25,0.0,700427.829999999,2018,3,6,CHECK_WITHDRAWAL,78194.25,C1749186397
861,409000493201',2018-03-07,BBPS SETTELET DTD 07.03.2,133276.73,0.0,567151.0999999989,2018,3,7,CASH_OUT,133276.73,C997608398
862,409000493201',2018-03-08,BBPS DT 08032018,208169.53,0.0,358981.56999999896,2018,3,8,PAYEMENT,208169.53,C2050019814
863,409000493201',2018-03-09,BBPS DT 09032018,205372.21,0.0,153609.35999999905,2018,3,9,PAYEMENT,205372.21,C1740000325
864,409000493201',2018-03-09,FDRL/INTERNAL FUND TRANSFE,0.0,200000.0,353609.35999999905,2018,3,9,TRANSFER,200000.0,C614685048
865,409000493201',2018-03-09,FDRL/INTERNAL FUND TRANSFE,0.0,200000.0,553609.3599999989,2018,3,9,TRANSFER,200000.0,C1170794006
866,409000493201',2018-03-12,FDRL/INTERNAL FUND TRANSFE,0.0,200000.0,753609.359999999,2018,3,12,TRANSFER,200000.0,C1860513229
867,409000493201',2018-03-12,BBPS DT 12032018,587655.98,0.0,165953.37999999907,2018,3,12,DEBIT,587655.98,C401424608
868,409000493201',2018-03-12,FDRL/INTERNAL FUND TRANSFE,0.0,200000.0,365953.3799999991,2018,3,12,TRANSFER,200000.0,C1782113663
869,409000493201',2018-03-12,FDRL/INTERNAL FUND TRANSFE,0.0,300000.0,665953.3799999991,2018,3,12,CHECK_CASHING,300000.0,C557041912
870,409000493201',2018-03-13,BBPS DT 13032018,232615.36,0.0,433338.0199999991,2018,3,13,CHECK_WITHDRAWAL,232615.36,C33524623
871,409000493201',2018-03-14,BBPS DT 14032018,169248.39,0.0,264089.6299999991,2018,3,14,CHECK_WITHDRAWAL,169248.39,C1816757085
872,409000493201',2018-03-14,FDRL/INTERNAL FUND TRANSFE,0.0,300000.0,564089.6299999991,2018,3,14,TRANSFER,300000.0,C248609774
873,409000493201',2018-03-15,BBPS DT 15032018,181965.87,0.0,382123.7599999991,2018,3,15,DEBIT,181965.87,C1262822392
874,409000493201',2018-03-16,BBPS DT 16032018,64069.0,0.0,318054.7599999991,2018,3,16,DEBIT,64069.0,C451111351
875,409000493201',2018-03-16,FDRL/INTERNAL FUND TRANSFE,0.0,200000.0,518054.7599999991,2018,3,16,CASH_IN,200000.0,C1750905143
876,409000493201',2018-03-16,FDRL/INTERNAL FUND TRANSFE,0.0,300000.0,818054.7599999991,2018,3,16,TRANSFER,300000.0,C33524623
877,409000493201',2018-03-17,BBPS DT 17032018,121924.84,0.0,696129.9199999991,2018,3,17,DEBIT,121924.84,C1750905143
878,409000493201',2018-03-19,BBPS DT 19032018,43998.98,0.0,652130.939999999,2018,3,19,PAYEMENT,43998.98,C1360767589
879,409000493201',2018-03-20,BBPS DT 20032018,226245.3,0.0,425885.6399999992,2018,3,20,CHECK_WITHDRAWAL,226245.3,C453211571
880,409000493201',2018-03-20,FDRL/INTERNAL FUND TRANSFE,0.0,200000.0,625885.6399999992,2018,3,20,CASH_IN,200000.0,C1262822392
881,409000493201',2018-03-21,BBPS DT 21032018,174291.75,0.0,451593.8899999992,2018,3,21,CHECK_WITHDRAWAL,174291.75,C1971489295
882,409000493201',2018-03-21,BBPS  DT 12022018,50650.62,0.0,400943.2699999992,2018,3,21,CHECK_WITHDRAWAL,50650.62,C1318822808
883,409000493201',2018-03-21,REV BBPS  DT 12022018,0.0,171840.28,572783.5499999992,2018,3,21,TRANSFER,171840.28,C977993101
884,409000493201',2018-03-22,BBPS DT 22032018,99571.0,0.0,473212.54999999923,2018,3,22,CASH_OUT,99571.0,C1971489295
885,409000493201',2018-03-23,BBPS DT 23032018,68100.91,0.0,405111.6399999992,2018,3,23,DEBIT,68100.91,C977993101
886,409000493201',2018-03-23,FDRL/INTERNAL FUND TRANSFE,0.0,200000.0,605111.6399999992,2018,3,23,TRANSFER,200000.0,C1526298704
887,409000493201',2018-03-26,BBPS DT 26032018,138542.03,0.0,466569.60999999923,2018,3,26,CHECK_WITHDRAWAL,138542.03,C1335050193
888,409000493201',2018-03-27,BBPS DT 27032018,117114.79,0.0,349454.8199999992,2018,3,27,CASH_OUT,117114.79,C990355670
889,409000493201',2018-03-27,FDRL/INTERNAL FUND TRANSFE,0.0,200000.0,549454.819999999,2018,3,27,TRANSFER,200000.0,C1182461167
890,409000493201',2018-03-28,BBPS DT 28032018,168011.64,0.0,381443.17999999906,2018,3,28,DEBIT,168011.64,C1750905143
891,409000493201',2018-03-29,BBPS DT 29032018,117919.02,0.0,263524.1599999991,2018,3,29,CASH_OUT,117919.02,C453211571
892,409000493201',2018-03-29,FDRL/INTERNAL FUND TRANSFE,0.0,300000.0,563524.1599999991,2018,3,29,CHECK_CASHING,300000.0,C1899073220
893,409000493201',2018-03-29,FDRL/INTERNAL FUND TRANSFE,0.0,200000.0,763524.1599999991,2018,3,29,CHECK_CASHING,200000.0,C357863579
894,409000493201',2018-03-31,FDRL/INTERNAL FUND TRANSFE,0.0,200000.0,963524.1599999992,2018,3,31,TRANSFER,200000.0,C977993101
895,409000493201',2018-03-31,BBPS DT 31032018,213036.21,0.0,750487.949999999,2018,3,31,CASH_OUT,213036.21,C1883840933
896,409000493201',2018-04-03,BBPS DT 03042018,62142.89,0.0,688345.059999999,2018,4,3,PAYEMENT,62142.89,C1899073220
897,409000493201',2018-04-03,BBPS DT 02042018,54010.29,0.0,634334.7699999991,2018,4,3,DEBIT,54010.29,C453211571
898,409000493201',2018-04-04,BBPS DT 04042018,40282.34,0.0,594052.4299999991,2018,4,4,PAYEMENT,40282.34,C1318822808
899,409000493201',2018-04-05,BBPS DT 05042018,118388.47,0.0,475663.9599999992,2018,4,5,CHECK_WITHDRAWAL,118388.47,C1023714065
900,409000493201',2018-04-05,FDRL/INTERNAL FUND TRANSFE,0.0,200000.0,675663.959999999,2018,4,5,CHECK_CASHING,200000.0,M905847077
901,409000493201',2018-04-06,BBPS DT 06042018,123743.72,0.0,551920.2399999992,2018,4,6,PAYEMENT,123743.72,M878991463
902,409000493201',2018-04-07,BBPS DT 07042018,197932.71,0.0,353987.5299999992,2018,4,7,CHECK_WITHDRAWAL,197932.71,M1622613647
903,409000493201',2018-04-09,BBPS DT 09042018,235573.75,0.0,118413.7799999992,2018,4,9,CASH_OUT,235573.75,M73688220
904,409000493201',2018-04-09,FDRL/INTERNAL FUND TRANSFE,0.0,300000.0,418413.7799999992,2018,4,9,CASH_IN,300000.0,M1599674462
905,409000493201',2018-04-09,FDRL/INTERNAL FUND TRANSFE,0.0,300000.0,718413.7799999992,2018,4,9,CHECK_CASHING,300000.0,M1205483858
906,409000493201',2018-04-10,BBPS DT 10042018,247145.7,0.0,471268.0799999992,2018,4,10,DEBIT,247145.7,M1189651769
907,409000493201',2018-04-11,BBPS DT 11042018,161435.3,0.0,309832.7799999992,2018,4,11,DEBIT,161435.3,M1607869297
908,409000493201',2018-04-11,FDRL/INTERNAL FUND TRANSFE,0.0,300000.0,609832.7799999992,2018,4,11,CASH_IN,300000.0,M727860268
909,409000493201',2018-04-12,BBPS DT 12042018,199217.29,0.0,410615.48999999923,2018,4,12,DEBIT,199217.29,M138536309
910,409000493201',2018-04-12,FDRL/INTERNAL FUND TRANSFE,0.0,300000.0,710615.4899999992,2018,4,12,TRANSFER,300000.0,M509559152
911,409000493201',2018-04-13,BBPS DT 13042018,191239.47,0.0,519376.0199999992,2018,4,13,PAYEMENT,191239.47,M1801021153
912,409000493201',2018-04-13,FDRL/INTERNAL FUND TRANSFE,0.0,200000.0,719376.0199999992,2018,4,13,TRANSFER,200000.0,M22446425
913,409000493201',2018-04-13,FDRL/INTERNAL FUND TRANSFE,0.0,200000.0,919376.0199999992,2018,4,13,CHECK_CASHING,200000.0,M1870723838
914,409000493201',2018-04-16,BBPS DT 16042018,76266.87,0.0,843109.1499999992,2018,4,16,PAYEMENT,76266.87,M261650860
915,409000493201',2018-04-16,BBPS DT 15042018,133355.43,0.0,709753.7199999994,2018,4,16,PAYEMENT,133355.43,M1598898814
916,409000493201',2018-04-16,BBPS DT 14042018,100657.31,0.0,609096.4099999992,2018,4,16,PAYEMENT,100657.31,M575360353
917,409000493201',2018-04-17,BBPS SETTELET DTD 17.04.2,237804.3,0.0,371292.10999999923,2018,4,17,CASH_OUT,237804.3,M809383315
918,409000493201',2018-04-17,FDRL/INTERNAL FUND TRANSFE,0.0,200000.0,571292.1099999992,2018,4,17,TRANSFER,200000.0,C998351292
919,409000493201',2018-04-18,BBPS DT 18042018,307704.52,0.0,263587.58999999915,2018,4,18,PAYEMENT,307704.52,M496757837
920,409000493201',2018-04-18,FDRL/INTERNAL FUND TRANSFE,0.0,200000.0,463587.5899999992,2018,4,18,CASH_IN,200000.0,M17600354
921,409000493201',2018-04-18,FDRL/INTERNAL FUND TRANSFE,0.0,300000.0,763587.5899999994,2018,4,18,CASH_IN,300000.0,C1629911510
922,409000493201',2018-04-19,BBPS DT 19042018,242028.32,0.0,521559.2699999992,2018,4,19,DEBIT,242028.32,C1686100174
923,409000493201',2018-04-20,BBPS DT 20042018,240151.47,0.0,281407.7999999991,2018,4,20,PAYEMENT,240151.47,M1521568953
924,409000493201',2018-04-21,BBPS DT 21042018,153156.83,0.0,128250.96999999913,2018,4,21,DEBIT,153156.83,M1134202713
925,409000493201',2018-04-21,FDRL/INTERNAL FUND TRANSFE,0.0,300000.0,428250.9699999992,2018,4,21,CASH_IN,300000.0,C997608398
926,409000493201',2018-04-21,FDRL/INTERNAL FUND TRANSFE,0.0,300000.0,728250.9699999994,2018,4,21,CHECK_CASHING,300000.0,M633131207
927,409000493201',2018-04-23,BBPS DT 22042018,142263.54,0.0,585987.4299999991,2018,4,23,DEBIT,142263.54,C1831477404
928,409000493201',2018-04-23,BBPS DT 23042018,106937.58,0.0,479049.84999999905,2018,4,23,DEBIT,106937.58,M1088239991
929,409000493201',2018-04-24,BBPS DT 24042018,212480.4,0.0,266569.44999999914,2018,4,24,PAYEMENT,212480.4,C476800120
930,409000493201',2018-04-24,FDRL/INTERNAL FUND TRANSFE,0.0,300000.0,566569.449999999,2018,4,24,TRANSFER,300000.0,M1658511941
931,409000493201',2018-04-24,FDRL/INTERNAL FUND TRANSFE,0.0,200000.0,766569.449999999,2018,4,24,TRANSFER,200000.0,M1878992188
932,409000493201',2018-04-24,FDRL/INTERNAL FUND TRANSFE,0.0,200000.0,966569.4499999993,2018,4,24,CHECK_CASHING,200000.0,M1495161082
933,409000493201',2018-04-25,BBPS DT 25042018,188141.79,0.0,778427.6599999991,2018,4,25,CHECK_WITHDRAWAL,188141.79,C1556995360
934,409000493201',2018-04-26,BBPS DT 26042018,123185.81,0.0,655241.8499999992,2018,4,26,CHECK_WITHDRAWAL,123185.81,M1497268815
935,409000493201',2018-04-27,BBPS DT 27042018,164119.79,0.0,491122.05999999907,2018,4,27,CASH_OUT,164119.79,M1837601499
936,409000493201',2018-04-27,FDRL/INTERNAL FUND TRANSFE,0.0,300000.0,791122.059999999,2018,4,27,CHECK_CASHING,300000.0,M1228798862
937,409000493201',2018-04-27,FDRL/INTERNAL FUND TRANSFE,0.0,300000.0,1091122.0599999991,2018,4,27,TRANSFER,300000.0,C392292416
938,409000493201',2018-04-27,Indiaforensic BBPS GURANATEE FEE,500000.0,0.0,591122.059999999,2018,4,27,PAYEMENT,500000.0,C1219161283
939,409000493201',2018-04-30,BBPS DT 28042018,160888.2,0.0,430233.85999999905,2018,4,30,PAYEMENT,160888.2,C317071334
940,409000493201',2018-04-30,BBPS DT 29042018,157810.46,0.0,272423.3999999991,2018,4,30,CHECK_WITHDRAWAL,157810.46,M1576277927
941,409000493201',2018-04-30,BBPS DT 30042018,57084.32,0.0,215339.07999999906,2018,4,30,CASH_OUT,57084.32,M2137642385
942,409000493201',2018-04-30,FDRL/INTERNAL FUND TRANSFE,0.0,200000.0,415339.0799999991,2018,4,30,CASH_IN,200000.0,M481553464
943,409000493201',2018-05-01,BBPS DT 01052018,154816.5,0.0,260522.5799999991,2018,5,1,CASH_OUT,154816.5,M1908781622
944,409000493201',2018-05-01,FDRL/INTERNAL FUND TRANSFE,0.0,200000.0,460522.5799999991,2018,5,1,CHECK_CASHING,200000.0,M796553753
945,409000493201',2018-05-01,FDRL/INTERNAL FUND TRANSFE,0.0,200000.0,660522.579999999,2018,5,1,TRANSFER,200000.0,M975001918
946,409000493201',2018-05-02,BBPS DT 02052018,183929.92,0.0,476592.659999999,2018,5,2,DEBIT,183929.92,M907815246
947,409000493201',2018-05-03,BBPS DT 03052018,187650.1,0.0,288942.5599999991,2018,5,3,CASH_OUT,187650.1,M677217562
948,409000493201',2018-05-03,FDRL/INTERNAL FUND TRANSFE,0.0,300000.0,588942.559999999,2018,5,3,TRANSFER,300000.0,M1716164115
949,409000493201',2018-05-04,BBPS DT 04052018,139069.5,0.0,449873.05999999907,2018,5,4,CASH_OUT,139069.5,M363397863
950,409000493201',2018-05-04,FDRL/INTERNAL FUND TRANSFE,0.0,200000.0,649873.059999999,2018,5,4,TRANSFER,200000.0,C1123629720
951,409000493201',2018-05-04,FDRL/INTERNAL FUND TRANSFE,0.0,300000.0,949873.0599999992,2018,5,4,CHECK_CASHING,300000.0,M1525844775
952,409000493201',2018-05-05,BBPS DT 05052018,107985.24,0.0,841887.819999999,2018,5,5,DEBIT,107985.24,C1740000325
953,409000493201',2018-05-07,BBPS DT 06052018,190194.7,0.0,651693.1199999992,2018,5,7,CHECK_WITHDRAWAL,190194.7,C1877453512
954,409000493201',2018-05-07,BBPS DT 07052018,68538.04,0.0,583155.079999999,2018,5,7,CASH_OUT,68538.04,M1016162524
955,409000493201',2018-05-08,BBPS DT 08052018,242380.79,0.0,340774.2899999991,2018,5,8,DEBIT,242380.79,M1419125235
956,409000493201',2018-05-08,FDRL/INTERNAL FUND TRANSFE,0.0,300000.0,640774.2899999991,2018,5,8,TRANSFER,300000.0,M841166421
957,409000493201',2018-05-09,BBPS DT 09052018,129549.64,0.0,511224.649999999,2018,5,9,DEBIT,129549.64,M938199512
958,409000493201',2018-05-09,FDRL/INTERNAL FUND TRANSFE,0.0,300000.0,811224.6499999991,2018,5,9,CASH_IN,300000.0,M37841489
959,409000493201',2018-05-10,BBPS DT 10052018,82525.95,0.0,728698.699999999,2018,5,10,DEBIT,82525.95,M115945887
960,409000493201',2018-05-11,BBPS DT 11052018,77162.26,0.0,651536.439999999,2018,5,11,CHECK_WITHDRAWAL,77162.26,M2079961240
961,409000493201',2018-05-14,FDRL/INTERNAL FUND TRANSFE,0.0,300000.0,951536.4399999992,2018,5,14,CASH_IN,300000.0,M1999664216
962,409000493201',2018-05-14,BBPS DT 12052018,11483.23,0.0,940053.2099999993,2018,5,14,PAYEMENT,11483.23,M688593710
963,409000493201',2018-05-14,BBPS DT 13052018,0.0,22479.51,962532.7199999993,2018,5,14,CHECK_CASHING,22479.51,C1049817027
964,409000493201',2018-05-14,BBPS DT 14052018,0.0,109368.29,1071901.009999999,2018,5,14,TRANSFER,109368.29,M739737502
965,409000493201',2018-05-15,BBPS DT 15052018,141740.47,0.0,930160.5399999992,2018,5,15,CASH_OUT,141740.47,M546796969
966,409000493201',2018-05-16,BBPS DT 16052018,7367.22,0.0,922793.3199999993,2018,5,16,CHECK_WITHDRAWAL,7367.22,M261845810
967,409000493201',2018-05-17,BBPS DT 17052018,0.0,13011.68,935804.9999999992,2018,5,17,CHECK_CASHING,13011.68,C1850180796
968,409000493201',2018-05-19,BBPS DT 19052018,0.0,20256.89,956061.8899999992,2018,5,19,CHECK_CASHING,20256.89,C33524623
969,409000493201',2018-05-19,BBPS DT 18052018,39858.43,0.0,916203.4599999993,2018,5,19,DEBIT,39858.43,C431687661
970,409000493201',2018-05-21,BBPS DT 20052018,0.0,17961.93,934165.3899999992,2018,5,21,CHECK_CASHING,17961.93,C716083600
971,409000493201',2018-05-21,BBPS DT 21052018,0.0,41666.35,975831.7399999992,2018,5,21,TRANSFER,41666.35,C644345897
972,409000493201',2018-05-22,BBPS DT 22052018,90671.52,0.0,885160.2199999994,2018,5,22,CASH_OUT,90671.52,M207988207
973,409000493201',2018-05-23,BBPS DT 23052018,153131.62,0.0,732028.5999999992,2018,5,23,PAYEMENT,153131.62,C1883840933
974,409000493201',2018-05-24,BBPS DT 25052018,84937.59,0.0,647091.0099999992,2018,5,24,PAYEMENT,84937.59,M799755007
975,409000493201',2018-05-25,BBPS DT 25052018,127374.04,0.0,519716.9699999992,2018,5,25,PAYEMENT,127374.04,M1850137076
976,409000493201',2018-05-28,BBPS DT 26052018,131055.59,0.0,388661.3799999992,2018,5,28,PAYEMENT,131055.59,C1664439369
977,409000493201',2018-05-28,BBPS DT 27052018,51500.8,0.0,337160.5799999992,2018,5,28,DEBIT,51500.8,M566641954
978,409000493201',2018-05-28,BBPS DT 28052018,0.0,53022.28,390182.85999999923,2018,5,28,CHECK_CASHING,53022.28,M299819831
979,409000493201',2018-05-28,FDRL/INTERNAL FUND TRANSFE,0.0,300000.0,690182.8599999992,2018,5,28,TRANSFER,300000.0,M1442038800
980,409000493201',2018-05-29,BBPS DT 26052018,142369.35,0.0,547813.5099999992,2018,5,29,CHECK_WITHDRAWAL,142369.35,C288665596
981,409000493201',2018-05-30,BBPS DT 30052018,110513.7,0.0,437299.80999999924,2018,5,30,PAYEMENT,110513.7,M1250603112
982,409000493201',2018-05-30,FDRL/INTERNAL FUND TRANSFE,0.0,300000.0,737299.809999999,2018,5,30,CASH_IN,300000.0,C1058634310
983,409000493201',2018-05-31,BBPS DT 31052018,115854.87,0.0,621444.939999999,2018,5,31,PAYEMENT,115854.87,M1806378373
984,409000493201',2018-06-01,BBPS DT 01062018,34285.36,0.0,587159.579999999,2018,6,1,CASH_OUT,34285.36,M1682733268
985,409000493201',2018-06-02,BBPS DT 02062018,65093.04,0.0,522066.5399999992,2018,6,2,DEBIT,65093.04,C736709391
986,409000493201',2018-06-04,BBPS DT 03062018,38019.06,0.0,484047.4799999992,2018,6,4,CHECK_WITHDRAWAL,38019.06,C1060830840
987,409000493201',2018-06-04,BBPS DT 04062018,0.0,14181.98,498229.4599999992,2018,6,4,TRANSFER,14181.98,M2092885124
988,409000493201',2018-06-05,BBPS DT 05062018,78982.56,0.0,419246.8999999992,2018,6,5,DEBIT,78982.56,C367746789
989,409000493201',2018-06-06,BBPS DT 06062018,64415.11,0.0,354831.7899999992,2018,6,6,DEBIT,64415.11,M67671827
990,409000493201',2018-06-07,BBPS DT 07062018,97510.32,0.0,257321.46999999922,2018,6,7,PAYEMENT,97510.32,M2013768748
991,409000493201',2018-06-08,BBPS DT 08062018,25366.64,0.0,231954.82999999914,2018,6,8,CASH_OUT,25366.64,M1264674474
992,409000493201',2018-06-11,FDRL/INTERNAL FUND TRANSFE,0.0,300000.0,531954.829999999,2018,6,11,CHECK_CASHING,300000.0,M1339345635
993,409000493201',2018-06-11,FDRL/INTERNAL FUND TRANSFE,0.0,300000.0,831954.829999999,2018,6,11,TRANSFER,300000.0,M168957945
994,409000493201',2018-06-11,BBPS DT 09062018,27920.62,0.0,804034.209999999,2018,6,11,DEBIT,27920.62,M1379148981
995,409000493201',2018-06-11,BBPS DT 10062018,8112.82,0.0,795921.3899999992,2018,6,11,CASH_OUT,8112.82,M832432849
996,409000493201',2018-06-11,BBPS DT 11062018,0.0,82132.09,878053.4799999992,2018,6,11,CHECK_CASHING,82132.09,M176041373
997,409000493201',2018-06-12,BBPS DT 12062018,29859.18,0.0,848194.2999999991,2018,6,12,DEBIT,29859.18,M726843606
998,409000493201',2018-06-13,BBPS DT 13062018,16905.35,0.0,831288.949999999,2018,6,13,CHECK_WITHDRAWAL,16905.35,M1288135425
999,409000493201',2018-06-14,BBPS DT 14062018,39815.49,0.0,791473.459999999,2018,6,14,CASH_OUT,39815.49,M1058650291
1000,409000493201',2018-06-15,BBPS DT 15062018,30196.44,0.0,761277.0199999992,2018,6,15,PAYEMENT,30196.44,M172518776
1001,409000493201',2018-06-18,BBPS DT 16062018,12958.25,0.0,748318.7699999992,2018,6,18,DEBIT,12958.25,M2129844134
1002,409000493201',2018-06-18,BBPS DT 17062018,0.0,43963.21,792281.9799999992,2018,6,18,CHECK_CASHING,43963.21,C885951223
1003,409000493201',2018-06-18,BBPS DT 18062018,0.0,53656.53,845938.5099999992,2018,6,18,CASH_IN,53656.53,C22805895
1004,409000493201',2018-06-19,BBPS DT 19062018,180907.04,0.0,665031.4699999993,2018,6,19,DEBIT,180907.04,M1240843015
1005,409000493201',2018-06-20,BBPS DT 20062018,146123.98,0.0,518907.48999999923,2018,6,20,DEBIT,146123.98,M1416706187
1006,409000493201',2018-06-21,BBPS DT 21062018,71360.1,0.0,447547.3899999992,2018,6,21,PAYEMENT,71360.1,M23076423
1007,409000493201',2018-06-22,BBPS DT 22062018,34623.77,0.0,412923.61999999924,2018,6,22,DEBIT,34623.77,M1721180011
1008,409000493201',2018-06-22,FDRL/INTERNAL FUND TRANSFE,0.0,200000.0,612923.6199999992,2018,6,22,CHECK_CASHING,200000.0,M1367068823
1009,409000493201',2018-06-25,BBPS DT 23062018,24246.1,0.0,588677.5199999992,2018,6,25,DEBIT,24246.1,M1251788491
1010,409000493201',2018-06-25,BBPS DT 24062018,26719.16,0.0,561958.3599999992,2018,6,25,CASH_OUT,26719.16,M1457551880
1011,409000493201',2018-06-25,BBPS DT 25062018,0.0,55573.29,617531.6499999992,2018,6,25,CASH_IN,55573.29,M424732838
1012,409000493201',2018-06-26,BBPS DT 26062018,48110.56,0.0,569421.0899999993,2018,6,26,DEBIT,48110.56,C392292416
1013,409000493201',2018-06-27,BBPS DT 27062018,63907.21,0.0,505513.8799999991,2018,6,27,DEBIT,63907.21,M290096578
1014,409000493201',2018-06-28,BBPS DT 28062018,23085.44,0.0,482428.4399999991,2018,6,28,PAYEMENT,23085.44,M217470033
1015,409000493201',2018-06-28,FDRL/INTERNAL FUND TRANSFE,0.0,200000.0,682428.439999999,2018,6,28,CHECK_CASHING,200000.0,M938405008
1016,409000493201',2018-06-29,BBPS DT 29062018,3341.29,0.0,679087.1499999991,2018,6,29,CHECK_WITHDRAWAL,3341.29,M211031000
1017,409000493201',2018-06-30,BBPS DT 30062018,12252.0,0.0,666835.1499999991,2018,6,30,CASH_OUT,12252.0,C998351292
1018,409000493201',2018-07-02,BBPS DT 01072018,22571.88,0.0,644263.2699999991,2018,7,2,CHECK_WITHDRAWAL,22571.88,M14124949
1019,409000493201',2018-07-02,BBPS DT 02072018,0.0,55900.4,700163.6699999991,2018,7,2,CASH_IN,55900.4,C1686100174
1020,409000493201',2018-07-03,BBPS DT 03072018,0.0,44892.38,745056.0499999991,2018,7,3,CHECK_CASHING,44892.38,M1000171161
1021,409000493201',2018-07-04,BBPS DT 04072018,6904.87,0.0,738151.1799999991,2018,7,4,CASH_OUT,6904.87,M560549459
1022,409000493201',2018-07-05,BBPS DT 05072018,0.0,17198.35,755349.5299999991,2018,7,5,TRANSFER,17198.35,C453211571
1023,409000493201',2018-07-06,BBPS DT 06072018,29872.95,0.0,725476.579999999,2018,7,6,CASH_OUT,29872.95,M1895479349
1024,409000493201',2018-07-07,BBPS DT 07072018,0.0,12990.47,738467.0499999991,2018,7,7,CASH_IN,12990.47,M1648458262
1025,409000493201',2018-07-09,BBPS DT 09072018,0.0,67657.57,806124.6199999992,2018,7,9,CASH_IN,67657.57,M650013863
1026,409000493201',2018-07-09,BBPS DT 08072018,29077.09,0.0,777047.5299999992,2018,7,9,CASH_OUT,29077.09,M123337428
1027,409000493201',2018-07-10,BBPS DT 10072018,90684.03,0.0,686363.4999999992,2018,7,10,PAYEMENT,90684.03,M1397333381
1028,409000493201',2018-07-11,BBPS DT 11072018,66435.79,0.0,619927.709999999,2018,7,11,DEBIT,66435.79,M2016038911
1029,409000493201',2018-07-12,BBPS DT 12072018,121795.12,0.0,498132.5899999992,2018,7,12,CHECK_WITHDRAWAL,121795.12,M1509713998
1030,409000493201',2018-07-13,BBPS DT 13072018,41636.56,0.0,456496.0299999992,2018,7,13,PAYEMENT,41636.56,C1336996537
1031,409000493201',2018-07-13,FDRL/INTERNAL FUND TRANSFE,0.0,300000.0,756496.0299999991,2018,7,13,CASH_IN,300000.0,M1525114112
1032,409000493201',2018-07-16,BBPS DT 14072018,53279.64,0.0,703216.3899999991,2018,7,16,DEBIT,53279.64,M288615534
1033,409000493201',2018-07-16,BBPS DT 15072018,0.0,3521.67,706738.059999999,2018,7,16,CASH_IN,3521.67,M1416665097
1034,409000493201',2018-07-16,BBPS DT 16072018,0.0,100682.1,807420.1599999991,2018,7,16,TRANSFER,100682.1,M619929778
1035,409000493201',2018-07-17,BBPS DT 17072018,100369.8,0.0,707050.359999999,2018,7,17,DEBIT,100369.8,M808447015
1036,409000493201',2018-07-18,BBPS DT 18072018,76026.55,0.0,631023.809999999,2018,7,18,DEBIT,76026.55,M1220806149
1037,409000493201',2018-07-19,BBPS DT 19072018,30494.01,0.0,600529.799999999,2018,7,19,CASH_OUT,30494.01,C824208363
1038,409000493201',2018-07-20,BBPS DT 20072018,90799.39,0.0,509730.409999999,2018,7,20,CASH_OUT,90799.39,M74885833
1039,409000493201',2018-07-21,BBPS DT 21072018,0.0,21731.12,531461.529999999,2018,7,21,TRANSFER,21731.12,M1004009692
1040,409000493201',2018-07-23,BBPS DT 22072018,0.0,33830.77,565292.299999999,2018,7,23,CASH_IN,33830.77,C1793436274
1041,409000493201',2018-07-23,BBPS DT 23072018,0.0,3260.67,568552.969999999,2018,7,23,CHECK_CASHING,3260.67,M569138567
1042,409000493201',2018-07-23,BBPS DT 23072018,0.0,49973.88,618526.8499999989,2018,7,23,CASH_IN,49973.88,C476800120
1043,409000493201',2018-07-24,BBPS DT 24072018,0.0,17711.45,636238.299999999,2018,7,24,TRANSFER,17711.45,M443110940
1044,409000493201',2018-07-25,BBPS DT 25072018,97234.02,0.0,539004.279999999,2018,7,25,CASH_OUT,97234.02,M910123336
1045,409000493201',2018-07-26,BBPS DT 26072018,22302.35,0.0,516701.929999999,2018,7,26,PAYEMENT,22302.35,M455668354
1046,409000493201',2018-07-27,BBPS DT 27072018,0.0,10227.38,526929.309999999,2018,7,27,CASH_IN,10227.38,M1584918772
1047,409000493201',2018-07-30,BBPS DT 28072018,0.0,33190.68,560119.9899999991,2018,7,30,CASH_IN,33190.68,C242131142
1048,409000493201',2018-07-30,BBPS DT 29072018,4625.14,0.0,555494.8499999989,2018,7,30,DEBIT,4625.14,C985934102
1049,409000493201',2018-07-30,BBPS DT 30072018,0.0,71337.37,626832.219999999,2018,7,30,TRANSFER,71337.37,M1209451152
1050,409000493201',2018-07-31,BBPS DT 31072018,29089.53,0.0,597742.689999999,2018,7,31,CHECK_WITHDRAWAL,29089.53,M373437697
1051,409000493201',2018-08-01,BBPS DT 01082018,30347.75,0.0,567394.939999999,2018,8,1,CHECK_WITHDRAWAL,30347.75,M2048102341
1052,409000493201',2018-08-02,BBPS DT 02082018,0.0,20224.88,587619.819999999,2018,8,2,CHECK_CASHING,20224.88,M813131188
1053,409000493201',2018-08-03,BBPS DT 03082018,4795.33,0.0,582824.4899999991,2018,8,3,CASH_OUT,4795.33,M748006558
1054,409000493201',2018-08-04,BBPS DT 04082018,14728.37,0.0,568096.1199999991,2018,8,4,PAYEMENT,14728.37,M1168079523
1055,409000493201',2018-08-06,BBPS DT 05082018,0.0,62024.88,630120.9999999991,2018,8,6,CASH_IN,62024.88,M2109027570
1056,409000493201',2018-08-06,BBPS DT 06082018,0.0,66966.06,697087.059999999,2018,8,6,TRANSFER,66966.06,M2052489518
1057,409000493201',2018-08-07,BBPS DT 07082018,35934.87,0.0,661152.189999999,2018,8,7,PAYEMENT,35934.87,C1321530272
1058,409000493201',2018-08-08,BBPS DT 08082018,10667.64,0.0,650484.5499999991,2018,8,8,CHECK_WITHDRAWAL,10667.64,M793269462
1059,409000493201',2018-08-09,BBPS DT 09082018,0.0,5322.89,655807.439999999,2018,8,9,TRANSFER,5322.89,C461160828
1060,409000493201',2018-08-10,BBPS DT 10082018,0.0,10564.32,666371.7599999991,2018,8,10,CASH_IN,10564.32,M15094126
1061,409000493201',2018-08-13,BBPS DT 11082018,0.0,53362.07,719733.829999999,2018,8,13,CHECK_CASHING,53362.07,M1139609587
1062,409000493201',2018-08-13,BBPS DT 12082018,0.0,151788.62,871522.449999999,2018,8,13,CHECK_CASHING,151788.62,M173060252
1063,409000493201',2018-08-13,BBPS DT 13082018,0.0,7164.58,878687.0299999991,2018,8,13,CASH_IN,7164.58,M1720797452
1064,409000493201',2018-08-14,BBPS DT 14082018,0.0,6597.22,885284.2499999991,2018,8,14,CHECK_CASHING,6597.22,M777813771
1065,409000493201',2018-08-16,BBPS DT 15082018,0.0,30456.56,915740.809999999,2018,8,16,TRANSFER,30456.56,M1306535359
1066,409000493201',2018-08-16,BBPS DT 16082018,0.0,156813.87,1072554.679999999,2018,8,16,TRANSFER,156813.87,M519019247
1067,409000493201',2018-08-17,BBPS DT 17082018,0.0,94982.32,1167536.999999999,2018,8,17,CASH_IN,94982.32,M1572442646
1068,409000493201',2018-08-18,BBPS DT 18082018,0.0,77676.77,1245213.769999999,2018,8,18,CHECK_CASHING,77676.77,M1545327692
1069,409000493201',2018-08-20,BBPS DT 19082018,0.0,54826.71,1300040.479999999,2018,8,20,CASH_IN,54826.71,M416049054
1070,409000493201',2018-08-20,BBPS DT 20082018,0.0,176705.41,1476745.889999999,2018,8,20,CASH_IN,176705.41,M743219449
1071,409000493201',2018-08-21,BBPS DT 21082018,0.0,39601.83,1516347.719999999,2018,8,21,CASH_IN,39601.83,C1870252780
1072,409000493201',2018-08-23,BBPS DT 22082018,0.0,137436.94,1653784.659999999,2018,8,23,CASH_IN,137436.94,C1816757085
1073,409000493201',2018-08-23,BBPS DT 23082018,0.0,114273.52,1768058.179999999,2018,8,23,TRANSFER,114273.52,M659937029
1074,409000493201',2018-08-23,TRF TO  Indiaforensic SERVICES I,1000000.0,0.0,768058.1799999991,2018,8,23,DEBIT,1000000.0,C1899073220
1075,409000493201',2018-08-24,BBPS DT 24082018,0.0,65456.4,833514.579999999,2018,8,24,CHECK_CASHING,65456.4,C1259769769
1076,409000493201',2018-08-27,BBPS DT 25082018,0.0,89601.49,923116.069999999,2018,8,27,TRANSFER,89601.49,C403147759
1077,409000493201',2018-08-27,BBPS DT 26082018,0.0,113986.27,1037102.339999999,2018,8,27,CASH_IN,113986.27,C1023714065
1078,409000493201',2018-08-27,BBPS DT 27082018,0.0,137139.75,1174242.0899999992,2018,8,27,CHECK_CASHING,137139.75,M1468343491
1079,409000493201',2018-08-28,BBPS DT 28082018,0.0,58964.84,1233206.929999999,2018,8,28,CASH_IN,58964.84,M2114537280
1080,409000493201',2018-08-29,BBPS DT 29082018,0.0,71493.16,1304700.0899999992,2018,8,29,CHECK_CASHING,71493.16,M80499834
1081,409000493201',2018-08-30,BBPS DT 30082018,64428.81,0.0,1240271.2799999989,2018,8,30,DEBIT,64428.81,C367746789
1082,409000493201',2018-08-31,BBPS DT 31082018,0.0,8238.05,1248509.3299999991,2018,8,31,CHECK_CASHING,8238.05,M898695324
1083,409000493201',2018-09-01,BBPS DT 01092018,0.0,93996.73,1342506.0599999991,2018,9,1,CASH_IN,93996.73,M190628410
1084,409000493201',2018-09-03,BBPS DT 02092018,0.0,159127.05,1501633.1099999992,2018,9,3,CHECK_CASHING,159127.05,C1590550415
1085,409000493201',2018-09-03,BBPS DT 03092018,0.0,233904.54,1735537.649999999,2018,9,3,TRANSFER,233904.54,M1972326147
1086,409000493201',2018-09-03,TRF TO  Indiaforensic SERVICES I,1000000.0,0.0,735537.6499999991,2018,9,3,CASH_OUT,1000000.0,M1764291958
1087,409000493201',2018-09-04,BBPS DT 04092018,0.0,148802.0,884339.6499999991,2018,9,4,CASH_IN,148802.0,M1777745301
1088,409000493201',2018-09-05,BBPS DT 05092018,0.0,79407.4,963747.0499999992,2018,9,5,CASH_IN,79407.4,M669053685
1089,409000493201',2018-09-06,BBPS DT 06092018,0.0,102541.01,1066288.0599999991,2018,9,6,TRANSFER,102541.01,M1840670774
1090,409000493201',2018-09-07,BBPS DT 07092018,0.0,121975.46,1188263.5199999989,2018,9,7,CASH_IN,121975.46,M769877691
1091,409000493201',2018-09-07,TRF TO  Indiaforensic SERVICES I,1000000.0,0.0,188263.51999999885,2018,9,7,PAYEMENT,1000000.0,M1637876401
1092,409000493201',2018-09-10,BBPS DT 08092018,0.0,68254.49,256518.0099999989,2018,9,10,TRANSFER,68254.49,M2014233765
1093,409000493201',2018-09-10,BBPS DT 09092018,0.0,179898.57,436416.5799999989,2018,9,10,TRANSFER,179898.57,M1869673263
1094,409000493201',2018-09-10,BBPS DT 10092018,0.0,102201.02,538617.5999999988,2018,9,10,CHECK_CASHING,102201.02,M1521204009
1095,409000493201',2018-09-11,BBPS DT 11092018,62249.74,0.0,476367.8599999988,2018,9,11,CASH_OUT,62249.74,M449338124
1096,409000493201',2018-09-12,BBPS DT 12092018,0.0,80279.07,556646.9299999988,2018,9,12,CASH_IN,80279.07,C392292416
1097,409000493201',2018-09-13,BBPS DT 13092018,0.0,60012.23,616659.1599999989,2018,9,13,CASH_IN,60012.23,C1671179293
1098,409000493201',2018-09-14,BBPS DT 14092018,0.0,125122.85,741782.0099999987,2018,9,14,CHECK_CASHING,125122.85,M1504083002
1099,409000493201',2018-09-15,BBPS DT 15092018,0.0,120905.14,862687.1499999987,2018,9,15,CHECK_CASHING,120905.14,C1948471365
1100,409000493201',2018-09-17,BBPS DT 17092018,938.84,0.0,861748.3099999988,2018,9,17,DEBIT,938.84,M24097622
1101,409000493201',2018-09-17,BBPS DT 16092018,0.0,113977.87,975726.1799999988,2018,9,17,TRANSFER,113977.87,M598325842
1102,409000493201',2018-09-17,TRF TO  Indiaforensic SERVICES I,900000.0,0.0,75726.17999999879,2018,9,17,CASH_OUT,900000.0,C728885526
1103,409000493201',2018-09-18,BBPS DT 18092018,6542.73,0.0,69183.44999999877,2018,9,18,PAYEMENT,6542.73,C1123629720
1104,409000493201',2018-09-19,BBPS DT 19092018,0.0,156502.39,225685.8399999988,2018,9,19,TRANSFER,156502.39,M1732410217
1105,409000493201',2018-09-20,BBPS DT 20092018,0.0,161689.32,387375.1599999988,2018,9,20,CHECK_CASHING,161689.32,C716083600
1106,409000493201',2018-09-21,BBPS DT 21092018,0.0,192331.28,579706.4399999988,2018,9,21,CASH_IN,192331.28,M1693997031
1107,409000493201',2018-09-24,BBPS DT 23092018,100527.62,0.0,479178.8199999989,2018,9,24,DEBIT,100527.62,M1489322191
1108,409000493201',2018-09-24,BBPS DT 22092018,0.0,13361.85,492540.6699999988,2018,9,24,CHECK_CASHING,13361.85,M461516748
1109,409000493201',2018-09-24,BBPS DT 24092018,63048.84,0.0,429491.8299999989,2018,9,24,CASH_OUT,63048.84,M1443900956
1110,409000493201',2018-09-25,BBPS DT 25092018,202530.64,0.0,226961.18999999878,2018,9,25,PAYEMENT,202530.64,M2032647583
1111,409000493201',2018-09-26,BBPS DT 26092018,0.0,49876.46,276837.6499999988,2018,9,26,CASH_IN,49876.46,C557041912
1112,409000493201',2018-09-27,BBPS DT 27092018,0.0,67155.84,343993.48999999877,2018,9,27,CHECK_CASHING,67155.84,C240650537
1113,409000493201',2018-09-28,BBPS  DT 28092018,0.0,277871.07,621864.5599999989,2018,9,28,CASH_IN,277871.07,C1254526270
1114,409000493201',2018-09-28,TRF TO  Indiaforensic SERVICES I,500000.0,0.0,121864.55999999885,2018,9,28,DEBIT,500000.0,M1374982240
1115,409000493201',2018-09-29,FDRL/INTERNAL FUND TRANSFE,0.0,100000.0,221864.5599999989,2018,9,29,TRANSFER,100000.0,C1136419747
1116,409000493201',2018-09-29,BBPS  DT 29092018,127682.12,0.0,94182.43999999893,2018,9,29,DEBIT,127682.12,C1983025922
1117,409000493201',2018-10-01,BBPS  DT 30092018,0.0,244133.61,338316.0499999989,2018,10,1,TRANSFER,244133.61,M485686996
1118,409000493201',2018-10-01,BBPS  DT 01102018,0.0,254293.54,592609.5899999989,2018,10,1,CHECK_CASHING,254293.54,C1526298704
1119,409000493201',2018-10-03,BBPS DT 02102018,0.0,202370.4,794979.9899999991,2018,10,3,CASH_IN,202370.4,C985934102
1120,409000493201',2018-10-03,BBPS DT 03102018,0.0,314101.5,1109081.4899999988,2018,10,3,TRANSFER,314101.5,C1096283470
1121,409000493201',2018-10-04,BBPS DT 04102018,0.0,233096.74,1342178.2299999988,2018,10,4,CHECK_CASHING,233096.74,M1535116392
1122,409000493201',2018-10-04,TRF TO  Indiaforensic SERVICES I,1000000.0,0.0,342178.2299999988,2018,10,4,PAYEMENT,1000000.0,M2115640742
1123,409000493201',2018-10-05,BBPS DT 05102018,0.0,250778.13,592956.3599999988,2018,10,5,CASH_IN,250778.13,C248609774
1124,409000493201',2018-10-05,TRF TO  Indiaforensic SERVICES I,400000.0,0.0,192956.3599999988,2018,10,5,CASH_OUT,400000.0,C1122805102
1125,409000493201',2018-10-06,BBPS DT 06102018,0.0,235850.74,428807.0999999988,2018,10,6,CASH_IN,235850.74,C793315160
1126,409000493201',2018-10-08,BBPS DT 07102018,0.0,276293.62,705100.7199999988,2018,10,8,CHECK_CASHING,276293.62,M1611221523
1127,409000493201',2018-10-08,BBPS DT 08102018,0.0,358259.54,1063360.2599999988,2018,10,8,CHECK_CASHING,358259.54,M473073770
1128,409000493201',2018-10-09,BBPS DT 09102018,0.0,130070.96,1193431.2199999988,2018,10,9,CHECK_CASHING,130070.96,C1049817027
1129,409000493201',2018-10-09,TRF TO  Indiaforensic SERVICES I,800000.0,0.0,393431.2199999988,2018,10,9,PAYEMENT,800000.0,C1360767589
1130,409000493201',2018-10-10,BBPS DT 10102018,0.0,200021.22,593452.4399999988,2018,10,10,TRANSFER,200021.22,M893835279
1131,409000493201',2018-10-11,BBPS DT 11102018,0.0,242343.57,835796.0099999987,2018,10,11,CHECK_CASHING,242343.57,M57085696
1132,409000493201',2018-10-11,TRF TO  Indiaforensic SERVICES I,600000.0,0.0,235796.0099999989,2018,10,11,DEBIT,600000.0,M1185618138
1133,409000493201',2018-10-12,BBPS DT 12102018,0.0,263821.96,499617.9699999989,2018,10,12,TRANSFER,263821.96,M1109752797
1134,409000493201',2018-10-15,BBPS DT 13102018,0.0,324167.89,823785.8599999989,2018,10,15,CASH_IN,324167.89,M1752856108
1135,409000493201',2018-10-15,BBPS DT 14102018,0.0,303093.88,1126879.7399999988,2018,10,15,TRANSFER,303093.88,M1933328958
1136,409000493201',2018-10-15,BBPS DT 15102018,0.0,322041.12,1448920.8599999992,2018,10,15,TRANSFER,322041.12,M1888639813
1137,409000493201',2018-10-15,TRF TO  Indiaforensic SERVICES I,1000000.0,0.0,448920.8599999989,2018,10,15,CASH_OUT,1000000.0,M178401052
1138,409000493201',2018-10-16,BBPS DT 16102018,0.0,151770.46,600691.3199999989,2018,10,16,CHECK_CASHING,151770.46,M936219350
1139,409000493201',2018-10-17,BBPS DT 17102018,0.0,267790.01,868481.3299999989,2018,10,17,CHECK_CASHING,267790.01,M1113829504
1140,409000493201',2018-10-17,TRF TO  Indiaforensic SERVICES I,500000.0,0.0,368481.3299999989,2018,10,17,CHECK_WITHDRAWAL,500000.0,M1911978617
1141,409000493201',2018-10-18,BBPS DT 18102018,0.0,253166.77,621648.0999999989,2018,10,18,CASH_IN,253166.77,C1961176822
1142,409000493201',2018-10-18,TRF TO  Indiaforensic SERVICES I,400000.0,0.0,221648.0999999989,2018,10,18,CASH_OUT,400000.0,M2022285740
1143,409000493201',2018-10-19,BBPS DT 19102018,0.0,336915.95,558564.0499999989,2018,10,19,TRANSFER,336915.95,M1593368350
1144,409000493201',2018-10-20,BBPS DT 20102018,0.0,349274.16,907838.2099999988,2018,10,20,CHECK_CASHING,349274.16,C673068808
1145,409000493201',2018-10-22,BBPS DT 21102018,0.0,307784.5,1215622.7099999988,2018,10,22,CHECK_CASHING,307784.5,C1831477404
1146,409000493201',2018-10-22,BBPS DT 22102018,0.0,416939.17,1632561.8799999987,2018,10,22,CASH_IN,416939.17,C1629911510
1147,409000493201',2018-10-22,TRF TO  Indiaforensic SERVICES I,1300000.0,0.0,332561.8799999987,2018,10,22,CASH_OUT,1300000.0,C22805895
1148,409000493201',2018-10-23,BBPS DT 23102018,0.0,267929.89,600491.7699999986,2018,10,23,CASH_IN,267929.89,C1123629720
1149,409000493201',2018-10-24,BBPS DT 24102018,0.0,76371.19,676862.9599999988,2018,10,24,CASH_IN,76371.19,C998351292
1150,409000493201',2018-10-25,BBPS DT 25102018,0.0,295669.35,972532.3099999988,2018,10,25,TRANSFER,295669.35,C977993101
1151,409000493201',2018-10-25,TRF TO  Indiaforensic SERVICES I,600000.0,0.0,372532.30999999883,2018,10,25,CHECK_WITHDRAWAL,600000.0,C1782580546
1152,409000493201',2018-10-26,BBPS DT 26102018,0.0,126310.53,498842.8399999988,2018,10,26,CHECK_CASHING,126310.53,C1973538135
1153,409000493201',2018-10-29,BBPS DT 27102018,0.0,198833.67,697676.5099999988,2018,10,29,CASH_IN,198833.67,C1883840933
1154,409000493201',2018-10-29,BBPS DT 28102018,0.0,282479.1,980155.6099999987,2018,10,29,CASH_IN,282479.1,C453211571
1155,409000493201',2018-10-29,BBPS DT 29102018,0.0,330885.85,1311041.4599999988,2018,10,29,TRANSFER,330885.85,C1688019098
1156,409000493201',2018-10-29,TRF TO  Indiaforensic SERVICES I,1000000.0,0.0,311041.4599999988,2018,10,29,CASH_OUT,1000000.0,C1789550256
1157,409000493201',2018-10-30,BBPS DT 30102018,0.0,15113.17,326154.6299999988,2018,10,30,CASH_IN,15113.17,C1286084959
1158,409000493201',2018-10-31,BBPS DT 31102018,0.0,57953.44,384108.0699999989,2018,10,31,TRANSFER,57953.44,C1782113663
1159,409000493201',2018-11-01,BBPS DT 01112018,0.0,290256.64,674364.7099999988,2018,11,1,CHECK_CASHING,290256.64,C1023714065
1160,409000493201',2018-11-02,BBPS DT 02112018,0.0,355637.06,1030001.7699999987,2018,11,2,CHECK_CASHING,355637.06,C564160838
1161,409000493201',2018-11-03,BBPS DT 03112018,0.0,282568.29,1312570.0599999991,2018,11,3,CHECK_CASHING,282568.29,C1225616405
1162,409000493201',2018-11-05,BBPS DT 04112018,0.0,354950.17,1667520.2299999988,2018,11,5,CHECK_CASHING,354950.17,C1750905143
1163,409000493201',2018-11-05,BBPS DT 05112018,0.0,545436.19,2212956.419999999,2018,11,5,CHECK_CASHING,545436.19,C453211571
1164,409000493201',2018-11-06,BBPS DT 06112018,0.0,182964.6,2395921.019999999,2018,11,6,CASH_IN,182964.6,C1782113663
1165,409000493201',2018-11-06,TRF TO  Indiaforensic SERVICES I,2000000.0,0.0,395921.0199999991,2018,11,6,CHECK_WITHDRAWAL,2000000.0,C1318822808
1166,409000493201',2018-11-07,BBPS DT 07112018,0.0,471757.52,867678.5399999991,2018,11,7,CHECK_CASHING,471757.52,C1318822808
1167,409000493201',2018-11-08,BBPS DT 08112018,0.0,375507.73,1243186.269999999,2018,11,8,CHECK_CASHING,375507.73,M1746578747
1168,409000493201',2018-11-09,BBPS DT 09112018,0.0,506473.63,1749659.899999999,2018,11,9,CHECK_CASHING,506473.63,M606593028
1169,409000493201',2018-11-12,BBPS DT 10112018,0.0,352561.1,2102220.999999999,2018,11,12,CHECK_CASHING,352561.1,C1018298342
1170,409000493201',2018-11-12,BBPS DT 11112018,0.0,290327.23,2392548.229999999,2018,11,12,TRANSFER,290327.23,M6559830
1171,409000493201',2018-11-12,BBPS DT 12112018,0.0,419224.8,2811773.029999999,2018,11,12,CASH_IN,419224.8,C846947180
1172,409000493201',2018-11-12,TRF TO  Indiaforensic SERVICES I,2500000.0,0.0,311773.0299999989,2018,11,12,DEBIT,2500000.0,C985934102
1173,409000493201',2018-11-13,BBPS DT 13112008,0.0,163109.39,474882.4199999989,2018,11,13,CASH_IN,163109.39,M1982958205
1174,409000493201',2018-11-14,BBPS DT 14112008,0.0,370836.7,845719.1199999991,2018,11,14,CHECK_CASHING,370836.7,M846718105
1175,409000493201',2018-11-14,TRF TO  Indiaforensic SERVICES I,500000.0,0.0,345719.1199999989,2018,11,14,CHECK_WITHDRAWAL,500000.0,M583015088
1176,409000493201',2018-11-15,BBPS DT 15112008,0.0,375417.76,721136.8799999991,2018,11,15,CASH_IN,375417.76,M1280128554
1177,409000493201',2018-11-15,TRF TO  Indiaforensic SERVICES I,500000.0,0.0,221136.87999999896,2018,11,15,PAYEMENT,500000.0,M1991724700
1178,409000493201',2018-11-16,BBPS DT 16112008,0.0,379555.15,600692.029999999,2018,11,16,TRANSFER,379555.15,M145455292
1179,409000493201',2018-11-16,TRF TO  Indiaforensic SERVICES I,500000.0,0.0,100692.02999999898,2018,11,16,DEBIT,500000.0,C662736689
1180,409000493201',2018-11-17,BBPS DT 17112008,0.0,322009.05,422701.07999999897,2018,11,17,CASH_IN,322009.05,M744316958
1181,409000493201',2018-11-19,BBPS DT 18112018,0.0,500434.76,923135.8399999988,2018,11,19,TRANSFER,500434.76,C1531333864
1182,409000493201',2018-11-19,BBPS DT 19112018,0.0,481280.06,1404415.899999999,2018,11,19,CHECK_CASHING,481280.06,M1215029765
1183,409000493201',2018-11-20,BBPS DT 20112008,0.0,436410.64,1840826.539999999,2018,11,20,TRANSFER,436410.64,M1962398162
1184,409000493201',2018-11-20,TRF TO  Indiaforensic SERVICES I,1700000.0,0.0,140826.5399999991,2018,11,20,DEBIT,1700000.0,C85777802
1185,409000493201',2018-11-21,BBPS DT 21112008,0.0,295177.19,436003.72999999905,2018,11,21,CHECK_CASHING,295177.19,M1516417700
1186,409000493201',2018-11-22,BBPS DT 22112008,0.0,426704.94,862708.6699999991,2018,11,22,TRANSFER,426704.94,M891894789
1187,409000493201',2018-11-22,TRF TO  Indiaforensic SERVICES I,600000.0,0.0,262708.6699999991,2018,11,22,DEBIT,600000.0,M766696861
1188,409000493201',2018-11-23,BBPS DT 23112008,0.0,423446.49,686155.1599999991,2018,11,23,CHECK_CASHING,423446.49,M1296109622
1189,409000493201',2018-11-26,BBPS DT 24112018,0.0,398309.17,1084464.3299999991,2018,11,26,CASH_IN,398309.17,M1103017075
1190,409000493201',2018-11-26,BBPS DT 25112018,0.0,313533.71,1397998.039999999,2018,11,26,TRANSFER,313533.71,M318794136
1191,409000493201',2018-11-26,BBPS DT 26112018,0.0,463841.24,1861839.279999999,2018,11,26,TRANSFER,463841.24,M55755528
1192,409000493201',2018-11-26,TRF TO  Indiaforensic SERVICES I,1700000.0,0.0,161839.2799999991,2018,11,26,DEBIT,1700000.0,M1835778392
1193,409000493201',2018-11-27,BBPS DT 27112008,0.0,288502.17,450341.4499999991,2018,11,27,TRANSFER,288502.17,M268599241
1194,409000493201',2018-11-28,BBPS DT 28112008,0.0,260361.75,710703.199999999,2018,11,28,CHECK_CASHING,260361.75,M1736293769
1195,409000493201',2018-11-29,BBPS DT 29112008,0.0,426237.52,1136940.719999999,2018,11,29,CHECK_CASHING,426237.52,C716083600
1196,409000493201',2018-11-29,TRF TO  Indiaforensic SERVICES I,1000000.0,0.0,136940.71999999904,2018,11,29,CHECK_WITHDRAWAL,1000000.0,C1335050193
1197,409000493201',2018-11-30,BBPS DT 30112008,0.0,335997.77,472938.48999999906,2018,11,30,CASH_IN,335997.77,C1526298704
1198,409000493201',2018-12-01,BBPS DT 01122008,0.0,268923.12,741861.609999999,2018,12,1,CHECK_CASHING,268923.12,C1782113663
1199,409000493201',2018-12-03,BBPS DT 02122008,0.0,271416.97,1013278.579999999,2018,12,3,CHECK_CASHING,271416.97,C985934102
1200,409000493201',2018-12-03,BBPS DT 03122008,0.0,291149.66,1304428.239999999,2018,12,3,TRANSFER,291149.66,C2083562754
1201,409000493201',2018-12-03,TRF TO  Indiaforensic SERVICES I,1200000.0,0.0,104428.23999999906,2018,12,3,DEBIT,1200000.0,C401424608
1202,409000493201',2018-12-04,BBPS DT 04122008,0.0,360370.52,464798.7599999991,2018,12,4,CASH_IN,360370.52,C1789550256
1203,409000493201',2018-12-05,BBPS DT 05122008,0.0,315346.66,780145.4199999991,2018,12,5,CHECK_CASHING,315346.66,C1782113663
1204,409000493201',2018-12-05,FDRL/INTERNAL FUND TRANSFE,0.0,200000.0,980145.4199999992,2018,12,5,TRANSFER,200000.0,C2094777811
1205,409000493201',2018-12-05,FDRL/INTERNAL FUND TRANSFE,0.0,300000.0,1280145.419999999,2018,12,5,CASH_IN,300000.0,C660143728
1206,409000493201',2018-12-05,TRF TO  Indiaforensic SERVICES I,500000.0,0.0,780145.4199999991,2018,12,5,CHECK_WITHDRAWAL,500000.0,C451111351
1207,409000493201',2018-12-06,BBPS DT 06122008,0.0,403296.6,1183442.019999999,2018,12,6,CASH_IN,403296.6,C1262822392
1208,409000493201',2018-12-07,BBPS DT 06122008,0.0,615753.17,1799195.189999999,2018,12,7,TRANSFER,615753.17,C998351292
1209,409000493201',2018-12-07,TRF TO  Indiaforensic SERVICES I,1500000.0,0.0,299195.189999999,2018,12,7,CASH_OUT,1500000.0,C392292416
1210,409000493201',2018-12-10,BBPS DT 08122018,0.0,515462.82,814658.0099999991,2018,12,10,CHECK_CASHING,515462.82,C451111351
1211,409000493201',2018-12-10,BBPS DT 09122018,0.0,193681.75,1008339.7599999992,2018,12,10,TRANSFER,193681.75,C401424608
1212,409000493201',2018-12-10,BBPS DT 10122018,0.0,439890.04,1448229.799999999,2018,12,10,TRANSFER,439890.04,C977993101
1213,409000493201',2018-12-10,TRF TO  Indiaforensic SERVICES I,1200000.0,0.0,248229.79999999912,2018,12,10,CASH_OUT,1200000.0,C1234776885
1214,409000493201',2018-12-11,BBPS DT 11122008,0.0,245690.74,493920.53999999905,2018,12,11,TRANSFER,245690.74,C998351292
1215,409000493201',2018-12-12,BBPS DT 12122018,0.0,361675.89,855596.4299999991,2018,12,12,CHECK_CASHING,361675.89,M1418315639
1216,409000493201',2018-12-13,BBPS DT 13122008,0.0,126219.22,981815.6499999992,2018,12,13,CASH_IN,126219.22,C1810132623
1217,409000493201',2018-12-13,TRF TO  Indiaforensic SERVICES I,800000.0,0.0,181815.6499999991,2018,12,13,PAYEMENT,800000.0,C2001112025
1218,409000493201',2018-12-14,BBPS DT 14122018,0.0,467994.77,649810.4199999991,2018,12,14,CHECK_CASHING,467994.77,M1381857776
1219,409000493201',2018-12-15,BBPS DT 15122018,0.0,474113.93,1123924.3499999992,2018,12,15,CHECK_CASHING,474113.93,C1360767589
1220,409000493201',2018-12-17,BBPS DT 17122018,0.0,518230.79,1642155.139999999,2018,12,17,CASH_IN,518230.79,C998351292
1221,409000493201',2018-12-17,BBPS DT 16122018,0.0,512680.61,2154835.749999999,2018,12,17,TRANSFER,512680.61,C306206744
1222,409000493201',2018-12-17,TRF TO  Indiaforensic SERVICES I,2000000.0,0.0,154835.74999999907,2018,12,17,CHECK_WITHDRAWAL,2000000.0,C1688019098
1223,409000493201',2018-12-18,BBPS DT 18122018,0.0,148602.58,303438.32999999897,2018,12,18,TRANSFER,148602.58,C747464370
1224,409000493201',2018-12-19,BBPS DT 19122018,0.0,193871.01,497309.339999999,2018,12,19,CASH_IN,193871.01,C716083600
1225,409000493201',2018-12-20,BBPS DT 20122018,2547.6,0.0,494761.73999999906,2018,12,20,DEBIT,2547.6,C401424608
1226,409000493201',2018-12-20,BBPS DT 20122018,0.0,183822.29,678584.0299999991,2018,12,20,CASH_IN,183822.29,C614685048
1227,409000493201',2018-12-20,TRF TO  Indiaforensic SERVICES I,500000.0,0.0,178584.0299999991,2018,12,20,PAYEMENT,500000.0,C248609774
1228,409000493201',2018-12-21,BBPS DT 21122018,0.0,86250.63,264834.6599999991,2018,12,21,CHECK_CASHING,86250.63,C932583850
1229,409000493201',2018-12-24,BBPS DT 23122018,182440.81,0.0,82393.8499999991,2018,12,24,CASH_OUT,182440.81,C665576141
1230,409000493201',2018-12-24,BBPS DT 22122018,3261.88,0.0,79131.9699999991,2018,12,24,PAYEMENT,3261.88,C1234776885
1231,409000493201',2018-12-24,FDRL/INTERNAL FUND TRANSFE,0.0,100000.0,179131.9699999991,2018,12,24,CASH_IN,100000.0,C306206744
1232,409000493201',2018-12-24,BBPS DT24122018  IMPS GL,99820.78,0.0,79311.1899999991,2018,12,24,PAYEMENT,99820.78,M1092619788
1233,409000493201',2018-12-26,FDRL/INTERNAL FUND TRANSFE,0.0,300000.0,379311.1899999991,2018,12,26,TRANSFER,300000.0,M1337835760
1234,409000493201',2018-12-26,FDRL/INTERNAL FUND TRANSFE,0.0,300000.0,679311.189999999,2018,12,26,CHECK_CASHING,300000.0,M1807911555
1235,409000493201',2018-12-26,BBPS DT 26122018,214821.75,0.0,464489.4399999991,2018,12,26,CASH_OUT,214821.75,C564160838
1236,409000493201',2018-12-26,BBPS DT 25122018,242437.03,0.0,222052.40999999913,2018,12,26,DEBIT,242437.03,C747464370
1237,409000493201',2018-12-27,FDRL/INTERNAL FUND TRANSFE,0.0,100000.0,322052.4099999991,2018,12,27,CASH_IN,100000.0,C401424608
1238,409000493201',2018-12-27,BBPS DT 27122018,209147.76,0.0,112904.64999999908,2018,12,27,PAYEMENT,209147.76,C488044861
1239,409000493201',2018-12-28,FDRL/INTERNAL FUND TRANSFE,0.0,200000.0,312904.6499999991,2018,12,28,TRANSFER,200000.0,C195600860
1240,409000493201',2018-12-28,BBPS DT 28122018,200080.84,0.0,112823.8099999991,2018,12,28,CHECK_WITHDRAWAL,200080.84,C1112414583
1241,409000493201',2018-12-28,FDRL/INTERNAL FUND TRANSFE,0.0,300000.0,412823.80999999907,2018,12,28,CHECK_CASHING,300000.0,C33524623
1242,409000493201',2018-12-29,BBPS DT 29122018,146825.27,0.0,265998.5399999991,2018,12,29,CHECK_WITHDRAWAL,146825.27,M2047744862
1243,409000493201',2018-12-31,FDRL/INTERNAL FUND TRANSFE,0.0,100000.0,365998.53999999905,2018,12,31,CHECK_CASHING,100000.0,M389779746
1244,409000493201',2018-12-31,BBPS DT 30122018,117494.93,0.0,248503.6099999991,2018,12,31,CASH_OUT,117494.93,M1984328477
1245,409000493201',2018-12-31,BBPS DT 31122018,50376.69,0.0,198126.9199999991,2018,12,31,CASH_OUT,50376.69,M991671211
1246,409000493201',2018-12-31,FDRL/INTERNAL FUND TRANSFE,0.0,200000.0,398126.91999999905,2018,12,31,CHECK_CASHING,200000.0,M1086323658
1247,409000425051',2018-04-07,IMPS 809712134438 FROM OX,0.0,10000.0,,2018,4,7,CHECK_CASHING,10000.0,M1118414398
1248,409000425051',2018-07-12,TRF TO  Indiaforensic SERVICES I,100000.0,0.0,,2018,7,12,CHECK_WITHDRAWAL,100000.0,C1219161283
1249,409000425051',2018-10-26,TRF TO Rajendra Kumar,15000000.0,0.0,,2018,10,26,CASH_OUT,15000000.0,C564160838
1250,409000425051',2018-10-26,TRF FROM  Indiaforensic SERVICES,0.0,15000000.0,,2018,10,26,CASH_IN,15000000.0,C824208363
1251,409000425051',2018-10-31,TRF TO  Myur Joshi,354000000.0,0.0,,2018,10,31,CHECK_WITHDRAWAL,354000000.0,M238874235
1252,409000425051',2018-10-31,TRF TO  Indiaforensic SERVICES I,900000.0,0.0,,2018,10,31,DEBIT,900000.0,M112797307
1253,409000425051',2018-10-31,409000425051:Int.Coll:01-,81569.0,0.0,,2018,10,31,DEBIT,81569.0,M699221219
1254,409000425051',2018-11-27,TRF FROM  Indiaforensic SERVICES,0.0,81568.0,,2018,11,27,TRANSFER,81568.0,C564160838
1255,409000425051',2018-11-27,TRF FROM  Indiaforensic SERVICES,0.0,10000.0,,2018,11,27,TRANSFER,10000.0,C824208363
1256,409000425051',2018-11-30,409000425051:Int.Coll:01-,2447599.0,0.0,,2018,11,30,CASH_OUT,2447599.0,M238874235
1257,409000425051',2018-12-17,TRF FRM  Indiaforensic SERVICES,0.0,2447600.0,,2018,12,17,CASH_IN,2447600.0,C838411509
1258,409000425051',2018-12-31,409000425051:Int.Coll:01-,2539665.0,0.0,,2018,12,31,DEBIT,2539665.0,M127356954
1259,409000405747',2018-04-07,IMPS 809712134386 FROM OX,0.0,10000.0,20294.199999990466,2018,4,7,TRANSFER,10000.0,M1475842502
1260,409000405747',2018-09-24,FUNDS TRF  Indiaforensic SERVICE,10000000.0,0.0,,2018,9,24,CHECK_WITHDRAWAL,10000000.0,C2083562754
1261,409000405747',2018-09-24,FUNDS TRF Riskpro,15000000.0,0.0,,2018,9,24,PAYEMENT,15000000.0,C838411509
1262,409000405747',2018-09-24,TRF TO  Riskpro Management,1000000.0,0.0,,2018,9,24,DEBIT,1000000.0,C1023714065
1263,409000405747',2018-09-24,TRF TO  Riskpro Management Consulting,10000000.0,0.0,,2018,9,24,DEBIT,10000000.0,C1750905143
1264,409000405747',2018-09-25,TRF TO  Rikpro Mgmt cons,15000000.0,0.0,,2018,9,25,CASH_OUT,15000000.0,C1219161283
1265,409000405747',2018-09-25,TRF TO  Reskpo Managemnt,10000000.0,0.0,,2018,9,25,PAYEMENT,10000000.0,C1359044626
1266,409000405747',2018-09-26,TRF TO  Riskpro Management,5800000.0,0.0,,2018,9,26,DEBIT,5800000.0,C97730845
1267,409000405747',2018-09-26,TRF TO  Riskpro Management,13100000.0,0.0,,2018,9,26,CASH_OUT,13100000.0,C1816757085
1268,409000405747',2018-09-27,TRF TO  Indiaforensic SERVICES I,7100000.0,0.0,,2018,9,27,CHECK_WITHDRAWAL,7100000.0,C367746789
1269,409000405747',2018-09-28,Payments For : 9090000577,103020294.2,0.0,,2018,9,28,CASH_OUT,103020294.2,C306206744
1270,409000405747',2018-09-29,TRF TO  Indiaforensic SERVICES I,5000000.0,0.0,,2018,9,29,DEBIT,5000000.0,C998351292
1271,409000405747',2018-09-30,409000405747:Int.Coll:01-,236963.0,0.0,,2018,9,30,CHECK_WITHDRAWAL,236963.0,C564160838
1272,409000405747',2018-10-09,TRF FROM  Indiaforensic SERVICES,0.0,250000.0,,2018,10,9,CHECK_CASHING,250000.0,C2083562754
1273,409000405747',2018-10-10,TRF FROM  Indiaforensic SERVICES,0.0,5000000.0,,2018,10,10,TRANSFER,5000000.0,C838411509
1274,409000405747',2018-10-11,TRF TO  Indiaforensic SERVICES I,10000000.0,0.0,,2018,10,11,CHECK_WITHDRAWAL,10000000.0,C1023714065
1275,409000405747',2018-10-31,409000405747:Int.Coll:01-,1727846.0,0.0,,2018,10,31,DEBIT,1727846.0,C1750905143
1276,409000405747',2018-11-27,TRF FROM  Indiaforensic SERVICES,0.0,1727846.0,,2018,11,27,CASH_IN,1727846.0,C2083562754
1277,409000405747',2018-11-30,409000405747:Int.Coll:01-,1703165.0,0.0,,2018,11,30,CHECK_WITHDRAWAL,1703165.0,C838411509
1278,409000405747',2018-12-19,TRF FROM  Indiaforensic SERVICES,0.0,1704000.0,,2018,12,19,CASH_IN,1704000.0,C1023714065
1279,409000405747',2018-12-24,FDRL/INTERNAL FUND TRANSFE,0.0,7500000.0,,2018,12,24,CASH_IN,7500000.0,C1750905143
1280,409000405747',2018-12-24,FDRL/INTERNAL FUND TRANSFE,0.0,500000.0,,2018,12,24,CASH_IN,500000.0,C392292416
1281,409000405747',2018-12-24,FDRL/INTERNAL FUND TRANSFE,0.0,2000000.0,,2018,12,24,CASH_IN,2000000.0,C564160838
1282,409000405747',2018-12-31,409000405747:Int.Coll:01-,1751799.0,0.0,,2018,12,31,PAYEMENT,1751799.0,C1060830840
1283,409000438611',2018-01-01,Indiaforensic VISA ACQ DOM311217,0.0,416.0,267014.9499999909,2018,1,1,CHECK_CASHING,416.0,C2083562754
1284,409000438611',2018-01-01,Indiaforensic RUPAY POS ACQ31121,0.0,888110.76,1155125.7099999909,2018,1,1,TRANSFER,888110.76,C1831477404
1285,409000438611',2018-01-01,Indiaforensic VISA ACQ INT 31121,0.0,989.0,1156114.7099999909,2018,1,1,CASH_IN,989.0,C248609774
1286,409000438611',2018-01-01,Indiaforensic RUPAY POS ACQ01011,0.0,1636631.26,2792745.969999991,2018,1,1,CHECK_CASHING,1636631.26,C875917495
1287,409000438611',2018-01-01,Indiaforensic VISA ACQ DOM010118,0.0,1721285.9,4514031.869999991,2018,1,1,TRANSFER,1721285.9,C832279283
1288,409000438611',2018-01-01,TRF TO  Indiaforensic SERVICES I,500000.0,0.0,4014031.8699999913,2018,1,1,PAYEMENT,500000.0,C1948471365
1289,409000438611',2018-01-01,TRF TO  Indiaforensic SERVICES I,4000000.0,0.0,14031.8699999908,2018,1,1,CASH_OUT,4000000.0,C1973538135
1290,409000438611',2018-01-01,Indiaforensic VISA ACQ INT 30121,0.0,3827.85,17859.719999990797,2018,1,1,CHECK_CASHING,3827.85,C1531333864
1291,409000438611',2018-01-02,Indiaforensic MASTER ACQ DOM0201,0.0,403189.87,421049.58999999077,2018,1,2,TRANSFER,403189.87,C1060830840
1292,409000438611',2018-01-02,Indiaforensic MASTER ACQ DOM0101,0.0,1198136.95,1619186.539999991,2018,1,2,CASH_IN,1198136.95,C11003494
1293,409000438611',2018-01-02,Indiaforensic MASTER ACQ DOM3012,0.0,576699.94,2195886.479999991,2018,1,2,CHECK_CASHING,576699.94,C11003494
1294,409000438611',2018-01-02,Indiaforensic VISA ACQ DOM020118,19630.0,0.0,2176256.479999991,2018,1,2,CHECK_WITHDRAWAL,19630.0,C660143728
1295,409000438611',2018-01-02,Indiaforensic RUPAY POS ACQ02011,0.0,1716570.64,3892827.1199999913,2018,1,2,TRANSFER,1716570.64,C998351292
1296,409000438611',2018-01-02,Indiaforensic MASTER ACQ DOM REV,666.5,0.0,3892160.6199999913,2018,1,2,CHECK_WITHDRAWAL,666.5,C1590550415
1297,409000438611',2018-01-02,Indiaforensic MASTER ACQ DOM REV,0.99,0.0,3892159.629999991,2018,1,2,CASH_OUT,0.99,C985934102
1298,409000438611',2018-01-03,TRF TO  Indiaforensic SERVICES I,3000000.0,0.0,892159.6299999906,2018,1,3,CASH_OUT,3000000.0,C1182461167
1299,409000438611',2018-01-03,TRF TO  Indiaforensic SERVICES I,500000.0,0.0,392159.6299999906,2018,1,3,CASH_OUT,500000.0,C1291286504
1300,409000438611',2018-01-03,Indiaforensic MASTER ACQ DOM0301,0.0,543996.35,936155.9799999908,2018,1,3,CASH_IN,543996.35,C1291286504
1301,409000438611',2018-01-03,Indiaforensic VISA ACQ DOM030118,0.0,645063.95,1581219.9299999904,2018,1,3,CHECK_CASHING,645063.95,C1961176822
1302,409000438611',2018-01-03,Indiaforensic RUPAY POS ACQ03011,0.0,1549720.45,3130940.3799999906,2018,1,3,CHECK_CASHING,1549720.45,C564160838
1303,409000438611',2018-01-03,TRF TO  Indiaforensic SERVICES I,3100000.0,0.0,30940.379999990568,2018,1,3,DEBIT,3100000.0,C564160838
1304,409000438611',2018-01-03,Indiaforensic MASTER INT SET 020,0.0,1009.17,31949.549999990566,2018,1,3,CHECK_CASHING,1009.17,C1182461167
1305,409000438611',2018-01-04,Indiaforensic MASTER ACQ DOM0401,0.0,574006.46,605956.0099999906,2018,1,4,CASH_IN,574006.46,C1123629720
1306,409000438611',2018-01-04,Indiaforensic VISA ACQ DOM040118,0.0,1449612.86,2055568.869999991,2018,1,4,CASH_IN,1449612.86,C662736689
1307,409000438611',2018-01-04,Indiaforensic RUPAY POS ACQ04011,0.0,1660030.44,3715599.309999991,2018,1,4,CHECK_CASHING,1660030.44,C2050019814
1308,409000438611',2018-01-04,TRF TO  Indiaforensic SERVICES I,3700000.0,0.0,15599.309999990744,2018,1,4,CASH_OUT,3700000.0,C885951223
1309,409000438611',2018-01-05,Indiaforensic MASTER ACQ DOM0501,0.0,758140.65,773739.9599999908,2018,1,5,CHECK_CASHING,758140.65,C1219161283
1310,409000438611',2018-01-05,Indiaforensic VISA ACQ DOM050118,0.0,789964.68,1563704.639999991,2018,1,5,CASH_IN,789964.68,C1831477404
1311,409000438611',2018-01-05,Indiaforensic RUPAY POS ACQ05011,0.0,1640559.78,3204264.4199999906,2018,1,5,CASH_IN,1640559.78,C1096283470
1312,409000438611',2018-01-05,Indiaforensic VISA ACQ INT 04011,0.0,5940.0,3210204.4199999906,2018,1,5,TRANSFER,5940.0,C1750905143
1313,409000438611',2018-01-05,Indiaforensic MASTER ACQ DOM CB,993.5,0.0,3209210.9199999906,2018,1,5,CASH_OUT,993.5,C1286084959
1314,409000438611',2018-01-05,TRF TO  Indiaforensic SERVICES I,3200000.0,0.0,9210.919999990612,2018,1,5,CASH_OUT,3200000.0,C985934102
1315,409000438611',2018-01-06,Indiaforensic VISA ACQ DOM060118,0.0,328961.67,338172.5899999906,2018,1,6,CHECK_CASHING,328961.67,C1937962514
1316,409000438611',2018-01-06,Indiaforensic RUPAY POS ACQ06011,0.0,1383356.63,1721529.2199999904,2018,1,6,CHECK_CASHING,1383356.63,C1068824137
1317,409000438611',2018-01-06,Indiaforensic VISA ACQ INT 05011,0.0,1978.0,1723507.2199999904,2018,1,6,CASH_IN,1978.0,C985934102
1318,409000438611',2018-01-08,Indiaforensic MASTER ACQ DOM0601,0.0,548886.42,2272393.6399999904,2018,1,8,CASH_IN,548886.42,C985934102
1319,409000438611',2018-01-08,Indiaforensic RUPAY POS ACQ07011,0.0,877932.6,3150326.2399999904,2018,1,8,TRANSFER,877932.6,C1182461167
1320,409000438611',2018-01-08,Indiaforensic VISA ACQ INT 06011,0.0,422.26,3150748.49999999,2018,1,8,TRANSFER,422.26,C1318822808
1321,409000438611',2018-01-08,Indiaforensic VISA ACQ DOM070118,0.0,454844.76,3605593.259999992,2018,1,8,CASH_IN,454844.76,C2050019814
1322,409000438611',2018-01-08,Indiaforensic MASTER ACQ DOM0801,0.0,1188636.87,4794230.1299999915,2018,1,8,CASH_IN,1188636.87,C306206744
1323,409000438611',2018-01-08,Indiaforensic VISA ACQ DOM080118,0.0,1695756.63,6489986.75999999,2018,1,8,CHECK_CASHING,1695756.63,C1096283470
1324,409000438611',2018-01-08,Indiaforensic RUPAY POS ACQ08011,0.0,1348672.8,7838659.55999999,2018,1,8,TRANSFER,1348672.8,C1883840933
1325,409000438611',2018-01-08,TRF TO  Indiaforensic SERVICES I,3000000.0,0.0,4838659.55999999,2018,1,8,CASH_OUT,3000000.0,C1749186397
1326,409000438611',2018-01-08,TRF TO  Indiaforensic SERVICES I,1000000.0,0.0,3838659.559999991,2018,1,8,CASH_OUT,1000000.0,C614685048
1327,409000438611',2018-01-08,TRF TO  Indiaforensic SERVICES I,500000.0,0.0,3338659.5599999907,2018,1,8,DEBIT,500000.0,C1049817027
1328,409000438611',2018-01-08,TRF TO  Indiaforensic SERVICES I,3000000.0,0.0,338659.55999999034,2018,1,8,DEBIT,3000000.0,C667346055
1329,409000438611',2018-01-08,Indiaforensic MASTER ACQ DOM REV,3.44,0.0,338656.11999999033,2018,1,8,PAYEMENT,3.44,C1526298704
1330,409000438611',2018-01-09,Indiaforensic MASTER ACQ DOM0901,0.0,590125.16,928781.27999999,2018,1,9,TRANSFER,590125.16,C1825027294
1331,409000438611',2018-01-09,Indiaforensic VISA ACQ DOM090118,0.0,836878.76,1765660.0399999903,2018,1,9,TRANSFER,836878.76,C1023714065
1332,409000438611',2018-01-09,Indiaforensic RUPAY POS ACQ09011,0.0,1884835.79,3650495.829999991,2018,1,9,TRANSFER,1884835.79,C667346055
1333,409000438611',2018-01-09,Indiaforensic VISA ACQ INT 08011,0.0,3960.0,3654455.829999991,2018,1,9,TRANSFER,3960.0,M1391119179
1334,409000438611',2018-01-10,TRF TO  Indiaforensic SERVICES I,3000000.0,0.0,654455.8299999903,2018,1,10,PAYEMENT,3000000.0,M710220387
1335,409000438611',2018-01-10,TRF TO  Indiaforensic SERVICES I,500000.0,0.0,154455.8299999903,2018,1,10,CHECK_WITHDRAWAL,500000.0,M517693873
1336,409000438611',2018-01-10,Indiaforensic MASTER ACQ DOM1001,0.0,653265.09,807720.9199999903,2018,1,10,CASH_IN,653265.09,M214313531
1337,409000438611',2018-01-10,Indiaforensic VISA ACQ DOM100118,0.0,1032858.93,1840579.8499999903,2018,1,10,TRANSFER,1032858.93,M693345846
1338,409000438611',2018-01-10,Indiaforensic RUPAY POS ACQ10011,0.0,1970703.66,3811283.509999992,2018,1,10,CHECK_CASHING,1970703.66,M257718694
1339,409000438611',2018-01-10,TRF TO  Indiaforensic SERVICES I,3800000.0,0.0,11283.509999990463,2018,1,10,CHECK_WITHDRAWAL,3800000.0,M1392886653
1340,409000438611',2018-01-11,Indiaforensic VISA ACQ INT 10011,0.0,2967.0,14250.509999990463,2018,1,11,CASH_IN,2967.0,M1037942373
1341,409000438611',2018-01-11,Indiaforensic VISA ACQ DOM110118,0.0,1172276.49,1186526.9999999905,2018,1,11,TRANSFER,1172276.49,M876962272
1342,409000438611',2018-01-11,Indiaforensic RUPAY POS ACQ11011,0.0,2078228.02,3264755.0199999907,2018,1,11,CASH_IN,2078228.02,M917277283
1343,409000438611',2018-01-11,Indiaforensic MASTER ACQ DOM1101,0.0,717518.91,3982273.9299999913,2018,1,11,CHECK_CASHING,717518.91,M1388849499
1344,409000438611',2018-01-11,Indiaforensic MASTER ACQ DOM1101,0.0,4770.86,3987044.789999991,2018,1,11,TRANSFER,4770.86,M2008159348
1345,409000438611',2018-01-11,TRF TO  Indiaforensic SERVICES I,3200000.0,0.0,787044.7899999903,2018,1,11,DEBIT,3200000.0,M1103132232
1346,409000438611',2018-01-12,Indiaforensic MASTER ACQ DOM1101,0.0,660091.71,1447136.4999999902,2018,1,12,TRANSFER,660091.71,M2015261478
1347,409000438611',2018-01-12,Indiaforensic VISA ACQ DOM110118,0.0,831870.37,2279006.8699999903,2018,1,12,TRANSFER,831870.37,C932583850
1348,409000438611',2018-01-12,Indiaforensic RUPAY POS ACQ11011,0.0,1716441.97,3995448.839999992,2018,1,12,CASH_IN,1716441.97,M968957548
1349,409000438611',2018-01-12,TRF TO  Indiaforensic SERVICES I,4000000.0,0.0,,2018,1,12,CHECK_WITHDRAWAL,4000000.0,C1750905143
1350,409000438611',2018-01-15,Indiaforensic RUPAY POS ACQ13011,0.0,1766723.94,1762172.7799999902,2018,1,15,TRANSFER,1766723.94,C1973538135
1351,409000438611',2018-01-15,Indiaforensic VISA ACQ DOM130118,0.0,848346.61,2610519.3899999904,2018,1,15,TRANSFER,848346.61,M1128266449
1352,409000438611',2018-01-15,Indiaforensic MASTER ACQ DOM1301,0.0,689671.4,3300190.7899999907,2018,1,15,TRANSFER,689671.4,M628487793
1353,409000438611',2018-01-15,Indiaforensic RUPAY POS ACQ14011,0.0,1549544.51,4849735.299999991,2018,1,15,TRANSFER,1549544.51,M248487859
1354,409000438611',2018-01-15,Indiaforensic VISA ACQ DOM150118,0.0,2344127.05,7193862.34999999,2018,1,15,CHECK_CASHING,2344127.05,M670689666
1355,409000438611',2018-01-15,Indiaforensic RUPAY POS ACQ15011,0.0,1353022.03,8546884.37999999,2018,1,15,CHECK_CASHING,1353022.03,C75457651
1356,409000438611',2018-01-15,Indiaforensic MASTER ACQ DOM1401,0.0,721264.39,9268148.76999999,2018,1,15,CHECK_CASHING,721264.39,M817941759
1357,409000438611',2018-01-15,Indiaforensic MASTER ACQ DOM1501,0.0,716553.42,9984702.18999999,2018,1,15,TRANSFER,716553.42,M36550900
1358,409000438611',2018-01-15,Indiaforensic VISA ACQ INT 14011,0.0,343.1,9985045.28999999,2018,1,15,TRANSFER,343.1,M492252770
1359,409000438611',2018-01-15,TRF TO  Indiaforensic SERVICES I,9900000.0,0.0,85045.28999998978,2018,1,15,DEBIT,9900000.0,M1187972599
1360,409000438611',2018-01-16,Indiaforensic MASTER ACQ DOM1701,0.0,556106.97,641152.2599999898,2018,1,16,CASH_IN,556106.97,C997608398
1361,409000438611',2018-01-16,Indiaforensic VISA ACQ DOM170118,0.0,937527.53,1578679.7899999898,2018,1,16,TRANSFER,937527.53,M49547843
1362,409000438611',2018-01-16,Indiaforensic RUPAY POS ACQ17011,0.0,1547728.28,3126408.06999999,2018,1,16,TRANSFER,1547728.28,C1023714065
1363,409000438611',2018-01-16,TRF TO  Indiaforensic SERVICES I,3100000.0,0.0,26408.069999990053,2018,1,16,CHECK_WITHDRAWAL,3100000.0,M402978317
1364,409000438611',2018-01-17,Indiaforensic MASTER ACQ DOM1701,0.0,690219.65,716627.7199999902,2018,1,17,TRANSFER,690219.65,M1417554340
1365,409000438611',2018-01-17,Indiaforensic VISA ACQ DOM170118,0.0,914099.32,1630727.03999999,2018,1,17,CASH_IN,914099.32,C1068824137
1366,409000438611',2018-01-17,Indiaforensic RUPAY POS ACQ17011,0.0,1510243.85,3140970.8899999917,2018,1,17,CASH_IN,1510243.85,C747464370
1367,409000438611',2018-01-17,TRF TO  Indiaforensic SERVICES I,3000000.0,0.0,140970.88999999035,2018,1,17,PAYEMENT,3000000.0,M1043317832
1368,409000438611',2018-01-17,Indiaforensic MASTER INT SET 01-,0.0,1047.42,142018.30999999036,2018,1,17,CHECK_CASHING,1047.42,M1485485458
1369,409000438611',2018-01-18,Indiaforensic MASTER ACQ DOM1801,0.0,616016.25,758034.5599999905,2018,1,18,CHECK_CASHING,616016.25,M1288052401
1370,409000438611',2018-01-18,Indiaforensic VISA ACQ DOM180118,0.0,718938.13,1476972.6899999904,2018,1,18,TRANSFER,718938.13,C885951223
1371,409000438611',2018-01-18,Indiaforensic RUPAY POS ACQ18011,0.0,1625683.75,3102656.43999999,2018,1,18,CHECK_CASHING,1625683.75,M1883830050
1372,409000438611',2018-01-18,TRF TO  Indiaforensic SERVICES I,3000000.0,0.0,102656.43999999015,2018,1,18,CASH_OUT,3000000.0,M1487230025
1373,409000438611',2018-01-19,Indiaforensic MASTER ACQ DOM1901,0.0,563214.64,665871.0799999902,2018,1,19,CHECK_CASHING,563214.64,M1846539844
1374,409000438611',2018-01-19,Indiaforensic VISA ACQ DOM190118,0.0,946977.06,1612848.1399999904,2018,1,19,TRANSFER,946977.06,C459857341
1375,409000438611',2018-01-19,Indiaforensic RUPAY POS ACQ19011,0.0,1201744.86,2814592.999999991,2018,1,19,TRANSFER,1201744.86,M1009326765
1376,409000438611',2018-01-19,Indiaforensic MASTER INT SET 180,0.0,412.91,2815005.9099999918,2018,1,19,TRANSFER,412.91,M7548983
1377,409000438611',2018-01-19,TRF TO  Indiaforensic SERVICES I,2800000.0,0.0,15005.909999990836,2018,1,19,CASH_OUT,2800000.0,M52487168
1378,409000438611',2018-01-20,Indiaforensic VISA ACQ INT 19011,0.0,1372.42,16378.329999990836,2018,1,20,CASH_IN,1372.42,M486348917
1379,409000438611',2018-01-20,Indiaforensic VISA ACQ DOM200118,0.0,771276.92,787655.2499999909,2018,1,20,TRANSFER,771276.92,M742672280
1380,409000438611',2018-01-20,Indiaforensic RUPAY POS ACQ20011,0.0,1259418.39,2047073.639999991,2018,1,20,CASH_IN,1259418.39,C812586739
1381,409000438611',2018-01-20,TRF TO  Indiaforensic SERVICES I,2000000.0,0.0,47073.63999999082,2018,1,20,DEBIT,2000000.0,C1234250905
1382,409000438611',2018-01-22,Indiaforensic MASTER ACQ DOM2101,0.0,554098.56,601172.199999991,2018,1,22,CASH_IN,554098.56,M1293252487
1383,409000438611',2018-01-22,Indiaforensic VISA ACQ INT 20011,0.0,494.5,601666.699999991,2018,1,22,CASH_IN,494.5,M1829966070
1384,409000438611',2018-01-22,Indiaforensic VISA ACQ INT 21011,0.0,16318.5,617985.199999991,2018,1,22,CHECK_CASHING,16318.5,C1068824137
1385,409000438611',2018-01-22,Indiaforensic RUPAY POS ACQ21011,0.0,1225988.7,1843973.8999999908,2018,1,22,CHECK_CASHING,1225988.7,M1354280589
1386,409000438611',2018-01-22,Indiaforensic VISA ACQ DOM220118,0.0,1628007.45,3471981.3499999912,2018,1,22,CASH_IN,1628007.45,C1832532108
1387,409000438611',2018-01-22,Indiaforensic MASTER ACQ DOM2201,0.0,592161.06,4064142.4099999913,2018,1,22,TRANSFER,592161.06,M1015799131
1388,409000438611',2018-01-22,Indiaforensic RUPAY POS ACQ22011,0.0,732959.29,4797101.699999991,2018,1,22,CHECK_CASHING,732959.29,C154319946
1389,409000438611',2018-01-22,Indiaforensic MASTER ACQ DOM2001,0.0,668644.13,5465745.829999992,2018,1,22,TRANSFER,668644.13,C488044861
1390,409000438611',2018-01-22,TRF TO  Indiaforensic SERVICES I,5400000.0,0.0,65745.82999999076,2018,1,22,CHECK_WITHDRAWAL,5400000.0,C195600860
1391,409000438611',2018-01-23,Indiaforensic VISA ACQ DOM230118,0.0,947487.29,1013233.1199999908,2018,1,23,TRANSFER,947487.29,M85121323
1392,409000438611',2018-01-23,Indiaforensic RUPAY POS ACQ23011,0.0,1535844.67,2549077.7899999907,2018,1,23,TRANSFER,1535844.67,M2078239671
1393,409000438611',2018-01-23,Indiaforensic MASTER ACQ DOM2301,0.0,630402.37,3179480.1599999918,2018,1,23,CASH_IN,630402.37,M143486875
1394,409000438611',2018-01-23,Indiaforensic VISA ACQ INT 22011,0.0,5201.95,3184682.109999991,2018,1,23,CASH_IN,5201.95,M1197176722
1395,409000438611',2018-01-23,TRF TO  Indiaforensic SERVICES I,3000000.0,0.0,184682.10999999105,2018,1,23,CHECK_WITHDRAWAL,3000000.0,C997608398
1396,409000438611',2018-01-23,Indiaforensic MASTER INT SET 20-,0.0,19634.99,204317.099999991,2018,1,23,TRANSFER,19634.99,M405488475
1397,409000438611',2018-01-24,Indiaforensic MASTER ACQ DOM2401,0.0,511540.86,715857.9599999909,2018,1,24,TRANSFER,511540.86,M49969897
1398,409000438611',2018-01-24,Indiaforensic VISA ACQ DOM240118,0.0,779976.47,1495834.4299999909,2018,1,24,CASH_IN,779976.47,M923013679
1399,409000438611',2018-01-24,Indiaforensic RUPAY POS ACQ24011,0.0,1190785.44,2686619.869999991,2018,1,24,CASH_IN,1190785.44,M1622135821
1400,409000438611',2018-01-24,Indiaforensic VISA ACQ INT 23011,0.0,13846.0,2700465.869999991,2018,1,24,CHECK_CASHING,13846.0,M1059080630
1401,409000438611',2018-01-24,TRF TO  Indiaforensic SERVICES I,2700000.0,0.0,465.8699999907985,2018,1,24,PAYEMENT,2700000.0,C453211571
1402,409000438611',2018-01-25,Indiaforensic MASTER ACQ DOM2501,0.0,590574.36,591040.2299999908,2018,1,25,CHECK_CASHING,590574.36,C63387985
1403,409000438611',2018-01-25,Indiaforensic VISA ACQ DOM250118,0.0,753365.83,1344406.0599999907,2018,1,25,TRANSFER,753365.83,C1262822392
1404,409000438611',2018-01-25,Indiaforensic RUPAY POS ACQ25011,0.0,1303777.92,2648183.979999991,2018,1,25,TRANSFER,1303777.92,C1504109395
1405,409000438611',2018-01-25,Indiaforensic VISA ACQ INT 24011,0.0,1256.96,2649440.93999999,2018,1,25,CASH_IN,1256.96,M503144273
1406,409000438611',2018-01-25,Indiaforensic MASTER INT SET 230,0.0,31322.77,2680763.70999999,2018,1,25,CASH_IN,31322.77,C1068824137
1407,409000438611',2018-01-25,TRF TO  Indiaforensic SERVICES I,2600000.0,0.0,80763.70999999065,2018,1,25,DEBIT,2600000.0,M985487390
1408,409000438611',2018-01-29,Indiaforensic MASTER ACQ DOM2601,0.0,713683.39,794447.0999999907,2018,1,29,CHECK_CASHING,713683.39,M1628289406
1409,409000438611',2018-01-29,Indiaforensic VISA ACQ DOM260118,0.0,626069.7,1420516.7999999903,2018,1,29,CHECK_CASHING,626069.7,M1068232840
1410,409000438611',2018-01-29,Indiaforensic RUPAY POS ACQ26011,0.0,1302405.91,2722922.70999999,2018,1,29,CASH_IN,1302405.91,M317960117
1411,409000438611',2018-01-29,Indiaforensic MASTER ACQ DOM2701,0.0,681274.47,3404197.179999992,2018,1,29,CASH_IN,681274.47,C1992550266
1412,409000438611',2018-01-29,Indiaforensic VISA ACQ DOM270118,0.0,841738.95,4245936.1299999915,2018,1,29,TRANSFER,841738.95,M2077662850
1413,409000438611',2018-01-29,Indiaforensic RUPAY POS ACQ27011,0.0,1243129.56,5489065.68999999,2018,1,29,CHECK_CASHING,1243129.56,M1370495328
1414,409000438611',2018-01-29,Indiaforensic RUPAY POS ACQ28011,0.0,1434625.98,6923691.6699999925,2018,1,29,CASH_IN,1434625.98,M668760567
1415,409000438611',2018-01-29,Indiaforensic VISA ACQ INT 28011,0.0,341.2,6924032.869999991,2018,1,29,CASH_IN,341.2,M984567559
1416,409000438611',2018-01-29,Indiaforensic VISA ACQ DOM290118,0.0,1626848.53,8550881.399999991,2018,1,29,TRANSFER,1626848.53,M417875774
1417,409000438611',2018-01-29,Indiaforensic RUPAY POS ACQ29011,0.0,1188258.26,9739139.65999999,2018,1,29,CASH_IN,1188258.26,M439925336
1418,409000438611',2018-01-29,Indiaforensic MASTER ACQ DOM2901,0.0,1210579.27,10949718.92999999,2018,1,29,CHECK_CASHING,1210579.27,C1286084959
1419,409000438611',2018-01-29,TRF TO  Indiaforensic SERVICES I,10900000.0,0.0,49718.92999999039,2018,1,29,DEBIT,10900000.0,M1121891386
1420,409000438611',2018-01-30,Indiaforensic MASTER ACQ DOM3001,0.0,8941636.79,8991355.71999999,2018,1,30,CHECK_CASHING,8941636.79,C2083117811
1421,409000438611',2018-01-30,Indiaforensic VISA ACQ DOM300118,0.0,746613.8,9737969.51999999,2018,1,30,TRANSFER,746613.8,M485475507
1422,409000438611',2018-01-30,Indiaforensic RUPAY POS ACQ30011,0.0,1411532.84,11149502.35999999,2018,1,30,CASH_IN,1411532.84,M1869247587
1423,409000438611',2018-01-30,Indiaforensic MASTER ACQ DOM3001,8941636.79,0.0,2207865.569999991,2018,1,30,CHECK_WITHDRAWAL,8941636.79,M2045913001
1424,409000438611',2018-01-30,Indiaforensic MASTER ACQ DOM3001,0.0,726562.21,2934427.779999992,2018,1,30,CASH_IN,726562.21,C1839337592
1425,409000438611',2018-01-30,Indiaforensic MASTER INT SET 290,0.0,1001.93,2935429.709999991,2018,1,30,CHECK_CASHING,1001.93,M508760925
1426,409000438611',2018-01-30,TRF TO  Indiaforensic SERVICES I,2900000.0,0.0,35429.709999991115,2018,1,30,CASH_OUT,2900000.0,C40075281
1427,409000438611',2018-01-31,Indiaforensic MASTER ACQ DOM3101,0.0,649780.58,685210.2899999911,2018,1,31,TRANSFER,649780.58,C800281454
1428,409000438611',2018-01-31,Indiaforensic RUPAY POS ACQ31011,0.0,1282120.87,1967331.1599999915,2018,1,31,CASH_IN,1282120.87,C317071334
1429,409000438611',2018-01-31,Indiaforensic VISA ACQ DOM310118,0.0,912070.21,2879401.3699999917,2018,1,31,CASH_IN,912070.21,M842957574
1430,409000438611',2018-01-31,Indiaforensic MASTER INT SET 300,0.0,431.93,2879833.299999992,2018,1,31,TRANSFER,431.93,M1255109302
1431,409000438611',2018-02-01,TRF TO  Indiaforensic SERVICES I,500000.0,0.0,2379833.2999999914,2018,2,1,CHECK_WITHDRAWAL,500000.0,M855724043
1432,409000438611',2018-02-01,TRF TO  Indiaforensic SERVICES I,2000000.0,0.0,379833.2999999913,2018,2,1,CHECK_WITHDRAWAL,2000000.0,C564160838
1433,409000438611',2018-02-01,Indiaforensic MASTER INT SET 310,0.0,9260.87,389094.1699999914,2018,2,1,CASH_IN,9260.87,C836514715
1434,409000438611',2018-02-01,Indiaforensic MASTER ACQ DOM0102,0.0,653648.49,1042742.6599999914,2018,2,1,CASH_IN,653648.49,M1470420462
1435,409000438611',2018-02-01,Indiaforensic VISA ACQ DOM010218,0.0,835914.6,1878657.2599999919,2018,2,1,CHECK_CASHING,835914.6,M977650730
1436,409000438611',2018-02-01,Indiaforensic RUPAY POS ACQ01021,0.0,1481779.33,3360436.589999992,2018,2,1,CHECK_CASHING,1481779.33,M1202081661
1437,409000438611',2018-02-01,TRF TO  Indiaforensic SERVICES I,3300000.0,0.0,60436.58999999148,2018,2,1,CHECK_WITHDRAWAL,3300000.0,M664839586
1438,409000438611',2018-02-02,Indiaforensic MASTER ACQ DOM0202,0.0,621251.5,681688.0899999915,2018,2,2,CHECK_CASHING,621251.5,M54176060
1439,409000438611',2018-02-02,Indiaforensic VISA ACQ DOM020218,0.0,803259.9,1484947.9899999911,2018,2,2,TRANSFER,803259.9,M275754769
1440,409000438611',2018-02-02,Indiaforensic RUPAY POS ACQ02021,0.0,1452688.23,2937636.219999992,2018,2,2,CHECK_CASHING,1452688.23,C614685048
1441,409000438611',2018-02-03,Indiaforensic VISA ACQ DOM030218,0.0,798365.55,3736001.769999991,2018,2,3,CHECK_CASHING,798365.55,M279781579
1442,409000438611',2018-02-03,Indiaforensic RUPAY POS ACQ03021,0.0,1308747.51,5044749.279999991,2018,2,3,CASH_IN,1308747.51,M740827140
1443,409000438611',2018-02-03,TRF TO  Indiaforensic SERVICES I,2000000.0,0.0,3044749.279999992,2018,2,3,CHECK_WITHDRAWAL,2000000.0,M2080125222
1444,409000438611',2018-02-03,TRF TO  Indiaforensic SERVICES I,500000.0,0.0,2544749.279999991,2018,2,3,CHECK_WITHDRAWAL,500000.0,C665576141
1445,409000438611',2018-02-03,TRF TO  Indiaforensic SERVICES I,2000000.0,0.0,544749.2799999911,2018,2,3,CHECK_WITHDRAWAL,2000000.0,M653345773
1446,409000438611',2018-02-03,TRF TO  Indiaforensic SERVICES I,500000.0,0.0,44749.27999999095,2018,2,3,DEBIT,500000.0,M1266093632
1447,409000438611',2018-02-05,Indiaforensic MASTER ACQ DOM0302,0.0,690907.86,735657.1399999909,2018,2,5,CHECK_CASHING,690907.86,C1860513229
1448,409000438611',2018-02-05,Indiaforensic MASTER ACQ DOM0502,0.0,1586494.06,2322151.199999991,2018,2,5,TRANSFER,1586494.06,M426288284
1449,409000438611',2018-02-05,Indiaforensic VISA ACQ DOM050218,0.0,1556744.94,3878896.1399999913,2018,2,5,CHECK_CASHING,1556744.94,C1504109395
1450,409000438611',2018-02-05,Indiaforensic RUPAY POS ACQ04021,0.0,1544881.94,5423778.079999992,2018,2,5,CHECK_CASHING,1544881.94,C1291286504
1451,409000438611',2018-02-05,Indiaforensic RUPAY POS ACQ05021,0.0,955577.98,6379356.059999991,2018,2,5,CASH_IN,955577.98,M203472514
1452,409000438611',2018-02-05,TRF TO  Indiaforensic SERVICES I,6000000.0,0.0,379356.05999999115,2018,2,5,CHECK_WITHDRAWAL,6000000.0,M1056185446
1453,409000438611',2018-02-06,Indiaforensic MASTER ACQ DOM0602,0.0,777289.47,1156645.5299999912,2018,2,6,CHECK_CASHING,777289.47,M1647243882
1454,409000438611',2018-02-06,Indiaforensic VISA ACQ DOM060218,0.0,778192.85,1934838.379999991,2018,2,6,TRANSFER,778192.85,M1599566873
1455,409000438611',2018-02-06,Indiaforensic RUPAY POS ACQ06021,0.0,2102529.4,4037367.779999992,2018,2,6,CHECK_CASHING,2102529.4,M1028811481
1456,409000438611',2018-02-06,Indiaforensic VISA ACQ INT 01021,0.0,54441.89,4091809.669999991,2018,2,6,TRANSFER,54441.89,M1779914089
1457,409000438611',2018-02-06,TRF TO  Indiaforensic SERVICES I,4000000.0,0.0,91809.66999999108,2018,2,6,PAYEMENT,4000000.0,M1060935276
1458,409000438611',2018-02-07,Indiaforensic MASTER ACQ DOM0702,0.0,856224.02,948033.6899999912,2018,2,7,CHECK_CASHING,856224.02,M1090695601
1459,409000438611',2018-02-07,Indiaforensic VISA ACQ DOM070218,0.0,990089.12,1938122.8099999912,2018,2,7,CASH_IN,990089.12,M980533504
1460,409000438611',2018-02-07,Indiaforensic RUPAY POS ACQ07021,0.0,1623600.65,3561723.459999991,2018,2,7,CASH_IN,1623600.65,M254955665
1461,409000438611',2018-02-07,TRF TO  Indiaforensic SERVICES I,3000000.0,0.0,561723.4599999911,2018,2,7,CASH_OUT,3000000.0,M2008229299
1462,409000438611',2018-02-08,Indiaforensic VISA ACQ INT 04021,0.0,148.35,561871.8099999911,2018,2,8,TRANSFER,148.35,M2123269713
1463,409000438611',2018-02-08,Indiaforensic VISA ACQ INT 03021,0.0,98.9,561970.7099999911,2018,2,8,CHECK_CASHING,98.9,M656349395
1464,409000438611',2018-02-08,Indiaforensic RUPAY POS ACQ08021,0.0,931299.07,1493269.779999991,2018,2,8,CASH_IN,931299.07,M1642308093
1465,409000438611',2018-02-08,Indiaforensic VISA ACQ DOM080218,0.0,923454.02,2416723.799999991,2018,2,8,CHECK_CASHING,923454.02,M246264949
1466,409000438611',2018-02-08,Indiaforensic MASTER ACQ DOM0802,0.0,749543.11,3166266.9099999918,2018,2,8,CASH_IN,749543.11,M828241083
1467,409000438611',2018-02-08,Indiaforensic POS ACQ SETTL 0802,931299.07,0.0,2234967.839999991,2018,2,8,CASH_OUT,931299.07,M1554877309
1468,409000438611',2018-02-08,Indiaforensic POS ACQ SETTL 0802,0.0,930249.22,3165217.059999991,2018,2,8,CASH_IN,930249.22,M623131585
1469,409000438611',2018-02-08,TRF TO  Indiaforensic SERVICES I,3000000.0,0.0,165217.05999999118,2018,2,8,DEBIT,3000000.0,M779018428
1470,409000438611',2018-02-09,Indiaforensic MASTER ACQ DOM0902,0.0,669583.55,834800.6099999913,2018,2,9,CHECK_CASHING,669583.55,M1182758821
1471,409000438611',2018-02-09,Indiaforensic VISA ACQ INT 06021,0.0,3121.17,837921.7799999913,2018,2,9,CASH_IN,3121.17,M1108066952
1472,409000438611',2018-02-09,Indiaforensic POS ACQ SETTL 0102,54441.89,0.0,783479.8899999913,2018,2,9,CASH_OUT,54441.89,M814377348
1473,409000438611',2018-02-09,Indiaforensic RUPAY POS ACQ09021,0.0,2152874.52,2936354.4099999918,2018,2,9,TRANSFER,2152874.52,M2050275256
1474,409000438611',2018-02-09,Indiaforensic VISA ACQ DOM090218,0.0,1096899.94,4033254.3499999912,2018,2,9,CASH_IN,1096899.94,M1005093407
1475,409000438611',2018-02-09,TRF TO  Indiaforensic SERVICES I,4000000.0,0.0,33254.34999999125,2018,2,9,DEBIT,4000000.0,M996533593
1476,409000438611',2018-02-09,Indiaforensic MASTER ACQ DOM REV,969.11,0.0,32285.239999991245,2018,2,9,CASH_OUT,969.11,C1789550256
1477,409000438611',2018-02-12,Indiaforensic MASTER ACQDOM10-12,0.0,2317875.26,2350160.499999991,2018,2,12,TRANSFER,2317875.26,M140428850
1478,409000438611',2018-02-12,Indiaforensic VISA ACQDOM100218,0.0,1005260.15,3355420.649999991,2018,2,12,TRANSFER,1005260.15,C1330106945
1479,409000438611',2018-02-12,Indiaforensic VISA ACQDOM 120218,0.0,2047654.08,5403074.729999991,2018,2,12,CASH_IN,2047654.08,M1608103523
1480,409000438611',2018-02-12,Indiaforensic RUPAY POSACQ100218,0.0,1481303.9,6884378.629999992,2018,2,12,TRANSFER,1481303.9,C767904468
1481,409000438611',2018-02-12,Indiaforensic RUPAY POSACQ110218,0.0,1863047.25,8747425.879999993,2018,2,12,CASH_IN,1863047.25,M238431319
1482,409000438611',2018-02-12,Indiaforensic RUPAY POSACQ120218,0.0,1361159.59,10108585.469999993,2018,2,12,CASH_IN,1361159.59,M2042917213
1483,409000438611',2018-02-12,Indiaforensic MASTER INT SET 090,0.0,611.73,10109197.199999992,2018,2,12,TRANSFER,611.73,M1699265405
1484,409000438611',2018-02-12,Indiaforensic MASTER ACQDOM12021,0.0,867.99,10110065.189999992,2018,2,12,CASH_IN,867.99,C357863579
1485,409000438611',2018-02-13,TRF TO  Indiaforensic SERVICES I,10000000.0,0.0,110065.18999999203,2018,2,13,CASH_OUT,10000000.0,M358019805
1486,409000438611',2018-02-14,Indiaforensic MASTER ACQ DOM1402,0.0,822534.03,932599.219999992,2018,2,14,CASH_IN,822534.03,M103118806
1487,409000438611',2018-02-14,Indiaforensic VISA ACQ DOM140218,0.0,961170.33,1893769.549999992,2018,2,14,CASH_IN,961170.33,M1801422599
1488,409000438611',2018-02-14,Indiaforensic RUPAY POS ACQ14021,0.0,2684779.78,4578549.329999992,2018,2,14,CHECK_CASHING,2684779.78,C1424082571
1489,409000438611',2018-02-14,Indiaforensic MASTER ACQ DOM1302,0.0,907663.38,5486212.709999992,2018,2,14,CASH_IN,907663.38,M2041264753
1490,409000438611',2018-02-14,Indiaforensic VISA ACQ DOM130218,0.0,1104589.67,6590802.379999992,2018,2,14,CHECK_CASHING,1104589.67,C1170794006
1491,409000438611',2018-02-14,Indiaforensic RUPAY POS ACQ13021,0.0,1333538.59,7924340.969999991,2018,2,14,CHECK_CASHING,1333538.59,M1902455960
1492,409000438611',2018-02-14,TRF TO  Indiaforensic SERVICES I,7900000.0,0.0,24340.969999991357,2018,2,14,PAYEMENT,7900000.0,M1622694817
1493,409000438611',2018-02-15,Indiaforensic MASTER ACQ DOM1502,0.0,778009.71,802350.6799999912,2018,2,15,CHECK_CASHING,778009.71,M292958927
1494,409000438611',2018-02-15,Indiaforensic VISA ACQ DOM150218,0.0,982687.44,1785038.1199999913,2018,2,15,CASH_IN,982687.44,M225553858
1495,409000438611',2018-02-15,Indiaforensic RUPAY POS ACQ15021,0.0,1917042.56,3702080.6799999913,2018,2,15,CHECK_CASHING,1917042.56,C998351292
1496,409000438611',2018-02-15,TRF TO  Indiaforensic SERVICES I,3700000.0,0.0,2080.67999999132,2018,2,15,CASH_OUT,3700000.0,M29774113
1497,409000438611',2018-02-15,Indiaforensic VISA ACQ INT 10021,0.0,874.28,2954.9599999913207,2018,2,15,TRANSFER,874.28,M1474072872
1498,409000438611',2018-02-16,Indiaforensic MASTER ACQ DOM1602,0.0,771473.92,774428.8799999914,2018,2,16,CHECK_CASHING,771473.92,C775514090
1499,409000438611',2018-02-16,Indiaforensic VISA ACQ DOM160218,0.0,1054089.52,1828518.3999999915,2018,2,16,CHECK_CASHING,1054089.52,C171493374
1500,409000438611',2018-02-16,Indiaforensic RUPAY POS ACQ16021,0.0,1944335.76,3772854.1599999918,2018,2,16,CHECK_CASHING,1944335.76,C778731861
1501,409000438611',2018-02-16,Indiaforensic VISA ACQ INT 14021,0.0,1510.32,3774364.479999992,2018,2,16,TRANSFER,1510.32,M1517758613
1502,409000438611',2018-02-16,TRF TO  Indiaforensic SERVICES I,3700000.0,0.0,74364.4799999916,2018,2,16,DEBIT,3700000.0,M1883971879
1503,409000438611',2018-02-17,Indiaforensic VISA ACQ DOM170218,0.0,949204.41,1023568.8899999915,2018,2,17,TRANSFER,949204.41,M1563634025
1504,409000438611',2018-02-17,Indiaforensic RUPAY POS ACQ17021,0.0,1613660.27,2637229.1599999918,2018,2,17,CHECK_CASHING,1613660.27,M774362927
1505,409000438611',2018-02-17,TRF TO  Indiaforensic SERVICES I,2000000.0,0.0,637229.1599999918,2018,2,17,PAYEMENT,2000000.0,M1211586911
1506,409000438611',2018-02-20,Indiaforensic MASTER ACQ DOM1702,0.0,730495.0,1367724.1599999918,2018,2,20,CHECK_CASHING,730495.0,M997294994
1507,409000438611',2018-02-20,Indiaforensic RUPAY POS ACQ18021,0.0,1438384.15,2806108.3099999917,2018,2,20,CHECK_CASHING,1438384.15,M523051393
1508,409000438611',2018-02-20,Indiaforensic VISA ACQ DOM190218,0.0,1817754.32,4623862.6299999915,2018,2,20,CHECK_CASHING,1817754.32,M2128961136
1509,409000438611',2018-02-20,Indiaforensic RUPAY POS ACQ19021,0.0,1650790.89,6274653.519999991,2018,2,20,CASH_IN,1650790.89,M1986581856
1510,409000438611',2018-02-20,Indiaforensic MASTER ACQ DOM2002,0.0,2287738.38,8562391.899999991,2018,2,20,CASH_IN,2287738.38,M309060377
1511,409000438611',2018-02-20,Indiaforensic VISA ACQ DOM200218,0.0,1035925.38,9598317.279999992,2018,2,20,CHECK_CASHING,1035925.38,M1547116051
1512,409000438611',2018-02-20,Indiaforensic RUPAY POS ACQ20021,0.0,1906559.53,11504876.809999993,2018,2,20,CASH_IN,1906559.53,M506775047
1513,409000438611',2018-02-20,Indiaforensic MASTER INT SET 160,0.0,10.3,11504887.109999992,2018,2,20,CHECK_CASHING,10.3,M917935693
1514,409000438611',2018-02-20,TRF TO  Indiaforensic SERVICES I,11500000.0,0.0,4887.109999991953,2018,2,20,PAYEMENT,11500000.0,M153448497
1515,409000438611',2018-02-21,Indiaforensic MASTER ACQ DOM2102,0.0,859735.58,864622.6899999919,2018,2,21,CASH_IN,859735.58,C611572016
1516,409000438611',2018-02-21,Indiaforensic VISA ACQ DOM210218,0.0,988978.38,1853601.069999992,2018,2,21,CHECK_CASHING,988978.38,C306206744
1517,409000438611',2018-02-21,Indiaforensic RUPAY POS ACQ21021,0.0,2002935.97,3856537.0399999917,2018,2,21,CHECK_CASHING,2002935.97,M673384643
1518,409000438611',2018-02-21,Indiaforensic MASTER INT SET 190,0.0,39163.83,3895700.8699999917,2018,2,21,CASH_IN,39163.83,M498134055
1519,409000438611',2018-02-21,TRF TO  Indiaforensic SERVICES I,3800000.0,0.0,95700.86999999172,2018,2,21,PAYEMENT,3800000.0,M223000346
1520,409000438611',2018-02-22,Indiaforensic RUPAY POS ACQ22021,0.0,1574990.14,1670691.0099999916,2018,2,22,TRANSFER,1574990.14,C1170794006
1521,409000438611',2018-02-22,Indiaforensic VISA ACQ DOM220218,0.0,987619.73,2658310.739999992,2018,2,22,CHECK_CASHING,987619.73,C1321640594
1522,409000438611',2018-02-22,Indiaforensic MASTER ACQ DOM2202,0.0,817892.23,3476202.969999992,2018,2,22,TRANSFER,817892.23,M28145535
1523,409000438611',2018-02-22,TRF TO  Indiaforensic SERVICES I,3400000.0,0.0,76202.96999999182,2018,2,22,CHECK_WITHDRAWAL,3400000.0,M1133227388
1524,409000438611',2018-02-22,Indiaforensic VISA ACQ INT 20021,0.0,11144.58,87347.54999999182,2018,2,22,CHECK_CASHING,11144.58,M1340051218
1525,409000438611',2018-02-23,Indiaforensic MASTER ACQ DOM2302,0.0,653177.19,740524.7399999917,2018,2,23,CHECK_CASHING,653177.19,M1425405511
1526,409000438611',2018-02-23,Indiaforensic VISA ACQ DOM230218,0.0,1019763.68,1760288.4199999918,2018,2,23,CASH_IN,1019763.68,C1335050193
1527,409000438611',2018-02-23,Indiaforensic RUPAY POS ACQ23021,0.0,1761626.95,3521915.3699999917,2018,2,23,TRANSFER,1761626.95,C1023714065
1528,409000438611',2018-02-23,TRF TO  Indiaforensic SERVICES I,3500000.0,0.0,21915.36999999173,2018,2,23,CHECK_WITHDRAWAL,3500000.0,M828088650
1529,409000438611',2018-02-26,Indiaforensic MASTER ACQ DOM2402,0.0,552833.6,574748.9699999917,2018,2,26,CASH_IN,552833.6,M670084377
1530,409000438611',2018-02-26,Indiaforensic VISA ACQ DOM240218,0.0,1022944.79,1597693.7599999919,2018,2,26,TRANSFER,1022944.79,C832279283
1531,409000438611',2018-02-26,Indiaforensic RUPAY POS ACQ24021,0.0,1747852.35,3345546.109999992,2018,2,26,TRANSFER,1747852.35,M1716551994
1532,409000438611',2018-02-26,Indiaforensic RUPAY POS ACQ25021,0.0,1785401.42,5130947.529999992,2018,2,26,CHECK_CASHING,1785401.42,M1355766307
1533,409000438611',2018-02-26,Indiaforensic MASTER ACQ DOM2602,0.0,1440201.53,6571149.059999992,2018,2,26,CHECK_CASHING,1440201.53,M658281599
1534,409000438611',2018-02-26,Indiaforensic VISA ACQ DOM260218,0.0,2059185.68,8630334.739999993,2018,2,26,TRANSFER,2059185.68,M452015229
1535,409000438611',2018-02-26,Indiaforensic RUPAY POS ACQ26021,0.0,1630083.47,10260418.209999992,2018,2,26,CHECK_CASHING,1630083.47,M544628437
1536,409000438611',2018-02-26,TRF TO  Indiaforensic SERVICES I,10200000.0,0.0,60418.209999993436,2018,2,26,PAYEMENT,10200000.0,M681158875
1537,409000438611',2018-02-27,Indiaforensic MASTER ACQ DOM2702,0.0,961965.27,1022383.4799999936,2018,2,27,CHECK_CASHING,961965.27,M203048480
1538,409000438611',2018-02-27,Indiaforensic RUPAY POS ACQ27021,0.0,1798130.59,2820514.069999994,2018,2,27,CHECK_CASHING,1798130.59,M319426406
1539,409000438611',2018-02-27,TRF TO  Indiaforensic SERVICES I,2800000.0,0.0,20514.069999993782,2018,2,27,CHECK_WITHDRAWAL,2800000.0,M305552520
1540,409000438611',2018-02-28,Indiaforensic MASTER ACQ DOM2802,0.0,747889.53,768403.5999999938,2018,2,28,TRANSFER,747889.53,M574077658
1541,409000438611',2018-02-28,Indiaforensic VISA ACQ DOM280218,0.0,2307661.97,3076065.569999994,2018,2,28,CASH_IN,2307661.97,M1460696714
1542,409000438611',2018-02-28,Indiaforensic RUPAY POS ACQ28021,0.0,1816466.2,4892531.769999994,2018,2,28,TRANSFER,1816466.2,M115397800
1543,409000438611',2018-02-28,TRF TO  Indiaforensic SERVICES I,4800000.0,0.0,92531.76999999397,2018,2,28,CASH_OUT,4800000.0,M807872790
1544,409000438611',2018-03-01,Indiaforensic VISA ACQ INT 24021,0.0,692.31,93224.07999999396,2018,3,1,CASH_IN,692.31,M1542856295
1545,409000438611',2018-03-01,Indiaforensic VISA ACQ INT 25021,0.0,13817.4,107041.47999999397,2018,3,1,CHECK_CASHING,13817.4,M187120217
1546,409000438611',2018-03-01,Indiaforensic VISA ACQ DOM010318,0.0,1332188.28,1439229.759999994,2018,3,1,TRANSFER,1332188.28,M622772003
1547,409000438611',2018-03-01,Indiaforensic RUPAY POS ACQ01031,0.0,2182420.65,3621650.4099999936,2018,3,1,CASH_IN,2182420.65,M460333119
1548,409000438611',2018-03-01,TRF TO  Indiaforensic SERVICES I,3600000.0,0.0,21650.40999999363,2018,3,1,DEBIT,3600000.0,M22040992
1549,409000438611',2018-03-03,Indiaforensic VISA ACQ DOM020318,0.0,1734486.17,1756136.5799999938,2018,3,3,TRANSFER,1734486.17,M185203393
1550,409000438611',2018-03-03,Indiaforensic RUPAY POS ACQ02031,0.0,2972986.91,4729123.489999994,2018,3,3,TRANSFER,2972986.91,M1627496281
1551,409000438611',2018-03-03,Indiaforensic VISA ACQ INT 27021,0.0,1870.7,4730994.189999994,2018,3,3,CHECK_CASHING,1870.7,M653515020
1552,409000438611',2018-03-03,Indiaforensic VISA ACQ DOM030318,0.0,636872.77,5367866.959999993,2018,3,3,TRANSFER,636872.77,M1365197105
1553,409000438611',2018-03-03,Indiaforensic RUPAY POS ACQ03031,0.0,975687.34,6343554.299999992,2018,3,3,CHECK_CASHING,975687.34,M1280443567
1554,409000438611',2018-03-03,TRF TO  Indiaforensic SERVICES I,4000000.0,0.0,2343554.2999999933,2018,3,3,CHECK_WITHDRAWAL,4000000.0,M348148678
1555,409000438611',2018-03-03,TRF TO  Indiaforensic SERVICES I,500000.0,0.0,1843554.299999993,2018,3,3,CHECK_WITHDRAWAL,500000.0,M814111376
1556,409000438611',2018-03-03,TRF TO  Indiaforensic SERVICES I,1000000.0,0.0,843554.2999999933,2018,3,3,CHECK_WITHDRAWAL,1000000.0,M2004655561
1557,409000438611',2018-03-03,TRF TO  Indiaforensic SERVICES I,500000.0,0.0,343554.2999999933,2018,3,3,DEBIT,500000.0,M1944138464
1558,409000438611',2018-03-05,IndforGN MSTR ACQ DOM01-0503,0.0,4759255.58,5102809.879999993,2018,3,5,CHECK_CASHING,4759255.58,M611502040
1559,409000438611',2018-03-05,Indiaforensic RUPAY POS ACQ04031,0.0,1976388.26,7079198.139999992,2018,3,5,TRANSFER,1976388.26,M571956559
1560,409000438611',2018-03-05,Indiaforensic RUPAY POS ACQ05031,0.0,1806993.81,8886191.949999994,2018,3,5,CASH_IN,1806993.81,M998283025
1561,409000438611',2018-03-05,Indiaforensic VISA ACQ DOM050318,0.0,2804904.72,11691096.669999994,2018,3,5,TRANSFER,2804904.72,M594195094
1562,409000438611',2018-03-05,Indiaforensic MASTER INT SET 010,0.0,35485.39,11726582.059999995,2018,3,5,CHECK_CASHING,35485.39,M1661161169
1563,409000438611',2018-03-05,TRF TO  Indiaforensic SERVICES I,11600000.0,0.0,126582.05999999492,2018,3,5,PAYEMENT,11600000.0,M1437129801
1564,409000438611',2018-03-06,Indiaforensic VISA ACQ INT 28021,0.0,3956.0,130538.05999999492,2018,3,6,CHECK_CASHING,3956.0,C1096283470
1565,409000438611',2018-03-06,Indiaforensic RUPAY POS ACQ06031,0.0,1425336.67,1555874.7299999946,2018,3,6,CHECK_CASHING,1425336.67,M1911168986
1566,409000438611',2018-03-06,Indiaforensic VISA ACQ DOM060318,0.0,1737721.26,3293595.9899999937,2018,3,6,TRANSFER,1737721.26,M1107772887
1567,409000438611',2018-03-06,Indiaforensic MASTER ACQ DOM 060,0.0,1336123.81,4629719.799999995,2018,3,6,TRANSFER,1336123.81,M1604616170
1568,409000438611',2018-03-06,TRF TO  Indiaforensic SERVICES I,4600000.0,0.0,29719.79999999516,2018,3,6,PAYEMENT,4600000.0,C1740000325
1569,409000438611',2018-03-07,Indiaforensic VISA ACQ DOM070318,0.0,1336084.19,1365803.989999995,2018,3,7,CHECK_CASHING,1336084.19,M687399269
1570,409000438611',2018-03-07,Indiaforensic VISA ACQ INT 01031,0.0,494.5,1366298.489999995,2018,3,7,TRANSFER,494.5,M1727424614
1571,409000438611',2018-03-07,Indiaforensic MASTER ACQ DOM 070,0.0,1206213.73,2572512.219999995,2018,3,7,CHECK_CASHING,1206213.73,C214187874
1572,409000438611',2018-03-07,Indiaforensic RUPAY POS ACQ07031,0.0,2067731.26,4640243.479999995,2018,3,7,CHECK_CASHING,2067731.26,M1704214570
1573,409000438611',2018-03-07,TRF TO  Indiaforensic SERVICES I,4600000.0,0.0,40243.47999999487,2018,3,7,CASH_OUT,4600000.0,C657736958
1574,409000438611',2018-03-08,Indiaforensic RUPAY POS ACQ08031,0.0,2541680.42,2581923.899999995,2018,3,8,CHECK_CASHING,2541680.42,M1041326823
1575,409000438611',2018-03-08,Indiaforensic VISA ACQ DOM080318,0.0,1202924.05,3784847.9499999946,2018,3,8,CHECK_CASHING,1202924.05,M1815025408
1576,409000438611',2018-03-08,Indiaforensic MASTER ACQ DOM 080,0.0,928321.98,4713169.929999994,2018,3,8,CHECK_CASHING,928321.98,M3694603
1577,409000438611',2018-03-08,TRF TO  Indiaforensic SERVICES I,4700000.0,0.0,13169.929999994114,2018,3,8,PAYEMENT,4700000.0,M1914615775
1578,409000438611',2018-03-09,Indiaforensic RUPAY POS ACQ09031,0.0,2157676.6,2170846.529999994,2018,3,9,CASH_IN,2157676.6,C998351292
1579,409000438611',2018-03-09,Indiaforensic VISA ACQ DOM090318,0.0,1380687.62,3551534.1499999943,2018,3,9,TRANSFER,1380687.62,M1385750189
1580,409000438611',2018-03-09,Indiaforensic MASTER ACQ DOM 090,0.0,899770.26,4451304.409999995,2018,3,9,CASH_IN,899770.26,M80191608
1581,409000438611',2018-03-09,TRF TO  Indiaforensic SERVICES I,4400000.0,0.0,51304.40999999456,2018,3,9,CHECK_WITHDRAWAL,4400000.0,C1529115495
1582,409000438611',2018-03-12,IndforGN MSTR ACQ DOM10-1203,0.0,2951753.66,3003058.069999995,2018,3,12,CHECK_CASHING,2951753.66,M1995505717
1583,409000438611',2018-03-12,Indiaforensic VISA ACQ DOM120318,0.0,3116765.95,6119824.019999995,2018,3,12,CHECK_CASHING,3116765.95,M45416784
1584,409000438611',2018-03-12,Indiaforensic RUPAY POS ACQ12031,0.0,2075795.76,8195619.779999995,2018,3,12,CASH_IN,2075795.76,M1807207655
1585,409000438611',2018-03-12,Indiaforensic RUPAY POS ACQ11031,0.0,2057325.0,10252944.779999994,2018,3,12,TRANSFER,2057325.0,M1800605369
1586,409000438611',2018-03-12,Indiaforensic VISA ACQ DOM100318,0.0,1293288.62,11546233.399999995,2018,3,12,CHECK_CASHING,1293288.62,M1736458419
1587,409000438611',2018-03-12,Indiaforensic RUPAY POS ACQ10031,0.0,2024483.53,13570716.929999994,2018,3,12,CASH_IN,2024483.53,M1688310330
1588,409000438611',2018-03-12,TRF TO  Indiaforensic SERVICES I,8200000.0,0.0,5370716.929999994,2018,3,12,CASH_OUT,8200000.0,M415906914
1589,409000438611',2018-03-13,TRF TO  Indiaforensic SERVICES I,5000000.0,0.0,370716.92999999406,2018,3,13,CHECK_WITHDRAWAL,5000000.0,M1154941313
1590,409000438611',2018-03-13,Indiaforensic MASTER ACQ DOM1303,0.0,1134856.66,1505573.589999994,2018,3,13,CASH_IN,1134856.66,M600199331
1591,409000438611',2018-03-13,Indiaforensic VISA ACQ DOM130318,0.0,1384132.47,2889706.059999993,2018,3,13,CASH_IN,1384132.47,C1568059495
1592,409000438611',2018-03-13,Indiaforensic RUPAY POS ACQ13031,0.0,2316511.83,5206217.889999994,2018,3,13,CHECK_CASHING,2316511.83,M1353838640
1593,409000438611',2018-03-13,Indiaforensic MASTER INT SET 120,0.0,557.86,5206775.7499999935,2018,3,13,CASH_IN,557.86,M1604342290
1594,409000438611',2018-03-13,TRF TO  Indiaforensic SERVICES I,5200000.0,0.0,6775.749999994412,2018,3,13,CHECK_WITHDRAWAL,5200000.0,M1544147328
1595,409000438611',2018-03-14,Indiaforensic MASTER ACQ DOM1403,0.0,1050890.33,1057666.0799999945,2018,3,14,TRANSFER,1050890.33,M1599556802
1596,409000438611',2018-03-14,Indiaforensic VISA ACQ DOM140318,0.0,1439336.22,2497002.299999994,2018,3,14,CASH_IN,1439336.22,M2057077925
1597,409000438611',2018-03-14,Indiaforensic RUPAY POS ACQ14031,0.0,2504225.18,5001227.479999995,2018,3,14,CASH_IN,2504225.18,M1222094219
1598,409000438611',2018-03-14,TRF TO  Indiaforensic SERVICES I,5000000.0,0.0,1227.479999994859,2018,3,14,PAYEMENT,5000000.0,M1612853208
1599,409000438611',2018-03-15,Indiaforensic VISA ACQ DOM150318,0.0,1256817.11,1258044.589999995,2018,3,15,CHECK_CASHING,1256817.11,C811597470
1600,409000438611',2018-03-15,Indiaforensic RUPAY POS ACQ15031,0.0,2105951.56,3363996.149999995,2018,3,15,CHECK_CASHING,2105951.56,M1896558831
1601,409000438611',2018-03-15,Indiaforensic MASTER ACQ DOM1503,0.0,927443.4,4291439.549999995,2018,3,15,TRANSFER,927443.4,M682981033
1602,409000438611',2018-03-15,TRF TO  Indiaforensic SERVICES I,4200000.0,0.0,91439.54999999516,2018,3,15,CHECK_WITHDRAWAL,4200000.0,M795590320
1603,409000438611',2018-03-16,Indiaforensic MASTER ACQ DOM1603,0.0,930235.32,1021674.8699999951,2018,3,16,CHECK_CASHING,930235.32,M404036116
1604,409000438611',2018-03-16,Indiaforensic VISA ACQ DOM160318,0.0,1294330.99,2316005.859999995,2018,3,16,CHECK_CASHING,1294330.99,M379430898
1605,409000438611',2018-03-16,Indiaforensic RUPAY POS ACQ16031,0.0,2007447.58,4323453.439999997,2018,3,16,CASH_IN,2007447.58,M216746962
1606,409000438611',2018-03-16,Indiaforensic VISA ACQ INT 14031,0.0,4202.51,4327655.949999996,2018,3,16,CHECK_CASHING,4202.51,M468776694
1607,409000438611',2018-03-16,Indiaforensic MASTER INT SET 150,0.0,2222.34,4329878.289999995,2018,3,16,TRANSFER,2222.34,M14633842
1608,409000438611',2018-03-16,TRF TO  Indiaforensic SERVICES I,4300000.0,0.0,29878.28999999538,2018,3,16,CASH_OUT,4300000.0,M939475028
1609,409000438611',2018-03-17,Indiaforensic VISA ACQ DOM170318,0.0,1119457.32,1149335.6099999954,2018,3,17,CASH_IN,1119457.32,M2063009760
1610,409000438611',2018-03-17,Indiaforensic RUPAY POS ACQ17031,0.0,1410316.41,2559652.019999996,2018,3,17,TRANSFER,1410316.41,C1531333864
1611,409000438611',2018-03-17,Indiaforensic VISA ACQ INT 15031,0.0,22764.73,2582416.749999996,2018,3,17,TRANSFER,22764.73,C811597470
1612,409000438611',2018-03-17,ICA17825 Indiaforensic MASTER IN,0.0,49922.26,2632339.009999995,2018,3,17,CHECK_CASHING,49922.26,C288665596
1613,409000438611',2018-03-17,TRF TO  Indiaforensic SERVICES I,2000000.0,0.0,632339.0099999951,2018,3,17,CASH_OUT,2000000.0,C488044861
1614,409000438611',2018-03-17,TRF TO  Indiaforensic SERVICES I,500000.0,0.0,132339.00999999512,2018,3,17,CASH_OUT,500000.0,C1789550256
1615,409000438611',2018-03-19,IndforGN MSTR ACQ DOM17-1903,0.0,2690541.17,2822880.179999995,2018,3,19,CHECK_CASHING,2690541.17,C985934102
1616,409000438611',2018-03-19,Indiaforensic VISA ACQ DOM190318,0.0,2535150.33,5358030.509999995,2018,3,19,CASH_IN,2535150.33,C1262822392
1617,409000438611',2018-03-19,Indiaforensic RUPAY POS ACQ18031,0.0,2500463.93,7858494.439999998,2018,3,19,CHECK_CASHING,2500463.93,C33524623
1618,409000438611',2018-03-19,Indiaforensic RUPAY POS ACQ19031,0.0,1688011.16,9546505.599999996,2018,3,19,TRANSFER,1688011.16,M1481594007
1619,409000438611',2018-03-19,TRF TO  Indiaforensic SERVICES I,9500000.0,0.0,46505.599999995895,2018,3,19,CHECK_WITHDRAWAL,9500000.0,M530410619
1620,409000438611',2018-03-20,Indiaforensic MASTER ACQ DOM2003,0.0,925201.91,971707.5099999959,2018,3,20,CASH_IN,925201.91,M1337655323
1621,409000438611',2018-03-20,Indiaforensic VISA ACQ DOM200318,0.0,1143454.67,2115162.179999996,2018,3,20,TRANSFER,1143454.67,M874153561
1622,409000438611',2018-03-20,Indiaforensic RUPAY POS ACQ20031,0.0,2149426.23,4264588.409999996,2018,3,20,CASH_IN,2149426.23,M1592763413
1623,409000438611',2018-03-20,Indiaforensic MASTER INT SET 170,0.0,98.97,4264687.379999996,2018,3,20,CASH_IN,98.97,M2027227708
1624,409000438611',2018-03-20,TRF TO  Indiaforensic SERVICES I,4200000.0,0.0,64687.37999999616,2018,3,20,CHECK_WITHDRAWAL,4200000.0,M215632153
1625,409000438611',2018-03-21,Indiaforensic RUPAY POS ACQ 2103,0.0,2065366.99,2130054.3699999964,2018,3,21,CASH_IN,2065366.99,M790229674
1626,409000438611',2018-03-21,Indiaforensic VISA ACQ DOM 21031,0.0,1131376.41,3261430.779999996,2018,3,21,CASH_IN,1131376.41,M1778877569
1627,409000438611',2018-03-21,Indiaforensic MASTER ACQ DOM 210,0.0,762926.84,4024357.619999997,2018,3,21,CHECK_CASHING,762926.84,M422134367
1628,409000438611',2018-03-21,Indiaforensic VISA ACQ INT 17031,0.0,29574.0,4053931.619999997,2018,3,21,CASH_IN,29574.0,M670283478
1629,409000438611',2018-03-21,Indiaforensic VISA ACQ INT 18031,0.0,395.6,4054327.219999997,2018,3,21,CHECK_CASHING,395.6,M639105046
1630,409000438611',2018-03-21,TRF TO  Indiaforensic SERVICES I,2000000.0,0.0,2054327.219999996,2018,3,21,PAYEMENT,2000000.0,M1561347421
1631,409000438611',2018-03-21,TRF TO  Indiaforensic SERVICES I,2000000.0,0.0,54327.21999999649,2018,3,21,CHECK_WITHDRAWAL,2000000.0,M1251285265
1632,409000438611',2018-03-21,Indiaforensic MASTER ACQ DOM2103,46810.59,0.0,7516.629999996483,2018,3,21,PAYEMENT,46810.59,M173259631
1633,409000438611',2018-03-22,Indiaforensic RUPAY POS ACQ 2203,0.0,1779439.2,1786955.8299999963,2018,3,22,CHECK_CASHING,1779439.2,M1733947537
1634,409000438611',2018-03-22,Indiaforensic VISA ACQ DOM 22031,0.0,1270455.53,3057411.359999997,2018,3,22,CHECK_CASHING,1270455.53,M346377974
1635,409000438611',2018-03-22,Indiaforensic MASTER ACQ DOM 220,0.0,309803.84,3367215.1999999965,2018,3,22,CASH_IN,309803.84,M141015648
1636,409000438611',2018-03-22,TRF TO  Indiaforensic SERVICES I,3300000.0,0.0,67215.19999999646,2018,3,22,PAYEMENT,3300000.0,M1699443392
1637,409000438611',2018-03-22,Indiaforensic MASTER ACQ DOM 220,0.0,498795.71,566010.9099999964,2018,3,22,CHECK_CASHING,498795.71,M1614079837
1638,409000438611',2018-03-22,Indiaforensic VISA ACQ INT 20031,0.0,9890.0,575900.9099999964,2018,3,22,TRANSFER,9890.0,M1060928475
1639,409000438611',2018-03-23,Indiaforensic RUPAY POS ACQ 2303,0.0,1665186.95,2241087.859999997,2018,3,23,TRANSFER,1665186.95,M44278425
1640,409000438611',2018-03-23,Indiaforensic VISA ACQ DOM 23031,0.0,1106682.12,3347769.9799999967,2018,3,23,CHECK_CASHING,1106682.12,C1504109395
1641,409000438611',2018-03-23,Indiaforensic MASTER ACQ DOM 230,0.0,683459.51,4031229.489999997,2018,3,23,TRANSFER,683459.51,M834562889
1642,409000438611',2018-03-23,TRF TO  Indiaforensic SERVICES I,4000000.0,0.0,31229.4899999965,2018,3,23,DEBIT,4000000.0,M1536728519
1643,409000438611',2018-03-23,Indiaforensic MASTER INT SET 220,0.0,4887.86,36117.3499999965,2018,3,23,TRANSFER,4887.86,M1112940474
1644,409000438611',2018-03-26,Indiaforensic RUPAY POS ACQ 2403,0.0,1938136.46,1974253.8099999968,2018,3,26,CASH_IN,1938136.46,M1186371052
1645,409000438611',2018-03-26,Indiaforensic RUPAY POS ACQ 2503,0.0,1622928.39,3597182.1999999965,2018,3,26,CASH_IN,1622928.39,M845119401
1646,409000438611',2018-03-26,Indiaforensic RUPAY POS ACQ 2603,0.0,1406490.45,5003672.649999997,2018,3,26,CHECK_CASHING,1406490.45,M1671811074
1647,409000438611',2018-03-26,Indiaforensic VISA ACQ DOM 24031,0.0,1252562.93,6256235.579999996,2018,3,26,TRANSFER,1252562.93,M1520836654
1648,409000438611',2018-03-26,Indiaforensic VISA ACQ DOM 26031,0.0,2172737.45,8428973.029999997,2018,3,26,TRANSFER,2172737.45,C1749186397
1649,409000438611',2018-03-26,Indiaforensic MSTR ACQ DOM24-260,0.0,2424876.17,10853849.199999996,2018,3,26,CASH_IN,2424876.17,C22805895
1650,409000438611',2018-03-26,Indiaforensic VISA ACQ INT 22031,0.0,1865.8,10855714.999999998,2018,3,26,CASH_IN,1865.8,C1100767002
1651,409000438611',2018-03-26,TRF TO  Indiaforensic SERVICES I,10800000.0,0.0,55714.99999999814,2018,3,26,CASH_OUT,10800000.0,M353206468
1652,409000438611',2018-03-27,Indiaforensic VISA ACQ DOM 27031,0.0,852335.94,908050.939999998,2018,3,27,CASH_IN,852335.94,M50345623
1653,409000438611',2018-03-27,Indiaforensic RUPAY POS ACQ 2703,0.0,1564237.48,2472288.419999998,2018,3,27,TRANSFER,1564237.48,M489070295
1654,409000438611',2018-03-27,Indiaforensic MSTR ACQ DOM   270,0.0,666654.42,3138942.839999998,2018,3,27,CASH_IN,666654.42,C1498438472
1655,409000438611',2018-03-27,Indiaforensic VISA ACQ INT 23031,0.0,898.94,3139841.779999998,2018,3,27,TRANSFER,898.94,M68217166
1656,409000438611',2018-03-27,TRF TO  Indiaforensic SERVICES I,3100000.0,0.0,39841.77999999793,2018,3,27,PAYEMENT,3100000.0,C1961176822
1657,409000438611',2018-03-28,ICA17825 Indiaforensic MASTER AD,0.0,37548.24,77390.01999999792,2018,3,28,CASH_IN,37548.24,M511651343
1658,409000438611',2018-03-28,Indiaforensic MSTR ACQ DOM   280,0.0,781717.64,859107.6599999979,2018,3,28,CHECK_CASHING,781717.64,M2027133545
1659,409000438611',2018-03-28,Indiaforensic VISA ACQ DOM 28031,0.0,942536.56,1801644.219999997,2018,3,28,TRANSFER,942536.56,C601893033
1660,409000438611',2018-03-28,TRF TO  Indiaforensic SERVICES I,1800000.0,0.0,1644.2199999978766,2018,3,28,CASH_OUT,1800000.0,M1897221921
1661,409000438611',2018-03-28,Indiaforensic VISA ACQ INT 24031,0.0,4470.41,6114.6299999978755,2018,3,28,CASH_IN,4470.41,M622263400
1662,409000438611',2018-03-28,Indiaforensic VISA ACQ INT 25031,0.0,15230.6,21345.229999997882,2018,3,28,CASH_IN,15230.6,M1811787796
1663,409000438611',2018-03-28,Indiaforensic RUPAY POS ACQ 2803,0.0,1010053.52,1031398.749999998,2018,3,28,TRANSFER,1010053.52,M1617937669
1664,409000438611',2018-03-30,FUND TRF TO  Indiaforensic SERVI,1000000.0,0.0,31398.749999997905,2018,3,30,PAYEMENT,1000000.0,C1671179293
1665,409000438611',2018-03-31,Indiaforensic RUPAY POS ACQ 2903,0.0,1817436.47,1848835.219999997,2018,3,31,CHECK_CASHING,1817436.47,M880533231
1666,409000438611',2018-03-31,Indiaforensic RUPAY POS ACQ 2803,0.0,994335.68,2843170.899999998,2018,3,31,CASH_IN,994335.68,M2134157671
1667,409000438611',2018-03-31,TRF TO  Indiaforensic SERVICES I,2800000.0,0.0,43170.899999998044,2018,3,31,CHECK_WITHDRAWAL,2800000.0,C736709391
1668,409000438611',2018-03-31,Indiaforensic VISA ACQ DOM 29031,0.0,1081320.98,1124491.879999998,2018,3,31,CASH_IN,1081320.98,M604060129
1669,409000438611',2018-03-31,Indiaforensic VISA ACQ DOM 30031,0.0,842955.95,1967447.8299999984,2018,3,31,CHECK_CASHING,842955.95,M1227459815
1670,409000438611',2018-03-31,Indiaforensic VISA ACQ DOM 31031,0.0,1123706.74,3091154.569999998,2018,3,31,TRANSFER,1123706.74,M148891937
1671,409000438611',2018-03-31,Indiaforensic RUPAY POS ACQ 2803,1010053.52,0.0,2081101.0499999984,2018,3,31,CHECK_WITHDRAWAL,1010053.52,M1442077586
1672,409000438611',2018-03-31,Indiaforensic RUPAY POS ACQ 3003,0.0,1509646.77,3590747.819999998,2018,3,31,CASH_IN,1509646.77,M1744713739
1673,409000438611',2018-03-31,Indiaforensic RUPAY POS ACQ 3103,0.0,1469574.91,5060322.729999999,2018,3,31,CHECK_CASHING,1469574.91,M1038988454
1674,409000438611',2018-03-31,TRF TO  Indiaforensic SERVICES I,2000000.0,0.0,3060322.7299999977,2018,3,31,CHECK_WITHDRAWAL,2000000.0,M1096682443
1675,409000438611',2018-03-31,TRF TO  Indiaforensic SERVICES I,2000000.0,0.0,1060322.7299999977,2018,3,31,PAYEMENT,2000000.0,M1238994373
1676,409000438611',2018-03-31,TRF TO  Indiaforensic SERVICES I,1000000.0,0.0,60322.729999997646,2018,3,31,CASH_OUT,1000000.0,M495051009
1677,409000438611',2018-04-03,Indiaforensic VISA ACQ DOM 01041,0.0,38525273.35,38585596.08,2018,4,3,CASH_IN,38525273.35,M200744172
1678,409000438611',2018-04-03,Indiaforensic VISA ACQ DOM 02041,0.0,1870017.44,40455613.52,2018,4,3,CASH_IN,1870017.44,M818785904
1679,409000438611',2018-04-03,Indiaforensic VISA ACQ DOM 03041,0.0,948629.45,41404242.97,2018,4,3,TRANSFER,948629.45,M628610760
1680,409000438611',2018-04-03,Indiaforensic RUPAY POS ACQ 0104,0.0,1301151.52,42705394.49,2018,4,3,CASH_IN,1301151.52,M1811942924
1681,409000438611',2018-04-03,Indiaforensic RUPAY POS ACQ 0204,0.0,1219784.75,43925179.24,2018,4,3,CASH_IN,1219784.75,C564742142
1682,409000438611',2018-04-03,Indiaforensic RUPAY POS ACQ 0304,0.0,1530167.8,45455347.04,2018,4,3,CASH_IN,1530167.8,M1769252629
1683,409000438611',2018-04-03,TRF TO  Indiaforensic SERVICES I,15000000.0,0.0,30455347.04,2018,4,3,DEBIT,15000000.0,M1137989065
1684,409000438611',2018-04-03,TRF TO  Indiaforensic SERVICES I,15000000.0,0.0,15455347.04,2018,4,3,CHECK_WITHDRAWAL,15000000.0,M10405169
1685,409000438611',2018-04-03,TRF TO  Indiaforensic SERVICES I,15000000.0,0.0,455347.03999999905,2018,4,3,CHECK_WITHDRAWAL,15000000.0,M554634433
1686,409000438611',2018-04-03,TRF TO  Indiaforensic SERVICES I,400000.0,0.0,55347.03999999911,2018,4,3,CHECK_WITHDRAWAL,400000.0,M1872088401
1687,409000438611',2018-04-03,Indiaforensic MASTER ACQ DOM2902,0.0,3252775.52,3308122.5599999987,2018,4,3,CHECK_CASHING,3252775.52,M1439361845
1688,409000438611',2018-04-03,Indiaforensic MASTER ACQ DOM 030,0.0,1258653.01,4566775.569999998,2018,4,3,CHECK_CASHING,1258653.01,M741883443
1689,409000438611',2018-04-03,Indiaforensic MASTER INT SET 280,0.0,503.9,4567279.47,2018,4,3,TRANSFER,503.9,M1982876486
1690,409000438611',2018-04-04,TRF TO  Indiaforensic SERVICES I,4500000.0,0.0,67279.46999999974,2018,4,4,CHECK_WITHDRAWAL,4500000.0,M1116197959
1691,409000438611',2018-04-04,TRF FROM Indiaforensic SERVICES,0.0,15000000.0,15067279.47,2018,4,4,CHECK_CASHING,15000000.0,M1315795813
1692,409000438611',2018-04-04,TRF FROM Indiaforensic SERVICES,0.0,15000000.0,30067279.47,2018,4,4,CHECK_CASHING,15000000.0,M13918250
1693,409000438611',2018-04-04,Indiaforensic VISA ACQ DOM 04041,0.0,1014286.68,31081566.15,2018,4,4,TRANSFER,1014286.68,M75356024
1694,409000438611',2018-04-04,Indiaforensic VISA ACQ INT 27031,0.0,306.19,31081872.34,2018,4,4,CASH_IN,306.19,M916958177
1695,409000438611',2018-04-04,Indiaforensic VISA ACQ INT 30031,0.0,989.0,31082861.34,2018,4,4,CHECK_CASHING,989.0,M235162442
1696,409000438611',2018-04-04,Indiaforensic VISA ACQ INT 02041,0.0,504.61,31083365.95,2018,4,4,TRANSFER,504.61,C22805895
1697,409000438611',2018-04-04,Indiaforensic RUPAY POS ACQ 0404,0.0,1720558.35,32803924.3,2018,4,4,TRANSFER,1720558.35,C33524623
1698,409000438611',2018-04-04,Indiaforensic MSTR ACQ DOM   040,0.0,848347.46,33652271.76,2018,4,4,CHECK_CASHING,848347.46,C1359044626
1699,409000438611',2018-04-04,REVIndiaforensic VISA ACQ DOM010,33659553.72,0.0,,2018,4,4,DEBIT,33659553.72,C11003494
1700,409000438611',2018-04-04,TRF FROM  Indiaforensic SERVICES,0.0,7500000.0,7492718.039999999,2018,4,4,CASH_IN,7500000.0,C977993101
1701,409000438611',2018-04-04,REVIndiaforensic VISA ACQ DOM010,4865719.63,0.0,2626998.409999999,2018,4,4,CASH_OUT,4865719.63,C1526298704
1702,409000438611',2018-04-04,Indiaforensic MASTER INT SET 030,0.0,1955.34,2628953.749999999,2018,4,4,CASH_IN,1955.34,C2083562754
1703,409000438611',2018-04-05,TRF TO  Indiaforensic SERVICES I,2600000.0,0.0,28953.74999999907,2018,4,5,CASH_OUT,2600000.0,C401424608
1704,409000438611',2018-04-05,Indiaforensic VISA ACQ DOM 05041,0.0,1340963.89,1369917.639999999,2018,4,5,CHECK_CASHING,1340963.89,C1068824137
1705,409000438611',2018-04-05,Indiaforensic RUPAY POS ACQ 0504,0.0,1880236.64,3250154.279999999,2018,4,5,TRANSFER,1880236.64,C838411509
1706,409000438611',2018-04-05,Indiaforensic MSTR ACQ DOM   050,0.0,986116.12,4236270.3999999985,2018,4,5,CASH_IN,986116.12,C997608398
1707,409000438611',2018-04-05,TRF TO  Indiaforensic SERVICES I,4200000.0,0.0,36270.39999999851,2018,4,5,PAYEMENT,4200000.0,C1789550256
1708,409000438611',2018-04-06,Indiaforensic VISA ACQ DOM 06041,0.0,1140945.03,1177215.4299999985,2018,4,6,CHECK_CASHING,1140945.03,C1721246982
1709,409000438611',2018-04-06,Indiaforensic VISA ACQ INT 04041,0.0,3461.5,1180676.9299999985,2018,4,6,CASH_IN,3461.5,C1671179293
1710,409000438611',2018-04-06,Indiaforensic RUPAY POS ACQ 0604,0.0,1708256.83,2888933.759999999,2018,4,6,CASH_IN,1708256.83,C1068824137
1711,409000438611',2018-04-06,Indiaforensic MSTR ACQ DOM   060,0.0,885795.49,3774729.25,2018,4,6,CASH_IN,885795.49,C1750905143
1712,409000438611',2018-04-06,TRF TO  Indiaforensic SERVICES I,3700000.0,0.0,74729.24999999907,2018,4,6,CHECK_WITHDRAWAL,3700000.0,C832279283
1713,409000438611',2018-04-07,Indiaforensic VISA ACQ DOM 07041,0.0,1128092.5,1202821.749999999,2018,4,7,TRANSFER,1128092.5,C476800120
1714,409000438611',2018-04-07,TRF TO  Indiaforensic SERVICES I,500000.0,0.0,702821.7499999991,2018,4,7,CASH_OUT,500000.0,C1170794006
1715,409000438611',2018-04-07,TRF TO  Indiaforensic SERVICES I,500000.0,0.0,202821.74999999907,2018,4,7,PAYEMENT,500000.0,C1335050193
1716,409000438611',2018-04-09,Indiaforensic RUPAY POS ACQ 0704,0.0,1927653.95,2130475.7,2018,4,9,TRANSFER,1927653.95,C575335780
1717,409000438611',2018-04-09,Indiaforensic RUPAY POS ACQ 0804,0.0,1757314.59,3887790.29,2018,4,9,CHECK_CASHING,1757314.59,C2083117811
1718,409000438611',2018-04-09,Indiaforensic RUPAY POS ACQ 0904,0.0,1616696.33,5504486.619999999,2018,4,9,CASH_IN,1616696.33,C997608398
1719,409000438611',2018-04-09,Indiaforensic MSTR ACQ DOM07-090,0.0,2716816.47,8221303.09,2018,4,9,CASH_IN,2716816.47,C1023714065
1720,409000438611',2018-04-09,Indiaforensic VISA ACQ DOM 09041,0.0,2511102.15,10732405.24,2018,4,9,CHECK_CASHING,2511102.15,C2100440237
1721,409000438611',2018-04-09,TRF TO  Indiaforensic SERVICES I,10000000.0,0.0,732405.2400000001,2018,4,9,DEBIT,10000000.0,C1234776885
1722,409000438611',2018-04-09,TRF TO  Indiaforensic SERVICES I,500000.0,0.0,232405.24000000022,2018,4,9,PAYEMENT,500000.0,C665576141
1723,409000438611',2018-04-10,Indiaforensic MSTR ACQ DOM   100,0.0,973232.63,1205637.87,2018,4,10,CASH_IN,973232.63,C1286084959
1724,409000438611',2018-04-10,Indiaforensic VISA ACQ DOM 10041,0.0,1444371.67,2650009.54,2018,4,10,CASH_IN,1444371.67,C1060830840
1725,409000438611',2018-04-10,Indiaforensic RUPAY POS ACQ 1004,0.0,2261359.12,4911368.66,2018,4,10,CHECK_CASHING,2261359.12,C812586739
1726,409000438611',2018-04-10,TRF TO  Indiaforensic SERVICES I,4900000.0,0.0,11368.660000000149,2018,4,10,CASH_OUT,4900000.0,C510113906
1727,409000438611',2018-04-10,Indiaforensic VISA ACQ INT 06041,0.0,2341.8,13710.460000000148,2018,4,10,CASH_IN,2341.8,C248609774
1728,409000438611',2018-04-10,17825-IRTT00701810687-BIL,9702.93,0.0,4007.5300000001475,2018,4,10,PAYEMENT,9702.93,C1100767002
1729,409000438611',2018-04-11,Indiaforensic RUPAY POS ACQ 1104,0.0,2057150.79,2061158.3200000003,2018,4,11,TRANSFER,2057150.79,C1688019098
1730,409000438611',2018-04-11,Indiaforensic MSTR ACQ DOM   110,0.0,987424.07,3048582.39,2018,4,11,CHECK_CASHING,987424.07,C662736689
1731,409000438611',2018-04-11,Indiaforensic VISA ACQ DOM 11041,0.0,1521589.48,4570171.87,2018,4,11,CASH_IN,1521589.48,C1590550415
1732,409000438611',2018-04-11,TRF TO  Indiaforensic SERVICES I,4500000.0,0.0,70171.87000000011,2018,4,11,CHECK_WITHDRAWAL,4500000.0,M485047320
1733,409000438611',2018-04-12,Indiaforensic MSTR ACQ DOM   120,0.0,1150952.56,1221124.4300000002,2018,4,12,TRANSFER,1150952.56,C461160828
1734,409000438611',2018-04-12,Indiaforensic VISA ACQ DOM 12041,0.0,1611989.33,2833113.76,2018,4,12,TRANSFER,1611989.33,M1174687658
1735,409000438611',2018-04-12,Indiaforensic RUPAY POS ACQ 1204,0.0,2372880.13,5205993.8900000015,2018,4,12,CASH_IN,2372880.13,M444127949
1736,409000438611',2018-04-12,Indiaforensic MASTER INT SET 110,0.0,1969.8,5207963.69,2018,4,12,CASH_IN,1969.8,C812586739
1737,409000438611',2018-04-13,TRF TO  Indiaforensic SERVICES I,4000000.0,0.0,1207963.6900000004,2018,4,13,DEBIT,4000000.0,M738111983
1738,409000438611',2018-04-13,TRF TO  Indiaforensic SERVICES I,1000000.0,0.0,207963.69000000038,2018,4,13,DEBIT,1000000.0,C35534346
1739,409000438611',2018-04-13,Indiaforensic MSTR ACQ DOM   130,0.0,1211092.69,1419056.3800000004,2018,4,13,CASH_IN,1211092.69,M2024945312
1740,409000438611',2018-04-13,Indiaforensic RUPAY POS ACQ 1304,0.0,2490856.88,3909913.26,2018,4,13,CHECK_CASHING,2490856.88,M876908140
1741,409000438611',2018-04-13,Indiaforensic VISA ACQ DOM 13041,0.0,1554850.15,5464763.41,2018,4,13,CHECK_CASHING,1554850.15,C812586739
1742,409000438611',2018-04-13,TRF TO  Indiaforensic SERVICES I,5400000.0,0.0,64763.41000000015,2018,4,13,CASH_OUT,5400000.0,M1130160902
1743,409000438611',2018-04-16,Indiaforensic MSTR ACQ DOM14-160,0.0,3548694.58,3613457.99,2018,4,16,CASH_IN,3548694.58,M2110068611
1744,409000438611',2018-04-16,Indiaforensic VISA ACQ DOM 14041,0.0,1565288.16,5178746.15,2018,4,16,TRANSFER,1565288.16,C1060830840
1745,409000438611',2018-04-16,Indiaforensic VISA ACQ DOM 16041,0.0,3364746.42,8543492.57,2018,4,16,CHECK_CASHING,3364746.42,M1709700394
1746,409000438611',2018-04-16,Indiaforensic RUPAY POS ACQ 1404,0.0,2250972.16,10794464.73,2018,4,16,CHECK_CASHING,2250972.16,C1321640594
1747,409000438611',2018-04-16,Indiaforensic RUPAY POS ACQ 1504,0.0,2505366.37,13299831.1,2018,4,16,CASH_IN,2505366.37,C1123629720
1748,409000438611',2018-04-16,Indiaforensic RUPAY POS ACQ 1604,0.0,2348826.37,15648657.470000004,2018,4,16,TRANSFER,2348826.37,M1256893889
1749,409000438611',2018-04-16,TRF TO  Indiaforensic SERVICES I,5000000.0,0.0,10648657.470000004,2018,4,16,PAYEMENT,5000000.0,M521466380
1750,409000438611',2018-04-16,TRF TO  Indiaforensic SERVICES I,2000000.0,0.0,8648657.470000003,2018,4,16,CASH_OUT,2000000.0,C1435804085
1751,409000438611',2018-04-16,TRF TO  Indiaforensic SERVICES I,3000000.0,0.0,5648657.4700000025,2018,4,16,DEBIT,3000000.0,M1850646717
1752,409000438611',2018-04-16,TRF TO  Indiaforensic SERVICES I,5600000.0,0.0,48657.470000002526,2018,4,16,CASH_OUT,5600000.0,C998351292
1753,409000438611',2018-04-17,Indiaforensic MASTER ACQ DOM 170,0.0,1376994.9,1425652.3700000024,2018,4,17,TRANSFER,1376994.9,M274298188
1754,409000438611',2018-04-17,Indiaforensic RUPAY POS ACQ 1704,0.0,2798974.02,4224626.3900000015,2018,4,17,CHECK_CASHING,2798974.02,M1223144402
1755,409000438611',2018-04-17,Indiaforensic VISA ACQ INT 12041,0.0,1437.65,4226064.040000003,2018,4,17,TRANSFER,1437.65,C75457651
1756,409000438611',2018-04-17,17825-IRTT00701811345-BIL,13029.46,0.0,4213034.580000003,2018,4,17,CASH_OUT,13029.46,C1292838001
1757,409000438611',2018-04-17,Indiaforensic VISA ACQ DOM 17041,0.0,2107621.92,6320656.500000003,2018,4,17,TRANSFER,2107621.92,M285754614
1758,409000438611',2018-04-17,TRF TO  Indiaforensic SERVICES I,4200000.0,0.0,2120656.500000004,2018,4,17,CASH_OUT,4200000.0,M233951222
1759,409000438611',2018-04-17,ICA17825 Indiaforensic MC ADJ 11,0.0,9087.19,2129743.6900000027,2018,4,17,TRANSFER,9087.19,M450438867
1760,409000438611',2018-04-18,TRF TO  Indiaforensic SERVICES I,2100000.0,0.0,29743.690000002734,2018,4,18,CASH_OUT,2100000.0,M969811954
1761,409000438611',2018-04-18,Indiaforensic RUPAY POS ACQ 1804,0.0,2949820.91,2979564.600000004,2018,4,18,TRANSFER,2949820.91,C1321530272
1762,409000438611',2018-04-18,Indiaforensic MASTER ACQ DOM 180,0.0,1606609.27,4586173.870000003,2018,4,18,CHECK_CASHING,1606609.27,C884457408
1763,409000438611',2018-04-18,Indiaforensic VISA ACQ DOM 18041,0.0,1867981.14,6454155.010000003,2018,4,18,CASH_IN,1867981.14,M1623287112
1764,409000438611',2018-04-18,TRF TO  Indiaforensic SERVICES I,6400000.0,0.0,54155.01000000257,2018,4,18,PAYEMENT,6400000.0,C747464370
1765,409000438611',2018-04-18,Indiaforensic VISA ACQ INT 14041,0.0,2036.35,56191.36000000257,2018,4,18,CHECK_CASHING,2036.35,C515132998
1766,409000438611',2018-04-19,Indiaforensic RUPAY POS ACQ 1904,0.0,3379206.77,3435398.1300000027,2018,4,19,CASH_IN,3379206.77,M1396292525
1767,409000438611',2018-04-19,Indiaforensic MASTER ACQ DOM 190,0.0,1451542.54,4886940.670000003,2018,4,19,TRANSFER,1451542.54,M680150616
1768,409000438611',2018-04-19,Indiaforensic VISA ACQ DOM 19041,0.0,1993420.23,6880360.900000002,2018,4,19,CASH_IN,1993420.23,M1160546880
1769,409000438611',2018-04-19,TRF TO  Indiaforensic SERVICES I,500000.0,0.0,6380360.900000002,2018,4,19,DEBIT,500000.0,M687892306
1770,409000438611',2018-04-19,TRF TO  Indiaforensic SERVICES I,1000000.0,0.0,5380360.900000002,2018,4,19,CASH_OUT,1000000.0,C728885526
1771,409000438611',2018-04-19,TRF TO  Indiaforensic SERVICES I,5000000.0,0.0,380360.9000000023,2018,4,19,CASH_OUT,5000000.0,M659115590
1772,409000438611',2018-04-20,Indiaforensic RUPAY POS ACQ 2004,0.0,2729885.42,3110246.3200000017,2018,4,20,CHECK_CASHING,2729885.42,M507583873
1773,409000438611',2018-04-20,Indiaforensic MASTER ACQ DOM 200,0.0,1343076.87,4453323.190000002,2018,4,20,CHECK_CASHING,1343076.87,M1047515321
1774,409000438611',2018-04-20,Indiaforensic VISA ACQ INT 18041,0.0,315.78,4453638.9700000025,2018,4,20,CASH_IN,315.78,M1769227988
1775,409000438611',2018-04-20,Indiaforensic VISA ACQ DOM 20041,0.0,1954967.01,6408605.980000002,2018,4,20,CASH_IN,1954967.01,C985934102
1776,409000438611',2018-04-21,TRF TO  Indiaforensic SERVICES I,4000000.0,0.0,2408605.9800000023,2018,4,21,DEBIT,4000000.0,C1850180796
1777,409000438611',2018-04-21,TRF TO  Indiaforensic SERVICES I,2000000.0,0.0,408605.98000000225,2018,4,21,DEBIT,2000000.0,C401424608
1778,409000438611',2018-04-21,Indiaforensic RUPAY POS ACQ 2104,0.0,2527381.4,2935987.3800000018,2018,4,21,CASH_IN,2527381.4,C716083600
1779,409000438611',2018-04-21,Indiaforensic VISA ACQ DOM 21041,0.0,1655224.25,4591211.630000003,2018,4,21,CASH_IN,1655224.25,C1286084959
1780,409000438611',2018-04-21,TRF TO  Indiaforensic SERVICES I,500000.0,0.0,4091211.6300000027,2018,4,21,PAYEMENT,500000.0,C306206744
1781,409000438611',2018-04-21,TRF TO  Indiaforensic SERVICES I,4000000.0,0.0,91211.63000000268,2018,4,21,PAYEMENT,4000000.0,C1816757085
1782,409000438611',2018-04-23,Indiaforensic MSTR ACQ DOM21-230,0.0,3526486.0,3617697.6300000027,2018,4,23,CHECK_CASHING,3526486.0,C1850180796
1783,409000438611',2018-04-23,Indiaforensic RUPAY POS ACQ 2204,0.0,2427227.06,6044924.690000002,2018,4,23,CASH_IN,2427227.06,C1262822392
1784,409000438611',2018-04-23,Indiaforensic RUPAY POS ACQ 2304,0.0,2110934.51,8155859.200000002,2018,4,23,CHECK_CASHING,2110934.51,C1740000325
1785,409000438611',2018-04-23,Indiaforensic VISA ACQ INT 19041,0.0,14850.0,8170709.200000002,2018,4,23,TRANSFER,14850.0,C1262822392
1786,409000438611',2018-04-23,Indiaforensic VISA ACQ DOM 23041,0.0,3602285.91,11772995.110000005,2018,4,23,TRANSFER,3602285.91,C248609774
1787,409000438611',2018-04-23,TRF TO  Indiaforensic SERVICES I,10000000.0,0.0,1772995.1100000031,2018,4,23,DEBIT,10000000.0,C1883840933
1788,409000438611',2018-04-23,TRF TO  Indiaforensic SERVICES I,1000000.0,0.0,772995.1100000031,2018,4,23,DEBIT,1000000.0,C1816757085
1789,409000438611',2018-04-24,Indiaforensic MASTER ACQ DOM 240,0.0,1523557.64,2296552.750000004,2018,4,24,CASH_IN,1523557.64,C1782113663
1790,409000438611',2018-04-24,Indiaforensic VISA ACQ DOM 21041,0.0,1999939.23,4296491.980000002,2018,4,24,CHECK_CASHING,1999939.23,C1816757085
1791,409000438611',2018-04-24,Indiaforensic RUPAY POS ACQ 2404,0.0,2710298.95,7006790.9300000025,2018,4,24,TRANSFER,2710298.95,C1721246982
1792,409000438611',2018-04-24,17825-IRTT00701812061-BIL,12200.94,0.0,6994589.990000002,2018,4,24,CASH_OUT,12200.94,C557041912
1793,409000438611',2018-04-24,TRF TO  Indiaforensic SERVICES I,4000000.0,0.0,2994589.990000002,2018,4,24,CASH_OUT,4000000.0,M814245389
1794,409000438611',2018-04-24,TRF TO  Indiaforensic SERVICES I,3000000.0,0.0,,2018,4,24,DEBIT,3000000.0,M855501888
1795,409000438611',2018-04-25,Indiaforensic RUPAY POS ACQ 2504,0.0,2599911.74,2594501.7300000023,2018,4,25,CHECK_CASHING,2599911.74,M467146800
1796,409000438611',2018-04-25,Indiaforensic VISA ACQ DOM 25041,0.0,1836830.56,4431332.290000003,2018,4,25,TRANSFER,1836830.56,M1693003105
1797,409000438611',2018-04-25,Indiaforensic MASTER ACQ DOM 250,0.0,1396642.26,5827974.550000003,2018,4,25,TRANSFER,1396642.26,M1255445356
1798,409000438611',2018-04-25,TRF TO  Indiaforensic SERVICES I,5800000.0,0.0,27974.550000002608,2018,4,25,DEBIT,5800000.0,M83674409
1799,409000438611',2018-04-26,Indiaforensic VISA ACQ DOM 26041,0.0,1808043.71,1836018.2600000026,2018,4,26,CASH_IN,1808043.71,M1273879638
1800,409000438611',2018-04-26,Indiaforensic RUPAY POS ACQ 2604,0.0,2769536.21,4605554.4700000025,2018,4,26,TRANSFER,2769536.21,M461448225
1801,409000438611',2018-04-26,Indiaforensic MASTER ACQ DOM 260,0.0,1369018.98,5974573.450000002,2018,4,26,CASH_IN,1369018.98,M2021835850
1802,409000438611',2018-04-26,TRF TO  Indiaforensic SERVICES I,5900000.0,0.0,74573.45000000298,2018,4,26,DEBIT,5900000.0,M550572371
1803,409000438611',2018-04-27,Indiaforensic VISA ACQ DOM  2741,0.0,1990817.21,2065390.6600000032,2018,4,27,CHECK_CASHING,1990817.21,M1447685190
1804,409000438611',2018-04-27,Indiaforensic RUPAY POS ACQ 2704,0.0,2381810.96,4447201.620000003,2018,4,27,TRANSFER,2381810.96,M1345293143
1805,409000438611',2018-04-27,Indiaforensic MASTER ACQ DOM 270,0.0,1571281.06,6018482.6800000025,2018,4,27,TRANSFER,1571281.06,C243745864
1806,409000438611',2018-04-27,TRF TO  Indiaforensic SERVICES I,6000000.0,0.0,18482.680000003427,2018,4,27,DEBIT,6000000.0,M1427247001
1807,409000438611',2018-04-27,Indiaforensic VISA ACQ INT 25041,0.0,0.99,18483.67000000343,2018,4,27,TRANSFER,0.99,M955443582
1808,409000438611',2018-05-02,Indiaforensic RUPAY POS ACQ 2804,0.0,2266050.67,2284534.340000004,2018,5,2,TRANSFER,2266050.67,M842422776
1809,409000438611',2018-05-02,Indiaforensic RUPAY POS ACQ 2904,0.0,2247496.04,4532030.380000004,2018,5,2,TRANSFER,2247496.04,M1045567253
1810,409000438611',2018-05-02,Indiaforensic RUPAY POS ACQ 3004,0.0,1885492.58,6417522.960000004,2018,5,2,CHECK_CASHING,1885492.58,M643587433
1811,409000438611',2018-05-02,Indiaforensic RUPAY POS ACQ 0105,0.0,2449654.68,8867177.640000004,2018,5,2,CHECK_CASHING,2449654.68,M1019348343
1812,409000438611',2018-05-02,Indiaforensic RUPAY POS ACQ 0205,0.0,2640640.43,11507818.070000006,2018,5,2,CASH_IN,2640640.43,C837659261
1813,409000438611',2018-05-02,Indiaforensic VISA ACQ DOM  2804,0.0,1786806.5,13294624.570000006,2018,5,2,TRANSFER,1786806.5,C824009085
1814,409000438611',2018-05-02,Indiaforensic VISA ACQ DOM  3004,0.0,4070818.32,17365442.890000004,2018,5,2,CHECK_CASHING,4070818.32,C1023714065
1815,409000438611',2018-05-02,Indiaforensic VISA ACQ DOM  0105,0.0,2107635.67,19473078.56,2018,5,2,CHECK_CASHING,2107635.67,C1568059495
1816,409000438611',2018-05-02,Indiaforensic VISA ACQ DOM  0205,0.0,2276385.18,21749463.74,2018,5,2,CASH_IN,2276385.18,C1899073220
1817,409000438611',2018-05-02,IndiaforensicMASTRACQDOM2804-020,0.0,6920176.73,28669640.47000001,2018,5,2,CASH_IN,6920176.73,C392292416
1818,409000438611',2018-05-02,TRF TO  Indiaforensic SERVICES I,15000000.0,0.0,13669640.470000004,2018,5,2,CHECK_WITHDRAWAL,15000000.0,C1883840933
1819,409000438611',2018-05-02,TRF TO  Indiaforensic SERVICES I,6700000.0,0.0,6969640.4700000025,2018,5,2,CHECK_WITHDRAWAL,6700000.0,C33524623
1820,409000438611',2018-05-02,TRF TO  Indiaforensic SERVICES I,6000000.0,0.0,969640.4700000023,2018,5,2,DEBIT,6000000.0,C22805895
1821,409000438611',2018-05-02,Indiaforensic VISA ACQ INT 26041,0.0,1017.68,970658.1500000028,2018,5,2,TRANSFER,1017.68,C1782113663
1822,409000438611',2018-05-02,17825-MASTERCARD BILL 290,116912.1,0.0,853746.0500000026,2018,5,2,CASH_OUT,116912.1,C1170794006
1823,409000438611',2018-05-02,Indiaforensic MASTER INT SET 300,0.0,3186.74,856932.7900000026,2018,5,2,CHECK_CASHING,3186.74,C97730845
1824,409000438611',2018-05-03,Indiaforensic VISA ACQ DOM  0305,0.0,2039309.61,2896242.4000000027,2018,5,3,CHECK_CASHING,2039309.61,C968113504
1825,409000438611',2018-05-03,Indiaforensic RUPAY POS ACQ 0305,0.0,2561426.64,5457669.040000003,2018,5,3,CASH_IN,2561426.64,M1274225913
1826,409000438611',2018-05-03,Indiaforensic MASTER ACQ DOM 030,0.0,417359.85,5875028.890000002,2018,5,3,CHECK_CASHING,417359.85,M212232499
1827,409000438611',2018-05-03,TRF TO  Indiaforensic SERVICES I,5800000.0,0.0,75028.89000000246,2018,5,3,DEBIT,5800000.0,M1335914322
1828,409000438611',2018-05-03,17825-MASTERCARD BILL 300,8878.87,0.0,66150.02000000246,2018,5,3,PAYEMENT,8878.87,M1610372241
1829,409000438611',2018-05-03,Indiaforensic MC BILL RECOVERY A,65768.99,0.0,381.0300000024581,2018,5,3,CHECK_WITHDRAWAL,65768.99,C1509514333
1830,409000438611',2018-05-04,Indiaforensic MASTER ACQ DOM0405,0.0,2420684.44,2421065.4700000025,2018,5,4,CASH_IN,2420684.44,C932583850
1831,409000438611',2018-05-04,Indiaforensic VISA ACQ DOM040518,0.0,1960038.47,4381103.940000002,2018,5,4,CASH_IN,1960038.47,C812586739
1832,409000438611',2018-05-04,TRF TO  Indiaforensic SERVICES I,4300000.0,0.0,81103.94000000227,2018,5,4,CHECK_WITHDRAWAL,4300000.0,C1262822392
1833,409000438611',2018-05-04,Indiaforensic RUPAY POS ACQ04051,0.0,2522789.37,2603893.3100000024,2018,5,4,CHECK_CASHING,2522789.37,C1750905143
1834,409000438611',2018-05-05,TRF TO  Indiaforensic SERVICES I,500000.0,0.0,2103893.3100000024,2018,5,5,CASH_OUT,500000.0,C1401316767
1835,409000438611',2018-05-05,TRF TO  Indiaforensic SERVICES I,2000000.0,0.0,103893.31000000238,2018,5,5,PAYEMENT,2000000.0,C1256728724
1836,409000438611',2018-05-05,Indiaforensic VISA ACQ DOM050518,0.0,2320432.48,2424325.7900000024,2018,5,5,CHECK_CASHING,2320432.48,C97730845
1837,409000438611',2018-05-05,Indiaforensic RUPAY POS ACQ05051,0.0,2763039.35,5187365.1400000015,2018,5,5,TRANSFER,2763039.35,C1286084959
1838,409000438611',2018-05-05,Indiaforensic VISA ACQ INT 02051,0.0,989.0,5188354.1400000015,2018,5,5,CHECK_CASHING,989.0,C1810132623
1839,409000438611',2018-05-05,TRF TO  Indiaforensic SERVICES I,5000000.0,0.0,188354.14000000246,2018,5,5,PAYEMENT,5000000.0,C2083562754
1840,409000438611',2018-05-07,Indiaforensic VISA ACQ DOM070518,0.0,4573066.02,4761420.160000002,2018,5,7,TRANSFER,4573066.02,C97730845
1841,409000438611',2018-05-07,Indiaforensic RUPAY POS ACQ06051,0.0,2648588.04,7410008.200000002,2018,5,7,CASH_IN,2648588.04,C1850180796
1842,409000438611',2018-05-07,TRF TO  Indiaforensic SERVICES I,4000000.0,0.0,3410008.200000002,2018,5,7,PAYEMENT,4000000.0,C1330400026
1843,409000438611',2018-05-07,TRF TO  Indiaforensic SERVICES I,3000000.0,0.0,410008.2000000021,2018,5,7,CASH_OUT,3000000.0,C1740000325
1844,409000438611',2018-05-07,Indiaforensic MASTER ACQ DOM0705,0.0,4142179.56,4552187.760000002,2018,5,7,CASH_IN,4142179.56,C665576141
1845,409000438611',2018-05-07,Indiaforensic RUPAY POS ACQ07051,0.0,1949655.7,6501843.460000003,2018,5,7,CHECK_CASHING,1949655.7,C655381473
1846,409000438611',2018-05-08,TRF TO  Indiaforensic SERVICES I,6500000.0,0.0,1843.4600000018247,2018,5,8,DEBIT,6500000.0,C97730845
1847,409000438611',2018-05-08,Indiaforensic MASTER ACQ DOM0805,0.0,1567349.6,1569193.060000002,2018,5,8,CASH_IN,1567349.6,C2083562754
1848,409000438611',2018-05-08,Indiaforensic VISA ACQ DOM080518,0.0,2245491.12,3814684.180000002,2018,5,8,CHECK_CASHING,2245491.12,C1256728724
1849,409000438611',2018-05-08,TRF TO  Indiaforensic SERVICES I,3800000.0,0.0,14684.180000002032,2018,5,8,PAYEMENT,3800000.0,C1629911510
1850,409000438611',2018-05-08,Indiaforensic MASTER INT SET 070,0.0,396.42,15080.60000000203,2018,5,8,TRANSFER,396.42,C716083600
1851,409000438611',2018-05-08,17825-MASTERCARD BILL 060,18990.35,0.0,,2018,5,8,CASH_OUT,18990.35,C20671747
1852,409000438611',2018-05-08,Indiaforensic RUPAY POS ACQ08051,0.0,2507929.95,2504020.200000002,2018,5,8,TRANSFER,2507929.95,C2083562754
1853,409000438611',2018-05-09,TRF TO  Indiaforensic SERVICES I,2000000.0,0.0,504020.2000000021,2018,5,9,CASH_OUT,2000000.0,C1568059495
1854,409000438611',2018-05-09,Indiaforensic MASTER ACQ DOM0905,0.0,1700570.48,2204590.680000002,2018,5,9,TRANSFER,1700570.48,C997608398
1855,409000438611',2018-05-09,Indiaforensic VISA ACQ DOM090518,0.0,2048217.55,4252808.230000002,2018,5,9,CASH_IN,2048217.55,C721748895
1856,409000438611',2018-05-09,Indiaforensic RUPAY POS ACQ09051,0.0,2485332.73,6738140.960000003,2018,5,9,CASH_IN,2485332.73,C1870252780
1857,409000438611',2018-05-09,TRF TO  Indiaforensic SERVICES I,6700000.0,0.0,38140.96000000277,2018,5,9,CHECK_WITHDRAWAL,6700000.0,C665576141
1858,409000438611',2018-05-09,Indiaforensic VISA ACQ INT 07051,0.0,752.14,38893.100000002756,2018,5,9,CHECK_CASHING,752.14,C1330400026
1859,409000438611',2018-05-10,Indiaforensic MASTER ACQ DOM1005,0.0,1870284.56,1909177.6600000027,2018,5,10,TRANSFER,1870284.56,C1590550415
1860,409000438611',2018-05-10,Indiaforensic VISA ACQ DOM100518,0.0,2372805.88,4281983.540000003,2018,5,10,CASH_IN,2372805.88,C1831477404
1861,409000438611',2018-05-10,Indiaforensic RUPAY POS ACQ10051,0.0,2592512.6,6874496.140000002,2018,5,10,CASH_IN,2592512.6,C22805895
1862,409000438611',2018-05-10,TRF TO  Indiaforensic SERVICES I,5000000.0,0.0,1874496.1400000025,2018,5,10,DEBIT,5000000.0,C985934102
1863,409000438611',2018-05-10,TRF TO  Indiaforensic SERVICES I,1000000.0,0.0,874496.1400000025,2018,5,10,DEBIT,1000000.0,C1816757085
1864,409000438611',2018-05-10,TRF TO  Indiaforensic SERVICES I,500000.0,0.0,374496.1400000025,2018,5,10,CHECK_WITHDRAWAL,500000.0,C716083600
1865,409000438611',2018-05-11,Indiaforensic MASTER ACQ DOM1105,0.0,1317448.3,1691944.4400000025,2018,5,11,TRANSFER,1317448.3,C1096283470
1866,409000438611',2018-05-11,Indiaforensic VISA ACQ DOM110518,0.0,2099887.49,3791831.9300000025,2018,5,11,TRANSFER,2099887.49,M7346738
1867,409000438611',2018-05-11,Indiaforensic RUPAY POS ACQ11051,0.0,2540774.91,6332606.840000003,2018,5,11,TRANSFER,2540774.91,C1831477404
1868,409000438611',2018-05-11,Indiaforensic VISA ACQ INT 09051,0.0,154.28,6332761.120000003,2018,5,11,TRANSFER,154.28,M667680223
1869,409000438611',2018-05-11,Indiaforensic MASTER INT SET1005,0.0,2017.56,6334778.6800000025,2018,5,11,TRANSFER,2017.56,C1384210339
1870,409000438611',2018-05-11,TRF TO  Indiaforensic SERVICES I,6300000.0,0.0,34778.680000002496,2018,5,11,PAYEMENT,6300000.0,C1364913072
1871,409000438611',2018-05-14,Indiaforensic VISA ACQ DOM120518,0.0,2463753.88,2498532.5600000024,2018,5,14,TRANSFER,2463753.88,M943666520
1872,409000438611',2018-05-14,Indiaforensic RUPAY POS ACQ12051,0.0,2672616.89,5171149.450000003,2018,5,14,CASH_IN,2672616.89,M892231982
1873,409000438611',2018-05-14,Indiaforensic RUPAY POS ACQ13051,0.0,2642429.63,7813579.080000003,2018,5,14,CASH_IN,2642429.63,M606365803
1874,409000438611',2018-05-14,Indiaforensic MASTER ACQ DOM12-1,0.0,4858349.67,12671928.750000006,2018,5,14,CHECK_CASHING,4858349.67,M675833472
1875,409000438611',2018-05-14,Indiaforensic VISA ACQ DOM140518,0.0,4092941.01,16764869.760000005,2018,5,14,CHECK_CASHING,4092941.01,M1243495105
1876,409000438611',2018-05-14,Indiaforensic RUPAY POS ACQ14051,0.0,2352399.15,19117268.910000004,2018,5,14,CHECK_CASHING,2352399.15,C2083117811
1877,409000438611',2018-05-14,Indiaforensic MASTER INT SET1105,0.0,98.87,19117367.780000005,2018,5,14,TRANSFER,98.87,M999221400
1878,409000438611',2018-05-14,TRF TO  Indiaforensic SERVICES I,5000000.0,0.0,14117367.780000005,2018,5,14,DEBIT,5000000.0,C932583850
1879,409000438611',2018-05-14,TRF TO  Indiaforensic SERVICES I,5000000.0,0.0,9117367.780000003,2018,5,14,CHECK_WITHDRAWAL,5000000.0,M1392570698
1880,409000438611',2018-05-14,TRF TO  Indiaforensic SERVICES I,4000000.0,0.0,5117367.780000005,2018,5,14,DEBIT,4000000.0,M2008746677
1881,409000438611',2018-05-14,TRF TO  Indiaforensic SERVICES I,5000000.0,0.0,117367.78000000492,2018,5,14,DEBIT,5000000.0,M1420623741
1882,409000438611',2018-05-14,Indiaforensic RUPAY POS ACQ C214,0.0,755045.86,872413.6400000048,2018,5,14,CHECK_CASHING,755045.86,M1418245573
1883,409000438611',2018-05-15,Indiaforensic MASTER ACQ DOM 150,0.0,1738774.24,2611187.880000005,2018,5,15,CASH_IN,1738774.24,M1898751355
1884,409000438611',2018-05-15,Indiaforensic VISA ACQ DOM150518,0.0,2385513.17,4996701.050000005,2018,5,15,TRANSFER,2385513.17,C1504109395
1885,409000438611',2018-05-15,Indiaforensic RUPAY POS ACQ15051,0.0,1972648.33,6969349.380000005,2018,5,15,CASH_IN,1972648.33,M1366581056
1886,409000438611',2018-05-15,Indiaforensic RUPAY POS C2 ACQ15,0.0,704726.12,7674075.500000005,2018,5,15,TRANSFER,704726.12,C1330400026
1887,409000438611',2018-05-15,Indiaforensic MASTER INT SET 120,0.0,1110.98,7675186.480000005,2018,5,15,CHECK_CASHING,1110.98,M1776486598
1888,409000438611',2018-05-15,17825-MASTERCARD BILL 130,46586.39,0.0,7628600.090000005,2018,5,15,CASH_OUT,46586.39,M1719547057
1889,409000438611',2018-05-15,TRF TO  Indiaforensic SERVICES I,7600000.0,0.0,28600.09000000544,2018,5,15,CASH_OUT,7600000.0,M1840940155
1890,409000438611',2018-05-15,Indiaforensic VISA ACQ INT 11051,0.0,1473.0,30073.09000000544,2018,5,15,CHECK_CASHING,1473.0,M371440613
1891,409000438611',2018-05-15,Indiaforensic RUPAY POS C2 ACQ15,0.0,689325.1,719398.1900000054,2018,5,15,CASH_IN,689325.1,M1129387802
1892,409000438611',2018-05-15,Indiaforensic RUPAY POS C2 REV15,704726.12,0.0,14672.07000000542,2018,5,15,CASH_OUT,704726.12,M936380963
1893,409000438611',2018-05-16,Indiaforensic MASTER ACQ DOM 160,0.0,1944216.67,1958888.7400000053,2018,5,16,CASH_IN,1944216.67,M144467413
1894,409000438611',2018-05-16,Indiaforensic VISA ACQ DOM160518,0.0,2242024.53,4200913.270000005,2018,5,16,TRANSFER,2242024.53,M941403433
1895,409000438611',2018-05-16,Indiaforensic RUPAY POS ACQ16051,0.0,2035902.75,6236816.020000005,2018,5,16,TRANSFER,2035902.75,M1649498695
1896,409000438611',2018-05-16,Indiaforensic RUPAY POS C2 ACQ16,0.0,672031.96,6908847.980000005,2018,5,16,CHECK_CASHING,672031.96,C1935365522
1897,409000438611',2018-05-16,TRF TO  Indiaforensic SERVICES I,6900000.0,0.0,8847.980000005104,2018,5,16,PAYEMENT,6900000.0,M688988404
1898,409000438611',2018-05-17,Indiaforensic MASTER ACQ DOM 170,0.0,1651074.91,1659922.890000005,2018,5,17,TRANSFER,1651074.91,C1899073220
1899,409000438611',2018-05-17,Indiaforensic VISA ACQ DOM170518,0.0,2177997.43,3837920.320000005,2018,5,17,CASH_IN,2177997.43,C1983747920
1900,409000438611',2018-05-17,Indiaforensic RUPAY POS ACQ17051,0.0,1841592.19,5679512.510000005,2018,5,17,CASH_IN,1841592.19,C832279283
1901,409000438611',2018-05-17,Indiaforensic RUPAY POS C2 ACQ17,0.0,608910.25,6288422.760000005,2018,5,17,CASH_IN,608910.25,C837659261
1902,409000438611',2018-05-17,TRF TO  Indiaforensic SERVICES I,5000000.0,0.0,1288422.7600000054,2018,5,17,CHECK_WITHDRAWAL,5000000.0,C747464370
1903,409000438611',2018-05-17,TRF TO  Indiaforensic SERVICES I,500000.0,0.0,788422.7600000055,2018,5,17,CHECK_WITHDRAWAL,500000.0,C977993101
1904,409000438611',2018-05-18,Indiaforensic MASTER ACQ DOM 180,0.0,1546537.3,2334960.060000005,2018,5,18,CASH_IN,1546537.3,C665576141
1905,409000438611',2018-05-18,Indiaforensic VISA ACQ DOM180518,0.0,1876027.77,4210987.830000007,2018,5,18,TRANSFER,1876027.77,C1749186397
1906,409000438611',2018-05-18,Indiaforensic RUPAY POS ACQ18051,0.0,831720.35,5042708.180000005,2018,5,18,CHECK_CASHING,831720.35,C1060830840
1907,409000438611',2018-05-18,Indiaforensic RUPAY POS C2 ACQ18,0.0,1535054.2,6577762.380000005,2018,5,18,CASH_IN,1535054.2,C248609774
1908,409000438611',2018-05-18,TRF TO  Indiaforensic SERVICES I,6500000.0,0.0,77762.38000000548,2018,5,18,DEBIT,6500000.0,C1782113663
1909,409000438611',2018-05-19,Indiaforensic VISA ACQ DOM190518,0.0,2274889.5,2352651.8800000055,2018,5,19,CASH_IN,2274889.5,C306206744
1910,409000438611',2018-05-19,Indiaforensic RUPAY POS ACQ19051,0.0,1540689.63,3893341.510000005,2018,5,19,CASH_IN,1540689.63,M1311544814
1911,409000438611',2018-05-19,Indiaforensic RUPAY POS C2 ACQ19,0.0,647667.43,4541008.940000005,2018,5,19,CASH_IN,647667.43,C297927961
1912,409000438611',2018-05-19,Chq Book Issuance Charges,100.0,0.0,4540908.940000005,2018,5,19,CHECK_WITHDRAWAL,100.0,M1944815218
1913,409000438611',2018-05-19,GST,18.0,0.0,4540890.940000005,2018,5,19,CHECK_WITHDRAWAL,18.0,M1584833211
1914,409000438611',2018-05-19,TRF TO  Indiaforensic SERVICES I,500000.0,0.0,4040890.940000005,2018,5,19,PAYEMENT,500000.0,M1518752790
1915,409000438611',2018-05-19,TRF TO  Indiaforensic SERVICES I,3000000.0,0.0,1040890.9400000052,2018,5,19,CASH_OUT,3000000.0,M2146613458
1916,409000438611',2018-05-21,Indiaforensic VISA ACQ DOM210518,0.0,4478087.89,5518978.830000005,2018,5,21,TRANSFER,4478087.89,M1855112877
1917,409000438611',2018-05-21,Indiaforensic MSTER ACQ DOM19-21,0.0,4328512.48,9847491.310000006,2018,5,21,CHECK_CASHING,4328512.48,M1164699452
1918,409000438611',2018-05-21,TRF TO  Indiaforensic SERVICES I,1000000.0,0.0,8847491.310000006,2018,5,21,DEBIT,1000000.0,M1537912396
1919,409000438611',2018-05-21,TRF TO  Indiaforensic SERVICES I,8800000.0,0.0,47491.31000000613,2018,5,21,DEBIT,8800000.0,M1101451553
1920,409000438611',2018-05-21,Indiaforensic RUPAY POS ACQ20051,0.0,665162.4,712653.7100000061,2018,5,21,TRANSFER,665162.4,M1091736037
1921,409000438611',2018-05-21,Indiaforensic RUPAY POS ACQ21051,0.0,2743731.03,3456384.7400000063,2018,5,21,CHECK_CASHING,2743731.03,M435175610
1922,409000438611',2018-05-21,Indiaforensic RUPAY POS C2 ACQ21,0.0,792628.8,4249013.540000007,2018,5,21,CHECK_CASHING,792628.8,M669200356
1923,409000438611',2018-05-22,TRF TO  Indiaforensic SERVICES I,4000000.0,0.0,249013.54000000565,2018,5,22,DEBIT,4000000.0,M399653041
1924,409000438611',2018-05-22,Indiaforensic VISA ACQ DOM220518,0.0,2363062.07,2612075.6100000055,2018,5,22,CHECK_CASHING,2363062.07,M56510351
1925,409000438611',2018-05-22,Indiaforensic MASTER ACQ DOM 220,0.0,1468030.22,4080105.8300000057,2018,5,22,TRANSFER,1468030.22,M1803361784
1926,409000438611',2018-05-22,Indiaforensic RUPAY POS ACQ22051,0.0,1780694.23,5860800.060000006,2018,5,22,TRANSFER,1780694.23,M1104654975
1927,409000438611',2018-05-22,Indiaforensic RUPAY POS C2 ACQ22,0.0,632535.73,6493335.7900000075,2018,5,22,CHECK_CASHING,632535.73,M1243102466
1928,409000438611',2018-05-22,TRF TO  Indiaforensic SERVICES I,3000000.0,0.0,3493335.790000006,2018,5,22,CHECK_WITHDRAWAL,3000000.0,M557705922
1929,409000438611',2018-05-22,TRF TO  Indiaforensic SERVICES I,3000000.0,0.0,493335.79000000656,2018,5,22,CASH_OUT,3000000.0,M680865258
1930,409000438611',2018-05-22,TRF TO  Indiaforensic SERVICES I,500000.0,0.0,,2018,5,22,PAYEMENT,500000.0,M339581587
1931,409000438611',2018-05-23,Indiaforensic MASTER ACQ DOM 230,0.0,1645932.08,1639267.8700000066,2018,5,23,CASH_IN,1645932.08,M1096411163
1932,409000438611',2018-05-23,Indiaforensic VISA ACQ DOM230518,0.0,1912026.96,3551294.830000006,2018,5,23,CASH_IN,1912026.96,M600657906
1933,409000438611',2018-05-23,Indiaforensic RUPAY POS ACQ23051,0.0,1347961.46,4899256.290000007,2018,5,23,TRANSFER,1347961.46,M2123846943
1934,409000438611',2018-05-23,Indiaforensic MASTER INT SET 220,0.0,1211.4,4900467.690000007,2018,5,23,TRANSFER,1211.4,M167175174
1935,409000438611',2018-05-23,Indiaforensic RUPAY POS C2 ACQ23,0.0,555379.76,5455847.450000007,2018,5,23,TRANSFER,555379.76,M1047477166
1936,409000438611',2018-05-23,17825-MASTERCARD BILL 200,54996.23,0.0,5400851.220000006,2018,5,23,PAYEMENT,54996.23,M749693202
1937,409000438611',2018-05-23,TRF TO  Indiaforensic SERVICES I,4900000.0,0.0,500851.2200000063,2018,5,23,DEBIT,4900000.0,M874740624
1938,409000438611',2018-05-23,Indiaforensic POS ACQ SETT DT 13,151771.14,0.0,349080.08000000624,2018,5,23,CHECK_WITHDRAWAL,151771.14,M1244775150
1939,409000438611',2018-05-23,OXYGEN POS ACQ SETT DT 01,0.4,0.0,349079.6800000062,2018,5,23,DEBIT,0.4,M571481216
1940,409000438611',2018-05-24,Indiaforensic VISA ACQ DOM240518,0.0,1822995.24,2172074.9200000064,2018,5,24,CASH_IN,1822995.24,M1973256691
1941,409000438611',2018-05-24,Indiaforensic RUPAY POS ACQ24051,0.0,1336190.54,3508265.4600000065,2018,5,24,TRANSFER,1336190.54,M1514955661
1942,409000438611',2018-05-24,Indiaforensic MASTER ACQ DOM2405,0.0,989175.21,4497440.670000006,2018,5,24,CHECK_CASHING,989175.21,C1112414583
1943,409000438611',2018-05-24,Indiaforensic RUPAY POS C2 ACQ24,0.0,423888.81,4921329.480000006,2018,5,24,TRANSFER,423888.81,M645643802
1944,409000438611',2018-05-24,Indiaforensic VISA ACQ INT 19051,0.0,1109.87,4922439.350000006,2018,5,24,CASH_IN,1109.87,M949314262
1945,409000438611',2018-05-24,Indiaforensic VISA ACQ INT 21051,0.0,3921.2,4926360.550000006,2018,5,24,CASH_IN,3921.2,C1826334428
1946,409000438611',2018-05-24,TRF TO  Indiaforensic SERVICES I,4000000.0,0.0,926360.5500000064,2018,5,24,PAYEMENT,4000000.0,C977993101
1947,409000438611',2018-05-24,TRF TO  Indiaforensic SERVICES I,500000.0,0.0,426360.55000000633,2018,5,24,DEBIT,500000.0,M979420182
1948,409000438611',2018-05-24,Indiaforensic MASTER INT SET 230,0.0,19694.53,446055.0800000064,2018,5,24,CASH_IN,19694.53,C1076835071
1949,409000438611',2018-05-24,Indiaforensic MASTER INT REV 230,19694.53,0.0,426360.55000000633,2018,5,24,CASH_OUT,19694.53,C611572016
1950,409000438611',2018-05-25,Indiaforensic MASTER ACQ DOM2505,0.0,1550590.03,1976950.5800000064,2018,5,25,CHECK_CASHING,1550590.03,M1472012329
1951,409000438611',2018-05-25,Indiaforensic VISA ACQ DOM250518,0.0,1821144.86,3798095.4400000083,2018,5,25,TRANSFER,1821144.86,M244297136
1952,409000438611',2018-05-25,Indiaforensic RUPAY POS ACQ25051,0.0,1558686.7,5356782.140000006,2018,5,25,TRANSFER,1558686.7,M1399225534
1953,409000438611',2018-05-25,Indiaforensic RUPAY POS C2 ACQ25,0.0,525478.13,5882260.270000006,2018,5,25,CHECK_CASHING,525478.13,M1857007886
1954,409000438611',2018-05-25,TRF TO  Indiaforensic SERVICES I,5300000.0,0.0,582260.2700000061,2018,5,25,CASH_OUT,5300000.0,M1179272258
1955,409000438611',2018-05-25,TRF TO  Indiaforensic SERVICES I,500000.0,0.0,82260.27000000607,2018,5,25,PAYEMENT,500000.0,C1529115495
1956,409000438611',2018-05-28,Indiaforensic VISA ACQ DOM260518,0.0,1686864.84,1769125.1100000062,2018,5,28,CHECK_CASHING,1686864.84,M1467977993
1957,409000438611',2018-05-28,Indiaforensic RUPAY POS ACQ26051,0.0,1404747.3,3173872.410000006,2018,5,28,CHECK_CASHING,1404747.3,M1970612644
1958,409000438611',2018-05-28,Indiaforensic VISA ACQ DOM280518,0.0,4087600.82,7261473.230000006,2018,5,28,CHECK_CASHING,4087600.82,C747464370
1959,409000438611',2018-05-28,Indiaforensic RUPAY POS ACQ28051,0.0,2169989.48,9431462.710000006,2018,5,28,CASH_IN,2169989.48,M35864696
1960,409000438611',2018-05-28,Indiaforensic RUPAY POS ACQ27051,0.0,1434923.48,10866386.190000007,2018,5,28,CASH_IN,1434923.48,M1178777373
1961,409000438611',2018-05-28,IndforGN MSTR ACQ DOM26-2805,0.0,4162866.21,15029252.400000004,2018,5,28,CASH_IN,4162866.21,C1259769769
1962,409000438611',2018-05-28,Indiaforensic RUPAY POS C2 ACQ28,0.0,771253.84,15800506.240000006,2018,5,28,TRANSFER,771253.84,C1219273867
1963,409000438611',2018-05-28,TRF TO  Indiaforensic SERVICES I,15000000.0,0.0,800506.2400000058,2018,5,28,CHECK_WITHDRAWAL,15000000.0,M988786279
1964,409000438611',2018-05-28,17825 SETTLE _RECOVERY  P,807788.2,0.0,,2018,5,28,PAYEMENT,807788.2,M1729734072
1965,409000438611',2018-05-28,Indiaforensic MASTER INT SET 250,0.0,1932.21,,2018,5,28,CASH_IN,1932.21,M2037202079
1966,409000438611',2018-05-29,Indiaforensic MASTER ACQ DOM2905,0.0,1343077.32,1337727.570000006,2018,5,29,TRANSFER,1343077.32,M1105282397
1967,409000438611',2018-05-29,Indiaforensic RUPAY POS ACQ29051,0.0,1396983.31,2734710.880000006,2018,5,29,CHECK_CASHING,1396983.31,M1590481849
1968,409000438611',2018-05-29,Indiaforensic VISA ACQ DOM290518,0.0,2167808.29,4902519.1700000055,2018,5,29,TRANSFER,2167808.29,M116356643
1969,409000438611',2018-05-29,Indiaforensic RUPAY POS C2 ACQ29,0.0,440382.64,5342901.810000005,2018,5,29,CASH_IN,440382.64,M1544067887
1970,409000438611',2018-05-29,TRF TO  Indiaforensic SERVICES I,4900000.0,0.0,442901.8100000053,2018,5,29,PAYEMENT,4900000.0,M347791431
1971,409000438611',2018-05-30,Indiaforensic RUPAY POS ACQ30051,0.0,1483645.34,1926547.1500000053,2018,5,30,TRANSFER,1483645.34,M1720746883
1972,409000438611',2018-05-30,Indiaforensic RUPAY POS C2 ACQ30,0.0,429288.9,2355836.0500000054,2018,5,30,TRANSFER,429288.9,M45880026
1973,409000438611',2018-05-30,Indiaforensic MASTER INT SET 260,0.0,1956.96,2357793.0100000054,2018,5,30,TRANSFER,1956.96,M1397530667
1974,409000438611',2018-05-30,17825-MASTERCARD BILL 270,22558.67,0.0,2335234.3400000054,2018,5,30,DEBIT,22558.67,M1265287441
1975,409000438611',2018-05-30,Indiaforensic VISA ACQ DOM300518,0.0,1540043.33,3875277.6700000055,2018,5,30,CASH_IN,1540043.33,M1495257933
1976,409000438611',2018-05-30,TRF TO  Indiaforensic SERVICES I,3000000.0,0.0,875277.6700000055,2018,5,30,DEBIT,3000000.0,M2090563811
1977,409000438611',2018-05-31,Indiaforensic VISA ACQ DOM310518,0.0,2160618.13,3035895.800000005,2018,5,31,TRANSFER,2160618.13,M399149970
1978,409000438611',2018-05-31,Indiaforensic RUPAY POS ACQ31051,0.0,1537728.91,4573624.710000007,2018,5,31,CHECK_CASHING,1537728.91,C339924917
1979,409000438611',2018-05-31,Indiaforensic RUPAY POS C2 ACQ31,0.0,612456.09,5186080.800000005,2018,5,31,TRANSFER,612456.09,C757108857
1980,409000438611',2018-05-31,Indiaforensic VISA ACQ INT 28051,0.0,18864.93,5204945.730000005,2018,5,31,CASH_IN,18864.93,C1068824137
1981,409000438611',2018-05-31,TRF TO  Indiaforensic SERVICES I,5000000.0,0.0,204945.7300000051,2018,5,31,PAYEMENT,5000000.0,C1529115495
1982,409000438611',2018-06-01,17825 SETTLE _RECOVERY  P,145822.29,0.0,59123.440000005095,2018,6,1,CASH_OUT,145822.29,C1826334428
1983,409000438611',2018-06-01,Indiaforensic MASTER ACQ DOM3005,0.0,1434717.01,1493840.450000005,2018,6,1,TRANSFER,1434717.01,C721748895
1984,409000438611',2018-06-01,Indiaforensic MASTER ACQ DOM3105,0.0,1568332.5,3062172.950000005,2018,6,1,TRANSFER,1568332.5,C1883840933
1985,409000438611',2018-06-01,Indiaforensic MASTER ACQ DOM0106,0.0,1746404.08,4808577.030000005,2018,6,1,CASH_IN,1746404.08,C557041912
1986,409000438611',2018-06-01,Indiaforensic VISA ACQ DOM010618,0.0,2047683.47,6856260.500000005,2018,6,1,TRANSFER,2047683.47,C97730845
1987,409000438611',2018-06-01,Indiaforensic RUPAY POS ACQ01061,0.0,1375121.56,8231382.060000002,2018,6,1,CHECK_CASHING,1375121.56,C1740000325
1988,409000438611',2018-06-01,Indiaforensic RUPAY POS C2 ACQ01,0.0,578396.11,8809778.170000004,2018,6,1,TRANSFER,578396.11,C1076835071
1989,409000438611',2018-06-01,Indiaforensic VISA ACQ INT 30051,0.0,13962.7,8823740.870000003,2018,6,1,TRANSFER,13962.7,C728885526
1990,409000438611',2018-06-01,TRF TO  Indiaforensic SERVICES I,8200000.0,0.0,623740.8700000029,2018,6,1,PAYEMENT,8200000.0,C401424608
1991,409000438611',2018-06-01,Indiaforensic MASTER INT SET 310,0.0,8168.93,631909.800000003,2018,6,1,CASH_IN,8168.93,C306206744
1992,409000438611',2018-06-02,Indiaforensic VISA ACQ DOM020618,0.0,2010423.01,2642332.8100000042,2018,6,2,CHECK_CASHING,2010423.01,C728885526
1993,409000438611',2018-06-02,Indiaforensic RUPAY POS ACQ02061,0.0,1564615.81,4206948.620000003,2018,6,2,TRANSFER,1564615.81,C453211571
1994,409000438611',2018-06-02,TRF TO  Indiaforensic SERVICES I,4000000.0,0.0,206948.62000000288,2018,6,2,DEBIT,4000000.0,M1052399527
1995,409000438611',2018-06-02,Indiaforensic RUPAY POS C2 ACQ02,0.0,681686.42,888635.040000003,2018,6,2,CHECK_CASHING,681686.42,M51376124
1996,409000438611',2018-06-04,Indiaforensic RUPAY POS ACQ03061,0.0,1459607.79,2348242.8300000043,2018,6,4,CHECK_CASHING,1459607.79,M197855654
1997,409000438611',2018-06-04,Indiaforensic MASTER ACQ DOM0406,0.0,4528557.54,6876800.370000003,2018,6,4,CHECK_CASHING,4528557.54,C1234776885
1998,409000438611',2018-06-04,Indiaforensic VISA ACQ DOM040618,0.0,2123987.85,9000788.220000003,2018,6,4,CASH_IN,2123987.85,C793315160
1999,409000438611',2018-06-04,Indiaforensic RUPAY POS ACQ04061,0.0,1680897.6,10681685.820000002,2018,6,4,TRANSFER,1680897.6,M928734079
2000,409000438611',2018-06-04,17825-MASTERCARD BILL 310,15988.52,0.0,10665697.300000004,2018,6,4,CASH_OUT,15988.52,M684429600
2001,409000438611',2018-06-04,Indiaforensic RUPAY POS C2 ACQ04,0.0,664670.0,11330367.300000004,2018,6,4,TRANSFER,664670.0,M1450712470
2002,409000438611',2018-06-04,TRF TO  Indiaforensic SERVICES I,10600000.0,0.0,730367.3000000026,2018,6,4,DEBIT,10600000.0,M633727380
2003,409000438611',2018-06-05,Indiaforensic MASTER ACQ DOM0406,0.0,1583272.17,2313639.4700000025,2018,6,5,CHECK_CASHING,1583272.17,M562685863
2004,409000438611',2018-06-05,Indiaforensic VISA ACQ DOM040618,0.0,4412724.2,6726363.670000003,2018,6,5,CHECK_CASHING,4412724.2,M1664165134
2005,409000438611',2018-06-05,Indiaforensic MC BILL RECOVERY M,59830.75,0.0,6666532.920000003,2018,6,5,DEBIT,59830.75,M1682619279
2006,409000438611',2018-06-05,Indiaforensic VISA ACQ INT 01061,0.0,2970.0,6669502.920000003,2018,6,5,TRANSFER,2970.0,M1882348832
2007,409000438611',2018-06-05,17825-MASTERCARD BILL 030,30413.84,0.0,6639089.080000003,2018,6,5,CASH_OUT,30413.84,M1300528434
2008,409000438611',2018-06-05,Indiaforensic RUPAY POS C2 ACQ04,0.0,563098.78,7202187.860000002,2018,6,5,CHECK_CASHING,563098.78,M1031775150
2009,409000438611',2018-06-05,Indiaforensic RUPAY POS ACQ04061,0.0,1729441.59,8931629.450000003,2018,6,5,CHECK_CASHING,1729441.59,M906347731
2010,409000438611',2018-06-05,TRF TO  Indiaforensic SERVICES I,6700000.0,0.0,2231629.450000003,2018,6,5,CHECK_WITHDRAWAL,6700000.0,M410958248
2011,409000438611',2018-06-06,TRF TO  Indiaforensic SERVICES I,2000000.0,0.0,231629.45000000298,2018,6,6,CHECK_WITHDRAWAL,2000000.0,M1792088662
2012,409000438611',2018-06-06,Indiaforensic MASTER INT SET 050,0.0,14732.87,246362.32000000298,2018,6,6,CASH_IN,14732.87,M1073051173
2013,409000438611',2018-06-06,Indiaforensic MASTER ACQ DOM0606,0.0,1083675.16,1330037.4800000028,2018,6,6,TRANSFER,1083675.16,M2088969892
2014,409000438611',2018-06-06,Indiaforensic VISA ACQ DOM060618,0.0,1885106.57,3215144.0500000026,2018,6,6,CHECK_CASHING,1885106.57,M1665308978
2015,409000438611',2018-06-06,Indiaforensic RUPAY POS ACQ06061,0.0,1081298.45,4296442.500000003,2018,6,6,CHECK_CASHING,1081298.45,C1234776885
2016,409000438611',2018-06-06,Indiaforensic RUPAY POS C2 ACQ06,0.0,427317.08,4723759.580000003,2018,6,6,TRANSFER,427317.08,M1862347028
2017,409000438611',2018-06-06,Indiaforensic MASTER ACQ DOM INT,0.0,1813.56,4725573.1400000015,2018,6,6,CASH_IN,1813.56,M13643661
2018,409000438611',2018-06-06,TRF TO  Indiaforensic SERVICES I,4000000.0,0.0,725573.1400000025,2018,6,6,DEBIT,4000000.0,M102052782
2019,409000438611',2018-06-06,TRF TO  Indiaforensic SERVICES I,500000.0,0.0,225573.1400000025,2018,6,6,DEBIT,500000.0,M1913017282
2020,409000438611',2018-06-06,Indiaforensic VISA ACQ INT 02061,0.0,2062.42,227635.5600000025,2018,6,6,CHECK_CASHING,2062.42,M1792381498
2021,409000438611',2018-06-06,Indiaforensic VISA ACQ INT 04061,0.0,2001.6,229637.1600000025,2018,6,6,TRANSFER,2001.6,M70978270
2022,409000438611',2018-06-07,Indiaforensic MASTER INT REV 050,14732.87,0.0,214904.29000000245,2018,6,7,DEBIT,14732.87,M353891891
2023,409000438611',2018-06-07,Indiaforensic MASTER ACQ DOM0706,0.0,1563685.34,1778589.6300000031,2018,6,7,CASH_IN,1563685.34,M332498651
2024,409000438611',2018-06-07,Indiaforensic VISA ACQ DOM070618,0.0,1703002.31,3481591.9400000023,2018,6,7,CHECK_CASHING,1703002.31,M1164289802
2025,409000438611',2018-06-07,Indiaforensic RUPAY POS ACQ07061,0.0,1333410.23,4815002.170000003,2018,6,7,CHECK_CASHING,1333410.23,C200224114
2026,409000438611',2018-06-07,TRF TO  Indiaforensic SERVICES I,4800000.0,0.0,15002.17000000272,2018,6,7,PAYEMENT,4800000.0,M824900551
2027,409000438611',2018-06-07,Indiaforensic RUPAY POS C2 ACQ07,0.0,487642.24,502644.4100000027,2018,6,7,CASH_IN,487642.24,M129371198
2028,409000438611',2018-06-08,Indiaforensic MASTER ACQ DOM0806,0.0,1712868.04,2215512.450000003,2018,6,8,CHECK_CASHING,1712868.04,M1701436909
2029,409000438611',2018-06-08,Indiaforensic VISA ACQ DOM080618,0.0,1783366.33,3998878.780000003,2018,6,8,TRANSFER,1783366.33,M1896708863
2030,409000438611',2018-06-08,Indiaforensic RUPAY POS ACQ08061,0.0,1129595.63,5128474.410000003,2018,6,8,CASH_IN,1129595.63,M106113013
2031,409000438611',2018-06-08,Indiaforensic RUPAY POS C2 ACQ08,0.0,418795.4,5547269.810000003,2018,6,8,CASH_IN,418795.4,M807239968
2032,409000438611',2018-06-08,TRF TO  Indiaforensic SERVICES I,5000000.0,0.0,547269.8100000033,2018,6,8,DEBIT,5000000.0,M1917161212
2033,409000438611',2018-06-08,TRF TO  Indiaforensic SERVICES I,500000.0,0.0,47269.81000000332,2018,6,8,PAYEMENT,500000.0,C401424608
2034,409000438611',2018-06-11,Indiaforensic VISA ACQ DOM090618,0.0,2026125.18,2073394.990000004,2018,6,11,CASH_IN,2026125.18,M882706486
2035,409000438611',2018-06-11,Indiaforensic RUPAY POS ACQ09061,0.0,1510320.36,3583715.350000004,2018,6,11,CASH_IN,1510320.36,M1041451158
2036,409000438611',2018-06-11,Indiaforensic RUPAY POS ACQ10061,0.0,2093270.03,5676985.380000004,2018,6,11,CASH_IN,2093270.03,M775574071
2037,409000438611',2018-06-11,Indiaforensic VISA ACQ DOM110618,0.0,4585234.72,10262220.100000003,2018,6,11,TRANSFER,4585234.72,M1791589252
2038,409000438611',2018-06-11,Indiaforensic MASTER ACQ DOM1106,0.0,5545911.66,15808131.760000005,2018,6,11,CHECK_CASHING,5545911.66,M901815188
2039,409000438611',2018-06-11,TRF TO  Indiaforensic SERVICES I,15000000.0,0.0,808131.7600000034,2018,6,11,DEBIT,15000000.0,M205496410
2040,409000438611',2018-06-11,TRF TO  Indiaforensic SERVICES I,800000.0,0.0,8131.760000003502,2018,6,11,PAYEMENT,800000.0,C1286084959
2041,409000438611',2018-06-11,Indiaforensic RUPAY POS C2 ACQ11,0.0,789018.34,797150.1000000035,2018,6,11,TRANSFER,789018.34,C932583850
2042,409000438611',2018-06-12,Indiaforensic RUPAY POS C2 REV11,789018.34,0.0,8131.760000003502,2018,6,12,CHECK_WITHDRAWAL,789018.34,M1225114731
2043,409000438611',2018-06-12,Indiaforensic RUPAY POS ACQ11061,0.0,2213418.38,2221550.140000004,2018,6,12,CASH_IN,2213418.38,M288797801
2044,409000438611',2018-06-12,Indiaforensic RUPAY POS C2 ACQ11,0.0,704615.05,2926165.190000003,2018,6,12,CHECK_CASHING,704615.05,C2083117811
2045,409000438611',2018-06-12,Indiaforensic MASTER ACQ DOM1206,0.0,1996176.12,4922341.310000003,2018,6,12,CASH_IN,1996176.12,M1715686600
2046,409000438611',2018-06-12,Indiaforensic VISA ACQ DOM120618,0.0,2335030.78,7257372.090000004,2018,6,12,CHECK_CASHING,2335030.78,M1765690649
2047,409000438611',2018-06-12,Indiaforensic RUPAY POS ACQ12061,0.0,1896488.13,9153860.220000004,2018,6,12,TRANSFER,1896488.13,M1412564235
2048,409000438611',2018-06-12,TRF TO  Indiaforensic SERVICES I,9100000.0,0.0,53860.220000002526,2018,6,12,PAYEMENT,9100000.0,C1049817027
2049,409000438611',2018-06-12,Indiaforensic RUPAY POS C2 ACQ12,0.0,611402.77,665262.9900000026,2018,6,12,CASH_IN,611402.77,M1833335943
2050,409000438611',2018-06-12,Indiaforensic MASTER INT SET 110,0.0,3983.65,669246.6400000026,2018,6,12,CASH_IN,3983.65,M1472036907
2051,409000438611',2018-06-13,Indiaforensic RUPAY POS C2 ACQ13,0.0,514928.49,1184175.130000003,2018,6,13,TRANSFER,514928.49,M46627301
2052,409000438611',2018-06-13,Indiaforensic MASTER ACQ DOM1306,0.0,1743283.91,2927459.0400000038,2018,6,13,CASH_IN,1743283.91,M1367594377
2053,409000438611',2018-06-13,Indiaforensic VISA ACQ DOM130618,0.0,2211209.73,5138668.770000003,2018,6,13,CASH_IN,2211209.73,M1747721875
2054,409000438611',2018-06-13,Indiaforensic RUPAY POS ACQ13061,0.0,2247589.61,7386258.380000003,2018,6,13,CHECK_CASHING,2247589.61,M1759915172
2055,409000438611',2018-06-13,Indiaforensic VISA ACQ INT 11061,0.0,8901.0,7395159.380000003,2018,6,13,CHECK_CASHING,8901.0,C1789550256
2056,409000438611',2018-06-13,TRF TO  Indiaforensic SERVICES I,7300000.0,0.0,95159.38000000268,2018,6,13,CASH_OUT,7300000.0,M1220524164
2057,409000438611',2018-06-13,Indiaforensic MASTER INT SET 120,0.0,9897.08,105056.46000000267,2018,6,13,CHECK_CASHING,9897.08,M118881143
2058,409000438611',2018-06-14,Indiaforensic VISA ACQ INT 10061,0.0,176.45,105232.91000000268,2018,6,14,TRANSFER,176.45,M777190206
2059,409000438611',2018-06-14,Indiaforensic MASTER INT SET 130,0.0,9826.97,115059.88000000268,2018,6,14,CASH_IN,9826.97,M1050149826
2060,409000438611',2018-06-14,Indiaforensic VISA ACQ DOM140618,0.0,2345280.52,2460340.4000000027,2018,6,14,TRANSFER,2345280.52,M2090289474
2061,409000438611',2018-06-14,Indiaforensic RUPAY POS ACQ14061,0.0,1813253.42,4273593.820000002,2018,6,14,TRANSFER,1813253.42,M1620187937
2062,409000438611',2018-06-14,Indiaforensic MASTER ACQ DOM1406,0.0,1825207.33,6098801.150000002,2018,6,14,CHECK_CASHING,1825207.33,M1296654536
2063,409000438611',2018-06-14,Indiaforensic RUPAY POS C2 ACQ14,0.0,690005.14,6788806.290000003,2018,6,14,TRANSFER,690005.14,C1330400026
2064,409000438611',2018-06-14,Indiaforensic MASTER INT SET 130,0.0,9826.97,6798633.260000003,2018,6,14,TRANSFER,9826.97,C401424608
2065,409000438611',2018-06-14,TRF TO  Indiaforensic SERVICES I,6100000.0,0.0,698633.2600000015,2018,6,14,DEBIT,6100000.0,M1838250251
2066,409000438611',2018-06-14,Indiaforensic MASTER INT SET 130,9826.97,0.0,688806.2900000017,2018,6,14,DEBIT,9826.97,M1204178174
2067,409000438611',2018-06-15,Indiaforensic MASTER ACQ DOM1506,0.0,1697294.3,2386100.5900000017,2018,6,15,TRANSFER,1697294.3,M173440626
2068,409000438611',2018-06-15,Indiaforensic VISA ACQ DOM150618,0.0,2223735.65,4609836.240000002,2018,6,15,CASH_IN,2223735.65,C997608398
2069,409000438611',2018-06-15,Indiaforensic RUPAY POS ACQ15061,0.0,1782763.43,6392599.670000003,2018,6,15,CASH_IN,1782763.43,M1260127127
2070,409000438611',2018-06-15,Indiaforensic MASTER INT SET 140,0.0,11319.76,6403919.4300000025,2018,6,15,CHECK_CASHING,11319.76,M884604029
2071,409000438611',2018-06-15,TRF TO  Indiaforensic SERVICES I,6300000.0,0.0,103919.43000000156,2018,6,15,PAYEMENT,6300000.0,M215614514
2072,409000438611',2018-06-15,Indiaforensic RUPAY POS C2 ACQ15,0.0,713128.56,817047.9900000016,2018,6,15,CHECK_CASHING,713128.56,M117460541
2073,409000438611',2018-06-18,Indiaforensic VISA ACQ DOM160618,0.0,2147130.16,2964178.150000002,2018,6,18,CASH_IN,2147130.16,M1906549136
2074,409000438611',2018-06-18,Indiaforensic RUPAY POS ACQ16061,0.0,1886002.42,4850180.570000002,2018,6,18,TRANSFER,1886002.42,M8136897
2075,409000438611',2018-06-18,Indiaforensic RUPAY POS ACQ17061,0.0,2179590.08,7029770.650000002,2018,6,18,CHECK_CASHING,2179590.08,M1743553655
2076,409000438611',2018-06-18,Indiaforensic MASTER ACQ DOM1806,0.0,5177340.05,12207110.700000005,2018,6,18,TRANSFER,5177340.05,C601893033
2077,409000438611',2018-06-18,Indiaforensic VISA ACQ DOM180618,0.0,4806591.74,17013702.440000005,2018,6,18,TRANSFER,4806591.74,M922992444
2078,409000438611',2018-06-18,Indiaforensic RUPAY POS ACQ18061,0.0,2205189.39,19218891.830000006,2018,6,18,CHECK_CASHING,2205189.39,M1530870688
2079,409000438611',2018-06-18,Indiaforensic RUPAY POS C2 ACQ18,0.0,646394.23,19865286.060000006,2018,6,18,CHECK_CASHING,646394.23,M663716901
2080,409000438611',2018-06-18,TRF TO  Indiaforensic SERVICES I,15000000.0,0.0,4865286.060000006,2018,6,18,CHECK_WITHDRAWAL,15000000.0,M1260043537
2081,409000438611',2018-06-18,TRF TO  Indiaforensic SERVICES I,4000000.0,0.0,865286.0600000061,2018,6,18,PAYEMENT,4000000.0,M1682157864
2082,409000438611',2018-06-18,Indiaforensic VISA ACQ INT 14061,0.0,2977.33,868263.3900000061,2018,6,18,TRANSFER,2977.33,C1740000325
2083,409000438611',2018-06-19,Indiaforensic MASTER ACQ DOM1906,0.0,2313815.18,3182078.5700000064,2018,6,19,TRANSFER,2313815.18,M1243350866
2084,409000438611',2018-06-19,Indiaforensic VISA ACQ DOM190618,0.0,3159932.31,6342010.880000006,2018,6,19,CHECK_CASHING,3159932.31,M456314134
2085,409000438611',2018-06-19,Indiaforensic RUPAY POS ACQ19061,0.0,2423389.01,8765399.890000006,2018,6,19,TRANSFER,2423389.01,M1641027464
2086,409000438611',2018-06-19,Indiaforensic RUPAY POS C2 ACQ19,0.0,832306.56,9597706.450000007,2018,6,19,CASH_IN,832306.56,M642538759
2087,409000438611',2018-06-19,TRF TO  Indiaforensic SERVICES I,8700000.0,0.0,897706.4500000067,2018,6,19,CASH_OUT,8700000.0,M1774897456
2088,409000438611',2018-06-19,Indiaforensic MASTER INT SET 180,0.0,3752.4,901458.8500000068,2018,6,19,CHECK_CASHING,3752.4,M1564078808
2089,409000438611',2018-06-20,Indiaforensic VISA ACQ INT 13061,0.0,209.47,901668.3200000068,2018,6,20,CASH_IN,209.47,M1441410416
2090,409000438611',2018-06-20,Indiaforensic RUPAY POS ACQ19061,0.0,2146626.49,3048294.810000007,2018,6,20,CHECK_CASHING,2146626.49,M391827378
2091,409000438611',2018-06-20,Indiaforensic RUPAY POSREVACQ190,2423389.01,0.0,624905.8000000073,2018,6,20,CHECK_WITHDRAWAL,2423389.01,M1317441269
2092,409000438611',2018-06-20,Indiaforensic MASTER ACQ DOM2006,0.0,1863576.67,2488482.4700000067,2018,6,20,CASH_IN,1863576.67,M816804727
2093,409000438611',2018-06-20,Indiaforensic VISA ACQ DOM200618,0.0,2570110.96,5058593.430000007,2018,6,20,CHECK_CASHING,2570110.96,M497786326
2094,409000438611',2018-06-20,Indiaforensic RUPAY POS ACQ20061,0.0,957006.69,6015600.120000008,2018,6,20,TRANSFER,957006.69,M1862900975
2095,409000438611',2018-06-20,Indiaforensic MASTER INT SET 190,0.0,5240.01,6020840.130000006,2018,6,20,CHECK_CASHING,5240.01,M1275011461
2096,409000438611',2018-06-20,TRF TO  Indiaforensic SERVICES I,6000000.0,0.0,20840.130000006407,2018,6,20,PAYEMENT,6000000.0,M2146303527
2097,409000438611',2018-06-20,Indiaforensic RUPAY POS C2 ACQ20,0.0,1446203.32,1467043.4500000062,2018,6,20,TRANSFER,1446203.32,M491152599
2098,409000438611',2018-06-20,Indiaforensic VISA ACQ INT 16061,0.0,11868.0,1478911.4500000062,2018,6,20,TRANSFER,11868.0,M1456265041
2099,409000438611',2018-06-21,TRF TO  Indiaforensic SERVICES I,1000000.0,0.0,478911.4500000065,2018,6,21,CHECK_WITHDRAWAL,1000000.0,M1808527451
2100,409000438611',2018-06-21,Indiaforensic MASTER ACQ DOM2106,0.0,2114385.86,2593297.310000006,2018,6,21,TRANSFER,2114385.86,M488669101
2101,409000438611',2018-06-21,Indiaforensic VISA ACQ DOM210618,0.0,2458111.48,5051408.790000007,2018,6,21,CHECK_CASHING,2458111.48,M1183905155
2102,409000438611',2018-06-21,Indiaforensic RUPAY POS ACQ21061,0.0,1859055.86,6910464.650000008,2018,6,21,TRANSFER,1859055.86,M1202907617
2103,409000438611',2018-06-21,Indiaforensic RUPAY POS C2 ACQ21,0.0,709243.64,7619708.290000007,2018,6,21,CHECK_CASHING,709243.64,C1286084959
2104,409000438611',2018-06-21,Indiaforensic MASTER INT SET 200,0.0,1007.57,7620715.860000008,2018,6,21,TRANSFER,1007.57,C24119573
2105,409000438611',2018-06-21,TRF TO  Indiaforensic SERVICES I,7600000.0,0.0,20715.860000006855,2018,6,21,CASH_OUT,7600000.0,M413550077
2106,409000438611',2018-06-22,Indiaforensic MASTER ACQ DOM2206,0.0,2019747.74,2040463.6000000068,2018,6,22,CASH_IN,2019747.74,M933646237
2107,409000438611',2018-06-22,Indiaforensic VISA ACQ DOM220618,0.0,2833099.15,4873562.7500000065,2018,6,22,CASH_IN,2833099.15,C1529115495
2108,409000438611',2018-06-22,Indiaforensic RUPAY POS ACQ22061,0.0,1585745.42,6459308.170000006,2018,6,22,TRANSFER,1585745.42,C1068824137
2109,409000438611',2018-06-22,Indiaforensic RUPAY POS C2 ACQ22,0.0,730009.69,7189317.860000008,2018,6,22,CHECK_CASHING,730009.69,M1831705084
2110,409000438611',2018-06-22,Indiaforensic VISA ACQ INT 20061,0.0,7490.44,7196808.300000007,2018,6,22,TRANSFER,7490.44,C13226198
2111,409000438611',2018-06-22,TRF TO  Indiaforensic SERVICES I,7100000.0,0.0,96808.30000000726,2018,6,22,CASH_OUT,7100000.0,C1577213552
2112,409000438611',2018-06-25,Indiaforensic VISA ACQ DOM230618,0.0,3086020.94,3182829.2400000067,2018,6,25,CHECK_CASHING,3086020.94,M538618049
2113,409000438611',2018-06-25,Indiaforensic RUPAY POS ACQ23061,0.0,1815935.72,4998764.960000007,2018,6,25,CASH_IN,1815935.72,M1386440976
2114,409000438611',2018-06-25,Indiaforensic RUPAY POS ACQ24061,0.0,2540692.97,7539457.930000007,2018,6,25,CASH_IN,2540692.97,M1327539680
2115,409000438611',2018-06-25,Indiaforensic VISA ACQ DOM250618,0.0,5165269.37,12704727.300000008,2018,6,25,CHECK_CASHING,5165269.37,M494414526
2116,409000438611',2018-06-25,Indiaforensic RUPAY POS ACQ25061,0.0,2301768.58,15006495.880000008,2018,6,25,TRANSFER,2301768.58,M665988980
2117,409000438611',2018-06-25,Indiaforensic MASTER ACQ DOM2506,0.0,5739467.67,20745963.55000001,2018,6,25,TRANSFER,5739467.67,M2122991287
2118,409000438611',2018-06-25,NEFT CHARGES AND GST/0000,29.5,0.0,20745934.05000001,2018,6,25,CASH_OUT,29.5,M420993295
2119,409000438611',2018-06-25,NEFT/000041992898/Indiaforensic,5000000.0,0.0,15745934.050000008,2018,6,25,DEBIT,5000000.0,M1252820474
2120,409000438611',2018-06-25,Indiaforensic RUPAY POS C2 ACQ25,0.0,701241.46,16447175.51000001,2018,6,25,CHECK_CASHING,701241.46,M101162229
2121,409000438611',2018-06-25,TRF TO  Indiaforensic SERVICES I,15000000.0,0.0,1447175.510000009,2018,6,25,DEBIT,15000000.0,M818859466
2122,409000438611',2018-06-25,TRF TO  Indiaforensic SERVICES I,700000.0,0.0,747175.5100000091,2018,6,25,CASH_OUT,700000.0,M1418102907
2123,409000438611',2018-06-25,Indiaforensic VISA ACQ INT 21061,0.0,9.89,747185.4000000091,2018,6,25,CASH_IN,9.89,C2089016471
2124,409000438611',2018-06-26,Indiaforensic MASTER ACQ DOM2606,0.0,1889215.32,2636400.720000009,2018,6,26,CASH_IN,1889215.32,M412835761
2125,409000438611',2018-06-26,Indiaforensic VISA ACQ DOM260618,0.0,3229133.72,5865534.440000009,2018,6,26,CHECK_CASHING,3229133.72,C1170794006
2126,409000438611',2018-06-26,Indiaforensic RUPAY POS ACQ26061,0.0,1816996.18,7682530.620000008,2018,6,26,CASH_IN,1816996.18,C1831477404
2127,409000438611',2018-06-26,TRF TO  Indiaforensic SERVICES I,7600000.0,0.0,82530.6200000085,2018,6,26,CHECK_WITHDRAWAL,7600000.0,C1721246982
2128,409000438611',2018-06-26,Indiaforensic RUPAY POS C2 ACQ26,0.0,658789.31,741319.9300000084,2018,6,26,CASH_IN,658789.31,C1335050193
2129,409000438611',2018-06-26,Indiaforensic VISA ACQ INT 22061,0.0,509.09,741829.0200000084,2018,6,26,CASH_IN,509.09,C667346055
2130,409000438611',2018-06-26,Indiaforensic MASTER INT 23-2506,0.0,3052.82,744881.8400000085,2018,6,26,CASH_IN,3052.82,C1256728724
2131,409000438611',2018-06-27,TRF TO  Indiaforensic SERVICES I,700000.0,0.0,44881.840000008466,2018,6,27,DEBIT,700000.0,C997608398
2132,409000438611',2018-06-27,Indiaforensic MASTER ACQ DOM2706,0.0,2222832.78,2267714.6200000085,2018,6,27,CASH_IN,2222832.78,C1721246982
2133,409000438611',2018-06-27,Indiaforensic VISA ACQ DOM270618,0.0,3279076.58,5546791.200000009,2018,6,27,TRANSFER,3279076.58,C1568059495
2134,409000438611',2018-06-27,Indiaforensic RUPAY POS ACQ27061,0.0,1854092.82,7400884.020000009,2018,6,27,TRANSFER,1854092.82,C836514715
2135,409000438611',2018-06-27,TRF TO  Indiaforensic SERVICES I,7400000.0,0.0,884.0200000088663,2018,6,27,CASH_OUT,7400000.0,C812586739
2136,409000438611',2018-06-27,Indiaforensic RUPAY POS C2 ACQ27,0.0,626712.92,627596.9400000089,2018,6,27,CASH_IN,626712.92,C1504109395
2137,409000438611',2018-06-27,Indiaforensic MASTER INT 260618,0.0,2027.87,629624.8100000089,2018,6,27,CASH_IN,2027.87,C1256728724
2138,409000438611',2018-06-28,Indiaforensic VISA ACQ DOM280618,0.0,2222406.45,2852031.2600000086,2018,6,28,CHECK_CASHING,2222406.45,C1058634310
2139,409000438611',2018-06-28,Indiaforensic RUPAY POS ACQ28061,0.0,1759959.01,4611990.270000009,2018,6,28,CHECK_CASHING,1759959.01,C985934102
2140,409000438611',2018-06-28,TRF TO  Indiaforensic SERVICES I,4600000.0,0.0,11990.270000008868,2018,6,28,CASH_OUT,4600000.0,C357863579
2141,409000438611',2018-06-28,Indiaforensic VISA ACQ INT 26061,0.0,308.37,12298.640000008867,2018,6,28,CASH_IN,308.37,C564160838
2142,409000438611',2018-06-28,Indiaforensic RUPAY POS C2 ACQ28,0.0,522299.26,534597.9000000089,2018,6,28,CASH_IN,522299.26,C985934102
2143,409000438611',2018-06-28,Indiaforensic MASTER ACQ DOM2806,0.0,2017195.99,2551793.890000009,2018,6,28,CHECK_CASHING,2017195.99,C1688019098
2144,409000438611',2018-06-28,Indiaforensic MC RECOV JUL 17,303686.99,0.0,2248106.9000000088,2018,6,28,CASH_OUT,303686.99,C1883840933
2145,409000438611',2018-06-29,TRF TO  Indiaforensic SERVICES I,2000000.0,0.0,248106.90000000875,2018,6,29,CHECK_WITHDRAWAL,2000000.0,C1749186397
2146,409000438611',2018-06-29,Indiaforensic MASTER ACQ DOM2906,0.0,1735668.56,1983775.4600000088,2018,6,29,TRANSFER,1735668.56,C557041912
2147,409000438611',2018-06-29,Indiaforensic VISA ACQ DOM290618,0.0,2285757.71,4269533.170000008,2018,6,29,CASH_IN,2285757.71,C306206744
2148,409000438611',2018-06-29,Indiaforensic RUPAY POS ACQ29061,0.0,1627152.48,5896685.65000001,2018,6,29,CASH_IN,1627152.48,C1629911510
2149,409000438611',2018-06-29,Indiaforensic MASTER INT 280618,0.0,1975.35,5898661.000000007,2018,6,29,CASH_IN,1975.35,C1234776885
2150,409000438611',2018-06-29,TRF TO  Indiaforensic SERVICES I,5900000.0,0.0,,2018,6,29,CASH_OUT,5900000.0,C20671747
2151,409000438611',2018-06-29,Indiaforensic RUPAY POS C2 ACQ29,0.0,640678.86,639339.8600000093,2018,6,29,TRANSFER,640678.86,C1297685781
2152,409000438611',2018-06-30,Indiaforensic VISA ACQ DOM300618,0.0,2614912.61,3254252.4700000086,2018,6,30,CHECK_CASHING,2614912.61,C811597470
2153,409000438611',2018-06-30,Indiaforensic RUPAY POS ACQ30061,0.0,1270137.2,4524389.670000008,2018,6,30,CHECK_CASHING,1270137.2,C453211571
2154,409000438611',2018-06-30,TRF TO  Indiaforensic SERVICES I,4000000.0,0.0,524389.6700000092,2018,6,30,CASH_OUT,4000000.0,C459857341
2155,409000438611',2018-06-30,TRF TO  Indiaforensic SERVICES I,500000.0,0.0,24389.67000000924,2018,6,30,PAYEMENT,500000.0,C1810132623
2156,409000438611',2018-07-02,Indiaforensic VISA ACQ DOM010718,12753.61,0.0,11636.060000009238,2018,7,2,DEBIT,12753.61,C884457408
2157,409000438611',2018-07-02,Indiaforensic RUPAY POS ACQ01071,0.0,1467964.7,1479600.760000009,2018,7,2,CHECK_CASHING,1467964.7,C1297685781
2158,409000438611',2018-07-02,Indiaforensic VISA ACQ DOM020718,0.0,4950516.77,6430117.530000009,2018,7,2,CHECK_CASHING,4950516.77,C1810132623
2159,409000438611',2018-07-02,Indiaforensic RUPAY POS ACQ02071,0.0,1751846.12,8181963.650000009,2018,7,2,CASH_IN,1751846.12,C97730845
2160,409000438611',2018-07-02,Indiaforensic RUPAY POS C2 ACQ02,0.0,615871.28,8797834.930000009,2018,7,2,CASH_IN,615871.28,C1749186397
2161,409000438611',2018-07-02,Indiaforensic RUPAY POS C2 ACQ30,0.0,631159.8,9428994.73000001,2018,7,2,TRANSFER,631159.8,C601893033
2162,409000438611',2018-07-02,Indiaforensic MASTER ACQ DOM0207,0.0,5512890.81,14941885.54000001,2018,7,2,CHECK_CASHING,5512890.81,C1529115495
2163,409000438611',2018-07-02,TRF TO  Indiaforensic SERVICES I,14900000.0,0.0,41885.54000001028,2018,7,2,CHECK_WITHDRAWAL,14900000.0,C401424608
2164,409000438611',2018-07-03,Indiaforensic MASTER ACQ DOM0307,0.0,2184316.24,2226201.7800000105,2018,7,3,TRANSFER,2184316.24,C1590550415
2165,409000438611',2018-07-03,Indiaforensic VISA ACQ DOM030718,0.0,2459749.9,4685951.680000011,2018,7,3,CHECK_CASHING,2459749.9,C1529115495
2166,409000438611',2018-07-03,Indiaforensic VISA ACQ INT 28061,0.0,1669.4,4687621.080000011,2018,7,3,CASH_IN,1669.4,C1577213552
2167,409000438611',2018-07-03,Indiaforensic RUPAY POS ACQ03071,0.0,1654065.41,6341686.490000011,2018,7,3,CHECK_CASHING,1654065.41,C998351292
2168,409000438611',2018-07-03,Indiaforensic RUPAY POS C2 ACQ03,0.0,444821.02,6786507.510000011,2018,7,3,TRANSFER,444821.02,C1740000325
2169,409000438611',2018-07-03,TRF TO  Indiaforensic SERVICES I,5000000.0,0.0,1786507.510000011,2018,7,3,PAYEMENT,5000000.0,C1935365522
2170,409000438611',2018-07-03,TRF TO  Indiaforensic SERVICES I,1000000.0,0.0,786507.510000011,2018,7,3,PAYEMENT,1000000.0,C837659261
2171,409000438611',2018-07-03,TRF TO  Indiaforensic SERVICES I,500000.0,0.0,286507.5100000109,2018,7,3,CASH_OUT,500000.0,C1839337592
2172,409000438611',2018-07-04,Indiaforensic MASTER ACQ DOM0407,0.0,2227803.74,2514311.2500000107,2018,7,4,CASH_IN,2227803.74,C1577213552
2173,409000438611',2018-07-04,Indiaforensic VISA ACQ DOM040718,0.0,2637725.76,5152037.010000011,2018,7,4,CHECK_CASHING,2637725.76,C1782113663
2174,409000438611',2018-07-04,Indiaforensic RUPAY POS ACQ04071,0.0,1651030.4,6803067.410000011,2018,7,4,CASH_IN,1651030.4,C558216562
2175,409000438611',2018-07-04,Indiaforensic VISA ACQ INT 02071,0.0,495.0,6803562.410000011,2018,7,4,TRANSFER,495.0,C97730845
2176,409000438611',2018-07-04,TRF TO  Indiaforensic SERVICES I,6800000.0,0.0,3562.410000011325,2018,7,4,PAYEMENT,6800000.0,C2083562754
2177,409000438611',2018-07-04,Indiaforensic RUPAY POS C2 ACQ04,0.0,571457.1,575019.5100000113,2018,7,4,TRANSFER,571457.1,C1259769769
2178,409000438611',2018-07-05,TRF TO  Indiaforensic SERVICES I,500000.0,0.0,75019.5100000113,2018,7,5,CHECK_WITHDRAWAL,500000.0,C1577213552
2179,409000438611',2018-07-05,Indiaforensic VISA ACQ DOM050718,0.0,2748303.86,2823323.3700000118,2018,7,5,CHECK_CASHING,2748303.86,C1899073220
2180,409000438611',2018-07-05,Indiaforensic RUPAY POS ACQ05071,0.0,1616233.08,4439556.450000011,2018,7,5,TRANSFER,1616233.08,C284686302
2181,409000438611',2018-07-05,Indiaforensic MASTER ACQ DOM0507,0.0,2124003.08,6563559.530000011,2018,7,5,CHECK_CASHING,2124003.08,C284686302
2182,409000438611',2018-07-05,Indiaforensic RUPAY POS C2 ACQ05,0.0,638577.49,7202137.020000013,2018,7,5,CASH_IN,638577.49,C1049817027
2183,409000438611',2018-07-05,TRF TO  Indiaforensic SERVICES I,6500000.0,0.0,702137.0200000118,2018,7,5,CHECK_WITHDRAWAL,6500000.0,C1049817027
2184,409000438611',2018-07-06,Indiaforensic MASTER ACQ DOM0607,0.0,2020691.4,2722828.420000012,2018,7,6,CASH_IN,2020691.4,C1983747920
2185,409000438611',2018-07-06,Indiaforensic VISA ACQ DOM060718,0.0,2256991.21,4979819.630000012,2018,7,6,CASH_IN,2256991.21,C793315160
2186,409000438611',2018-07-06,Indiaforensic RUPAY POS ACQ06071,0.0,1513145.26,6492964.890000013,2018,7,6,TRANSFER,1513145.26,C1590550415
2187,409000438611',2018-07-06,Indiaforensic MASTER INT 300618,0.0,1188.46,6494153.350000013,2018,7,6,CASH_IN,1188.46,C985934102
2188,409000438611',2018-07-06,Indiaforensic RUPAY POS C2 ACQ06,0.0,580792.56,7074945.910000011,2018,7,6,TRANSFER,580792.56,C665576141
2189,409000438611',2018-07-06,TRF TO  Indiaforensic SERVICES I,6500000.0,0.0,574945.9100000113,2018,7,6,CASH_OUT,6500000.0,C5592464
2190,409000438611',2018-07-06,Indiaforensic MASTER INT 050718,0.0,3577.64,578523.5500000113,2018,7,6,CHECK_CASHING,3577.64,M1861754673
2191,409000438611',2018-07-06,TRF TO  Indiaforensic SERVICES I,500000.0,0.0,78523.55000001134,2018,7,6,CASH_OUT,500000.0,M866901553
2192,409000438611',2018-07-06,ICA 17825 Indiaforensic INTG RVS,0.0,171239.95,249763.5000000113,2018,7,6,CHECK_CASHING,171239.95,M657998502
2193,409000438611',2018-07-07,Indiaforensic VISA ACQ DOM070718,0.0,2596279.65,2846043.150000011,2018,7,7,CHECK_CASHING,2596279.65,C392292416
2194,409000438611',2018-07-07,Indiaforensic RUPAY POS ACQ07071,0.0,1808517.14,4654560.290000011,2018,7,7,CASH_IN,1808517.14,C423583818
2195,409000438611',2018-07-07,TRF TO  Indiaforensic SERVICES I,3000000.0,0.0,1654560.2900000112,2018,7,7,PAYEMENT,3000000.0,M1432403167
2196,409000438611',2018-07-07,TRF TO  Indiaforensic SERVICES I,1000000.0,0.0,654560.2900000112,2018,7,7,DEBIT,1000000.0,M766101
2197,409000438611',2018-07-07,TRF TO  Indiaforensic SERVICES I,500000.0,0.0,154560.29000001118,2018,7,7,CHECK_WITHDRAWAL,500000.0,M665512315
2198,409000438611',2018-07-07,Indiaforensic RUPAY POS C2 ACQ07,0.0,454985.56,609545.8500000114,2018,7,7,TRANSFER,454985.56,M1562249660
2199,409000438611',2018-07-07,2044913-20180707225219,1536.0,0.0,608009.8500000114,2018,7,7,CHECK_WITHDRAWAL,1536.0,C1498438472
2200,409000438611',2018-07-08,COMMISSION FOR Indiaforensic 201,0.0,11.52,608021.3700000113,2018,7,8,CHECK_CASHING,11.52,M1595188851
2201,409000438611',2018-07-09,TRF TO  Indiaforensic SERVICES I,500000.0,0.0,108021.37000001127,2018,7,9,CASH_OUT,500000.0,C1782113663
2202,409000438611',2018-07-09,Indiaforensic RUPAY POS ACQ08071,0.0,1549439.1,1657460.4700000111,2018,7,9,CASH_IN,1549439.1,C747464370
2203,409000438611',2018-07-09,Indiaforensic VISA ACQ DOM090718,0.0,5383803.73,7041264.200000012,2018,7,9,CHECK_CASHING,5383803.73,M1989219205
2204,409000438611',2018-07-09,Indiaforensic RUPAY POS ACQ09071,0.0,1295798.19,8337062.390000013,2018,7,9,CASH_IN,1295798.19,M369333979
2205,409000438611',2018-07-09,Indiaforensic MASTER ACQ DOM0707,0.0,2481297.39,10818359.780000012,2018,7,9,CHECK_CASHING,2481297.39,M67811496
2206,409000438611',2018-07-09,TRF TO  Indiaforensic SERVICES I,3000000.0,0.0,7818359.780000012,2018,7,9,CASH_OUT,3000000.0,M1707901480
2207,409000438611',2018-07-09,TRF TO  Indiaforensic SERVICES I,5000000.0,0.0,2818359.7800000124,2018,7,9,CASH_OUT,5000000.0,M35068320
2208,409000438611',2018-07-09,Indiaforensic MASTER ACQ DOM08-0,0.0,3987860.36,6806220.140000013,2018,7,9,TRANSFER,3987860.36,C1917025677
2209,409000438611',2018-07-09,TRF TO  Indiaforensic SERVICES I,2800000.0,0.0,4006220.140000012,2018,7,9,PAYEMENT,2800000.0,C884457408
2210,409000438611',2018-07-09,TRF TO  Indiaforensic SERVICES I,3000000.0,0.0,1006220.140000012,2018,7,9,DEBIT,3000000.0,C884457408
2211,409000438611',2018-07-09,TRF TO  Indiaforensic SERVICES I,1000000.0,0.0,6220.140000011773,2018,7,9,CASH_OUT,1000000.0,C1234776885
2212,409000438611',2018-07-09,Indiaforensic RUPAY POS C2 ACQ09,0.0,1447899.53,1454119.6700000118,2018,7,9,CASH_IN,1447899.53,C1259769769
2213,409000438611',2018-07-10,TRF TO  Indiaforensic SERVICES I,1000000.0,0.0,454119.6700000118,2018,7,10,CASH_OUT,1000000.0,C11003494
2214,409000438611',2018-07-10,Indiaforensic MASTER ACQ DOM1007,0.0,2759464.87,3213584.5400000117,2018,7,10,CASH_IN,2759464.87,M178325065
2215,409000438611',2018-07-10,Indiaforensic VISA ACQ DOM100718,0.0,2829789.4,6043373.9400000125,2018,7,10,CASH_IN,2829789.4,M923360749
2216,409000438611',2018-07-10,Indiaforensic RUPAY POS ACQ10071,0.0,1743167.66,7786541.600000013,2018,7,10,CHECK_CASHING,1743167.66,M749098095
2217,409000438611',2018-07-10,Indiaforensic RUPAY POS C2 ACQ10,0.0,578193.5,8364735.100000013,2018,7,10,TRANSFER,578193.5,M2032399795
2218,409000438611',2018-07-10,Indiaforensic MASTER INT 060718,0.0,17799.32,8382534.420000013,2018,7,10,CASH_IN,17799.32,M1970856042
2219,409000438611',2018-07-10,Indiaforensic VISA ACQ INT 05071,0.0,3334.71,8385869.130000013,2018,7,10,TRANSFER,3334.71,M1457148583
2220,409000438611',2018-07-10,TRF TO  Indiaforensic SERVICES I,7700000.0,0.0,685869.1300000129,2018,7,10,PAYEMENT,7700000.0,C2118255842
2221,409000438611',2018-07-10,TRF TO  Indiaforensic SERVICES I,500000.0,0.0,185869.13000001293,2018,7,10,CHECK_WITHDRAWAL,500000.0,M873168630
2222,409000438611',2018-07-10,Indiaforensic MASTER INT 0707-09,0.0,3254.07,189123.20000001293,2018,7,10,CHECK_CASHING,3254.07,M1615873578
2223,409000438611',2018-07-11,Indiaforensic MASTER ACQ DOM1307,0.0,2256789.01,2445912.2100000125,2018,7,11,CHECK_CASHING,2256789.01,C1850180796
2224,409000438611',2018-07-11,Indiaforensic VISA ACQ DOM130718,0.0,2854284.3,5300196.510000013,2018,7,11,TRANSFER,2854284.3,M293870357
2225,409000438611',2018-07-11,Indiaforensic RUPAY POS ACQ13071,0.0,1524436.63,6824633.140000013,2018,7,11,CASH_IN,1524436.63,M2065730373
2226,409000438611',2018-07-11,Indiaforensic RUPAY POS C2 ACQ13,0.0,604282.7,7428915.840000013,2018,7,11,TRANSFER,604282.7,C1335050193
2227,409000438611',2018-07-11,Indiaforensic VISA ACQ INT 07061,0.0,3380.34,7432296.180000013,2018,7,11,CHECK_CASHING,3380.34,M2095970915
2228,409000438611',2018-07-11,Indiaforensic VISA ACQ INT 08061,0.0,3861.9,7436158.080000012,2018,7,11,CASH_IN,3861.9,C248609774
2229,409000438611',2018-07-11,Indiaforensic VISA ACQ INT 09061,0.0,3213.88,7439371.960000012,2018,7,11,TRANSFER,3213.88,C1032986144
2230,409000438611',2018-07-11,Indiaforensic MASTER INT 100718,0.0,2274.53,7441646.490000012,2018,7,11,CHECK_CASHING,2274.53,M1317963297
2231,409000438611',2018-07-11,TRF TO  Indiaforensic SERVICES I,600000.0,0.0,6841646.490000012,2018,7,11,PAYEMENT,600000.0,M61814127
2232,409000438611',2018-07-11,TRF TO  Indiaforensic SERVICES I,6800000.0,0.0,41646.49000001326,2018,7,11,PAYEMENT,6800000.0,M2118571592
2233,409000438611',2018-07-12,Indiaforensic VISA ACQ DOM120718,0.0,2832314.17,2873960.660000013,2018,7,12,CHECK_CASHING,2832314.17,C716083600
2234,409000438611',2018-07-12,Indiaforensic RUPAY POS ACQ12071,0.0,1678111.9,4552072.560000014,2018,7,12,TRANSFER,1678111.9,C564160838
2235,409000438611',2018-07-12,Indiaforensic MASTER ACQ DOM1207,0.0,1663265.14,6215337.700000012,2018,7,12,TRANSFER,1663265.14,C1917025677
2236,409000438611',2018-07-12,Indiaforensic RUPAY POS C2 ACQ12,0.0,547915.25,6763252.950000012,2018,7,12,CASH_IN,547915.25,C657736958
2237,409000438611',2018-07-12,TRF TO  Indiaforensic SERVICES I,4500000.0,0.0,2263252.950000013,2018,7,12,DEBIT,4500000.0,M809128217
2238,409000438611',2018-07-12,TRF TO  Indiaforensic SERVICES I,2000000.0,0.0,263252.9500000132,2018,7,12,CHECK_WITHDRAWAL,2000000.0,M466319810
2239,409000438611',2018-07-13,Indiaforensic VISA ACQ DOM130718,0.0,2352101.11,2615354.060000013,2018,7,13,CASH_IN,2352101.11,C64133603
2240,409000438611',2018-07-13,Indiaforensic RUPAY POS ACQ13071,0.0,1705457.46,4320811.5200000135,2018,7,13,CHECK_CASHING,1705457.46,C1219273867
2241,409000438611',2018-07-13,Indiaforensic MASTER ACQ DOM1307,0.0,662902.95,4983714.470000013,2018,7,13,TRANSFER,662902.95,M1899567935
2242,409000438611',2018-07-13,Indiaforensic MASTER INT 120718,0.0,1968.66,4985683.130000013,2018,7,13,TRANSFER,1968.66,M316355462
2243,409000438611',2018-07-13,TRF TO  Indiaforensic SERVICES I,4900000.0,0.0,85683.13000001293,2018,7,13,DEBIT,4900000.0,C657736958
2244,409000438611',2018-07-13,Indiaforensic MASTER ACQ DOM INT,0.0,48872.97,134556.10000001293,2018,7,13,CASH_IN,48872.97,C1112414583
2245,409000438611',2018-07-16,Indiaforensic RUPAY POS C2 ACQ13,0.0,514962.27,649518.3700000129,2018,7,16,TRANSFER,514962.27,C1750905143
2246,409000438611',2018-07-16,Indiaforensic RUPAY POS ACQ15071,0.0,2378651.13,3028169.500000013,2018,7,16,TRANSFER,2378651.13,C662736689
2247,409000438611',2018-07-16,Indiaforensic VISA ACQ DOM140718,0.0,2900874.8,5929044.300000013,2018,7,16,TRANSFER,2900874.8,C1816757085
2248,409000438611',2018-07-16,Indiaforensic RUPAY POS ACQ14071,0.0,1701792.83,7630837.130000013,2018,7,16,TRANSFER,1701792.83,C1671179293
2249,409000438611',2018-07-16,TRF TO  Indiaforensic SERVICES I,5000000.0,0.0,2630837.130000013,2018,7,16,DEBIT,5000000.0,C611572016
2250,409000438611',2018-07-16,TRF TO  Indiaforensic SERVICES I,1000000.0,0.0,1630837.1300000132,2018,7,16,CASH_OUT,1000000.0,C401424608
2251,409000438611',2018-07-16,TRF TO  Indiaforensic SERVICES I,1000000.0,0.0,630837.1300000129,2018,7,16,DEBIT,1000000.0,C997608398
2252,409000438611',2018-07-16,Indiaforensic VISA ACQ DOM160718,0.0,5924470.66,6555307.790000012,2018,7,16,CASH_IN,5924470.66,C716083600
2253,409000438611',2018-07-16,Indiaforensic RUPAY POS ACQ16071,0.0,2051467.74,8606775.530000012,2018,7,16,CASH_IN,2051467.74,C1782113663
2254,409000438611',2018-07-16,Indiaforensic MASTER ACQ DOM1607,0.0,7500124.07,16106899.600000013,2018,7,16,TRANSFER,7500124.07,C1068824137
2255,409000438611',2018-07-16,Indiaforensic RUPAY POS C2 ACQ16,0.0,512349.97,16619249.570000013,2018,7,16,CASH_IN,512349.97,C812586739
2256,409000438611',2018-07-16,Indiaforensic VISA ACQ INT 12071,0.0,8656.99,16627906.560000015,2018,7,16,CASH_IN,8656.99,C1899073220
2257,409000438611',2018-07-16,TRF TO  Indiaforensic SERVICES I,15000000.0,0.0,1627906.5600000138,2018,7,16,PAYEMENT,15000000.0,C1831477404
2258,409000438611',2018-07-16,TRF TO  Indiaforensic SERVICES I,1000000.0,0.0,627906.5600000136,2018,7,16,CASH_OUT,1000000.0,C1721246982
2259,409000438611',2018-07-17,Indiaforensic MASTER ACQ DOM1707,0.0,1890735.44,2518642.000000013,2018,7,17,CHECK_CASHING,1890735.44,C1782113663
2260,409000438611',2018-07-17,Indiaforensic POS ACQ SETTL17071,0.0,3416328.36,5934970.360000012,2018,7,17,CHECK_CASHING,3416328.36,C22805895
2261,409000438611',2018-07-17,Indiaforensic RUPAY POS ACQ17071,0.0,1738033.41,7673003.770000013,2018,7,17,CHECK_CASHING,1738033.41,C1983747920
2262,409000438611',2018-07-17,Indiaforensic MASTER INT 160718,0.0,1523.95,7674527.720000014,2018,7,17,CASH_IN,1523.95,C1023714065
2263,409000438611',2018-07-17,TRF TO  Indiaforensic SERVICES I,7600000.0,0.0,74527.72000001371,2018,7,17,CASH_OUT,7600000.0,C1060830840
2264,409000438611',2018-07-17,Indiaforensic RUPAY POS C2 ACQ17,0.0,623971.71,698499.4300000137,2018,7,17,TRANSFER,623971.71,C1060830840
2265,409000438611',2018-07-17,Indiaforensic VISA ACQ INT 13071,0.0,29600.0,728099.4300000138,2018,7,17,CASH_IN,29600.0,C793315160
2266,409000438611',2018-07-18,Indiaforensic VISA ACQ DOM180718,0.0,3064964.05,3793063.480000014,2018,7,18,CHECK_CASHING,3064964.05,C2083562754
2267,409000438611',2018-07-18,Indiaforensic RUPAY POS ACQ18071,0.0,1783095.72,5576159.200000013,2018,7,18,TRANSFER,1783095.72,M1156841091
2268,409000438611',2018-07-18,Indiaforensic MASTER ACQ DOM1807,0.0,2414600.91,7990760.110000012,2018,7,18,CHECK_CASHING,2414600.91,C1850180796
2269,409000438611',2018-07-18,TRF TO  Indiaforensic SERVICES I,7900000.0,0.0,90760.11000001336,2018,7,18,CHECK_WITHDRAWAL,7900000.0,C1789550256
2270,409000438611',2018-07-18,Indiaforensic VISA ACQ INT 15071,0.0,2189.08,92949.19000001338,2018,7,18,TRANSFER,2189.08,C597190999
2271,409000438611',2018-07-18,Indiaforensic RUPAY POS C2 ACQ18,0.0,626867.85,719817.0400000133,2018,7,18,TRANSFER,626867.85,C665576141
2272,409000438611',2018-07-19,TRF TO  Indiaforensic SERVICES I,700000.0,0.0,19817.040000013312,2018,7,19,CASH_OUT,700000.0,C998351292
2273,409000438611',2018-07-19,Indiaforensic MASTER ACQ DOM1907,0.0,2619236.29,2639053.330000013,2018,7,19,CASH_IN,2619236.29,C35534346
2274,409000438611',2018-07-19,Indiaforensic VISA ACQ DOM190718,0.0,3015407.05,5654460.380000013,2018,7,19,CHECK_CASHING,3015407.05,C85777802
2275,409000438611',2018-07-19,Indiaforensic RUPAY POS ACQ19071,0.0,1882275.64,7536736.020000013,2018,7,19,CHECK_CASHING,1882275.64,C1023714065
2276,409000438611',2018-07-19,TRF TO  Indiaforensic SERVICES I,7500000.0,0.0,36736.02000001259,2018,7,19,PAYEMENT,7500000.0,C64133603
2277,409000438611',2018-07-19,Indiaforensic RUPAY POS C2 ACQ19,0.0,618283.46,655019.4800000126,2018,7,19,TRANSFER,618283.46,C1076835071
2278,409000438611',2018-07-20,Indiaforensic VISA ACQ DOM200718,0.0,2515289.5,3170308.9800000126,2018,7,20,CASH_IN,2515289.5,C1286084959
2279,409000438611',2018-07-20,Indiaforensic RUPAY POS ACQ20071,0.0,1696329.33,4866638.310000014,2018,7,20,CHECK_CASHING,1696329.33,C248609774
2280,409000438611',2018-07-20,Indiaforensic MASTER ACQ DOM2007,0.0,2137265.63,7003903.9400000125,2018,7,20,CASH_IN,2137265.63,C1983025922
2281,409000438611',2018-07-20,Indiaforensic MASTER INT 190718,0.0,2764.47,7006668.410000012,2018,7,20,CASH_IN,2764.47,C1318822808
2282,409000438611',2018-07-20,TRF TO  Indiaforensic SERVICES I,5000000.0,0.0,2006668.4100000125,2018,7,20,DEBIT,5000000.0,C1782113663
2283,409000438611',2018-07-20,TRF TO  Indiaforensic SERVICES I,1000000.0,0.0,1006668.4100000124,2018,7,20,CHECK_WITHDRAWAL,1000000.0,C728885526
2284,409000438611',2018-07-20,TRF TO  Indiaforensic SERVICES I,1000000.0,0.0,6668.410000012256,2018,7,20,PAYEMENT,1000000.0,C1750905143
2285,409000438611',2018-07-20,Indiaforensic RUPAY POS C2 ACQ20,0.0,548939.88,555608.2900000123,2018,7,20,CASH_IN,548939.88,C1810132623
2286,409000438611',2018-07-21,Indiaforensic VISA ACQ DOM210718,0.0,2761926.02,3317534.3100000117,2018,7,21,CHECK_CASHING,2761926.02,C1234776885
2287,409000438611',2018-07-21,Indiaforensic RUPAY POS ACQ21071,0.0,1729353.15,5046887.460000012,2018,7,21,CHECK_CASHING,1729353.15,C885951223
2288,409000438611',2018-07-21,TRF TO  Indiaforensic SERVICES I,5000000.0,0.0,46887.46000001207,2018,7,21,CHECK_WITHDRAWAL,5000000.0,C665576141
2289,409000438611',2018-07-21,Indiaforensic RUPAY POS C2 ACQ21,0.0,592541.41,639428.8700000121,2018,7,21,CASH_IN,592541.41,C22805895
2290,409000438611',2018-07-23,Indiaforensic VISA ACQ DOM220718,10217.79,0.0,629211.0800000121,2018,7,23,DEBIT,10217.79,C1286084959
2291,409000438611',2018-07-23,Indiaforensic RUPAY POS ACQ22071,0.0,1612004.04,2241215.1200000118,2018,7,23,CHECK_CASHING,1612004.04,C33524623
2292,409000438611',2018-07-23,Indiaforensic VISA ACQ DOM230718,0.0,5472894.38,7714109.500000012,2018,7,23,TRANSFER,5472894.38,C1816757085
2293,409000438611',2018-07-23,Indiaforensic RUPAY POS ACQ23071,0.0,1122498.77,8836608.270000013,2018,7,23,TRANSFER,1122498.77,C2083562754
2294,409000438611',2018-07-23,Indiaforensic RUPAY POS C2 ACQ23,0.0,1003030.61,9839638.880000012,2018,7,23,TRANSFER,1003030.61,C1504109395
2295,409000438611',2018-07-23,Indiaforensic MASTER INT 200718,0.0,10735.62,9850374.500000013,2018,7,23,CHECK_CASHING,10735.62,M465839591
2296,409000438611',2018-07-23,TRF TO  Indiaforensic SERVICES I,1000000.0,0.0,8850374.500000011,2018,7,23,DEBIT,1000000.0,M841483227
2297,409000438611',2018-07-23,TRF TO  Indiaforensic SERVICES I,8800000.0,0.0,50374.50000001117,2018,7,23,DEBIT,8800000.0,M1827371870
2298,409000438611',2018-07-23,Indiaforensic VISA ACQ INT 19071,0.0,2816.93,53191.43000001117,2018,7,23,CHECK_CASHING,2816.93,M253027775
2299,409000438611',2018-07-23,Indiaforensic MASTER ACQ DOM2307,0.0,5510061.34,5563252.770000012,2018,7,23,CHECK_CASHING,5510061.34,M982634822
2300,409000438611',2018-07-24,TRF TO  Indiaforensic SERVICES I,5000000.0,0.0,563252.7700000107,2018,7,24,DEBIT,5000000.0,C1529115495
2301,409000438611',2018-07-24,Indiaforensic VISA ACQ DOM240718,0.0,2883729.75,3446982.5200000107,2018,7,24,TRANSFER,2883729.75,C116289363
2302,409000438611',2018-07-24,Indiaforensic RUPAY POS ACQ24071,0.0,1539784.98,4986767.500000011,2018,7,24,CASH_IN,1539784.98,C2100440237
2303,409000438611',2018-07-24,Indiaforensic MASTER ACQ DOM2407,0.0,2551257.29,7538024.790000011,2018,7,24,TRANSFER,2551257.29,M178259104
2304,409000438611',2018-07-24,Indiaforensic VISA ACQ INT 20071,0.0,101096.9,7639121.6900000125,2018,7,24,CHECK_CASHING,101096.9,C728885526
2305,409000438611',2018-07-24,TRF TO  Indiaforensic SERVICES I,5000000.0,0.0,2639121.690000012,2018,7,24,CHECK_WITHDRAWAL,5000000.0,M133177937
2306,409000438611',2018-07-24,TRF TO  Indiaforensic SERVICES I,2000000.0,0.0,639121.6900000116,2018,7,24,DEBIT,2000000.0,M81269359
2307,409000438611',2018-07-24,TRF TO  Indiaforensic SERVICES I,500000.0,0.0,139121.69000001161,2018,7,24,PAYEMENT,500000.0,M1800959603
2308,409000438611',2018-07-24,Indiaforensic RUPAY POS C2 ACQ24,0.0,426866.28,565987.9700000116,2018,7,24,CASH_IN,426866.28,M1598047636
2309,409000438611',2018-07-25,Indiaforensic MASTER ACQ DOM2507,0.0,2581144.68,3147132.650000012,2018,7,25,CASH_IN,2581144.68,M2066366456
2310,409000438611',2018-07-25,Indiaforensic VISA ACQ DOM250718,0.0,2762574.82,5909707.470000013,2018,7,25,TRANSFER,2762574.82,M1175154004
2311,409000438611',2018-07-25,Indiaforensic RUPAY POS ACQ25071,0.0,1625939.36,7535646.830000012,2018,7,25,CASH_IN,1625939.36,M1980194149
2312,409000438611',2018-07-25,Indiaforensic RUPAY POS C2 ACQ25,0.0,448779.81,7984426.640000013,2018,7,25,CASH_IN,448779.81,M666312528
2313,409000438611',2018-07-25,Indiaforensic VISA ACQ INT 21071,0.0,1526.57,7985953.210000012,2018,7,25,TRANSFER,1526.57,M1956060889
2314,409000438611',2018-07-25,Indiaforensic VISA ACQ INT 22071,0.0,1971.86,7987925.070000012,2018,7,25,CASH_IN,1971.86,M214768579
2315,409000438611',2018-07-25,TRF TO  Indiaforensic SERVICES I,5000000.0,0.0,2987925.0700000124,2018,7,25,PAYEMENT,5000000.0,M1146484093
2316,409000438611',2018-07-25,TRF TO  Indiaforensic SERVICES I,2000000.0,0.0,987925.0700000123,2018,7,25,CASH_OUT,2000000.0,M1292570580
2317,409000438611',2018-07-25,TRF TO  Indiaforensic SERVICES I,500000.0,0.0,487925.0700000124,2018,7,25,PAYEMENT,500000.0,M1815592231
2318,409000438611',2018-07-26,Indiaforensic VISA ACQ DOM260718,0.0,2758537.59,3246462.6600000127,2018,7,26,CASH_IN,2758537.59,M808653065
2319,409000438611',2018-07-26,Indiaforensic RUPAY POS ACQ26071,0.0,1355705.29,4602167.950000012,2018,7,26,TRANSFER,1355705.29,M1962826086
2320,409000438611',2018-07-26,Indiaforensic MASTER ACQ DOM2607,0.0,1645851.2,6248019.1500000125,2018,7,26,TRANSFER,1645851.2,M1736150547
2321,409000438611',2018-07-26,Indiaforensic RUPAY POS C2 ACQ26,0.0,479266.53,6727285.680000013,2018,7,26,CHECK_CASHING,479266.53,M1277678493
2322,409000438611',2018-07-26,Indiaforensic VISA ACQ INT 24071,0.0,2018.44,6729304.120000012,2018,7,26,TRANSFER,2018.44,M2078154554
2323,409000438611',2018-07-26,TRF TO  Indiaforensic SERVICES I,2000000.0,0.0,4729304.120000013,2018,7,26,PAYEMENT,2000000.0,M1742448147
2324,409000438611',2018-07-26,Indiaforensic MASTER INT 250718,0.0,7104.62,4736408.740000013,2018,7,26,CHECK_CASHING,7104.62,M1559817679
2325,409000438611',2018-07-26,TRF TO  Indiaforensic SERVICES I,4600000.0,0.0,136408.74000001323,2018,7,26,PAYEMENT,4600000.0,M1654589039
2326,409000438611',2018-07-27,Indiaforensic MASTER ACQ DOM2707,0.0,1858255.03,1994663.770000013,2018,7,27,CHECK_CASHING,1858255.03,M248495761
2327,409000438611',2018-07-27,TRF TO  Indiaforensic SERVICES I,2000000.0,0.0,,2018,7,27,PAYEMENT,2000000.0,M987489551
2328,409000438611',2018-07-27,Indiaforensic RUPAY POS C2 ACQ27,0.0,1203587.56,1198251.3300000129,2018,7,27,CHECK_CASHING,1203587.56,C1360767589
2329,409000438611',2018-07-27,Indiaforensic VISA ACQ DOM270718,0.0,3035309.0,4233560.330000013,2018,7,27,CHECK_CASHING,3035309.0,M9843062
2330,409000438611',2018-07-27,Indiaforensic RUPAY POS ACQ27071,0.0,1034933.71,5268494.040000013,2018,7,27,CASH_IN,1034933.71,M1286580650
2331,409000438611',2018-07-27,TRF TO Indiaforensic SERVICES IN,3000000.0,0.0,2268494.040000013,2018,7,27,PAYEMENT,3000000.0,M1728057672
2332,409000438611',2018-07-27,TRF TO Indiaforensic SERVICES IN,1000000.0,0.0,1268494.040000013,2018,7,27,CASH_OUT,1000000.0,C1850180796
2333,409000438611',2018-07-27,TRF TO Indiaforensic SERVICES IN,1000000.0,0.0,268494.0400000131,2018,7,27,DEBIT,1000000.0,M65982709
2334,409000438611',2018-07-27,Indiaforensic MASTER INT 260718,0.0,1017.24,269511.28000001307,2018,7,27,CASH_IN,1017.24,C1401316767
2335,409000438611',2018-07-30,Indiaforensic RUPAY POS ACQ28071,0.0,853117.15,1122628.4300000132,2018,7,30,TRANSFER,853117.15,C985934102
2336,409000438611',2018-07-30,Indiaforensic VISA ACQ INT 25071,0.0,1010.97,1123639.4000000132,2018,7,30,TRANSFER,1010.97,C459857341
2337,409000438611',2018-07-30,Indiaforensic VISA ACQ DOM290718,0.0,2972450.64,4096090.040000013,2018,7,30,TRANSFER,2972450.64,M1142735456
2338,409000438611',2018-07-30,Indiaforensic RUPAY POS ACQ29071,0.0,2133218.5,6229308.540000012,2018,7,30,CHECK_CASHING,2133218.5,C2063763486
2339,409000438611',2018-07-30,Indiaforensic VISA ACQ DOM300718,0.0,5436022.74,11665331.280000012,2018,7,30,TRANSFER,5436022.74,M1726515679
2340,409000438611',2018-07-30,Indiaforensic MASTER ACQ DOM3007,0.0,4579311.04,16244642.320000013,2018,7,30,CASH_IN,4579311.04,M929482343
2341,409000438611',2018-07-30,TRF TO  Indiaforensic SERVICES I,5000000.0,0.0,11244642.320000013,2018,7,30,CASH_OUT,5000000.0,M1438178266
2342,409000438611',2018-07-30,Indiaforensic RUPAY POS ACQ30071,0.0,1946193.38,13190835.70000001,2018,7,30,CHECK_CASHING,1946193.38,M973219190
2343,409000438611',2018-07-30,Indiaforensic RUPAY POS C2 ACQ30,0.0,1293745.33,14484581.03000001,2018,7,30,CASH_IN,1293745.33,M1044965465
2344,409000438611',2018-07-30,TRF TO  Indiaforensic SERVICES I,11200000.0,0.0,3284581.0300000105,2018,7,30,CASH_OUT,11200000.0,M442465916
2345,409000438611',2018-07-30,Indiaforensic VISA ACQ INT 26071,0.0,509.09,3285090.1200000118,2018,7,30,CHECK_CASHING,509.09,C1850180796
2346,409000438611',2018-07-30,TRF TO  Indiaforensic SERVICES I,3000000.0,0.0,285090.1200000104,2018,7,30,CASH_OUT,3000000.0,C564160838
2347,409000438611',2018-07-31,Indiaforensic MASTER ACQ DOM3107,0.0,4254434.37,4539524.4900000105,2018,7,31,CHECK_CASHING,4254434.37,M482032955
2348,409000438611',2018-07-31,Indiaforensic VISA ACQ DOM310718,0.0,3440720.04,7980244.53000001,2018,7,31,CHECK_CASHING,3440720.04,C990398217
2349,409000438611',2018-07-31,Indiaforensic RUPAY POS ACQ31071,0.0,1927006.77,9907251.30000001,2018,7,31,CHECK_CASHING,1927006.77,M832066800
2350,409000438611',2018-07-31,TRF TO  Indiaforensic SERVICES I,9900000.0,0.0,7251.300000010058,2018,7,31,DEBIT,9900000.0,C11003494
2351,409000438611',2018-07-31,Indiaforensic MASTER INT 300718,0.0,2180.69,9431.99000001006,2018,7,31,CHECK_CASHING,2180.69,C1234250905
2352,409000438611',2018-07-31,Indiaforensic RUPAY POS C2 ACQ31,0.0,556278.03,565710.02000001,2018,7,31,TRANSFER,556278.03,C1997859171
2353,409000438611',2018-07-31,Indiaforensic VISA ACQ INT 27071,0.0,9517.48,575227.50000001,2018,7,31,CASH_IN,9517.48,M1096343229
2354,409000438611',2018-08-01,Indiaforensic MASTER ACQ DOM0108,0.0,334337.56,909565.06000001,2018,8,1,TRANSFER,334337.56,M2000530216
2355,409000438611',2018-08-01,Indiaforensic VISA ACQ DOM010818,0.0,3960856.97,4870422.0300000105,2018,8,1,TRANSFER,3960856.97,M1665209618
2356,409000438611',2018-08-01,Indiaforensic RUPAY POS ACQ01081,0.0,1134826.43,6005248.46000001,2018,8,1,TRANSFER,1134826.43,C801142660
2357,409000438611',2018-08-01,Indiaforensic RUPAY POS C2 ACQ01,0.0,1632967.41,7638215.87000001,2018,8,1,TRANSFER,1632967.41,M2189588
2358,409000438611',2018-08-01,Indiaforensic MASTER INT 310718,0.0,1009.56,7639225.43000001,2018,8,1,CHECK_CASHING,1009.56,M896945135
2359,409000438611',2018-08-01,TRF TO  Indiaforensic SERVICES I,1600000.0,0.0,6039225.43000001,2018,8,1,CHECK_WITHDRAWAL,1600000.0,M1565614310
2360,409000438611',2018-08-01,TRF TO  Indiaforensic SERVICES I,4000000.0,0.0,2039225.43000001,2018,8,1,PAYEMENT,4000000.0,M688113407
2361,409000438611',2018-08-01,TRF TO  Indiaforensic SERVICES I,2000000.0,0.0,39225.430000009954,2018,8,1,CASH_OUT,2000000.0,M934223763
2362,409000438611',2018-08-02,Indiaforensic VISA ACQ INT 28071,0.0,2996.18,42221.610000009954,2018,8,2,TRANSFER,2996.18,M1083086553
2363,409000438611',2018-08-02,Indiaforensic VISA ACQ DOM020818,0.0,3278925.14,3321146.7500000107,2018,8,2,CHECK_CASHING,3278925.14,M378327915
2364,409000438611',2018-08-02,Indiaforensic RUPAY POS ACQ02081,0.0,1570705.34,4891852.09000001,2018,8,2,TRANSFER,1570705.34,M956429999
2365,409000438611',2018-08-02,Indiaforensic MASTER ACQ DOM0208,0.0,2364675.24,7256527.33000001,2018,8,2,CASH_IN,2364675.24,M281896787
2366,409000438611',2018-08-02,Indiaforensic RUPAY POS C2 ACQ02,0.0,558557.73,7815085.06000001,2018,8,2,CHECK_CASHING,558557.73,M1202653598
2367,409000438611',2018-08-02,TRF TO  Indiaforensic SERVICES I,7200000.0,0.0,615085.0600000097,2018,8,2,CHECK_WITHDRAWAL,7200000.0,M193156903
2368,409000438611',2018-08-02,Indiaforensic VISA ACQ INT 31071,0.0,3369.39,618454.4500000097,2018,8,2,TRANSFER,3369.39,M747004588
2369,409000438611',2018-08-02,Indiaforensic MASTER ACQ DOM0108,0.0,2676548.96,3295003.41000001,2018,8,2,CHECK_CASHING,2676548.96,M925152318
2370,409000438611',2018-08-03,TRF TO  Indiaforensic SERVICES I,3000000.0,0.0,295003.41000000987,2018,8,3,CASH_OUT,3000000.0,M1760020675
2371,409000438611',2018-08-03,Indiaforensic MASTER ACQ DOM0308,0.0,2994466.06,3289469.47000001,2018,8,3,TRANSFER,2994466.06,M596376940
2372,409000438611',2018-08-03,Indiaforensic VISA ACQ DOM030818,0.0,3358436.6,6647906.07000001,2018,8,3,CHECK_CASHING,3358436.6,M1485179287
2373,409000438611',2018-08-03,Indiaforensic RUPAY POS ACQ03081,0.0,1919868.91,8567774.98000001,2018,8,3,TRANSFER,1919868.91,M1955049794
2374,409000438611',2018-08-03,Indiaforensic RUPAY POS C2 ACQ03,0.0,666002.66,9233777.64000001,2018,8,3,TRANSFER,666002.66,M429639728
2375,409000438611',2018-08-03,TRF TO  Indiaforensic SERVICES I,8500000.0,0.0,733777.6400000098,2018,8,3,CASH_OUT,8500000.0,M41633258
2376,409000438611',2018-08-03,Indiaforensic MASTER INT 020818,0.0,38564.42,772342.06000001,2018,8,3,TRANSFER,38564.42,C1068824137
2377,409000438611',2018-08-03,Indiaforensic VISA ACQ INT 01081,0.0,5531.99,777874.05000001,2018,8,3,CHECK_CASHING,5531.99,M1300399812
2378,409000438611',2018-08-04,Indiaforensic RUPAY POS C2 ACQ04,0.0,668470.29,1446344.34000001,2018,8,4,TRANSFER,668470.29,C1182908789
2379,409000438611',2018-08-04,Indiaforensic VISA ACQ DOM040818,0.0,3198963.45,4645307.79000001,2018,8,4,CHECK_CASHING,3198963.45,M1041611526
2380,409000438611',2018-08-04,Indiaforensic RUPAY POS ACQ04081,0.0,2119957.61,6765265.40000001,2018,8,4,CASH_IN,2119957.61,M81907268
2381,409000438611',2018-08-04,TRF TO  Indiaforensic SERVICES I,4000000.0,0.0,2765265.4000000097,2018,8,4,CASH_OUT,4000000.0,M2054997292
2382,409000438611',2018-08-04,TRF TO  Indiaforensic SERVICES I,2000000.0,0.0,765265.4000000097,2018,8,4,CHECK_WITHDRAWAL,2000000.0,M1380593659
2383,409000438611',2018-08-04,TRF TO  Indiaforensic SERVICES I,500000.0,0.0,265265.4000000097,2018,8,4,CASH_OUT,500000.0,M858267892
2384,409000438611',2018-08-06,Indiaforensic VISA ACQ DOM050818,0.0,1997.0,267262.4000000097,2018,8,6,CASH_IN,1997.0,M1917149817
2385,409000438611',2018-08-06,Indiaforensic RUPAY POS ACQ05081,0.0,1735960.81,2003223.2100000097,2018,8,6,CASH_IN,1735960.81,C1941598182
2386,409000438611',2018-08-06,Indiaforensic VISA ACQ DOM060818,0.0,6157567.12,8160790.3300000075,2018,8,6,CASH_IN,6157567.12,C837659261
2387,409000438611',2018-08-06,Indiaforensic RUPAY POS ACQ06081,0.0,2288150.04,10448940.370000007,2018,8,6,CASH_IN,2288150.04,M337039263
2388,409000438611',2018-08-06,Indiaforensic MSTR ACQ DOM04-060,0.0,7393401.46,17842341.83000001,2018,8,6,CASH_IN,7393401.46,M201069753
2389,409000438611',2018-08-06,Indiaforensic RUPAY POS C2 ACQ06,0.0,550324.2,18392666.03000001,2018,8,6,TRANSFER,550324.2,C1620301064
2390,409000438611',2018-08-06,Indiaforensic MASTER INT 030818,0.0,1017.61,18393683.640000008,2018,8,6,CASH_IN,1017.61,M19467337
2391,409000438611',2018-08-06,TRF TO  Indiaforensic SERVICES I,10000000.0,0.0,8393683.640000008,2018,8,6,CHECK_WITHDRAWAL,10000000.0,C977993101
2392,409000438611',2018-08-06,TRF TO  Indiaforensic SERVICES I,7800000.0,0.0,593683.6400000079,2018,8,6,PAYEMENT,7800000.0,M173115411
2393,409000438611',2018-08-07,Indiaforensic VISA ACQ DOM070818,0.0,3991059.33,4584742.970000008,2018,8,7,CASH_IN,3991059.33,M1966480630
2394,409000438611',2018-08-07,Indiaforensic RUPAY POS ACQ07081,0.0,1840178.24,6424921.210000007,2018,8,7,TRANSFER,1840178.24,M1806121021
2395,409000438611',2018-08-07,Indiaforensic MASTER ACQ DOM0708,0.0,356189.49,6781110.700000009,2018,8,7,CASH_IN,356189.49,C665576141
2396,409000438611',2018-08-07,TRF TO  Indiaforensic SERVICES I,6400000.0,0.0,381110.7000000085,2018,8,7,CASH_OUT,6400000.0,M494266287
2397,409000438611',2018-08-07,Indiaforensic MASTER INT 040818,0.0,2793.28,383903.9800000086,2018,8,7,TRANSFER,2793.28,C101601906
2398,409000438611',2018-08-07,Indiaforensic RUPAY POS C2 ACQ07,0.0,691905.97,1075809.9500000086,2018,8,7,TRANSFER,691905.97,M703440120
2399,409000438611',2018-08-07,Indiaforensic VISA ACQ INT 03081,0.0,1390.73,1077200.6800000085,2018,8,7,CASH_IN,1390.73,M1577353545
2400,409000438611',2018-08-08,Indiaforensic MASTER ACQ DOM0908,0.0,4429078.72,5506279.400000008,2018,8,8,CASH_IN,4429078.72,M1029148906
2401,409000438611',2018-08-08,Indiaforensic VISA ACQ DOM080818,0.0,3093491.53,8599770.930000007,2018,8,8,CASH_IN,3093491.53,M1738784081
2402,409000438611',2018-08-08,Indiaforensic RUPAY POS ACQ08081,0.0,1452095.46,10051866.390000008,2018,8,8,CASH_IN,1452095.46,M1452355939
2403,409000438611',2018-08-08,TRF TO  Indiaforensic SERVICES I,10000000.0,0.0,51866.39000000805,2018,8,8,CASH_OUT,10000000.0,M169370778
2404,409000438611',2018-08-08,Indiaforensic RUPAY POS C2 ACQ08,0.0,616577.17,668443.5600000081,2018,8,8,CASH_IN,616577.17,C1529115495
2405,409000438611',2018-08-08,Indiaforensic MASTER INT 070818,0.0,2010.1,670453.6600000082,2018,8,8,TRANSFER,2010.1,M723689932
2406,409000438611',2018-08-08,TRF TO  Indiaforensic SERVICES I,600000.0,0.0,70453.66000000808,2018,8,8,CASH_OUT,600000.0,M605600260
2407,409000438611',2018-08-08,Indiaforensic VISA ACQ INT 04081,0.0,14577.06,85030.72000000806,2018,8,8,CASH_IN,14577.06,C810576909
2408,409000438611',2018-08-08,Indiaforensic VISA ACQ INT 05081,0.0,7624.11,92654.83000000806,2018,8,8,TRANSFER,7624.11,M1901648626
2409,409000438611',2018-08-09,Indiaforensic MASTER ACQ DOM0908,0.0,2734406.19,2827061.020000008,2018,8,9,TRANSFER,2734406.19,M271514713
2410,409000438611',2018-08-09,Indiaforensic VISA ACQ DOM090818,0.0,3533239.51,6360300.530000008,2018,8,9,CASH_IN,3533239.51,C1068824137
2411,409000438611',2018-08-09,Indiaforensic RUPAY POS ACQ09081,0.0,1594196.83,7954497.360000008,2018,8,9,TRANSFER,1594196.83,M315748820
2412,409000438611',2018-08-09,TRF TO  Indiaforensic SERVICES I,7900000.0,0.0,54497.360000007786,2018,8,9,CASH_OUT,7900000.0,M2050529121
2413,409000438611',2018-08-09,Indiaforensic RUPAY POS C2 ACQ09,0.0,539209.85,593707.2100000078,2018,8,9,CASH_IN,539209.85,C1850180796
2414,409000438611',2018-08-09,Indiaforensic MASTER INT 080818,0.0,3262.44,596969.6500000077,2018,8,9,CASH_IN,3262.44,C453211571
2415,409000438611',2018-08-09,Indiaforensic VISA ACQ INT 07081,0.0,5832.89,602802.5400000077,2018,8,9,CASH_IN,5832.89,M47719432
2416,409000438611',2018-08-10,Indiaforensic VISA ACQ DOM100818,0.0,3674356.61,4277159.150000008,2018,8,10,CHECK_CASHING,3674356.61,M258447256
2417,409000438611',2018-08-10,Indiaforensic RUPAY POS ACQ10081,0.0,1719972.28,5997131.430000007,2018,8,10,CASH_IN,1719972.28,C33524623
2418,409000438611',2018-08-10,Indiaforensic MASTER ACQ DOM1008,0.0,2976343.33,8973474.76000001,2018,8,10,TRANSFER,2976343.33,M1408043496
2419,409000438611',2018-08-10,TRF TO  Indiaforensic SERVICES I,8900000.0,0.0,73474.76000000909,2018,8,10,DEBIT,8900000.0,M498023236
2420,409000438611',2018-08-10,Indiaforensic RUPAY POS C2 ACQ10,0.0,740399.39,813874.1500000091,2018,8,10,CASH_IN,740399.39,M1153511683
2421,409000438611',2018-08-10,Indiaforensic MASTER INT 090818,0.0,3624.55,817498.7000000094,2018,8,10,TRANSFER,3624.55,M1818453711
2422,409000438611',2018-08-10,Indiaforensic VISA ACQ INT 08081,0.0,16246.02,833744.7200000092,2018,8,10,CASH_IN,16246.02,M413990536
2423,409000438611',2018-08-13,Indiaforensic VISA ACQ DOM110818,0.0,3813353.52,4647098.24000001,2018,8,13,TRANSFER,3813353.52,M1999135146
2424,409000438611',2018-08-13,Indiaforensic RUPAY POS ACQ11081,0.0,1799837.52,6446935.760000009,2018,8,13,TRANSFER,1799837.52,M429269396
2425,409000438611',2018-08-13,Indiaforensic RUPAY POS ACQ12081,0.0,2405658.23,8852593.99000001,2018,8,13,CASH_IN,2405658.23,M2089786414
2426,409000438611',2018-08-13,Indiaforensic MASTER ACQ DOM1308,0.0,7784381.35,16636975.34000001,2018,8,13,CHECK_CASHING,7784381.35,M1019157412
2427,409000438611',2018-08-13,Indiaforensic VISA ACQ DOM130818,0.0,6140621.11,22777596.45000001,2018,8,13,CHECK_CASHING,6140621.11,M8268900
2428,409000438611',2018-08-13,Indiaforensic RUPAY POS ACQ13081,0.0,2227181.93,25004778.38000001,2018,8,13,CASH_IN,2227181.93,M943219925
2429,409000438611',2018-08-13,TRF TO  Indiaforensic SERVICES I,4000000.0,0.0,21004778.38000001,2018,8,13,PAYEMENT,4000000.0,M1286868539
2430,409000438611',2018-08-13,TRF TO  Indiaforensic SERVICES I,2000000.0,0.0,19004778.38000001,2018,8,13,DEBIT,2000000.0,M978599729
2431,409000438611',2018-08-13,NEFT CHARGES AND GST/0000,29.5,0.0,19004748.88000001,2018,8,13,DEBIT,29.5,M731870416
2432,409000438611',2018-08-13,NEFT/000046766266/Indiaforensic,15000000.0,0.0,4004748.88000001,2018,8,13,CASH_OUT,15000000.0,M2130606983
2433,409000438611',2018-08-13,Indiaforensic RUPAY POS C2 ACQ13,0.0,529291.2,4534040.08000001,2018,8,13,TRANSFER,529291.2,M1512822728
2434,409000438611',2018-08-13,TRF TO  Indiaforensic SERVICES I,4000000.0,0.0,534040.0800000103,2018,8,13,CASH_OUT,4000000.0,M1904720585
2435,409000438611',2018-08-14,Indiaforensic MASTER INT 130818,0.0,4110.93,538151.0100000104,2018,8,14,TRANSFER,4110.93,M1863557065
2436,409000438611',2018-08-14,Indiaforensic MASTER ACQ DOM1408,0.0,2486077.35,3024228.3600000106,2018,8,14,CHECK_CASHING,2486077.35,M423109432
2437,409000438611',2018-08-14,Indiaforensic VISA ACQ DOM140818,0.0,3662821.93,6687050.29000001,2018,8,14,CASH_IN,3662821.93,M366752671
2438,409000438611',2018-08-14,Indiaforensic RUPAY POS ACQ14081,0.0,1918832.75,8605883.04000001,2018,8,14,CHECK_CASHING,1918832.75,M883735648
2439,409000438611',2018-08-14,Indiaforensic RUPAY POS C2 ACQ14,0.0,350602.07,8956485.11000001,2018,8,14,CASH_IN,350602.07,M906370291
2440,409000438611',2018-08-14,Indiaforensic VISA ACQ INT 10081,0.0,2484.96,8958970.070000011,2018,8,14,TRANSFER,2484.96,M538132628
2441,409000438611',2018-08-14,TRF TO  Indiaforensic SERVICES I,8900000.0,0.0,58970.070000011474,2018,8,14,CHECK_WITHDRAWAL,8900000.0,C97730845
2442,409000438611',2018-08-16,Indiaforensic VISA ACQ DOM150818,0.0,4374248.6,4433218.670000011,2018,8,16,CASH_IN,4374248.6,M1813375175
2443,409000438611',2018-08-16,Indiaforensic RUPAY POS ACQ15081,0.0,1966311.39,6399530.060000013,2018,8,16,TRANSFER,1966311.39,C11003494
2444,409000438611',2018-08-16,TRF TO  Indiaforensic SERVICES I,3000000.0,0.0,3399530.0600000108,2018,8,16,CHECK_WITHDRAWAL,3000000.0,M1799316869
2445,409000438611',2018-08-16,TRF TO  Indiaforensic SERVICES I,3000000.0,0.0,399530.06000001077,2018,8,16,PAYEMENT,3000000.0,M1041255755
2446,409000438611',2018-08-16,Indiaforensic VISA ACQ DOM160818,0.0,3196572.65,3596102.7100000107,2018,8,16,TRANSFER,3196572.65,C1810132623
2447,409000438611',2018-08-16,Indiaforensic RUPAY POS ACQ16081,0.0,2485112.43,6081215.140000011,2018,8,16,CHECK_CASHING,2485112.43,M314966354
2448,409000438611',2018-08-16,Indiaforensic MASTER ACQ DOM15-1,0.0,5082342.79,11163557.93000001,2018,8,16,TRANSFER,5082342.79,M1825662118
2449,409000438611',2018-08-16,Indiaforensic VISA ACQ INT 11081,0.0,5892.0,11169449.93000001,2018,8,16,TRANSFER,5892.0,M105146840
2450,409000438611',2018-08-16,Indiaforensic VISA ACQ INT 13081,0.0,5084.7,11174534.63000001,2018,8,16,TRANSFER,5084.7,M1276666395
2451,409000438611',2018-08-16,Indiaforensic MASTER INT 150818,0.0,2739.33,11177273.96000001,2018,8,16,CHECK_CASHING,2739.33,M485237151
2452,409000438611',2018-08-16,TRF TO  Indiaforensic SERVICES I,10000000.0,0.0,1177273.9600000102,2018,8,16,CHECK_WITHDRAWAL,10000000.0,M1714007305
2453,409000438611',2018-08-16,TRF TO  Indiaforensic SERVICES I,1000000.0,0.0,177273.9600000102,2018,8,16,PAYEMENT,1000000.0,C1219161283
2454,409000438611',2018-08-16,Indiaforensic RUPAY POS C2 ACQ16,0.0,639214.75,816488.7100000102,2018,8,16,TRANSFER,639214.75,M668929853
2455,409000438611',2018-08-16,MDR REIMBURSEMENT Q1-2018,0.0,225649.03,1042137.74000001,2018,8,16,CHECK_CASHING,225649.03,M1146423186
2456,409000438611',2018-08-17,TRF TO  Indiaforensic SERVICES I,500000.0,0.0,542137.7400000102,2018,8,17,CHECK_WITHDRAWAL,500000.0,M1196200241
2457,409000438611',2018-08-17,TRF TO  Indiaforensic SERVICES I,500000.0,0.0,42137.74000001024,2018,8,17,CHECK_WITHDRAWAL,500000.0,C1068824137
2458,409000438611',2018-08-17,Indiaforensic RUPAY POS ACQ17081,0.0,1748185.48,1790323.2200000102,2018,8,17,CASH_IN,1748185.48,C248609774
2459,409000438611',2018-08-17,Indiaforensic RUPAY POS C2 ACQ17,0.0,732649.7,2522972.92000001,2018,8,17,TRANSFER,732649.7,C1364913072
2460,409000438611',2018-08-17,TRF TO  Indiaforensic SERVICES I,1700000.0,0.0,822972.9200000102,2018,8,17,CASH_OUT,1700000.0,C1899073220
2461,409000438611',2018-08-18,Indiaforensic VISA ACQ DOM170818,0.0,3019250.24,3842223.1600000095,2018,8,18,CASH_IN,3019250.24,C297927961
2462,409000438611',2018-08-18,Indiaforensic VISA ACQ DOM180818,0.0,3121194.1,6963417.260000011,2018,8,18,CASH_IN,3121194.1,C1122118227
2463,409000438611',2018-08-18,Indiaforensic RUPAY POS ACQ18081,0.0,682930.85,7646348.1100000115,2018,8,18,CHECK_CASHING,682930.85,C660143728
2464,409000438611',2018-08-18,Indiaforensic VISA ACQ INT 14081,0.0,6147.37,7652495.480000013,2018,8,18,CHECK_CASHING,6147.37,C884457408
2465,409000438611',2018-08-18,Indiaforensic VISA ACQ INT 15081,0.0,6189.11,7658684.590000011,2018,8,18,TRANSFER,6189.11,M320321288
2466,409000438611',2018-08-18,TRF TO  Indiaforensic SERVICES I,500000.0,0.0,7158684.590000011,2018,8,18,DEBIT,500000.0,M777113684
2467,409000438611',2018-08-18,TRF TO  Indiaforensic SERVICES I,5000000.0,0.0,2158684.590000011,2018,8,18,PAYEMENT,5000000.0,M1633566545
2468,409000438611',2018-08-18,TRF TO  Indiaforensic SERVICES I,500000.0,0.0,1658684.590000011,2018,8,18,CHECK_WITHDRAWAL,500000.0,M1619773688
2469,409000438611',2018-08-18,Indiaforensic RUPAY POS C2 ACQ18,0.0,1424414.33,3083098.920000011,2018,8,18,TRANSFER,1424414.33,M1151772302
2470,409000438611',2018-08-18,TRF TO  Indiaforensic SERVICES I,500000.0,0.0,2583098.920000011,2018,8,18,CHECK_WITHDRAWAL,500000.0,M2033282874
2471,409000438611',2018-08-20,TRF TO  Indiaforensic SERVICES I,2500000.0,0.0,83098.9200000111,2018,8,20,CASH_OUT,2500000.0,M1241395522
2472,409000438611',2018-08-20,Indiaforensic RUPAY POS ACQ19081,0.0,1867793.6,1950892.5200000112,2018,8,20,CASH_IN,1867793.6,M1640244246
2473,409000438611',2018-08-20,Indiaforensic RUPAY POS ACQ20081,0.0,2103335.6,4054228.1200000113,2018,8,20,CHECK_CASHING,2103335.6,C357863579
2474,409000438611',2018-08-20,Indiaforensic VISA ACQ DOM200818,0.0,6146407.5,10200635.620000012,2018,8,20,CHECK_CASHING,6146407.5,C2140846441
2475,409000438611',2018-08-20,TRF TO  Indiaforensic SERVICES I,10000000.0,0.0,200635.62000001228,2018,8,20,PAYEMENT,10000000.0,M795275472
2476,409000438611',2018-08-20,Indiaforensic MASTER ACQ DOM2008,0.0,10609275.97,10809911.590000013,2018,8,20,TRANSFER,10609275.97,C1711105800
2477,409000438611',2018-08-20,Indiaforensic RUPAY POS C2 ACQ20,0.0,712729.76,11522641.350000013,2018,8,20,CHECK_CASHING,712729.76,C1259769769
2478,409000438611',2018-08-20,Indiaforensic MASTER INT 160818,0.0,1054.58,11523695.930000013,2018,8,20,CASH_IN,1054.58,M382044126
2479,409000438611',2018-08-20,Indiaforensic MASTER INT 170818,0.0,2108.7,11525804.630000012,2018,8,20,CHECK_CASHING,2108.7,C22805895
2480,409000438611',2018-08-20,TRF TO  Indiaforensic SERVICES I,10800000.0,0.0,725804.630000012,2018,8,20,DEBIT,10800000.0,C1997859171
2481,409000438611',2018-08-21,Indiaforensic VISA ACQ DOM210818,0.0,3572383.72,4298188.350000013,2018,8,21,TRANSFER,3572383.72,M720638621
2482,409000438611',2018-08-21,Indiaforensic RUPAY POS ACQ21081,0.0,2045231.8,6343420.1500000125,2018,8,21,CHECK_CASHING,2045231.8,M373299466
2483,409000438611',2018-08-21,Indiaforensic MASTER ACQ DOM2108,0.0,2640659.52,8984079.670000013,2018,8,21,CHECK_CASHING,2640659.52,C451111351
2484,409000438611',2018-08-21,Indiaforensic MASTER INT 180818,0.0,4954.03,8989033.700000012,2018,8,21,CHECK_CASHING,4954.03,C681979935
2485,409000438611',2018-08-21,TRF TO  Indiaforensic SERVICES I,6300000.0,0.0,2689033.7000000123,2018,8,21,DEBIT,6300000.0,C681979935
2486,409000438611',2018-08-21,TRF TO  Indiaforensic SERVICES I,2600000.0,0.0,89033.70000001231,2018,8,21,CASH_OUT,2600000.0,C1262822392
2487,409000438611',2018-08-21,Indiaforensic RUPAY POS C2 ACQ21,0.0,605709.01,694742.7100000123,2018,8,21,CASH_IN,605709.01,C747464370
2488,409000438611',2018-08-21,Indiaforensic VISA ACQ INT 16081,0.0,3054.53,697797.2400000122,2018,8,21,CHECK_CASHING,3054.53,C1831477404
2489,409000438611',2018-08-21,Indiaforensic VISA ACQ INT 17081,0.0,8056.12,705853.3600000123,2018,8,21,CHECK_CASHING,8056.12,C1360767589
2490,409000438611',2018-08-23,TRF TO  Indiaforensic SERVICES I,700000.0,0.0,5853.360000012325,2018,8,23,DEBIT,700000.0,C667346055
2491,409000438611',2018-08-23,Indiaforensic VISA ACQ DOM220818,0.0,3732174.79,3738028.1500000125,2018,8,23,CASH_IN,3732174.79,C1789550256
2492,409000438611',2018-08-23,Indiaforensic RUPAY POS ACQ22081,0.0,2110843.66,5848871.810000013,2018,8,23,CASH_IN,2110843.66,C2083562754
2493,409000438611',2018-08-23,TRF TO  Indiaforensic SERVICES I,5800000.0,0.0,48871.81000001263,2018,8,23,DEBIT,5800000.0,C968113504
2494,409000438611',2018-08-23,Indiaforensic RUPAY POS ACQ23081,0.0,2217738.39,2266610.2000000128,2018,8,23,TRANSFER,2217738.39,M43368234
2495,409000438611',2018-08-23,Indiaforensic VISA ACQ DOM230818,0.0,3635811.2,5902421.4000000125,2018,8,23,TRANSFER,3635811.2,C597190999
2496,409000438611',2018-08-23,TRF TO  Indiaforensic SERVICES I,5900000.0,0.0,2421.400000013411,2018,8,23,CASH_OUT,5900000.0,M724081353
2497,409000438611',2018-08-23,Indiaforensic MASTER ACQ DOM2308,0.0,5748219.23,5750640.630000014,2018,8,23,CASH_IN,5748219.23,M1943266645
2498,409000438611',2018-08-23,Indiaforensic RUPAY POS C2 ACQ23,0.0,517752.75,6268393.380000014,2018,8,23,CASH_IN,517752.75,C115939475
2499,409000438611',2018-08-23,Indiaforensic MASTER INT 210818,0.0,72473.17,6340866.550000014,2018,8,23,CHECK_CASHING,72473.17,M407241000
2500,409000438611',2018-08-23,Indiaforensic VISA ACQ INT 18081,0.0,8846.89,6349713.4400000125,2018,8,23,CASH_IN,8846.89,C884457408
2501,409000438611',2018-08-23,Indiaforensic VISA ACQ INT 20081,0.0,814.54,6350527.9800000135,2018,8,23,TRANSFER,814.54,C796774130
2502,409000438611',2018-08-23,TRF TO  Indiaforensic SERVICES I,5700000.0,0.0,650527.9800000135,2018,8,23,PAYEMENT,5700000.0,C22805895
2503,409000438611',2018-08-23,TRF TO  Indiaforensic SERVICES I,500000.0,0.0,150527.9800000135,2018,8,23,PAYEMENT,500000.0,C909295153
2504,409000438611',2018-08-24,Indiaforensic VISA ACQ DOM240818,0.0,3678765.45,3829293.4300000137,2018,8,24,CHECK_CASHING,3678765.45,C33524623
2505,409000438611',2018-08-24,Indiaforensic RUPAY POS ACQ24081,0.0,1736286.43,5565579.860000013,2018,8,24,TRANSFER,1736286.43,C453211571
2506,409000438611',2018-08-24,Indiaforensic MASTER ACQ DOM2408,0.0,2697229.07,8262808.930000013,2018,8,24,CASH_IN,2697229.07,C1068824137
2507,409000438611',2018-08-24,Indiaforensic RUPAY POS C2 ACQ24,0.0,410319.22,8673128.150000013,2018,8,24,TRANSFER,410319.22,C1899073220
2508,409000438611',2018-08-24,TRF TO  Indiaforensic SERVICES I,5500000.0,0.0,3173128.150000013,2018,8,24,DEBIT,5500000.0,C1711105800
2509,409000438611',2018-08-24,Indiaforensic VISA ACQ INT 21081,0.0,5046.07,3178174.2200000123,2018,8,24,TRANSFER,5046.07,C662736689
2510,409000438611',2018-08-24,Indiaforensic VISA ACQ INT 22081,0.0,53908.43,3232082.650000013,2018,8,24,CHECK_CASHING,53908.43,C11003494
2511,409000438611',2018-08-24,Indiaforensic MASTER INT 230818,0.0,3256.98,3235339.630000013,2018,8,24,CHECK_CASHING,3256.98,C564160838
2512,409000438611',2018-08-24,TRF TO  Indiaforensic SERVICES I,3180000.0,0.0,55339.630000013385,2018,8,24,CASH_OUT,3180000.0,C747464370
2513,409000438611',2018-08-27,Indiaforensic VISA ACQ DOM250818,0.0,2923178.17,2978517.8000000133,2018,8,27,CHECK_CASHING,2923178.17,C1335050193
2514,409000438611',2018-08-27,Indiaforensic RUPAY POS ACQ25081,0.0,1771847.06,4750364.860000013,2018,8,27,CHECK_CASHING,1771847.06,C2100440237
2515,409000438611',2018-08-27,Indiaforensic RUPAY POS ACQ26081,0.0,3327441.43,8077806.290000014,2018,8,27,CASH_IN,3327441.43,C2063763486
2516,409000438611',2018-08-27,Indiaforensic VISA ACQ DOM270818,0.0,7371878.89,15449685.180000015,2018,8,27,CHECK_CASHING,7371878.89,C1335050193
2517,409000438611',2018-08-27,Indiaforensic RUPAY POS ACQ27081,0.0,2520143.87,17969829.050000016,2018,8,27,CHECK_CASHING,2520143.87,C1277716905
2518,409000438611',2018-08-27,Indiaforensic RUPAY POS C2 ACQ27,0.0,579344.56,18549173.610000014,2018,8,27,CHECK_CASHING,579344.56,C11003494
2519,409000438611',2018-08-27,Indiaforensic MASTER ACQ DOM25-2,0.0,9268664.96,27817838.57000001,2018,8,27,TRANSFER,9268664.96,C1859965144
2520,409000438611',2018-08-27,TRF TO  Indiaforensic SERVICES I,3000000.0,0.0,24817838.57000001,2018,8,27,CHECK_WITHDRAWAL,3000000.0,C1360767589
2521,409000438611',2018-08-27,TRF TO  Indiaforensic SERVICES I,15000000.0,0.0,9817838.570000017,2018,8,27,DEBIT,15000000.0,C193625667
2522,409000438611',2018-08-27,TRF TO  Indiaforensic SERVICES I,9700000.0,0.0,117838.5700000152,2018,8,27,PAYEMENT,9700000.0,C1459035867
2523,409000438611',2018-08-28,Indiaforensic MASTER ACQ DOM2808,0.0,2937776.19,3055614.760000015,2018,8,28,CHECK_CASHING,2937776.19,C998351292
2524,409000438611',2018-08-28,Indiaforensic VISA ACQ DOM280818,0.0,3866649.81,6922264.570000015,2018,8,28,CASH_IN,3866649.81,M542598487
2525,409000438611',2018-08-28,Indiaforensic RUPAY POS ACQ28081,0.0,2107692.96,9029957.530000016,2018,8,28,CHECK_CASHING,2107692.96,M1170399398
2526,409000438611',2018-08-28,Indiaforensic VISA ACQ INT 23081,0.0,2514.18,9032471.710000016,2018,8,28,CHECK_CASHING,2514.18,M175822565
2527,409000438611',2018-08-28,Indiaforensic MASTER INT 25-2708,0.0,3042.21,9035513.920000017,2018,8,28,CASH_IN,3042.21,M1762378078
2528,409000438611',2018-08-28,TRF TO  Indiaforensic SERVICES I,9000000.0,0.0,35513.92000001669,2018,8,28,DEBIT,9000000.0,M1196836564
2529,409000438611',2018-08-28,Indiaforensic VISA ACQ INT 24081,0.0,505.48,36019.40000001669,2018,8,28,CHECK_CASHING,505.48,M1035563730
2530,409000438611',2018-08-28,Indiaforensic RUPAY POS C2 ACQ28,0.0,463026.31,499045.7100000167,2018,8,28,CHECK_CASHING,463026.31,M1753107603
2531,409000438611',2018-08-29,Indiaforensic VISA ACQ DOM290818,0.0,3456562.43,3955608.140000017,2018,8,29,CHECK_CASHING,3456562.43,M1858583776
2532,409000438611',2018-08-29,Indiaforensic RUPAY POS ACQ29081,0.0,1938212.68,5893820.820000017,2018,8,29,CASH_IN,1938212.68,M925364462
2533,409000438611',2018-08-29,Indiaforensic MASTER ACQ DOM2908,0.0,2857275.74,8751096.560000017,2018,8,29,TRANSFER,2857275.74,M263656423
2534,409000438611',2018-08-29,TRF FROM  Indiaforensic SERVICES,8700000.0,0.0,51096.560000017285,2018,8,29,CASH_OUT,8700000.0,M326376794
2535,409000438611',2018-08-29,Indiaforensic RUPAY POS C2 ACQ29,0.0,601630.01,652726.5700000173,2018,8,29,TRANSFER,601630.01,M1551263930
2536,409000438611',2018-08-29,Indiaforensic MASTER INT 280818,0.0,3573.96,656300.5300000173,2018,8,29,TRANSFER,3573.96,M361712894
2537,409000438611',2018-08-29,Indiaforensic VISA ACQ INT 25081,0.0,1463.72,657764.2500000172,2018,8,29,CASH_IN,1463.72,M1521132614
2538,409000438611',2018-08-29,Indiaforensic VISA ACQ INT 26081,0.0,31823.05,689587.3000000173,2018,8,29,TRANSFER,31823.05,M65305091
2539,409000438611',2018-08-29,Indiaforensic VISA ACQ INT 27081,0.0,2021.94,691609.2400000172,2018,8,29,TRANSFER,2021.94,M148813381
2540,409000438611',2018-08-30,Indiaforensic VISA ACQ DOM300818,0.0,3662754.29,4354363.530000017,2018,8,30,CHECK_CASHING,3662754.29,M1564629011
2541,409000438611',2018-08-30,Indiaforensic RUPAY POS ACQ30081,0.0,1692205.26,6046568.790000018,2018,8,30,TRANSFER,1692205.26,M1788048182
2542,409000438611',2018-08-30,Indiaforensic MASTER ACQ DOM3008,0.0,3087297.88,9133866.670000017,2018,8,30,CASH_IN,3087297.88,M1749758430
2543,409000438611',2018-08-30,Indiaforensic RUPAY POS C2 ACQ30,0.0,655832.55,9789699.220000016,2018,8,30,CHECK_CASHING,655832.55,M438897070
2544,409000438611',2018-08-30,Indiaforensic VISA ACQ INT 28081,0.0,4372.39,9794071.610000018,2018,8,30,TRANSFER,4372.39,M1064315206
2545,409000438611',2018-08-30,TRF TO  Indiaforensic SERVICES I,9100000.0,0.0,694071.6100000179,2018,8,30,DEBIT,9100000.0,M268490061
2546,409000438611',2018-08-30,TRF TO  Indiaforensic SERVICES I,600000.0,0.0,94071.61000001804,2018,8,30,PAYEMENT,600000.0,M21723014
2547,409000438611',2018-08-31,Indiaforensic VISA ACQ DOM310818,0.0,4019263.03,4113334.6400000174,2018,8,31,TRANSFER,4019263.03,M1672736386
2548,409000438611',2018-08-31,Indiaforensic RUPAY POS ACQ31081,0.0,1581449.02,5694783.660000018,2018,8,31,CASH_IN,1581449.02,M2089636626
2549,409000438611',2018-08-31,Indiaforensic MASTER ACQ DOM3108,0.0,2681385.66,8376169.320000017,2018,8,31,CASH_IN,2681385.66,M168670597
2550,409000438611',2018-08-31,Indiaforensic MASTER INT 300818,0.0,1014.64,8377183.960000018,2018,8,31,CASH_IN,1014.64,M1027022907
2551,409000438611',2018-08-31,Indiaforensic RUPAY POS C2 ACQ31,0.0,606218.89,8983402.850000018,2018,8,31,CHECK_CASHING,606218.89,M412375354
2552,409000438611',2018-08-31,FUNDS TRF  Indiaforensic SERVICE,8300000.0,0.0,683402.8500000183,2018,8,31,DEBIT,8300000.0,C195600860
2553,409000438611',2018-08-31,TRF TO  Indiaforensic SERVICES I,600000.0,0.0,83402.85000001825,2018,8,31,PAYEMENT,600000.0,M2095710480
2554,409000438611',2018-09-01,Indiaforensic RUPAY POS ACQ01091,0.0,1452754.86,1536157.7100000184,2018,9,1,CASH_IN,1452754.86,M1428664849
2555,409000438611',2018-09-01,Indiaforensic VISA ACQ DOM010918,0.0,4037598.98,5573756.690000018,2018,9,1,TRANSFER,4037598.98,M2013332834
2556,409000438611',2018-09-01,TRF TO  Indiaforensic SERVICES I,2000000.0,0.0,3573756.690000018,2018,9,1,CASH_OUT,2000000.0,M950729555
2557,409000438611',2018-09-01,TRF TO  Indiaforensic SERVICES I,3000000.0,0.0,573756.6900000181,2018,9,1,CASH_OUT,3000000.0,M1744032146
2558,409000438611',2018-09-01,TRF TO  Indiaforensic SERVICES I,500000.0,0.0,73756.69000001809,2018,9,1,CHECK_WITHDRAWAL,500000.0,M1929447269
2559,409000438611',2018-09-01,Indiaforensic RUPAY POS C2 ACQ01,0.0,611814.84,685571.5300000181,2018,9,1,CASH_IN,611814.84,C101601906
2560,409000438611',2018-09-01,TRF TO  Indiaforensic SERVICES I,500000.0,0.0,185571.53000001807,2018,9,1,PAYEMENT,500000.0,M1054477035
2561,409000438611',2018-09-03,Indiaforensic RUPAY POS ACQ03091,0.0,2323065.0,2508636.530000018,2018,9,3,CHECK_CASHING,2323065.0,C1067936865
2562,409000438611',2018-09-03,Indiaforensic RUPAY POS ACQ02091,0.0,2028367.81,4537004.3400000185,2018,9,3,CASH_IN,2028367.81,M218654115
2563,409000438611',2018-09-03,Indiaforensic VISA ACQ DOM030918,0.0,7174743.68,11711748.020000018,2018,9,3,CASH_IN,7174743.68,M2125346660
2564,409000438611',2018-09-03,Indiaforensic MASTER ACQ DOM0309,0.0,9897149.02,21608897.040000014,2018,9,3,CHECK_CASHING,9897149.02,M1332121385
2565,409000438611',2018-09-03,Indiaforensic MASTER INT 310818,0.0,1016.83,21609913.870000016,2018,9,3,TRANSFER,1016.83,C373928166
2566,409000438611',2018-09-03,TRF TO  Indiaforensic SERVICES I,10000000.0,0.0,11609913.870000014,2018,9,3,DEBIT,10000000.0,C1163619825
2567,409000438611',2018-09-03,TRF TO  Indiaforensic SERVICES I,10000000.0,0.0,1609913.870000016,2018,9,3,DEBIT,10000000.0,M1783418615
2568,409000438611',2018-09-03,TRF TO  Indiaforensic SERVICES I,1000000.0,0.0,609913.8700000161,2018,9,3,PAYEMENT,1000000.0,C1076835071
2569,409000438611',2018-09-03,TRF TO  Indiaforensic SERVICES I,500000.0,0.0,109913.87000001594,2018,9,3,CHECK_WITHDRAWAL,500000.0,M1689498062
2570,409000438611',2018-09-03,Indiaforensic RUPAY POS C2 ACQ03,0.0,727402.53,837316.400000016,2018,9,3,TRANSFER,727402.53,M1240230559
2571,409000438611',2018-09-03,TRF TO  Indiaforensic SERVICES I,500000.0,0.0,337316.40000001603,2018,9,3,PAYEMENT,500000.0,M1602069459
2572,409000438611',2018-09-04,Indiaforensic MASTER ACQ DOM0409,0.0,2975294.11,3312610.510000016,2018,9,4,CASH_IN,2975294.11,C681979935
2573,409000438611',2018-09-04,Indiaforensic VISA ACQ DOM040918,0.0,3810101.92,7122712.4300000165,2018,9,4,CHECK_CASHING,3810101.92,M1454366618
2574,409000438611',2018-09-04,Indiaforensic RUPAY POS ACQ04091,0.0,1787794.25,8910506.680000015,2018,9,4,TRANSFER,1787794.25,M1892470159
2575,409000438611',2018-09-04,Indiaforensic RUPAY POS C2 ACQ04,0.0,625885.12,9536391.800000014,2018,9,4,CASH_IN,625885.12,C1058634310
2576,409000438611',2018-09-04,Indiaforensic VISA ACQ INT 30081,0.0,2172.07,9538563.870000014,2018,9,4,TRANSFER,2172.07,M1743770306
2577,409000438611',2018-09-04,TRF TO  Indiaforensic SERVICES I,8900000.0,0.0,638563.8700000141,2018,9,4,CASH_OUT,8900000.0,M398644489
2578,409000438611',2018-09-04,TRF TO  Indiaforensic SERVICES I,500000.0,0.0,138563.87000001408,2018,9,4,CASH_OUT,500000.0,M436949795
2579,409000438611',2018-09-05,Indiaforensic RUPAY POS ACQ05091,0.0,1933424.86,2071988.7300000144,2018,9,5,CHECK_CASHING,1933424.86,M610189734
2580,409000438611',2018-09-05,Indiaforensic VISA ACQ DOM050918,0.0,3719198.83,5791187.560000015,2018,9,5,CASH_IN,3719198.83,C1749186397
2581,409000438611',2018-09-05,Indiaforensic MASTER ACQ DOM0509,0.0,3099035.19,8890222.750000015,2018,9,5,TRANSFER,3099035.19,C655381473
2582,409000438611',2018-09-05,Indiaforensic RUPAY POS C2 ACQ05,0.0,503373.11,9393595.860000014,2018,9,5,CHECK_CASHING,503373.11,C1401316767
2583,409000438611',2018-09-05,Indiaforensic MASTER INT 03-0409,0.0,6123.72,9399719.580000017,2018,9,5,CHECK_CASHING,6123.72,C1916720513
2584,409000438611',2018-09-05,TRF TO  Indiaforensic SERVICES I,8800000.0,0.0,599719.580000015,2018,9,5,CHECK_WITHDRAWAL,8800000.0,C481402298
2585,409000438611',2018-09-05,Indiaforensic VISA ACQ INT 01091,0.0,189.69,599909.2700000149,2018,9,5,CASH_IN,189.69,C1899073220
2586,409000438611',2018-09-05,Indiaforensic VISA ACQ INT 02091,0.0,8130.99,608040.2600000149,2018,9,5,CHECK_CASHING,8130.99,C932583850
2587,409000438611',2018-09-05,TRF TO  Indiaforensic SERVICES I,500000.0,0.0,108040.26000001493,2018,9,5,CHECK_WITHDRAWAL,500000.0,C667346055
2588,409000438611',2018-09-06,Indiaforensic MASTER ACQ DOM0609,0.0,3500828.78,3608869.040000015,2018,9,6,CASH_IN,3500828.78,C657736958
2589,409000438611',2018-09-06,Indiaforensic VISA ACQ DOM060918,0.0,3779849.68,7388718.7200000165,2018,9,6,TRANSFER,3779849.68,C998351292
2590,409000438611',2018-09-06,Indiaforensic RUPAY POS ACQ06091,0.0,1790930.88,9179649.600000016,2018,9,6,TRANSFER,1790930.88,C1538745405
2591,409000438611',2018-09-06,Indiaforensic MASTER INT 050918,0.0,4031.54,9183681.140000015,2018,9,6,TRANSFER,4031.54,C392292416
2592,409000438611',2018-09-06,TRF TO  Indiaforensic SERVICES I,9100000.0,0.0,83681.1400000155,2018,9,6,CASH_OUT,9100000.0,C1653859230
2593,409000438611',2018-09-06,Indiaforensic RUPAY POS C2 ACQ06,0.0,560611.28,644292.4200000155,2018,9,6,CASH_IN,560611.28,C665576141
2594,409000438611',2018-09-07,Indiaforensic VISA ACQ DOM070918,0.0,3782758.89,4427051.310000015,2018,9,7,TRANSFER,3782758.89,C1122118227
2595,409000438611',2018-09-07,Indiaforensic RUPAY POS ACQ07091,0.0,1673134.21,6100185.520000015,2018,9,7,TRANSFER,1673134.21,C564160838
2596,409000438611',2018-09-07,Indiaforensic MASTER INT 060918,0.0,2537.04,6102722.560000015,2018,9,7,CHECK_CASHING,2537.04,C1034584766
2597,409000438611',2018-09-07,Indiaforensic VISA ACQ INT 05091,0.0,426.58,6103149.140000016,2018,9,7,CHECK_CASHING,426.58,M2025928493
2598,409000438611',2018-09-07,Indiaforensic RUPAY POS C2 ACQ07,0.0,582582.43,6685731.570000015,2018,9,7,CASH_IN,582582.43,M1945836927
2599,409000438611',2018-09-07,Indiaforensic MASTER ACQ DOM0709,0.0,3335038.44,10020770.010000017,2018,9,7,TRANSFER,3335038.44,M39661414
2600,409000438611',2018-09-07,TRF TO  Indiaforensic SERVICES I,6100000.0,0.0,3920770.010000015,2018,9,7,PAYEMENT,6100000.0,C24119573
2601,409000438611',2018-09-07,TRF TO  Indiaforensic SERVICES I,3900000.0,0.0,20770.01000001468,2018,9,7,CHECK_WITHDRAWAL,3900000.0,M580965610
2602,409000438611',2018-09-10,Indiaforensic VISA ACQ DOM080918,0.0,3810469.95,3831239.960000015,2018,9,10,CASH_IN,3810469.95,C453211571
2603,409000438611',2018-09-10,Indiaforensic RUPAY POS ACQ08091,0.0,1899292.19,5730532.150000015,2018,9,10,TRANSFER,1899292.19,M1037346554
2604,409000438611',2018-09-10,Indiaforensic RUPAY POS ACQ09091,0.0,2613455.08,8343987.230000015,2018,9,10,CASH_IN,2613455.08,M1064456966
2605,409000438611',2018-09-10,TRF TO  Indiaforensic SERVICES I,2000000.0,0.0,6343987.230000015,2018,9,10,CASH_OUT,2000000.0,M605201451
2606,409000438611',2018-09-10,TRF TO  Indiaforensic SERVICES I,3000000.0,0.0,3343987.2300000163,2018,9,10,CASH_OUT,3000000.0,M689147194
2607,409000438611',2018-09-10,TRF TO  Indiaforensic SERVICES I,3000000.0,0.0,343987.2300000153,2018,9,10,DEBIT,3000000.0,M1841099284
2608,409000438611',2018-09-10,Indiaforensic MASTER INT 070918,0.0,2032.59,346019.8200000154,2018,9,10,CASH_IN,2032.59,M2082807696
2609,409000438611',2018-09-10,Indiaforensic MASTER ACQ DOM1009,0.0,10195651.51,10541671.330000017,2018,9,10,CHECK_CASHING,10195651.51,M1537371824
2610,409000438611',2018-09-10,Indiaforensic RUPAY POS C2 ACQ10,0.0,1648788.83,12190460.160000015,2018,9,10,CHECK_CASHING,1648788.83,M399715995
2611,409000438611',2018-09-10,Indiaforensic VISA ACQ DOM100918,0.0,8588677.49,20779137.650000013,2018,9,10,TRANSFER,8588677.49,M779051277
2612,409000438611',2018-09-10,Indiaforensic RUPAY POS ACQ10091,0.0,1555893.84,22335031.490000013,2018,9,10,CHECK_CASHING,1555893.84,M279963418
2613,409000438611',2018-09-10,Indiaforensic VISA ACQ INT 06091,0.0,4657.67,22339689.16000001,2018,9,10,TRANSFER,4657.67,M556662073
2614,409000438611',2018-09-10,TRF TO  Indiaforensic SERVICES I,10000000.0,0.0,12339689.160000015,2018,9,10,PAYEMENT,10000000.0,M1708490318
2615,409000438611',2018-09-10,TRF TO  Indiaforensic SERVICES I,10000000.0,0.0,2339689.160000015,2018,9,10,PAYEMENT,10000000.0,M598049166
2616,409000438611',2018-09-10,TRFTO  Indiaforensic SERVICES IN,2000000.0,0.0,339689.16000001505,2018,9,10,CHECK_WITHDRAWAL,2000000.0,M167550865
2617,409000438611',2018-09-11,Indiaforensic MASTER ACQ DOM1109,0.0,2908886.79,3248575.950000015,2018,9,11,TRANSFER,2908886.79,C1778801068
2618,409000438611',2018-09-11,Indiaforensic VISA ACQ DOM110918,0.0,3591350.17,6839926.120000015,2018,9,11,TRANSFER,3591350.17,M2055472834
2619,409000438611',2018-09-11,Indiaforensic RUPAY POS ACQ11091,0.0,936400.67,7776326.790000015,2018,9,11,CHECK_CASHING,936400.67,M1750120280
2620,409000438611',2018-09-11,TRF TO  Indiaforensic SERVICES I,7700000.0,0.0,76326.79000001494,2018,9,11,PAYEMENT,7700000.0,M1883652579
2621,409000438611',2018-09-11,Indiaforensic MASTER INT 100918,0.0,2552.71,78879.50000001494,2018,9,11,CHECK_CASHING,2552.71,M1107779742
2622,409000438611',2018-09-11,Indiaforensic RUPAY POS C2 ACQ11,0.0,655208.1,734087.6000000149,2018,9,11,CHECK_CASHING,655208.1,M1568450200
2623,409000438611',2018-09-11,TRFT O  Indiaforensic SERVICES I,700000.0,0.0,34087.600000014885,2018,9,11,DEBIT,700000.0,M208437930
2624,409000438611',2018-09-12,Indiaforensic VISA ACQ DOM120918,0.0,4889386.57,4923474.170000015,2018,9,12,CASH_IN,4889386.57,M384283650
2625,409000438611',2018-09-12,Indiaforensic RUPAY POS ACQ12091,0.0,2483737.13,7407211.300000015,2018,9,12,CHECK_CASHING,2483737.13,M1004390006
2626,409000438611',2018-09-12,Indiaforensic MASTER ACQ DOM1209,0.0,2844050.08,10251261.380000014,2018,9,12,CASH_IN,2844050.08,M38647502
2627,409000438611',2018-09-12,TRF TO  Indiaforensic SERVICES I,7400000.0,0.0,2851261.380000014,2018,9,12,DEBIT,7400000.0,M1739653374
2628,409000438611',2018-09-12,TRF TO  Indiaforensic SERVICES I,2700000.0,0.0,151261.38000001386,2018,9,12,CHECK_WITHDRAWAL,2700000.0,M732277370
2629,409000438611',2018-09-13,Indiaforensic RUPAY POS ACQ13091,0.0,1803361.41,1954622.7900000138,2018,9,13,CASH_IN,1803361.41,C1076835071
2630,409000438611',2018-09-13,Indiaforensic RUPAY POS C2 ACQ12,0.0,1461479.98,3416102.770000013,2018,9,13,TRANSFER,1461479.98,M1784908921
2631,409000438611',2018-09-13,Indiaforensic RUPAY POS C2 ACQ13,0.0,889359.55,4305462.320000013,2018,9,13,CHECK_CASHING,889359.55,M1152488702
2632,409000438611',2018-09-13,TRF TO  Indiaforensic SERVICES I,4300000.0,0.0,5462.3200000133365,2018,9,13,CHECK_WITHDRAWAL,4300000.0,C1899073220
2633,409000438611',2018-09-14,Indiaforensic VISA ACQ DOM130918,0.0,5547889.69,5553352.010000014,2018,9,14,CHECK_CASHING,5547889.69,C543409470
2634,409000438611',2018-09-14,Indiaforensic VISA ACQ DOM140918,0.0,5194622.45,10747974.460000014,2018,9,14,CASH_IN,5194622.45,M62182667
2635,409000438611',2018-09-14,Indiaforensic MASTER INT 120918,0.0,851.36,10748825.820000013,2018,9,14,TRANSFER,851.36,M1198450099
2636,409000438611',2018-09-14,TRFT O  Indiaforensic SERVICES I,10000000.0,0.0,748825.8200000133,2018,9,14,PAYEMENT,10000000.0,M2094310615
2637,409000438611',2018-09-14,Indiaforensic RUPAY POS ACQ14091,0.0,1897124.31,2645950.130000013,2018,9,14,CHECK_CASHING,1897124.31,M26059997
2638,409000438611',2018-09-14,Indiaforensic MASTER ACQ DOM1409,0.0,6878167.6,9524117.730000012,2018,9,14,TRANSFER,6878167.6,M1753746465
2639,409000438611',2018-09-14,TRFT O  Indiaforensic SERVICES I,700000.0,0.0,8824117.730000012,2018,9,14,CHECK_WITHDRAWAL,700000.0,C1286084959
2640,409000438611',2018-09-14,Indiaforensic VISA ACQ INT 09091,0.0,7873.94,8831991.670000013,2018,9,14,CHECK_CASHING,7873.94,M1866340787
2641,409000438611',2018-09-14,Indiaforensic VISA ACQ INT 11091,0.0,610.91,8832602.580000013,2018,9,14,TRANSFER,610.91,M2097435292
2642,409000438611',2018-09-14,Indiaforensic RUPAY POS C2 ACQ14,0.0,727827.14,9560429.720000014,2018,9,14,TRANSFER,727827.14,M186049026
2643,409000438611',2018-09-14,TRF TO  Indiaforensic SERVICES I,8800000.0,0.0,760429.7200000137,2018,9,14,CASH_OUT,8800000.0,C667346055
2644,409000438611',2018-09-15,Indiaforensic VISA ACQ DOM150918,0.0,4484441.34,5244871.060000014,2018,9,15,CASH_IN,4484441.34,C421163163
2645,409000438611',2018-09-15,Indiaforensic RUPAY POS ACQ15091,0.0,2054952.63,7299823.6900000125,2018,9,15,TRANSFER,2054952.63,C1935365522
2646,409000438611',2018-09-15,TRF TO  Indiaforensic SERVICES I,2000000.0,0.0,5299823.690000013,2018,9,15,CHECK_WITHDRAWAL,2000000.0,C1850180796
2647,409000438611',2018-09-15,TRF TO  Indiaforensic SERVICES I,5000000.0,0.0,299823.69000001345,2018,9,15,PAYEMENT,5000000.0,C557041912
2648,409000438611',2018-09-15,Indiaforensic RUPAY POS C2 ACQ15,0.0,722352.03,1022175.7200000136,2018,9,15,CASH_IN,722352.03,C832279283
2649,409000438611',2018-09-15,TRF TO  Indiaforensic SERVICES I,1000000.0,0.0,22175.72000001348,2018,9,15,PAYEMENT,1000000.0,C1568059495
2650,409000438611',2018-09-17,Indiaforensic RUPAY POS ACQ17091,0.0,3801066.65,3823242.370000013,2018,9,17,CHECK_CASHING,3801066.65,C392292416
2651,409000438611',2018-09-17,Indiaforensic RUPAY POS ACQ16091,0.0,458605.83,4281848.200000013,2018,9,17,CHECK_CASHING,458605.83,C540811471
2652,409000438611',2018-09-17,Indiaforensic RUPAY POS ACQ REV1,458605.83,0.0,3823242.370000013,2018,9,17,CASH_OUT,458605.83,C667346055
2653,409000438611',2018-09-17,Indiaforensic RUPAY POS ACQ16091,0.0,1089064.92,4912307.290000013,2018,9,17,TRANSFER,1089064.92,C1364913072
2654,409000438611',2018-09-17,Indiaforensic MASTER ACQ DOM1709,0.0,10379899.39,15292206.680000015,2018,9,17,TRANSFER,10379899.39,C1234776885
2655,409000438611',2018-09-17,Indiaforensic VISA ACQ DOM170918,0.0,8848842.47,24141049.15000001,2018,9,17,CASH_IN,8848842.47,C248609774
2656,409000438611',2018-09-17,TRF TO  Indiaforensic SERVICES I,4000000.0,0.0,20141049.150000013,2018,9,17,CASH_OUT,4000000.0,C22805895
2657,409000438611',2018-09-17,TRF TO  Indiaforensic SERVICES I,10000000.0,0.0,10141049.150000013,2018,9,17,PAYEMENT,10000000.0,C195600860
2658,409000438611',2018-09-17,TRF TO  Indiaforensic SERVICES I,10000000.0,0.0,141049.1500000134,2018,9,17,DEBIT,10000000.0,C193864812
2659,409000438611',2018-09-17,Indiaforensic RUPAY POS C2 ACQ17,0.0,711362.08,852411.2300000135,2018,9,17,TRANSFER,711362.08,C1590550415
2660,409000438611',2018-09-17,Indiaforensic VISA ACQ INT 12091,0.0,2505.88,854917.1100000135,2018,9,17,CASH_IN,2505.88,C1816757085
2661,409000438611',2018-09-17,Indiaforensic VISA ACQ INT 13091,0.0,791.2,855708.3100000133,2018,9,17,TRANSFER,791.2,C1041638599
2662,409000438611',2018-09-17,TRF TO  Indiaforensic SERVICES I,800000.0,0.0,55708.31000001333,2018,9,17,CASH_OUT,800000.0,C884457408
2663,409000438611',2018-09-18,Indiaforensic VISA ACQ DOM180918,0.0,4287912.0,4343620.310000014,2018,9,18,TRANSFER,4287912.0,C657736958
2664,409000438611',2018-09-18,Indiaforensic RUPAY POS ACQ18091,0.0,2253557.87,6597178.180000014,2018,9,18,CHECK_CASHING,2253557.87,C35534346
2665,409000438611',2018-09-18,Indiaforensic MASTER ACQ DOM1809,0.0,3531438.7,10128616.880000014,2018,9,18,CASH_IN,3531438.7,C1740000325
2666,409000438611',2018-09-18,TRF TO  Indiaforensic SERVICES I,10000000.0,0.0,128616.88000001384,2018,9,18,DEBIT,10000000.0,C716083600
2667,409000438611',2018-09-18,Indiaforensic MASTER INT15-17091,0.0,2544.31,131161.19000001386,2018,9,18,CASH_IN,2544.31,C657736958
2668,409000438611',2018-09-18,Indiaforensic RUPAY POS C2 ACQ18,0.0,719024.8,850185.9900000141,2018,9,18,TRANSFER,719024.8,C838411509
2669,409000438611',2018-09-18,Indiaforensic VISA ACQ INT 14091,0.0,916.36,851102.3500000141,2018,9,18,CHECK_CASHING,916.36,C1577213552
2670,409000438611',2018-09-19,TRF TO  Indiaforensic SERVICES I,800000.0,0.0,51102.35000001395,2018,9,19,CHECK_WITHDRAWAL,800000.0,C2118255842
2671,409000438611',2018-09-19,Indiaforensic VISA ACQ DOM190918,0.0,4620810.48,4671912.830000014,2018,9,19,CHECK_CASHING,4620810.48,C447320069
2672,409000438611',2018-09-19,Indiaforensic RUPAY POS ACQ19091,0.0,2075213.08,6747125.910000014,2018,9,19,CASH_IN,2075213.08,C1721246982
2673,409000438611',2018-09-19,TRF TO  Indiaforensic SERVICES I,1000000.0,0.0,5747125.910000014,2018,9,19,DEBIT,1000000.0,C401424608
2674,409000438611',2018-09-19,Indiaforensic MASTER ACQ DOM1909,0.0,3259083.71,9006209.620000014,2018,9,19,CHECK_CASHING,3259083.71,C998351292
2675,409000438611',2018-09-19,TRF TO  Indiaforensic SERVICES I,5000000.0,0.0,4006209.6200000136,2018,9,19,CHECK_WITHDRAWAL,5000000.0,C543409470
2676,409000438611',2018-09-19,Indiaforensic RUPAY POS C2 ACQ19,0.0,604523.51,4610733.130000014,2018,9,19,CHECK_CASHING,604523.51,C1286084959
2677,409000438611',2018-09-19,TRF TO  Indiaforensic SERVICES I,500000.0,0.0,4110733.130000014,2018,9,19,PAYEMENT,500000.0,C681979935
2678,409000438611',2018-09-19,TRF TO  Indiaforensic SERVICES I,4000000.0,0.0,110733.13000001387,2018,9,19,PAYEMENT,4000000.0,C1870252780
2679,409000438611',2018-09-19,Indiaforensic VISA ACQ INT 15091,0.0,2463.68,113196.81000001385,2018,9,19,CASH_IN,2463.68,C1590550415
2680,409000438611',2018-09-19,Indiaforensic VISA ACQ INT 16091,0.0,2021.94,115218.75000001385,2018,9,19,CHECK_CASHING,2021.94,C1259769769
2681,409000438611',2018-09-19,Indiaforensic VISA ACQ INT 17091,0.0,3639.49,118858.24000001384,2018,9,19,TRANSFER,3639.49,C1688019098
2682,409000438611',2018-09-20,Indiaforensic RUPAY POS ACQ20091,0.0,2024638.2,2143496.440000014,2018,9,20,CHECK_CASHING,2024638.2,C657736958
2683,409000438611',2018-09-20,Indiaforensic RUPAY POS C2 ACQ20,0.0,613675.86,2757172.3000000142,2018,9,20,CHECK_CASHING,613675.86,C1859965144
2684,409000438611',2018-09-20,TRF TO  Indiaforensic SERVICES I,2700000.0,0.0,57172.300000013776,2018,9,20,DEBIT,2700000.0,C1740000325
2685,409000438611',2018-09-21,Indiaforensic VISA ACQ DOM200918,0.0,5095510.17,5152682.470000014,2018,9,21,CASH_IN,5095510.17,C97730845
2686,409000438611',2018-09-21,FUND TRF TO  Indiaforensic SERVI,5000000.0,0.0,152682.47000001368,2018,9,21,CASH_OUT,5000000.0,C97730845
2687,409000438611',2018-09-21,Indiaforensic MASTER ACQ DOM20-2,0.0,8137653.92,8290336.390000014,2018,9,21,TRANSFER,8137653.92,C1629911510
2688,409000438611',2018-09-21,Indiaforensic VISA ACQ DOM210918,0.0,4940834.91,13231171.300000016,2018,9,21,CASH_IN,4940834.91,C878506901
2689,409000438611',2018-09-21,Indiaforensic RUPAY POS ACQ21091,0.0,1849903.02,15081074.320000013,2018,9,21,TRANSFER,1849903.02,C1899073220
2690,409000438611',2018-09-21,Indiaforensic RUPAY POS C2 ACQ21,0.0,889018.24,15970092.560000015,2018,9,21,CHECK_CASHING,889018.24,C655381473
2691,409000438611',2018-09-21,NEFT CHARGES AND GST/0000,29.5,0.0,15970063.060000015,2018,9,21,DEBIT,29.5,C801142660
2692,409000438611',2018-09-21,NEFT/000050794506/Indiaforensic,10000000.0,0.0,5970063.060000014,2018,9,21,CHECK_WITHDRAWAL,10000000.0,C33524623
2693,409000438611',2018-09-21,NEFT CHARGES AND GST/0000,29.5,0.0,5970033.560000014,2018,9,21,DEBIT,29.5,C728885526
2694,409000438611',2018-09-21,NEFT/000050794647/Indiaforensic,5000000.0,0.0,970033.5600000136,2018,9,21,CASH_OUT,5000000.0,C1870252780
2695,409000438611',2018-09-21,Indiaforensic MASTER INT190918,0.0,5021.8,975055.3600000136,2018,9,21,TRANSFER,5021.8,C1163619825
2696,409000438611',2018-09-21,Indiaforensic MASTER INT200918,0.0,2002.91,977058.2700000136,2018,9,21,CHECK_CASHING,2002.91,C747464370
2697,409000438611',2018-09-21,Indiaforensic VISA ACQ INT 18091,0.0,3026.11,980084.3800000136,2018,9,21,CHECK_CASHING,3026.11,C534662976
2698,409000438611',2018-09-21,FUND TRF TO  Indiaforensic SERVI,900000.0,0.0,80084.38000001363,2018,9,21,CHECK_WITHDRAWAL,900000.0,C557041912
2699,409000438611',2018-09-24,Indiaforensic VISA ACQ DOM220918,0.0,5362262.85,5442347.2300000135,2018,9,24,CHECK_CASHING,5362262.85,C564160838
2700,409000438611',2018-09-24,Indiaforensic RUPAY POS ACQ22091,0.0,2208240.16,7650587.390000014,2018,9,24,CASH_IN,2208240.16,C297927961
2701,409000438611',2018-09-24,Indiaforensic VISA ACQ DOM230918,2000.0,0.0,7648587.390000014,2018,9,24,DEBIT,2000.0,C1041638599
2702,409000438611',2018-09-24,Indiaforensic RUPAY POS ACQ23091,0.0,2763472.14,10412059.530000014,2018,9,24,TRANSFER,2763472.14,C1590550415
2703,409000438611',2018-09-24,TRF TO  Indiaforensic SERVICES I,10000000.0,0.0,412059.53000001423,2018,9,24,DEBIT,10000000.0,C2117043942
2704,409000438611',2018-09-24,Indiaforensic MASTER ACQ DOM2409,0.0,10828620.68,11240680.210000014,2018,9,24,CASH_IN,10828620.68,M162667475
2705,409000438611',2018-09-24,Indiaforensic VISA ACQ DOM240918,0.0,8384692.62,19625372.830000013,2018,9,24,TRANSFER,8384692.62,M124132186
2706,409000438611',2018-09-24,Indiaforensic RUPAY POS ACQ24091,0.0,2381076.28,22006449.110000014,2018,9,24,CHECK_CASHING,2381076.28,M1707293586
2707,409000438611',2018-09-24,TRF TO  Indiaforensic SERVICES I,15000000.0,0.0,7006449.110000012,2018,9,24,CASH_OUT,15000000.0,M1309191417
2708,409000438611',2018-09-24,TRF TO  Indiaforensic SERVICES I,5000000.0,0.0,2006449.1100000143,2018,9,24,PAYEMENT,5000000.0,M2026706491
2709,409000438611',2018-09-24,TRF TO  Indiaforensic SERVICES I,2000000.0,0.0,6449.110000014305,2018,9,24,CHECK_WITHDRAWAL,2000000.0,M351216770
2710,409000438611',2018-09-24,Indiaforensic RUPAY POS C2 ACQ24,0.0,626670.73,633119.8400000143,2018,9,24,CHECK_CASHING,626670.73,M1967667267
2711,409000438611',2018-09-24,Indiaforensic VISA ACQ INT 19091,0.0,1162.62,634282.4600000143,2018,9,24,CHECK_CASHING,1162.62,M1589968642
2712,409000438611',2018-09-24,Indiaforensic VISA ACQ INT 20091,0.0,2021.94,636304.4000000142,2018,9,24,TRANSFER,2021.94,M724525007
2713,409000438611',2018-09-24,TRF TO  Indiaforensic SERVICES I,500000.0,0.0,136304.40000001426,2018,9,24,CHECK_WITHDRAWAL,500000.0,M1897732690
2714,409000438611',2018-09-25,Indiaforensic MASTER ACQ DOM2509,0.0,3364041.58,3500345.9800000144,2018,9,25,CHECK_CASHING,3364041.58,M808377204
2715,409000438611',2018-09-25,Indiaforensic VISA ACQ DOM250918,0.0,4448670.26,7949016.240000014,2018,9,25,CHECK_CASHING,4448670.26,M1730900666
2716,409000438611',2018-09-25,Indiaforensic RUPAY POS ACQ25091,0.0,1823030.98,9772047.220000014,2018,9,25,TRANSFER,1823030.98,M824915171
2717,409000438611',2018-09-25,TRF TO  Indiaforensic SERVICES I,9700000.0,0.0,72047.22000001371,2018,9,25,CASH_OUT,9700000.0,M445010547
2718,409000438611',2018-09-25,Indiaforensic RUPAY POS C2 ACQ25,0.0,785412.7,857459.9200000138,2018,9,25,CASH_IN,785412.7,M1080561710
2719,409000438611',2018-09-25,Indiaforensic MASTER INT220918,0.0,2866.68,860326.6000000137,2018,9,25,CASH_IN,2866.68,M1811975204
2720,409000438611',2018-09-25,Indiaforensic VISA ACQ INT 21091,0.0,1525.41,861852.0100000137,2018,9,25,CASH_IN,1525.41,M554146322
2721,409000438611',2018-09-26,TRF TO  Indiaforensic SERVICES I,800000.0,0.0,61852.01000001375,2018,9,26,DEBIT,800000.0,C662736689
2722,409000438611',2018-09-26,Indiaforensic MASTER ACQ DOM2609,0.0,3929121.5,3990973.5100000137,2018,9,26,TRANSFER,3929121.5,M910260820
2723,409000438611',2018-09-26,Indiaforensic VISA ACQ DOM260918,0.0,4710129.14,8701102.650000013,2018,9,26,TRANSFER,4710129.14,M1193939374
2724,409000438611',2018-09-26,Indiaforensic RUPAY POS ACQ26091,0.0,2069945.73,10771048.380000014,2018,9,26,CHECK_CASHING,2069945.73,M820627987
2725,409000438611',2018-09-26,Indiaforensic RUPAY POS C2 ACQ26,0.0,618219.68,11389268.060000015,2018,9,26,TRANSFER,618219.68,C1899073220
2726,409000438611',2018-09-26,Indiaforensic MASTER INT250918,0.0,610.79,11389878.850000013,2018,9,26,CHECK_CASHING,610.79,M1624203949
2727,409000438611',2018-09-26,TRF TO  Indiaforensic SERVICES I,10000000.0,0.0,1389878.850000013,2018,9,26,CASH_OUT,10000000.0,M449105069
2728,409000438611',2018-09-26,TRF TO  Indiaforensic SERVICES I,500000.0,0.0,889878.8500000127,2018,9,26,CASH_OUT,500000.0,M345516674
2729,409000438611',2018-09-26,Indiaforensic VISA ACQ INT 22091,0.0,3028.49,892907.3400000127,2018,9,26,CASH_IN,3028.49,M1928900108
2730,409000438611',2018-09-26,Indiaforensic VISA ACQ INT 23091,0.0,1527.26,894434.6000000127,2018,9,26,CHECK_CASHING,1527.26,M1730595945
2731,409000438611',2018-09-26,PENDING SETTL -DT 110317,0.0,770755.56,1665190.1600000127,2018,9,26,TRANSFER,770755.56,M864657274
2732,409000438611',2018-09-26,OXYGEN POS ACQ SETTL 0409,742776.21,0.0,922413.9500000128,2018,9,26,PAYEMENT,742776.21,M688722159
2733,409000438611',2018-09-26,TRF TO  Indiaforensic SERVICES I,800000.0,0.0,122413.95000001276,2018,9,26,DEBIT,800000.0,M1682828548
2734,409000438611',2018-09-27,Indiaforensic VISA ACQ DOM270918,0.0,3983092.06,4105506.010000012,2018,9,27,CHECK_CASHING,3983092.06,M332998175
2735,409000438611',2018-09-27,Indiaforensic RUPAY POS ACQ27091,0.0,1582522.62,5688028.630000013,2018,9,27,TRANSFER,1582522.62,M87035052
2736,409000438611',2018-09-27,Indiaforensic RUPAY POS C2 ACQ27,0.0,629228.89,6317257.520000013,2018,9,27,CHECK_CASHING,629228.89,M463690173
2737,409000438611',2018-09-27,Indiaforensic MASTER ACQ DOM2709,0.0,3566752.62,9884010.140000012,2018,9,27,CHECK_CASHING,3566752.62,M1731795367
2738,409000438611',2018-09-27,TRF TO  Indiaforensic SERVICES I,5000000.0,0.0,4884010.140000012,2018,9,27,CASH_OUT,5000000.0,M607578671
2739,409000438611',2018-09-27,TRF TO  Indiaforensic SERVICES I,1300000.0,0.0,3584010.140000012,2018,9,27,CASH_OUT,1300000.0,M550424075
2740,409000438611',2018-09-27,Indiaforensic VISA ACQ INT 25091,0.0,3134.0,3587144.140000012,2018,9,27,CASH_IN,3134.0,C503195940
2741,409000438611',2018-09-27,TRF TO  Indiaforensic SERVICES I,3000000.0,0.0,587144.1400000118,2018,9,27,CHECK_WITHDRAWAL,3000000.0,C1870252780
2742,409000438611',2018-09-28,TRF TO  Indiaforensic SERVICES I,500000.0,0.0,87144.14000001177,2018,9,28,CHECK_WITHDRAWAL,500000.0,C1750905143
2743,409000438611',2018-09-28,Indiaforensic MASTER ACQ DOM2809,0.0,3402144.5,3489288.640000012,2018,9,28,TRANSFER,3402144.5,C306206744
2744,409000438611',2018-09-28,Indiaforensic VISA ACQ DOM280918,0.0,4491980.38,7981269.020000013,2018,9,28,CHECK_CASHING,4491980.38,C1782113663
2745,409000438611',2018-09-28,Indiaforensic RUPAY POS ACQ28091,0.0,1599830.58,9581099.600000013,2018,9,28,TRANSFER,1599830.58,C1335050193
2746,409000438611',2018-09-28,Indiaforensic RUPAY POS C2 ACQ28,0.0,592337.81,10173437.410000013,2018,9,28,TRANSFER,592337.81,C667346055
2747,409000438611',2018-09-28,TRF TO  Indiaforensic SERVICES I,9500000.0,0.0,673437.4100000132,2018,9,28,CASH_OUT,9500000.0,C1577213552
2748,409000438611',2018-09-28,TRF TO  Indiaforensic SERVICES I,500000.0,0.0,173437.41000001322,2018,9,28,CHECK_WITHDRAWAL,500000.0,C557041912
2749,409000438611',2018-09-29,Indiaforensic VISA ACQ DOM290918,0.0,4743583.33,4917020.740000013,2018,9,29,CHECK_CASHING,4743583.33,C1916720513
2750,409000438611',2018-09-29,Indiaforensic RUPAY POS ACQ29091,0.0,1811308.94,6728329.680000013,2018,9,29,TRANSFER,1811308.94,C1068824137
2751,409000438611',2018-09-29,Indiaforensic RUPAY POS C2 ACQ29,0.0,730811.78,7459141.460000012,2018,9,29,CASH_IN,730811.78,C1778801068
2752,409000438611',2018-09-29,TRF TO  Indiaforensic SERVICES I,5000000.0,0.0,2459141.460000013,2018,9,29,CASH_OUT,5000000.0,C1262822392
2753,409000438611',2018-09-29,TRF TO  Indiaforensic SERVICES I,1000000.0,0.0,1459141.4600000132,2018,9,29,CHECK_WITHDRAWAL,1000000.0,C1318822808
2754,409000438611',2018-09-29,TRF TO  Indiaforensic SERVICES I,500000.0,0.0,959141.460000013,2018,9,29,CASH_OUT,500000.0,C884457408
2755,409000438611',2018-09-29,Indiaforensic VISA ACQ INT 26091,0.0,1018.18,960159.6400000128,2018,9,29,TRANSFER,1018.18,C1782113663
2756,409000438611',2018-10-01,Indiaforensic VISA ACQ DOM300918,1497.75,0.0,958661.8900000128,2018,10,1,DEBIT,1497.75,C1504109395
2757,409000438611',2018-10-01,Indiaforensic RUPAY POS ACQ30091,0.0,2087393.53,3046055.420000013,2018,10,1,CASH_IN,2087393.53,C1740000325
2758,409000438611',2018-10-01,TRF TO  Indiaforensic SERVICES I,3000000.0,0.0,46055.42000001296,2018,10,1,CHECK_WITHDRAWAL,3000000.0,C836514715
2759,409000438611',2018-10-01,Indiaforensic VISA ACQ DOM011018,0.0,10088103.89,10134159.310000014,2018,10,1,CHECK_CASHING,10088103.89,C1850180796
2760,409000438611',2018-10-01,Indiaforensic RUPAY POS ACQ01101,0.0,1739866.69,11874026.000000013,2018,10,1,CHECK_CASHING,1739866.69,C124540047
2761,409000438611',2018-10-01,Indiaforensic MASTER ACQ DOM0110,0.0,10614031.83,22488057.830000013,2018,10,1,CASH_IN,10614031.83,C1538745405
2762,409000438611',2018-10-01,Indiaforensic RUPAY POS C2 ACQ01,0.0,1527959.32,24016017.15000001,2018,10,1,CHECK_CASHING,1527959.32,C1286084959
2763,409000438611',2018-10-01,TRF TO  Indiaforensic SERVICES I,15000000.0,0.0,9016017.150000013,2018,10,1,CASH_OUT,15000000.0,C97730845
2764,409000438611',2018-10-01,TRF TO  Indiaforensic SERVICES I,7400000.0,0.0,1616017.1500000134,2018,10,1,CASH_OUT,7400000.0,C1498438472
2765,409000438611',2018-10-01,TRF TO  Indiaforensic SERVICES I,1600000.0,0.0,16017.150000013413,2018,10,1,CHECK_WITHDRAWAL,1600000.0,C1112414583
2766,409000438611',2018-10-03,Indiaforensic VISA ACQ DOM021018,0.0,5265869.44,5281886.590000014,2018,10,3,TRANSFER,5265869.44,C193864812
2767,409000438611',2018-10-03,Indiaforensic RUPAY POS ACQ02101,0.0,2342981.61,7624868.200000014,2018,10,3,CASH_IN,2342981.61,C1360767589
2768,409000438611',2018-10-03,Indiaforensic VISA ACQ INT 27091,0.0,14835.0,7639703.200000014,2018,10,3,CASH_IN,14835.0,C1076835071
2769,409000438611',2018-10-03,Indiaforensic VISA ACQ DOM031018,0.0,5317080.62,12956783.820000015,2018,10,3,CASH_IN,5317080.62,C193864812
2770,409000438611',2018-10-03,Indiaforensic RUPAY POS ACQ03101,0.0,3527074.28,16483858.100000015,2018,10,3,TRANSFER,3527074.28,C1068824137
2771,409000438611',2018-10-03,TRF TO  Indiaforensic SERVICES I,12200000.0,0.0,4283858.100000015,2018,10,3,PAYEMENT,12200000.0,C1262822392
2772,409000438611',2018-10-03,Indiaforensic MASTER ACQ DOM0310,0.0,8233183.51,12517041.610000014,2018,10,3,CHECK_CASHING,8233183.51,C1076835071
2773,409000438611',2018-10-03,Indiaforensic RUPAY POS C2 ACQ03,0.0,660066.66,13177108.270000014,2018,10,3,CASH_IN,660066.66,C1318822808
2774,409000438611',2018-10-03,Indiaforensic MASTER INT2909-011,0.0,10742.67,13187850.940000014,2018,10,3,CASH_IN,10742.67,C24119573
2775,409000438611',2018-10-03,TRF TO  Indiaforensic SERVICES I,4200000.0,0.0,8987850.940000014,2018,10,3,DEBIT,4200000.0,C1899073220
2776,409000438611',2018-10-04,TRF TO  Indiaforensic SERVICES I,8500000.0,0.0,487850.9400000144,2018,10,4,PAYEMENT,8500000.0,C193625667
2777,409000438611',2018-10-04,Indiaforensic MASTER ACQ DOM0410,0.0,4252285.78,4740136.720000015,2018,10,4,CASH_IN,4252285.78,C1749186397
2778,409000438611',2018-10-04,Indiaforensic VISA ACQ DOM041018,0.0,6244561.32,10984698.040000014,2018,10,4,CHECK_CASHING,6244561.32,C97730845
2779,409000438611',2018-10-04,Indiaforensic RUPAY POS ACQ04101,0.0,2429243.92,13413941.960000016,2018,10,4,CHECK_CASHING,2429243.92,C1286084959
2780,409000438611',2018-10-04,Indiaforensic MASTER INT031018,0.0,513.55,13414455.510000015,2018,10,4,CASH_IN,513.55,C248609774
2781,409000438611',2018-10-04,Indiaforensic RUPAY POS C2 ACQ04,0.0,606308.94,14020764.450000014,2018,10,4,CASH_IN,606308.94,C1816757085
2782,409000438611',2018-10-04,TRF TO  Indiaforensic SERVICES I,13400000.0,0.0,620764.4500000143,2018,10,4,PAYEMENT,13400000.0,C306206744
2783,409000438611',2018-10-04,TRF TO  Indiaforensic SERVICES I,600000.0,0.0,20764.45000001416,2018,10,4,CHECK_WITHDRAWAL,600000.0,C33524623
2784,409000438611',2018-10-04,Indiaforensic VISA ACQ INT 29091,0.0,3026.73,23791.18000001416,2018,10,4,CHECK_CASHING,3026.73,C124540047
2785,409000438611',2018-10-04,Indiaforensic VISA ACQ INT 30091,0.0,328.15,24119.33000001416,2018,10,4,TRANSFER,328.15,C42158278
2786,409000438611',2018-10-04,Indiaforensic VISA ACQ INT 01101,0.0,209.22,24328.550000014162,2018,10,4,TRANSFER,209.22,C1997859171
2787,409000438611',2018-10-04,Indiaforensic VISA ACQ INT 02101,0.0,2036.35,26364.90000001416,2018,10,4,CASH_IN,2036.35,C451111351
2788,409000438611',2018-10-05,Indiaforensic MASTER ACQ DOM 051,0.0,4548892.59,4575257.490000014,2018,10,5,CASH_IN,4548892.59,C564160838
2789,409000438611',2018-10-05,Indiaforensic RUPAY POS ACQ05101,0.0,2088062.12,6663319.610000012,2018,10,5,TRANSFER,2088062.12,C459857341
2790,409000438611',2018-10-05,Indiaforensic VISA ACQ DOM051018,0.0,5949288.33,12612607.940000014,2018,10,5,CHECK_CASHING,5949288.33,C1782113663
2791,409000438611',2018-10-05,TRFTO  Indiaforensic SERVICES IN,3000000.0,0.0,9612607.940000014,2018,10,5,CASH_OUT,3000000.0,C1491676195
2792,409000438611',2018-10-05,TRF TO  Indiaforensic SERVICES I,3000000.0,0.0,6612607.9400000125,2018,10,5,DEBIT,3000000.0,C1789550256
2793,409000438611',2018-10-05,Indiaforensic RUPAY POS C2 ACQ05,0.0,771744.96,7384352.9000000125,2018,10,5,CASH_IN,771744.96,C357863579
2794,409000438611',2018-10-05,TRF TO  Indiaforensic SERVICES I,6600000.0,0.0,784352.9000000143,2018,10,5,CHECK_WITHDRAWAL,6600000.0,C793315160
2795,409000438611',2018-10-05,Indiaforensic MASTER INT041018,0.0,4099.21,788452.1100000144,2018,10,5,TRANSFER,4099.21,C657736958
2796,409000438611',2018-10-05,Indiaforensic VISA ACQ INT 03101,0.0,1017.97,789470.0800000144,2018,10,5,TRANSFER,1017.97,C481402298
2797,409000438611',2018-10-05,TRF TO  Indiaforensic SERVICES I,700000.0,0.0,89470.08000001428,2018,10,5,DEBIT,700000.0,M1857126088
2798,409000438611',2018-10-06,Indiaforensic VISA ACQ DOM061018,0.0,5667933.35,5757403.430000014,2018,10,6,CHECK_CASHING,5667933.35,C63387985
2799,409000438611',2018-10-06,Indiaforensic RUPAY POS ACQ06101,0.0,2117607.1,7875010.530000012,2018,10,6,CASH_IN,2117607.1,M262878641
2800,409000438611',2018-10-06,TRF TO  Indiaforensic SERVICES I,4000000.0,0.0,3875010.5300000138,2018,10,6,PAYEMENT,4000000.0,C481402298
2801,409000438611',2018-10-06,Indiaforensic RUPAY POS C2 ACQ06,0.0,648714.71,4523725.240000014,2018,10,6,CHECK_CASHING,648714.71,C905650857
2802,409000438611',2018-10-06,TRFV TO  Indiaforensic SERVICES,3000000.0,0.0,1523725.240000014,2018,10,6,CASH_OUT,3000000.0,C811597470
2803,409000438611',2018-10-06,TRF TO  Indiaforensic SERVICES I,500000.0,0.0,1023725.2400000142,2018,10,6,DEBIT,500000.0,C1353512285
2804,409000438611',2018-10-06,TRF TO  Indiaforensic SERVICES I,1000000.0,0.0,23725.240000014193,2018,10,6,CHECK_WITHDRAWAL,1000000.0,M1613912455
2805,409000438611',2018-10-08,Indiaforensic RUPAY POS ACQ07101,0.0,2106907.54,2130632.780000014,2018,10,8,TRANSFER,2106907.54,C1041638599
2806,409000438611',2018-10-08,TRF TO  Indiaforensic SERVICES I,2000000.0,0.0,130632.78000001426,2018,10,8,CASH_OUT,2000000.0,M720803395
2807,409000438611',2018-10-08,Indiaforensic MASTER ACQ DOM0810,0.0,12243224.61,12373857.390000015,2018,10,8,TRANSFER,12243224.61,M1213367860
2808,409000438611',2018-10-08,Indiaforensic VISA ACQ DOM081018,0.0,9825517.55,22199374.940000013,2018,10,8,CASH_IN,9825517.55,C2063763486
2809,409000438611',2018-10-08,Indiaforensic RUPAY POS ACQ08101,0.0,2276266.93,24475641.87000001,2018,10,8,CHECK_CASHING,2276266.93,M1221759982
2810,409000438611',2018-10-08,Indiaforensic RUPAY POS C2 ACQ08,0.0,584292.66,25059934.53000001,2018,10,8,CASH_IN,584292.66,M576222471
2811,409000438611',2018-10-08,TRF TO  Indiaforensic SERVICES I,4000000.0,0.0,21059934.53000001,2018,10,8,DEBIT,4000000.0,C1262822392
2812,409000438611',2018-10-08,TRF TO  Indiaforensic SERVICES I,4000000.0,0.0,17059934.530000012,2018,10,8,PAYEMENT,4000000.0,M2047799833
2813,409000438611',2018-10-08,TRF TO  Indiaforensic SERVICES I,4000000.0,0.0,13059934.530000012,2018,10,8,CHECK_WITHDRAWAL,4000000.0,M2061316668
2814,409000438611',2018-10-08,TRF TO  Indiaforensic SERVICES I,5000000.0,0.0,8059934.530000012,2018,10,8,CHECK_WITHDRAWAL,5000000.0,M1197535593
2815,409000438611',2018-10-08,TRF TO  Indiaforensic SERVICES I,5000000.0,0.0,3059934.5300000124,2018,10,8,DEBIT,5000000.0,C1955948959
2816,409000438611',2018-10-08,Indiaforensic MASTER INT051018,0.0,3410.53,3063345.0600000117,2018,10,8,CASH_IN,3410.53,M1703040426
2817,409000438611',2018-10-08,TRF TO  Indiaforensic SERVICES I,3000000.0,0.0,63345.060000012156,2018,10,8,DEBIT,3000000.0,M1985363238
2818,409000438611',2018-10-09,Indiaforensic MASTER ACQ DOM0910,0.0,4466303.48,4529648.540000012,2018,10,9,TRANSFER,4466303.48,C1782113663
2819,409000438611',2018-10-09,Indiaforensic VISA ACQ DOM091018,0.0,5383168.21,9912816.750000013,2018,10,9,TRANSFER,5383168.21,M1351247295
2820,409000438611',2018-10-09,Indiaforensic RUPAY POS ACQ09101,0.0,2490161.94,12402978.69000001,2018,10,9,TRANSFER,2490161.94,M509104428
2821,409000438611',2018-10-09,Indiaforensic POS ACQ C2 SETTL09,0.0,625812.54,13028791.230000012,2018,10,9,CASH_IN,625812.54,M581383895
2822,409000438611',2018-10-09,TRF TO  Indiaforensic SERVICES I,5000000.0,0.0,8028791.230000013,2018,10,9,DEBIT,5000000.0,M2134195609
2823,409000438611',2018-10-09,TRF TO  Indiaforensic SERVICES I,4000000.0,0.0,4028791.230000012,2018,10,9,DEBIT,4000000.0,M1564688538
2824,409000438611',2018-10-09,TRF  Indiaforensic SERVICES INDI,2000000.0,0.0,2028791.2300000119,2018,10,9,CASH_OUT,2000000.0,C564160838
2825,409000438611',2018-10-09,TRF TO  Indiaforensic SERVICES I,2000000.0,0.0,28791.230000011627,2018,10,9,CASH_OUT,2000000.0,C2117043942
2826,409000438611',2018-10-10,Indiaforensic MASTER ACQ DOM1010,0.0,4879119.87,4907911.100000012,2018,10,10,CHECK_CASHING,4879119.87,C1401316767
2827,409000438611',2018-10-10,Indiaforensic VISA ACQ DOM101018,0.0,5974259.57,10882170.670000013,2018,10,10,CHECK_CASHING,5974259.57,M304718519
2828,409000438611',2018-10-10,Indiaforensic RUPAY POS ACQ10101,0.0,2239495.94,13121666.610000012,2018,10,10,CHECK_CASHING,2239495.94,M1372150180
2829,409000438611',2018-10-10,Indiaforensic RUPAY POS C2 ACQ10,0.0,681131.17,13802797.780000012,2018,10,10,CASH_IN,681131.17,M278986288
2830,409000438611',2018-10-10,TRF TO  Indiaforensic SERVICES I,3800000.0,0.0,10002797.780000012,2018,10,10,CHECK_WITHDRAWAL,3800000.0,C248609774
2831,409000438611',2018-10-10,Indiaforensic MASTER INT0910018,0.0,208.85,10003006.630000012,2018,10,10,TRANSFER,208.85,M837693403
2832,409000438611',2018-10-10,TRF TO  Indiaforensic SERVICES I,10000000.0,0.0,3006.6300000119954,2018,10,10,DEBIT,10000000.0,C1883840933
2833,409000438611',2018-10-11,MDR REIMBURSEMENT Q2-2018,0.0,335379.0,338385.630000012,2018,10,11,CHECK_CASHING,335379.0,M1187146208
2834,409000438611',2018-10-11,Indiaforensic MASTER INT0910018,0.0,3028.19,341413.820000012,2018,10,11,CASH_IN,3028.19,C13226198
2835,409000438611',2018-10-11,Indiaforensic MC BILL PARTIAL RE,335379.0,0.0,6034.820000012,2018,10,11,PAYEMENT,335379.0,M6267452
2836,409000438611',2018-10-12,Indiaforensic MASTER ACQ DOM1110,0.0,4966212.66,4972247.4800000135,2018,10,12,CHECK_CASHING,4966212.66,M1127434428
2837,409000438611',2018-10-12,Indiaforensic VISA ACQ DOM111018,0.0,5728242.35,10700489.830000013,2018,10,12,CASH_IN,5728242.35,M271502370
2838,409000438611',2018-10-12,Indiaforensic RUPAY POS ACQ11101,0.0,2594958.14,13295447.970000016,2018,10,12,CASH_IN,2594958.14,M651992021
2839,409000438611',2018-10-12,Indiaforensic RUPAY POS C2 ACQ11,0.0,759693.61,14055141.580000013,2018,10,12,CHECK_CASHING,759693.61,M1124360095
2840,409000438611',2018-10-12,Indiaforensic VISA ACQ INT 06101,0.0,916.36,14056057.940000013,2018,10,12,CHECK_CASHING,916.36,M1677976140
2841,409000438611',2018-10-12,Indiaforensic VISA ACQ INT 07101,0.0,7169.83,14063227.770000013,2018,10,12,TRANSFER,7169.83,M1320826684
2842,409000438611',2018-10-12,Indiaforensic VISA ACQ INT 08101,0.0,1722.15,14064949.920000013,2018,10,12,CHECK_CASHING,1722.15,M219192399
2843,409000438611',2018-10-12,Indiaforensic VISA ACQ INT 09101,0.0,4058.3,14069008.220000016,2018,10,12,TRANSFER,4058.3,M653553574
2844,409000438611',2018-10-12,TRF TO  Indiaforensic SERVICES I,4000000.0,0.0,10069008.220000014,2018,10,12,CHECK_WITHDRAWAL,4000000.0,M156855528
2845,409000438611',2018-10-12,TRF TO  Indiaforensic SERVICES I,10000000.0,0.0,69008.22000001371,2018,10,12,DEBIT,10000000.0,C13329486
2846,409000438611',2018-10-12,Indiaforensic MASTER INT1110018,0.0,9373.87,78382.0900000137,2018,10,12,TRANSFER,9373.87,M1673604690
2847,409000438611',2018-10-12,Indiaforensic MASTER ACQ DOM1210,0.0,5100396.1,5178778.190000013,2018,10,12,TRANSFER,5100396.1,M650410100
2848,409000438611',2018-10-12,Indiaforensic VISA ACQ DOM121018,0.0,5558289.64,10737067.830000013,2018,10,12,CHECK_CASHING,5558289.64,M675889995
2849,409000438611',2018-10-12,Indiaforensic VISA ACQ INT 10101,0.0,3460.75,10740528.580000013,2018,10,12,CHECK_CASHING,3460.75,M1706655559
2850,409000438611',2018-10-12,Indiaforensic RUPAY POS ACQ12101,0.0,2705507.78,13446036.360000012,2018,10,12,CASH_IN,2705507.78,C1711105800
2851,409000438611',2018-10-12,Indiaforensic RUPAY POS C2 ACQ12,0.0,788029.41,14234065.770000013,2018,10,12,CHECK_CASHING,788029.41,M2047770317
2852,409000438611',2018-10-12,TRF TO  Indiaforensic SERVICES I,10000000.0,0.0,4234065.7700000135,2018,10,12,PAYEMENT,10000000.0,M71209097
2853,409000438611',2018-10-12,TRF TO  Indiaforensic SERVICES I,4200000.0,0.0,34065.77000001259,2018,10,12,CHECK_WITHDRAWAL,4200000.0,C1183572822
2854,409000438611',2018-10-15,Indiaforensic MASTER ACQ DOM1510,0.0,14607747.66,14641813.430000013,2018,10,15,CHECK_CASHING,14607747.66,C990398217
2855,409000438611',2018-10-15,Indiaforensic VISA ACQ DOM131018,0.0,6805365.64,21447179.07000001,2018,10,15,TRANSFER,6805365.64,M174515584
2856,409000438611',2018-10-15,Indiaforensic VISA ACQ DOM151018,0.0,12028184.93,33475364.00000001,2018,10,15,CHECK_CASHING,12028184.93,M215690645
2857,409000438611',2018-10-15,Indiaforensic RUPAY POS ACQ15101,0.0,3152198.4,36627562.40000001,2018,10,15,CHECK_CASHING,3152198.4,C884457408
2858,409000438611',2018-10-15,Indiaforensic RUPAY POS C2 ACQ15,0.0,832521.26,37460083.66000001,2018,10,15,CASH_IN,832521.26,M1576499395
2859,409000438611',2018-10-15,Indiaforensic VISA ACQ INT 11101,0.0,3040.12,37463123.78000001,2018,10,15,TRANSFER,3040.12,M1906335777
2860,409000438611',2018-10-15,Indiaforensic RUPAY POS ACQ13101,0.0,2434867.93,39897991.71000001,2018,10,15,TRANSFER,2434867.93,M1859956068
2861,409000438611',2018-10-15,Indiaforensic RUPAY POS ACQ14101,0.0,3700385.18,43598376.89000001,2018,10,15,CHECK_CASHING,3700385.18,M1043584830
2862,409000438611',2018-10-15,TRF TO  Indiaforensic SERVICES I,15000000.0,0.0,28598376.89000001,2018,10,15,CHECK_WITHDRAWAL,15000000.0,M1648217898
2863,409000438611',2018-10-15,TRF TO  Indiaforensic SERVICES I,15000000.0,0.0,13598376.890000008,2018,10,15,DEBIT,15000000.0,M243596165
2864,409000438611',2018-10-15,TRF TO  Indiaforensic SERVICES I,10000000.0,0.0,3598376.890000008,2018,10,15,DEBIT,10000000.0,M1684802151
2865,409000438611',2018-10-15,Indiaforensic MASTER INT121018,0.0,887.97,3599264.8600000083,2018,10,15,CASH_IN,887.97,M292890110
2866,409000438611',2018-10-15,TRF TO  Indiaforensic SERVICES I,3600000.0,0.0,,2018,10,15,PAYEMENT,3600000.0,M1539477312
2867,409000438611',2018-10-16,Indiaforensic MASTER ACQ DOM1610,0.0,4626494.44,4625759.300000008,2018,10,16,TRANSFER,4626494.44,M2121573248
2868,409000438611',2018-10-16,Indiaforensic VISA ACQ DOM161018,0.0,6345468.65,10971227.950000007,2018,10,16,TRANSFER,6345468.65,M581364120
2869,409000438611',2018-10-16,Indiaforensic RUPAY POS ACQ16101,0.0,2431187.27,13402415.220000008,2018,10,16,TRANSFER,2431187.27,M240641494
2870,409000438611',2018-10-16,Indiaforensic VISA ACQ INT 12101,0.0,2138.17,13404553.390000008,2018,10,16,TRANSFER,2138.17,M2013613908
2871,409000438611',2018-10-16,TRF TO  Indiaforensic SERVICES I,10000000.0,0.0,3404553.390000008,2018,10,16,CHECK_WITHDRAWAL,10000000.0,M1040172900
2872,409000438611',2018-10-16,TRF TO  Indiaforensic SERVICES I,3400000.0,0.0,4553.390000008047,2018,10,16,CASH_OUT,3400000.0,M1444635117
2873,409000438611',2018-10-16,Indiaforensic RUPAY POS C2 ACQ16,0.0,1130242.14,1134795.530000008,2018,10,16,CHECK_CASHING,1130242.14,M650859015
2874,409000438611',2018-10-16,Indiaforensic MASTER INT1510018,0.0,7749.74,1142545.270000008,2018,10,16,TRANSFER,7749.74,C1529115495
2875,409000438611',2018-10-16,TRF TO  Indiaforensic SERVICES I,1100000.0,0.0,42545.270000007935,2018,10,16,CASH_OUT,1100000.0,M511357840
2876,409000438611',2018-10-17,Indiaforensic MASTER ACQ DOM1710,0.0,5123996.66,5166541.930000008,2018,10,17,TRANSFER,5123996.66,M2004305265
2877,409000438611',2018-10-17,Indiaforensic VISA ACQ DOM171018,0.0,5651220.62,10817762.550000008,2018,10,17,CHECK_CASHING,5651220.62,M1825984232
2878,409000438611',2018-10-17,Indiaforensic RUPAY POS ACQ17101,0.0,2776591.89,13594354.440000007,2018,10,17,CASH_IN,2776591.89,M790432700
2879,409000438611',2018-10-17,Indiaforensic RUPAY POS C2 ACQ17,0.0,885466.39,14479820.83000001,2018,10,17,CASH_IN,885466.39,M178192958
2880,409000438611',2018-10-17,Indiaforensic VISA ACQ INT 13101,0.0,3412.11,14483232.940000007,2018,10,17,CHECK_CASHING,3412.11,C323761934
2881,409000438611',2018-10-17,Indiaforensic VISA ACQ INT 14101,0.0,104929.64,14588162.58000001,2018,10,17,CHECK_CASHING,104929.64,M439078230
2882,409000438611',2018-10-17,Indiaforensic VISA ACQ INT 15101,0.0,4345.98,14592508.56000001,2018,10,17,TRANSFER,4345.98,M1507604180
2883,409000438611',2018-10-17,TRF TO  Indiaforensic SERVICES I,10000000.0,0.0,4592508.56000001,2018,10,17,DEBIT,10000000.0,M1450830187
2884,409000438611',2018-10-17,TRF TO  Indiaforensic SERVICES I,4500000.0,0.0,92508.56000000985,2018,10,17,CASH_OUT,4500000.0,M1002406942
2885,409000438611',2018-10-17,Indiaforensic MASTER INT161018,0.0,1004.61,93513.17000000985,2018,10,17,CASH_IN,1004.61,M1453650546
2886,409000438611',2018-10-18,Indiaforensic RUPAY POS ACQ18101,0.0,3046105.69,3139618.8600000087,2018,10,18,CASH_IN,3046105.69,C655381473
2887,409000438611',2018-10-18,Indiaforensic RUPAY POS C2 ACQ18,0.0,849069.63,3988688.4900000095,2018,10,18,CASH_IN,849069.63,M1296153103
2888,409000438611',2018-10-18,TRF TO  Indiaforensic SERVICES I,3000000.0,0.0,988688.4900000095,2018,10,18,CASH_OUT,3000000.0,C681979935
2889,409000438611',2018-10-18,TRF TO  Indiaforensic SERVICES I,900000.0,0.0,88688.49000000954,2018,10,18,CASH_OUT,900000.0,M1010434098
2890,409000438611',2018-10-19,Indiaforensic MASTER ACQ DOM1810,0.0,4906649.53,4995338.02000001,2018,10,19,CASH_IN,4906649.53,C925936450
2891,409000438611',2018-10-19,Indiaforensic VISA ACQ DOM181018,0.0,6311491.94,11306829.96000001,2018,10,19,CASH_IN,6311491.94,M632115057
2892,409000438611',2018-10-19,Indiaforensic MASTER ACQ DOM1910,0.0,4725521.98,16032351.94000001,2018,10,19,CHECK_CASHING,4725521.98,C1668376627
2893,409000438611',2018-10-19,Indiaforensic VISA ACQ DOM191018,0.0,5205840.45,21238192.39000001,2018,10,19,TRANSFER,5205840.45,C1234250905
2894,409000438611',2018-10-19,Indiaforensic RUPAY POS ACQ19101,0.0,2529003.04,23767195.43000001,2018,10,19,TRANSFER,2529003.04,C667346055
2895,409000438611',2018-10-19,Indiaforensic RUPAY POS C2 ACQ19,0.0,690283.81,24457479.24000001,2018,10,19,CHECK_CASHING,690283.81,C481402298
2896,409000438611',2018-10-19,Indiaforensic VISA ACQ INT 16101,0.0,509.09,24457988.33000001,2018,10,19,TRANSFER,509.09,C985934102
2897,409000438611',2018-10-19,Indiaforensic MASTER INT171018,0.0,1819.26,24459807.59000001,2018,10,19,TRANSFER,1819.26,C1249547869
2898,409000438611',2018-10-19,TFR TO 1196428  Indiaforensic SE,5000000.0,0.0,19459807.59000001,2018,10,19,CASH_OUT,5000000.0,C13329486
2899,409000438611',2018-10-19,TFR TO 1196428  Indiaforensic SE,5000000.0,0.0,14459807.590000013,2018,10,19,CASH_OUT,5000000.0,C1671179293
2900,409000438611',2018-10-19,TFR TO 1196428  Indiaforensic SE,5000000.0,0.0,9459807.590000013,2018,10,19,CASH_OUT,5000000.0,C1721246982
2901,409000438611',2018-10-19,TFR TO 1196428  Indiaforensic SE,5000000.0,0.0,4459807.590000011,2018,10,19,DEBIT,5000000.0,C1538745405
2902,409000438611',2018-10-19,TFR TO 1196428  Indiaforensic SE,2000000.0,0.0,2459807.590000011,2018,10,19,CASH_OUT,2000000.0,C1163619825
2903,409000438611',2018-10-19,TFR TO 1196428  Indiaforensic SE,2000000.0,0.0,459807.590000011,2018,10,19,PAYEMENT,2000000.0,C1234776885
2904,409000438611',2018-10-19,Indiaforensic MASTER INT181018,0.0,1007.49,460815.080000011,2018,10,19,CASH_IN,1007.49,C1067936865
2905,409000438611',2018-10-20,Indiaforensic VISA ACQ DOM201018,0.0,4454020.13,4914835.210000011,2018,10,20,TRANSFER,4454020.13,C1360767589
2906,409000438611',2018-10-20,Indiaforensic RUPAY POS ACQ20101,0.0,2195898.18,7110733.390000013,2018,10,20,CHECK_CASHING,2195898.18,C1401316767
2907,409000438611',2018-10-20,TRF TO  Indiaforensic SERVICES I,1000000.0,0.0,6110733.390000013,2018,10,20,DEBIT,1000000.0,C451111351
2908,409000438611',2018-10-20,TRF TO  Indiaforensic SERVICES I,3000000.0,0.0,3110733.390000012,2018,10,20,CASH_OUT,3000000.0,C968113504
2909,409000438611',2018-10-20,TRF TO  Indiaforensic SERVICES I,3000000.0,0.0,110733.39000001176,2018,10,20,CHECK_WITHDRAWAL,3000000.0,C932583850
2910,409000438611',2018-10-20,Indiaforensic RUPAY POS C2 ACQ20,0.0,616358.29,727091.6800000119,2018,10,20,CHECK_CASHING,616358.29,C33524623
2911,409000438611',2018-10-22,Indiaforensic MASTER INT191018,0.0,502.8,727594.4800000119,2018,10,22,CASH_IN,502.8,C1916720513
2912,409000438611',2018-10-22,Indiaforensic RUPAY POS ACQ21101,0.0,2478198.85,3205793.3300000117,2018,10,22,TRANSFER,2478198.85,C2007149130
2913,409000438611',2018-10-22,Indiaforensic MASTER ACQ DOM2210,0.0,12664093.19,15869886.52000001,2018,10,22,CASH_IN,12664093.19,C1286084959
2914,409000438611',2018-10-22,Indiaforensic VISA ACQ DOM221018,0.0,10567320.54,26437207.06000001,2018,10,22,TRANSFER,10567320.54,C1816757085
2915,409000438611',2018-10-22,Indiaforensic RUPAY POS ACQ22101,0.0,2795619.44,29232826.50000001,2018,10,22,CASH_IN,2795619.44,C1577213552
2916,409000438611',2018-10-22,Indiaforensic RUPAY POS C2 ACQ22,0.0,884282.35,30117108.85000001,2018,10,22,TRANSFER,884282.35,C35534346
2917,409000438611',2018-10-22,Indiaforensic VISA ACQ INT 17101,0.0,2634.78,30119743.63000001,2018,10,22,CHECK_CASHING,2634.78,C836514715
2918,409000438611',2018-10-22,Indiaforensic VISA ACQ INT 18101,0.0,14012.55,30133756.18000001,2018,10,22,CASH_IN,14012.55,C195600860
2919,409000438611',2018-10-22,TRF TO  Indiaforensic SERVICES I,15000000.0,0.0,15133756.180000015,2018,10,22,CASH_OUT,15000000.0,C977993101
2920,409000438611',2018-10-22,TRF TO  Indiaforensic SERVICES I,15000000.0,0.0,133756.1800000146,2018,10,22,CHECK_WITHDRAWAL,15000000.0,C977993101
2921,409000438611',2018-10-23,Indiaforensic MASTER ACQ DOM2310,0.0,3974847.74,4108603.920000015,2018,10,23,CASH_IN,3974847.74,C1883840933
2922,409000438611',2018-10-23,Indiaforensic VISA ACQ DOM231018,0.0,6270696.8,10379300.720000014,2018,10,23,TRANSFER,6270696.8,C657736958
2923,409000438611',2018-10-23,Indiaforensic RUPAY POS ACQ23101,0.0,2553401.49,12932702.210000016,2018,10,23,CHECK_CASHING,2553401.49,C1122118227
2924,409000438611',2018-10-23,Indiaforensic RUPAY POS C2 ACQ23,0.0,807380.7,13740082.910000013,2018,10,23,CHECK_CASHING,807380.7,C977993101
2925,409000438611',2018-10-23,TRF TO  Indiaforensic SERVICES I,5000000.0,0.0,8740082.910000013,2018,10,23,CASH_OUT,5000000.0,C2140846441
2926,409000438611',2018-10-23,TRF TO  Indiaforensic SERVICES I,5000000.0,0.0,3740082.910000013,2018,10,23,CASH_OUT,5000000.0,C885951223
2927,409000438611',2018-10-23,Indiaforensic MASTER INT221018,0.0,5854.91,3745937.8200000124,2018,10,23,CHECK_CASHING,5854.91,C1590550415
2928,409000438611',2018-10-23,TRF TO  Indiaforensic SERVICES I,3700000.0,0.0,45937.82000001334,2018,10,23,PAYEMENT,3700000.0,C564160838
2929,409000438611',2018-10-24,Indiaforensic MASTER ACQ DOM2410,0.0,4191533.88,4237471.700000013,2018,10,24,TRANSFER,4191533.88,C392292416
2930,409000438611',2018-10-24,Indiaforensic VISA ACQ DOM241018,0.0,6545888.72,10783360.420000013,2018,10,24,CHECK_CASHING,6545888.72,C11003494
2931,409000438611',2018-10-24,Indiaforensic RUPAY POS ACQ24101,0.0,2830036.69,13613397.110000012,2018,10,24,CHECK_CASHING,2830036.69,C998351292
2932,409000438611',2018-10-24,Indiaforensic RUPAY POS C2 ACQ24,0.0,864088.07,14477485.180000013,2018,10,24,CHECK_CASHING,864088.07,C990398217
2933,409000438611',2018-10-24,Indiaforensic VISA ACQ INT 20101,0.0,509.09,14477994.270000013,2018,10,24,CHECK_CASHING,509.09,C1060830840
2934,409000438611',2018-10-24,Indiaforensic VISA ACQ INT 21101,0.0,3219.02,14481213.290000012,2018,10,24,CHECK_CASHING,3219.02,C1789550256
2935,409000438611',2018-10-24,Indiaforensic VISA ACQ INT 22101,0.0,2638.82,14483852.110000012,2018,10,24,CASH_IN,2638.82,C1839337592
2936,409000438611',2018-10-24,TRF TO  Indiaforensic SERVICES I,14400000.0,0.0,83852.11000001244,2018,10,24,DEBIT,14400000.0,C1529115495
2937,409000438611',2018-10-25,Indiaforensic MASTER ACQ DOM2510,0.0,4614937.75,4698789.8600000115,2018,10,25,CASH_IN,4614937.75,C977993101
2938,409000438611',2018-10-25,Indiaforensic VISA ACQ DOM251018,0.0,5710056.99,10408846.850000013,2018,10,25,CHECK_CASHING,5710056.99,C1234250905
2939,409000438611',2018-10-25,Indiaforensic RUPAY POS ACQ25101,0.0,2295581.71,12704428.560000015,2018,10,25,TRANSFER,2295581.71,C1459035867
2940,409000438611',2018-10-25,Indiaforensic RUPAY POS C2 ACQ25,0.0,720324.88,13424753.440000014,2018,10,25,CASH_IN,720324.88,C24119573
2941,409000438611',2018-10-25,TRF TO  Indiaforensic SERVICES I,4000000.0,0.0,9424753.440000014,2018,10,25,PAYEMENT,4000000.0,C22805895
2942,409000438611',2018-10-25,TRF TO  Indiaforensic SERVICES I,4000000.0,0.0,5424753.440000013,2018,10,25,PAYEMENT,4000000.0,C2117043942
2943,409000438611',2018-10-25,TRF TO  Indiaforensic SERVICES I,3000000.0,0.0,2424753.4400000144,2018,10,25,CASH_OUT,3000000.0,C63387985
2944,409000438611',2018-10-25,TRF TO  Indiaforensic SERVICES I,2000000.0,0.0,424753.4400000144,2018,10,25,DEBIT,2000000.0,C1347294617
2945,409000438611',2018-10-25,Indiaforensic MASTER INT241018,0.0,2233.37,426986.8100000144,2018,10,25,TRANSFER,2233.37,C716083600
2946,409000438611',2018-10-25,TRF TO  Indiaforensic SERVICES I,400000.0,0.0,26986.81000001437,2018,10,25,DEBIT,400000.0,C985934102
2947,409000438611',2018-10-26,Indiaforensic MASTER ACQ DOM2610,0.0,5218682.49,5245669.300000015,2018,10,26,TRANSFER,5218682.49,C1286084959
2948,409000438611',2018-10-26,Indiaforensic VISA ACQ DOM261018,0.0,7045712.77,12291382.070000015,2018,10,26,CASH_IN,7045712.77,C1590550415
2949,409000438611',2018-10-26,Indiaforensic RUPAY POS ACQ26101,0.0,2692052.23,14983434.300000016,2018,10,26,CHECK_CASHING,2692052.23,C716083600
2950,409000438611',2018-10-26,Indiaforensic RUPAY POS C2 ACQ26,0.0,709683.72,15693118.020000014,2018,10,26,TRANSFER,709683.72,C1122118227
2951,409000438611',2018-10-26,Indiaforensic VISA ACQ INT 24101,0.0,1628.07,15694746.090000015,2018,10,26,TRANSFER,1628.07,C1068824137
2952,409000438611',2018-10-26,TRF TO  Indiaforensic SERVICES I,15000000.0,0.0,694746.0900000166,2018,10,26,PAYEMENT,15000000.0,C564160838
2953,409000438611',2018-10-26,TRF TO  Indiaforensic SERVICES I,700000.0,0.0,,2018,10,26,PAYEMENT,700000.0,C1778801068
2954,409000438611',2018-10-29,Indiaforensic VISA ACQ DOM271018,0.0,6115541.06,6110287.150000016,2018,10,29,CHECK_CASHING,6115541.06,C977993101
2955,409000438611',2018-10-29,Indiaforensic RUPAY POS ACQ27101,0.0,2489916.33,8600203.480000015,2018,10,29,TRANSFER,2489916.33,C998351292
2956,409000438611',2018-10-29,Indiaforensic RUPAY POS ACQ28101,0.0,2866433.54,11466637.020000014,2018,10,29,TRANSFER,2866433.54,C1401316767
2957,409000438611',2018-10-29,Indiaforensic MASTER ACQ DOM2910,0.0,12939624.3,24406261.32000001,2018,10,29,TRANSFER,12939624.3,C11003494
2958,409000438611',2018-10-29,Indiaforensic VISA ACQ DOM291018,0.0,11271551.45,35677812.77000001,2018,10,29,CASH_IN,11271551.45,M1503546689
2959,409000438611',2018-10-29,Indiaforensic RUPAY POS ACQ29101,0.0,2714946.91,38392759.68000001,2018,10,29,CASH_IN,2714946.91,M17792118
2960,409000438611',2018-10-29,Indiaforensic RUPAY POS C2 ACQ29,0.0,808434.95,39201194.63000001,2018,10,29,TRANSFER,808434.95,C1761291320
2961,409000438611',2018-10-29,Indiaforensic VISA ACQ INT 25101,0.0,5231.66,39206426.29000001,2018,10,29,TRANSFER,5231.66,C1538745405
2962,409000438611',2018-10-29,TRF TO  Indiaforensic SERVICES I,500000.0,0.0,38706426.29000001,2018,10,29,PAYEMENT,500000.0,M264767425
2963,409000438611',2018-10-29,TRF TO  Indiaforensic SERVICES I,1000000.0,0.0,37706426.29000001,2018,10,29,DEBIT,1000000.0,C270095066
2964,409000438611',2018-10-29,TRF TO  Indiaforensic SERVICES I,1000000.0,0.0,36706426.29000001,2018,10,29,PAYEMENT,1000000.0,M1574503358
2965,409000438611',2018-10-29,TRF TO  Indiaforensic SERVICES I,15000000.0,0.0,21706426.290000007,2018,10,29,PAYEMENT,15000000.0,C1504109395
2966,409000438611',2018-10-29,TRF TO  Indiaforensic SERVICES I,15000000.0,0.0,6706426.2900000075,2018,10,29,CHECK_WITHDRAWAL,15000000.0,M2120493960
2967,409000438611',2018-10-29,TRF TO  Indiaforensic SERVICES I,2000000.0,0.0,4706426.290000007,2018,10,29,DEBIT,2000000.0,C1721246982
2968,409000438611',2018-10-29,TRF TO  Indiaforensic SERVICES I,4000000.0,0.0,706426.2900000066,2018,10,29,CHECK_WITHDRAWAL,4000000.0,M92862012
2969,409000438611',2018-10-30,TRF TO  Indiaforensic SERVICES I,500000.0,0.0,206426.29000000656,2018,10,30,CASH_OUT,500000.0,M427939937
2970,409000438611',2018-10-30,Indiaforensic MASTER ACQ DOM3010,0.0,4000006.36,4206432.650000006,2018,10,30,TRANSFER,4000006.36,M1408549350
2971,409000438611',2018-10-30,Indiaforensic VISA ACQ DOM301018,0.0,5702269.15,9908701.800000006,2018,10,30,TRANSFER,5702269.15,M1665324560
2972,409000438611',2018-10-30,Indiaforensic RUPAY POS ACQ30101,0.0,2212981.27,12121683.070000006,2018,10,30,TRANSFER,2212981.27,M2018164030
2973,409000438611',2018-10-30,Indiaforensic RUPAY POS C2 ACQ30,0.0,768501.76,12890184.830000006,2018,10,30,TRANSFER,768501.76,M1128600792
2974,409000438611',2018-10-30,TRF TO  Indiaforensic SERVICES I,10000000.0,0.0,2890184.8300000057,2018,10,30,CASH_OUT,10000000.0,M1175662879
2975,409000438611',2018-10-30,Indiaforensic MASTER INT27-29101,0.0,10252.41,2900437.2400000063,2018,10,30,CASH_IN,10252.41,M248050873
2976,409000438611',2018-10-30,TRF TO  Indiaforensic SERVICES I,2800000.0,0.0,100437.2400000058,2018,10,30,PAYEMENT,2800000.0,C1219273867
2977,409000438611',2018-10-31,Indiaforensic VISA ACQ DOM311018,0.0,6193971.18,6294408.420000005,2018,10,31,CASH_IN,6193971.18,M937366737
2978,409000438611',2018-10-31,Indiaforensic RUPAY POS ACQ31101,0.0,2760485.22,9054893.640000006,2018,10,31,CASH_IN,2760485.22,M1998876751
2979,409000438611',2018-10-31,Indiaforensic VISA ACQ INT 27101,0.0,3509.0,9058402.640000006,2018,10,31,TRANSFER,3509.0,M1290358063
2980,409000438611',2018-10-31,Indiaforensic VISA ACQ INT 28101,0.0,229.25,9058631.890000006,2018,10,31,CASH_IN,229.25,M1020897892
2981,409000438611',2018-10-31,Indiaforensic VISA ACQ INT 29101,0.0,2599.67,9061231.560000006,2018,10,31,TRANSFER,2599.67,M1144979403
2982,409000438611',2018-10-31,Indiaforensic MASTER ACQ DOM3110,0.0,4238903.89,13300135.450000007,2018,10,31,TRANSFER,4238903.89,M85435056
2983,409000438611',2018-10-31,Indiaforensic RUPAY POS C2 ACQ31,0.0,803011.1,14103146.550000004,2018,10,31,CASH_IN,803011.1,M910691117
2984,409000438611',2018-10-31,TRF TO  Indiaforensic SERVICES I,13300000.0,0.0,803146.5500000062,2018,10,31,CASH_OUT,13300000.0,M526981115
2985,409000438611',2018-10-31,TRF TO  Indiaforensic SERVICES I,800000.0,0.0,3146.550000006333,2018,10,31,PAYEMENT,800000.0,M931987151
2986,409000438611',2018-11-01,Indiaforensic VISA ACQ DOM011118,0.0,6214061.08,6217207.630000006,2018,11,1,CHECK_CASHING,6214061.08,M1585189917
2987,409000438611',2018-11-01,Indiaforensic RUPAY POS ACQ01111,0.0,2545483.39,8762691.020000007,2018,11,1,CASH_IN,2545483.39,M319144230
2988,409000438611',2018-11-01,TRF TO  Indiaforensic SERVICES I,8700000.0,0.0,62691.020000007,2018,11,1,CHECK_WITHDRAWAL,8700000.0,M1276894402
2989,409000438611',2018-11-01,Indiaforensic MASTER ACQ DOM0111,0.0,4744407.86,4807098.880000007,2018,11,1,CHECK_CASHING,4744407.86,M1268237485
2990,409000438611',2018-11-01,Indiaforensic VISA ACQ INT 30101,0.0,5079.97,4812178.850000007,2018,11,1,TRANSFER,5079.97,M1680841335
2991,409000438611',2018-11-01,Indiaforensic RUPAY POS C2 ACQ01,0.0,790551.54,5602730.390000007,2018,11,1,CASH_IN,790551.54,M1446301940
2992,409000438611',2018-11-01,TRF TO  Indiaforensic SERVICES I,5600000.0,0.0,2730.3900000071153,2018,11,1,CHECK_WITHDRAWAL,5600000.0,M1028538462
2993,409000438611',2018-11-01,Indiaforensic MASTER INT311018,0.0,1019.55,3749.940000007116,2018,11,1,CHECK_CASHING,1019.55,M1888952688
2994,409000438611',2018-11-02,Indiaforensic MASTER ACQ DOM0211,0.0,5505148.23,5508898.170000006,2018,11,2,TRANSFER,5505148.23,M1310344955
2995,409000438611',2018-11-02,Indiaforensic VISA ACQ DOM021118,0.0,5798359.1,11307257.270000007,2018,11,2,TRANSFER,5798359.1,C1629687658
2996,409000438611',2018-11-02,Indiaforensic RUPAY POS ACQ02111,0.0,2793512.18,14100769.450000007,2018,11,2,TRANSFER,2793512.18,M1823438851
2997,409000438611',2018-11-02,Indiaforensic RUPAY POS C2 ACQ02,0.0,768530.11,14869299.560000004,2018,11,2,CHECK_CASHING,768530.11,M1771040410
2998,409000438611',2018-11-02,Indiaforensic VISA ACQ INT 31101,0.0,36711.34,14906010.900000004,2018,11,2,TRANSFER,36711.34,M131353113
2999,409000438611',2018-11-02,TRF TO  Indiaforensic SERVICES I,10000000.0,0.0,4906010.900000006,2018,11,2,CHECK_WITHDRAWAL,10000000.0,M387377349
3000,409000438611',2018-11-02,TRF TO  Indiaforensic SERVICES I,4900000.0,0.0,6010.9000000059605,2018,11,2,CASH_OUT,4900000.0,M1079167170
3001,409000438611',2018-11-02,Indiaforensic MASTER INT011118,0.0,1000.73,7011.630000005961,2018,11,2,TRANSFER,1000.73,M954928973
3002,409000438611',2018-11-03,Indiaforensic VISA ACQ DOM031118,0.0,7645892.11,7652903.740000008,2018,11,3,CHECK_CASHING,7645892.11,M364266169
3003,409000438611',2018-11-03,Indiaforensic RUPAY POS ACQ03111,0.0,3379685.55,11032589.290000008,2018,11,3,CASH_IN,3379685.55,M830083467
3004,409000438611',2018-11-03,TRF TO  Indiaforensic SERVICES I,10000000.0,0.0,1032589.2900000066,2018,11,3,DEBIT,10000000.0,M1901824111
3005,409000438611',2018-11-03,TRF TO  Indiaforensic SERVICES I,1000000.0,0.0,32589.290000006557,2018,11,3,CHECK_WITHDRAWAL,1000000.0,M505756829
3006,409000438611',2018-11-03,Indiaforensic RUPAY POS C2 ACQ03,0.0,883026.49,915615.7800000064,2018,11,3,CASH_IN,883026.49,C1018298342
3007,409000438611',2018-11-05,Indiaforensic RUPAY POS ACQ04111,0.0,2784015.69,3699631.4700000063,2018,11,5,CASH_IN,2784015.69,M1938047257
3008,409000438611',2018-11-05,Indiaforensic MASTER ACQ DOM0511,0.0,15546792.38,19246423.85000001,2018,11,5,CHECK_CASHING,15546792.38,M408543908
3009,409000438611',2018-11-05,Indiaforensic VISA ACQ DOM051118,0.0,15859883.17,35106307.02000001,2018,11,5,CHECK_CASHING,15859883.17,C1941598182
3010,409000438611',2018-11-05,Indiaforensic RUPAY POS ACQ05111,0.0,4346047.11,39452354.13000001,2018,11,5,CHECK_CASHING,4346047.11,C1850180796
3011,409000438611',2018-11-05,Indiaforensic RUPAY POS C2 ACQ05,0.0,809760.06,40262114.19000001,2018,11,5,TRANSFER,809760.06,C657736958
3012,409000438611',2018-11-05,Indiaforensic VISA ACQ INT 01111,0.0,2021.94,40264136.13000001,2018,11,5,CASH_IN,2021.94,C1870252780
3013,409000438611',2018-11-05,TRF TO  Indiaforensic SERVICES I,15000000.0,0.0,25264136.13000001,2018,11,5,PAYEMENT,15000000.0,C1134894336
3014,409000438611',2018-11-05,TRF TO  Indiaforensic SERVICES I,15000000.0,0.0,10264136.13000001,2018,11,5,CASH_OUT,15000000.0,C905650857
3015,409000438611',2018-11-05,TRF TO  Indiaforensic SERVICES I,10000000.0,0.0,264136.13000001013,2018,11,5,PAYEMENT,10000000.0,C11003494
3016,409000438611',2018-11-06,Indiaforensic VISA ACQ DOM061118,0.0,7725533.42,7989669.55000001,2018,11,6,CASH_IN,7725533.42,C793315160
3017,409000438611',2018-11-06,Indiaforensic RUPAY POS ACQ06111,0.0,6363067.59,14352737.14000001,2018,11,6,TRANSFER,6363067.59,C1122118227
3018,409000438611',2018-11-06,Indiaforensic VISA ACQ INT 02111,0.0,4706.14,14357443.28000001,2018,11,6,CASH_IN,4706.14,C801142660
3019,409000438611',2018-11-06,TRF TO  Indiaforensic SERVICES I,14300000.0,0.0,57443.280000010505,2018,11,6,PAYEMENT,14300000.0,C1504109395
3020,409000438611',2018-11-06,Indiaforensic MASTER ACQ DOM0611,0.0,6292989.98,6350433.260000011,2018,11,6,CHECK_CASHING,6292989.98,C1453128758
3021,409000438611',2018-11-06,Indiaforensic RUPAY POS C2 ACQ06,0.0,1111346.39,7461779.6500000125,2018,11,6,CASH_IN,1111346.39,M595556720
3022,409000438611',2018-11-06,TRF TO  Indiaforensic SERVICES I,2000000.0,0.0,5461779.650000012,2018,11,6,DEBIT,2000000.0,M2073333566
3023,409000438611',2018-11-06,TRF TO  Indiaforensic SERVICES I,5000000.0,0.0,461779.6500000106,2018,11,6,DEBIT,5000000.0,M2007004340
3024,409000438611',2018-11-07,Indiaforensic RUPAY POS ACQ07111,0.0,2893029.34,3354808.9900000105,2018,11,7,TRANSFER,2893029.34,M1812861879
3025,409000438611',2018-11-07,Indiaforensic RUPAY POS C2 ACQ07,0.0,883587.82,4238396.810000012,2018,11,7,CASH_IN,883587.82,M1444642131
3026,409000438611',2018-11-08,TRF TO  Indiaforensic SERVICES I,3000000.0,0.0,1238396.8100000108,2018,11,8,CHECK_WITHDRAWAL,3000000.0,M499339307
3027,409000438611',2018-11-08,TRF TO  Indiaforensic SERVICES I,1000000.0,0.0,238396.8100000108,2018,11,8,CHECK_WITHDRAWAL,1000000.0,M1742814160
3028,409000438611',2018-11-08,Indiaforensic RUPAY POS ACQ08111,0.0,2726849.05,2965245.8600000106,2018,11,8,TRANSFER,2726849.05,M46852536
3029,409000438611',2018-11-08,Indiaforensic RUPAYPOSACQC208111,0.0,800589.63,3765835.4900000105,2018,11,8,CASH_IN,800589.63,C1286084959
3030,409000438611',2018-11-08,TRF TO  Indiaforensic SERVICES I,3000000.0,0.0,765835.4900000105,2018,11,8,DEBIT,3000000.0,M402264886
3031,409000438611',2018-11-09,Indiaforensic VISA ACQ DOM071118,0.0,7158935.89,7924771.38000001,2018,11,9,CHECK_CASHING,7158935.89,M1756988236
3032,409000438611',2018-11-09,Indiaforensic VISA ACQ DOM081118,0.0,6050299.48,13975070.86000001,2018,11,9,CASH_IN,6050299.48,M1729958231
3033,409000438611',2018-11-09,TRF TO  Indiaforensic SERVICES I,3000000.0,0.0,10975070.86000001,2018,11,9,DEBIT,3000000.0,C2094777811
3034,409000438611',2018-11-09,TRF TO  Indiaforensic SERVICES I,10000000.0,0.0,975070.8600000106,2018,11,9,PAYEMENT,10000000.0,M708222484
3035,409000438611',2018-11-09,Indiaforensic MASTER ACQ DOM07-0,0.0,14539365.82,15514436.68000001,2018,11,9,CHECK_CASHING,14539365.82,C885951223
3036,409000438611',2018-11-09,Indiaforensic VISA ACQ DOM091118,0.0,5522417.64,21036854.32000001,2018,11,9,CHECK_CASHING,5522417.64,C1899073220
3037,409000438611',2018-11-09,Indiaforensic RUPAY POS ACQ09111,0.0,2714751.86,23751606.18000001,2018,11,9,CASH_IN,2714751.86,C991505714
3038,409000438611',2018-11-09,TRF TO Indiaforensic SERVICES IN,15000000.0,0.0,8751606.18000001,2018,11,9,PAYEMENT,15000000.0,C1471633238
3039,409000438611',2018-11-09,TRF TO Indiaforensic SERVICES IN,5000000.0,0.0,3751606.1800000113,2018,11,9,CASH_OUT,5000000.0,M1334391583
3040,409000438611',2018-11-09,TRF TO Indiaforensic SERVICES IN,1000000.0,0.0,2751606.180000011,2018,11,9,PAYEMENT,1000000.0,M376601584
3041,409000438611',2018-11-09,TRF TO  Indiaforensic SERVICES I,2000000.0,0.0,751606.180000011,2018,11,9,DEBIT,2000000.0,M689140691
3042,409000438611',2018-11-09,TRF TO  Indiaforensic SERVICES I,500000.0,0.0,251606.1800000109,2018,11,9,CASH_OUT,500000.0,M839180856
3043,409000438611',2018-11-09,Indiaforensic RUPAY POS C2 ACQ09,0.0,834435.72,1086041.9000000108,2018,11,9,CASH_IN,834435.72,M173175486
3044,409000438611',2018-11-09,Indiaforensic VISA ACQ INT 04111,0.0,6357.44,1092399.3400000108,2018,11,9,CASH_IN,6357.44,M1304065853
3045,409000438611',2018-11-09,Indiaforensic VISA ACQ INT 05111,0.0,1010.97,1093410.3100000108,2018,11,9,CHECK_CASHING,1010.97,M80052821
3046,409000438611',2018-11-09,Indiaforensic VISA ACQ INT 06111,0.0,2036.35,1095446.6600000109,2018,11,9,TRANSFER,2036.35,M280078161
3047,409000438611',2018-11-09,Indiaforensic VISA ACQ INT 07111,0.0,110.57,1095557.230000011,2018,11,9,TRANSFER,110.57,M2066770847
3048,409000438611',2018-11-09,ICA 17825 Indiaforensic INT05111,0.0,79707.87,1175265.1000000108,2018,11,9,CHECK_CASHING,79707.87,M154449199
3049,409000438611',2018-11-09,ICA 17825 Indiaforensic INT06111,0.0,5122.95,1180388.0500000108,2018,11,9,TRANSFER,5122.95,M1587818510
3050,409000438611',2018-11-09,ICA 17825 Indiaforensic INT07111,0.0,15729.12,1196117.1700000109,2018,11,9,CASH_IN,15729.12,M1991075605
3051,409000438611',2018-11-09,ICA 17825 Indiaforensic INT08111,0.0,1019.8,1197136.970000011,2018,11,9,TRANSFER,1019.8,M691540605
3052,409000438611',2018-11-12,Indiaforensic VISA ACQ DOM101118,0.0,6352472.57,7549609.540000011,2018,11,12,CASH_IN,6352472.57,M267533031
3053,409000438611',2018-11-12,Indiaforensic RUPAY POS ACQ10111,0.0,2762517.91,10312127.45000001,2018,11,12,CASH_IN,2762517.91,M729375394
3054,409000438611',2018-11-12,Indiaforensic RUPAY POS ACQ11111,0.0,4223595.48,14535722.93000001,2018,11,12,CHECK_CASHING,4223595.48,M1961510626
3055,409000438611',2018-11-12,Indiaforensic MASTER ACQ DOM10-1,0.0,15264703.21,29800426.14000001,2018,11,12,CASH_IN,15264703.21,M253558788
3056,409000438611',2018-11-12,Indiaforensic VISA ACQ DOM121118,0.0,12901419.9,42701846.040000014,2018,11,12,TRANSFER,12901419.9,M1219797059
3057,409000438611',2018-11-12,Indiaforensic RUPAY POS ACQ12111,0.0,3736785.65,46438631.69000001,2018,11,12,TRANSFER,3736785.65,M1210165919
3058,409000438611',2018-11-12,Indiaforensic RUPAY POS C2 ACQ12,0.0,968967.68,47407599.37000001,2018,11,12,TRANSFER,968967.68,M840109665
3059,409000438611',2018-11-12,Indiaforensic VISA ACQ INT 08111,0.0,14207.86,47421807.23000001,2018,11,12,CHECK_CASHING,14207.86,C2063275841
3060,409000438611',2018-11-12,TRF TO  Indiaforensic SERVICES I,15000000.0,0.0,32421807.23000001,2018,11,12,CHECK_WITHDRAWAL,15000000.0,C644345897
3061,409000438611',2018-11-12,TRF TO  Indiaforensic SERVICES I,15000000.0,0.0,17421807.23000001,2018,11,12,DEBIT,15000000.0,M828312047
3062,409000438611',2018-11-12,TRF TO  Indiaforensic SERVICES I,10000000.0,0.0,7421807.230000013,2018,11,12,CASH_OUT,10000000.0,M1976870927
3063,409000438611',2018-11-12,ICA 17825 Indiaforensic INT09111,0.0,10248.16,7432055.390000013,2018,11,12,TRANSFER,10248.16,M214929887
3064,409000438611',2018-11-12,TRF TO  Indiaforensic SERVICES I,5000000.0,0.0,2432055.390000012,2018,11,12,CASH_OUT,5000000.0,M1372817363
3065,409000438611',2018-11-12,TRF TO  Indiaforensic SERVICES I,2000000.0,0.0,432055.3900000118,2018,11,12,CASH_OUT,2000000.0,C662045021
3066,409000438611',2018-11-13,Indiaforensic VISA ACQ DOM131118,0.0,7238266.06,7670321.450000011,2018,11,13,TRANSFER,7238266.06,M1827710791
3067,409000438611',2018-11-13,Indiaforensic RUPAY POS ACQ13111,0.0,2984430.53,10654751.980000012,2018,11,13,CASH_IN,2984430.53,C977993101
3068,409000438611',2018-11-13,Indiaforensic VISA ACQ INT 09111,0.0,16290.81,10671042.790000012,2018,11,13,CASH_IN,16290.81,C1973538135
3069,409000438611',2018-11-13,ICA 17825 Indiaforensic MC DOM 1,0.0,5311712.6,15982755.390000012,2018,11,13,CASH_IN,5311712.6,M836614448
3070,409000438611',2018-11-13,TRF TO  Indiaforensic SERVICES I,10600000.0,0.0,5382755.390000012,2018,11,13,PAYEMENT,10600000.0,M1010584177
3071,409000438611',2018-11-13,TRF TO  Indiaforensic SERVICES I,5300000.0,0.0,82755.39000001177,2018,11,13,DEBIT,5300000.0,C566698125
3072,409000438611',2018-11-13,Indiaforensic RUPAY POS C2 ACQ13,0.0,935708.81,1018464.2000000118,2018,11,13,CHECK_CASHING,935708.81,C2081595126
3073,409000438611',2018-11-13,TRF TO  Indiaforensic SERVICES I,1000000.0,0.0,18464.200000011828,2018,11,13,CHECK_WITHDRAWAL,1000000.0,C1023714065
3074,409000438611',2018-11-14,Indiaforensic VISA ACQ DOM141118,0.0,5951423.18,5969887.380000013,2018,11,14,TRANSFER,5951423.18,C401424608
3075,409000438611',2018-11-14,Indiaforensic RUPAY POS ACQ14111,0.0,2805849.78,8775737.160000011,2018,11,14,CASH_IN,2805849.78,C1916720513
3076,409000438611',2018-11-14,ICA 17825 Indiaforensic MC DOM 1,0.0,4063196.06,12838933.220000012,2018,11,14,CHECK_CASHING,4063196.06,C1122118227
3077,409000438611',2018-11-14,TRF TO  Indiaforensic SERVICES I,8700000.0,0.0,4138933.220000012,2018,11,14,CASH_OUT,8700000.0,C459857341
3078,409000438611',2018-11-14,TRF TO  Indiaforensic SERVICES I,4100000.0,0.0,38933.220000011854,2018,11,14,PAYEMENT,4100000.0,C985934102
3079,409000438611',2018-11-14,ICA 17825 Indiaforensic MC INT10,0.0,21692.29,60625.51000001185,2018,11,14,CHECK_CASHING,21692.29,C248609774
3080,409000438611',2018-11-14,Indiaforensic RUPAY POS C2 ACQ14,0.0,877441.89,938067.400000012,2018,11,14,CASH_IN,877441.89,C2063763486
3081,409000438611',2018-11-14,Indiaforensic VISA ACQ INT 10111,0.0,2451.66,940519.060000012,2018,11,14,TRANSFER,2451.66,C998351292
3082,409000438611',2018-11-14,Indiaforensic VISA ACQ INT 11111,0.0,3228.51,943747.570000012,2018,11,14,CHECK_CASHING,3228.51,C1122118227
3083,409000438611',2018-11-14,Indiaforensic VISA ACQ INT 12111,0.0,5701.38,949448.9500000121,2018,11,14,CHECK_CASHING,5701.38,C1721246982
3084,409000438611',2018-11-15,TRF TO  Indiaforensic SERVICES I,500000.0,0.0,449448.950000012,2018,11,15,DEBIT,500000.0,C1504109395
3085,409000438611',2018-11-15,Indiaforensic VISA ACQ DOM151118,0.0,5186503.19,5635952.140000013,2018,11,15,CASH_IN,5186503.19,C998351292
3086,409000438611',2018-11-15,Indiaforensic RUPAY POS ACQ15111,0.0,2695708.37,8331660.510000013,2018,11,15,CASH_IN,2695708.37,C998351292
3087,409000438611',2018-11-15,ICA 17825 Indiaforensic MC DOM 1,0.0,5143647.04,13475307.550000012,2018,11,15,TRANSFER,5143647.04,M983834017
3088,409000438611',2018-11-15,TRF TO  Indiaforensic SERVICES I,8300000.0,0.0,5175307.550000012,2018,11,15,DEBIT,8300000.0,M1015236238
3089,409000438611',2018-11-15,Indiaforensic RUPAY POS C2 ACQ15,0.0,785816.5,5961124.050000013,2018,11,15,TRANSFER,785816.5,M1031780408
3090,409000438611',2018-11-15,Indiaforensic VISA ACQ INT 13111,0.0,13386.28,5974510.330000012,2018,11,15,CHECK_CASHING,13386.28,M976725249
3091,409000438611',2018-11-15,TRF TO  Indiaforensic SERVICES I,5100000.0,0.0,874510.3300000122,2018,11,15,CASH_OUT,5100000.0,M975629453
3092,409000438611',2018-11-15,TRF TO  Indiaforensic SERVICES I,800000.0,0.0,74510.33000001218,2018,11,15,PAYEMENT,800000.0,M269257589
3093,409000438611',2018-11-16,Indiaforensic VISA ACQ DOM161118,0.0,6603560.59,6678070.920000013,2018,11,16,CHECK_CASHING,6603560.59,M646757254
3094,409000438611',2018-11-16,Indiaforensic RUPAY POS ACQ16111,0.0,1540910.37,8218981.290000012,2018,11,16,CASH_IN,1540910.37,C1899073220
3095,409000438611',2018-11-16,ICA 17825 Indiaforensic MC DOM 1,0.0,5120387.97,13339369.260000013,2018,11,16,CHECK_CASHING,5120387.97,C1234250905
3096,409000438611',2018-11-16,ICA 17825 Indiaforensic MC INT15,0.0,3545.59,13342914.850000013,2018,11,16,TRANSFER,3545.59,C1100767002
3097,409000438611',2018-11-16,TRF TO  Indiaforensic SERVICES I,13300000.0,0.0,42914.850000012666,2018,11,16,CASH_OUT,13300000.0,M1000631907
3098,409000438611',2018-11-16,Indiaforensic RUPAY POS C2 ACQ16,0.0,2268346.44,2311261.2900000126,2018,11,16,CASH_IN,2268346.44,M767764251
3099,409000438611',2018-11-16,Indiaforensic VISA ACQ INT 14111,0.0,5056.2,2316317.4900000133,2018,11,16,CHECK_CASHING,5056.2,M1023423954
3100,409000438611',2018-11-16,TRF TO  Indiaforensic SERVICES I,2300000.0,0.0,16317.490000012795,2018,11,16,DEBIT,2300000.0,C77811359
3101,409000438611',2018-11-17,Indiaforensic VISA ACQ DOM171118,0.0,5276439.1,5292756.590000013,2018,11,17,CASH_IN,5276439.1,M1184974266
3102,409000438611',2018-11-17,Indiaforensic RUPAY POS ACQ17111,0.0,783728.36,6076484.950000012,2018,11,17,CASH_IN,783728.36,M182639397
3103,409000438611',2018-11-17,Indiaforensic RUPAY POS C2 ACQ17,0.0,2150244.52,8226729.470000014,2018,11,17,CHECK_CASHING,2150244.52,M2063355321
3104,409000438611',2018-11-17,TRF TO  Indiaforensic SERVICES I,2000000.0,0.0,6226729.470000014,2018,11,17,PAYEMENT,2000000.0,M104367332
3105,409000438611',2018-11-19,TRF TO  Indiaforensic SERVICES I,3000000.0,0.0,3226729.4700000137,2018,11,19,PAYEMENT,3000000.0,M1254850252
3106,409000438611',2018-11-19,TRF TO  Indiaforensic SERVICES I,3000000.0,0.0,226729.4700000137,2018,11,19,DEBIT,3000000.0,M1746074170
3107,409000438611',2018-11-19,ICA 17825 Indiaforensic MC INT 1,0.0,3041.42,229770.89000001372,2018,11,19,TRANSFER,3041.42,C998351292
3108,409000438611',2018-11-19,ICA 17825 Indiaforensic MC DOM 1,0.0,12671255.85,12901026.740000013,2018,11,19,CASH_IN,12671255.85,C967643830
3109,409000438611',2018-11-19,TRF TO  Indiaforensic SERVICES I,10000000.0,0.0,2901026.7400000133,2018,11,19,CASH_OUT,10000000.0,M389703464
3110,409000438611',2018-11-19,Indiaforensic VISA ACQ DOM191118,0.0,12121648.0,15022674.740000013,2018,11,19,CHECK_CASHING,12121648.0,M1733381085
3111,409000438611',2018-11-19,Indiaforensic RUPAY POS ACQ18111,0.0,2300668.87,17323343.610000014,2018,11,19,TRANSFER,2300668.87,M2136291489
3112,409000438611',2018-11-19,Indiaforensic RUPAY POS ACQ19111,0.0,3084878.46,20408222.07000001,2018,11,19,TRANSFER,3084878.46,M530528285
3113,409000438611',2018-11-19,Indiaforensic RUPAY POS C2 ACQ19,0.0,702017.72,21110239.790000014,2018,11,19,TRANSFER,702017.72,M1648278215
3114,409000438611',2018-11-19,TRF TO  Indiaforensic SERVICES I,15000000.0,0.0,6110239.790000014,2018,11,19,CHECK_WITHDRAWAL,15000000.0,M448131210
3115,409000438611',2018-11-19,TRF T  Indiaforensic SERVICES IN,4000000.0,0.0,2110239.790000014,2018,11,19,CHECK_WITHDRAWAL,4000000.0,M2040548959
3116,409000438611',2018-11-19,TRF T0  Indiaforensic SERVICES I,2000000.0,0.0,110239.790000014,2018,11,19,CHECK_WITHDRAWAL,2000000.0,M1395725953
3117,409000438611',2018-11-20,ICA 17825 Indiaforensic MC INT 1,0.0,39799.19,150038.980000014,2018,11,20,CASH_IN,39799.19,M1058984040
3118,409000438611',2018-11-20,Indiaforensic VISA ACQ DOM201118,0.0,6627773.93,6777812.910000014,2018,11,20,TRANSFER,6627773.93,C481402298
3119,409000438611',2018-11-20,Indiaforensic RUPAY POS ACQ20111,0.0,2486465.85,9264278.760000017,2018,11,20,TRANSFER,2486465.85,C2118255842
3120,409000438611',2018-11-20,Indiaforensic VISA ACQ INT 16111,0.0,5573.1,9269851.860000014,2018,11,20,TRANSFER,5573.1,M505323251
3121,409000438611',2018-11-20,Indiaforensic RUPAY POS C2 ACQ20,0.0,766268.52,10036120.380000014,2018,11,20,TRANSFER,766268.52,C1850180796
3122,409000438611',2018-11-20,TRF TO  Indiaforensic SERVICES I,5000000.0,0.0,5036120.380000014,2018,11,20,CHECK_WITHDRAWAL,5000000.0,C932583850
3123,409000438611',2018-11-20,TRF TO  Indiaforensic SERVICES I,2000000.0,0.0,3036120.380000014,2018,11,20,PAYEMENT,2000000.0,C564160838
3124,409000438611',2018-11-20,TRF TO  Indiaforensic SERVICES I,2000000.0,0.0,1036120.3800000141,2018,11,20,CASH_OUT,2000000.0,C1899073220
3125,409000438611',2018-11-21,FUND TRF TO  Indiaforensic SERVI,1000000.0,0.0,36120.380000013865,2018,11,21,DEBIT,1000000.0,C306206744
3126,409000438611',2018-11-21,Indiaforensic RUPAY POS ACQ21111,0.0,3078833.91,3114954.290000013,2018,11,21,TRANSFER,3078833.91,C998351292
3127,409000438611',2018-11-21,Indiaforensic RUPAY POS C2 ACQ21,0.0,732121.39,3847075.6800000137,2018,11,21,CASH_IN,732121.39,C909295153
3128,409000438611',2018-11-21,FUND TRF TO  Indiaforensic SERVI,2000000.0,0.0,1847075.6800000141,2018,11,21,PAYEMENT,2000000.0,C248609774
3129,409000438611',2018-11-21,FUND TRF TO  Indiaforensic SERVI,1000000.0,0.0,847075.680000014,2018,11,21,PAYEMENT,1000000.0,C1750563752
3130,409000438611',2018-11-21,FUND TRF TO  Indiaforensic SERVI,500000.0,0.0,347075.6800000141,2018,11,21,DEBIT,500000.0,C1453128758
3131,409000438611',2018-11-22,ICA 17825 Indiaforensic MC INT 2,0.0,19279.39,366355.07000001415,2018,11,22,CHECK_CASHING,19279.39,C1234776885
3132,409000438611',2018-11-22,ICA 17825 Indiaforensic MC INT 2,0.0,7152.14,373507.21000001417,2018,11,22,TRANSFER,7152.14,C2118255842
3133,409000438611',2018-11-22,ICA 17825 Indiaforensic MC DOM 2,0.0,15140655.54,15514162.750000013,2018,11,22,TRANSFER,15140655.54,C1023714065
3134,409000438611',2018-11-22,TRF TO  Indiaforensic SERVICES I,15000000.0,0.0,514162.750000013,2018,11,22,DEBIT,15000000.0,C716083600
3135,409000438611',2018-11-22,Indiaforensic VISA ACQ DOM211118,0.0,6233273.22,6747435.970000013,2018,11,22,TRANSFER,6233273.22,M1961232715
3136,409000438611',2018-11-22,Indiaforensic VISA ACQ DOM221118,0.0,5883662.68,12631098.650000013,2018,11,22,TRANSFER,5883662.68,M1559434619
3137,409000438611',2018-11-22,Indiaforensic RUPAY POS ACQ22111,0.0,3065036.47,15696135.120000014,2018,11,22,CHECK_CASHING,3065036.47,M641011362
3138,409000438611',2018-11-22,Indiaforensic RUPAY POS C2 ACQ22,0.0,756809.82,16452944.940000014,2018,11,22,CASH_IN,756809.82,M1510535132
3139,409000438611',2018-11-22,Indiaforensic VISA ACQ INT 19111,0.0,3542.0,16456486.940000014,2018,11,22,CHECK_CASHING,3542.0,M1500079441
3140,409000438611',2018-11-22,TRF TO  Indiaforensic SERVICES I,1000000.0,0.0,15456486.940000014,2018,11,22,PAYEMENT,1000000.0,M2045143855
3141,409000438611',2018-11-22,TRF TO  Indiaforensic SERVICES I,15000000.0,0.0,456486.9400000144,2018,11,22,PAYEMENT,15000000.0,M100048427
3142,409000438611',2018-11-23,Indiaforensic RUPAY POS ACQ23111,0.0,965541.18,1422028.1200000143,2018,11,23,CHECK_CASHING,965541.18,M1139915666
3143,409000438611',2018-11-23,Indiaforensic RUPAY POS C2 ACQ23,0.0,1562155.14,2984183.260000015,2018,11,23,CHECK_CASHING,1562155.14,M1549623669
3144,409000438611',2018-11-26,TRF TO  Indiaforensic SERVICES I,2900000.0,0.0,84183.26000001468,2018,11,26,DEBIT,2900000.0,M992457879
3145,409000438611',2018-11-26,ICA 17825 Indiaforensic MC DOM 2,0.0,16419259.12,16503442.380000016,2018,11,26,CASH_IN,16419259.12,M1014278669
3146,409000438611',2018-11-26,TRF TO  Indiaforensic SERVICES I,10000000.0,0.0,6503442.380000014,2018,11,26,DEBIT,10000000.0,M1786872722
3147,409000438611',2018-11-26,TRF TO  Indiaforensic SERVICES I,5000000.0,0.0,1503442.380000014,2018,11,26,CHECK_WITHDRAWAL,5000000.0,C510113906
3148,409000438611',2018-11-26,Indiaforensic VISA ACQ DOM231118,0.0,4993123.72,6496566.100000014,2018,11,26,CASH_IN,4993123.72,C542895457
3149,409000438611',2018-11-26,Indiaforensic RUPAY POS ACQ24111,0.0,2556219.48,9052785.580000013,2018,11,26,TRANSFER,2556219.48,C270095066
3150,409000438611',2018-11-26,Indiaforensic RUPAY POS ACQ25111,0.0,3393970.41,12446755.990000013,2018,11,26,CHECK_CASHING,3393970.41,M927159199
3151,409000438611',2018-11-26,Indiaforensic VISA ACQ DOM241118,0.0,4522443.03,16969199.020000014,2018,11,26,CASH_IN,4522443.03,M1572255813
3152,409000438611',2018-11-26,Indiaforensic VISA ACQ DOM261118,0.0,11708902.02,28678101.04000001,2018,11,26,CASH_IN,11708902.02,C297927961
3153,409000438611',2018-11-26,Indiaforensic RUPAY POS ACQ26111,0.0,1506380.84,30184481.88000001,2018,11,26,CHECK_CASHING,1506380.84,C453211571
3154,409000438611',2018-11-26,Indiaforensic RUPAY POS C2 ACQ26,0.0,1798748.08,31983229.960000016,2018,11,26,CASH_IN,1798748.08,M1146859833
3155,409000438611',2018-11-26,ICA 17825 Indiaforensic MC INT 2,0.0,31944.43,32015174.39000001,2018,11,26,CASH_IN,31944.43,M2055276126
3156,409000438611',2018-11-26,TRF TO  Indiaforensic SERVICES I,1900000.0,0.0,30115174.39000001,2018,11,26,DEBIT,1900000.0,C655381473
3157,409000438611',2018-11-26,TRF TO  Indiaforensic SERVICES I,15000000.0,0.0,15115174.390000015,2018,11,26,PAYEMENT,15000000.0,C1917025677
3158,409000438611',2018-11-26,TRF TO  Indiaforensic SERVICES I,15000000.0,0.0,115174.39000001553,2018,11,26,DEBIT,15000000.0,M1596278280
3159,409000438611',2018-11-27,ICA 17825 Indiaforensic MC INT 2,0.0,42079.28,157253.6700000155,2018,11,27,TRANSFER,42079.28,M454841229
3160,409000438611',2018-11-27,Indiaforensic VISA ACQ DOM271118,0.0,2553252.82,2710506.490000015,2018,11,27,TRANSFER,2553252.82,M1663431506
3161,409000438611',2018-11-27,Indiaforensic RUPAY POS ACQ27111,0.0,2553252.82,5263759.310000015,2018,11,27,TRANSFER,2553252.82,M1824327284
3162,409000438611',2018-11-27,ICA 17825 Indiaforensic MC DOM 2,0.0,4504947.47,9768706.780000016,2018,11,27,CHECK_CASHING,4504947.47,C268086000
3163,409000438611',2018-11-27,TRF TO  Indiaforensic SERVICES I,9700000.0,0.0,68706.78000001611,2018,11,27,CASH_OUT,9700000.0,C991505714
3164,409000438611',2018-11-27,Indiaforensic RUPAY POS C2 ACQ27,0.0,752477.31,821184.0900000161,2018,11,27,TRANSFER,752477.31,M765702264
3165,409000438611',2018-11-27,Indiaforensic VISA ACQ INT 22111,0.0,3690.04,824874.1300000163,2018,11,27,CHECK_CASHING,3690.04,M2142660176
3166,409000438611',2018-11-27,Indiaforensic VISA ACQ INT 23111,0.0,9346.56,834220.6900000162,2018,11,27,CASH_IN,9346.56,M713464342
3167,409000438611',2018-11-27,TRF TO  Indiaforensic SERVICES I,800000.0,0.0,34220.690000016235,2018,11,27,PAYEMENT,800000.0,C1870252780
3168,409000438611',2018-11-27,Indiaforensic VISA ACQ DOM271118,0.0,6216646.03,6250866.7200000165,2018,11,27,CHECK_CASHING,6216646.03,C461160828
3169,409000438611',2018-11-27,Indiaforensic RUPAY POS ACQ27111,2553252.82,0.0,3697613.9000000167,2018,11,27,CHECK_WITHDRAWAL,2553252.82,M1947397483
3170,409000438611',2018-11-28,TRF TO  Indiaforensic SERVICES I,3000000.0,0.0,697613.9000000167,2018,11,28,DEBIT,3000000.0,M2068450031
3171,409000438611',2018-11-28,TRF TO  Indiaforensic SERVICES I,500000.0,0.0,197613.90000001667,2018,11,28,PAYEMENT,500000.0,M651433745
3172,409000438611',2018-11-28,ICA 17825 Indiaforensic MC INT 2,0.0,1876.39,199490.29000001668,2018,11,28,CHECK_CASHING,1876.39,C1428469551
3173,409000438611',2018-11-28,ICA 17825 Indiaforensic MC DOM 2,0.0,4168767.81,4368258.100000016,2018,11,28,CASH_IN,4168767.81,M836749045
3174,409000438611',2018-11-28,Indiaforensic VISA ACQ DOM281118,0.0,5619451.48,9987709.580000017,2018,11,28,CHECK_CASHING,5619451.48,C1068824137
3175,409000438611',2018-11-28,Indiaforensic RUPAY POS ACQ28111,0.0,2475503.03,12463212.610000014,2018,11,28,TRANSFER,2475503.03,M793657559
3176,409000438611',2018-11-28,Indiaforensic VISA ACQ INT 24111,0.0,108844.68,12572057.290000016,2018,11,28,CASH_IN,108844.68,C1318822808
3177,409000438611',2018-11-28,Indiaforensic VISA ACQ INT 25111,0.0,56310.97,12628368.260000015,2018,11,28,CHECK_CASHING,56310.97,M1168076863
3178,409000438611',2018-11-28,Indiaforensic VISA ACQ INT 26111,0.0,3144.12,12631512.380000016,2018,11,28,CHECK_CASHING,3144.12,M911267068
3179,409000438611',2018-11-28,Indiaforensic RUPAY POS C2 ACQ28,0.0,576674.12,13208186.500000015,2018,11,28,CASH_IN,576674.12,M873105556
3180,409000438611',2018-11-28,TRF TO  Indiaforensic SERVICES I,12600000.0,0.0,608186.5000000149,2018,11,28,DEBIT,12600000.0,C660143728
3181,409000438611',2018-11-28,TRF TO  Indiaforensic SERVICES I,600000.0,0.0,8186.500000014901,2018,11,28,CHECK_WITHDRAWAL,600000.0,M281487983
3182,409000438611',2018-11-29,ICA 17825 Indiaforensic MC INT 2,0.0,36134.95,44321.450000014906,2018,11,29,TRANSFER,36134.95,M1456464145
3183,409000438611',2018-11-29,Indiaforensic VISA ACQ DOM291118,0.0,6463189.36,6507510.810000015,2018,11,29,CHECK_CASHING,6463189.36,C1453128758
3184,409000438611',2018-11-29,Indiaforensic RUPAY POS ACQ29111,0.0,2381269.09,8888779.900000015,2018,11,29,TRANSFER,2381269.09,M1834755909
3185,409000438611',2018-11-29,Indiaforensic VISA ACQ INT 27111,0.0,1433.83,8890213.730000015,2018,11,29,TRANSFER,1433.83,C1261031890
3186,409000438611',2018-11-29,ICA 17825 Indiaforensic MC DOM 2,0.0,4851716.63,13741930.360000014,2018,11,29,TRANSFER,4851716.63,M50826412
3187,409000438611',2018-11-29,TRF TO  Indiaforensic SERVICES I,13700000.0,0.0,41930.36000001431,2018,11,29,DEBIT,13700000.0,C339924917
3188,409000438611',2018-11-29,Indiaforensic RUPAY POS C2 ACQ29,0.0,596990.04,638920.4000000143,2018,11,29,TRANSFER,596990.04,C1122118227
3189,409000438611',2018-11-29,TRF TO  Indiaforensic SERVICES I,600000.0,0.0,38920.400000014335,2018,11,29,PAYEMENT,600000.0,M1138356642
3190,409000438611',2018-11-30,Indiaforensic VISA ACQ DOM301118,0.0,5115401.7,5154322.100000015,2018,11,30,CASH_IN,5115401.7,M577038898
3191,409000438611',2018-11-30,Indiaforensic RUPAY POS ACQ30111,0.0,2392021.27,7546343.370000014,2018,11,30,CHECK_CASHING,2392021.27,M1910813448
3192,409000438611',2018-11-30,Indiaforensic VISA ACQ INT 28111,0.0,3552.8,7549896.170000014,2018,11,30,TRANSFER,3552.8,M346049017
3193,409000438611',2018-11-30,ICA 17825 Indiaforensic MC DOM 3,0.0,3332083.27,10881979.440000014,2018,11,30,CHECK_CASHING,3332083.27,C1471633238
3194,409000438611',2018-11-30,TRF TO  Indiaforensic SERVICES I,10000000.0,0.0,881979.4400000144,2018,11,30,CASH_OUT,10000000.0,M1287875609
3195,409000438611',2018-11-30,ICA 17825 Indiaforensic MC INT 2,0.0,30956.87,912936.3100000144,2018,11,30,TRANSFER,30956.87,M553701447
3196,409000438611',2018-11-30,Indiaforensic RUPAY POS C2 ACQ30,0.0,677021.33,1589957.6400000143,2018,11,30,TRANSFER,677021.33,M494951073
3197,409000438611',2018-11-30,TRF TO  Indiaforensic SERVICES I,800000.0,0.0,789957.6400000143,2018,11,30,PAYEMENT,800000.0,M818546553
3198,409000438611',2018-12-01,Indiaforensic VISA ACQ DOM011218,0.0,5296020.9,6085978.540000015,2018,12,1,CHECK_CASHING,5296020.9,M1203638171
3199,409000438611',2018-12-01,TRF TO  Indiaforensic SERVICES I,3000000.0,0.0,3085978.540000015,2018,12,1,CHECK_WITHDRAWAL,3000000.0,C434091818
3200,409000438611',2018-12-01,TRF TO  Indiaforensic SERVICES I,3000000.0,0.0,85978.54000001494,2018,12,1,CHECK_WITHDRAWAL,3000000.0,M859985937
3201,409000438611',2018-12-01,Indiaforensic RUPAY POS ACQ01121,0.0,2655105.43,2741083.970000015,2018,12,1,CHECK_CASHING,2655105.43,M240000757
3202,409000438611',2018-12-01,TRF TO  Indiaforensic SERVICES I,2000000.0,0.0,741083.9700000151,2018,12,1,CASH_OUT,2000000.0,M1286771084
3203,409000438611',2018-12-01,Indiaforensic RUPAY POS C2 ACQ01,0.0,574648.18,1315732.150000015,2018,12,1,TRANSFER,574648.18,M203785427
3204,409000438611',2018-12-03,TRF TO  Indiaforensic SERVICES I,1300000.0,0.0,15732.150000015274,2018,12,3,CHECK_WITHDRAWAL,1300000.0,C728885526
3205,409000438611',2018-12-03,Indiaforensic RUPAY POS ACQ02121,0.0,1223406.7,1239138.8500000152,2018,12,3,CHECK_CASHING,1223406.7,M1374431318
3206,409000438611',2018-12-03,ICA 17825 Indiaforensic MC DOM 0,0.0,13683158.1,14922296.950000014,2018,12,3,CHECK_CASHING,13683158.1,M480943798
3207,409000438611',2018-12-03,TRF TO  Indiaforensic SERVICES I,14900000.0,0.0,22296.95000001416,2018,12,3,CASH_OUT,14900000.0,M801996095
3208,409000438611',2018-12-03,Indiaforensic VISA ACQ DOM031218,0.0,11949030.72,11971327.670000015,2018,12,3,CASH_IN,11949030.72,C1504109395
3209,409000438611',2018-12-03,Indiaforensic RUPAY POS ACQ03121,0.0,4440936.91,16412264.580000015,2018,12,3,TRANSFER,4440936.91,M1793469566
3210,409000438611',2018-12-03,Indiaforensic RUPAY POS C2 ACQ03,0.0,712882.36,17125146.940000016,2018,12,3,TRANSFER,712882.36,M935552520
3211,409000438611',2018-12-03,Indiaforensic VISA ACQ INT 29111,0.0,53600.51,17178747.450000018,2018,12,3,CHECK_CASHING,53600.51,M102185114
3212,409000438611',2018-12-03,TRF TO  Indiaforensic SERVICES I,15000000.0,0.0,2178747.4500000183,2018,12,3,PAYEMENT,15000000.0,M810593327
3213,409000438611',2018-12-03,TRF TO  Indiaforensic SERVICES I,1400000.0,0.0,778747.450000018,2018,12,3,PAYEMENT,1400000.0,M423095039
3214,409000438611',2018-12-03,ICA 17825 Indiaforensic MC INT 3,0.0,1011.62,779759.070000018,2018,12,3,CHECK_CASHING,1011.62,M1259283097
3215,409000438611',2018-12-04,TRF TO  Indiaforensic SERVICES I,700000.0,0.0,79759.07000001788,2018,12,4,PAYEMENT,700000.0,M356539350
3216,409000438611',2018-12-04,Indiaforensic VISA ACQ DOM041218,0.0,4492757.27,4572516.3400000185,2018,12,4,CHECK_CASHING,4492757.27,M117911771
3217,409000438611',2018-12-04,Indiaforensic RUPAY POS ACQ04121,0.0,1904177.82,6476694.160000018,2018,12,4,TRANSFER,1904177.82,M309349909
3218,409000438611',2018-12-04,TRF TO  Indiaforensic SERVICES I,6400000.0,0.0,76694.16000001784,2018,12,4,PAYEMENT,6400000.0,C1538745405
3219,409000438611',2018-12-04,ICA 17825 Indiaforensic MC DOM 0,0.0,3198798.74,3275492.900000018,2018,12,4,TRANSFER,3198798.74,C377957453
3220,409000438611',2018-12-04,TRF TO  Indiaforensic SERVICES I,3200000.0,0.0,75492.90000001808,2018,12,4,CHECK_WITHDRAWAL,3200000.0,M862146308
3221,409000438611',2018-12-04,ICA 17825 Indiaforensic MC INT 0,0.0,36068.76,111561.66000001806,2018,12,4,CASH_IN,36068.76,C63387985
3222,409000438611',2018-12-04,Indiaforensic RUPAY POS C2 ACQ04,0.0,315809.94,427371.60000001814,2018,12,4,CASH_IN,315809.94,C1831477404
3223,409000438611',2018-12-04,Indiaforensic VISA ACQ INT 30111,0.0,4893.02,432264.6200000181,2018,12,4,TRANSFER,4893.02,M1637000661
3224,409000438611',2018-12-04,Indiaforensic RUPAY POS C2 ACQ03,0.0,712882.35,1145146.970000018,2018,12,4,CHECK_CASHING,712882.35,M1287401019
3225,409000438611',2018-12-04,Indiaforensic RUPAY POS C2 ACQ03,712882.36,0.0,432264.61000001815,2018,12,4,CASH_OUT,712882.36,M1986001684
3226,409000438611',2018-12-05,Indiaforensic VISA ACQ DOM051218,0.0,5712862.99,6145127.600000017,2018,12,5,CASH_IN,5712862.99,M2050360660
3227,409000438611',2018-12-05,Indiaforensic RUPAY POS ACQ05121,0.0,2305327.72,8450455.320000019,2018,12,5,CHECK_CASHING,2305327.72,M1271084832
3228,409000438611',2018-12-05,ICA 17825 Indiaforensic MC DOM 0,0.0,4436153.72,12886609.040000018,2018,12,5,TRANSFER,4436153.72,M1728465884
3229,409000438611',2018-12-05,TRF TO  Indiaforensic SERVICES I,12800000.0,0.0,86609.04000001772,2018,12,5,PAYEMENT,12800000.0,M408388753
3230,409000438611',2018-12-05,ICA 17825 Indiaforensic MC INT 0,0.0,20392.14,107001.18000001773,2018,12,5,TRANSFER,20392.14,M1729904998
3231,409000438611',2018-12-05,Indiaforensic VISA ACQ INT 01121,0.0,157021.85,264023.0300000177,2018,12,5,CHECK_CASHING,157021.85,M2005293363
3232,409000438611',2018-12-05,Indiaforensic VISA ACQ INT 02121,0.0,124116.27,388139.30000001774,2018,12,5,CASH_IN,124116.27,M1293465402
3233,409000438611',2018-12-05,Indiaforensic RUPAY POS C2 ACQ05,0.0,651814.48,1039953.7800000176,2018,12,5,TRANSFER,651814.48,M1392482765
3234,409000438611',2018-12-05,Indiaforensic RUPAY POS ACQ05121,0.0,2305327.73,3345281.5100000175,2018,12,5,CHECK_CASHING,2305327.73,M1141059550
3235,409000438611',2018-12-05,Indiaforensic RUPAY POS ACQ05121,2305327.72,0.0,1039953.7900000172,2018,12,5,DEBIT,2305327.72,M1433976386
3236,409000438611',2018-12-06,ICA 17825 Indiaforensic MC DOM 0,0.0,4358449.18,5398402.9700000165,2018,12,6,TRANSFER,4358449.18,C54617902
3237,409000438611',2018-12-06,TRF TO  Indiaforensic SERVICES I,5000000.0,0.0,398402.97000001743,2018,12,6,CHECK_WITHDRAWAL,5000000.0,C1850180796
3238,409000438611',2018-12-06,Indiaforensic VISA ACQ DOM061218,0.0,6318103.53,6716506.500000018,2018,12,6,TRANSFER,6318103.53,M1130153977
3239,409000438611',2018-12-06,Indiaforensic RUPAY POS ACQ06121,0.0,2860987.12,9577493.620000018,2018,12,6,TRANSFER,2860987.12,M461001437
3240,409000438611',2018-12-06,Indiaforensic VISA ACQ INT 04121,0.0,2036.35,9579529.970000016,2018,12,6,CHECK_CASHING,2036.35,M1523957322
3241,409000438611',2018-12-06,TRF TO  Indiaforensic SERVICES I,9500000.0,0.0,79529.97000001742,2018,12,6,PAYEMENT,9500000.0,M1937575946
3242,409000438611',2018-12-06,ICA 17825 Indiaforensic MC INT 0,0.0,34076.18,113606.15000001744,2018,12,6,CHECK_CASHING,34076.18,C453211571
3243,409000438611',2018-12-06,Indiaforensic RUPAY POS C2 ACQ06,0.0,601594.35,715200.5000000175,2018,12,6,TRANSFER,601594.35,C1353512285
3244,409000438611',2018-12-07,ICA 17825 Indiaforensic MC DOM 0,0.0,4802557.18,5517757.6800000165,2018,12,7,CASH_IN,4802557.18,M117052390
3245,409000438611',2018-12-07,Indiaforensic VISA ACQ DOM071218,0.0,5952941.04,11470698.720000016,2018,12,7,CASH_IN,5952941.04,M1996787860
3246,409000438611',2018-12-07,Indiaforensic RUPAY POS ACQ07121,0.0,2381605.31,13852304.030000018,2018,12,7,CASH_IN,2381605.31,M1505486986
3247,409000438611',2018-12-07,TRF TO  Indiaforensic SERVICES I,13800000.0,0.0,52304.030000017956,2018,12,7,CHECK_WITHDRAWAL,13800000.0,M249109901
3248,409000438611',2018-12-07,ICA 17825 Indiaforensic MC INT 0,0.0,4838.59,57142.62000001795,2018,12,7,CHECK_CASHING,4838.59,M1117747481
3249,409000438611',2018-12-07,Indiaforensic RUPAY POS C2 ACQ07,0.0,795570.2,852712.820000018,2018,12,7,TRANSFER,795570.2,M215638041
3250,409000438611',2018-12-10,Indiaforensic VISA ACQ DOM081218,0.0,6164581.32,7017294.140000017,2018,12,10,TRANSFER,6164581.32,C1963862935
3251,409000438611',2018-12-10,Indiaforensic RUPAY POS ACQ08121,0.0,3195098.96,10212393.100000018,2018,12,10,CASH_IN,3195098.96,C1850042097
3252,409000438611',2018-12-10,Indiaforensic RUPAY POS ACQ09121,0.0,3140022.67,13352415.770000018,2018,12,10,TRANSFER,3140022.67,M485542604
3253,409000438611',2018-12-10,ICA 17825 Indiaforensic MC DOM 1,0.0,14926188.87,28278604.64000001,2018,12,10,CASH_IN,14926188.87,M1385966234
3254,409000438611',2018-12-10,TRF TO  Indiaforensic SERVICES I,10000000.0,0.0,18278604.64000001,2018,12,10,CASH_OUT,10000000.0,M649848324
3255,409000438611',2018-12-10,TRF TO  Indiaforensic SERVICES I,3000000.0,0.0,15278604.640000015,2018,12,10,DEBIT,3000000.0,C1793436274
3256,409000438611',2018-12-10,TRF TO  Indiaforensic SERVICES I,15000000.0,0.0,278604.6400000155,2018,12,10,DEBIT,15000000.0,C40075281
3257,409000438611',2018-12-10,Indiaforensic VISA ACQ DOM101218,0.0,12098346.17,12376950.810000015,2018,12,10,CHECK_CASHING,12098346.17,M1174478906
3258,409000438611',2018-12-10,TRF TO  Indiaforensic SERVICES I,10000000.0,0.0,2376950.8100000154,2018,12,10,DEBIT,10000000.0,C214187874
3259,409000438611',2018-12-10,ICA 17825 Indiaforensic MC INT 0,0.0,18060.13,2395010.940000016,2018,12,10,TRANSFER,18060.13,M135002781
3260,409000438611',2018-12-10,Indiaforensic RUPAY POS ACQ10121,0.0,3148757.68,5543768.620000016,2018,12,10,CASH_IN,3148757.68,M1258527853
3261,409000438611',2018-12-10,Indiaforensic RUPAY POS C2 ACQ10,0.0,736858.78,6280627.400000016,2018,12,10,CHECK_CASHING,736858.78,M1350395050
3262,409000438611',2018-12-11,TRF TO  Indiaforensic SERVICES I,5000000.0,0.0,1280627.4000000162,2018,12,11,DEBIT,5000000.0,M1622362417
3263,409000438611',2018-12-11,TRF TO  Indiaforensic SERVICES I,1000000.0,0.0,280627.4000000162,2018,12,11,PAYEMENT,1000000.0,M1908505175
3264,409000438611',2018-12-11,ICA 17825 Indiaforensic MC DOM 1,0.0,4708779.92,4989407.320000016,2018,12,11,CHECK_CASHING,4708779.92,M504006221
3265,409000438611',2018-12-11,TRF TO  Indiaforensic SERVICES I,4900000.0,0.0,89407.32000001613,2018,12,11,DEBIT,4900000.0,M1047000562
3266,409000438611',2018-12-11,Indiaforensic VISA ACQ DOM111218,0.0,6243888.06,6333295.380000018,2018,12,11,CASH_IN,6243888.06,M1160247050
3267,409000438611',2018-12-11,Indiaforensic RUPAY POS ACQ11121,0.0,1402223.24,7735518.620000016,2018,12,11,TRANSFER,1402223.24,M1899145692
3268,409000438611',2018-12-11,Indiaforensic VISA ACQ INT 07121,0.0,11716.72,7747235.340000018,2018,12,11,CASH_IN,11716.72,M765880900
3269,409000438611',2018-12-11,TRF TO  Indiaforensic SERVICES I,4000000.0,0.0,3747235.340000016,2018,12,11,PAYEMENT,4000000.0,M1639958975
3270,409000438611',2018-12-11,TRF TO  Indiaforensic SERVICES I,3000000.0,0.0,747235.3400000156,2018,12,11,DEBIT,3000000.0,M849063257
3271,409000438611',2018-12-11,Indiaforensic RUPAY POS C2 ACQ11,0.0,2571313.35,3318548.6900000162,2018,12,11,TRANSFER,2571313.35,C634210724
3272,409000438611',2018-12-11,ICA 17825 Indiaforensic MC INT 0,0.0,64308.53,3382857.220000016,2018,12,11,TRANSFER,64308.53,C1032986144
3273,409000438611',2018-12-12,TRF TO  Indiaforensic SERVICES I,3300000.0,0.0,82857.22000001557,2018,12,12,CASH_OUT,3300000.0,M1550991149
3274,409000438611',2018-12-12,ICA 17825 Indiaforensic MC DOM 1,0.0,5524227.49,5607084.710000016,2018,12,12,CASH_IN,5524227.49,M763008902
3275,409000438611',2018-12-12,Indiaforensic VISA ACQ DOM121218,0.0,6493784.36,12100869.070000015,2018,12,12,TRANSFER,6493784.36,C97730845
3276,409000438611',2018-12-12,Indiaforensic RUPAY POS ACQ12121,0.0,2716816.87,14817685.940000014,2018,12,12,TRANSFER,2716816.87,C838411509
3277,409000438611',2018-12-12,Indiaforensic VISA ACQ INT 08121,0.0,123739.63,14941425.570000015,2018,12,12,CHECK_CASHING,123739.63,C1491676195
3278,409000438611',2018-12-12,Indiaforensic VISA ACQ INT 09121,0.0,1530.35,14942955.920000015,2018,12,12,CASH_IN,1530.35,M753853622
3279,409000438611',2018-12-12,Indiaforensic VISA ACQ INT 10121,0.0,100825.03,15043780.950000014,2018,12,12,CHECK_CASHING,100825.03,M1768471788
3280,409000438611',2018-12-12,TRF TO  Indiaforensic SERVICES I,5000000.0,0.0,10043780.950000016,2018,12,12,PAYEMENT,5000000.0,M242762528
3281,409000438611',2018-12-12,TRF TO  Indiaforensic SERVICES I,5000000.0,0.0,5043780.950000016,2018,12,12,CASH_OUT,5000000.0,M331918455
3282,409000438611',2018-12-12,TRF TO  Indiaforensic SERVICES I,4000000.0,0.0,1043780.9500000159,2018,12,12,DEBIT,4000000.0,C2083562754
3283,409000438611',2018-12-12,Indiaforensic RUPAY POS C2 ACQ12,0.0,637958.84,1681739.7900000159,2018,12,12,CASH_IN,637958.84,M744715819
3284,409000438611',2018-12-12,ICA 17825 Indiaforensic MC INT 1,0.0,2513.95,1684253.7400000158,2018,12,12,TRANSFER,2513.95,C1335050193
3285,409000438611',2018-12-13,TRF TO  Indiaforensic SERVICES I,1600000.0,0.0,84253.74000001582,2018,12,13,DEBIT,1600000.0,M1594214614
3286,409000438611',2018-12-13,ICA 17825 Indiaforensic MC DOM 1,0.0,4753047.52,4837301.260000017,2018,12,13,TRANSFER,4753047.52,M1687430663
3287,409000438611',2018-12-13,TRF TO  Indiaforensic SERVICES I,4800000.0,0.0,37301.26000001561,2018,12,13,DEBIT,4800000.0,M2096808863
3288,409000438611',2018-12-13,Indiaforensic VISA ACQ DOM131218,0.0,5223193.7,5260494.960000016,2018,12,13,CASH_IN,5223193.7,M1357597228
3289,409000438611',2018-12-13,Indiaforensic RUPAY POS ACQ13121,0.0,2503052.32,7763547.280000016,2018,12,13,CHECK_CASHING,2503052.32,M812229472
3290,409000438611',2018-12-13,Indiaforensic RUPAY POS C2 ACQ13,0.0,512063.58,8275610.860000016,2018,12,13,CHECK_CASHING,512063.58,M2022012779
3291,409000438611',2018-12-13,Indiaforensic VISA ACQ INT 11121,0.0,105619.6,8381230.460000016,2018,12,13,CASH_IN,105619.6,M879924346
3292,409000438611',2018-12-13,TRF TO  Indiaforensic SERVICES I,8300000.0,0.0,81230.4600000158,2018,12,13,CHECK_WITHDRAWAL,8300000.0,M977195776
3293,409000438611',2018-12-13,ICA 17825 Indiaforensic MC INT 1,0.0,1007.64,82238.1000000158,2018,12,13,CHECK_CASHING,1007.64,M972404515
3294,409000438611',2018-12-14,ICA 17825 Indiaforensic MC DOM 1,0.0,5113900.31,5196138.410000015,2018,12,14,TRANSFER,5113900.31,M37768026
3295,409000438611',2018-12-14,Indiaforensic VISA ACQ DOM141218,0.0,6045909.33,11242047.740000017,2018,12,14,CASH_IN,6045909.33,M783117220
3296,409000438611',2018-12-14,Indiaforensic RUPAY POS ACQ14121,0.0,1472903.16,12714950.900000015,2018,12,14,CASH_IN,1472903.16,C215145189
3297,409000438611',2018-12-14,Indiaforensic RUPAY POS C2 ACQ14,0.0,2114789.95,14829740.850000015,2018,12,14,TRANSFER,2114789.95,M664836465
3298,409000438611',2018-12-14,Indiaforensic VISA ACQ INT 12121,0.0,710.42,14830451.270000014,2018,12,14,TRANSFER,710.42,M1188871851
3299,409000438611',2018-12-14,TRF T  Indiaforensic SERVICES IN,5000000.0,0.0,9830451.270000016,2018,12,14,PAYEMENT,5000000.0,C564160838
3300,409000438611',2018-12-14,TRF TO  Indiaforensic SERVICES I,9800000.0,0.0,30451.270000016317,2018,12,14,PAYEMENT,9800000.0,C2081595126
3301,409000438611',2018-12-14,ICA 17825 Indiaforensic MC DOM 1,700.9,0.0,29750.37000001632,2018,12,14,DEBIT,700.9,C481402298
3302,409000438611',2018-12-14,ICA 17825 Indiaforensic MC INT 1,0.0,2723.15,32473.520000016317,2018,12,14,TRANSFER,2723.15,C662736689
3303,409000438611',2018-12-15,Indiaforensic VISA ACQ DOM151218,0.0,6091213.26,6123686.780000016,2018,12,15,CHECK_CASHING,6091213.26,C1538745405
3304,409000438611',2018-12-15,Indiaforensic RUPAY POS ACQ15121,0.0,2863225.36,8986912.140000015,2018,12,15,CASH_IN,2863225.36,C665576141
3305,409000438611',2018-12-15,TRF TO  Indiaforensic SERVICES I,2000000.0,0.0,6986912.140000016,2018,12,15,CHECK_WITHDRAWAL,2000000.0,C1234776885
3306,409000438611',2018-12-15,TRF TO  Indiaforensic SERVICES I,3000000.0,0.0,3986912.1400000164,2018,12,15,CASH_OUT,3000000.0,C1538745405
3307,409000438611',2018-12-15,TRF TO  Indiaforensic SERVICES I,3000000.0,0.0,986912.1400000156,2018,12,15,CASH_OUT,3000000.0,C977993101
3308,409000438611',2018-12-15,Indiaforensic RUPAY POS C2 ACQ15,0.0,766128.04,1753040.1800000155,2018,12,15,TRANSFER,766128.04,C1782580546
3309,409000438611',2018-12-17,TRF TO  Indiaforensic SERVICES I,1000000.0,0.0,753040.1800000154,2018,12,17,PAYEMENT,1000000.0,C481402298
3310,409000438611',2018-12-17,TRF TO  Indiaforensic SERVICES I,500000.0,0.0,253040.18000001553,2018,12,17,CHECK_WITHDRAWAL,500000.0,C738590621
3311,409000438611',2018-12-17,Indiaforensic VISA ACQ DOM171218,0.0,9768546.91,10021587.090000017,2018,12,17,CHECK_CASHING,9768546.91,C801142660
3312,409000438611',2018-12-17,Indiaforensic RUPAY POS ACQ16121,0.0,2029086.36,12050673.450000014,2018,12,17,CASH_IN,2029086.36,C1134894336
3313,409000438611',2018-12-17,Indiaforensic RUPAY POS ACQ17121,0.0,2452224.36,14502897.810000015,2018,12,17,CHECK_CASHING,2452224.36,C2083562754
3314,409000438611',2018-12-17,Indiaforensic VISA ACQ INT 13121,0.0,53166.18,14556063.990000013,2018,12,17,TRANSFER,53166.18,C1122118227
3315,409000438611',2018-12-17,ICA 17825 Indiaforensic MC DOM 1,0.0,12202546.59,26758610.58000001,2018,12,17,CASH_IN,12202546.59,C1538745405
3316,409000438611',2018-12-17,TRF TO  Indiaforensic SERVICES I,5000000.0,0.0,21758610.580000013,2018,12,17,PAYEMENT,5000000.0,C1062254208
3317,409000438611',2018-12-17,TRF TO  Indiaforensic SERVICES I,5000000.0,0.0,16758610.580000013,2018,12,17,CHECK_WITHDRAWAL,5000000.0,C224063653
3318,409000438611',2018-12-17,TRF TO  Indiaforensic SERVICES I,14500000.0,0.0,2258610.580000013,2018,12,17,CHECK_WITHDRAWAL,14500000.0,M1427020774
3319,409000438611',2018-12-17,TRF TO  Indiaforensic SERVICES I,2000000.0,0.0,258610.58000001308,2018,12,17,DEBIT,2000000.0,C1674899618
3320,409000438611',2018-12-17,Indiaforensic RUPAY POS C2 ACQ17,0.0,401144.87,659755.4500000131,2018,12,17,TRANSFER,401144.87,M650797503
3321,409000438611',2018-12-17,ICA 17825 Indiaforensic MC INT 1,0.0,3067.68,662823.1300000132,2018,12,17,TRANSFER,3067.68,M262535196
3322,409000438611',2018-12-18,TRF TO  Indiaforensic SERVICES I,500000.0,0.0,162823.13000001313,2018,12,18,DEBIT,500000.0,M523174153
3323,409000438611',2018-12-18,Indiaforensic VISA ACQ DOM181218,0.0,4231262.18,4394085.310000014,2018,12,18,CASH_IN,4231262.18,M1753113235
3324,409000438611',2018-12-18,Indiaforensic RUPAY POS ACQ18121,0.0,1912891.07,6306976.380000013,2018,12,18,CHECK_CASHING,1912891.07,C423583818
3325,409000438611',2018-12-18,Indiaforensic VISA ACQ INT 14121,0.0,4325.64,6311302.020000013,2018,12,18,CASH_IN,4325.64,M531576940
3326,409000438611',2018-12-18,TRF TO  Indiaforensic SERVICES I,3000000.0,0.0,3311302.0200000126,2018,12,18,PAYEMENT,3000000.0,C578102596
3327,409000438611',2018-12-18,TRF TO  Indiaforensic SERVICES I,3000000.0,0.0,311302.0200000126,2018,12,18,CHECK_WITHDRAWAL,3000000.0,M1625321341
3328,409000438611',2018-12-18,ICA 17825 Indiaforensic MC DOM 1,0.0,2917130.39,3228432.4100000127,2018,12,18,CHECK_CASHING,2917130.39,M1998224723
3329,409000438611',2018-12-18,ICA 17825 Indiaforensic MC INT 1,0.0,9648.88,3238081.2900000126,2018,12,18,CHECK_CASHING,9648.88,M244668763
3330,409000438611',2018-12-18,TRF TO  Indiaforensic SERVICES I,3000000.0,0.0,238081.2900000126,2018,12,18,CHECK_WITHDRAWAL,3000000.0,M2118482375
3331,409000438611',2018-12-18,Indiaforensic RUPAY POS C2 ACQ18,0.0,406733.51,644814.8000000126,2018,12,18,CHECK_CASHING,406733.51,M1570022108
3332,409000438611',2018-12-19,TRF TO  Indiaforensic SERVICES I,600000.0,0.0,44814.80000001262,2018,12,19,CASH_OUT,600000.0,C885951223
3333,409000438611',2018-12-19,Indiaforensic VISA ACQ DOM191218,0.0,4092845.05,4137659.8500000127,2018,12,19,CASH_IN,4092845.05,C24404443
3334,409000438611',2018-12-19,Indiaforensic RUPAY POS ACQ19121,0.0,1826756.7,5964416.550000013,2018,12,19,CHECK_CASHING,1826756.7,M591247593
3335,409000438611',2018-12-19,Indiaforensic VISA ACQ INT 15121,0.0,93198.65,6057615.200000012,2018,12,19,CHECK_CASHING,93198.65,M1614238
3336,409000438611',2018-12-19,Indiaforensic VISA ACQ INT 17121,0.0,610.91,6058226.110000012,2018,12,19,CHECK_CASHING,610.91,C1899073220
3337,409000438611',2018-12-19,ICA 17825 Indiaforensic MC DOM 1,0.0,3115189.54,9173415.650000013,2018,12,19,TRANSFER,3115189.54,C248609774
3338,409000438611',2018-12-19,TRF TO  Indiaforensic SERVICES I,4000000.0,0.0,5173415.650000013,2018,12,19,DEBIT,4000000.0,C644345897
3339,409000438611',2018-12-19,TRF TO  Indiaforensic SERVICES I,4000000.0,0.0,1173415.6500000134,2018,12,19,DEBIT,4000000.0,C1750563752
3340,409000438611',2018-12-19,TRF TO  Indiaforensic SERVICES I,1000000.0,0.0,173415.6500000134,2018,12,19,CHECK_WITHDRAWAL,1000000.0,C905650857
3341,409000438611',2018-12-19,Indiaforensic RUPAY POS C2 ACQ19,0.0,542293.7,715709.3500000135,2018,12,19,TRANSFER,542293.7,C1122118227
3342,409000438611',2018-12-19,ICA 17825 Indiaforensic MC DOM 1,120.89,0.0,715588.4600000135,2018,12,19,PAYEMENT,120.89,C1916720513
3343,409000438611',2018-12-20,TRF TO  Indiaforensic SERVICES I,500000.0,0.0,215588.4600000133,2018,12,20,DEBIT,500000.0,C991505714
3344,409000438611',2018-12-20,ICA 17825 Indiaforensic MC DOM 2,0.0,4163409.55,4378998.010000013,2018,12,20,CASH_IN,4163409.55,C1023714065
3345,409000438611',2018-12-20,TRF TO  Indiaforensic SERVICES I,4000000.0,0.0,378998.0100000128,2018,12,20,PAYEMENT,4000000.0,C977993101
3346,409000438611',2018-12-20,Indiaforensic VISA ACQ DOM201218,0.0,4899447.75,5278445.760000013,2018,12,20,CASH_IN,4899447.75,C11003494
3347,409000438611',2018-12-20,Indiaforensic RUPAY POS ACQ20121,0.0,1704722.12,6983167.880000013,2018,12,20,TRANSFER,1704722.12,C1453128758
3348,409000438611',2018-12-20,Indiaforensic RUPAY POS C2 ACQ20,0.0,873351.9,7856519.780000012,2018,12,20,TRANSFER,873351.9,C1870252780
3349,409000438611',2018-12-20,Indiaforensic VISA ACQ INT 18121,0.0,2819.35,7859339.130000013,2018,12,20,CASH_IN,2819.35,C306206744
3350,409000438611',2018-12-20,TRF TO  Indiaforensic SERVICES I,7800000.0,0.0,59339.13000001293,2018,12,20,PAYEMENT,7800000.0,C909295153
3351,409000438611',2018-12-20,ICA 17825 Indiaforensic MC INT 1,0.0,21903.41,81242.54000001293,2018,12,20,CHECK_CASHING,21903.41,C1899073220
3352,409000438611',2018-12-21,Indiaforensic VISA ACQ DOM211218,0.0,3850979.79,3932222.330000013,2018,12,21,CHECK_CASHING,3850979.79,C909295153
3353,409000438611',2018-12-21,Indiaforensic RUPAY POS ACQ21121,0.0,1498692.61,5430914.940000013,2018,12,21,TRANSFER,1498692.61,C657736958
3354,409000438611',2018-12-21,Indiaforensic VISA ACQ INT 19121,0.0,49031.83,5479946.7700000135,2018,12,21,CASH_IN,49031.83,C248609774
3355,409000438611',2018-12-21,TRF TO  Indiaforensic SERVICES I,5000000.0,0.0,479946.7700000135,2018,12,21,PAYEMENT,5000000.0,C33524623
3356,409000438611',2018-12-21,Indiaforensic RUPAY POS C2 ACQ21,0.0,555897.26,1035844.0300000136,2018,12,21,CHECK_CASHING,555897.26,C985934102
3357,409000438611',2018-12-21,ICA 17825 Indiaforensic MC INT 2,0.0,22689.02,1058533.0500000136,2018,12,21,CHECK_CASHING,22689.02,M2038484780
3358,409000438611',2018-12-21,TRF TO  Indiaforensic SERVICES I,1000000.0,0.0,58533.050000013565,2018,12,21,PAYEMENT,1000000.0,C1750563752
3359,409000438611',2018-12-24,ICA 17825 Indiaforensic MC DOM 2,0.0,3326102.65,3384635.700000013,2018,12,24,CASH_IN,3326102.65,M1447678234
3360,409000438611',2018-12-24,ICA 17825 Indiaforensic MC DOM 2,0.0,7999198.35,11383834.050000012,2018,12,24,TRANSFER,7999198.35,M658781536
3361,409000438611',2018-12-24,TRF TO  Indiaforensic SERVICES I,2000000.0,0.0,9383834.050000012,2018,12,24,CASH_OUT,2000000.0,M629321967
3362,409000438611',2018-12-24,Indiaforensic POS VIS SETTL22121,0.0,3387670.54,12771504.590000013,2018,12,24,CASH_IN,3387670.54,M1989924937
3363,409000438611',2018-12-24,Indiaforensic POS VIS SETTL24121,0.0,6547693.55,19319198.14000001,2018,12,24,CHECK_CASHING,6547693.55,M547973118
3364,409000438611',2018-12-24,Indiaforensic RUP ACQ SETL 22121,0.0,1984011.06,21303209.20000001,2018,12,24,CASH_IN,1984011.06,M1747631271
3365,409000438611',2018-12-24,Indiaforensic RUP ACQ SETL 23121,0.0,2383057.01,23686266.21000001,2018,12,24,CHECK_CASHING,2383057.01,M1995997657
3366,409000438611',2018-12-24,Indiaforensic RUP ACQ SETL 24121,0.0,1849183.91,25535450.12000001,2018,12,24,CHECK_CASHING,1849183.91,M1352743983
3367,409000438611',2018-12-24,Indiaforensic POS INTL SETL 2012,0.0,71980.99,25607431.11000001,2018,12,24,CASH_IN,71980.99,M1405721353
3368,409000438611',2018-12-24,TRF TO  Indiaforensic SERVICES I,1000000.0,0.0,24607431.11000001,2018,12,24,CHECK_WITHDRAWAL,1000000.0,M2082524624
3369,409000438611',2018-12-24,TRF TO  Indiaforensic SERVICES I,15000000.0,0.0,9607431.110000007,2018,12,24,CHECK_WITHDRAWAL,15000000.0,M1802415698
3370,409000438611',2018-12-24,TRF TO  Indiaforensic SERVICES I,2000000.0,0.0,7607431.110000008,2018,12,24,CASH_OUT,2000000.0,M2061552777
3371,409000438611',2018-12-24,TRF TO  Indiaforensic SERVICES I,5000000.0,0.0,2607431.110000007,2018,12,24,PAYEMENT,5000000.0,M333828675
3372,409000438611',2018-12-24,TRF TO  Indiaforensic SERVICES I,2000000.0,0.0,607431.1100000069,2018,12,24,PAYEMENT,2000000.0,M1234654510
3373,409000438611',2018-12-24,TRF TO  Indiaforensic SERVICES I,500000.0,0.0,107431.11000000684,2018,12,24,CHECK_WITHDRAWAL,500000.0,C575335780
3374,409000438611',2018-12-24,ICA 17825 Indiaforensic MC INT 2,0.0,2022.35,109453.46000000686,2018,12,24,CASH_IN,2022.35,M154674411
3375,409000438611',2018-12-24,Indiaforensic RUP ACQ C2 SETL 24,0.0,452738.16,562191.6200000069,2018,12,24,CHECK_CASHING,452738.16,M2009196049
3376,409000438611',2018-12-26,Indiaforensic POS VIS SETTL25121,0.0,3004995.21,3567186.830000006,2018,12,26,CASH_IN,3004995.21,M1519890812
3377,409000438611',2018-12-26,Indiaforensic POS VIS SETTL26121,0.0,2736730.19,6303917.020000008,2018,12,26,CASH_IN,2736730.19,C20671747
3378,409000438611',2018-12-26,Indiaforensic RUP ACQ SETL 25121,0.0,757283.45,7061200.470000007,2018,12,26,TRANSFER,757283.45,C914293025
3379,409000438611',2018-12-26,Indiaforensic RUP ACQ SETL 26121,0.0,2367856.66,9429057.130000006,2018,12,26,CASH_IN,2367856.66,M48522228
3380,409000438611',2018-12-26,Indiaforensic RUP ACQ C2 SETL 26,0.0,344005.99,9773063.120000007,2018,12,26,TRANSFER,344005.99,M917190676
3381,409000438611',2018-12-26,Indiaforensic POS INTL SETL 2112,0.0,30632.36,9803695.480000006,2018,12,26,CASH_IN,30632.36,M190967225
3382,409000438611',2018-12-26,TRF TO  Indiaforensic SERVICES I,5000000.0,0.0,4803695.480000006,2018,12,26,PAYEMENT,5000000.0,M851116146
3383,409000438611',2018-12-26,TRF TO  Indiaforensic SERVICES I,4000000.0,0.0,803695.4800000059,2018,12,26,CASH_OUT,4000000.0,M1115296438
3384,409000438611',2018-12-26,TRF TO  Indiaforensic SERVICES I,500000.0,0.0,303695.48000000603,2018,12,26,PAYEMENT,500000.0,M184017782
3385,409000438611',2018-12-26,ICA 17825 Indiaforensic MC INT 2,0.0,17447.74,321143.220000006,2018,12,26,CHECK_CASHING,17447.74,M1336953458
3386,409000438611',2018-12-27,Indiaforensic POS VIS SETTL27121,0.0,3356693.91,3677837.1300000064,2018,12,27,CHECK_CASHING,3356693.91,M876487258
3387,409000438611',2018-12-27,Indiaforensic RUP ACQ SETL 27121,0.0,1341668.87,5019506.0000000065,2018,12,27,CASH_IN,1341668.87,M1276002922
3388,409000438611',2018-12-27,Indiaforensic POS INTL SETL 2312,0.0,3726.64,5023232.640000006,2018,12,27,CHECK_CASHING,3726.64,C392292416
3389,409000438611',2018-12-27,Indiaforensic POS INTL SETL 2412,0.0,10487.67,5033720.310000006,2018,12,27,CASH_IN,10487.67,M917156101
3390,409000438611',2018-12-27,ICA 17825 Indiaforensic MC DOM 2,0.0,5067750.89,10101471.200000007,2018,12,27,CHECK_CASHING,5067750.89,M254358847
3391,409000438611',2018-12-27,ICA 17825 Indiaforensic MC INT 2,0.0,5810.29,10107281.490000006,2018,12,27,TRANSFER,5810.29,C621014131
3392,409000438611',2018-12-27,ICA 17825 Indiaforensic MC DOM 2,0.0,2308212.13,12415493.620000005,2018,12,27,CASH_IN,2308212.13,C778731861
3393,409000438611',2018-12-27,TRF TO  Indiaforensic SERVICES I,10000000.0,0.0,2415493.620000005,2018,12,27,CHECK_WITHDRAWAL,10000000.0,C20671747
3394,409000438611',2018-12-27,TRF TO  Indiaforensic SERVICES I,2400000.0,0.0,15493.620000004768,2018,12,27,CHECK_WITHDRAWAL,2400000.0,M463313451
3395,409000438611',2018-12-27,Indiaforensic RUP ACQ C2 SETL 27,0.0,434047.3,449540.92000000476,2018,12,27,TRANSFER,434047.3,M400216879
3396,409000438611',2018-12-27,ICA 17825 Indiaforensic MC DOM 2,42665.53,0.0,406875.3900000048,2018,12,27,CASH_OUT,42665.53,M248705782
3397,409000438611',2018-12-28,ICA 17825 Indiaforensic MC DOM 2,0.0,2196351.65,2603227.0400000047,2018,12,28,TRANSFER,2196351.65,M1323996324
3398,409000438611',2018-12-28,FDRL/INTERNAL FUND TRANSFE,1000000.0,0.0,1603227.0400000047,2018,12,28,DEBIT,1000000.0,M1710491273
3399,409000438611',2018-12-28,FDRL/INTERNAL FUND TRANSFE,500000.0,0.0,1103227.040000005,2018,12,28,PAYEMENT,500000.0,C1810132623
3400,409000438611',2018-12-28,FDRL/INTERNAL FUND TRANSFE,1000000.0,0.0,103227.04000000472,2018,12,28,CHECK_WITHDRAWAL,1000000.0,M260727363
3401,409000438611',2018-12-28,Indiaforensic POS VIS SETTL28121,18786.1,0.0,84440.94000000469,2018,12,28,PAYEMENT,18786.1,M388489274
3402,409000438611',2018-12-28,Indiaforensic RUP ACQ SETL 28121,0.0,1203089.3,1287530.2400000046,2018,12,28,CHECK_CASHING,1203089.3,M601520619
3403,409000438611',2018-12-28,Indiaforensic RUP ACQ C2 SETL 28,0.0,307124.32,1594654.5600000047,2018,12,28,CASH_IN,307124.32,M1040537707
3404,409000438611',2018-12-28,Indiaforensic POS INTL SETL 2512,0.0,325.83,1594980.3900000048,2018,12,28,CHECK_CASHING,325.83,C790722099
3405,409000438611',2018-12-28,Indiaforensic POS INTL SETL 2612,0.0,1059.68,1596040.0700000047,2018,12,28,TRANSFER,1059.68,M167146668
3406,409000438611',2018-12-28,FDRL/INTERNAL FUND TRANSFE,500000.0,0.0,1096040.070000005,2018,12,28,PAYEMENT,500000.0,M600554759
3407,409000438611',2018-12-28,FDRL/INTERNAL FUND TRANSFE,1000000.0,0.0,96040.07000000472,2018,12,28,PAYEMENT,1000000.0,M2120404899
3408,409000438611',2018-12-28,ICA 17825 Indiaforensic MC INT 2,0.0,18610.44,114650.51000000472,2018,12,28,CHECK_CASHING,18610.44,M943472307
3409,409000438611',2018-12-29,Indiaforensic POS VIS SETTL29121,0.0,6604502.51,6719153.020000004,2018,12,29,CHECK_CASHING,6604502.51,M1214032527
3410,409000438611',2018-12-29,Indiaforensic RUP ACQ SETL 29121,0.0,669731.46,7388884.480000004,2018,12,29,CASH_IN,669731.46,M1541427914
3411,409000438611',2018-12-29,FDRL/INTERNAL FUND TRANSFE,1000000.0,0.0,6388884.480000004,2018,12,29,DEBIT,1000000.0,M228756739
3412,409000438611',2018-12-29,FDRL/INTERNAL FUND TRANSFE,1000000.0,0.0,5388884.480000004,2018,12,29,CHECK_WITHDRAWAL,1000000.0,M1469235340
3413,409000438611',2018-12-29,FDRL/INTERNAL FUND TRANSFE,1000000.0,0.0,4388884.480000004,2018,12,29,DEBIT,1000000.0,M1422271143
3414,409000438611',2018-12-29,FDRL/INTERNAL FUND TRANSFE,1000000.0,0.0,3388884.4800000037,2018,12,29,PAYEMENT,1000000.0,M1994634331
3415,409000438611',2018-12-29,FDRL/INTERNAL FUND TRANSFE,1000000.0,0.0,2388884.480000004,2018,12,29,PAYEMENT,1000000.0,M1963080787
3416,409000438611',2018-12-29,FDRL/INTERNAL FUND TRANSFE,1000000.0,0.0,1388884.4800000042,2018,12,29,CHECK_WITHDRAWAL,1000000.0,M229318537
3417,409000438611',2018-12-29,FDRL/INTERNAL FUND TRANSFE,1000000.0,0.0,388884.48000000406,2018,12,29,DEBIT,1000000.0,M1578365270
3418,409000438611',2018-12-29,Indiaforensic RUP ACQ C2 SETL 29,0.0,1272855.2,1661739.6800000041,2018,12,29,CHECK_CASHING,1272855.2,M1678557259
3419,409000438611',2018-12-31,FDRL/INTERNAL FUND TRANSFE,1000000.0,0.0,661739.680000004,2018,12,31,PAYEMENT,1000000.0,M584262389
3420,409000438611',2018-12-31,FDRL/INTERNAL FUND TRANSFE,500000.0,0.0,161739.68000000413,2018,12,31,PAYEMENT,500000.0,M1730371851
3421,409000438611',2018-12-31,ICA 17825 Indiaforensic MC DOM 2,0.0,6378574.93,6540314.610000004,2018,12,31,CHECK_CASHING,6378574.93,M1625258377
3422,409000438611',2018-12-31,Indiaforensic POS VIS SETTL31121,0.0,5371589.67,11911904.280000005,2018,12,31,TRANSFER,5371589.67,M115740440
3423,409000438611',2018-12-31,Indiaforensic RUP ACQ SETL 30121,0.0,1526611.51,13438515.790000005,2018,12,31,CASH_IN,1526611.51,M1206931021
3424,409000438611',2018-12-31,Indiaforensic RUP ACQ SETL 31121,0.0,1417714.74,14856230.530000005,2018,12,31,CASH_IN,1417714.74,M59298126
3425,409000438611',2018-12-31,Indiaforensic POS INTL SETL 2712,0.0,47423.75,14903654.280000005,2018,12,31,CHECK_CASHING,47423.75,M1502843539
3426,409000438611',2018-12-31,FDRL/INTERNAL FUND TRANSFE,5000000.0,0.0,9903654.280000003,2018,12,31,CHECK_WITHDRAWAL,5000000.0,M762628123
3427,409000438611',2018-12-31,FDRL/INTERNAL FUND TRANSFE,1000000.0,0.0,8903654.280000005,2018,12,31,PAYEMENT,1000000.0,M1442089085
3428,409000438611',2018-12-31,FDRL/INTERNAL FUND TRANSFE,5000000.0,0.0,3903654.280000005,2018,12,31,CASH_OUT,5000000.0,M767312012
3429,409000438611',2018-12-31,FDRL/INTERNAL FUND TRANSFE,500000.0,0.0,3403654.280000005,2018,12,31,CHECK_WITHDRAWAL,500000.0,M2027363825
3430,409000438611',2018-12-31,FDRL/INTERNAL FUND TRANSFE,1000000.0,0.0,2403654.280000005,2018,12,31,CHECK_WITHDRAWAL,1000000.0,M178019189
3431,409000438611',2018-12-31,FDRL/INTERNAL FUND TRANSFE,1000000.0,0.0,1403654.280000005,2018,12,31,DEBIT,1000000.0,M1303122461
3432,409000438611',2018-12-31,FDRL/INTERNAL FUND TRANSFE,1000000.0,0.0,403654.2800000049,2018,12,31,CHECK_WITHDRAWAL,1000000.0,M1042874081
3433,409000438611',2018-12-31,Indiaforensic RUP ACQ C2 SETL 31,0.0,402262.7,805916.9800000049,2018,12,31,TRANSFER,402262.7,M993208674
3434,409000438611',2018-12-31,FDRL/INTERNAL FUND TRANSFE,500000.0,0.0,305916.98000000487,2018,12,31,CASH_OUT,500000.0,M779876279
3435,409000493210',2018-01-16,FDRL/INTERNAL FUND TRANSFE,0.0,200000.0,798965.0,2018,1,16,CHECK_CASHING,200000.0,C1668376627
3436,409000493210',2018-02-07,FDRL/INTERNAL FUND TRANSFE,0.0,300000.0,1098965.0,2018,2,7,CHECK_CASHING,300000.0,C1135523296
3437,409000493210',2018-02-07,FDRL/INTERNAL FUND TRANSFE,0.0,300000.0,1398965.0,2018,2,7,TRANSFER,300000.0,M1159329398
3438,409000493210',2018-02-15,FDRL/INTERNAL FUND TRANSFE,0.0,15000000.0,16398965.0,2018,2,15,CASH_IN,15000000.0,M899068489
3439,409000493210',2018-02-15,FDRL/INTERNAL FUND TRANSFE,0.0,15000000.0,31398965.0,2018,2,15,CHECK_CASHING,15000000.0,C1318822808
3440,409000493210',2018-02-15,FDRL/INTERNAL FUND TRANSFE,0.0,6647330.4,38046295.4,2018,2,15,CASH_IN,6647330.4,C991505714
3441,409000493210',2018-02-15,FDRL/INTERNAL FUND TRANSFE,0.0,15000000.0,53046295.4,2018,2,15,TRANSFER,15000000.0,M1680794780
3442,409000493210',2018-02-15,FDRL/INTERNAL FUND TRANSFE,0.0,15000000.0,68046295.4,2018,2,15,CASH_IN,15000000.0,M1771084820
3443,409000493210',2018-02-16,TRF TO  Indiaforensic SERVICES I,5000000.0,0.0,63046295.40000001,2018,2,16,PAYEMENT,5000000.0,M1310871029
3444,409000493210',2018-02-16,TRF TO  Indiaforensic SERVICES I,15000000.0,0.0,48046295.40000001,2018,2,16,DEBIT,15000000.0,M1599612880
3445,409000493210',2018-02-16,TRF TO  Indiaforensic SERVICES I,15000000.0,0.0,33046295.40000001,2018,2,16,CASH_OUT,15000000.0,M70482685
3446,409000493210',2018-02-16,TRF TO  Indiaforensic SERVICES I,15000000.0,0.0,18046295.400000006,2018,2,16,PAYEMENT,15000000.0,M66747889
3447,409000493210',2018-02-17,TRF TO  Indiaforensic SERVICES I,14000000.0,0.0,4046295.4000000064,2018,2,17,CHECK_WITHDRAWAL,14000000.0,M1377992370
3448,409000493210',2018-02-19,TRF FRM  Indiaforensic SERVICES,0.0,350000.0,4396295.400000006,2018,2,19,CASH_IN,350000.0,M169110289
3449,409000493210',2018-02-22,TRF TO  Indiaforensic SERVICES I,2647330.0,0.0,1748965.400000006,2018,2,22,DEBIT,2647330.0,C1183572822
3450,409000493210',2018-03-07,FDRL/INTERNAL FUND TRANSFE,0.0,300000.0,2048965.400000006,2018,3,7,TRANSFER,300000.0,M416285645
3451,409000493210',2018-03-07,FDRL/INTERNAL FUND TRANSFE,0.0,300000.0,2348965.400000006,2018,3,7,TRANSFER,300000.0,M581770158
3452,409000493210',2018-03-07,FDRL/INTERNAL FUND TRANSFE,0.0,300000.0,2648965.400000006,2018,3,7,TRANSFER,300000.0,M1505774574
3453,409000493210',2018-03-07,FDRL/INTERNAL FUND TRANSFE,0.0,300000.0,2948965.4000000064,2018,3,7,TRANSFER,300000.0,M254416915
3454,409000493210',2018-03-07,FDRL/INTERNAL FUND TRANSFE,0.0,300000.0,3248965.4000000064,2018,3,7,CASH_IN,300000.0,M582857168
3455,409000493210',2018-03-07,FDRL/INTERNAL FUND TRANSFE,0.0,300000.0,3548965.4000000064,2018,3,7,CHECK_CASHING,300000.0,M948315053
3456,409000493210',2018-03-07,FDRL/INTERNAL FUND TRANSFE,0.0,300000.0,3848965.4000000064,2018,3,7,CASH_IN,300000.0,C490150701
3457,409000493210',2018-03-12,TRF FROM  Indiaforensic SERVICES,0.0,220000.0,4068965.4000000064,2018,3,12,TRANSFER,220000.0,M998458782
3458,409000493210',2018-03-14,TRF TO  Indiaforensic SERVICES I,3000000.0,0.0,1068965.400000006,2018,3,14,CASH_OUT,3000000.0,M1095731113
3459,409000493210',2018-03-22,FDRL/INTERNAL FUND TRANSFE,0.0,200000.0,1268965.400000006,2018,3,22,CHECK_CASHING,200000.0,M1020421154
3460,409000493210',2018-04-05,TRF TO  Indiaforensic SERVICES I,200000.0,0.0,1068965.400000006,2018,4,5,CASH_OUT,200000.0,M1067588937
3461,409000493210',2018-04-05,TRF FROM  Indiaforensic SERVICES,0.0,135801.0,1204766.400000006,2018,4,5,CHECK_CASHING,135801.0,M1848760713
3462,409000493210',2018-04-10,TRF FROM  Indiaforensic SERVICES,0.0,240000.0,1444766.400000006,2018,4,10,CHECK_CASHING,240000.0,M785848103
3463,409000493210',2018-04-11,TRF FROM  Indiaforensic SERVICES,0.0,1935500.0,3380266.4000000064,2018,4,11,CASH_IN,1935500.0,M1706779253
3464,409000493210',2018-04-27,TRF TO  Indiaforensic SERVICES I,3000000.0,0.0,380266.400000006,2018,4,27,CHECK_WITHDRAWAL,3000000.0,M1923232046
3465,409000493210',2018-05-18,TRF FROM  Indiaforensic SERVICES,0.0,1690492.0,2070758.400000006,2018,5,18,CASH_IN,1690492.0,M2035401634
3466,409000493210',2018-05-18,FDRL/INTERNAL FUND TRANSFE,0.0,100000.0,2170758.400000006,2018,5,18,TRANSFER,100000.0,M756126725
3467,409000493210',2018-05-18,FDRL/INTERNAL FUND TRANSFE,0.0,100000.0,2270758.400000006,2018,5,18,CHECK_CASHING,100000.0,M542641486
3468,409000493210',2018-05-18,FDRL/INTERNAL FUND TRANSFE,0.0,200000.0,2470758.400000006,2018,5,18,CASH_IN,200000.0,C1017997535
3469,409000493210',2018-05-18,FDRL/INTERNAL FUND TRANSFE,0.0,200000.0,2670758.400000006,2018,5,18,CASH_IN,200000.0,M1262693971
3470,409000493210',2018-05-18,FDRL/INTERNAL FUND TRANSFE,0.0,200000.0,2870758.4000000064,2018,5,18,CASH_IN,200000.0,M1659969211
3471,409000493210',2018-05-18,FDRL/INTERNAL FUND TRANSFE,0.0,200000.0,3070758.4000000064,2018,5,18,CHECK_CASHING,200000.0,M1477431915
3472,409000493210',2018-05-18,FDRL/INTERNAL FUND TRANSFE,0.0,200000.0,3270758.4000000064,2018,5,18,TRANSFER,200000.0,M311487784
3473,409000493210',2018-05-18,FDRL/INTERNAL FUND TRANSFE,0.0,200000.0,3470758.4000000064,2018,5,18,CASH_IN,200000.0,C451111351
3474,409000493210',2018-05-18,FDRL/INTERNAL FUND TRANSFE,0.0,300000.0,3770758.4000000064,2018,5,18,CHECK_CASHING,300000.0,M1442707449
3475,409000493210',2018-05-18,FDRL/INTERNAL FUND TRANSFE,0.0,200000.0,3970758.4000000064,2018,5,18,TRANSFER,200000.0,M688197093
3476,409000493210',2018-05-18,FDRL/INTERNAL FUND TRANSFE,0.0,200000.0,4170758.4000000064,2018,5,18,CHECK_CASHING,200000.0,M208181619
3477,409000493210',2018-05-19,Indiaforensic  RUPAY SETT 190518,4285.44,0.0,4166472.9600000083,2018,5,19,DEBIT,4285.44,M1074868579
3478,409000493210',2018-05-19,Indiaforensic  RUPAY SETT 190518,896.42,0.0,4165576.540000006,2018,5,19,DEBIT,896.42,M969432090
3479,409000493210',2018-05-21,Indiaforensic RUPAY SETT 200518,4454.41,0.0,4161122.1300000064,2018,5,21,CASH_OUT,4454.41,M1657218305
3480,409000493210',2018-05-21,Indiaforensic RUPAY SETT 210518,13951.0,0.0,4147171.1300000064,2018,5,21,PAYEMENT,13951.0,M2010856706
3481,409000493210',2018-05-21,Indiaforensic RUPAY SETT 210518-,20.71,0.0,4147150.4200000064,2018,5,21,DEBIT,20.71,M602748972
3482,409000493210',2018-05-22,Indiaforensic  RUPAY SETT 220518,0.0,750.35,4147900.770000006,2018,5,22,CHECK_CASHING,750.35,M1165023158
3483,409000493210',2018-05-22,Indiaforensic  RUPAY SETT 220518,46.71,0.0,4147854.060000006,2018,5,22,DEBIT,46.71,M944826636
3484,409000493210',2018-05-22,OXYGEN NFS SETT 21-05-201,200.0,0.0,4147654.060000006,2018,5,22,PAYEMENT,200.0,M2123492724
3485,409000493210',2018-05-22,OXYGEN NFS SETT 21-05-201,2000.0,0.0,4145654.060000006,2018,5,22,DEBIT,2000.0,M132065521
3486,409000493210',2018-05-23,OXYGEN NFS SETT 23-05-201,100.0,0.0,4145554.060000006,2018,5,23,PAYEMENT,100.0,M831285461
3487,409000493210',2018-05-23,OXYGEN NFS SETT 23-05-201,1000.0,0.0,4144554.060000006,2018,5,23,CHECK_WITHDRAWAL,1000.0,M840737335
3488,409000493210',2018-05-23,Indiaforensic  RUPAY SETT 230518,1204.25,0.0,4143349.810000006,2018,5,23,CASH_OUT,1204.25,M516040753
3489,409000493210',2018-05-23,Indiaforensic  RUPAY SETT 230518,211.42,0.0,4143138.390000006,2018,5,23,PAYEMENT,211.42,M1365611185
3490,409000493210',2018-05-24,OXYGEN NFS SETT 24-05-201,3500.0,0.0,4139638.390000006,2018,5,24,CASH_OUT,3500.0,M1131673199
3491,409000493210',2018-05-24,OXYGEN NFS SETT 24-05-201,6500.0,0.0,4133138.390000006,2018,5,24,DEBIT,6500.0,M1141984159
3492,409000493210',2018-05-24,OXYGEN NFS SETT 24-05-201,4000.0,0.0,4129138.390000006,2018,5,24,CHECK_WITHDRAWAL,4000.0,M706960270
3493,409000493210',2018-05-24,OXYGEN NFS SETT 24-05-201,1000.0,0.0,4128138.390000006,2018,5,24,PAYEMENT,1000.0,M953191605
3494,409000493210',2018-05-24,OXYGEN NFS SETT 24-05-201,300.0,0.0,4127838.390000006,2018,5,24,CASH_OUT,300.0,M116650158
3495,409000493210',2018-05-24,Indiaforensic  RUPAY SETT 240518,2218.3,0.0,4125620.0900000064,2018,5,24,PAYEMENT,2218.3,M1470540083
3496,409000493210',2018-05-24,Indiaforensic  RUPAY SETT 240518,121.71,0.0,4125498.3800000064,2018,5,24,CHECK_WITHDRAWAL,121.71,M422882684
3497,409000493210',2018-05-25,Indiaforensic  RUPAY SETT 250518,1636.08,0.0,4123862.3000000063,2018,5,25,CHECK_WITHDRAWAL,1636.08,M1772780918
3498,409000493210',2018-05-25,Indiaforensic  RUPAY SETT 250518,591.12,0.0,4123271.180000006,2018,5,25,DEBIT,591.12,M252864198
3499,409000493210',2018-05-25,OXYGEN NFS SETT 24-05-201,400.0,0.0,4122871.180000006,2018,5,25,DEBIT,400.0,M65567135
3500,409000493210',2018-05-25,OXYGEN NFS SETT 24-05-201,500.0,0.0,4122371.180000006,2018,5,25,PAYEMENT,500.0,M655180711
3501,409000493210',2018-05-25,OXYGEN NFS SETT 24-05-201,5000.0,0.0,4117371.180000006,2018,5,25,DEBIT,5000.0,M1103934393
3502,409000493210',2018-05-25,OXYGEN NFS SETT 24-05-201,500.0,0.0,4116871.180000006,2018,5,25,CASH_OUT,500.0,M512029640
3503,409000493210',2018-05-25,OXYGEN NFS SETT 24-05-201,700.0,0.0,4116171.180000006,2018,5,25,CHECK_WITHDRAWAL,700.0,M2066533285
3504,409000493210',2018-05-25,OXYGEN NFS SETT 24-05-201,1500.0,0.0,4114671.180000006,2018,5,25,PAYEMENT,1500.0,M1566200241
3505,409000493210',2018-05-25,OXYGEN NFS SETT 24-05-201,500.0,0.0,4114171.180000006,2018,5,25,PAYEMENT,500.0,M1353406178
3506,409000493210',2018-05-28,Indiaforensic RUPAY SETT 260518,1352.71,0.0,4112818.4700000063,2018,5,28,CHECK_WITHDRAWAL,1352.71,M1954761469
3507,409000493210',2018-05-28,Indiaforensic RUPAY SETT 270518,3522.18,0.0,4109296.290000006,2018,5,28,PAYEMENT,3522.18,M222927891
3508,409000493210',2018-05-28,Indiaforensic RUPAY SETT 280518,7232.58,0.0,4102063.7100000083,2018,5,28,PAYEMENT,7232.58,M1121370413
3509,409000493210',2018-05-29,OXYGEN NFS SETT 28-05-201,300.0,0.0,4101763.7100000083,2018,5,29,CHECK_WITHDRAWAL,300.0,M2049620066
3510,409000493210',2018-05-29,OXYGEN NFS SETT 28-05-201,300.0,0.0,4101463.7100000083,2018,5,29,CASH_OUT,300.0,C173783788
3511,409000493210',2018-05-29,OXYGEN NFS SETT 28-05-201,100.0,0.0,4101363.7100000083,2018,5,29,PAYEMENT,100.0,M1825228532
3512,409000493210',2018-05-29,OXYGEN NFS SETT 28-05-201,1000.0,0.0,4100363.7100000083,2018,5,29,CHECK_WITHDRAWAL,1000.0,M877898962
3513,409000493210',2018-05-29,OXYGEN NFS SETT 28-05-201,200.0,0.0,4100163.7100000083,2018,5,29,CASH_OUT,200.0,M1456006896
3514,409000493210',2018-05-29,OXYGEN NFS SETT 28-05-201,1000.0,0.0,4099163.7100000083,2018,5,29,PAYEMENT,1000.0,M1487540468
3515,409000493210',2018-05-29,OXYGEN NFS SETT 28-05-201,2000.0,0.0,4097163.7100000083,2018,5,29,CHECK_WITHDRAWAL,2000.0,C1397643446
3516,409000493210',2018-05-29,OXYGEN NFS SETT 28-05-201,2000.0,0.0,4095163.7100000083,2018,5,29,PAYEMENT,2000.0,C451111351
3517,409000493210',2018-05-29,OXYGEN NFS SETT 28-05-201,1000.0,0.0,4094163.7100000083,2018,5,29,DEBIT,1000.0,C1182461167
3518,409000493210',2018-05-29,OXYGEN NFS SETT 28-05-201,100.0,0.0,4094063.7100000083,2018,5,29,PAYEMENT,100.0,C1321640594
3519,409000493210',2018-05-29,OXYGEN NFS SETT 28-05-201,1000.0,0.0,4093063.7100000083,2018,5,29,CASH_OUT,1000.0,M1916303325
3520,409000493210',2018-05-29,OXYGEN NFS SETT 25-05-18,500.0,0.0,4092563.7100000083,2018,5,29,CHECK_WITHDRAWAL,500.0,M1456250665
3521,409000493210',2018-05-29,OXYGEN NFS SETT 25-05-18,1000.0,0.0,4091563.7100000083,2018,5,29,CASH_OUT,1000.0,C655381473
3522,409000493210',2018-05-29,OXYGEN NFS SETT 25-05-18,500.0,0.0,4091063.7100000083,2018,5,29,CHECK_WITHDRAWAL,500.0,M1419958638
3523,409000493210',2018-05-29,OXYGEN NFS SETT 25-05-18,300.0,0.0,4090763.7100000083,2018,5,29,PAYEMENT,300.0,M1830984476
3524,409000493210',2018-05-29,OXYGEN NFS SETT 25-05-18,200.0,0.0,4090563.7100000083,2018,5,29,DEBIT,200.0,M766089249
3525,409000493210',2018-05-29,OXYGEN NFS SETT 25-05-18,100.0,0.0,4090463.7100000083,2018,5,29,PAYEMENT,100.0,C1240730624
3526,409000493210',2018-05-29,OXYGEN NFS SETT 25-05-18,3000.0,0.0,4087463.7100000083,2018,5,29,DEBIT,3000.0,M1713365029
3527,409000493210',2018-05-29,OXYGEN NFS SETT 25-05-18,1200.0,0.0,4086263.7100000083,2018,5,29,CHECK_WITHDRAWAL,1200.0,M955153053
3528,409000493210',2018-05-29,OXYGEN NFS SETT 25-05-18,1100.0,0.0,4085163.7100000083,2018,5,29,DEBIT,1100.0,M2065587797
3529,409000493210',2018-05-29,OXYGEN NFS SETT 25-05-18,2300.0,0.0,4082863.7100000083,2018,5,29,CASH_OUT,2300.0,M124581953
3530,409000493210',2018-05-29,OXYGEN NFS SETT 25-05-18,1000.0,0.0,4081863.7100000083,2018,5,29,PAYEMENT,1000.0,M546936087
3531,409000493210',2018-05-29,OXYGEN NFS SETT 25-05-18,3400.0,0.0,4078463.7100000083,2018,5,29,CASH_OUT,3400.0,C1380361139
3532,409000493210',2018-05-29,OXYGEN NFS SETT 26-05-18,2000.0,0.0,4076463.7100000083,2018,5,29,DEBIT,2000.0,C1211297851
3533,409000493210',2018-05-29,OXYGEN NFS SETT 26-05-18,500.0,0.0,4075963.7100000083,2018,5,29,PAYEMENT,500.0,M1201324747
3534,409000493210',2018-05-29,OXYGEN NFS SETT 26-05-18,1000.0,0.0,4074963.7100000083,2018,5,29,CHECK_WITHDRAWAL,1000.0,C1360393616
3535,409000493210',2018-05-29,OXYGEN NFS SETT 26-05-18,400.0,0.0,4074563.7100000083,2018,5,29,CHECK_WITHDRAWAL,400.0,M1086017415
3536,409000493210',2018-05-29,OXYGEN NFS SETT 26-05-18,600.0,0.0,4073963.7100000083,2018,5,29,PAYEMENT,600.0,M390010388
3537,409000493210',2018-05-29,OXYGEN NFS SETT 26-05-18,600.0,0.0,4073363.7100000083,2018,5,29,CHECK_WITHDRAWAL,600.0,M1984294974
3538,409000493210',2018-05-29,OXYGEN NFS SETT 26-05-18,1000.0,0.0,4072363.7100000083,2018,5,29,DEBIT,1000.0,M2054071421
3539,409000493210',2018-05-29,OXYGEN NFS SETT 26-05-18,400.0,0.0,4071963.7100000083,2018,5,29,DEBIT,400.0,M229581552
3540,409000493210',2018-05-29,OXYGEN NFS SETT 26-05-18,1500.0,0.0,4070463.7100000083,2018,5,29,CASH_OUT,1500.0,C990355670
3541,409000493210',2018-05-29,OXYGEN NFS SETT 26-05-18,200.0,0.0,4070263.7100000083,2018,5,29,CASH_OUT,200.0,M552260985
3542,409000493210',2018-05-29,OXYGEN NFS SETT 26-05-18,1300.0,0.0,4068963.7100000083,2018,5,29,CASH_OUT,1300.0,C248609774
3543,409000493210',2018-05-29,OXYGEN NFS SETT 26-05-18,1000.0,0.0,4067963.7100000083,2018,5,29,PAYEMENT,1000.0,C1017997535
3544,409000493210',2018-05-29,OXYGEN NFS SETT 26-05-18,200.0,0.0,4067763.7100000083,2018,5,29,DEBIT,200.0,C542895457
3545,409000493210',2018-05-29,OXYGEN NFS SETT 27-05-18,1000.0,0.0,4066763.7100000083,2018,5,29,PAYEMENT,1000.0,C1335050193
3546,409000493210',2018-05-29,OXYGEN NFS SETT 27-05-18,10000.0,0.0,4056763.7100000083,2018,5,29,DEBIT,10000.0,M726483751
3547,409000493210',2018-05-29,OXYGEN NFS SETT 27-05-18,500.0,0.0,4056263.7100000083,2018,5,29,PAYEMENT,500.0,M1730062079
3548,409000493210',2018-05-29,OXYGEN NFS SETT 27-05-18,3000.0,0.0,4053263.7100000083,2018,5,29,CASH_OUT,3000.0,C1832532108
3549,409000493210',2018-05-29,OXYGEN NFS SETT 27-05-18,500.0,0.0,4052763.7100000083,2018,5,29,PAYEMENT,500.0,M453940999
3550,409000493210',2018-05-29,OXYGEN NFS SETT 27-05-18,1500.0,0.0,4051263.7100000083,2018,5,29,PAYEMENT,1500.0,M121644275
3551,409000493210',2018-05-29,OXYGEN NFS SETT 27-05-18,500.0,0.0,4050763.7100000083,2018,5,29,DEBIT,500.0,M251074782
3552,409000493210',2018-05-29,OXYGEN NFS SETT 27-05-18,100.0,0.0,4050663.7100000083,2018,5,29,CHECK_WITHDRAWAL,100.0,C173783788
3553,409000493210',2018-05-29,OXYGEN NFS SETT 27-05-18,200.0,0.0,4050463.7100000083,2018,5,29,CASH_OUT,200.0,C481402298
3554,409000493210',2018-05-29,OXYGEN NFS SETT 27-05-18,500.0,0.0,4049963.7100000083,2018,5,29,CHECK_WITHDRAWAL,500.0,C173783788
3555,409000493210',2018-05-29,OXYGEN NFS SETT 27-05-18,300.0,0.0,4049663.7100000083,2018,5,29,CHECK_WITHDRAWAL,300.0,C885951223
3556,409000493210',2018-05-29,OXYGEN NFS SETT 27-05-18,100.0,0.0,4049563.7100000083,2018,5,29,CHECK_WITHDRAWAL,100.0,C995911260
3557,409000493210',2018-05-29,OXYGEN NFS SETT 27-05-18,100.0,0.0,4049463.7100000083,2018,5,29,DEBIT,100.0,C1916720513
3558,409000493210',2018-05-29,OXYGEN NFS SETT 27-05-18,2000.0,0.0,4047463.7100000083,2018,5,29,PAYEMENT,2000.0,C306206744
3559,409000493210',2018-05-29,OXYGEN NFS SETT 27-05-18,500.0,0.0,4046963.7100000083,2018,5,29,DEBIT,500.0,C1916720513
3560,409000493210',2018-05-29,OXYGEN NFS SETT 27-05-18,500.0,0.0,4046463.7100000083,2018,5,29,CASH_OUT,500.0,C909295153
3561,409000493210',2018-05-29,OXYGEN NFS SETT 27-05-18,500.0,0.0,4045963.7100000083,2018,5,29,CASH_OUT,500.0,C1899073220
3562,409000493210',2018-05-29,Indiaforensic  RUPAY SETT 290518,3324.08,0.0,4042639.6300000064,2018,5,29,DEBIT,3324.08,C306206744
3563,409000493210',2018-05-29,Indiaforensic  RUPAY SETT 290518,110.71,0.0,4042528.9200000064,2018,5,29,DEBIT,110.71,C1538745405
3564,409000493210',2018-05-30,FDRL/INTERNAL FUND TRANSFE,0.0,100000.0,4142528.9200000064,2018,5,30,CHECK_CASHING,100000.0,C306206744
3565,409000493210',2018-05-30,OXYGEN NFS SETT 29-05-201,400.0,0.0,4142128.9200000064,2018,5,30,DEBIT,400.0,C985934102
3566,409000493210',2018-05-30,OXYGEN NFS SETT 29-05-201,1500.0,0.0,4140628.9200000064,2018,5,30,CASH_OUT,1500.0,C2083562754
3567,409000493210',2018-05-30,OXYGEN NFS SETT 29-05-201,200.0,0.0,4140428.9200000064,2018,5,30,DEBIT,200.0,C977993101
3568,409000493210',2018-05-30,OXYGEN NFS SETT 29-05-201,300.0,0.0,4140128.9200000064,2018,5,30,DEBIT,300.0,C1916720513
3569,409000493210',2018-05-30,OXYGEN NFS SETT 29-05-201,1400.0,0.0,4138728.9200000064,2018,5,30,DEBIT,1400.0,C1789550256
3570,409000493210',2018-05-30,OXYGEN NFS SETT 29-05-201,1000.0,0.0,4137728.9200000064,2018,5,30,PAYEMENT,1000.0,C453211571
3571,409000493210',2018-05-30,OXYGEN NFS SETT 29-05-201,300.0,0.0,4137428.9200000064,2018,5,30,PAYEMENT,300.0,C2134357721
3572,409000493210',2018-05-30,Indiaforensic  RUPAY SETT 300518,640.58,0.0,4136788.3400000064,2018,5,30,CHECK_WITHDRAWAL,640.58,C2083562754
3573,409000493210',2018-05-31,OXYGEN NFS SETT 30-05-201,500.0,0.0,4136288.3400000064,2018,5,31,DEBIT,500.0,C1899073220
3574,409000493210',2018-05-31,OXYGEN NFS SETT 30-05-201,1300.0,0.0,4134988.3400000064,2018,5,31,CASH_OUT,1300.0,C665576141
3575,409000493210',2018-05-31,OXYGEN NFS SETT 30-05-201,2000.0,0.0,4132988.3400000064,2018,5,31,PAYEMENT,2000.0,M511646132
3576,409000493210',2018-05-31,OXYGEN NFS SETT 30-05-201,1000.0,0.0,4131988.3400000064,2018,5,31,DEBIT,1000.0,M70543368
3577,409000493210',2018-05-31,OXYGEN NFS SETT 30-05-201,1000.0,0.0,4130988.3400000064,2018,5,31,DEBIT,1000.0,C173783788
3578,409000493210',2018-05-31,OXYGEN NFS SETT 30-05-201,2500.0,0.0,4128488.3400000064,2018,5,31,PAYEMENT,2500.0,C187649742
3579,409000493210',2018-05-31,OXYGEN NFS SETT 30-05-201,8000.0,0.0,4120488.3400000064,2018,5,31,PAYEMENT,8000.0,C716157500
3580,409000493210',2018-05-31,OXYGEN NFS SETT 30-05-201,10000.0,0.0,4110488.3400000064,2018,5,31,DEBIT,10000.0,C1877453512
3581,409000493210',2018-05-31,OXYGEN NFS SETT 30-05-201,200.0,0.0,4110288.3400000064,2018,5,31,PAYEMENT,200.0,M1768142988
3582,409000493210',2018-05-31,OXYGEN NFS SETT 30-05-201,3300.0,0.0,4106988.3400000064,2018,5,31,DEBIT,3300.0,M1424243710
3583,409000493210',2018-05-31,OXYGEN NFS SETT 30-05-201,2500.0,0.0,4104488.3400000064,2018,5,31,CHECK_WITHDRAWAL,2500.0,M1681423383
3584,409000493210',2018-05-31,OXYGEN NFS SETT 30-05-201,200.0,0.0,4104288.3400000064,2018,5,31,CHECK_WITHDRAWAL,200.0,M167275971
3585,409000493210',2018-05-31,OXYGEN NFS SETT 30-05-201,200.0,0.0,4104088.3400000064,2018,5,31,DEBIT,200.0,M1714317354
3586,409000493210',2018-05-31,Indiaforensic  RUPAY SETT 310518,2118.42,0.0,4101969.9200000064,2018,5,31,PAYEMENT,2118.42,M1688151539
3587,409000493210',2018-05-31,Indiaforensic  RUPAY SETT 310518,411.42,0.0,4101558.500000006,2018,5,31,DEBIT,411.42,C726762476
3588,409000493210',2018-06-01,OXYGEN NFS SETT 31-05-201,400.0,0.0,4101158.500000006,2018,6,1,DEBIT,400.0,M200760156
3589,409000493210',2018-06-01,OXYGEN NFS SETT 31-05-201,9000.0,0.0,4092158.500000006,2018,6,1,PAYEMENT,9000.0,C1674899618
3590,409000493210',2018-06-01,OXYGEN NFS SETT 31-05-201,100.0,0.0,4092058.500000006,2018,6,1,DEBIT,100.0,C1823014131
3591,409000493210',2018-06-01,OXYGEN NFS SETT 31-05-201,3500.0,0.0,4088558.500000006,2018,6,1,CHECK_WITHDRAWAL,3500.0,C173783788
3592,409000493210',2018-06-01,OXYGEN NFS SETT 31-05-201,8000.0,0.0,4080558.500000006,2018,6,1,DEBIT,8000.0,C13329486
3593,409000493210',2018-06-01,OXYGEN NFS SETT 31-05-201,600.0,0.0,4079958.500000006,2018,6,1,CASH_OUT,600.0,M848343462
3594,409000493210',2018-06-01,OXYGEN NFS SETT 31-05-201,500.0,0.0,4079458.500000006,2018,6,1,PAYEMENT,500.0,M1740571776
3595,409000493210',2018-06-01,OXYGEN NFS SETT 31-05-201,1000.0,0.0,4078458.500000006,2018,6,1,PAYEMENT,1000.0,M855286124
3596,409000493210',2018-06-01,OXYGEN NFS SETT 31-05-201,10000.0,0.0,4068458.500000006,2018,6,1,DEBIT,10000.0,M733693146
3597,409000493210',2018-06-01,OXYGEN NFS SETT 31-05-201,1000.0,0.0,4067458.500000006,2018,6,1,CHECK_WITHDRAWAL,1000.0,M1209462308
3598,409000493210',2018-06-01,Indiaforensic  RUPAY SETT 010618,100.71,0.0,4067357.790000006,2018,6,1,CASH_OUT,100.71,M1935751909
3599,409000493210',2018-06-02,OXYGEN NFS SETT 01-06-201,6000.0,0.0,4061357.790000006,2018,6,2,DEBIT,6000.0,C1428469551
3600,409000493210',2018-06-02,OXYGEN NFS SETT 01-06-201,200.0,0.0,4061157.790000006,2018,6,2,CHECK_WITHDRAWAL,200.0,M1324526451
3601,409000493210',2018-06-02,OXYGEN NFS SETT 01-06-201,400.0,0.0,4060757.790000006,2018,6,2,CASH_OUT,400.0,M1905229914
3602,409000493210',2018-06-02,OXYGEN NFS SETT 01-06-201,1900.0,0.0,4058857.790000006,2018,6,2,CASH_OUT,1900.0,M1434151479
3603,409000493210',2018-06-02,OXYGEN NFS SETT 01-06-201,1000.0,0.0,4057857.790000006,2018,6,2,DEBIT,1000.0,C2134357721
3604,409000493210',2018-06-02,Indiaforensic  RUPAY SETT 020618,5571.48,0.0,4052286.310000006,2018,6,2,PAYEMENT,5571.48,M1576416089
3605,409000493210',2018-06-02,Indiaforensic  RUPAY SETT 020618,200.71,0.0,4052085.600000006,2018,6,2,CHECK_WITHDRAWAL,200.71,M1530504166
3606,409000493210',2018-06-04,TRF FROM  Indiaforensic SERVICES,0.0,24000.0,4076085.600000006,2018,6,4,TRANSFER,24000.0,C1883840933
3607,409000493210',2018-06-04,Indiaforensic  RUPAY SETT 030618,1494.42,0.0,4074591.180000006,2018,6,4,PAYEMENT,1494.42,C621014131
3608,409000493210',2018-06-04,Indiaforensic  RUPAY SETT 040618,5118.29,0.0,4069472.890000006,2018,6,4,PAYEMENT,5118.29,C22805895
3609,409000493210',2018-06-04,Indiaforensic  RUPAY SETT 040618,5000.71,0.0,4064472.180000006,2018,6,4,DEBIT,5000.71,C117162427
3610,409000493210',2018-06-05,OXYGEN NFS SETT 02-06-201,2000.0,0.0,4062472.180000006,2018,6,5,PAYEMENT,2000.0,C1782113663
3611,409000493210',2018-06-05,OXYGEN NFS SETT 02-06-201,200.0,0.0,4062272.180000006,2018,6,5,CHECK_WITHDRAWAL,200.0,C117162427
3612,409000493210',2018-06-05,OXYGEN NFS SETT 02-06-201,500.0,0.0,4061772.180000006,2018,6,5,PAYEMENT,500.0,C1750563752
3613,409000493210',2018-06-05,OXYGEN NFS SETT 02-06-201,400.0,0.0,4061372.180000006,2018,6,5,CHECK_WITHDRAWAL,400.0,C1222590577
3614,409000493210',2018-06-05,OXYGEN NFS SETT 02-06-201,2200.0,0.0,4059172.180000006,2018,6,5,DEBIT,2200.0,C392292416
3615,409000493210',2018-06-05,OXYGEN NFS SETT 02-06-201,1000.0,0.0,4058172.180000006,2018,6,5,CASH_OUT,1000.0,C97730845
3616,409000493210',2018-06-05,OXYGEN NFS SETT 02-06-201,9600.0,0.0,4048572.180000006,2018,6,5,DEBIT,9600.0,C874189736
3617,409000493210',2018-06-05,OXYGEN NFS SETT 03-06-201,10000.0,0.0,4038572.180000006,2018,6,5,CASH_OUT,10000.0,C1286084959
3618,409000493210',2018-06-05,OXYGEN NFS SETT 03-06-201,1700.0,0.0,4036872.180000006,2018,6,5,CHECK_WITHDRAWAL,1700.0,C667346055
3619,409000493210',2018-06-05,OXYGEN NFS SETT 03-06-201,1100.0,0.0,4035772.180000006,2018,6,5,CASH_OUT,1100.0,C214187874
3620,409000493210',2018-06-05,OXYGEN NFS SETT 03-06-201,4000.0,0.0,4031772.180000006,2018,6,5,CHECK_WITHDRAWAL,4000.0,C931482420
3621,409000493210',2018-06-05,Indiaforensic  RUPAY SETT 050618,510.71,0.0,4031261.4700000063,2018,6,5,DEBIT,510.71,C885951223
3622,409000493210',2018-06-05,Indiaforensic  RUPAY SETT 050618,5111.42,0.0,4026150.0500000063,2018,6,5,CASH_OUT,5111.42,C716083600
3623,409000493210',2018-06-06,OXYGEN NFS SETT 04-06-201,100.0,0.0,4026050.0500000063,2018,6,6,PAYEMENT,100.0,C1810132623
3624,409000493210',2018-06-06,OXYGEN NFS SETT 04-06-201,100.0,0.0,4025950.0500000063,2018,6,6,PAYEMENT,100.0,C655381473
3625,409000493210',2018-06-06,OXYGEN NFS SETT 05-06-201,1000.0,0.0,4024950.0500000063,2018,6,6,DEBIT,1000.0,C985934102
3626,409000493210',2018-06-06,TRF FROM  Indiaforensic SERVICES,0.0,2140000.0,6164950.050000006,2018,6,6,TRANSFER,2140000.0,C42158278
3627,409000493210',2018-06-06,Indiaforensic  RUPAY SETT 060518,1752.75,0.0,6163197.300000006,2018,6,6,DEBIT,1752.75,C1100767002
3628,409000493210',2018-06-07,Indiaforensic  RUPAY SETT 070618,1403.17,0.0,6161794.130000006,2018,6,7,DEBIT,1403.17,C1899073220
3629,409000493210',2018-06-07,Indiaforensic  RUPAY SETT 070618,13580.12,0.0,6148214.010000006,2018,6,7,DEBIT,13580.12,C24119573
3630,409000493210',2018-06-07,OXYGEN NFS SETT 06-06-201,2000.0,0.0,6146214.010000006,2018,6,7,PAYEMENT,2000.0,C977993101
3631,409000493210',2018-06-08,OXYGEN NFS SETT 07-06-201,2000.0,0.0,6144214.010000006,2018,6,8,DEBIT,2000.0,C884457408
3632,409000493210',2018-06-08,OXYGEN NFS SETT 07-06-201,9000.0,0.0,6135214.010000006,2018,6,8,PAYEMENT,9000.0,C681979935
3633,409000493210',2018-06-08,OXYGEN NFS SETT 07-06-201,8500.0,0.0,6126714.010000006,2018,6,8,PAYEMENT,8500.0,C1330106945
3634,409000493210',2018-06-08,OXYGEN NFS SETT 07-06-201,300.0,0.0,6126414.010000006,2018,6,8,CASH_OUT,300.0,C453211571
3635,409000493210',2018-06-08,OXYGEN NFS SETT 07-06-201,300.0,0.0,6126114.010000006,2018,6,8,CHECK_WITHDRAWAL,300.0,C1504109395
3636,409000493210',2018-06-08,OXYGEN NFS SETT 07-06-201,300.0,0.0,6125814.010000006,2018,6,8,PAYEMENT,300.0,C998351292
3637,409000493210',2018-06-08,OXYGEN NFS SETT 07-06-201,8000.0,0.0,6117814.010000006,2018,6,8,PAYEMENT,8000.0,C977993101
3638,409000493210',2018-06-08,OXYGEN NFS SETT 07-06-201,5500.0,0.0,6112314.010000006,2018,6,8,DEBIT,5500.0,C985934102
3639,409000493210',2018-06-08,OXYGEN NFS SETT 07-06-201,6000.0,0.0,6106314.010000006,2018,6,8,CASH_OUT,6000.0,C1360767589
3640,409000493210',2018-06-08,OXYGEN NFS SETT 07-06-201,8000.0,0.0,6098314.010000006,2018,6,8,DEBIT,8000.0,C662736689
3641,409000493210',2018-06-08,OXYGEN NFS SETT 07-06-201,10000.0,0.0,6088314.010000006,2018,6,8,CASH_OUT,10000.0,C1674899618
3642,409000493210',2018-06-08,OXYGEN NFS SETT 07-06-201,8000.0,0.0,6080314.010000006,2018,6,8,PAYEMENT,8000.0,C985934102
3643,409000493210',2018-06-08,OXYGEN NFS SETT 07-06-201,400.0,0.0,6079914.010000006,2018,6,8,DEBIT,400.0,C1339858954
3644,409000493210',2018-06-08,OXYGEN NFS SETT 07-06-201,5000.0,0.0,6074914.010000006,2018,6,8,DEBIT,5000.0,C1997859171
3645,409000493210',2018-06-08,OXYGEN NFS SETT 07-06-201,10000.0,0.0,6064914.010000006,2018,6,8,CASH_OUT,10000.0,C2081595126
3646,409000493210',2018-06-08,OXYGEN NFS SETT 07-06-201,3000.0,0.0,6061914.010000006,2018,6,8,CASH_OUT,3000.0,C295372946
3647,409000493210',2018-06-08,OXYGEN NFS SETT 07-06-201,5000.0,0.0,6056914.010000006,2018,6,8,CASH_OUT,5000.0,C1453128758
3648,409000493210',2018-06-08,OXYGEN NFS SETT 07-06-201,2500.0,0.0,6054414.010000006,2018,6,8,DEBIT,2500.0,C451111351
3649,409000493210',2018-06-08,OXYGEN NFS SETT 07-06-201,2000.0,0.0,6052414.010000006,2018,6,8,PAYEMENT,2000.0,C1432687668
3650,409000493210',2018-06-08,OXYGEN NFS SETT 07-06-201,5000.0,0.0,6047414.010000006,2018,6,8,DEBIT,5000.0,C1346667529
3651,409000493210',2018-06-08,OXYGEN NFS SETT 07-06-201,1500.0,0.0,6045914.010000006,2018,6,8,PAYEMENT,1500.0,C909295153
3652,409000493210',2018-06-08,OXYGEN NFS SETT 07-06-201,2500.0,0.0,6043414.010000006,2018,6,8,DEBIT,2500.0,C934085675
3653,409000493210',2018-06-08,OXYGEN NFS SETT 07-06-201,2500.0,0.0,6040914.010000006,2018,6,8,CASH_OUT,2500.0,C1023714065
3654,409000493210',2018-06-08,OXYGEN NFS SETT 07-06-201,2000.0,0.0,6038914.010000006,2018,6,8,DEBIT,2000.0,C11003494
3655,409000493210',2018-06-08,OXYGEN NFS SETT 07-06-201,300.0,0.0,6038614.010000006,2018,6,8,CASH_OUT,300.0,C1778801068
3656,409000493210',2018-06-08,OXYGEN NFS SETT 07-06-201,5000.0,0.0,6033614.010000006,2018,6,8,PAYEMENT,5000.0,C1870252780
3657,409000493210',2018-06-08,OXYGEN NFS SETT 07-06-201,800.0,0.0,6032814.010000006,2018,6,8,CASH_OUT,800.0,C1816757085
3658,409000493210',2018-06-08,OXYGEN NFS SETT 07-06-201,7000.0,0.0,6025814.010000006,2018,6,8,CASH_OUT,7000.0,C998351292
3659,409000493210',2018-06-08,OXYGEN NFS SETT 07-06-201,8500.0,0.0,6017314.010000006,2018,6,8,DEBIT,8500.0,C453211571
3660,409000493210',2018-06-08,OXYGEN NFS SETT 07-06-201,1000.0,0.0,6016314.010000006,2018,6,8,CASH_OUT,1000.0,C42158278
3661,409000493210',2018-06-08,OXYGEN NFS SETT 07-06-201,6000.0,0.0,6010314.010000006,2018,6,8,CHECK_WITHDRAWAL,6000.0,C2134357721
3662,409000493210',2018-06-08,OXYGEN NFS SETT 07-06-201,8000.0,0.0,6002314.010000006,2018,6,8,DEBIT,8000.0,C1380361139
3663,409000493210',2018-06-08,OXYGEN NFS SETT 07-06-201,6000.0,0.0,5996314.010000006,2018,6,8,CASH_OUT,6000.0,C1568059495
3664,409000493210',2018-06-08,OXYGEN NFS SETT 07-06-201,5000.0,0.0,5991314.010000006,2018,6,8,CHECK_WITHDRAWAL,5000.0,C1135523296
3665,409000493210',2018-06-08,OXYGEN NFS SETT 07-06-201,2400.0,0.0,5988914.010000006,2018,6,8,PAYEMENT,2400.0,C1850180796
3666,409000493210',2018-06-08,OXYGEN NFS SETT 07-06-201,6900.0,0.0,5982014.010000006,2018,6,8,CHECK_WITHDRAWAL,6900.0,C1498438472
3667,409000493210',2018-06-08,OXYGEN NFS SETT 07-06-201,8700.0,0.0,5973314.010000006,2018,6,8,PAYEMENT,8700.0,C932583850
3668,409000493210',2018-06-08,OXYGEN NFS SETT 07-06-201,8000.0,0.0,5965314.010000006,2018,6,8,CHECK_WITHDRAWAL,8000.0,C1789550256
3669,409000493210',2018-06-08,OXYGEN NFS SETT 07-06-201,7000.0,0.0,5958314.010000006,2018,6,8,CASH_OUT,7000.0,C361268035
3670,409000493210',2018-06-08,OXYGEN NFS SETT 07-06-201,8200.0,0.0,5950114.010000006,2018,6,8,PAYEMENT,8200.0,C1538745405
3671,409000493210',2018-06-08,OXYGEN NFS SETT 07-06-201,10000.0,0.0,5940114.010000006,2018,6,8,CHECK_WITHDRAWAL,10000.0,C1789550256
3672,409000493210',2018-06-08,OXYGEN NFS SETT 07-06-201,10000.0,0.0,5930114.010000006,2018,6,8,DEBIT,10000.0,C769342184
3673,409000493210',2018-06-08,OXYGEN NFS SETT 07-06-201,500.0,0.0,5929614.010000006,2018,6,8,CHECK_WITHDRAWAL,500.0,C214187874
3674,409000493210',2018-06-08,OXYGEN NFS SETT 07-06-201,5000.0,0.0,5924614.010000006,2018,6,8,DEBIT,5000.0,C977993101
3675,409000493210',2018-06-08,OXYGEN NFS SETT 07-06-201,9000.0,0.0,5915614.010000006,2018,6,8,DEBIT,9000.0,C1262822392
3676,409000493210',2018-06-08,OXYGEN NFS SETT 07-06-201,200.0,0.0,5915414.010000006,2018,6,8,PAYEMENT,200.0,C1870252780
3677,409000493210',2018-06-08,OXYGEN NFS SETT 07-06-201,8700.0,0.0,5906714.010000006,2018,6,8,CHECK_WITHDRAWAL,8700.0,C2134357721
3678,409000493210',2018-06-08,OXYGEN NFS SETT 07-06-201,4000.0,0.0,5902714.010000006,2018,6,8,CHECK_WITHDRAWAL,4000.0,M325897214
3679,409000493210',2018-06-08,OXYGEN NFS SETT 07-06-201,500.0,0.0,5902214.010000006,2018,6,8,PAYEMENT,500.0,C838411509
3680,409000493210',2018-06-08,OXYGEN NFS SETT 07-06-201,4000.0,0.0,5898214.010000006,2018,6,8,CASH_OUT,4000.0,C985934102
3681,409000493210',2018-06-08,OXYGEN NFS SETT 07-06-201,3500.0,0.0,5894714.010000006,2018,6,8,CASH_OUT,3500.0,M1636256669
3682,409000493210',2018-06-08,OXYGEN NFS SETT 07-06-201,2000.0,0.0,5892714.010000006,2018,6,8,CHECK_WITHDRAWAL,2000.0,M1328349514
3683,409000493210',2018-06-08,OXYGEN NFS SETT 07-06-201,9000.0,0.0,5883714.010000006,2018,6,8,PAYEMENT,9000.0,C234430897
3684,409000493210',2018-06-08,OXYGEN NFS SETT 07-06-201,500.0,0.0,5883214.010000006,2018,6,8,CASH_OUT,500.0,C1711105800
3685,409000493210',2018-06-08,OXYGEN NFS SETT 07-06-201,8700.0,0.0,5874514.010000006,2018,6,8,CHECK_WITHDRAWAL,8700.0,C657736958
3686,409000493210',2018-06-08,OXYGEN NFS SETT 07-06-201,7000.0,0.0,5867514.010000006,2018,6,8,CASH_OUT,7000.0,C154319946
3687,409000493210',2018-06-08,OXYGEN NFS SETT 07-06-201,6000.0,0.0,5861514.010000006,2018,6,8,CHECK_WITHDRAWAL,6000.0,M1890097328
3688,409000493210',2018-06-08,OXYGEN NFS SETT 07-06-201,7300.0,0.0,5854214.010000006,2018,6,8,CHECK_WITHDRAWAL,7300.0,C1916720513
3689,409000493210',2018-06-08,OXYGEN NFS SETT 07-06-201,100.0,0.0,5854114.010000006,2018,6,8,DEBIT,100.0,M254145674
3690,409000493210',2018-06-08,OXYGEN NFS SETT 07-06-201,10000.0,0.0,5844114.010000006,2018,6,8,CASH_OUT,10000.0,M992893965
3691,409000493210',2018-06-08,OXYGEN NFS SETT 07-06-201,7400.0,0.0,5836714.010000006,2018,6,8,CHECK_WITHDRAWAL,7400.0,M1413005690
3692,409000493210',2018-06-08,OXYGEN NFS SETT 07-06-201,7900.0,0.0,5828814.010000006,2018,6,8,PAYEMENT,7900.0,M1117448897
3693,409000493210',2018-06-08,OXYGEN NFS SETT 07-06-201,9100.0,0.0,5819714.010000006,2018,6,8,CASH_OUT,9100.0,C836514715
3694,409000493210',2018-06-08,OXYGEN NFS SETT 07-06-201,8000.0,0.0,5811714.010000006,2018,6,8,DEBIT,8000.0,M146605930
3695,409000493210',2018-06-08,OXYGEN NFS SETT 07-06-201,8000.0,0.0,5803714.010000006,2018,6,8,CHECK_WITHDRAWAL,8000.0,M326692514
3696,409000493210',2018-06-08,OXYGEN NFS SETT 07-06-201,8000.0,0.0,5795714.010000006,2018,6,8,DEBIT,8000.0,M1716661933
3697,409000493210',2018-06-08,OXYGEN NFS SETT 07-06-201,600.0,0.0,5795114.010000006,2018,6,8,DEBIT,600.0,M244430068
3698,409000493210',2018-06-08,OXYGEN NFS SETT 07-06-201,8100.0,0.0,5787014.010000006,2018,6,8,DEBIT,8100.0,M1487814699
3699,409000493210',2018-06-08,OXYGEN NFS SETT 07-06-201,400.0,0.0,5786614.010000006,2018,6,8,CASH_OUT,400.0,M1135348328
3700,409000493210',2018-06-08,OXYGEN NFS SETT 07-06-201,8000.0,0.0,5778614.010000006,2018,6,8,PAYEMENT,8000.0,M925410680
3701,409000493210',2018-06-08,OXYGEN NFS SETT 07-06-201,9000.0,0.0,5769614.010000006,2018,6,8,DEBIT,9000.0,M501244955
3702,409000493210',2018-06-08,OXYGEN NFS SETT 07-06-201,8000.0,0.0,5761614.010000006,2018,6,8,CHECK_WITHDRAWAL,8000.0,M440815523
3703,409000493210',2018-06-08,OXYGEN NFS SETT 07-06-201,6000.0,0.0,5755614.010000006,2018,6,8,PAYEMENT,6000.0,M1556841942
3704,409000493210',2018-06-08,OXYGEN NFS SETT 07-06-201,7000.0,0.0,5748614.010000006,2018,6,8,DEBIT,7000.0,M630949334
3705,409000493210',2018-06-08,OXYGEN NFS SETT 07-06-201,700.0,0.0,5747914.010000006,2018,6,8,CHECK_WITHDRAWAL,700.0,C1941598182
3706,409000493210',2018-06-08,OXYGEN NFS SETT 07-06-201,6000.0,0.0,5741914.010000006,2018,6,8,DEBIT,6000.0,M34150451
3707,409000493210',2018-06-08,OXYGEN NFS SETT 07-06-201,1100.0,0.0,5740814.010000006,2018,6,8,PAYEMENT,1100.0,M1678856266
3708,409000493210',2018-06-08,OXYGEN NFS SETT 07-06-201,6000.0,0.0,5734814.010000006,2018,6,8,CHECK_WITHDRAWAL,6000.0,M524536503
3709,409000493210',2018-06-08,OXYGEN NFS SETT 07-06-201,5000.0,0.0,5729814.010000006,2018,6,8,CASH_OUT,5000.0,M644399750
3710,409000493210',2018-06-08,OXYGEN NFS SETT 07-06-201,9000.0,0.0,5720814.010000006,2018,6,8,PAYEMENT,9000.0,M2124562732
3711,409000493210',2018-06-08,OXYGEN NFS SETT 07-06-201,4000.0,0.0,5716814.010000006,2018,6,8,CHECK_WITHDRAWAL,4000.0,C2034460325
3712,409000493210',2018-06-08,OXYGEN NFS SETT 07-06-201,100.0,0.0,5716714.010000006,2018,6,8,CASH_OUT,100.0,M716996660
3713,409000493210',2018-06-08,OXYGEN NFS SETT 07-06-201,3000.0,0.0,5713714.010000006,2018,6,8,CASH_OUT,3000.0,M1195473402
3714,409000493210',2018-06-08,OXYGEN NFS SETT 07-06-201,10000.0,0.0,5703714.010000006,2018,6,8,DEBIT,10000.0,M209667159
3715,409000493210',2018-06-08,OXYGEN NFS SETT 07-06-201,2000.0,0.0,5701714.010000006,2018,6,8,CHECK_WITHDRAWAL,2000.0,M1579356102
3716,409000493210',2018-06-08,OXYGEN NFS SETT 07-06-201,8500.0,0.0,5693214.010000006,2018,6,8,CHECK_WITHDRAWAL,8500.0,M212397882
3717,409000493210',2018-06-08,OXYGEN NFS SETT 07-06-201,2000.0,0.0,5691214.010000006,2018,6,8,CHECK_WITHDRAWAL,2000.0,M1361009437
3718,409000493210',2018-06-08,OXYGEN NFS SETT 07-06-201,300.0,0.0,5690914.010000006,2018,6,8,CASH_OUT,300.0,M2053668237
3719,409000493210',2018-06-08,OXYGEN NFS SETT 07-06-201,6000.0,0.0,5684914.010000006,2018,6,8,PAYEMENT,6000.0,M1743702241
3720,409000493210',2018-06-08,OXYGEN NFS SETT 07-06-201,7500.0,0.0,5677414.010000006,2018,6,8,CASH_OUT,7500.0,M2074687317
3721,409000493210',2018-06-08,OXYGEN NFS SETT 07-06-201,5800.0,0.0,5671614.010000006,2018,6,8,CHECK_WITHDRAWAL,5800.0,M870593736
3722,409000493210',2018-06-08,OXYGEN NFS SETT 07-06-201,8000.0,0.0,5663614.010000006,2018,6,8,DEBIT,8000.0,M1715606187
3723,409000493210',2018-06-08,OXYGEN NFS SETT 07-06-201,8000.0,0.0,5655614.010000006,2018,6,8,CASH_OUT,8000.0,M876864630
3724,409000493210',2018-06-08,OXYGEN NFS SETT 07-06-201,8000.0,0.0,5647614.010000006,2018,6,8,PAYEMENT,8000.0,C1134894336
3725,409000493210',2018-06-08,OXYGEN NFS SETT 07-06-201,8500.0,0.0,5639114.010000006,2018,6,8,CHECK_WITHDRAWAL,8500.0,M854977732
3726,409000493210',2018-06-08,OXYGEN NFS SETT 07-06-201,4800.0,0.0,5634314.010000006,2018,6,8,PAYEMENT,4800.0,M463759298
3727,409000493210',2018-06-08,OXYGEN NFS SETT 07-06-201,7100.0,0.0,5627214.010000006,2018,6,8,CHECK_WITHDRAWAL,7100.0,M2130242983
3728,409000493210',2018-06-08,Indiaforensic  RUPAY SETT 080618,12034.99,0.0,5615179.020000006,2018,6,8,PAYEMENT,12034.99,M704530496
3729,409000493210',2018-06-08,Indiaforensic  RUPAY SETT 080618,1835.91,0.0,5613343.110000006,2018,6,8,CASH_OUT,1835.91,M1183065103
3730,409000493210',2018-06-11,FDRL/INTERNAL FUND TRANSFE,0.0,100000.0,5713343.110000006,2018,6,11,CASH_IN,100000.0,M1769339676
3731,409000493210',2018-06-11,FDRL/INTERNAL FUND TRANSFE,0.0,100000.0,5813343.110000006,2018,6,11,CASH_IN,100000.0,C875917495
3732,409000493210',2018-06-11,Indiaforensic  RUPAY SETT 090618,11854.87,0.0,5801488.240000006,2018,6,11,PAYEMENT,11854.87,M277130309
3733,409000493210',2018-06-11,Indiaforensic  RUPAY SETT 100618,5944.49,0.0,5795543.750000007,2018,6,11,DEBIT,5944.49,C1060830840
3734,409000493210',2018-06-11,OXYGEN NFS SETT 08-06-201,5800.0,0.0,5789743.750000007,2018,6,11,CASH_OUT,5800.0,C459857341
3735,409000493210',2018-06-11,OXYGEN NFS SETT 08-06-201,500.0,0.0,5789243.750000007,2018,6,11,PAYEMENT,500.0,C932583850
3736,409000493210',2018-06-11,OXYGEN NFS SETT 08-06-201,5000.0,0.0,5784243.750000007,2018,6,11,CHECK_WITHDRAWAL,5000.0,C1134894336
3737,409000493210',2018-06-11,OXYGEN NFS SETT 08-06-201,3600.0,0.0,5780643.750000007,2018,6,11,CASH_OUT,3600.0,C453211571
3738,409000493210',2018-06-11,OXYGEN NFS SETT 08-06-201,10000.0,0.0,5770643.750000007,2018,6,11,CASH_OUT,10000.0,C836514715
3739,409000493210',2018-06-11,OXYGEN NFS SETT 08-06-201,1500.0,0.0,5769143.750000007,2018,6,11,DEBIT,1500.0,C995911260
3740,409000493210',2018-06-11,OXYGEN NFS SETT 08-06-201,8000.0,0.0,5761143.750000007,2018,6,11,CASH_OUT,8000.0,C1916720513
3741,409000493210',2018-06-11,OXYGEN NFS SETT 08-06-201,7000.0,0.0,5754143.750000007,2018,6,11,DEBIT,7000.0,C1870252780
3742,409000493210',2018-06-11,OXYGEN NFS SETT 08-06-201,8000.0,0.0,5746143.750000007,2018,6,11,PAYEMENT,8000.0,C1453128758
3743,409000493210',2018-06-11,OXYGEN NFS SETT 08-06-201,200.0,0.0,5745943.750000007,2018,6,11,PAYEMENT,200.0,C481402298
3744,409000493210',2018-06-11,OXYGEN NFS SETT 08-06-201,2000.0,0.0,5743943.750000007,2018,6,11,CASH_OUT,2000.0,C1471633238
3745,409000493210',2018-06-11,OXYGEN NFS SETT 08-06-201,1000.0,0.0,5742943.750000007,2018,6,11,DEBIT,1000.0,C1446521801
3746,409000493210',2018-06-11,OXYGEN NFS SETT 08-06-201,800.0,0.0,5742143.750000007,2018,6,11,PAYEMENT,800.0,C811597470
3747,409000493210',2018-06-11,OXYGEN NFS SETT 08-06-201,200.0,0.0,5741943.750000007,2018,6,11,CASH_OUT,200.0,C248609774
3748,409000493210',2018-06-11,OXYGEN NFS SETT 08-06-201,2000.0,0.0,5739943.750000007,2018,6,11,CHECK_WITHDRAWAL,2000.0,C1471633238
3749,409000493210',2018-06-11,OXYGEN NFS SETT 08-06-201,9500.0,0.0,5730443.750000007,2018,6,11,DEBIT,9500.0,C1832532108
3750,409000493210',2018-06-11,OXYGEN NFS SETT 08-06-201,1000.0,0.0,5729443.750000007,2018,6,11,CHECK_WITHDRAWAL,1000.0,C11003494
3751,409000493210',2018-06-11,OXYGEN NFS SETT 08-06-201,3000.0,0.0,5726443.750000007,2018,6,11,CHECK_WITHDRAWAL,3000.0,C1434651019
3752,409000493210',2018-06-11,OXYGEN NFS SETT 08-06-201,3500.0,0.0,5722943.750000007,2018,6,11,PAYEMENT,3500.0,C1286084959
3753,409000493210',2018-06-11,OXYGEN NFS SETT 08-06-201,3500.0,0.0,5719443.750000007,2018,6,11,CASH_OUT,3500.0,C977993101
3754,409000493210',2018-06-11,OXYGEN NFS SETT 08-06-201,1500.0,0.0,5717943.750000007,2018,6,11,PAYEMENT,1500.0,C451111351
3755,409000493210',2018-06-11,OXYGEN NFS SETT 08-06-201,1000.0,0.0,5716943.750000007,2018,6,11,DEBIT,1000.0,C665576141
3756,409000493210',2018-06-11,OXYGEN NFS SETT 08-06-201,5000.0,0.0,5711943.750000007,2018,6,11,CASH_OUT,5000.0,C453211571
3757,409000493210',2018-06-11,OXYGEN NFS SETT 08-06-201,500.0,0.0,5711443.750000007,2018,6,11,PAYEMENT,500.0,C1380361139
3758,409000493210',2018-06-11,OXYGEN NFS SETT 08-06-201,5000.0,0.0,5706443.750000007,2018,6,11,DEBIT,5000.0,C542895457
3759,409000493210',2018-06-11,OXYGEN NFS SETT 08-06-201,2500.0,0.0,5703943.750000007,2018,6,11,CASH_OUT,2500.0,C1321530272
3760,409000493210',2018-06-11,OXYGEN NFS SETT 08-06-201,10000.0,0.0,5693943.750000007,2018,6,11,CASH_OUT,10000.0,C657736958
3761,409000493210',2018-06-11,OXYGEN NFS SETT 08-06-201,8000.0,0.0,5685943.750000007,2018,6,11,CHECK_WITHDRAWAL,8000.0,C932583850
3762,409000493210',2018-06-11,OXYGEN NFS SETT 08-06-201,5200.0,0.0,5680743.750000007,2018,6,11,PAYEMENT,5200.0,C1816757085
3763,409000493210',2018-06-11,OXYGEN NFS SETT 08-06-201,10000.0,0.0,5670743.750000007,2018,6,11,CASH_OUT,10000.0,C932583850
3764,409000493210',2018-06-11,OXYGEN NFS SETT 08-06-201,8700.0,0.0,5662043.750000007,2018,6,11,DEBIT,8700.0,C1782113663
3765,409000493210',2018-06-11,OXYGEN NFS SETT 08-06-201,7600.0,0.0,5654443.750000007,2018,6,11,DEBIT,7600.0,C97730845
3766,409000493210',2018-06-11,OXYGEN NFS SETT 08-06-201,5000.0,0.0,5649443.750000007,2018,6,11,CASH_OUT,5000.0,C1782113663
3767,409000493210',2018-06-11,OXYGEN NFS SETT 08-06-201,9000.0,0.0,5640443.750000007,2018,6,11,PAYEMENT,9000.0,C459857341
3768,409000493210',2018-06-11,OXYGEN NFS SETT 08-06-201,500.0,0.0,5639943.750000007,2018,6,11,DEBIT,500.0,C625232315
3769,409000493210',2018-06-11,OXYGEN NFS SETT 08-06-201,10000.0,0.0,5629943.750000007,2018,6,11,DEBIT,10000.0,C991505714
3770,409000493210',2018-06-11,OXYGEN NFS SETT 08-06-201,8000.0,0.0,5621943.750000007,2018,6,11,CHECK_WITHDRAWAL,8000.0,C1899073220
3771,409000493210',2018-06-11,OXYGEN NFS SETT 08-06-201,1000.0,0.0,5620943.750000007,2018,6,11,DEBIT,1000.0,C885951223
3772,409000493210',2018-06-11,OXYGEN NFS SETT 08-06-201,7000.0,0.0,5613943.750000007,2018,6,11,CHECK_WITHDRAWAL,7000.0,C1750563752
3773,409000493210',2018-06-11,OXYGEN NFS SETT 08-06-201,8500.0,0.0,5605443.750000007,2018,6,11,PAYEMENT,8500.0,C1380361139
3774,409000493210',2018-06-11,OXYGEN NFS SETT 08-06-201,10000.0,0.0,5595443.750000007,2018,6,11,DEBIT,10000.0,C451111351
3775,409000493210',2018-06-11,OXYGEN NFS SETT 08-06-201,100.0,0.0,5595343.750000007,2018,6,11,PAYEMENT,100.0,C1060563153
3776,409000493210',2018-06-11,OXYGEN NFS SETT 08-06-201,100.0,0.0,5595243.750000007,2018,6,11,CASH_OUT,100.0,C339924917
3777,409000493210',2018-06-11,OXYGEN NFS SETT 08-06-201,100.0,0.0,5595143.750000007,2018,6,11,CASH_OUT,100.0,M1094446968
3778,409000493210',2018-06-11,OXYGEN NFS SETT 08-06-201,100.0,0.0,5595043.750000007,2018,6,11,CASH_OUT,100.0,C747464370
3779,409000493210',2018-06-11,OXYGEN NFS SETT 08-06-201,100.0,0.0,5594943.750000007,2018,6,11,DEBIT,100.0,M1561668557
3780,409000493210',2018-06-11,OXYGEN NFS SETT 08-06-201,100.0,0.0,5594843.750000007,2018,6,11,CHECK_WITHDRAWAL,100.0,M1681259036
3781,409000493210',2018-06-11,OXYGEN NFS SETT 08-06-201,9000.0,0.0,5585843.750000007,2018,6,11,CHECK_WITHDRAWAL,9000.0,M226213650
3782,409000493210',2018-06-11,OXYGEN NFS SETT 08-06-201,1000.0,0.0,5584843.750000007,2018,6,11,PAYEMENT,1000.0,C2012808675
3783,409000493210',2018-06-11,OXYGEN NFS SETT 08-06-201,3000.0,0.0,5581843.750000007,2018,6,11,PAYEMENT,3000.0,M61041877
3784,409000493210',2018-06-11,OXYGEN NFS SETT 08-06-201,3000.0,0.0,5578843.750000007,2018,6,11,CASH_OUT,3000.0,C1568059495
3785,409000493210',2018-06-11,OXYGEN NFS SETT 08-06-201,1500.0,0.0,5577343.750000007,2018,6,11,CASH_OUT,1500.0,C832279283
3786,409000493210',2018-06-11,OXYGEN NFS SETT 08-06-201,5000.0,0.0,5572343.750000007,2018,6,11,PAYEMENT,5000.0,M2010350054
3787,409000493210',2018-06-11,OXYGEN NFS SETT 08-06-201,5000.0,0.0,5567343.750000007,2018,6,11,CASH_OUT,5000.0,M66515916
3788,409000493210',2018-06-11,OXYGEN NFS SETT 08-06-201,2000.0,0.0,5565343.750000007,2018,6,11,CHECK_WITHDRAWAL,2000.0,M1933329999
3789,409000493210',2018-06-11,OXYGEN NFS SETT 08-06-201,5000.0,0.0,5560343.750000007,2018,6,11,PAYEMENT,5000.0,M1945886568
3790,409000493210',2018-06-11,OXYGEN NFS SETT 08-06-201,7000.0,0.0,5553343.750000007,2018,6,11,CASH_OUT,7000.0,M594463953
3791,409000493210',2018-06-11,OXYGEN NFS SETT 08-06-201,5000.0,0.0,5548343.750000007,2018,6,11,CHECK_WITHDRAWAL,5000.0,M1887218054
3792,409000493210',2018-06-11,OXYGEN NFS SETT 08-06-201,5000.0,0.0,5543343.750000007,2018,6,11,CASH_OUT,5000.0,M406511188
3793,409000493210',2018-06-11,OXYGEN NFS SETT 08-06-201,5000.0,0.0,5538343.750000007,2018,6,11,PAYEMENT,5000.0,M1500821480
3794,409000493210',2018-06-11,OXYGEN NFS SETT 08-06-201,10000.0,0.0,5528343.750000007,2018,6,11,CHECK_WITHDRAWAL,10000.0,M1723810021
3795,409000493210',2018-06-11,OXYGEN NFS SETT 08-06-201,800.0,0.0,5527543.750000007,2018,6,11,CASH_OUT,800.0,M1579610605
3796,409000493210',2018-06-11,OXYGEN NFS SETT 08-06-201,7300.0,0.0,5520243.750000007,2018,6,11,PAYEMENT,7300.0,M633514467
3797,409000493210',2018-06-11,OXYGEN NFS SETT 08-06-201,10000.0,0.0,5510243.750000007,2018,6,11,DEBIT,10000.0,M1626478944
3798,409000493210',2018-06-11,OXYGEN NFS SETT 08-06-201,1500.0,0.0,5508743.750000007,2018,6,11,CASH_OUT,1500.0,C625232315
3799,409000493210',2018-06-11,OXYGEN NFS SETT 08-06-201,1500.0,0.0,5507243.750000007,2018,6,11,DEBIT,1500.0,M1111100957
3800,409000493210',2018-06-11,OXYGEN NFS SETT 08-06-201,8500.0,0.0,5498743.750000007,2018,6,11,DEBIT,8500.0,M1005373776
3801,409000493210',2018-06-11,OXYGEN NFS SETT 08-06-201,5500.0,0.0,5493243.750000007,2018,6,11,CASH_OUT,5500.0,M2034723406
3802,409000493210',2018-06-11,OXYGEN NFS SETT 08-06-201,400.0,0.0,5492843.750000007,2018,6,11,CASH_OUT,400.0,C1397643446
3803,409000493210',2018-06-11,OXYGEN NFS SETT 08-06-201,6000.0,0.0,5486843.750000007,2018,6,11,CASH_OUT,6000.0,M436328432
3804,409000493210',2018-06-11,OXYGEN NFS SETT 08-06-201,500.0,0.0,5486343.750000007,2018,6,11,CHECK_WITHDRAWAL,500.0,C728885526
3805,409000493210',2018-06-11,OXYGEN NFS SETT 08-06-201,500.0,0.0,5485843.750000007,2018,6,11,DEBIT,500.0,C323761934
3806,409000493210',2018-06-11,OXYGEN NFS SETT 08-06-201,500.0,0.0,5485343.750000007,2018,6,11,CASH_OUT,500.0,C1359044626
3807,409000493210',2018-06-11,OXYGEN NFS SETT 08-06-201,4000.0,0.0,5481343.750000007,2018,6,11,DEBIT,4000.0,C885951223
3808,409000493210',2018-06-11,OXYGEN NFS SETT 09-06-201,7000.0,0.0,5474343.750000007,2018,6,11,PAYEMENT,7000.0,C97730845
3809,409000493210',2018-06-11,OXYGEN NFS SETT 09-06-201,10000.0,0.0,5464343.750000007,2018,6,11,PAYEMENT,10000.0,C248609774
3810,409000493210',2018-06-11,OXYGEN NFS SETT 09-06-201,600.0,0.0,5463743.750000007,2018,6,11,PAYEMENT,600.0,M852760745
3811,409000493210',2018-06-11,OXYGEN NFS SETT 09-06-201,2000.0,0.0,5461743.750000007,2018,6,11,CHECK_WITHDRAWAL,2000.0,C657736958
3812,409000493210',2018-06-11,OXYGEN NFS SETT 09-06-201,8200.0,0.0,5453543.750000007,2018,6,11,DEBIT,8200.0,M1139605173
3813,409000493210',2018-06-11,OXYGEN NFS SETT 09-06-201,6500.0,0.0,5447043.750000007,2018,6,11,CHECK_WITHDRAWAL,6500.0,M1402211887
3814,409000493210',2018-06-11,OXYGEN NFS SETT 09-06-201,500.0,0.0,5446543.750000007,2018,6,11,CHECK_WITHDRAWAL,500.0,M1641776831
3815,409000493210',2018-06-11,OXYGEN NFS SETT 09-06-201,2000.0,0.0,5444543.750000007,2018,6,11,PAYEMENT,2000.0,C1222590577
3816,409000493210',2018-06-11,OXYGEN NFS SETT 09-06-201,10000.0,0.0,5434543.750000007,2018,6,11,PAYEMENT,10000.0,M1303238288
3817,409000493210',2018-06-11,OXYGEN NFS SETT 09-06-201,6000.0,0.0,5428543.750000007,2018,6,11,PAYEMENT,6000.0,C67985650
3818,409000493210',2018-06-11,OXYGEN NFS SETT 09-06-201,1700.0,0.0,5426843.750000007,2018,6,11,CASH_OUT,1700.0,M930641076
3819,409000493210',2018-06-11,OXYGEN NFS SETT 09-06-201,9000.0,0.0,5417843.750000007,2018,6,11,CHECK_WITHDRAWAL,9000.0,M381768094
3820,409000493210',2018-06-11,OXYGEN NFS SETT 09-06-201,5000.0,0.0,5412843.750000007,2018,6,11,DEBIT,5000.0,M1588330347
3821,409000493210',2018-06-11,OXYGEN NFS SETT 09-06-201,500.0,0.0,5412343.750000007,2018,6,11,PAYEMENT,500.0,M1196550329
3822,409000493210',2018-06-11,OXYGEN NFS SETT 09-06-201,2500.0,0.0,5409843.750000007,2018,6,11,CASH_OUT,2500.0,C1360767589
3823,409000493210',2018-06-11,OXYGEN NFS SETT 09-06-201,8000.0,0.0,5401843.750000007,2018,6,11,CHECK_WITHDRAWAL,8000.0,M536994956
3824,409000493210',2018-06-11,OXYGEN NFS SETT 09-06-201,1000.0,0.0,5400843.750000007,2018,6,11,CHECK_WITHDRAWAL,1000.0,M812415990
3825,409000493210',2018-06-11,OXYGEN NFS SETT 09-06-201,500.0,0.0,5400343.750000007,2018,6,11,PAYEMENT,500.0,C542895457
3826,409000493210',2018-06-11,OXYGEN NFS SETT 09-06-201,6000.0,0.0,5394343.750000007,2018,6,11,PAYEMENT,6000.0,M1329043305
3827,409000493210',2018-06-11,OXYGEN NFS SETT 09-06-201,3000.0,0.0,5391343.750000007,2018,6,11,PAYEMENT,3000.0,M1263623851
3828,409000493210',2018-06-11,OXYGEN NFS SETT 09-06-201,500.0,0.0,5390843.750000007,2018,6,11,DEBIT,500.0,M355920448
3829,409000493210',2018-06-11,OXYGEN NFS SETT 09-06-201,2800.0,0.0,5388043.750000007,2018,6,11,CASH_OUT,2800.0,M2006112337
3830,409000493210',2018-06-11,OXYGEN NFS SETT 09-06-201,700.0,0.0,5387343.750000007,2018,6,11,CHECK_WITHDRAWAL,700.0,M2116025968
3831,409000493210',2018-06-11,OXYGEN NFS SETT 10-06-201,9100.0,0.0,5378243.750000007,2018,6,11,CHECK_WITHDRAWAL,9100.0,M305468700
3832,409000493210',2018-06-11,OXYGEN NFS SETT 10-06-201,500.0,0.0,5377743.750000007,2018,6,11,CHECK_WITHDRAWAL,500.0,C558216562
3833,409000493210',2018-06-11,OXYGEN NFS SETT 10-06-201,8000.0,0.0,5369743.750000007,2018,6,11,PAYEMENT,8000.0,M1463835093
3834,409000493210',2018-06-11,OXYGEN NFS SETT 10-06-201,100.0,0.0,5369643.750000007,2018,6,11,PAYEMENT,100.0,M1735854903
3835,409000493210',2018-06-11,OXYGEN NFS SETT 10-06-201,500.0,0.0,5369143.750000007,2018,6,11,PAYEMENT,500.0,M1428815684
3836,409000493210',2018-06-11,OXYGEN NFS SETT 10-06-201,3000.0,0.0,5366143.750000007,2018,6,11,CHECK_WITHDRAWAL,3000.0,C1364913072
3837,409000493210',2018-06-11,OXYGEN NFS SETT 10-06-201,100.0,0.0,5366043.750000007,2018,6,11,DEBIT,100.0,M1246810186
3838,409000493210',2018-06-11,OXYGEN NFS SETT 10-06-201,100.0,0.0,5365943.750000007,2018,6,11,CHECK_WITHDRAWAL,100.0,M1942163841
3839,409000493210',2018-06-11,OXYGEN NFS SETT 10-06-201,4000.0,0.0,5361943.750000007,2018,6,11,CASH_OUT,4000.0,M1330143761
3840,409000493210',2018-06-11,OXYGEN NFS SETT 10-06-201,200.0,0.0,5361743.750000007,2018,6,11,CHECK_WITHDRAWAL,200.0,C621014131
3841,409000493210',2018-06-11,OXYGEN NFS SETT 10-06-201,8000.0,0.0,5353743.750000007,2018,6,11,CHECK_WITHDRAWAL,8000.0,M145122075
3842,409000493210',2018-06-11,OXYGEN NFS SETT 10-06-201,9000.0,0.0,5344743.750000007,2018,6,11,CHECK_WITHDRAWAL,9000.0,M1271241511
3843,409000493210',2018-06-11,OXYGEN NFS SETT 10-06-201,3000.0,0.0,5341743.750000007,2018,6,11,CHECK_WITHDRAWAL,3000.0,M1996449989
3844,409000493210',2018-06-11,OXYGEN NFS SETT 10-06-201,800.0,0.0,5340943.750000007,2018,6,11,CHECK_WITHDRAWAL,800.0,C691404076
3845,409000493210',2018-06-11,OXYGEN NFS SETT 10-06-201,8000.0,0.0,5332943.750000007,2018,6,11,PAYEMENT,8000.0,M497104907
3846,409000493210',2018-06-11,OXYGEN NFS SETT 10-06-201,6600.0,0.0,5326343.750000007,2018,6,11,CASH_OUT,6600.0,M858965925
3847,409000493210',2018-06-11,OXYGEN NFS SETT 10-06-201,3500.0,0.0,5322843.750000007,2018,6,11,PAYEMENT,3500.0,M1043970800
3848,409000493210',2018-06-11,OXYGEN NFS SETT 10-06-201,2000.0,0.0,5320843.750000007,2018,6,11,CHECK_WITHDRAWAL,2000.0,M631851861
3849,409000493210',2018-06-11,OXYGEN NFS SETT 10-06-201,5500.0,0.0,5315343.750000007,2018,6,11,CHECK_WITHDRAWAL,5500.0,M432112141
3850,409000493210',2018-06-11,OXYGEN NFS SETT 10-06-201,300.0,0.0,5315043.750000007,2018,6,11,DEBIT,300.0,M1796938191
3851,409000493210',2018-06-11,OXYGEN NFS SETT 10-06-201,500.0,0.0,5314543.750000007,2018,6,11,DEBIT,500.0,M1993836574
3852,409000493210',2018-06-11,Indiaforensic  RUPAY SETT 110618,449.42,0.0,5314094.330000007,2018,6,11,DEBIT,449.42,M2034610694
3853,409000493210',2018-06-12,OXYGEN NFS SETT 11-06-201,2000.0,0.0,5312094.330000007,2018,6,12,PAYEMENT,2000.0,M1292487390
3854,409000493210',2018-06-12,OXYGEN NFS SETT 11-06-201,5000.0,0.0,5307094.330000007,2018,6,12,DEBIT,5000.0,M1267082248
3855,409000493210',2018-06-12,OXYGEN NFS SETT 11-06-201,8000.0,0.0,5299094.330000007,2018,6,12,PAYEMENT,8000.0,M1854053968
3856,409000493210',2018-06-12,OXYGEN NFS SETT 11-06-201,3000.0,0.0,5296094.330000007,2018,6,12,CHECK_WITHDRAWAL,3000.0,M813583428
3857,409000493210',2018-06-12,OXYGEN NFS SETT 11-06-201,6000.0,0.0,5290094.330000007,2018,6,12,DEBIT,6000.0,M1342198213
3858,409000493210',2018-06-12,OXYGEN NFS SETT 11-06-201,4000.0,0.0,5286094.330000007,2018,6,12,CASH_OUT,4000.0,C1753885705
3859,409000493210',2018-06-12,OXYGEN NFS SETT 11-06-201,7500.0,0.0,5278594.330000007,2018,6,12,PAYEMENT,7500.0,M926837661
3860,409000493210',2018-06-12,OXYGEN NFS SETT 11-06-201,4000.0,0.0,5274594.330000007,2018,6,12,DEBIT,4000.0,M1454942961
3861,409000493210',2018-06-12,OXYGEN NFS SETT 11-06-201,400.0,0.0,5274194.330000007,2018,6,12,DEBIT,400.0,M270812962
3862,409000493210',2018-06-12,OXYGEN NFS SETT 11-06-201,200.0,0.0,5273994.330000007,2018,6,12,PAYEMENT,200.0,M1914538677
3863,409000493210',2018-06-12,OXYGEN NFS SETT 11-06-201,1800.0,0.0,5272194.330000007,2018,6,12,PAYEMENT,1800.0,M26502020
3864,409000493210',2018-06-12,OXYGEN NFS SETT 11-06-201,100.0,0.0,5272094.330000007,2018,6,12,CHECK_WITHDRAWAL,100.0,M1947378744
3865,409000493210',2018-06-12,OXYGEN NFS SETT 11-06-201,500.0,0.0,5271594.330000007,2018,6,12,CASH_OUT,500.0,M1016408627
3866,409000493210',2018-06-12,OXYGEN NFS SETT 11-06-201,500.0,0.0,5271094.330000007,2018,6,12,CHECK_WITHDRAWAL,500.0,M290509937
3867,409000493210',2018-06-12,OXYGEN NFS SETT 11-06-201,9000.0,0.0,5262094.330000007,2018,6,12,PAYEMENT,9000.0,M1699637904
3868,409000493210',2018-06-12,OXYGEN NFS SETT 11-06-201,4000.0,0.0,5258094.330000007,2018,6,12,CASH_OUT,4000.0,C1122118227
3869,409000493210',2018-06-12,OXYGEN NFS SETT 11-06-201,2000.0,0.0,5256094.330000007,2018,6,12,CHECK_WITHDRAWAL,2000.0,M505567264
3870,409000493210',2018-06-12,Indiaforensic RUPAY SETT 110618,5063.21,0.0,5251031.120000007,2018,6,12,CHECK_WITHDRAWAL,5063.21,M44227594
3871,409000493210',2018-06-12,Indiaforensic RUPAY SETT 120618,9808.96,0.0,5241222.160000007,2018,6,12,CHECK_WITHDRAWAL,9808.96,M921640293
3872,409000493210',2018-06-13,Indiaforensic  RUPAY SETT 130618,0.0,5.11,5241227.270000006,2018,6,13,TRANSFER,5.11,M1597400455
3873,409000493210',2018-06-14,TRF FROM  Indiaforensic SERVICES,0.0,5000.0,5246227.270000006,2018,6,14,CASH_IN,5000.0,C146305349
3874,409000493210',2018-06-14,Indiaforensic  RUPAY SETT 140618,556.94,0.0,5245670.330000007,2018,6,14,CHECK_WITHDRAWAL,556.94,M1618230491
3875,409000493210',2018-06-14,Indiaforensic  RUPAY SETT 140618,7.71,0.0,5245662.620000007,2018,6,14,PAYEMENT,7.71,M1897372527
3876,409000493210',2018-06-15,Indiaforensic NFS SETT 13-06-18,2000.0,0.0,5243662.620000007,2018,6,15,CHECK_WITHDRAWAL,2000.0,M1382973704
3877,409000493210',2018-06-15,Indiaforensic NFS SETT 13-06-18,9000.0,0.0,5234662.620000007,2018,6,15,CHECK_WITHDRAWAL,9000.0,C738590621
3878,409000493210',2018-06-15,Indiaforensic NFS SETT 13-06-18,300.0,0.0,5234362.620000007,2018,6,15,CASH_OUT,300.0,C40075281
3879,409000493210',2018-06-15,Indiaforensic NFS SETT 13-06-18,5000.0,0.0,5229362.620000007,2018,6,15,DEBIT,5000.0,C1360767589
3880,409000493210',2018-06-15,Indiaforensic NFS SETT 13-06-18,3000.0,0.0,5226362.620000007,2018,6,15,CHECK_WITHDRAWAL,3000.0,M1254651534
3881,409000493210',2018-06-15,Indiaforensic NFS SETT 13-06-18,10000.0,0.0,5216362.620000007,2018,6,15,CASH_OUT,10000.0,M1762984107
3882,409000493210',2018-06-15,Indiaforensic NFS SETT 13-06-18,5000.0,0.0,5211362.620000007,2018,6,15,DEBIT,5000.0,M876695548
3883,409000493210',2018-06-15,Indiaforensic NFS SETT 13-06-18,900.0,0.0,5210462.620000007,2018,6,15,CHECK_WITHDRAWAL,900.0,M1078031260
3884,409000493210',2018-06-15,Indiaforensic NFS SETT 13-06-18,2000.0,0.0,5208462.620000007,2018,6,15,CHECK_WITHDRAWAL,2000.0,M1652552120
3885,409000493210',2018-06-15,Indiaforensic NFS SETT 13-06-18,2000.0,0.0,5206462.620000007,2018,6,15,CASH_OUT,2000.0,M698562080
3886,409000493210',2018-06-15,Indiaforensic NFS SETT 13-06-18,500.0,0.0,5205962.620000007,2018,6,15,DEBIT,500.0,M323981046
3887,409000493210',2018-06-15,Indiaforensic NFS SETT 13-06-18,5500.0,0.0,5200462.620000007,2018,6,15,CHECK_WITHDRAWAL,5500.0,M1781668126
3888,409000493210',2018-06-15,Indiaforensic NFS SETT 13-06-18,200.0,0.0,5200262.620000007,2018,6,15,DEBIT,200.0,M162320368
3889,409000493210',2018-06-15,Indiaforensic NFS SETT 13-06-18,6000.0,0.0,5194262.620000007,2018,6,15,PAYEMENT,6000.0,M676692948
3890,409000493210',2018-06-15,Indiaforensic NFS SETT 13-06-18,3000.0,0.0,5191262.620000007,2018,6,15,DEBIT,3000.0,M2139431292
3891,409000493210',2018-06-15,Indiaforensic NFS SETT 13-06-18,900.0,0.0,5190362.620000007,2018,6,15,PAYEMENT,900.0,M95552255
3892,409000493210',2018-06-15,Indiaforensic NFS SETT 14-06-201,3000.0,0.0,5187362.620000007,2018,6,15,CASH_OUT,3000.0,C836514715
3893,409000493210',2018-06-15,Indiaforensic NFS SETT 14-06-201,2000.0,0.0,5185362.620000007,2018,6,15,DEBIT,2000.0,C2118255842
3894,409000493210',2018-06-15,Indiaforensic NFS SETT 14-06-201,500.0,0.0,5184862.620000007,2018,6,15,PAYEMENT,500.0,M1904652802
3895,409000493210',2018-06-15,Indiaforensic NFS SETT 14-06-201,1500.0,0.0,5183362.620000007,2018,6,15,CASH_OUT,1500.0,M1710180594
3896,409000493210',2018-06-15,Indiaforensic NFS SETT 14-06-201,800.0,0.0,5182562.620000007,2018,6,15,CHECK_WITHDRAWAL,800.0,C173783788
3897,409000493210',2018-06-15,Indiaforensic NFS SETT 14-06-201,5000.0,0.0,5177562.620000007,2018,6,15,CHECK_WITHDRAWAL,5000.0,M1032382137
3898,409000493210',2018-06-15,Indiaforensic NFS SETT 14-06-201,500.0,0.0,5177062.620000007,2018,6,15,CHECK_WITHDRAWAL,500.0,C1076835071
3899,409000493210',2018-06-15,Indiaforensic NFS SETT 14-06-201,6000.0,0.0,5171062.620000007,2018,6,15,DEBIT,6000.0,M1940906679
3900,409000493210',2018-06-15,Indiaforensic NFS SETT 14-06-201,6500.0,0.0,5164562.620000007,2018,6,15,PAYEMENT,6500.0,C248609774
3901,409000493210',2018-06-15,Indiaforensic NFS SETT 14-06-201,100.0,0.0,5164462.620000007,2018,6,15,DEBIT,100.0,M1729954747
3902,409000493210',2018-06-15,Indiaforensic NFS SETT 14-06-201,2000.0,0.0,5162462.620000007,2018,6,15,CHECK_WITHDRAWAL,2000.0,M561227586
3903,409000493210',2018-06-15,Indiaforensic NFS SETT 14-06-201,6500.0,0.0,5155962.620000007,2018,6,15,DEBIT,6500.0,M2137205195
3904,409000493210',2018-06-15,Indiaforensic NFS SETT 14-06-201,2000.0,0.0,5153962.620000007,2018,6,15,CASH_OUT,2000.0,M2012528704
3905,409000493210',2018-06-15,Indiaforensic NFS SETT 14-06-201,1800.0,0.0,5152162.620000007,2018,6,15,DEBIT,1800.0,M111238003
3906,409000493210',2018-06-15,Indiaforensic NFS SETT 14-06-201,500.0,0.0,5151662.620000007,2018,6,15,CHECK_WITHDRAWAL,500.0,M368788838
3907,409000493210',2018-06-15,Indiaforensic NFS SETT 14-06-201,200.0,0.0,5151462.620000007,2018,6,15,PAYEMENT,200.0,M696870185
3908,409000493210',2018-06-15,Indiaforensic NFS SETT 14-06-201,100.0,0.0,5151362.620000007,2018,6,15,CHECK_WITHDRAWAL,100.0,M1102463008
3909,409000493210',2018-06-15,Indiaforensic NFS SETT 14-06-201,9000.0,0.0,5142362.620000007,2018,6,15,PAYEMENT,9000.0,M2022768790
3910,409000493210',2018-06-15,Indiaforensic NFS SETT 14-06-201,8800.0,0.0,5133562.620000007,2018,6,15,PAYEMENT,8800.0,M1243227501
3911,409000493210',2018-06-15,Indiaforensic NFS SETT 14-06-201,2500.0,0.0,5131062.620000007,2018,6,15,CHECK_WITHDRAWAL,2500.0,M1021082377
3912,409000493210',2018-06-15,Indiaforensic NFS SETT 14-06-201,10000.0,0.0,5121062.620000007,2018,6,15,PAYEMENT,10000.0,M1749978269
3913,409000493210',2018-06-15,Indiaforensic NFS SETT 14-06-201,6900.0,0.0,5114162.620000007,2018,6,15,CASH_OUT,6900.0,M831993944
3914,409000493210',2018-06-15,Indiaforensic NFS SETT 14-06-201,2000.0,0.0,5112162.620000007,2018,6,15,CASH_OUT,2000.0,M2045188238
3915,409000493210',2018-06-15,Indiaforensic NFS SETT 14-06-201,2500.0,0.0,5109662.620000007,2018,6,15,CHECK_WITHDRAWAL,2500.0,M2146285461
3916,409000493210',2018-06-15,Indiaforensic NFS SETT 14-06-201,8300.0,0.0,5101362.620000007,2018,6,15,PAYEMENT,8300.0,M1374115041
3917,409000493210',2018-06-15,Indiaforensic NFS SETT 14-06-201,2500.0,0.0,5098862.620000007,2018,6,15,CHECK_WITHDRAWAL,2500.0,M876945112
3918,409000493210',2018-06-15,Indiaforensic NFS SETT 14-06-201,9000.0,0.0,5089862.620000007,2018,6,15,CHECK_WITHDRAWAL,9000.0,M1740328397
3919,409000493210',2018-06-15,Indiaforensic NFS SETT 14-06-201,5000.0,0.0,5084862.620000007,2018,6,15,DEBIT,5000.0,C117162427
3920,409000493210',2018-06-15,Indiaforensic NFS SETT 14-06-201,4000.0,0.0,5080862.620000007,2018,6,15,CASH_OUT,4000.0,C1883840933
3921,409000493210',2018-06-15,Indiaforensic NFS SETT 14-06-201,7000.0,0.0,5073862.620000007,2018,6,15,CHECK_WITHDRAWAL,7000.0,C1750563752
3922,409000493210',2018-06-15,Indiaforensic NFS SETT 14-06-201,5000.0,0.0,5068862.620000007,2018,6,15,CASH_OUT,5000.0,C665576141
3923,409000493210',2018-06-15,Indiaforensic NFS SETT 14-06-201,400.0,0.0,5068462.620000007,2018,6,15,CHECK_WITHDRAWAL,400.0,C1850180796
3924,409000493210',2018-06-15,Indiaforensic  RUPAY SETT 150618,1605.3,0.0,5066857.320000006,2018,6,15,CHECK_WITHDRAWAL,1605.3,C173783788
3925,409000493210',2018-06-15,Indiaforensic  RUPAY SETT 150618,327.12,0.0,5066530.200000007,2018,6,15,CHECK_WITHDRAWAL,327.12,C1446521801
3926,409000493210',2018-06-18,Indiaforensic RUPAY SETT 160618,14325.92,0.0,5052204.280000006,2018,6,18,CHECK_WITHDRAWAL,14325.92,C173783788
3927,409000493210',2018-06-18,Indiaforensic RUPAY SETT 170618,5447.08,0.0,5046757.200000007,2018,6,18,DEBIT,5447.08,C1997859171
3928,409000493210',2018-06-18,Indiaforensic RUPAY SETT 180618,4540.31,0.0,5042216.890000006,2018,6,18,CHECK_WITHDRAWAL,4540.31,C1899073220
3929,409000493210',2018-06-19,Indiaforensic NFS SETT 15-06-201,500.0,0.0,5041716.890000006,2018,6,19,CHECK_WITHDRAWAL,500.0,C1963862935
3930,409000493210',2018-06-19,Indiaforensic NFS SETT 15-06-201,900.0,0.0,5040816.890000006,2018,6,19,DEBIT,900.0,C885951223
3931,409000493210',2018-06-19,Indiaforensic NFS SETT 15-06-201,8500.0,0.0,5032316.890000006,2018,6,19,PAYEMENT,8500.0,C1538745405
3932,409000493210',2018-06-19,Indiaforensic NFS SETT 15-06-201,200.0,0.0,5032116.890000006,2018,6,19,CHECK_WITHDRAWAL,200.0,C1778801068
3933,409000493210',2018-06-19,Indiaforensic NFS SETT 15-06-201,400.0,0.0,5031716.890000006,2018,6,19,CHECK_WITHDRAWAL,400.0,C977993101
3934,409000493210',2018-06-19,Indiaforensic NFS SETT 15-06-201,10000.0,0.0,5021716.890000006,2018,6,19,DEBIT,10000.0,C11003494
3935,409000493210',2018-06-19,Indiaforensic NFS SETT 15-06-201,2000.0,0.0,5019716.890000006,2018,6,19,PAYEMENT,2000.0,C968113504
3936,409000493210',2018-06-19,Indiaforensic NFS SETT 15-06-201,4000.0,0.0,5015716.890000006,2018,6,19,PAYEMENT,4000.0,C1255024717
3937,409000493210',2018-06-19,Indiaforensic NFS SETT 15-06-201,400.0,0.0,5015316.890000006,2018,6,19,DEBIT,400.0,C1825027294
3938,409000493210',2018-06-19,Indiaforensic NFS SETT 15-06-201,4900.0,0.0,5010416.890000006,2018,6,19,CHECK_WITHDRAWAL,4900.0,C665576141
3939,409000493210',2018-06-19,Indiaforensic NFS SETT 15-06-201,100.0,0.0,5010316.890000006,2018,6,19,DEBIT,100.0,C667346055
3940,409000493210',2018-06-19,Indiaforensic NFS SETT 15-06-201,6000.0,0.0,5004316.890000006,2018,6,19,CHECK_WITHDRAWAL,6000.0,C1538745405
3941,409000493210',2018-06-19,Indiaforensic NFS SETT 15-06-201,5700.0,0.0,4998616.890000006,2018,6,19,PAYEMENT,5700.0,C1049817027
3942,409000493210',2018-06-19,Indiaforensic NFS SETT 15-06-201,8000.0,0.0,4990616.890000006,2018,6,19,CHECK_WITHDRAWAL,8000.0,C317071334
3943,409000493210',2018-06-19,Indiaforensic NFS SETT 15-06-201,8500.0,0.0,4982116.890000006,2018,6,19,DEBIT,8500.0,C1916720513
3944,409000493210',2018-06-19,Indiaforensic NFS SETT 15-06-201,400.0,0.0,4981716.890000006,2018,6,19,DEBIT,400.0,C1017997535
3945,409000493210',2018-06-19,Indiaforensic NFS SETT 15-06-201,500.0,0.0,4981216.890000006,2018,6,19,CASH_OUT,500.0,C1397643446
3946,409000493210',2018-06-19,Indiaforensic NFS SETT 15-06-201,500.0,0.0,4980716.890000006,2018,6,19,PAYEMENT,500.0,C423583818
3947,409000493210',2018-06-19,Indiaforensic NFS SETT 15-06-201,1000.0,0.0,4979716.890000006,2018,6,19,CHECK_WITHDRAWAL,1000.0,C995911260
3948,409000493210',2018-06-19,Indiaforensic NFS SETT 15-06-201,5000.0,0.0,4974716.890000006,2018,6,19,CASH_OUT,5000.0,C224063653
3949,409000493210',2018-06-19,Indiaforensic NFS SETT 15-06-201,7900.0,0.0,4966816.890000006,2018,6,19,DEBIT,7900.0,C1789550256
3950,409000493210',2018-06-19,Indiaforensic NFS SETT 15-06-201,6500.0,0.0,4960316.890000006,2018,6,19,CHECK_WITHDRAWAL,6500.0,C1850180796
3951,409000493210',2018-06-19,Indiaforensic NFS SETT 15-06-201,500.0,0.0,4959816.890000006,2018,6,19,CHECK_WITHDRAWAL,500.0,C1504109395
3952,409000493210',2018-06-19,Indiaforensic NFS SETT 15-06-201,3000.0,0.0,4956816.890000006,2018,6,19,CHECK_WITHDRAWAL,3000.0,C621014131
3953,409000493210',2018-06-19,Indiaforensic NFS SETT 15-06-201,1500.0,0.0,4955316.890000006,2018,6,19,CHECK_WITHDRAWAL,1500.0,C977993101
3954,409000493210',2018-06-19,Indiaforensic NFS SETT 15-06-201,7000.0,0.0,4948316.890000006,2018,6,19,PAYEMENT,7000.0,C564160838
3955,409000493210',2018-06-19,Indiaforensic NFS SETT 15-06-201,6000.0,0.0,4942316.890000006,2018,6,19,PAYEMENT,6000.0,C1674899618
3956,409000493210',2018-06-19,Indiaforensic NFS SETT 15-06-201,5000.0,0.0,4937316.890000006,2018,6,19,CHECK_WITHDRAWAL,5000.0,C801142660
3957,409000493210',2018-06-19,Indiaforensic NFS SETT 15-06-201,300.0,0.0,4937016.890000006,2018,6,19,CHECK_WITHDRAWAL,300.0,C575335780
3958,409000493210',2018-06-19,Indiaforensic NFS SETT 16-06-201,9000.0,0.0,4928016.890000006,2018,6,19,CASH_OUT,9000.0,C1234776885
3959,409000493210',2018-06-19,Indiaforensic NFS SETT 16-06-201,9000.0,0.0,4919016.890000006,2018,6,19,PAYEMENT,9000.0,C1504109395
3960,409000493210',2018-06-19,Indiaforensic NFS SETT 16-06-201,10000.0,0.0,4909016.890000006,2018,6,19,PAYEMENT,10000.0,M1901752553
3961,409000493210',2018-06-19,Indiaforensic NFS SETT 16-06-201,10000.0,0.0,4899016.890000006,2018,6,19,DEBIT,10000.0,M180017308
3962,409000493210',2018-06-19,Indiaforensic NFS SETT 16-06-201,8000.0,0.0,4891016.890000006,2018,6,19,PAYEMENT,8000.0,C991505714
3963,409000493210',2018-06-19,Indiaforensic NFS SETT 16-06-201,10000.0,0.0,4881016.890000006,2018,6,19,CHECK_WITHDRAWAL,10000.0,M1308527415
3964,409000493210',2018-06-19,Indiaforensic NFS SETT 16-06-201,400.0,0.0,4880616.890000006,2018,6,19,CHECK_WITHDRAWAL,400.0,M219396780
3965,409000493210',2018-06-19,Indiaforensic NFS SETT 16-06-201,9900.0,0.0,4870716.890000006,2018,6,19,CHECK_WITHDRAWAL,9900.0,M1974379194
3966,409000493210',2018-06-19,Indiaforensic NFS SETT 16-06-201,9900.0,0.0,4860816.890000006,2018,6,19,PAYEMENT,9900.0,M317880757
3967,409000493210',2018-06-19,Indiaforensic NFS SETT 16-06-201,9900.0,0.0,4850916.890000006,2018,6,19,DEBIT,9900.0,M1607278346
3968,409000493210',2018-06-19,Indiaforensic NFS SETT 16-06-201,10000.0,0.0,4840916.890000006,2018,6,19,DEBIT,10000.0,M2145001473
3969,409000493210',2018-06-19,Indiaforensic NFS SETT 16-06-201,900.0,0.0,4840016.890000006,2018,6,19,CHECK_WITHDRAWAL,900.0,M565077371
3970,409000493210',2018-06-19,Indiaforensic NFS SETT 16-06-201,10000.0,0.0,4830016.890000006,2018,6,19,CASH_OUT,10000.0,M1466662004
3971,409000493210',2018-06-19,Indiaforensic NFS SETT 16-06-201,900.0,0.0,4829116.890000006,2018,6,19,CHECK_WITHDRAWAL,900.0,M1938377818
3972,409000493210',2018-06-19,Indiaforensic NFS SETT 16-06-201,300.0,0.0,4828816.890000006,2018,6,19,DEBIT,300.0,M2057104863
3973,409000493210',2018-06-19,Indiaforensic NFS SETT 16-06-201,100.0,0.0,4828716.890000006,2018,6,19,CASH_OUT,100.0,C1032986144
3974,409000493210',2018-06-19,Indiaforensic NFS SETT 16-06-201,100.0,0.0,4828616.890000006,2018,6,19,PAYEMENT,100.0,M575779772
3975,409000493210',2018-06-19,Indiaforensic NFS SETT 16-06-201,300.0,0.0,4828316.890000006,2018,6,19,CASH_OUT,300.0,C392292416
3976,409000493210',2018-06-19,Indiaforensic NFS SETT 16-06-201,4000.0,0.0,4824316.890000006,2018,6,19,DEBIT,4000.0,M366008009
3977,409000493210',2018-06-19,Indiaforensic NFS SETT 16-06-201,4500.0,0.0,4819816.890000006,2018,6,19,DEBIT,4500.0,M2000802630
3978,409000493210',2018-06-19,Indiaforensic NFS SETT 16-06-201,5000.0,0.0,4814816.890000006,2018,6,19,CHECK_WITHDRAWAL,5000.0,C1753885705
3979,409000493210',2018-06-19,Indiaforensic NFS SETT 16-06-201,5000.0,0.0,4809816.890000006,2018,6,19,DEBIT,5000.0,M1644128841
3980,409000493210',2018-06-19,Indiaforensic NFS SETT 16-06-201,500.0,0.0,4809316.890000006,2018,6,19,CASH_OUT,500.0,M1614992995
3981,409000493210',2018-06-19,Indiaforensic NFS SETT 16-06-201,200.0,0.0,4809116.890000006,2018,6,19,CHECK_WITHDRAWAL,200.0,M1043576110
3982,409000493210',2018-06-19,Indiaforensic NFS SETT 16-06-201,2000.0,0.0,4807116.890000006,2018,6,19,DEBIT,2000.0,M988637661
3983,409000493210',2018-06-19,Indiaforensic NFS SETT 16-06-201,500.0,0.0,4806616.890000006,2018,6,19,CASH_OUT,500.0,M480498267
3984,409000493210',2018-06-19,Indiaforensic NFS SETT 16-06-201,5000.0,0.0,4801616.890000006,2018,6,19,CHECK_WITHDRAWAL,5000.0,M1398428044
3985,409000493210',2018-06-19,Indiaforensic NFS SETT 16-06-201,200.0,0.0,4801416.890000006,2018,6,19,CHECK_WITHDRAWAL,200.0,M977972728
3986,409000493210',2018-06-19,Indiaforensic NFS SETT 16-06-201,200.0,0.0,4801216.890000006,2018,6,19,DEBIT,200.0,M2053647669
3987,409000493210',2018-06-19,Indiaforensic NFS SETT 16-06-201,200.0,0.0,4801016.890000006,2018,6,19,PAYEMENT,200.0,M1638051511
3988,409000493210',2018-06-19,Indiaforensic NFS SETT 17-06-201,700.0,0.0,4800316.890000006,2018,6,19,CASH_OUT,700.0,M1603114855
3989,409000493210',2018-06-19,Indiaforensic NFS SETT 17-06-201,200.0,0.0,4800116.890000006,2018,6,19,PAYEMENT,200.0,M1655740181
3990,409000493210',2018-06-19,Indiaforensic NFS SETT 17-06-201,1000.0,0.0,4799116.890000006,2018,6,19,DEBIT,1000.0,M228904713
3991,409000493210',2018-06-19,Indiaforensic NFS SETT 17-06-201,600.0,0.0,4798516.890000006,2018,6,19,CHECK_WITHDRAWAL,600.0,C934085675
3992,409000493210',2018-06-19,Indiaforensic NFS SETT 17-06-201,200.0,0.0,4798316.890000006,2018,6,19,CHECK_WITHDRAWAL,200.0,M1399550388
3993,409000493210',2018-06-19,Indiaforensic  RUPAY SETT 190618,214.71,0.0,4798102.180000006,2018,6,19,PAYEMENT,214.71,M966005897
3994,409000493210',2018-06-19,Indiaforensic NFS SETT 18-06-201,300.0,0.0,4797802.180000006,2018,6,19,CHECK_WITHDRAWAL,300.0,M1731406622
3995,409000493210',2018-06-19,Indiaforensic NFS SETT 18-06-201,10000.0,0.0,4787802.180000006,2018,6,19,CASH_OUT,10000.0,M1738396212
3996,409000493210',2018-06-19,Indiaforensic NFS SETT 18-06-201,500.0,0.0,4787302.180000006,2018,6,19,CASH_OUT,500.0,M509522442
3997,409000493210',2018-06-19,Indiaforensic NFS SETT 18-06-201,2000.0,0.0,4785302.180000006,2018,6,19,PAYEMENT,2000.0,M1279124366
3998,409000493210',2018-06-19,Indiaforensic NFS SETT 18-06-201,2000.0,0.0,4783302.180000006,2018,6,19,DEBIT,2000.0,M530402062
3999,409000493210',2018-06-19,Indiaforensic NFS SETT 18-06-201,2000.0,0.0,4781302.180000006,2018,6,19,PAYEMENT,2000.0,C461160828
4000,409000493210',2018-06-19,Indiaforensic NFS SETT 18-06-201,2000.0,0.0,4779302.180000006,2018,6,19,PAYEMENT,2000.0,C1778801068
4001,409000493210',2018-06-20,TRF FROM  Indiaforensic SERVICES,0.0,374000.0,5153302.180000006,2018,6,20,CHECK_CASHING,374000.0,C2063763486
4002,409000493210',2018-06-20,Indiaforensic NFS SETT 19-06-201,100.0,0.0,5153202.180000006,2018,6,20,CHECK_WITHDRAWAL,100.0,C1883840933
4003,409000493210',2018-06-20,Indiaforensic  RUPAY SETT 200618,1178.0,0.0,5152024.180000006,2018,6,20,CHECK_WITHDRAWAL,1178.0,C1219273867
4004,409000493210',2018-06-21,Indiaforensic NFS SETT 20-06-201,5000.0,0.0,5147024.180000006,2018,6,21,CHECK_WITHDRAWAL,5000.0,C716083600
4005,409000493210',2018-06-21,Indiaforensic NFS SETT 20-06-201,400.0,0.0,5146624.180000006,2018,6,21,PAYEMENT,400.0,C1816757085
4006,409000493210',2018-06-21,Indiaforensic NFS SETT 20-06-201,300.0,0.0,5146324.180000006,2018,6,21,CASH_OUT,300.0,C1789550256
4007,409000493210',2018-06-21,Indiaforensic NFS SETT 20-06-201,5000.0,0.0,5141324.180000006,2018,6,21,CHECK_WITHDRAWAL,5000.0,C657736958
4008,409000493210',2018-06-21,Indiaforensic NFS SETT 20-06-201,500.0,0.0,5140824.180000006,2018,6,21,CHECK_WITHDRAWAL,500.0,C1023714065
4009,409000493210',2018-06-21,Indiaforensic NFS SETT 20-06-201,4000.0,0.0,5136824.180000006,2018,6,21,CHECK_WITHDRAWAL,4000.0,C1076835071
4010,409000493210',2018-06-21,Indiaforensic  RUPAY SETT 210618,1354.25,0.0,5135469.930000006,2018,6,21,PAYEMENT,1354.25,C1538745405
4011,409000493210',2018-06-22,Indiaforensic NFS SETT 21-06-201,1000.0,0.0,5134469.930000006,2018,6,22,CHECK_WITHDRAWAL,1000.0,C1782113663
4012,409000493210',2018-06-22,Indiaforensic NFS SETT 21-06-201,6000.0,0.0,5128469.930000006,2018,6,22,DEBIT,6000.0,C1963862935
4013,409000493210',2018-06-22,Indiaforensic NFS SETT 21-06-201,500.0,0.0,5127969.930000006,2018,6,22,DEBIT,500.0,C979387846
4014,409000493210',2018-06-22,Indiaforensic NFS SETT 21-06-201,500.0,0.0,5127469.930000006,2018,6,22,CASH_OUT,500.0,C451111351
4015,409000493210',2018-06-22,Indiaforensic NFS SETT 21-06-201,8000.0,0.0,5119469.930000006,2018,6,22,PAYEMENT,8000.0,C2063763486
4016,409000493210',2018-06-22,Indiaforensic  RUPAY SETT 220618,3611.79,0.0,5115858.140000006,2018,6,22,CHECK_WITHDRAWAL,3611.79,C1850180796
4017,409000493210',2018-06-25,Indiaforensic RUPAY SETT 230618,6984.07,0.0,5108874.070000006,2018,6,25,CHECK_WITHDRAWAL,6984.07,C117162427
4018,409000493210',2018-06-25,Indiaforensic RUPAY SETT 240618,3985.29,0.0,5104888.780000006,2018,6,25,CASH_OUT,3985.29,C1831477404
4019,409000493210',2018-06-25,Indiaforensic RUPAY SETT 250618,23742.97,0.0,5081145.810000006,2018,6,25,PAYEMENT,23742.97,C451111351
4020,409000493210',2018-06-25,Indiaforensic NFS SETT 22-06-201,400.0,0.0,5080745.810000006,2018,6,25,CHECK_WITHDRAWAL,400.0,C1590550415
4021,409000493210',2018-06-25,Indiaforensic NFS SETT 22-06-201,200.0,0.0,5080545.810000006,2018,6,25,CASH_OUT,200.0,C1721246982
4022,409000493210',2018-06-25,Indiaforensic NFS SETT 22-06-201,5000.0,0.0,5075545.810000006,2018,6,25,DEBIT,5000.0,C2118255842
4023,409000493210',2018-06-25,Indiaforensic NFS SETT 22-06-201,9000.0,0.0,5066545.810000006,2018,6,25,CASH_OUT,9000.0,C195600860
4024,409000493210',2018-06-25,Indiaforensic NFS SETT 22-06-201,5000.0,0.0,5061545.810000006,2018,6,25,PAYEMENT,5000.0,C1850042097
4025,409000493210',2018-06-25,Indiaforensic NFS SETT 23-06-201,300.0,0.0,5061245.810000006,2018,6,25,CASH_OUT,300.0,C11003494
4026,409000493210',2018-06-25,Indiaforensic NFS SETT 23-06-201,200.0,0.0,5061045.810000006,2018,6,25,CASH_OUT,200.0,C1255024717
4027,409000493210',2018-06-25,Indiaforensic NFS SETT 23-06-201,100.0,0.0,5060945.810000006,2018,6,25,PAYEMENT,100.0,C423583818
4028,409000493210',2018-06-25,Indiaforensic NFS SETT 24-06-201,1500.0,0.0,5059445.810000006,2018,6,25,CASH_OUT,1500.0,C1973538135
4029,409000493210',2018-06-25,Indiaforensic NFS SETT 24-06-201,500.0,0.0,5058945.810000006,2018,6,25,DEBIT,500.0,C392292416
4030,409000493210',2018-06-25,Indiaforensic NFS SETT 24-06-201,600.0,0.0,5058345.810000006,2018,6,25,CASH_OUT,600.0,C1286084959
4031,409000493210',2018-06-25,Indiaforensic NFS SETT 24-06-201,200.0,0.0,5058145.810000006,2018,6,25,PAYEMENT,200.0,C1778801068
4032,409000493210',2018-06-25,Indiaforensic NFS SETT 24-06-201,100.0,0.0,5058045.810000006,2018,6,25,CASH_OUT,100.0,C1916720513
4033,409000493210',2018-06-25,Indiaforensic NFS SETT 24-06-201,500.0,0.0,5057545.810000006,2018,6,25,CASH_OUT,500.0,C1789550256
4034,409000493210',2018-06-26,Indiaforensic  RUPAY SETT 260618,1556.98,0.0,5055988.830000007,2018,6,26,CHECK_WITHDRAWAL,1556.98,M1798667958
4035,409000493210',2018-06-26,Indiaforensic  RUPAY SETT 260618,0.02,0.0,5055988.810000006,2018,6,26,CASH_OUT,0.02,C709091500
4036,409000493210',2018-06-26,Indiaforensic NFS SETT 25-06-201,1800.0,0.0,5054188.810000006,2018,6,26,CASH_OUT,1800.0,M925955862
4037,409000493210',2018-06-26,Indiaforensic NFS SETT 25-06-201,5000.0,0.0,5049188.810000006,2018,6,26,PAYEMENT,5000.0,M1727373358
4038,409000493210',2018-06-26,Indiaforensic NFS SETT 25-06-201,1200.0,0.0,5047988.810000006,2018,6,26,DEBIT,1200.0,M2122837918
4039,409000493210',2018-06-26,Indiaforensic NFS SETT 25-06-201,1600.0,0.0,5046388.810000006,2018,6,26,DEBIT,1600.0,C1782113663
4040,409000493210',2018-06-26,Indiaforensic NFS SETT 25-06-201,3800.0,0.0,5042588.810000006,2018,6,26,CHECK_WITHDRAWAL,3800.0,C1182908789
4041,409000493210',2018-06-26,Indiaforensic NFS SETT 25-06-201,400.0,0.0,5042188.810000006,2018,6,26,CHECK_WITHDRAWAL,400.0,M872340040
4042,409000493210',2018-06-26,Indiaforensic NFS SETT 25-06-201,500.0,0.0,5041688.810000006,2018,6,26,CASH_OUT,500.0,M22690626
4043,409000493210',2018-06-26,Indiaforensic NFS SETT 25-06-201,1500.0,0.0,5040188.810000006,2018,6,26,DEBIT,1500.0,C1750905143
4044,409000493210',2018-06-26,Indiaforensic NFS SETT 25-06-201,100.0,0.0,5040088.810000006,2018,6,26,CHECK_WITHDRAWAL,100.0,M925913781
4045,409000493210',2018-06-26,Indiaforensic NFS SETT 25-06-201,1500.0,0.0,5038588.810000006,2018,6,26,CHECK_WITHDRAWAL,1500.0,M2066478917
4046,409000493210',2018-06-26,Indiaforensic NFS SETT 25-06-201,800.0,0.0,5037788.810000006,2018,6,26,CHECK_WITHDRAWAL,800.0,C40075281
4047,409000493210',2018-06-26,Indiaforensic NFS SETT 25-06-201,200.0,0.0,5037588.810000006,2018,6,26,PAYEMENT,200.0,M982313508
4048,409000493210',2018-06-26,Indiaforensic NFS SETT 25-06-201,800.0,0.0,5036788.810000006,2018,6,26,CHECK_WITHDRAWAL,800.0,M1563528849
4049,409000493210',2018-06-26,Indiaforensic NFS SETT 25-06-201,200.0,0.0,5036588.810000006,2018,6,26,PAYEMENT,200.0,M1946904104
4050,409000493210',2018-06-26,Indiaforensic NFS SETT 25-06-201,200.0,0.0,5036388.810000006,2018,6,26,PAYEMENT,200.0,M1986679541
4051,409000493210',2018-06-26,Indiaforensic NFS SETT 25-06-201,400.0,0.0,5035988.810000006,2018,6,26,CASH_OUT,400.0,C1241128308
4052,409000493210',2018-06-26,Indiaforensic NFS SETT 25-06-201,400.0,0.0,5035588.810000006,2018,6,26,CHECK_WITHDRAWAL,400.0,M2082740895
4053,409000493210',2018-06-26,Indiaforensic NFS SETT 25-06-201,400.0,0.0,5035188.810000006,2018,6,26,DEBIT,400.0,M2106390956
4054,409000493210',2018-06-26,Indiaforensic NFS SETT 25-06-201,400.0,0.0,5034788.810000006,2018,6,26,CASH_OUT,400.0,M61321954
4055,409000493210',2018-06-26,Indiaforensic NFS SETT 25-06-201,500.0,0.0,5034288.810000006,2018,6,26,CASH_OUT,500.0,M690070378
4056,409000493210',2018-06-26,Indiaforensic NFS SETT 25-06-201,1500.0,0.0,5032788.810000006,2018,6,26,DEBIT,1500.0,M360528453
4057,409000493210',2018-06-26,Indiaforensic NFS SETT 25-06-201,5000.0,0.0,5027788.810000006,2018,6,26,PAYEMENT,5000.0,M1368391951
4058,409000493210',2018-06-26,Indiaforensic NFS SETT 25-06-201,100.0,0.0,5027688.810000006,2018,6,26,DEBIT,100.0,M468567811
4059,409000493210',2018-06-27,Indiaforensic  RUPAY SETT 270618,167.12,0.0,5027521.690000006,2018,6,27,PAYEMENT,167.12,M1234757451
4060,409000493210',2018-06-27,Indiaforensic  RUPAY SETT 250618,0.04,0.0,5027521.650000006,2018,6,27,CHECK_WITHDRAWAL,0.04,M673684041
4061,409000493210',2018-06-27,Indiaforensic NFS SETT 26-06-201,300.0,0.0,5027221.650000006,2018,6,27,DEBIT,300.0,M912511162
4062,409000493210',2018-06-27,Indiaforensic NFS SETT 26-06-201,600.0,0.0,5026621.650000006,2018,6,27,DEBIT,600.0,M1128109696
4063,409000493210',2018-06-27,Indiaforensic NFS SETT 26-06-201,100.0,0.0,5026521.650000006,2018,6,27,DEBIT,100.0,M765990740
4064,409000493210',2018-06-27,Indiaforensic NFS SETT 26-06-201,400.0,0.0,5026121.650000006,2018,6,27,DEBIT,400.0,M817833695
4065,409000493210',2018-06-27,Indiaforensic NFS SETT 26-06-201,200.0,0.0,5025921.650000006,2018,6,27,CHECK_WITHDRAWAL,200.0,M1872627924
4066,409000493210',2018-06-27,Indiaforensic NFS SETT 26-06-201,300.0,0.0,5025621.650000006,2018,6,27,CASH_OUT,300.0,M1883269062
4067,409000493210',2018-06-27,Indiaforensic NFS SETT 26-06-201,1000.0,0.0,5024621.650000006,2018,6,27,DEBIT,1000.0,M1610803524
4068,409000493210',2018-06-27,Indiaforensic NFS SETT 26-06-201,10000.0,0.0,5014621.650000006,2018,6,27,CHECK_WITHDRAWAL,10000.0,M721975085
4069,409000493210',2018-06-27,Indiaforensic NFS SETT 26-06-201,2000.0,0.0,5012621.650000006,2018,6,27,CASH_OUT,2000.0,M253171986
4070,409000493210',2018-06-27,Indiaforensic NFS SETT 26-06-201,100.0,0.0,5012521.650000006,2018,6,27,CHECK_WITHDRAWAL,100.0,M362030306
4071,409000493210',2018-06-28,Indiaforensic  RUPAY SETT 280618,1118.79,0.0,5011402.860000006,2018,6,28,CASH_OUT,1118.79,M508864177
4072,409000493210',2018-06-29,Indiaforensic  RUPAY SETT 290618,9849.04,0.0,5001553.820000006,2018,6,29,CASH_OUT,9849.04,M992217213
4073,409000493210',2018-06-29,Indiaforensic  RUPAY SETT 290618,382.12,0.0,5001171.700000007,2018,6,29,PAYEMENT,382.12,M1311004473
4074,409000493210',2018-06-29,Indiaforensic NFS SETT 27-06-201,1000.0,0.0,5000171.700000007,2018,6,29,PAYEMENT,1000.0,M1184527733
4075,409000493210',2018-06-29,Indiaforensic NFS SETT 27-06-201,500.0,0.0,4999671.700000007,2018,6,29,CHECK_WITHDRAWAL,500.0,M790689709
4076,409000493210',2018-06-29,Indiaforensic NFS SETT 27-06-201,500.0,0.0,4999171.700000007,2018,6,29,DEBIT,500.0,M1346560976
4077,409000493210',2018-06-30,Indiaforensic  RUPAY SETT 300618,406.42,0.0,4998765.280000006,2018,6,30,CHECK_WITHDRAWAL,406.42,M880883688
4078,409000493210',2018-06-30,Indiaforensic NFS SETT 29-06-201,300.0,0.0,4998465.280000006,2018,6,30,PAYEMENT,300.0,M104298781
4079,409000493210',2018-06-30,Indiaforensic NFS SETT 29-06-201,300.0,0.0,4998165.280000006,2018,6,30,PAYEMENT,300.0,M101676975
4080,409000493210',2018-06-30,Indiaforensic NFS SETT 29-06-201,10000.0,0.0,4988165.280000006,2018,6,30,DEBIT,10000.0,M414634945
4081,409000493210',2018-06-30,Indiaforensic NFS SETT 29-06-201,10000.0,0.0,4978165.280000006,2018,6,30,CHECK_WITHDRAWAL,10000.0,M1071977170
4082,409000493210',2018-06-30,Indiaforensic NFS SETT 28-06-201,4000.0,0.0,4974165.280000006,2018,6,30,CHECK_WITHDRAWAL,4000.0,C1321530272
4083,409000493210',2018-06-30,Indiaforensic NFS SETT 28-06-201,1500.0,0.0,4972665.280000006,2018,6,30,CASH_OUT,1500.0,M115139998
4084,409000493210',2018-06-30,Indiaforensic NFS SETT 28-06-201,600.0,0.0,4972065.280000006,2018,6,30,DEBIT,600.0,M844133497
4085,409000493210',2018-07-02,Indiaforensic RUPAY SETT 300618_,151.42,0.0,4971913.860000006,2018,7,2,PAYEMENT,151.42,M1256384385
4086,409000493210',2018-07-02,Indiaforensic RUPAY SETT 010718,4849.66,0.0,4967064.200000007,2018,7,2,CHECK_WITHDRAWAL,4849.66,M48063459
4087,409000493210',2018-07-02,Indiaforensic RUPAY SETT 020718,12867.52,0.0,4954196.680000006,2018,7,2,CASH_OUT,12867.52,C832279283
4088,409000493210',2018-07-02,Indiaforensic RUPAY SETT 020718_,110.71,0.0,4954085.970000006,2018,7,2,DEBIT,110.71,C1538745405
4089,409000493210',2018-07-03,Indiaforensic  RUPAY SETT 030718,181.58,0.0,4953904.390000006,2018,7,3,CHECK_WITHDRAWAL,181.58,M62085016
4090,409000493210',2018-07-03,Indiaforensic  RUPAY SETT 030718,7646.61,0.0,4946257.780000006,2018,7,3,CASH_OUT,7646.61,M1191372709
4091,409000493210',2018-07-04,TRF FROM  Indiaforensic SERVICES,0.0,97000.0,5043257.780000006,2018,7,4,CHECK_CASHING,97000.0,M1941639991
4092,409000493210',2018-07-04,Indiaforensic RUPAY SETT 040718,1895.35,0.0,5041362.430000006,2018,7,4,DEBIT,1895.35,M942714988
4093,409000493210',2018-07-04,Indiaforensic RUPAY SETT 040718_,1.71,0.0,5041360.720000006,2018,7,4,DEBIT,1.71,M354502944
4094,409000493210',2018-07-04,OXYGEN NFS SETT 02-07-201,10000.0,0.0,5031360.720000006,2018,7,4,CHECK_WITHDRAWAL,10000.0,M973777648
4095,409000493210',2018-07-04,OXYGEN NFS SETT 02-07-201,1000.0,0.0,5030360.720000006,2018,7,4,CHECK_WITHDRAWAL,1000.0,M1570117874
4096,409000493210',2018-07-04,OXYGEN NFS SETT 02-07-201,9000.0,0.0,5021360.720000006,2018,7,4,CHECK_WITHDRAWAL,9000.0,C681979935
4097,409000493210',2018-07-04,OXYGEN NFS SETT 02-07-201,10000.0,0.0,5011360.720000006,2018,7,4,PAYEMENT,10000.0,M1483243447
4098,409000493210',2018-07-04,OXYGEN NFS SETT 02-07-201,500.0,0.0,5010860.720000006,2018,7,4,PAYEMENT,500.0,M976949492
4099,409000493210',2018-07-04,OXYGEN NFS SETT 02-07-201,400.0,0.0,5010460.720000006,2018,7,4,CHECK_WITHDRAWAL,400.0,M1381386227
4100,409000493210',2018-07-04,OXYGEN NFS SETT 02-07-201,8000.0,0.0,5002460.720000006,2018,7,4,CASH_OUT,8000.0,M547507935
4101,409000493210',2018-07-04,OXYGEN NFS SETT 30-06-201,10000.0,0.0,4992460.720000006,2018,7,4,CASH_OUT,10000.0,M1226803249
4102,409000493210',2018-07-04,OXYGEN NFS SETT 30-06-201,10000.0,0.0,4982460.720000006,2018,7,4,PAYEMENT,10000.0,M1534279415
4103,409000493210',2018-07-04,OXYGEN NFS SETT 30-06-201,500.0,0.0,4981960.720000006,2018,7,4,DEBIT,500.0,C118648358
4104,409000493210',2018-07-04,OXYGEN NFS SETT 01-07-201,10000.0,0.0,4971960.720000006,2018,7,4,CHECK_WITHDRAWAL,10000.0,C124540047
4105,409000493210',2018-07-04,OXYGEN NFS SETT 01-07-201,5000.0,0.0,4966960.720000006,2018,7,4,CASH_OUT,5000.0,M2001882279
4106,409000493210',2018-07-04,OXYGEN NFS SETT 01-07-201,200.0,0.0,4966760.720000006,2018,7,4,CASH_OUT,200.0,C979387846
4107,409000493210',2018-07-04,OXYGEN NFS SETT 01-07-201,400.0,0.0,4966360.720000006,2018,7,4,PAYEMENT,400.0,C2094777811
4108,409000493210',2018-07-05,TRF FROM  Indiaforensic SERVICES,0.0,50000.0,5016360.720000006,2018,7,5,TRANSFER,50000.0,M1794509290
4109,409000493210',2018-07-05,Indiaforensic RUPAY SETT 050718,8367.83,0.0,5007992.890000006,2018,7,5,CASH_OUT,8367.83,M971324399
4110,409000493210',2018-07-05,Indiaforensic RUPAY SETT 050718_,1295.71,0.0,5006697.180000006,2018,7,5,DEBIT,1295.71,M1322354584
4111,409000493210',2018-07-06,Indiaforensic NFS SETT 04-07-201,500.0,0.0,5006197.180000006,2018,7,6,DEBIT,500.0,M1529457505
4112,409000493210',2018-07-06,Indiaforensic NFS SETT 04-07-201,100.0,0.0,5006097.180000006,2018,7,6,DEBIT,100.0,M505316221
4113,409000493210',2018-07-06,TRF FROM  Indiaforensic SERVICES,0.0,70000.0,5076097.180000006,2018,7,6,CHECK_CASHING,70000.0,M1567732992
4114,409000493210',2018-07-06,Indiaforensic RUPAY SETT 060718,4320.72,0.0,5071776.4600000065,2018,7,6,PAYEMENT,4320.72,M1651205022
4115,409000493210',2018-07-06,Indiaforensic RUPAY SETT 060718_,5545.12,0.0,5066231.340000006,2018,7,6,PAYEMENT,5545.12,M1383761509
4116,409000493210',2018-07-06,Indiaforensic  RUPAY SETT 050718,0.0,0.01,5066231.350000006,2018,7,6,CHECK_CASHING,0.01,M1132219173
4117,409000493210',2018-07-07,Indiaforensic  RUPAY SETT 070718,8859.98,0.0,5057371.370000007,2018,7,7,CASH_OUT,8859.98,M1476985549
4118,409000493210',2018-07-07,Indiaforensic  RUPAY SETT 070718,8485.83,0.0,5048885.540000007,2018,7,7,CASH_OUT,8485.83,M374585422
4119,409000493210',2018-07-09,TRF FROM  Indiaforensic SERVICES,0.0,150000.0,5198885.540000007,2018,7,9,TRANSFER,150000.0,C885951223
4120,409000493210',2018-07-09,Indiaforensic  RUPAY SETT 090718,3901.83,0.0,5194983.710000007,2018,7,9,DEBIT,3901.83,M1738345448
4121,409000493210',2018-07-09,Indiaforensic  RUPAY SETT 080718,2451.66,0.0,5192532.050000005,2018,7,9,CHECK_WITHDRAWAL,2451.66,M1191464829
4122,409000493210',2018-07-09,Indiaforensic  RUPAY SETT 090718,22575.62,0.0,5169956.430000005,2018,7,9,CASH_OUT,22575.62,M150783284
4123,409000493210',2018-07-10,Indiaforensic  RUPAY SETT 100718,4843.32,0.0,5165113.110000005,2018,7,10,CHECK_WITHDRAWAL,4843.32,M994267665
4124,409000493210',2018-07-10,OXYGEN NFS SETT 06-07-201,1000.0,0.0,5164113.110000005,2018,7,10,CHECK_WITHDRAWAL,1000.0,M1487365582
4125,409000493210',2018-07-10,OXYGEN NFS SETT 06-07-201,10000.0,0.0,5154113.110000005,2018,7,10,DEBIT,10000.0,M1796615884
4126,409000493210',2018-07-10,OXYGEN NFS SETT 07-07-201,7000.0,0.0,5147113.110000005,2018,7,10,PAYEMENT,7000.0,M1487543666
4127,409000493210',2018-07-10,OXYGEN NFS SETT 07-07-201,500.0,0.0,5146613.110000005,2018,7,10,CASH_OUT,500.0,M1777163938
4128,409000493210',2018-07-10,OXYGEN NFS SETT 07-07-201,10000.0,0.0,5136613.110000005,2018,7,10,DEBIT,10000.0,M1592618491
4129,409000493210',2018-07-10,OXYGEN NFS SETT 07-07-201,10000.0,0.0,5126613.110000005,2018,7,10,PAYEMENT,10000.0,M1427892726
4130,409000493210',2018-07-10,OXYGEN NFS SETT 07-07-201,3000.0,0.0,5123613.110000005,2018,7,10,PAYEMENT,3000.0,M321192242
4131,409000493210',2018-07-10,OXYGEN NFS SETT 07-07-201,8800.0,0.0,5114813.110000005,2018,7,10,DEBIT,8800.0,M1250315597
4132,409000493210',2018-07-10,OXYGEN NFS SETT 07-07-201,3100.0,0.0,5111713.110000005,2018,7,10,DEBIT,3100.0,M1184965604
4133,409000493210',2018-07-10,OXYGEN NFS SETT 07-07-201,6500.0,0.0,5105213.110000005,2018,7,10,CHECK_WITHDRAWAL,6500.0,M1009313206
4134,409000493210',2018-07-10,OXYGEN NFS SETT 07-07-201,8000.0,0.0,5097213.110000005,2018,7,10,PAYEMENT,8000.0,M975790343
4135,409000493210',2018-07-10,OXYGEN NFS SETT 07-07-201,8000.0,0.0,5089213.110000005,2018,7,10,CHECK_WITHDRAWAL,8000.0,M1684854630
4136,409000493210',2018-07-10,OXYGEN NFS SETT 07-07-201,700.0,0.0,5088513.110000005,2018,7,10,CASH_OUT,700.0,M642087302
4137,409000493210',2018-07-10,OXYGEN NFS SETT 07-07-201,1400.0,0.0,5087113.110000005,2018,7,10,CASH_OUT,1400.0,M799692219
4138,409000493210',2018-07-10,OXYGEN NFS SETT 07-07-201,6000.0,0.0,5081113.110000005,2018,7,10,PAYEMENT,6000.0,M1562221939
4139,409000493210',2018-07-10,OXYGEN NFS SETT 07-07-201,500.0,0.0,5080613.110000005,2018,7,10,CASH_OUT,500.0,M1984577117
4140,409000493210',2018-07-10,OXYGEN NFS SETT 07-07-201,9200.0,0.0,5071413.110000005,2018,7,10,CHECK_WITHDRAWAL,9200.0,M1572066684
4141,409000493210',2018-07-10,OXYGEN NFS SETT 07-07-201,7500.0,0.0,5063913.110000005,2018,7,10,CASH_OUT,7500.0,M1958375413
4142,409000493210',2018-07-10,OXYGEN NFS SETT 07-07-201,9000.0,0.0,5054913.110000005,2018,7,10,CASH_OUT,9000.0,M2055501967
4143,409000493210',2018-07-10,OXYGEN NFS SETT 07-07-201,1000.0,0.0,5053913.110000005,2018,7,10,CHECK_WITHDRAWAL,1000.0,M652268444
4144,409000493210',2018-07-10,OXYGEN NFS SETT 07-07-201,5000.0,0.0,5048913.110000005,2018,7,10,CASH_OUT,5000.0,M1014135205
4145,409000493210',2018-07-10,OXYGEN NFS SETT 07-07-201,5800.0,0.0,5043113.110000005,2018,7,10,CHECK_WITHDRAWAL,5800.0,M188193734
4146,409000493210',2018-07-10,OXYGEN NFS SETT 07-07-201,5000.0,0.0,5038113.110000005,2018,7,10,DEBIT,5000.0,C479161446
4147,409000493210',2018-07-10,OXYGEN NFS SETT 07-07-201,10000.0,0.0,5028113.110000005,2018,7,10,PAYEMENT,10000.0,C634440506
4148,409000493210',2018-07-10,OXYGEN NFS SETT 07-07-201,5000.0,0.0,5023113.110000005,2018,7,10,CASH_OUT,5000.0,C1922859107
4149,409000493210',2018-07-10,OXYGEN NFS SETT 07-07-201,4000.0,0.0,5019113.110000005,2018,7,10,DEBIT,4000.0,C11003494
4150,409000493210',2018-07-10,OXYGEN NFS SETT 07-07-201,5000.0,0.0,5014113.110000005,2018,7,10,PAYEMENT,5000.0,C1262822392
4151,409000493210',2018-07-10,OXYGEN NFS SETT 07-07-201,300.0,0.0,5013813.110000005,2018,7,10,CASH_OUT,300.0,C306206744
4152,409000493210',2018-07-10,OXYGEN NFS SETT 07-07-201,4000.0,0.0,5009813.110000005,2018,7,10,CHECK_WITHDRAWAL,4000.0,C985934102
4153,409000493210',2018-07-10,OXYGEN NFS SETT 07-07-201,5000.0,0.0,5004813.110000005,2018,7,10,PAYEMENT,5000.0,C667346055
4154,409000493210',2018-07-10,OXYGEN NFS SETT 07-07-201,2000.0,0.0,5002813.110000005,2018,7,10,CHECK_WITHDRAWAL,2000.0,C601893033
4155,409000493210',2018-07-10,OXYGEN NFS SETT 07-07-201,9000.0,0.0,4993813.110000005,2018,7,10,PAYEMENT,9000.0,C97730845
4156,409000493210',2018-07-10,OXYGEN NFS SETT 07-07-201,7200.0,0.0,4986613.110000005,2018,7,10,CHECK_WITHDRAWAL,7200.0,C1504109395
4157,409000493210',2018-07-10,OXYGEN NFS SETT 07-07-201,7000.0,0.0,4979613.110000005,2018,7,10,CASH_OUT,7000.0,C451111351
4158,409000493210',2018-07-10,OXYGEN NFS SETT 07-07-201,4000.0,0.0,4975613.110000005,2018,7,10,CASH_OUT,4000.0,C1916720513
4159,409000493210',2018-07-10,OXYGEN NFS SETT 07-07-201,8000.0,0.0,4967613.110000005,2018,7,10,CHECK_WITHDRAWAL,8000.0,C667346055
4160,409000493210',2018-07-10,OXYGEN NFS SETT 07-07-201,5000.0,0.0,4962613.110000005,2018,7,10,CHECK_WITHDRAWAL,5000.0,C1255024717
4161,409000493210',2018-07-10,OXYGEN NFS SETT 07-07-201,3000.0,0.0,4959613.110000005,2018,7,10,CASH_OUT,3000.0,C146305349
4162,409000493210',2018-07-10,OXYGEN NFS SETT 07-07-201,1000.0,0.0,4958613.110000005,2018,7,10,DEBIT,1000.0,C1005928818
4163,409000493210',2018-07-10,OXYGEN NFS SETT 07-07-201,9000.0,0.0,4949613.110000005,2018,7,10,PAYEMENT,9000.0,C991505714
4164,409000493210',2018-07-10,OXYGEN NFS SETT 07-07-201,8800.0,0.0,4940813.110000005,2018,7,10,CASH_OUT,8800.0,C1721246982
4165,409000493210',2018-07-10,OXYGEN NFS SETT 07-07-201,9800.0,0.0,4931013.110000005,2018,7,10,CHECK_WITHDRAWAL,9800.0,C801142660
4166,409000493210',2018-07-10,OXYGEN NFS SETT 07-07-201,4000.0,0.0,4927013.110000005,2018,7,10,PAYEMENT,4000.0,C479161446
4167,409000493210',2018-07-10,OXYGEN NFS SETT 07-07-201,300.0,0.0,4926713.110000005,2018,7,10,DEBIT,300.0,C1916720513
4168,409000493210',2018-07-10,OXYGEN NFS SETT 07-07-201,4000.0,0.0,4922713.110000005,2018,7,10,CASH_OUT,4000.0,C453211571
4169,409000493210',2018-07-10,OXYGEN NFS SETT 07-07-201,2000.0,0.0,4920713.110000005,2018,7,10,PAYEMENT,2000.0,C1303868418
4170,409000493210',2018-07-10,OXYGEN NFS SETT 07-07-201,1800.0,0.0,4918913.110000005,2018,7,10,CASH_OUT,1800.0,C997608398
4171,409000493210',2018-07-10,OXYGEN NFS SETT 07-07-201,6500.0,0.0,4912413.110000005,2018,7,10,DEBIT,6500.0,M1510333744
4172,409000493210',2018-07-10,OXYGEN NFS SETT 07-07-201,5000.0,0.0,4907413.110000005,2018,7,10,CHECK_WITHDRAWAL,5000.0,M230610941
4173,409000493210',2018-07-10,OXYGEN NFS SETT 07-07-201,4700.0,0.0,4902713.110000005,2018,7,10,CASH_OUT,4700.0,C998351292
4174,409000493210',2018-07-10,OXYGEN NFS SETT 07-07-201,2000.0,0.0,4900713.110000005,2018,7,10,PAYEMENT,2000.0,M2120154283
4175,409000493210',2018-07-10,OXYGEN NFS SETT 07-07-201,3000.0,0.0,4897713.110000005,2018,7,10,CASH_OUT,3000.0,M30604162
4176,409000493210',2018-07-10,OXYGEN NFS SETT 07-07-201,7700.0,0.0,4890013.110000005,2018,7,10,CASH_OUT,7700.0,M1035361293
4177,409000493210',2018-07-10,OXYGEN NFS SETT 07-07-201,7200.0,0.0,4882813.110000005,2018,7,10,CHECK_WITHDRAWAL,7200.0,M147077478
4178,409000493210',2018-07-10,OXYGEN NFS SETT 07-07-201,8000.0,0.0,4874813.110000005,2018,7,10,PAYEMENT,8000.0,M295937119
4179,409000493210',2018-07-10,OXYGEN NFS SETT 07-07-201,200.0,0.0,4874613.110000005,2018,7,10,CHECK_WITHDRAWAL,200.0,C13226198
4180,409000493210',2018-07-10,OXYGEN NFS SETT 07-07-201,9500.0,0.0,4865113.110000005,2018,7,10,PAYEMENT,9500.0,M146842175
4181,409000493210',2018-07-10,OXYGEN NFS SETT 07-07-201,7500.0,0.0,4857613.110000005,2018,7,10,DEBIT,7500.0,C20671747
4182,409000493210',2018-07-10,OXYGEN NFS SETT 07-07-201,6000.0,0.0,4851613.110000005,2018,7,10,CASH_OUT,6000.0,M489200959
4183,409000493210',2018-07-10,OXYGEN NFS SETT 07-07-201,5500.0,0.0,4846113.110000005,2018,7,10,DEBIT,5500.0,C1922859107
4184,409000493210',2018-07-10,OXYGEN NFS SETT 07-07-201,200.0,0.0,4845913.110000005,2018,7,10,DEBIT,200.0,M479769835
4185,409000493210',2018-07-10,OXYGEN NFS SETT 07-07-201,9000.0,0.0,4836913.110000005,2018,7,10,DEBIT,9000.0,M1969958288
4186,409000493210',2018-07-10,OXYGEN NFS SETT 07-07-201,8000.0,0.0,4828913.110000005,2018,7,10,CASH_OUT,8000.0,M1824931880
4187,409000493210',2018-07-10,OXYGEN NFS SETT 07-07-201,200.0,0.0,4828713.110000005,2018,7,10,DEBIT,200.0,C929856893
4188,409000493210',2018-07-10,OXYGEN NFS SETT 07-07-201,1300.0,0.0,4827413.110000005,2018,7,10,DEBIT,1300.0,M873249151
4189,409000493210',2018-07-10,OXYGEN NFS SETT 07-07-201,2500.0,0.0,4824913.110000005,2018,7,10,CHECK_WITHDRAWAL,2500.0,M298355914
4190,409000493210',2018-07-10,OXYGEN NFS SETT 07-07-201,7000.0,0.0,4817913.110000005,2018,7,10,DEBIT,7000.0,M1243705012
4191,409000493210',2018-07-10,OXYGEN NFS SETT 07-07-201,1500.0,0.0,4816413.110000005,2018,7,10,PAYEMENT,1500.0,M1590202270
4192,409000493210',2018-07-10,OXYGEN NFS SETT 07-07-201,10000.0,0.0,4806413.110000005,2018,7,10,CHECK_WITHDRAWAL,10000.0,M990994954
4193,409000493210',2018-07-10,OXYGEN NFS SETT 07-07-201,400.0,0.0,4806013.110000005,2018,7,10,PAYEMENT,400.0,C995911260
4194,409000493210',2018-07-10,OXYGEN NFS SETT 07-07-201,1000.0,0.0,4805013.110000005,2018,7,10,CHECK_WITHDRAWAL,1000.0,C24119573
4195,409000493210',2018-07-10,OXYGEN NFS SETT 07-07-201,800.0,0.0,4804213.110000005,2018,7,10,DEBIT,800.0,C1711105800
4196,409000493210',2018-07-10,OXYGEN NFS SETT 07-07-201,9000.0,0.0,4795213.110000005,2018,7,10,DEBIT,9000.0,M2050083360
4197,409000493210',2018-07-10,OXYGEN NFS SETT 07-07-201,700.0,0.0,4794513.110000005,2018,7,10,DEBIT,700.0,M569235601
4198,409000493210',2018-07-10,OXYGEN NFS SETT 07-07-201,10000.0,0.0,4784513.110000005,2018,7,10,CHECK_WITHDRAWAL,10000.0,M2037498537
4199,409000493210',2018-07-10,OXYGEN NFS SETT 07-07-201,1000.0,0.0,4783513.110000005,2018,7,10,PAYEMENT,1000.0,M1622534157
4200,409000493210',2018-07-10,OXYGEN NFS SETT 07-07-201,8800.0,0.0,4774713.110000005,2018,7,10,DEBIT,8800.0,C99219259
4201,409000493210',2018-07-10,OXYGEN NFS SETT 07-07-201,8000.0,0.0,4766713.110000005,2018,7,10,CHECK_WITHDRAWAL,8000.0,M40626598
4202,409000493210',2018-07-10,OXYGEN NFS SETT 07-07-201,7500.0,0.0,4759213.110000005,2018,7,10,DEBIT,7500.0,M1092591822
4203,409000493210',2018-07-10,OXYGEN NFS SETT 07-07-201,100.0,0.0,4759113.110000005,2018,7,10,CASH_OUT,100.0,M2028372993
4204,409000493210',2018-07-10,OXYGEN NFS SETT 07-07-201,7900.0,0.0,4751213.110000005,2018,7,10,DEBIT,7900.0,C667346055
4205,409000493210',2018-07-10,OXYGEN NFS SETT 07-07-201,7500.0,0.0,4743713.110000005,2018,7,10,DEBIT,7500.0,M1268629255
4206,409000493210',2018-07-10,OXYGEN NFS SETT 07-07-201,2500.0,0.0,4741213.110000005,2018,7,10,CASH_OUT,2500.0,M381516513
4207,409000493210',2018-07-10,OXYGEN NFS SETT 07-07-201,4500.0,0.0,4736713.110000005,2018,7,10,CHECK_WITHDRAWAL,4500.0,M856880372
4208,409000493210',2018-07-10,OXYGEN NFS SETT 07-07-201,300.0,0.0,4736413.110000005,2018,7,10,CHECK_WITHDRAWAL,300.0,M1993191331
4209,409000493210',2018-07-10,OXYGEN NFS SETT 07-07-201,6000.0,0.0,4730413.110000005,2018,7,10,CHECK_WITHDRAWAL,6000.0,M1337347604
4210,409000493210',2018-07-10,OXYGEN NFS SETT 07-07-201,8000.0,0.0,4722413.110000005,2018,7,10,DEBIT,8000.0,M170611939
4211,409000493210',2018-07-10,OXYGEN NFS SETT 07-07-201,10000.0,0.0,4712413.110000005,2018,7,10,PAYEMENT,10000.0,C1032986144
4212,409000493210',2018-07-10,OXYGEN NFS SETT 07-07-201,2700.0,0.0,4709713.110000005,2018,7,10,CHECK_WITHDRAWAL,2700.0,M854202039
4213,409000493210',2018-07-10,OXYGEN NFS SETT 07-07-201,10000.0,0.0,4699713.110000005,2018,7,10,DEBIT,10000.0,M1492276401
4214,409000493210',2018-07-10,OXYGEN NFS SETT 07-07-201,1700.0,0.0,4698013.110000005,2018,7,10,DEBIT,1700.0,M604976394
4215,409000493210',2018-07-10,OXYGEN NFS SETT 07-07-201,8900.0,0.0,4689113.110000005,2018,7,10,DEBIT,8900.0,M989001798
4216,409000493210',2018-07-10,OXYGEN NFS SETT 07-07-201,10000.0,0.0,4679113.110000005,2018,7,10,DEBIT,10000.0,M923570200
4217,409000493210',2018-07-10,Indiaforensic NFS SETT 09-07-201,5000.0,0.0,4674113.110000005,2018,7,10,PAYEMENT,5000.0,M287056540
4218,409000493210',2018-07-10,Indiaforensic NFS SETT 09-07-201,400.0,0.0,4673713.110000005,2018,7,10,PAYEMENT,400.0,M437583344
4219,409000493210',2018-07-10,Indiaforensic NFS SETT 09-07-201,300.0,0.0,4673413.110000005,2018,7,10,PAYEMENT,300.0,M1488130490
4220,409000493210',2018-07-10,Indiaforensic NFS SETT 09-07-201,8500.0,0.0,4664913.110000005,2018,7,10,DEBIT,8500.0,M1978317461
4221,409000493210',2018-07-10,Indiaforensic NFS SETT 09-07-201,500.0,0.0,4664413.110000005,2018,7,10,CHECK_WITHDRAWAL,500.0,M1130250604
4222,409000493210',2018-07-10,Indiaforensic NFS SETT 09-07-201,1000.0,0.0,4663413.110000005,2018,7,10,CHECK_WITHDRAWAL,1000.0,C384887832
4223,409000493210',2018-07-10,Indiaforensic NFS SETT 09-07-201,6000.0,0.0,4657413.110000005,2018,7,10,PAYEMENT,6000.0,C20671747
4224,409000493210',2018-07-10,Indiaforensic NFS SETT 09-07-201,3000.0,0.0,4654413.110000005,2018,7,10,CASH_OUT,3000.0,M2111615196
4225,409000493210',2018-07-10,Indiaforensic NFS SETT 09-07-201,2000.0,0.0,4652413.110000005,2018,7,10,CASH_OUT,2000.0,C1504109395
4226,409000493210',2018-07-10,Indiaforensic NFS SETT 09-07-201,4000.0,0.0,4648413.110000005,2018,7,10,PAYEMENT,4000.0,C1877453512
4227,409000493210',2018-07-10,Indiaforensic NFS SETT 09-07-201,8000.0,0.0,4640413.110000005,2018,7,10,CHECK_WITHDRAWAL,8000.0,C1023714065
4228,409000493210',2018-07-10,Indiaforensic NFS SETT 09-07-201,9500.0,0.0,4630913.110000005,2018,7,10,DEBIT,9500.0,C1065443868
4229,409000493210',2018-07-10,Indiaforensic NFS SETT 09-07-201,3000.0,0.0,4627913.110000005,2018,7,10,PAYEMENT,3000.0,C1167066016
4230,409000493210',2018-07-10,Indiaforensic NFS SETT 09-07-201,5000.0,0.0,4622913.110000005,2018,7,10,CHECK_WITHDRAWAL,5000.0,C2118255842
4231,409000493210',2018-07-10,Indiaforensic NFS SETT 09-07-201,9000.0,0.0,4613913.110000005,2018,7,10,DEBIT,9000.0,C2063763486
4232,409000493210',2018-07-10,Indiaforensic NFS SETT 09-07-201,8500.0,0.0,4605413.110000005,2018,7,10,CASH_OUT,8500.0,C1590550415
4233,409000493210',2018-07-10,Indiaforensic NFS SETT 09-07-201,10000.0,0.0,4595413.110000005,2018,7,10,CHECK_WITHDRAWAL,10000.0,C1870252780
4234,409000493210',2018-07-10,Indiaforensic NFS SETT 09-07-201,7000.0,0.0,4588413.110000005,2018,7,10,PAYEMENT,7000.0,C932583850
4235,409000493210',2018-07-10,Indiaforensic NFS SETT 09-07-201,10000.0,0.0,4578413.110000005,2018,7,10,CASH_OUT,10000.0,C709091500
4236,409000493210',2018-07-10,Indiaforensic NFS SETT 09-07-201,2000.0,0.0,4576413.110000005,2018,7,10,CASH_OUT,2000.0,C187649742
4237,409000493210',2018-07-10,Indiaforensic NFS SETT 09-07-201,10000.0,0.0,4566413.110000005,2018,7,10,CHECK_WITHDRAWAL,10000.0,C1023714065
4238,409000493210',2018-07-10,Indiaforensic NFS SETT 09-07-201,1000.0,0.0,4565413.110000005,2018,7,10,CASH_OUT,1000.0,C413177525
4239,409000493210',2018-07-10,Indiaforensic NFS SETT 09-07-201,6000.0,0.0,4559413.110000005,2018,7,10,PAYEMENT,6000.0,C1286084959
4240,409000493210',2018-07-10,Indiaforensic NFS SETT 09-07-201,8500.0,0.0,4550913.110000005,2018,7,10,PAYEMENT,8500.0,C977993101
4241,409000493210',2018-07-10,Indiaforensic NFS SETT 09-07-201,7000.0,0.0,4543913.110000005,2018,7,10,CHECK_WITHDRAWAL,7000.0,C728885526
4242,409000493210',2018-07-10,Indiaforensic NFS SETT 09-07-201,6000.0,0.0,4537913.110000005,2018,7,10,CASH_OUT,6000.0,M109673034
4243,409000493210',2018-07-10,Indiaforensic NFS SETT 09-07-201,500.0,0.0,4537413.110000005,2018,7,10,DEBIT,500.0,M113042195
4244,409000493210',2018-07-10,Indiaforensic NFS SETT 09-07-201,3800.0,0.0,4533613.110000005,2018,7,10,CHECK_WITHDRAWAL,3800.0,C569022831
4245,409000493210',2018-07-10,Indiaforensic NFS SETT 09-07-201,10000.0,0.0,4523613.110000005,2018,7,10,DEBIT,10000.0,M715213542
4246,409000493210',2018-07-10,Indiaforensic NFS SETT 09-07-201,2500.0,0.0,4521113.110000005,2018,7,10,DEBIT,2500.0,M1097397209
4247,409000493210',2018-07-10,Indiaforensic  RUPAY SETT 100718,219.08,0.0,4520894.030000005,2018,7,10,PAYEMENT,219.08,M367589810
4248,409000493210',2018-07-11,Indiaforensic  RUPAY SETT 110718,757.15,0.0,4520136.880000005,2018,7,11,CHECK_WITHDRAWAL,757.15,M2090142523
4249,409000493210',2018-07-11,TRF FROM  Indiaforensic SERVICES,0.0,70000.0,4590136.880000005,2018,7,11,TRANSFER,70000.0,M1745241742
4250,409000493210',2018-07-11,Indiaforensic  RUPAY SETT 110718,10.0,0.0,4590126.880000005,2018,7,11,DEBIT,10.0,M1751325469
4251,409000493210',2018-07-12,Indiaforensic  RUPAY SETT 120718,2048.43,0.0,4588078.450000005,2018,7,12,CASH_OUT,2048.43,M10536382
4252,409000493210',2018-07-12,Indiaforensic  RUPAY SETT 120718,966.42,0.0,4587112.030000005,2018,7,12,PAYEMENT,966.42,C1261031890
4253,409000493210',2018-07-12,Indiaforensic NFS SETT 08-07-201,9800.0,0.0,4577312.030000005,2018,7,12,CHECK_WITHDRAWAL,9800.0,C667346055
4254,409000493210',2018-07-12,Indiaforensic NFS SETT 08-07-201,10000.0,0.0,4567312.030000005,2018,7,12,CHECK_WITHDRAWAL,10000.0,M241316255
4255,409000493210',2018-07-12,Indiaforensic NFS SETT 08-07-201,800.0,0.0,4566512.030000005,2018,7,12,PAYEMENT,800.0,M614516107
4256,409000493210',2018-07-12,Indiaforensic NFS SETT 08-07-201,5000.0,0.0,4561512.030000005,2018,7,12,PAYEMENT,5000.0,C173783788
4257,409000493210',2018-07-12,Indiaforensic NFS SETT 08-07-201,1000.0,0.0,4560512.030000005,2018,7,12,DEBIT,1000.0,C1761291320
4258,409000493210',2018-07-12,Indiaforensic NFS SETT 08-07-201,8800.0,0.0,4551712.030000005,2018,7,12,CHECK_WITHDRAWAL,8800.0,M974242027
4259,409000493210',2018-07-12,Indiaforensic NFS SETT 08-07-201,100.0,0.0,4551612.030000005,2018,7,12,CASH_OUT,100.0,M741095751
4260,409000493210',2018-07-12,Indiaforensic NFS SETT 08-07-201,3800.0,0.0,4547812.030000005,2018,7,12,CASH_OUT,3800.0,C1002031672
4261,409000493210',2018-07-12,Indiaforensic NFS SETT 08-07-201,2500.0,0.0,4545312.030000005,2018,7,12,CASH_OUT,2500.0,C573200870
4262,409000493210',2018-07-12,Indiaforensic NFS SETT 08-07-201,8000.0,0.0,4537312.030000005,2018,7,12,CHECK_WITHDRAWAL,8000.0,M511094763
4263,409000493210',2018-07-12,Indiaforensic NFS SETT 08-07-201,1000.0,0.0,4536312.030000005,2018,7,12,CHECK_WITHDRAWAL,1000.0,M1045250282
4264,409000493210',2018-07-12,Indiaforensic NFS SETT 08-07-201,4900.0,0.0,4531412.030000005,2018,7,12,PAYEMENT,4900.0,M748523772
4265,409000493210',2018-07-12,Indiaforensic NFS SETT 08-07-201,2000.0,0.0,4529412.030000005,2018,7,12,DEBIT,2000.0,M1099925775
4266,409000493210',2018-07-12,Indiaforensic NFS SETT 08-07-201,7000.0,0.0,4522412.030000005,2018,7,12,PAYEMENT,7000.0,M2103895364
4267,409000493210',2018-07-12,Indiaforensic NFS SETT 08-07-201,1000.0,0.0,4521412.030000005,2018,7,12,PAYEMENT,1000.0,M1528574692
4268,409000493210',2018-07-12,Indiaforensic NFS SETT 08-07-201,10000.0,0.0,4511412.030000005,2018,7,12,PAYEMENT,10000.0,M1220292558
4269,409000493210',2018-07-12,Indiaforensic NFS SETT 08-07-201,400.0,0.0,4511012.030000005,2018,7,12,DEBIT,400.0,M620471432
4270,409000493210',2018-07-12,Indiaforensic NFS SETT 08-07-201,5900.0,0.0,4505112.030000005,2018,7,12,PAYEMENT,5900.0,M1515016092
4271,409000493210',2018-07-12,Indiaforensic NFS SETT 08-07-201,1000.0,0.0,4504112.030000005,2018,7,12,CHECK_WITHDRAWAL,1000.0,M1822115007
4272,409000493210',2018-07-12,Indiaforensic NFS SETT 08-07-201,6000.0,0.0,4498112.030000005,2018,7,12,CHECK_WITHDRAWAL,6000.0,M421135185
4273,409000493210',2018-07-12,Indiaforensic NFS SETT 08-07-201,10000.0,0.0,4488112.030000005,2018,7,12,DEBIT,10000.0,M1371182382
4274,409000493210',2018-07-12,Indiaforensic NFS SETT 08-07-201,4500.0,0.0,4483612.030000005,2018,7,12,CHECK_WITHDRAWAL,4500.0,C1926673338
4275,409000493210',2018-07-12,Indiaforensic NFS SETT 08-07-201,3000.0,0.0,4480612.030000005,2018,7,12,CASH_OUT,3000.0,M507575219
4276,409000493210',2018-07-12,Indiaforensic NFS SETT 08-07-201,500.0,0.0,4480112.030000005,2018,7,12,CHECK_WITHDRAWAL,500.0,M165687172
4277,409000493210',2018-07-12,Indiaforensic NFS SETT 08-07-201,7000.0,0.0,4473112.030000005,2018,7,12,CASH_OUT,7000.0,M132423149
4278,409000493210',2018-07-12,Indiaforensic NFS SETT 08-07-201,5000.0,0.0,4468112.030000005,2018,7,12,DEBIT,5000.0,M611890729
4279,409000493210',2018-07-12,Indiaforensic NFS SETT 08-07-201,5500.0,0.0,4462612.030000005,2018,7,12,DEBIT,5500.0,M439010439
4280,409000493210',2018-07-12,Indiaforensic NFS SETT 08-07-201,7000.0,0.0,4455612.030000005,2018,7,12,CASH_OUT,7000.0,C1750563752
4281,409000493210',2018-07-12,Indiaforensic NFS SETT 08-07-201,10000.0,0.0,4445612.030000005,2018,7,12,CHECK_WITHDRAWAL,10000.0,M518349613
4282,409000493210',2018-07-12,Indiaforensic NFS SETT 08-07-201,1900.0,0.0,4443712.030000005,2018,7,12,PAYEMENT,1900.0,C728885526
4283,409000493210',2018-07-12,Indiaforensic NFS SETT 08-07-201,6500.0,0.0,4437212.030000005,2018,7,12,CASH_OUT,6500.0,M1917214386
4284,409000493210',2018-07-12,Indiaforensic NFS SETT 08-07-201,7000.0,0.0,4430212.030000005,2018,7,12,CASH_OUT,7000.0,M701652581
4285,409000493210',2018-07-12,Indiaforensic NFS SETT 08-07-201,700.0,0.0,4429512.030000005,2018,7,12,DEBIT,700.0,M1506030945
4286,409000493210',2018-07-12,Indiaforensic NFS SETT 08-07-201,1900.0,0.0,4427612.030000005,2018,7,12,DEBIT,1900.0,C1877453512
4287,409000493210',2018-07-12,Indiaforensic NFS SETT 08-07-201,9000.0,0.0,4418612.030000005,2018,7,12,CHECK_WITHDRAWAL,9000.0,M2065196426
4288,409000493210',2018-07-12,Indiaforensic NFS SETT 08-07-201,9000.0,0.0,4409612.030000005,2018,7,12,CHECK_WITHDRAWAL,9000.0,M438270414
4289,409000493210',2018-07-12,Indiaforensic NFS SETT 08-07-201,10000.0,0.0,4399612.030000005,2018,7,12,CHECK_WITHDRAWAL,10000.0,M1386999197
4290,409000493210',2018-07-12,Indiaforensic NFS SETT 08-07-201,1500.0,0.0,4398112.030000005,2018,7,12,PAYEMENT,1500.0,M1227612217
4291,409000493210',2018-07-12,Indiaforensic NFS SETT 08-07-201,1500.0,0.0,4396612.030000005,2018,7,12,CHECK_WITHDRAWAL,1500.0,M286840121
4292,409000493210',2018-07-12,Indiaforensic NFS SETT 08-07-201,2500.0,0.0,4394112.030000005,2018,7,12,CASH_OUT,2500.0,M1981900848
4293,409000493210',2018-07-12,Indiaforensic NFS SETT 08-07-201,500.0,0.0,4393612.030000005,2018,7,12,DEBIT,500.0,M767060604
4294,409000493210',2018-07-12,Indiaforensic NFS SETT 08-07-201,3500.0,0.0,4390112.030000005,2018,7,12,PAYEMENT,3500.0,M1526901124
4295,409000493210',2018-07-12,Indiaforensic NFS SETT 08-07-201,7000.0,0.0,4383112.030000005,2018,7,12,CHECK_WITHDRAWAL,7000.0,M958209587
4296,409000493210',2018-07-12,Indiaforensic NFS SETT 08-07-201,800.0,0.0,4382312.030000005,2018,7,12,PAYEMENT,800.0,M678538385
4297,409000493210',2018-07-12,Indiaforensic NFS SETT 10-07-201,500.0,0.0,4381812.030000005,2018,7,12,DEBIT,500.0,M1835638995
4298,409000493210',2018-07-12,Indiaforensic NFS SETT 10-07-201,500.0,0.0,4381312.030000005,2018,7,12,PAYEMENT,500.0,M629092599
4299,409000493210',2018-07-12,Indiaforensic NFS SETT 10-07-201,6000.0,0.0,4375312.030000005,2018,7,12,DEBIT,6000.0,M529621529
4300,409000493210',2018-07-12,Indiaforensic NFS SETT 10-07-201,8000.0,0.0,4367312.030000005,2018,7,12,PAYEMENT,8000.0,M990413155
4301,409000493210',2018-07-12,Indiaforensic NFS SETT 10-07-201,500.0,0.0,4366812.030000005,2018,7,12,PAYEMENT,500.0,M1629292387
4302,409000493210',2018-07-12,Indiaforensic NFS SETT 10-07-201,7000.0,0.0,4359812.030000005,2018,7,12,PAYEMENT,7000.0,M505572301
4303,409000493210',2018-07-12,Indiaforensic NFS SETT 10-07-201,1000.0,0.0,4358812.030000005,2018,7,12,CASH_OUT,1000.0,M589489519
4304,409000493210',2018-07-12,Indiaforensic NFS SETT 10-07-201,1000.0,0.0,4357812.030000005,2018,7,12,DEBIT,1000.0,M947069796
4305,409000493210',2018-07-12,Indiaforensic NFS SETT 10-07-201,8300.0,0.0,4349512.030000005,2018,7,12,CHECK_WITHDRAWAL,8300.0,C1060830840
4306,409000493210',2018-07-12,Indiaforensic NFS SETT 10-07-201,700.0,0.0,4348812.030000005,2018,7,12,CHECK_WITHDRAWAL,700.0,M1866002564
4307,409000493210',2018-07-12,Indiaforensic NFS SETT 10-07-201,200.0,0.0,4348612.030000005,2018,7,12,CHECK_WITHDRAWAL,200.0,C1289462509
4308,409000493210',2018-07-12,Indiaforensic NFS SETT 10-07-201,500.0,0.0,4348112.030000005,2018,7,12,DEBIT,500.0,C1453128758
4309,409000493210',2018-07-12,Indiaforensic NFS SETT 10-07-201,9000.0,0.0,4339112.030000005,2018,7,12,DEBIT,9000.0,C1816757085
4310,409000493210',2018-07-12,Indiaforensic NFS SETT 11-07-201,500.0,0.0,4338612.030000005,2018,7,12,CHECK_WITHDRAWAL,500.0,C728885526
4311,409000493210',2018-07-12,Indiaforensic NFS SETT 11-07-201,1300.0,0.0,4337312.030000005,2018,7,12,CHECK_WITHDRAWAL,1300.0,C997608398
4312,409000493210',2018-07-12,Indiaforensic NFS SETT 11-07-201,4500.0,0.0,4332812.030000005,2018,7,12,PAYEMENT,4500.0,C1234776885
4313,409000493210',2018-07-12,Indiaforensic NFS SETT 11-07-201,1300.0,0.0,4331512.030000005,2018,7,12,CASH_OUT,1300.0,C1467740330
4314,409000493210',2018-07-12,Indiaforensic NFS SETT 11-07-201,100.0,0.0,4331412.030000005,2018,7,12,DEBIT,100.0,C1498438472
4315,409000493210',2018-07-12,Indiaforensic NFS SETT 11-07-201,9000.0,0.0,4322412.030000005,2018,7,12,DEBIT,9000.0,C1782113663
4316,409000493210',2018-07-12,Indiaforensic NFS SETT 11-07-201,4000.0,0.0,4318412.030000005,2018,7,12,PAYEMENT,4000.0,C1789550256
4317,409000493210',2018-07-12,Indiaforensic NFS SETT 11-07-201,4000.0,0.0,4314412.030000005,2018,7,12,DEBIT,4000.0,C667346055
4318,409000493210',2018-07-12,Indiaforensic NFS SETT 11-07-201,3700.0,0.0,4310712.030000005,2018,7,12,CASH_OUT,3700.0,C1388157479
4319,409000493210',2018-07-12,Indiaforensic NFS SETT 11-07-201,1000.0,0.0,4309712.030000005,2018,7,12,DEBIT,1000.0,C173783788
4320,409000493210',2018-07-12,Indiaforensic NFS SETT 11-07-201,2000.0,0.0,4307712.030000005,2018,7,12,PAYEMENT,2000.0,C1286084959
4321,409000493210',2018-07-12,Indiaforensic NFS SETT 11-07-201,400.0,0.0,4307312.030000005,2018,7,12,DEBIT,400.0,C1446521801
4322,409000493210',2018-07-12,Indiaforensic NFS SETT 11-07-201,300.0,0.0,4307012.030000005,2018,7,12,CHECK_WITHDRAWAL,300.0,C728526866
4323,409000493210',2018-07-12,Indiaforensic NFS SETT 11-07-201,400.0,0.0,4306612.030000005,2018,7,12,PAYEMENT,400.0,C1452722471
4324,409000493210',2018-07-12,Indiaforensic NFS SETT 11-07-201,200.0,0.0,4306412.030000005,2018,7,12,CHECK_WITHDRAWAL,200.0,C564160838
4325,409000493210',2018-07-12,Indiaforensic NFS SETT 11-07-201,1100.0,0.0,4305312.030000005,2018,7,12,CASH_OUT,1100.0,C97730845
4326,409000493210',2018-07-12,Indiaforensic NFS SETT 11-07-201,2000.0,0.0,4303312.030000005,2018,7,12,PAYEMENT,2000.0,C2083562754
4327,409000493210',2018-07-12,Indiaforensic NFS SETT 11-07-201,500.0,0.0,4302812.030000005,2018,7,12,DEBIT,500.0,C1870252780
4328,409000493210',2018-07-13,Indiaforensic  RUPAY SETT 130718,6988.26,0.0,4295823.770000005,2018,7,13,DEBIT,6988.26,C811597470
4329,409000493210',2018-07-13,Indiaforensic  RUPAY SETT 130718,302.12,0.0,4295521.650000005,2018,7,13,CHECK_WITHDRAWAL,302.12,C1782113663
4330,409000493210',2018-07-16,Indiaforensic RUPAY SETT 140718,3258.27,0.0,4292263.3800000055,2018,7,16,DEBIT,3258.27,C997608398
4331,409000493210',2018-07-16,Indiaforensic RUPAY SETT 150718,21688.44,0.0,4270574.940000005,2018,7,16,DEBIT,21688.44,C1721246982
4332,409000493210',2018-07-16,Indiaforensic RUPAY SETT 160718,41652.65,0.0,4228922.290000005,2018,7,16,DEBIT,41652.65,C1303868418
4333,409000493210',2018-07-16,Indiaforensic  RUPAY SETT 160718,6085.66,0.0,4222836.630000005,2018,7,16,CASH_OUT,6085.66,C1163619825
4334,409000493210',2018-07-16,Indiaforensic NFS SETT 13-07-201,5000.0,0.0,4217836.630000005,2018,7,16,PAYEMENT,5000.0,C1538745405
4335,409000493210',2018-07-16,Indiaforensic NFS SETT 13-07-201,5000.0,0.0,4212836.630000005,2018,7,16,DEBIT,5000.0,C1067155425
4336,409000493210',2018-07-16,Indiaforensic NFS SETT 13-07-201,200.0,0.0,4212636.630000005,2018,7,16,DEBIT,200.0,C728885526
4337,409000493210',2018-07-16,Indiaforensic NFS SETT 13-07-201,2000.0,0.0,4210636.630000005,2018,7,16,CHECK_WITHDRAWAL,2000.0,C1674899618
4338,409000493210',2018-07-16,Indiaforensic NFS SETT 13-07-201,8500.0,0.0,4202136.630000005,2018,7,16,CHECK_WITHDRAWAL,8500.0,C2117043942
4339,409000493210',2018-07-16,Indiaforensic NFS SETT 13-07-201,7500.0,0.0,4194636.630000005,2018,7,16,CHECK_WITHDRAWAL,7500.0,C1721246982
4340,409000493210',2018-07-16,Indiaforensic NFS SETT 13-07-201,1000.0,0.0,4193636.630000005,2018,7,16,CHECK_WITHDRAWAL,1000.0,C1122118227
4341,409000493210',2018-07-16,Indiaforensic NFS SETT 13-07-201,5000.0,0.0,4188636.630000005,2018,7,16,CASH_OUT,5000.0,M1370231468
4342,409000493210',2018-07-16,Indiaforensic NFS SETT 13-07-201,7000.0,0.0,4181636.630000005,2018,7,16,CASH_OUT,7000.0,M2073484941
4343,409000493210',2018-07-16,Indiaforensic NFS SETT 13-07-201,1000.0,0.0,4180636.630000005,2018,7,16,CASH_OUT,1000.0,M1304765785
4344,409000493210',2018-07-16,Indiaforensic NFS SETT 13-07-201,10000.0,0.0,4170636.630000005,2018,7,16,PAYEMENT,10000.0,M294817977
4345,409000493210',2018-07-16,Indiaforensic NFS SETT 13-07-201,4000.0,0.0,4166636.630000005,2018,7,16,DEBIT,4000.0,M1657521272
4346,409000493210',2018-07-16,Indiaforensic NFS SETT 14-07-201,1000.0,0.0,4165636.630000005,2018,7,16,DEBIT,1000.0,M1361755941
4347,409000493210',2018-07-16,Indiaforensic NFS SETT 14-07-201,500.0,0.0,4165136.630000005,2018,7,16,PAYEMENT,500.0,M1829651877
4348,409000493210',2018-07-16,Indiaforensic NFS SETT 14-07-201,4000.0,0.0,4161136.630000005,2018,7,16,PAYEMENT,4000.0,C709091500
4349,409000493210',2018-07-16,Indiaforensic NFS SETT 14-07-201,8000.0,0.0,4153136.630000005,2018,7,16,CASH_OUT,8000.0,C903716563
4350,409000493210',2018-07-16,Indiaforensic NFS SETT 14-07-201,1500.0,0.0,4151636.630000005,2018,7,16,CASH_OUT,1500.0,M1633530712
4351,409000493210',2018-07-16,Indiaforensic NFS SETT 14-07-201,10000.0,0.0,4141636.630000005,2018,7,16,PAYEMENT,10000.0,M1609501721
4352,409000493210',2018-07-16,Indiaforensic NFS SETT 14-07-201,10000.0,0.0,4131636.630000005,2018,7,16,PAYEMENT,10000.0,M581359452
4353,409000493210',2018-07-16,Indiaforensic NFS SETT 14-07-201,300.0,0.0,4131336.630000005,2018,7,16,PAYEMENT,300.0,M2100297853
4354,409000493210',2018-07-16,Indiaforensic NFS SETT 14-07-201,6000.0,0.0,4125336.630000005,2018,7,16,CHECK_WITHDRAWAL,6000.0,M749030825
4355,409000493210',2018-07-16,Indiaforensic NFS SETT 14-07-201,500.0,0.0,4124836.630000005,2018,7,16,DEBIT,500.0,M1231864343
4356,409000493210',2018-07-16,Indiaforensic NFS SETT 14-07-201,800.0,0.0,4124036.630000005,2018,7,16,PAYEMENT,800.0,M483589979
4357,409000493210',2018-07-16,Indiaforensic NFS SETT 14-07-201,8000.0,0.0,4116036.630000005,2018,7,16,DEBIT,8000.0,M402622480
4358,409000493210',2018-07-16,Indiaforensic NFS SETT 14-07-201,6500.0,0.0,4109536.630000005,2018,7,16,DEBIT,6500.0,M1739986996
4359,409000493210',2018-07-16,Indiaforensic NFS SETT 14-07-201,10000.0,0.0,4099536.630000005,2018,7,16,CHECK_WITHDRAWAL,10000.0,C997608398
4360,409000493210',2018-07-16,Indiaforensic NFS SETT 14-07-201,8000.0,0.0,4091536.630000005,2018,7,16,CASH_OUT,8000.0,M350099713
4361,409000493210',2018-07-16,Indiaforensic NFS SETT 14-07-201,9000.0,0.0,4082536.630000005,2018,7,16,CHECK_WITHDRAWAL,9000.0,M301084728
4362,409000493210',2018-07-16,Indiaforensic NFS SETT 14-07-201,9000.0,0.0,4073536.630000005,2018,7,16,CASH_OUT,9000.0,M1763010538
4363,409000493210',2018-07-16,Indiaforensic NFS SETT 15-07-201,1000.0,0.0,4072536.630000005,2018,7,16,CASH_OUT,1000.0,M1552767213
4364,409000493210',2018-07-16,Indiaforensic NFS SETT 15-07-201,5000.0,0.0,4067536.630000005,2018,7,16,CHECK_WITHDRAWAL,5000.0,M683573228
4365,409000493210',2018-07-16,Indiaforensic NFS SETT 15-07-201,200.0,0.0,4067336.630000005,2018,7,16,PAYEMENT,200.0,M873688017
4366,409000493210',2018-07-16,Indiaforensic NFS SETT 15-07-201,200.0,0.0,4067136.630000005,2018,7,16,PAYEMENT,200.0,M914175168
4367,409000493210',2018-07-16,Indiaforensic NFS SETT 15-07-201,6000.0,0.0,4061136.630000005,2018,7,16,CHECK_WITHDRAWAL,6000.0,M1669392873
4368,409000493210',2018-07-16,Indiaforensic NFS SETT 15-07-201,1500.0,0.0,4059636.630000005,2018,7,16,CHECK_WITHDRAWAL,1500.0,M1778993228
4369,409000493210',2018-07-16,Indiaforensic NFS SETT 15-07-201,400.0,0.0,4059236.630000005,2018,7,16,CHECK_WITHDRAWAL,400.0,C1826334428
4370,409000493210',2018-07-17,Indiaforensic  RUPAY SETT 170718,10469.36,0.0,4048767.270000005,2018,7,17,DEBIT,10469.36,M145833361
4371,409000493210',2018-07-17,TRF FROM  Indiaforensic SERVICES,0.0,109225.0,4157992.270000005,2018,7,17,CHECK_CASHING,109225.0,C1604271704
4372,409000493210',2018-07-17,OXYGEN NFS SETT 12-07-201,100.0,0.0,4157892.270000005,2018,7,17,PAYEMENT,100.0,C1750563752
4373,409000493210',2018-07-17,OXYGEN NFS SETT 12-07-201,4500.0,0.0,4153392.270000005,2018,7,17,DEBIT,4500.0,M383005108
4374,409000493210',2018-07-17,OXYGEN NFS SETT 12-07-201,6000.0,0.0,4147392.270000005,2018,7,17,DEBIT,6000.0,M123045427
4375,409000493210',2018-07-17,OXYGEN NFS SETT 12-07-201,500.0,0.0,4146892.270000005,2018,7,17,CHECK_WITHDRAWAL,500.0,M1631143060
4376,409000493210',2018-07-17,OXYGEN NFS SETT 12-07-201,3000.0,0.0,4143892.270000005,2018,7,17,CHECK_WITHDRAWAL,3000.0,M2084912180
4377,409000493210',2018-07-17,OXYGEN NFS SETT 12-07-201,500.0,0.0,4143392.270000005,2018,7,17,PAYEMENT,500.0,M1040015904
4378,409000493210',2018-07-17,OXYGEN NFS SETT 12-07-201,500.0,0.0,4142892.270000005,2018,7,17,CHECK_WITHDRAWAL,500.0,M1843674049
4379,409000493210',2018-07-17,OXYGEN NFS SETT 12-07-201,3000.0,0.0,4139892.270000005,2018,7,17,PAYEMENT,3000.0,M1905486482
4380,409000493210',2018-07-17,OXYGEN NFS SETT 12-07-201,2500.0,0.0,4137392.270000005,2018,7,17,PAYEMENT,2500.0,C1540270363
4381,409000493210',2018-07-17,OXYGEN NFS SETT 12-07-201,300.0,0.0,4137092.270000005,2018,7,17,PAYEMENT,300.0,M1157856790
4382,409000493210',2018-07-17,OXYGEN NFS SETT 12-07-201,6500.0,0.0,4130592.270000005,2018,7,17,CASH_OUT,6500.0,M1646410010
4383,409000493210',2018-07-17,OXYGEN NFS SETT 12-07-201,100.0,0.0,4130492.270000005,2018,7,17,CHECK_WITHDRAWAL,100.0,M220661927
4384,409000493210',2018-07-17,OXYGEN NFS SETT 12-07-201,2500.0,0.0,4127992.270000005,2018,7,17,CASH_OUT,2500.0,M588503940
4385,409000493210',2018-07-17,OXYGEN NFS SETT 12-07-201,100.0,0.0,4127892.270000005,2018,7,17,DEBIT,100.0,M347354124
4386,409000493210',2018-07-17,OXYGEN NFS SETT 12-07-201,4400.0,0.0,4123492.270000005,2018,7,17,PAYEMENT,4400.0,C1297685781
4387,409000493210',2018-07-17,OXYGEN NFS SETT 12-07-201,300.0,0.0,4123192.270000005,2018,7,17,DEBIT,300.0,M362140338
4388,409000493210',2018-07-17,TRF FROM  Indiaforensic SERVICES,0.0,50000.0,4173192.270000005,2018,7,17,CHECK_CASHING,50000.0,C790722099
4389,409000493210',2018-07-17,Indiaforensic  RUPAY SETT 170718,190.71,0.0,4173001.560000005,2018,7,17,PAYEMENT,190.71,M215694469
4390,409000493210',2018-07-18,Indiaforensic  RUPAY SETT 180718,300.67,0.0,4172700.890000005,2018,7,18,DEBIT,300.67,M869437194
4391,409000493210',2018-07-18,Indiaforensic NFS SETT 16-07-201,4000.0,0.0,4168700.890000005,2018,7,18,DEBIT,4000.0,M1374115999
4392,409000493210',2018-07-18,Indiaforensic NFS SETT 16-07-201,1000.0,0.0,4167700.890000005,2018,7,18,PAYEMENT,1000.0,M1119955774
4393,409000493210',2018-07-18,Indiaforensic NFS SETT 16-07-201,1900.0,0.0,4165800.890000005,2018,7,18,DEBIT,1900.0,M1190608890
4394,409000493210',2018-07-18,Indiaforensic NFS SETT 16-07-201,2000.0,0.0,4163800.890000005,2018,7,18,DEBIT,2000.0,M184410212
4395,409000493210',2018-07-18,Indiaforensic NFS SETT 16-07-201,2000.0,0.0,4161800.890000005,2018,7,18,DEBIT,2000.0,M623820846
4396,409000493210',2018-07-18,Indiaforensic NFS SETT 16-07-201,600.0,0.0,4161200.890000005,2018,7,18,CASH_OUT,600.0,M1962049725
4397,409000493210',2018-07-18,Indiaforensic NFS SETT 16-07-201,2000.0,0.0,4159200.890000005,2018,7,18,CASH_OUT,2000.0,M875010954
4398,409000493210',2018-07-18,Indiaforensic NFS SETT 16-07-201,2000.0,0.0,4157200.890000005,2018,7,18,PAYEMENT,2000.0,M140778365
4399,409000493210',2018-07-18,Indiaforensic NFS SETT 16-07-201,2000.0,0.0,4155200.890000005,2018,7,18,CASH_OUT,2000.0,M1068781783
4400,409000493210',2018-07-18,Indiaforensic NFS SETT 17-07-201,9000.0,0.0,4146200.890000005,2018,7,18,PAYEMENT,9000.0,M1667859935
4401,409000493210',2018-07-18,Indiaforensic NFS SETT 17-07-201,8500.0,0.0,4137700.890000005,2018,7,18,PAYEMENT,8500.0,M1916681239
4402,409000493210',2018-07-18,Indiaforensic NFS SETT 17-07-201,2000.0,0.0,4135700.890000005,2018,7,18,PAYEMENT,2000.0,M1620368915
4403,409000493210',2018-07-18,Indiaforensic NFS SETT 17-07-201,1500.0,0.0,4134200.890000005,2018,7,18,PAYEMENT,1500.0,M65465460
4404,409000493210',2018-07-18,Indiaforensic NFS SETT 17-07-201,300.0,0.0,4133900.890000005,2018,7,18,CHECK_WITHDRAWAL,300.0,M1836765429
4405,409000493210',2018-07-18,Indiaforensic NFS SETT 17-07-201,6200.0,0.0,4127700.890000005,2018,7,18,DEBIT,6200.0,M77215921
4406,409000493210',2018-07-18,Indiaforensic NFS SETT 17-07-201,7100.0,0.0,4120600.890000005,2018,7,18,CASH_OUT,7100.0,M1406593369
4407,409000493210',2018-07-18,Indiaforensic NFS SETT 17-07-201,10000.0,0.0,4110600.890000005,2018,7,18,CASH_OUT,10000.0,M1772358460
4408,409000493210',2018-07-18,Indiaforensic NFS SETT 17-07-201,7700.0,0.0,4102900.890000005,2018,7,18,CASH_OUT,7700.0,M1713988669
4409,409000493210',2018-07-18,Indiaforensic NFS SETT 17-07-201,3000.0,0.0,4099900.890000005,2018,7,18,CASH_OUT,3000.0,C977993101
4410,409000493210',2018-07-18,Indiaforensic NFS SETT 17-07-201,5000.0,0.0,4094900.890000005,2018,7,18,DEBIT,5000.0,C1916720513
4411,409000493210',2018-07-18,Indiaforensic NFS SETT 17-07-201,6900.0,0.0,4088000.890000005,2018,7,18,PAYEMENT,6900.0,C726762476
4412,409000493210',2018-07-18,Indiaforensic NFS SETT 17-07-201,10000.0,0.0,4078000.890000005,2018,7,18,CHECK_WITHDRAWAL,10000.0,M1675999402
4413,409000493210',2018-07-18,Indiaforensic NFS SETT 17-07-201,10000.0,0.0,4068000.890000005,2018,7,18,CASH_OUT,10000.0,M1114681666
4414,409000493210',2018-07-18,Indiaforensic NFS SETT 17-07-201,10000.0,0.0,4058000.890000005,2018,7,18,CASH_OUT,10000.0,M1662312252
4415,409000493210',2018-07-18,Indiaforensic NFS SETT 17-07-201,1000.0,0.0,4057000.890000005,2018,7,18,DEBIT,1000.0,M280541440
4416,409000493210',2018-07-18,Indiaforensic NFS SETT 17-07-201,10000.0,0.0,4047000.890000005,2018,7,18,CHECK_WITHDRAWAL,10000.0,M671187578
4417,409000493210',2018-07-18,Indiaforensic NFS SETT 17-07-201,10000.0,0.0,4037000.890000005,2018,7,18,DEBIT,10000.0,M93974967
4418,409000493210',2018-07-18,Indiaforensic NFS SETT 17-07-201,10000.0,0.0,4027000.890000005,2018,7,18,DEBIT,10000.0,M105860882
4419,409000493210',2018-07-18,Indiaforensic NFS SETT 17-07-201,400.0,0.0,4026600.890000005,2018,7,18,CASH_OUT,400.0,M2097992252
4420,409000493210',2018-07-18,Indiaforensic NFS SETT 17-07-201,2500.0,0.0,4024100.890000005,2018,7,18,DEBIT,2500.0,M1796154990
4421,409000493210',2018-07-18,Indiaforensic NFS SETT 17-07-201,500.0,0.0,4023600.890000005,2018,7,18,PAYEMENT,500.0,M1395740534
4422,409000493210',2018-07-18,Indiaforensic  RUPAY SETT 180718,115.15,0.0,4023485.740000005,2018,7,18,CASH_OUT,115.15,M1887965475
4423,409000493210',2018-07-19,Indiaforensic  RUPAY SETT 190718,134.72,0.0,4023351.020000005,2018,7,19,CASH_OUT,134.72,M1586519852
4424,409000493210',2018-07-19,Indiaforensic  RUPAY SETT 190718,3221.42,0.0,4020129.600000005,2018,7,19,PAYEMENT,3221.42,M1064095359
4425,409000493210',2018-07-20,Indiaforensic  RUPAY SETT 200718,974.37,0.0,4019155.230000005,2018,7,20,CASH_OUT,974.37,M2073069810
4426,409000493210',2018-07-20,Indiaforensic NFS SETT 19-07-201,900.0,0.0,4018255.230000005,2018,7,20,DEBIT,900.0,M1138190994
4427,409000493210',2018-07-20,Indiaforensic NFS SETT 19-07-201,100.0,0.0,4018155.230000005,2018,7,20,DEBIT,100.0,M889398176
4428,409000493210',2018-07-20,Indiaforensic NFS SETT 19-07-201,1000.0,0.0,4017155.230000005,2018,7,20,CASH_OUT,1000.0,C1292838001
4429,409000493210',2018-07-20,Indiaforensic NFS SETT 19-07-201,2000.0,0.0,4015155.230000005,2018,7,20,DEBIT,2000.0,M1215025252
4430,409000493210',2018-07-20,Indiaforensic NFS SETT 19-07-201,100.0,0.0,4015055.230000005,2018,7,20,PAYEMENT,100.0,M1946917456
4431,409000493210',2018-07-20,Indiaforensic NFS SETT 19-07-201,1000.0,0.0,4014055.230000005,2018,7,20,PAYEMENT,1000.0,M1360125564
4432,409000493210',2018-07-20,Indiaforensic NFS SETT 19-07-201,100.0,0.0,4013955.230000005,2018,7,20,CHECK_WITHDRAWAL,100.0,M1379222018
4433,409000493210',2018-07-20,Indiaforensic NFS SETT 19-07-201,200.0,0.0,4013755.230000005,2018,7,20,CHECK_WITHDRAWAL,200.0,M875487383
4434,409000493210',2018-07-20,Indiaforensic NFS SETT 19-07-201,320.0,0.0,4013435.230000005,2018,7,20,PAYEMENT,320.0,M303638020
4435,409000493210',2018-07-20,Indiaforensic NFS SETT 19-07-201,2500.0,0.0,4010935.230000005,2018,7,20,PAYEMENT,2500.0,C1615535645
4436,409000493210',2018-07-20,Indiaforensic NFS SETT 19-07-201,2800.0,0.0,4008135.230000005,2018,7,20,DEBIT,2800.0,M1802555899
4437,409000493210',2018-07-20,Indiaforensic NFS SETT 19-07-201,1000.0,0.0,4007135.230000005,2018,7,20,DEBIT,1000.0,M2107760645
4438,409000493210',2018-07-20,Indiaforensic NFS SETT 19-07-201,4000.0,0.0,4003135.230000005,2018,7,20,DEBIT,4000.0,M1434940020
4439,409000493210',2018-07-20,Indiaforensic NFS SETT 19-07-201,200.0,0.0,4002935.230000005,2018,7,20,DEBIT,200.0,C644345897
4440,409000493210',2018-07-20,Indiaforensic  RUPAY SETT 200718,4001.42,0.0,3998933.810000005,2018,7,20,DEBIT,4001.42,C945327594
4441,409000493210',2018-07-20,Indiaforensic NFS SETT 18-07-201,4000.0,0.0,3994933.810000005,2018,7,20,CASH_OUT,4000.0,C766681183
4442,409000493210',2018-07-20,Indiaforensic NFS SETT 18-07-201,500.0,0.0,3994433.810000005,2018,7,20,PAYEMENT,500.0,C449261773
4443,409000493210',2018-07-20,Indiaforensic NFS SETT 18-07-201,8800.0,0.0,3985633.810000005,2018,7,20,DEBIT,8800.0,C932583850
4444,409000493210',2018-07-20,Indiaforensic NFS SETT 18-07-201,1000.0,0.0,3984633.810000005,2018,7,20,CHECK_WITHDRAWAL,1000.0,M82750270
4445,409000493210',2018-07-20,Indiaforensic NFS SETT 18-07-201,1000.0,0.0,3983633.810000005,2018,7,20,PAYEMENT,1000.0,M783339262
4446,409000493210',2018-07-20,Indiaforensic NFS SETT 18-07-201,800.0,0.0,3982833.810000005,2018,7,20,CHECK_WITHDRAWAL,800.0,M736888459
4447,409000493210',2018-07-20,Indiaforensic NFS SETT 18-07-201,500.0,0.0,3982333.810000005,2018,7,20,PAYEMENT,500.0,M1429610243
4448,409000493210',2018-07-20,Indiaforensic NFS SETT 18-07-201,9000.0,0.0,3973333.810000005,2018,7,20,CHECK_WITHDRAWAL,9000.0,C1359953204
4449,409000493210',2018-07-20,Indiaforensic NFS SETT 18-07-201,8500.0,0.0,3964833.810000005,2018,7,20,CASH_OUT,8500.0,M556773329
4450,409000493210',2018-07-20,Indiaforensic NFS SETT 18-07-201,200.0,0.0,3964633.810000005,2018,7,20,CHECK_WITHDRAWAL,200.0,M2021230836
4451,409000493210',2018-07-20,Indiaforensic NFS SETT 18-07-201,1000.0,0.0,3963633.810000005,2018,7,20,PAYEMENT,1000.0,M1327714567
4452,409000493210',2018-07-20,Indiaforensic NFS SETT 18-07-201,8000.0,0.0,3955633.810000005,2018,7,20,CHECK_WITHDRAWAL,8000.0,M475871799
4453,409000493210',2018-07-20,Indiaforensic NFS SETT 18-07-201,5000.0,0.0,3950633.810000005,2018,7,20,PAYEMENT,5000.0,M725873428
4454,409000493210',2018-07-20,Indiaforensic NFS SETT 18-07-201,500.0,0.0,3950133.810000005,2018,7,20,DEBIT,500.0,M1328764608
4455,409000493210',2018-07-20,Indiaforensic NFS SETT 18-07-201,400.0,0.0,3949733.810000005,2018,7,20,CASH_OUT,400.0,M1820545559
4456,409000493210',2018-07-21,Indiaforensic  RUPAY SETT 210718,968.92,0.0,3948764.890000005,2018,7,21,DEBIT,968.92,C1860564101
4457,409000493210',2018-07-21,Indiaforensic  RUPAY SETT 210718,1044.12,0.0,3947720.770000005,2018,7,21,PAYEMENT,1044.12,C977993101
4458,409000493210',2018-07-21,Indiaforensic NFS SETT 20-07-201,4000.0,0.0,3943720.770000005,2018,7,21,DEBIT,4000.0,C985934102
4459,409000493210',2018-07-21,Indiaforensic NFS SETT 20-07-201,5000.0,0.0,3938720.770000005,2018,7,21,DEBIT,5000.0,C998351292
4460,409000493210',2018-07-21,Indiaforensic NFS SETT 20-07-201,4500.0,0.0,3934220.770000005,2018,7,21,CASH_OUT,4500.0,C306206744
4461,409000493210',2018-07-23,Indiaforensic  RUPAY SETT 220718,7369.34,0.0,3926851.430000005,2018,7,23,PAYEMENT,7369.34,C1721246982
4462,409000493210',2018-07-23,Indiaforensic  RUPAY SETT 230718,10458.57,0.0,3916392.860000005,2018,7,23,CHECK_WITHDRAWAL,10458.57,C1065443868
4463,409000493210',2018-07-23,TRF FROM  Indiaforensic SERVICES,0.0,50000.0,3966392.860000005,2018,7,23,CHECK_CASHING,50000.0,C1750905143
4464,409000493210',2018-07-23,Indiaforensic NFS SETT 21-07-201,900.0,0.0,3965492.860000005,2018,7,23,CHECK_WITHDRAWAL,900.0,C575335780
4465,409000493210',2018-07-23,Indiaforensic NFS SETT 21-07-201,200.0,0.0,3965292.860000005,2018,7,23,DEBIT,200.0,C1816757085
4466,409000493210',2018-07-23,Indiaforensic NFS SETT 21-07-201,1500.0,0.0,3963792.860000005,2018,7,23,CASH_OUT,1500.0,C644345897
4467,409000493210',2018-07-23,Indiaforensic NFS SETT 22-07-201,200.0,0.0,3963592.860000005,2018,7,23,DEBIT,200.0,C728526866
4468,409000493210',2018-07-23,Indiaforensic NFS SETT 22-07-201,8500.0,0.0,3955092.860000005,2018,7,23,CHECK_WITHDRAWAL,8500.0,C1234776885
4469,409000493210',2018-07-23,Indiaforensic  RUPAY SETT 230718,5306.22,0.0,3949786.640000005,2018,7,23,DEBIT,5306.22,C1604271704
4470,409000493210',2018-07-24,Indiaforensic  RUPAY SETT 240718,2828.79,0.0,3946957.850000005,2018,7,24,CASH_OUT,2828.79,C1711105800
4471,409000493210',2018-07-24,Indiaforensic NFS SETT 23-07-201,1000.0,0.0,3945957.850000005,2018,7,24,CHECK_WITHDRAWAL,1000.0,C662736689
4472,409000493210',2018-07-24,Indiaforensic NFS SETT 23-07-201,900.0,0.0,3945057.850000005,2018,7,24,CHECK_WITHDRAWAL,900.0,C481402298
4473,409000493210',2018-07-24,Indiaforensic NFS SETT 23-07-201,500.0,0.0,3944557.850000005,2018,7,24,DEBIT,500.0,C481402298
4474,409000493210',2018-07-24,Indiaforensic  RUPAY SETT 240718,991.06,0.0,3943566.790000005,2018,7,24,CASH_OUT,991.06,C214774813
4475,409000493210',2018-07-25,Indiaforensic  RUPAY SETT 250718,821.54,0.0,3942745.250000005,2018,7,25,PAYEMENT,821.54,C644345897
4476,409000493210',2018-07-25,FDRL/INTERNAL FUND TRANSFE,0.0,100000.0,4042745.250000005,2018,7,25,CASH_IN,100000.0,C564160838
4477,409000493210',2018-07-25,FDRL/INTERNAL FUND TRANSFE,0.0,100000.0,4142745.250000005,2018,7,25,CHECK_CASHING,100000.0,C1935365522
4478,409000493210',2018-07-25,Indiaforensic  RUPAY SETT 250718,6992.39,0.0,4135752.860000005,2018,7,25,CHECK_WITHDRAWAL,6992.39,C490150701
4479,409000493210',2018-07-25,Indiaforensic NFS SETT 24-07-201,300.0,0.0,4135452.860000005,2018,7,25,CHECK_WITHDRAWAL,300.0,C214187874
4480,409000493210',2018-07-25,Indiaforensic NFS SETT 24-07-201,500.0,0.0,4134952.860000005,2018,7,25,CHECK_WITHDRAWAL,500.0,C214774813
4481,409000493210',2018-07-25,Indiaforensic NFS SETT 24-07-201,100.0,0.0,4134852.860000005,2018,7,25,CHECK_WITHDRAWAL,100.0,C317071334
4482,409000493210',2018-07-25,Indiaforensic NFS SETT 24-07-201,1000.0,0.0,4133852.860000005,2018,7,25,PAYEMENT,1000.0,C977993101
4483,409000493210',2018-07-25,Indiaforensic NFS SETT 24-07-201,1800.0,0.0,4132052.860000005,2018,7,25,DEBIT,1800.0,C934085675
4484,409000493210',2018-07-25,Indiaforensic NFS SETT 24-07-201,500.0,0.0,4131552.860000005,2018,7,25,PAYEMENT,500.0,C187649742
4485,409000493210',2018-07-26,Indiaforensic  RUPAY SETT 260718,390.88,0.0,4131161.980000005,2018,7,26,CHECK_WITHDRAWAL,390.88,C716083600
4486,409000493210',2018-07-26,Indiaforensic  RUPAY SETT 260718,10309.37,0.0,4120852.610000005,2018,7,26,DEBIT,10309.37,C1023714065
4487,409000493210',2018-07-26,Indiaforensic NFS SETT 25-07-201,400.0,0.0,4120452.610000005,2018,7,26,PAYEMENT,400.0,C1453128758
4488,409000493210',2018-07-26,Indiaforensic NFS SETT 25-07-201,2000.0,0.0,4118452.610000005,2018,7,26,CHECK_WITHDRAWAL,2000.0,C932583850
4489,409000493210',2018-07-26,Indiaforensic NFS SETT 25-07-201,800.0,0.0,4117652.610000005,2018,7,26,DEBIT,800.0,C1883840933
4490,409000493210',2018-07-26,Indiaforensic NFS SETT 25-07-201,200.0,0.0,4117452.610000005,2018,7,26,CHECK_WITHDRAWAL,200.0,C1899073220
4491,409000493210',2018-07-26,Indiaforensic NFS SETT 25-07-201,2000.0,0.0,4115452.610000005,2018,7,26,CHECK_WITHDRAWAL,2000.0,C392292416
4492,409000493210',2018-07-26,Indiaforensic NFS SETT 25-07-201,2500.0,0.0,4112952.610000005,2018,7,26,PAYEMENT,2500.0,C1883840933
4493,409000493210',2018-07-26,Indiaforensic NFS SETT 25-07-201,1500.0,0.0,4111452.610000005,2018,7,26,CHECK_WITHDRAWAL,1500.0,C929856893
4494,409000493210',2018-07-26,Indiaforensic NFS SETT 25-07-201,2400.0,0.0,4109052.610000005,2018,7,26,CHECK_WITHDRAWAL,2400.0,C564160838
4495,409000493210',2018-07-26,Indiaforensic NFS SETT 25-07-201,1000.0,0.0,4108052.610000005,2018,7,26,CASH_OUT,1000.0,C977993101
4496,409000493210',2018-07-26,Indiaforensic NFS SETT 25-07-201,1200.0,0.0,4106852.610000005,2018,7,26,PAYEMENT,1200.0,C1750563752
4497,409000493210',2018-07-26,Indiaforensic NFS SETT 25-07-201,1000.0,0.0,4105852.610000005,2018,7,26,DEBIT,1000.0,C453211571
4498,409000493210',2018-07-26,Indiaforensic NFS SETT 25-07-201,300.0,0.0,4105552.610000005,2018,7,26,PAYEMENT,300.0,C392292416
4499,409000493210',2018-07-26,Indiaforensic NFS SETT 25-07-201,300.0,0.0,4105252.610000005,2018,7,26,CASH_OUT,300.0,C11003494
4500,409000493210',2018-07-26,Indiaforensic NFS SETT 25-07-201,600.0,0.0,4104652.610000005,2018,7,26,CASH_OUT,600.0,C453211571
4501,409000493210',2018-07-26,Indiaforensic NFS SETT 25-07-201,200.0,0.0,4104452.610000005,2018,7,26,PAYEMENT,200.0,C1916720513
4502,409000493210',2018-07-26,Indiaforensic NFS SETT 25-07-201,100.0,0.0,4104352.610000005,2018,7,26,CHECK_WITHDRAWAL,100.0,C2118255842
4503,409000493210',2018-07-26,Indiaforensic NFS SETT 25-07-201,1000.0,0.0,4103352.610000005,2018,7,26,CASH_OUT,1000.0,C1916720513
4504,409000493210',2018-07-26,Indiaforensic NFS SETT 25-07-201,2000.0,0.0,4101352.610000005,2018,7,26,PAYEMENT,2000.0,C662736689
4505,409000493210',2018-07-26,Indiaforensic NFS SETT 25-07-201,500.0,0.0,4100852.610000005,2018,7,26,CASH_OUT,500.0,C766681183
4506,409000493210',2018-07-26,Indiaforensic NFS SETT 25-07-201,200.0,0.0,4100652.610000005,2018,7,26,CHECK_WITHDRAWAL,200.0,C769342184
4507,409000493210',2018-07-26,Indiaforensic NFS SETT 25-07-201,10000.0,0.0,4090652.610000005,2018,7,26,CASH_OUT,10000.0,C601893033
4508,409000493210',2018-07-27,Indiaforensic  RUPAY SETT 270718,5797.3,0.0,4084855.310000005,2018,7,27,CASH_OUT,5797.3,C884457408
4509,409000493210',2018-07-27,Indiaforensic NFS SETT 26-07-201,10000.0,0.0,4074855.310000005,2018,7,27,DEBIT,10000.0,C790722099
4510,409000493210',2018-07-27,Indiaforensic NFS SETT 26-07-201,100.0,0.0,4074755.310000005,2018,7,27,CASH_OUT,100.0,C2089016471
4511,409000493210',2018-07-27,Indiaforensic NFS SETT 26-07-201,1700.0,0.0,4073055.310000005,2018,7,27,CHECK_WITHDRAWAL,1700.0,C655381473
4512,409000493210',2018-07-27,Indiaforensic NFS SETT 26-07-201,1000.0,0.0,4072055.310000005,2018,7,27,CASH_OUT,1000.0,C769342184
4513,409000493210',2018-07-27,Indiaforensic NFS SETT 26-07-201,200.0,0.0,4071855.310000005,2018,7,27,DEBIT,200.0,C985934102
4514,409000493210',2018-07-27,Indiaforensic NFS SETT 26-07-201,2400.0,0.0,4069455.310000005,2018,7,27,CASH_OUT,2400.0,C665576141
4515,409000493210',2018-07-27,Indiaforensic NFS SETT 26-07-201,900.0,0.0,4068555.310000005,2018,7,27,PAYEMENT,900.0,C662736689
4516,409000493210',2018-07-27,Indiaforensic NFS SETT 26-07-201,500.0,0.0,4068055.310000005,2018,7,27,CASH_OUT,500.0,C1774531247
4517,409000493210',2018-07-27,Indiaforensic NFS SETT 26-07-201,500.0,0.0,4067555.310000005,2018,7,27,CHECK_WITHDRAWAL,500.0,C1778801068
4518,409000493210',2018-07-27,Indiaforensic NFS SETT 26-07-201,1200.0,0.0,4066355.310000005,2018,7,27,CHECK_WITHDRAWAL,1200.0,C909295153
4519,409000493210',2018-07-27,Indiaforensic NFS SETT 26-07-201,500.0,0.0,4065855.310000005,2018,7,27,PAYEMENT,500.0,C1883840933
4520,409000493210',2018-07-27,Indiaforensic NFS SETT 26-07-201,1500.0,0.0,4064355.310000005,2018,7,27,PAYEMENT,1500.0,C1538745405
4521,409000493210',2018-07-27,Indiaforensic NFS SETT 26-07-201,400.0,0.0,4063955.310000005,2018,7,27,DEBIT,400.0,C248609774
4522,409000493210',2018-07-27,Indiaforensic  RUPAY SETT 270718,325.71,0.0,4063629.600000005,2018,7,27,CASH_OUT,325.71,C153950082
4523,409000493210',2018-07-30,TRF FROM  Indiaforensic SERVICES,0.0,60000.0,4123629.600000005,2018,7,30,CHECK_CASHING,60000.0,C998351292
4524,409000493210',2018-07-30,Indiaforensic RUPAY SETT 280718,2140.74,0.0,4121488.860000005,2018,7,30,PAYEMENT,2140.74,C664232848
4525,409000493210',2018-07-30,Indiaforensic RUPAY SETT 290718,11551.68,0.0,4109937.180000005,2018,7,30,CHECK_WITHDRAWAL,11551.68,C1446521801
4526,409000493210',2018-07-30,Indiaforensic RUPAY SETT 300718,7786.22,0.0,4102150.9600000037,2018,7,30,CASH_OUT,7786.22,C1504109395
4527,409000493210',2018-07-30,Indiaforensic  RUPAY SETT 300718,9656.83,0.0,4092494.1300000036,2018,7,30,CASH_OUT,9656.83,M1543272907
4528,409000493210',2018-07-30,Indiaforensic NFS SETT 27-07-201,700.0,0.0,4091794.1300000036,2018,7,30,CASH_OUT,700.0,M1002380301
4529,409000493210',2018-07-30,Indiaforensic NFS SETT 27-07-201,300.0,0.0,4091494.1300000036,2018,7,30,DEBIT,300.0,M560734926
4530,409000493210',2018-07-30,Indiaforensic NFS SETT 27-07-201,100.0,0.0,4091394.1300000036,2018,7,30,CHECK_WITHDRAWAL,100.0,M568717494
4531,409000493210',2018-07-30,Indiaforensic NFS SETT 27-07-201,300.0,0.0,4091094.1300000036,2018,7,30,CASH_OUT,300.0,C1850042097
4532,409000493210',2018-07-30,Indiaforensic NFS SETT 27-07-201,1500.0,0.0,4089594.1300000036,2018,7,30,DEBIT,1500.0,M1701331644
4533,409000493210',2018-07-30,Indiaforensic NFS SETT 27-07-201,500.0,0.0,4089094.1300000036,2018,7,30,CASH_OUT,500.0,C657736958
4534,409000493210',2018-07-30,Indiaforensic NFS SETT 27-07-201,500.0,0.0,4088594.1300000036,2018,7,30,DEBIT,500.0,C11003494
4535,409000493210',2018-07-30,Indiaforensic NFS SETT 28-07-201,1000.0,0.0,4087594.1300000036,2018,7,30,CASH_OUT,1000.0,C1883840933
4536,409000493210',2018-07-30,Indiaforensic NFS SETT 28-07-201,10000.0,0.0,4077594.1300000036,2018,7,30,DEBIT,10000.0,C905650857
4537,409000493210',2018-07-30,Indiaforensic NFS SETT 28-07-201,200.0,0.0,4077394.1300000036,2018,7,30,CASH_OUT,200.0,C248609774
4538,409000493210',2018-07-30,Indiaforensic NFS SETT 28-07-201,100.0,0.0,4077294.1300000036,2018,7,30,PAYEMENT,100.0,C1850042097
4539,409000493210',2018-07-30,Indiaforensic NFS SETT 28-07-201,100.0,0.0,4077194.1300000036,2018,7,30,DEBIT,100.0,C914293025
4540,409000493210',2018-07-30,Indiaforensic NFS SETT 28-07-201,100.0,0.0,4077094.1300000036,2018,7,30,DEBIT,100.0,C1782113663
4541,409000493210',2018-07-30,Indiaforensic NFS SETT 28-07-201,100.0,0.0,4076994.1300000036,2018,7,30,PAYEMENT,100.0,C1504109395
4542,409000493210',2018-07-30,Indiaforensic NFS SETT 28-07-201,100.0,0.0,4076894.1300000036,2018,7,30,DEBIT,100.0,C716083600
4543,409000493210',2018-07-30,Indiaforensic NFS SETT 28-07-201,100.0,0.0,4076794.1300000036,2018,7,30,CASH_OUT,100.0,C1060830840
4544,409000493210',2018-07-30,Indiaforensic NFS SETT 28-07-201,500.0,0.0,4076294.1300000036,2018,7,30,PAYEMENT,500.0,C741431520
4545,409000493210',2018-07-30,Indiaforensic NFS SETT 29-07-201,400.0,0.0,4075894.1300000036,2018,7,30,CHECK_WITHDRAWAL,400.0,C317071334
4546,409000493210',2018-07-30,Indiaforensic NFS SETT 29-07-201,1000.0,0.0,4074894.1300000036,2018,7,30,DEBIT,1000.0,C1255024717
4547,409000493210',2018-07-30,Indiaforensic NFS SETT 29-07-201,10000.0,0.0,4064894.1300000036,2018,7,30,PAYEMENT,10000.0,C248609774
4548,409000493210',2018-07-30,Indiaforensic NFS SETT 29-07-201,10000.0,0.0,4054894.1300000036,2018,7,30,CHECK_WITHDRAWAL,10000.0,C1870252780
4549,409000493210',2018-07-31,Indiaforensic  RUPAY SETT 310718,1971.86,0.0,4052922.2700000037,2018,7,31,DEBIT,1971.86,C323761934
4550,409000493210',2018-07-31,Indiaforensic  RUPAY SETT 310718,3571.96,0.0,4049350.310000004,2018,7,31,CHECK_WITHDRAWAL,3571.96,C481402298
4551,409000493210',2018-08-01,Indiaforensic  RUPAY SETT 010818,5671.76,0.0,4043678.550000005,2018,8,1,PAYEMENT,5671.76,C453211571
4552,409000493210',2018-08-01,Indiaforensic RUPAY STL INTC0108,0.0,105.29,4043783.840000005,2018,8,1,CHECK_CASHING,105.29,C1359953204
4553,409000493210',2018-08-01,Indiaforensic RUPAY STL INTC0108,52.0,0.0,4043731.840000005,2018,8,1,CHECK_WITHDRAWAL,52.0,C914293025
4554,409000493210',2018-08-01,Indiaforensic RUPAY STL INTC0108,0.0,0.39,4043732.230000005,2018,8,1,TRANSFER,0.39,C97730845
4555,409000493210',2018-08-01,Indiaforensic  RUPAY SETT 010818,373.33,0.0,4043358.900000005,2018,8,1,CASH_OUT,373.33,C1068824137
4556,409000493210',2018-08-01,Indiaforensic RUPAY STL INTC0108,0.0,1.88,4043360.780000005,2018,8,1,CHECK_CASHING,1.88,C2118255842
4557,409000493210',2018-08-01,Indiaforensic RUPAY STL INTC0108,1.86,0.0,4043358.920000005,2018,8,1,DEBIT,1.86,C657736958
4558,409000493210',2018-08-01,Indiaforensic NFS SETT 30-07-201,500.0,0.0,4042858.920000005,2018,8,1,CHECK_WITHDRAWAL,500.0,C1831477404
4559,409000493210',2018-08-01,Indiaforensic NFS SETT 30-07-201,100.0,0.0,4042758.920000005,2018,8,1,CASH_OUT,100.0,C1778801068
4560,409000493210',2018-08-01,Indiaforensic NFS SETT 30-07-201,2000.0,0.0,4040758.920000005,2018,8,1,DEBIT,2000.0,C1782113663
4561,409000493210',2018-08-01,Indiaforensic NFS SETT 30-07-201,4000.0,0.0,4036758.920000005,2018,8,1,CASH_OUT,4000.0,C728526866
4562,409000493210',2018-08-01,Indiaforensic NFS SETT 30-07-201,1600.0,0.0,4035158.920000005,2018,8,1,PAYEMENT,1600.0,C1899073220
4563,409000493210',2018-08-01,Indiaforensic NFS SETT 30-07-201,100.0,0.0,4035058.920000005,2018,8,1,CASH_OUT,100.0,M595759572
4564,409000493210',2018-08-01,Indiaforensic NFS SETT 31-07-201,1000.0,0.0,4034058.920000005,2018,8,1,PAYEMENT,1000.0,M1746833724
4565,409000493210',2018-08-01,Indiaforensic NFS SETT 31-07-201,500.0,0.0,4033558.920000005,2018,8,1,PAYEMENT,500.0,M518739992
4566,409000493210',2018-08-01,Indiaforensic NFS SETT 31-07-201,5000.0,0.0,4028558.920000005,2018,8,1,CHECK_WITHDRAWAL,5000.0,M1490297742
4567,409000493210',2018-08-01,Indiaforensic NFS SETT 31-07-201,1500.0,0.0,4027058.920000005,2018,8,1,DEBIT,1500.0,M910658510
4568,409000493210',2018-08-01,Indiaforensic NFS SETT 31-07-201,200.0,0.0,4026858.920000005,2018,8,1,CHECK_WITHDRAWAL,200.0,M1970880279
4569,409000493210',2018-08-01,Indiaforensic NFS SETT 31-07-201,6000.0,0.0,4020858.920000005,2018,8,1,DEBIT,6000.0,C1651379334
4570,409000493210',2018-08-01,Indiaforensic NFS SETT 31-07-201,200.0,0.0,4020658.920000005,2018,8,1,CASH_OUT,200.0,C413177525
4571,409000493210',2018-08-01,Indiaforensic NFS SETT 31-07-201,1200.0,0.0,4019458.920000005,2018,8,1,CHECK_WITHDRAWAL,1200.0,M970423785
4572,409000493210',2018-08-01,Indiaforensic NFS SETT 31-07-201,1000.0,0.0,4018458.920000005,2018,8,1,DEBIT,1000.0,M738636051
4573,409000493210',2018-08-01,Indiaforensic NFS SETT 31-07-201,7300.0,0.0,4011158.920000005,2018,8,1,CASH_OUT,7300.0,M2019482012
4574,409000493210',2018-08-01,Indiaforensic NFS SETT 31-07-201,1000.0,0.0,4010158.920000005,2018,8,1,CASH_OUT,1000.0,M1968922416
4575,409000493210',2018-08-02,Indiaforensic  RUPAY SETT 020818,710.84,0.0,4009448.080000005,2018,8,2,PAYEMENT,710.84,C187649742
4576,409000493210',2018-08-02,Indiaforensic RUPAY STL INTC0208,0.0,7.19,4009455.270000005,2018,8,2,CASH_IN,7.19,M751628596
4577,409000493210',2018-08-02,Indiaforensic RUPAY STL INTC0208,7.19,0.0,4009448.080000005,2018,8,2,DEBIT,7.19,C466505482
4578,409000493210',2018-08-02,Indiaforensic  RUPAY SETT 020818,3717.71,0.0,4005730.370000005,2018,8,2,CHECK_WITHDRAWAL,3717.71,C1917025677
4579,409000493210',2018-08-02,Indiaforensic RUPAY STL INTC0208,0.0,27.88,4005758.250000005,2018,8,2,CHECK_CASHING,27.88,C909295153
4580,409000493210',2018-08-02,Indiaforensic RUPAY STL INTC0208,27.88,0.0,4005730.370000005,2018,8,2,CASH_OUT,27.88,C1504109395
4581,409000493210',2018-08-03,Indiaforensic  RUPAY SETT 030818,991.24,0.0,4004739.130000005,2018,8,3,CASH_OUT,991.24,C991505714
4582,409000493210',2018-08-03,Indiaforensic RUPAY STL INTC0308,0.0,70.77,4004809.900000005,2018,8,3,CASH_IN,70.77,C1538745405
4583,409000493210',2018-08-03,Indiaforensic RUPAY STL INTC0308,8.05,0.0,4004801.850000005,2018,8,3,CHECK_WITHDRAWAL,8.05,C1789550256
4584,409000493210',2018-08-03,Indiaforensic RUPAY STL INTC0308,0.0,0.46,4004802.310000005,2018,8,3,CASH_IN,0.46,C801142660
4585,409000493210',2018-08-03,Indiaforensic  RUPAY SETT 030818,1552.42,0.0,4003249.890000005,2018,8,3,DEBIT,1552.42,C1632716597
4586,409000493210',2018-08-03,Indiaforensic RUPAY STL INTC0308,0.0,19.86,4003269.750000005,2018,8,3,CHECK_CASHING,19.86,M850083982
4587,409000493210',2018-08-03,Indiaforensic RUPAY STL INTC0308,19.86,0.0,4003249.890000005,2018,8,3,PAYEMENT,19.86,M2024814472
4588,409000493210',2018-08-03,Indiaforensic NFS SETT 01-08-201,5000.0,0.0,3998249.890000005,2018,8,3,PAYEMENT,5000.0,M1461347900
4589,409000493210',2018-08-03,Indiaforensic NFS SETT 01-08-201,1500.0,0.0,3996749.890000005,2018,8,3,PAYEMENT,1500.0,M1124987728
4590,409000493210',2018-08-03,Indiaforensic NFS SETT 01-08-201,10000.0,0.0,3986749.890000005,2018,8,3,DEBIT,10000.0,M391928890
4591,409000493210',2018-08-03,Indiaforensic NFS SETT 01-08-201,1900.0,0.0,3984849.890000005,2018,8,3,PAYEMENT,1900.0,C557041912
4592,409000493210',2018-08-03,Indiaforensic NFS SETT 01-08-201,3500.0,0.0,3981349.890000005,2018,8,3,CASH_OUT,3500.0,M1233049719
4593,409000493210',2018-08-03,Indiaforensic NFS SETT 02-08-201,800.0,0.0,3980549.890000005,2018,8,3,DEBIT,800.0,M2069971440
4594,409000493210',2018-08-03,Indiaforensic NFS SETT 02-08-201,1000.0,0.0,3979549.890000005,2018,8,3,DEBIT,1000.0,M1890881203
4595,409000493210',2018-08-03,Indiaforensic NFS SETT 02-08-201,4000.0,0.0,3975549.890000005,2018,8,3,PAYEMENT,4000.0,C1744423762
4596,409000493210',2018-08-03,Indiaforensic NFS SETT 02-08-201,9000.0,0.0,3966549.890000005,2018,8,3,PAYEMENT,9000.0,C662736689
4597,409000493210',2018-08-03,Indiaforensic NFS SETT 02-08-201,2800.0,0.0,3963749.890000005,2018,8,3,CASH_OUT,2800.0,C297927961
4598,409000493210',2018-08-03,Indiaforensic NFS SETT 02-08-201,200.0,0.0,3963549.890000005,2018,8,3,CASH_OUT,200.0,C909295153
4599,409000493210',2018-08-04,Indiaforensic  RUPAY SETT 040818,10405.33,0.0,3953144.560000005,2018,8,4,CHECK_WITHDRAWAL,10405.33,C1286084959
4600,409000493210',2018-08-04,Indiaforensic RUPAY STL INTC0408,0.0,142.12,3953286.680000005,2018,8,4,CHECK_CASHING,142.12,C392292416
4601,409000493210',2018-08-04,Indiaforensic RUPAY STL INTC0408,113.49,0.0,3953173.190000005,2018,8,4,CHECK_WITHDRAWAL,113.49,C769342184
4602,409000493210',2018-08-04,Indiaforensic RUPAY STL INTC0408,0.0,0.21,3953173.400000005,2018,8,4,CHECK_CASHING,0.21,C728526866
4603,409000493210',2018-08-04,Indiaforensic  RUPAY SETT 040818,600.71,0.0,3952572.690000005,2018,8,4,PAYEMENT,600.71,C2083562754
4604,409000493210',2018-08-04,Indiaforensic RUPAY STL INTC0408,0.0,3.0,3952575.690000005,2018,8,4,CASH_IN,3.0,C214774813
4605,409000493210',2018-08-04,Indiaforensic RUPAY STL INTC0408,3.0,0.0,3952572.690000005,2018,8,4,CASH_OUT,3.0,C2083562754
4606,409000493210',2018-08-04,Indiaforensic NFS SETT 03-08-201,100.0,0.0,3952472.690000005,2018,8,4,PAYEMENT,100.0,C769342184
4607,409000493210',2018-08-04,Indiaforensic NFS SETT 03-08-201,9500.0,0.0,3942972.690000005,2018,8,4,CASH_OUT,9500.0,C1167066016
4608,409000493210',2018-08-04,Indiaforensic NFS SETT 03-08-201,400.0,0.0,3942572.690000005,2018,8,4,CHECK_WITHDRAWAL,400.0,C1360767589
4609,409000493210',2018-08-04,Indiaforensic NFS SETT 03-08-201,400.0,0.0,3942172.690000005,2018,8,4,DEBIT,400.0,C459857341
4610,409000493210',2018-08-04,Indiaforensic NFS SETT 03-08-201,5000.0,0.0,3937172.690000005,2018,8,4,CHECK_WITHDRAWAL,5000.0,C2134357721
4611,409000493210',2018-08-04,Indiaforensic NFS SETT 03-08-201,10000.0,0.0,3927172.690000005,2018,8,4,PAYEMENT,10000.0,C665576141
4612,409000493210',2018-08-04,Indiaforensic NFS SETT 03-08-201,10000.0,0.0,3917172.690000005,2018,8,4,CASH_OUT,10000.0,C1963862935
4613,409000493210',2018-08-06,Indiaforensic RUPAY SETT 050818,634.49,0.0,3916538.200000005,2018,8,6,CASH_OUT,634.49,C33524623
4614,409000493210',2018-08-06,Indiaforensic RUPAY STL INTC0508,0.0,6.3,3916544.5000000037,2018,8,6,CASH_IN,6.3,C1922859107
4615,409000493210',2018-08-06,Indiaforensic RUPAY STL INTC0508,6.3,0.0,3916538.200000005,2018,8,6,CHECK_WITHDRAWAL,6.3,C146305349
4616,409000493210',2018-08-06,Indiaforensic RUPAY SETT 060818,2829.42,0.0,3913708.780000005,2018,8,6,CHECK_WITHDRAWAL,2829.42,C1592415783
4617,409000493210',2018-08-06,Indiaforensic RUPAY STL INTC0608,0.0,19.14,3913727.920000005,2018,8,6,CASH_IN,19.14,C1899073220
4618,409000493210',2018-08-06,Indiaforensic RUPAY STL INTC0608,19.14,0.0,3913708.780000005,2018,8,6,PAYEMENT,19.14,C1360767589
4619,409000493210',2018-08-06,Indiaforensic NFS SETT 04-08-201,2000.0,0.0,3911708.780000005,2018,8,6,DEBIT,2000.0,M1487131937
4620,409000493210',2018-08-06,Indiaforensic NFS SETT 04-08-201,3000.0,0.0,3908708.780000005,2018,8,6,CASH_OUT,3000.0,M2135563436
4621,409000493210',2018-08-06,Indiaforensic NFS SETT 04-08-201,3000.0,0.0,3905708.780000005,2018,8,6,CASH_OUT,3000.0,M206999441
4622,409000493210',2018-08-06,Indiaforensic NFS SETT 04-08-201,10000.0,0.0,3895708.780000005,2018,8,6,CHECK_WITHDRAWAL,10000.0,M1893004914
4623,409000493210',2018-08-06,Indiaforensic NFS SETT 04-08-201,10000.0,0.0,3885708.780000005,2018,8,6,DEBIT,10000.0,C1183572822
4624,409000493210',2018-08-06,Indiaforensic NFS SETT 04-08-201,800.0,0.0,3884908.780000005,2018,8,6,PAYEMENT,800.0,M781527109
4625,409000493210',2018-08-06,Indiaforensic NFS SETT 04-08-201,300.0,0.0,3884608.780000005,2018,8,6,DEBIT,300.0,M1874812338
4626,409000493210',2018-08-06,Indiaforensic NFS SETT 04-08-201,100.0,0.0,3884508.780000005,2018,8,6,CHECK_WITHDRAWAL,100.0,C392292416
4627,409000493210',2018-08-06,Indiaforensic NFS SETT 04-08-201,2500.0,0.0,3882008.780000005,2018,8,6,CASH_OUT,2500.0,M123458189
4628,409000493210',2018-08-06,Indiaforensic NFS SETT 04-08-201,500.0,0.0,3881508.780000005,2018,8,6,CHECK_WITHDRAWAL,500.0,M293669143
4629,409000493210',2018-08-06,Indiaforensic NFS SETT 04-08-201,3000.0,0.0,3878508.780000005,2018,8,6,PAYEMENT,3000.0,M1244785938
4630,409000493210',2018-08-06,Indiaforensic NFS SETT 04-08-201,3000.0,0.0,3875508.780000005,2018,8,6,PAYEMENT,3000.0,C1820355723
4631,409000493210',2018-08-06,Indiaforensic NFS SETT 04-08-201,3000.0,0.0,3872508.780000005,2018,8,6,PAYEMENT,3000.0,M213850519
4632,409000493210',2018-08-06,Indiaforensic NFS SETT 05-08-201,400.0,0.0,3872108.780000005,2018,8,6,PAYEMENT,400.0,M1605299030
4633,409000493210',2018-08-06,Indiaforensic NFS SETT 05-08-201,300.0,0.0,3871808.780000005,2018,8,6,CASH_OUT,300.0,C1129670968
4634,409000493210',2018-08-06,Indiaforensic NFS SETT 05-08-201,300.0,0.0,3871508.780000005,2018,8,6,PAYEMENT,300.0,C1146719991
4635,409000493210',2018-08-06,Indiaforensic  RUPAY SETT 060818,335.71,0.0,3871173.070000005,2018,8,6,CHECK_WITHDRAWAL,335.71,M1608357825
4636,409000493210',2018-08-06,Indiaforensic RUPAY STL INTC0608,0.0,1.68,3871174.750000005,2018,8,6,TRANSFER,1.68,M366098173
4637,409000493210',2018-08-06,Indiaforensic RUPAY STL INTC0608,1.68,0.0,3871173.070000005,2018,8,6,CHECK_WITHDRAWAL,1.68,M1481417616
4638,409000493210',2018-08-07,Indiaforensic  RUPAY SETT 070818,935.12,0.0,3870237.950000005,2018,8,7,PAYEMENT,935.12,C1017997535
4639,409000493210',2018-08-07,Indiaforensic RUPAY STL INTC0708,0.0,11.09,3870249.0400000038,2018,8,7,TRANSFER,11.09,M1045677229
4640,409000493210',2018-08-07,Indiaforensic RUPAY STL INTC0708,10.26,0.0,3870238.780000005,2018,8,7,CASH_OUT,10.26,C116289363
4641,409000493210',2018-08-07,TRF FRM  Indiaforensic SERVICES,0.0,1475000.0,5345238.780000005,2018,8,7,CHECK_CASHING,1475000.0,M171751994
4642,409000493210',2018-08-07,Indiaforensic NFS SETT 06-08-201,9500.0,0.0,5335738.780000005,2018,8,7,PAYEMENT,9500.0,M1554308325
4643,409000493210',2018-08-07,Indiaforensic NFS SETT 06-08-201,2000.0,0.0,5333738.780000005,2018,8,7,DEBIT,2000.0,C413177525
4644,409000493210',2018-08-07,Indiaforensic NFS SETT 06-08-201,400.0,0.0,5333338.780000005,2018,8,7,CHECK_WITHDRAWAL,400.0,M67883256
4645,409000493210',2018-08-07,Indiaforensic NFS SETT 06-08-201,6000.0,0.0,5327338.780000005,2018,8,7,PAYEMENT,6000.0,M1634319881
4646,409000493210',2018-08-08,Indiaforensic  RUPAY SETT 080818,717.26,0.0,5326621.520000005,2018,8,8,PAYEMENT,717.26,M1605715776
4647,409000493210',2018-08-08,Indiaforensic RUPAY STL INTC0808,0.0,10.42,5326631.940000005,2018,8,8,CHECK_CASHING,10.42,M518261596
4648,409000493210',2018-08-08,Indiaforensic RUPAY STL INTC0808,5.92,0.0,5326626.020000005,2018,8,8,PAYEMENT,5.92,C1886938557
4649,409000493210',2018-08-08,Indiaforensic RUPAY STL INTC0808,0.0,0.02,5326626.040000005,2018,8,8,TRANSFER,0.02,C1829344035
4650,409000493210',2018-08-08,Indiaforensic  RUPAY SETT 080818,1602.12,0.0,5325023.920000005,2018,8,8,DEBIT,1602.12,C740950652
4651,409000493210',2018-08-08,Indiaforensic RUPAY STL INTC0808,0.0,15.6,5325039.520000004,2018,8,8,TRANSFER,15.6,M1357185836
4652,409000493210',2018-08-08,Indiaforensic RUPAY STL INTC0808,15.6,0.0,5325023.920000005,2018,8,8,PAYEMENT,15.6,M307148861
4653,409000493210',2018-08-09,Indiaforensic  RUPAY SETT 090818,3833.96,0.0,5321189.960000005,2018,8,9,CASH_OUT,3833.96,C1413871034
4654,409000493210',2018-08-09,Indiaforensic RUPAY STL INTC0908,0.0,28.62,5321218.580000005,2018,8,9,TRANSFER,28.62,M759840275
4655,409000493210',2018-08-09,Indiaforensic RUPAY STL INTC0908,28.62,0.0,5321189.960000005,2018,8,9,DEBIT,28.62,M227030447
4656,409000493210',2018-08-09,Indiaforensic NFS SETT 07-08-201,5000.0,0.0,5316189.960000005,2018,8,9,PAYEMENT,5000.0,M1789791855
4657,409000493210',2018-08-09,Indiaforensic NFS SETT 07-08-201,1000.0,0.0,5315189.960000005,2018,8,9,CASH_OUT,1000.0,M2073961917
4658,409000493210',2018-08-09,Indiaforensic NFS SETT 07-08-201,2000.0,0.0,5313189.960000005,2018,8,9,DEBIT,2000.0,M937936076
4659,409000493210',2018-08-09,Indiaforensic NFS SETT 07-08-201,2000.0,0.0,5311189.960000005,2018,8,9,CHECK_WITHDRAWAL,2000.0,M813285994
4660,409000493210',2018-08-09,Indiaforensic NFS SETT 07-08-201,5000.0,0.0,5306189.960000005,2018,8,9,CHECK_WITHDRAWAL,5000.0,M401355610
4661,409000493210',2018-08-09,Indiaforensic NFS SETT 07-08-201,2000.0,0.0,5304189.960000005,2018,8,9,DEBIT,2000.0,M1448967471
4662,409000493210',2018-08-09,Indiaforensic NFS SETT 07-08-201,5000.0,0.0,5299189.960000005,2018,8,9,CHECK_WITHDRAWAL,5000.0,M476709123
4663,409000493210',2018-08-09,Indiaforensic NFS SETT 07-08-201,9000.0,0.0,5290189.960000005,2018,8,9,DEBIT,9000.0,C914293025
4664,409000493210',2018-08-09,Indiaforensic NFS SETT 07-08-201,8000.0,0.0,5282189.960000005,2018,8,9,DEBIT,8000.0,M2077462509
4665,409000493210',2018-08-09,Indiaforensic NFS SETT 07-08-201,3000.0,0.0,5279189.960000005,2018,8,9,CHECK_WITHDRAWAL,3000.0,C728526866
4666,409000493210',2018-08-09,Indiaforensic NFS SETT 07-08-201,500.0,0.0,5278689.960000005,2018,8,9,CASH_OUT,500.0,M1198859194
4667,409000493210',2018-08-09,Indiaforensic NFS SETT 07-08-201,4000.0,0.0,5274689.960000005,2018,8,9,CHECK_WITHDRAWAL,4000.0,C2127862399
4668,409000493210',2018-08-09,Indiaforensic NFS SETT 07-08-201,1500.0,0.0,5273189.960000005,2018,8,9,CASH_OUT,1500.0,C1394526584
4669,409000493210',2018-08-09,Indiaforensic NFS SETT 07-08-201,1000.0,0.0,5272189.960000005,2018,8,9,DEBIT,1000.0,M1466148437
4670,409000493210',2018-08-09,Indiaforensic NFS SETT 07-08-201,9000.0,0.0,5263189.960000005,2018,8,9,CHECK_WITHDRAWAL,9000.0,C459857341
4671,409000493210',2018-08-09,Indiaforensic NFS SETT 07-08-201,10000.0,0.0,5253189.960000005,2018,8,9,PAYEMENT,10000.0,M1444912530
4672,409000493210',2018-08-09,Indiaforensic NFS SETT 07-08-201,8500.0,0.0,5244689.960000005,2018,8,9,CASH_OUT,8500.0,M2095803461
4673,409000493210',2018-08-09,Indiaforensic NFS SETT 07-08-201,200.0,0.0,5244489.960000005,2018,8,9,CHECK_WITHDRAWAL,200.0,C481402298
4674,409000493210',2018-08-09,Indiaforensic NFS SETT 07-08-201,8000.0,0.0,5236489.960000005,2018,8,9,PAYEMENT,8000.0,C1255024717
4675,409000493210',2018-08-09,Indiaforensic NFS SETT 07-08-201,6000.0,0.0,5230489.960000005,2018,8,9,CHECK_WITHDRAWAL,6000.0,C481402298
4676,409000493210',2018-08-09,Indiaforensic NFS SETT 07-08-201,5000.0,0.0,5225489.960000005,2018,8,9,DEBIT,5000.0,C97730845
4677,409000493210',2018-08-09,Indiaforensic NFS SETT 07-08-201,7600.0,0.0,5217889.960000005,2018,8,9,CASH_OUT,7600.0,C1850042097
4678,409000493210',2018-08-09,Indiaforensic NFS SETT 07-08-201,5000.0,0.0,5212889.960000005,2018,8,9,PAYEMENT,5000.0,C728526866
4679,409000493210',2018-08-09,Indiaforensic NFS SETT 07-08-201,400.0,0.0,5212489.960000005,2018,8,9,DEBIT,400.0,C1360767589
4680,409000493210',2018-08-09,Indiaforensic NFS SETT 07-08-201,5500.0,0.0,5206989.960000005,2018,8,9,CHECK_WITHDRAWAL,5500.0,C662736689
4681,409000493210',2018-08-09,Indiaforensic NFS SETT 07-08-201,7000.0,0.0,5199989.960000005,2018,8,9,CHECK_WITHDRAWAL,7000.0,C932583850
4682,409000493210',2018-08-09,Indiaforensic NFS SETT 07-08-201,8900.0,0.0,5191089.960000005,2018,8,9,PAYEMENT,8900.0,C1883840933
4683,409000493210',2018-08-09,Indiaforensic NFS SETT 07-08-201,8600.0,0.0,5182489.960000005,2018,8,9,PAYEMENT,8600.0,C1286084959
4684,409000493210',2018-08-09,Indiaforensic NFS SETT 07-08-201,8000.0,0.0,5174489.960000005,2018,8,9,DEBIT,8000.0,C1916720513
4685,409000493210',2018-08-09,Indiaforensic NFS SETT 07-08-201,5600.0,0.0,5168889.960000005,2018,8,9,CASH_OUT,5600.0,C2083562754
4686,409000493210',2018-08-09,Indiaforensic NFS SETT 07-08-201,8000.0,0.0,5160889.960000005,2018,8,9,DEBIT,8000.0,C214774813
4687,409000493210',2018-08-09,Indiaforensic NFS SETT 07-08-201,10000.0,0.0,5150889.960000005,2018,8,9,DEBIT,10000.0,C662736689
4688,409000493210',2018-08-09,Indiaforensic NFS SETT 07-08-201,300.0,0.0,5150589.960000005,2018,8,9,DEBIT,300.0,C1883840933
4689,409000493210',2018-08-09,Indiaforensic NFS SETT 07-08-201,8100.0,0.0,5142489.960000005,2018,8,9,CHECK_WITHDRAWAL,8100.0,C1076835071
4690,409000493210',2018-08-09,Indiaforensic NFS SETT 07-08-201,3000.0,0.0,5139489.960000005,2018,8,9,DEBIT,3000.0,M1436610577
4691,409000493210',2018-08-09,Indiaforensic NFS SETT 07-08-201,8700.0,0.0,5130789.960000005,2018,8,9,CHECK_WITHDRAWAL,8700.0,M957559364
4692,409000493210',2018-08-09,Indiaforensic NFS SETT 07-08-201,6000.0,0.0,5124789.960000005,2018,8,9,CASH_OUT,6000.0,M1578712821
4693,409000493210',2018-08-09,Indiaforensic NFS SETT 07-08-201,500.0,0.0,5124289.960000005,2018,8,9,CASH_OUT,500.0,C410033330
4694,409000493210',2018-08-09,Indiaforensic NFS SETT 07-08-201,100.0,0.0,5124189.960000005,2018,8,9,PAYEMENT,100.0,C2094777811
4695,409000493210',2018-08-09,Indiaforensic NFS SETT 07-08-201,7000.0,0.0,5117189.960000005,2018,8,9,PAYEMENT,7000.0,M1641677843
4696,409000493210',2018-08-09,Indiaforensic NFS SETT 07-08-201,5400.0,0.0,5111789.960000005,2018,8,9,DEBIT,5400.0,M1296833449
4697,409000493210',2018-08-09,Indiaforensic NFS SETT 07-08-201,8000.0,0.0,5103789.960000005,2018,8,9,CASH_OUT,8000.0,M291279979
4698,409000493210',2018-08-09,Indiaforensic NFS SETT 07-08-201,9000.0,0.0,5094789.960000005,2018,8,9,DEBIT,9000.0,M1425454633
4699,409000493210',2018-08-09,Indiaforensic NFS SETT 07-08-201,2000.0,0.0,5092789.960000005,2018,8,9,CASH_OUT,2000.0,M1044639817
4700,409000493210',2018-08-09,Indiaforensic NFS SETT 07-08-201,9500.0,0.0,5083289.960000005,2018,8,9,PAYEMENT,9500.0,M1968861720
4701,409000493210',2018-08-09,Indiaforensic NFS SETT 07-08-201,6000.0,0.0,5077289.960000005,2018,8,9,PAYEMENT,6000.0,M1361241279
4702,409000493210',2018-08-09,Indiaforensic NFS SETT 07-08-201,9000.0,0.0,5068289.960000005,2018,8,9,PAYEMENT,9000.0,M92962244
4703,409000493210',2018-08-09,Indiaforensic NFS SETT 07-08-201,7000.0,0.0,5061289.960000005,2018,8,9,PAYEMENT,7000.0,M670503317
4704,409000493210',2018-08-09,Indiaforensic NFS SETT 07-08-201,10000.0,0.0,5051289.960000005,2018,8,9,CASH_OUT,10000.0,C40075281
4705,409000493210',2018-08-09,Indiaforensic NFS SETT 07-08-201,7000.0,0.0,5044289.960000005,2018,8,9,CASH_OUT,7000.0,M862931361
4706,409000493210',2018-08-09,Indiaforensic NFS SETT 07-08-201,8500.0,0.0,5035789.960000005,2018,8,9,CASH_OUT,8500.0,M1337294771
4707,409000493210',2018-08-09,Indiaforensic NFS SETT 07-08-201,8000.0,0.0,5027789.960000005,2018,8,9,PAYEMENT,8000.0,C728526866
4708,409000493210',2018-08-09,Indiaforensic NFS SETT 07-08-201,500.0,0.0,5027289.960000005,2018,8,9,CHECK_WITHDRAWAL,500.0,M1383675856
4709,409000493210',2018-08-09,Indiaforensic NFS SETT 07-08-201,10000.0,0.0,5017289.960000005,2018,8,9,CASH_OUT,10000.0,M1814730197
4710,409000493210',2018-08-09,Indiaforensic NFS SETT 07-08-201,3000.0,0.0,5014289.960000005,2018,8,9,CHECK_WITHDRAWAL,3000.0,M1057262726
4711,409000493210',2018-08-09,Indiaforensic NFS SETT 07-08-201,8000.0,0.0,5006289.960000005,2018,8,9,PAYEMENT,8000.0,M501301044
4712,409000493210',2018-08-09,Indiaforensic NFS SETT 07-08-201,500.0,0.0,5005789.960000005,2018,8,9,DEBIT,500.0,M1700973603
4713,409000493210',2018-08-09,Indiaforensic NFS SETT 07-08-201,10000.0,0.0,4995789.960000005,2018,8,9,PAYEMENT,10000.0,M946448101
4714,409000493210',2018-08-09,Indiaforensic NFS SETT 07-08-201,9000.0,0.0,4986789.960000005,2018,8,9,CASH_OUT,9000.0,M2101891021
4715,409000493210',2018-08-09,Indiaforensic NFS SETT 07-08-201,10000.0,0.0,4976789.960000005,2018,8,9,PAYEMENT,10000.0,M220588152
4716,409000493210',2018-08-09,Indiaforensic NFS SETT 07-08-201,9000.0,0.0,4967789.960000005,2018,8,9,CASH_OUT,9000.0,M2014406233
4717,409000493210',2018-08-09,Indiaforensic NFS SETT 07-08-201,8000.0,0.0,4959789.960000005,2018,8,9,CHECK_WITHDRAWAL,8000.0,M1407858699
4718,409000493210',2018-08-09,Indiaforensic NFS SETT 07-08-201,5000.0,0.0,4954789.960000005,2018,8,9,PAYEMENT,5000.0,M610056415
4719,409000493210',2018-08-09,Indiaforensic NFS SETT 07-08-201,9000.0,0.0,4945789.960000005,2018,8,9,PAYEMENT,9000.0,M605787935
4720,409000493210',2018-08-09,Indiaforensic NFS SETT 07-08-201,500.0,0.0,4945289.960000005,2018,8,9,PAYEMENT,500.0,C1182461167
4721,409000493210',2018-08-09,Indiaforensic NFS SETT 07-08-201,8000.0,0.0,4937289.960000005,2018,8,9,CHECK_WITHDRAWAL,8000.0,M1799545709
4722,409000493210',2018-08-09,Indiaforensic NFS SETT 07-08-201,300.0,0.0,4936989.960000005,2018,8,9,PAYEMENT,300.0,M2031705122
4723,409000493210',2018-08-09,Indiaforensic NFS SETT 07-08-201,10000.0,0.0,4926989.960000005,2018,8,9,CHECK_WITHDRAWAL,10000.0,M1891535340
4724,409000493210',2018-08-09,Indiaforensic NFS SETT 07-08-201,3500.0,0.0,4923489.960000005,2018,8,9,CASH_OUT,3500.0,M430290487
4725,409000493210',2018-08-09,Indiaforensic NFS SETT 07-08-201,5000.0,0.0,4918489.960000005,2018,8,9,PAYEMENT,5000.0,M1263102442
4726,409000493210',2018-08-09,Indiaforensic NFS SETT 07-08-201,8500.0,0.0,4909989.960000005,2018,8,9,CHECK_WITHDRAWAL,8500.0,M627411361
4727,409000493210',2018-08-09,Indiaforensic NFS SETT 07-08-201,7800.0,0.0,4902189.960000005,2018,8,9,DEBIT,7800.0,M162752456
4728,409000493210',2018-08-09,Indiaforensic NFS SETT 07-08-201,7800.0,0.0,4894389.960000005,2018,8,9,CASH_OUT,7800.0,M1038585959
4729,409000493210',2018-08-09,Indiaforensic NFS SETT 07-08-201,8900.0,0.0,4885489.960000005,2018,8,9,CHECK_WITHDRAWAL,8900.0,M212329343
4730,409000493210',2018-08-09,Indiaforensic NFS SETT 07-08-201,8500.0,0.0,4876989.960000005,2018,8,9,PAYEMENT,8500.0,M1713589007
4731,409000493210',2018-08-09,Indiaforensic NFS SETT 07-08-201,4000.0,0.0,4872989.960000005,2018,8,9,CASH_OUT,4000.0,M1777030223
4732,409000493210',2018-08-09,Indiaforensic NFS SETT 07-08-201,500.0,0.0,4872489.960000005,2018,8,9,PAYEMENT,500.0,M11913474
4733,409000493210',2018-08-09,Indiaforensic NFS SETT 07-08-201,10000.0,0.0,4862489.960000005,2018,8,9,CHECK_WITHDRAWAL,10000.0,C872592585
4734,409000493210',2018-08-09,Indiaforensic NFS SETT 07-08-201,3800.0,0.0,4858689.960000005,2018,8,9,CASH_OUT,3800.0,C931482420
4735,409000493210',2018-08-09,Indiaforensic NFS SETT 07-08-201,4000.0,0.0,4854689.960000005,2018,8,9,DEBIT,4000.0,C1255024717
4736,409000493210',2018-08-09,Indiaforensic NFS SETT 07-08-201,2500.0,0.0,4852189.960000005,2018,8,9,DEBIT,2500.0,C1774531247
4737,409000493210',2018-08-09,Indiaforensic NFS SETT 07-08-201,4000.0,0.0,4848189.960000005,2018,8,9,CHECK_WITHDRAWAL,4000.0,C1778801068
4738,409000493210',2018-08-09,Indiaforensic NFS SETT 07-08-201,8500.0,0.0,4839689.960000005,2018,8,9,CASH_OUT,8500.0,C1167066016
4739,409000493210',2018-08-09,Indiaforensic NFS SETT 07-08-201,10000.0,0.0,4829689.960000005,2018,8,9,CHECK_WITHDRAWAL,10000.0,C766681183
4740,409000493210',2018-08-09,Indiaforensic NFS SETT 07-08-201,8000.0,0.0,4821689.960000005,2018,8,9,CHECK_WITHDRAWAL,8000.0,C1750905143
4741,409000493210',2018-08-09,Indiaforensic NFS SETT 07-08-201,500.0,0.0,4821189.960000005,2018,8,9,CASH_OUT,500.0,C803116137
4742,409000493210',2018-08-09,Indiaforensic NFS SETT 07-08-201,8000.0,0.0,4813189.960000005,2018,8,9,CASH_OUT,8000.0,C1782113663
4743,409000493210',2018-08-09,Indiaforensic  RUPAY SETT 090818,8193.54,0.0,4804996.420000005,2018,8,9,CASH_OUT,8193.54,C1899073220
4744,409000493210',2018-08-10,Indiaforensic NFS SETT 08-08-201,500.0,0.0,4804496.420000005,2018,8,10,PAYEMENT,500.0,C909295153
4745,409000493210',2018-08-10,Indiaforensic NFS SETT 08-08-201,4500.0,0.0,4799996.420000005,2018,8,10,DEBIT,4500.0,C766681183
4746,409000493210',2018-08-10,Indiaforensic NFS SETT 08-08-201,9000.0,0.0,4790996.420000005,2018,8,10,DEBIT,9000.0,C1364913072
4747,409000493210',2018-08-10,Indiaforensic NFS SETT 08-08-201,7500.0,0.0,4783496.420000005,2018,8,10,DEBIT,7500.0,C2134357721
4748,409000493210',2018-08-10,Indiaforensic NFS SETT 08-08-201,10000.0,0.0,4773496.420000005,2018,8,10,CASH_OUT,10000.0,M1389978471
4749,409000493210',2018-08-10,Indiaforensic NFS SETT 08-08-201,9500.0,0.0,4763996.420000005,2018,8,10,PAYEMENT,9500.0,M855769947
4750,409000493210',2018-08-10,Indiaforensic NFS SETT 08-08-201,100.0,0.0,4763896.420000005,2018,8,10,CASH_OUT,100.0,M1963774829
4751,409000493210',2018-08-10,Indiaforensic NFS SETT 08-08-201,3900.0,0.0,4759996.420000005,2018,8,10,PAYEMENT,3900.0,C716083600
4752,409000493210',2018-08-10,Indiaforensic NFS SETT 08-08-201,9000.0,0.0,4750996.420000005,2018,8,10,DEBIT,9000.0,M2009915092
4753,409000493210',2018-08-10,Indiaforensic NFS SETT 08-08-201,8500.0,0.0,4742496.420000005,2018,8,10,CHECK_WITHDRAWAL,8500.0,M566105282
4754,409000493210',2018-08-10,Indiaforensic NFS SETT 08-08-201,7000.0,0.0,4735496.420000005,2018,8,10,PAYEMENT,7000.0,M138087695
4755,409000493210',2018-08-10,Indiaforensic NFS SETT 08-08-201,2000.0,0.0,4733496.420000005,2018,8,10,CASH_OUT,2000.0,M2063470183
4756,409000493210',2018-08-10,Indiaforensic NFS SETT 08-08-201,4000.0,0.0,4729496.420000005,2018,8,10,CASH_OUT,4000.0,M824348035
4757,409000493210',2018-08-10,Indiaforensic NFS SETT 08-08-201,9500.0,0.0,4719996.420000005,2018,8,10,DEBIT,9500.0,C1983747920
4758,409000493210',2018-08-10,Indiaforensic NFS SETT 08-08-201,5000.0,0.0,4714996.420000005,2018,8,10,DEBIT,5000.0,C1688019098
4759,409000493210',2018-08-10,Indiaforensic NFS SETT 08-08-201,7400.0,0.0,4707596.420000005,2018,8,10,CASH_OUT,7400.0,M1638335699
4760,409000493210',2018-08-10,Indiaforensic NFS SETT 08-08-201,1300.0,0.0,4706296.420000005,2018,8,10,DEBIT,1300.0,M1450174524
4761,409000493210',2018-08-10,Indiaforensic NFS SETT 08-08-201,1600.0,0.0,4704696.420000005,2018,8,10,CHECK_WITHDRAWAL,1600.0,M769896530
4762,409000493210',2018-08-10,Indiaforensic NFS SETT 08-08-201,3000.0,0.0,4701696.420000005,2018,8,10,CASH_OUT,3000.0,M381397683
4763,409000493210',2018-08-10,Indiaforensic NFS SETT 08-08-201,8000.0,0.0,4693696.420000005,2018,8,10,PAYEMENT,8000.0,M266611209
4764,409000493210',2018-08-10,Indiaforensic NFS SETT 08-08-201,8000.0,0.0,4685696.420000005,2018,8,10,PAYEMENT,8000.0,C1926673338
4765,409000493210',2018-08-10,Indiaforensic NFS SETT 08-08-201,8000.0,0.0,4677696.420000005,2018,8,10,CASH_OUT,8000.0,M188241890
4766,409000493210',2018-08-10,Indiaforensic NFS SETT 08-08-201,1400.0,0.0,4676296.420000005,2018,8,10,DEBIT,1400.0,C124540047
4767,409000493210',2018-08-10,Indiaforensic NFS SETT 08-08-201,500.0,0.0,4675796.420000005,2018,8,10,PAYEMENT,500.0,C2134357721
4768,409000493210',2018-08-10,Indiaforensic NFS SETT 08-08-201,500.0,0.0,4675296.420000005,2018,8,10,CHECK_WITHDRAWAL,500.0,M161237395
4769,409000493210',2018-08-10,Indiaforensic NFS SETT 08-08-201,9000.0,0.0,4666296.420000005,2018,8,10,CHECK_WITHDRAWAL,9000.0,M158505623
4770,409000493210',2018-08-10,Indiaforensic NFS SETT 08-08-201,6000.0,0.0,4660296.420000005,2018,8,10,CHECK_WITHDRAWAL,6000.0,M910572297
4771,409000493210',2018-08-10,Indiaforensic NFS SETT 08-08-201,3500.0,0.0,4656796.420000005,2018,8,10,DEBIT,3500.0,M1474607212
4772,409000493210',2018-08-10,Indiaforensic NFS SETT 08-08-201,2100.0,0.0,4654696.420000005,2018,8,10,CHECK_WITHDRAWAL,2100.0,M1690018027
4773,409000493210',2018-08-10,Indiaforensic NFS SETT 08-08-201,3500.0,0.0,4651196.420000005,2018,8,10,DEBIT,3500.0,M632168320
4774,409000493210',2018-08-10,Indiaforensic NFS SETT 08-08-201,6000.0,0.0,4645196.420000005,2018,8,10,CASH_OUT,6000.0,C1937209374
4775,409000493210',2018-08-10,Indiaforensic NFS SETT 08-08-201,7500.0,0.0,4637696.420000005,2018,8,10,CHECK_WITHDRAWAL,7500.0,C1191544932
4776,409000493210',2018-08-10,Indiaforensic NFS SETT 08-08-201,4000.0,0.0,4633696.420000005,2018,8,10,CHECK_WITHDRAWAL,4000.0,C560041895
4777,409000493210',2018-08-10,Indiaforensic NFS SETT 08-08-201,4000.0,0.0,4629696.420000005,2018,8,10,PAYEMENT,4000.0,M1922881634
4778,409000493210',2018-08-10,Indiaforensic NFS SETT 08-08-201,6000.0,0.0,4623696.420000005,2018,8,10,CHECK_WITHDRAWAL,6000.0,M1452232618
4779,409000493210',2018-08-10,Indiaforensic NFS SETT 08-08-201,700.0,0.0,4622996.420000005,2018,8,10,DEBIT,700.0,M1486748271
4780,409000493210',2018-08-10,Indiaforensic NFS SETT 08-08-201,5000.0,0.0,4617996.420000005,2018,8,10,DEBIT,5000.0,M1871079355
4781,409000493210',2018-08-10,Indiaforensic NFS SETT 08-08-201,3000.0,0.0,4614996.420000005,2018,8,10,PAYEMENT,3000.0,M661970164
4782,409000493210',2018-08-10,Indiaforensic NFS SETT 08-08-201,9000.0,0.0,4605996.420000005,2018,8,10,CHECK_WITHDRAWAL,9000.0,M2086611398
4783,409000493210',2018-08-10,Indiaforensic NFS SETT 08-08-201,8000.0,0.0,4597996.420000005,2018,8,10,CASH_OUT,8000.0,M86509192
4784,409000493210',2018-08-10,Indiaforensic NFS SETT 08-08-201,4000.0,0.0,4593996.420000005,2018,8,10,PAYEMENT,4000.0,M1638622497
4785,409000493210',2018-08-10,Indiaforensic NFS SETT 08-08-201,7500.0,0.0,4586496.420000005,2018,8,10,CASH_OUT,7500.0,M2002190941
4786,409000493210',2018-08-10,Indiaforensic NFS SETT 08-08-201,8000.0,0.0,4578496.420000005,2018,8,10,PAYEMENT,8000.0,M1388602164
4787,409000493210',2018-08-10,Indiaforensic NFS SETT 08-08-201,7000.0,0.0,4571496.420000005,2018,8,10,CHECK_WITHDRAWAL,7000.0,M1568043544
4788,409000493210',2018-08-10,Indiaforensic NFS SETT 08-08-201,7000.0,0.0,4564496.420000005,2018,8,10,PAYEMENT,7000.0,C345679794
4789,409000493210',2018-08-10,Indiaforensic NFS SETT 08-08-201,1000.0,0.0,4563496.420000005,2018,8,10,CHECK_WITHDRAWAL,1000.0,M1414953733
4790,409000493210',2018-08-10,Indiaforensic NFS SETT 08-08-201,3000.0,0.0,4560496.420000005,2018,8,10,CHECK_WITHDRAWAL,3000.0,C846947180
4791,409000493210',2018-08-10,Indiaforensic NFS SETT 08-08-201,9000.0,0.0,4551496.420000005,2018,8,10,DEBIT,9000.0,M725978326
4792,409000493210',2018-08-10,Indiaforensic NFS SETT 08-08-201,1000.0,0.0,4550496.420000005,2018,8,10,PAYEMENT,1000.0,M118503237
4793,409000493210',2018-08-10,Indiaforensic NFS SETT 08-08-201,10000.0,0.0,4540496.420000005,2018,8,10,DEBIT,10000.0,C1456465598
4794,409000493210',2018-08-10,Indiaforensic NFS SETT 08-08-201,8500.0,0.0,4531996.420000005,2018,8,10,CHECK_WITHDRAWAL,8500.0,M201036751
4795,409000493210',2018-08-10,Indiaforensic NFS SETT 08-08-201,300.0,0.0,4531696.420000005,2018,8,10,DEBIT,300.0,M2076356118
4796,409000493210',2018-08-10,Indiaforensic NFS SETT 08-08-201,6000.0,0.0,4525696.420000005,2018,8,10,CASH_OUT,6000.0,M2101082331
4797,409000493210',2018-08-10,Indiaforensic NFS SETT 08-08-201,7300.0,0.0,4518396.420000005,2018,8,10,CASH_OUT,7300.0,M666586565
4798,409000493210',2018-08-10,Indiaforensic NFS SETT 08-08-201,5000.0,0.0,4513396.420000005,2018,8,10,DEBIT,5000.0,C1413871034
4799,409000493210',2018-08-10,Indiaforensic NFS SETT 08-08-201,8100.0,0.0,4505296.420000005,2018,8,10,PAYEMENT,8100.0,C476179877
4800,409000493210',2018-08-10,Indiaforensic NFS SETT 08-08-201,6000.0,0.0,4499296.420000005,2018,8,10,CASH_OUT,6000.0,M1877964230
4801,409000493210',2018-08-10,Indiaforensic NFS SETT 08-08-201,300.0,0.0,4498996.420000005,2018,8,10,CASH_OUT,300.0,M860176544
4802,409000493210',2018-08-10,Indiaforensic NFS SETT 08-08-201,7000.0,0.0,4491996.420000005,2018,8,10,CASH_OUT,7000.0,M188909616
4803,409000493210',2018-08-10,Indiaforensic NFS SETT 08-08-201,9300.0,0.0,4482696.420000005,2018,8,10,CASH_OUT,9300.0,M1118442276
4804,409000493210',2018-08-10,Indiaforensic NFS SETT 08-08-201,5100.0,0.0,4477596.420000005,2018,8,10,DEBIT,5100.0,M2130241059
4805,409000493210',2018-08-10,Indiaforensic NFS SETT 08-08-201,8000.0,0.0,4469596.420000005,2018,8,10,DEBIT,8000.0,M799834280
4806,409000493210',2018-08-10,Indiaforensic NFS SETT 08-08-201,500.0,0.0,4469096.420000005,2018,8,10,CHECK_WITHDRAWAL,500.0,M1350011870
4807,409000493210',2018-08-10,Indiaforensic NFS SETT 08-08-201,9200.0,0.0,4459896.420000005,2018,8,10,CASH_OUT,9200.0,C1339858954
4808,409000493210',2018-08-10,Indiaforensic NFS SETT 08-08-201,4000.0,0.0,4455896.420000005,2018,8,10,DEBIT,4000.0,C1281580764
4809,409000493210',2018-08-10,Indiaforensic NFS SETT 08-08-201,5000.0,0.0,4450896.420000005,2018,8,10,PAYEMENT,5000.0,C634440506
4810,409000493210',2018-08-10,Indiaforensic NFS SETT 08-08-201,5000.0,0.0,4445896.420000005,2018,8,10,CHECK_WITHDRAWAL,5000.0,M1778375336
4811,409000493210',2018-08-10,Indiaforensic NFS SETT 08-08-201,200.0,0.0,4445696.420000005,2018,8,10,DEBIT,200.0,M1758917774
4812,409000493210',2018-08-10,Indiaforensic NFS SETT 08-08-201,100.0,0.0,4445596.420000005,2018,8,10,CHECK_WITHDRAWAL,100.0,M2074865054
4813,409000493210',2018-08-10,Indiaforensic NFS SETT 08-08-201,5000.0,0.0,4440596.420000005,2018,8,10,DEBIT,5000.0,M2088687402
4814,409000493210',2018-08-10,Indiaforensic NFS SETT 08-08-201,10000.0,0.0,4430596.420000005,2018,8,10,CHECK_WITHDRAWAL,10000.0,M114565630
4815,409000493210',2018-08-10,Indiaforensic NFS SETT 08-08-201,500.0,0.0,4430096.420000005,2018,8,10,DEBIT,500.0,M920320548
4816,409000493210',2018-08-10,Indiaforensic NFS SETT 08-08-201,8000.0,0.0,4422096.420000005,2018,8,10,PAYEMENT,8000.0,M209029677
4817,409000493210',2018-08-10,Indiaforensic NFS SETT 08-08-201,300.0,0.0,4421796.420000005,2018,8,10,CASH_OUT,300.0,M1826705682
4818,409000493210',2018-08-10,Indiaforensic NFS SETT 08-08-201,9000.0,0.0,4412796.420000005,2018,8,10,PAYEMENT,9000.0,M731915467
4819,409000493210',2018-08-10,Indiaforensic NFS SETT 08-08-201,500.0,0.0,4412296.420000005,2018,8,10,DEBIT,500.0,M478113430
4820,409000493210',2018-08-10,Indiaforensic NFS SETT 08-08-201,2500.0,0.0,4409796.420000005,2018,8,10,PAYEMENT,2500.0,M448843184
4821,409000493210',2018-08-10,Indiaforensic NFS SETT 08-08-201,3500.0,0.0,4406296.420000005,2018,8,10,PAYEMENT,3500.0,M23604842
4822,409000493210',2018-08-10,Indiaforensic NFS SETT 08-08-201,9500.0,0.0,4396796.420000005,2018,8,10,CHECK_WITHDRAWAL,9500.0,M1290584410
4823,409000493210',2018-08-10,Indiaforensic NFS SETT 08-08-201,8000.0,0.0,4388796.420000005,2018,8,10,DEBIT,8000.0,M1296953588
4824,409000493210',2018-08-10,Indiaforensic NFS SETT 08-08-201,10000.0,0.0,4378796.420000005,2018,8,10,DEBIT,10000.0,M1580751727
4825,409000493210',2018-08-10,Indiaforensic NFS SETT 08-08-201,3000.0,0.0,4375796.420000005,2018,8,10,DEBIT,3000.0,M1172170412
4826,409000493210',2018-08-10,Indiaforensic  RUPAY SETT 100818,10623.54,0.0,4365172.880000005,2018,8,10,CHECK_WITHDRAWAL,10623.54,M143830798
4827,409000493210',2018-08-10,Indiaforensic RUPAY STL INTC1008,0.0,164.9,4365337.780000005,2018,8,10,CASH_IN,164.9,M1848568533
4828,409000493210',2018-08-10,Indiaforensic RUPAY STL INTC1008,164.9,0.0,4365172.880000005,2018,8,10,CASH_OUT,164.9,M212158113
4829,409000493210',2018-08-13,Indiaforensic RUPAY SETT 110818,13932.57,0.0,4351240.310000003,2018,8,13,CASH_OUT,13932.57,M896232285
4830,409000493210',2018-08-13,Indiaforensic RUPAY STL INTC1108,0.0,109.26,4351349.570000004,2018,8,13,CASH_IN,109.26,M294116482
4831,409000493210',2018-08-13,Indiaforensic RUPAY STL INTC1108,106.27,0.0,4351243.300000005,2018,8,13,PAYEMENT,106.27,M26101073
4832,409000493210',2018-08-13,Indiaforensic RUPAY STL INTC1108,0.0,0.02,4351243.320000004,2018,8,13,TRANSFER,0.02,M300430509
4833,409000493210',2018-08-13,Indiaforensic RUPAY SETT 120818,1835.02,0.0,4349408.300000005,2018,8,13,DEBIT,1835.02,M39686426
4834,409000493210',2018-08-13,Indiaforensic RUPAY STL INTC1208,23.29,0.0,4349385.0100000035,2018,8,13,DEBIT,23.29,M1218405027
4835,409000493210',2018-08-13,Indiaforensic RUPAY SETT 130818,3220.39,0.0,4346164.620000005,2018,8,13,CHECK_WITHDRAWAL,3220.39,C1983747920
4836,409000493210',2018-08-13,Indiaforensic RUPAY STL INTC1308,35.04,0.0,4346129.580000005,2018,8,13,CASH_OUT,35.04,M196539383
4837,409000493210',2018-08-13,Indiaforensic RUPAY STL INTC1208,0.0,47.81,4346177.390000003,2018,8,13,TRANSFER,47.81,C434091818
4838,409000493210',2018-08-13,Indiaforensic RUPAY STL INTC1208,0.0,0.17,4346177.560000003,2018,8,13,CHECK_CASHING,0.17,M181022659
4839,409000493210',2018-08-13,Indiaforensic RUPAY STL INTC1308,0.0,38.23,4346215.790000005,2018,8,13,CHECK_CASHING,38.23,M1988265335
4840,409000493210',2018-08-13,Indiaforensic RUPAY STL INTC1308,0.0,0.02,4346215.810000003,2018,8,13,CASH_IN,0.02,C451111351
4841,409000493210',2018-08-13,Indiaforensic  RUPAY SETT 130818,130.71,0.0,4346085.100000003,2018,8,13,DEBIT,130.71,M804153761
4842,409000493210',2018-08-13,Indiaforensic RUPAY STL INTC1308,0.0,1.43,4346086.530000004,2018,8,13,CASH_IN,1.43,M1819028083
4843,409000493210',2018-08-13,Indiaforensic RUPAY STL INTC1308,1.43,0.0,4346085.100000003,2018,8,13,PAYEMENT,1.43,M917847816
4844,409000493210',2018-08-13,Indiaforensic NFS SETT 09-08-201,9000.0,0.0,4337085.100000003,2018,8,13,PAYEMENT,9000.0,M1493177287
4845,409000493210',2018-08-13,Indiaforensic NFS SETT 09-08-201,8000.0,0.0,4329085.100000003,2018,8,13,DEBIT,8000.0,M2065764471
4846,409000493210',2018-08-13,Indiaforensic NFS SETT 09-08-201,300.0,0.0,4328785.100000003,2018,8,13,PAYEMENT,300.0,M1655750533
4847,409000493210',2018-08-13,Indiaforensic NFS SETT 09-08-201,8000.0,0.0,4320785.100000003,2018,8,13,CASH_OUT,8000.0,C1360767589
4848,409000493210',2018-08-13,Indiaforensic NFS SETT 09-08-201,400.0,0.0,4320385.100000003,2018,8,13,PAYEMENT,400.0,M1862784020
4849,409000493210',2018-08-13,Indiaforensic NFS SETT 09-08-201,6000.0,0.0,4314385.100000003,2018,8,13,CHECK_WITHDRAWAL,6000.0,M1090191122
4850,409000493210',2018-08-13,Indiaforensic NFS SETT 09-08-201,9000.0,0.0,4305385.100000003,2018,8,13,PAYEMENT,9000.0,M574187498
4851,409000493210',2018-08-13,Indiaforensic NFS SETT 09-08-201,100.0,0.0,4305285.100000003,2018,8,13,PAYEMENT,100.0,M1568611929
4852,409000493210',2018-08-13,Indiaforensic NFS SETT 09-08-201,5000.0,0.0,4300285.100000003,2018,8,13,CASH_OUT,5000.0,M981865495
4853,409000493210',2018-08-13,Indiaforensic NFS SETT 09-08-201,10000.0,0.0,4290285.100000003,2018,8,13,DEBIT,10000.0,M109987815
4854,409000493210',2018-08-13,Indiaforensic NFS SETT 09-08-201,7000.0,0.0,4283285.100000003,2018,8,13,PAYEMENT,7000.0,M380390717
4855,409000493210',2018-08-13,Indiaforensic NFS SETT 09-08-201,9000.0,0.0,4274285.100000003,2018,8,13,CASH_OUT,9000.0,M1906057135
4856,409000493210',2018-08-13,Indiaforensic NFS SETT 09-08-201,100.0,0.0,4274185.100000003,2018,8,13,CHECK_WITHDRAWAL,100.0,M521611410
4857,409000493210',2018-08-13,Indiaforensic NFS SETT 09-08-201,9000.0,0.0,4265185.100000003,2018,8,13,CHECK_WITHDRAWAL,9000.0,C162114152
4858,409000493210',2018-08-13,Indiaforensic NFS SETT 09-08-201,8500.0,0.0,4256685.100000003,2018,8,13,PAYEMENT,8500.0,C410033330
4859,409000493210',2018-08-13,Indiaforensic NFS SETT 09-08-201,6000.0,0.0,4250685.100000003,2018,8,13,CHECK_WITHDRAWAL,6000.0,M978881375
4860,409000493210',2018-08-13,Indiaforensic NFS SETT 09-08-201,7000.0,0.0,4243685.100000003,2018,8,13,CHECK_WITHDRAWAL,7000.0,C97730845
4861,409000493210',2018-08-13,Indiaforensic NFS SETT 09-08-201,9500.0,0.0,4234185.100000003,2018,8,13,CASH_OUT,9500.0,C885951223
4862,409000493210',2018-08-13,Indiaforensic NFS SETT 09-08-201,7000.0,0.0,4227185.100000003,2018,8,13,CHECK_WITHDRAWAL,7000.0,M576909528
4863,409000493210',2018-08-13,Indiaforensic NFS SETT 09-08-201,4500.0,0.0,4222685.100000003,2018,8,13,CASH_OUT,4500.0,M1507885816
4864,409000493210',2018-08-13,Indiaforensic NFS SETT 09-08-201,5000.0,0.0,4217685.100000003,2018,8,13,DEBIT,5000.0,C859193874
4865,409000493210',2018-08-13,Indiaforensic NFS SETT 09-08-201,10000.0,0.0,4207685.100000003,2018,8,13,CHECK_WITHDRAWAL,10000.0,C24119573
4866,409000493210',2018-08-13,Indiaforensic NFS SETT 09-08-201,2000.0,0.0,4205685.100000003,2018,8,13,CHECK_WITHDRAWAL,2000.0,M1701756941
4867,409000493210',2018-08-13,Indiaforensic NFS SETT 09-08-201,800.0,0.0,4204885.100000003,2018,8,13,DEBIT,800.0,M1590842898
4868,409000493210',2018-08-13,Indiaforensic NFS SETT 09-08-201,6500.0,0.0,4198385.100000003,2018,8,13,CASH_OUT,6500.0,M1457899771
4869,409000493210',2018-08-13,Indiaforensic NFS SETT 09-08-201,400.0,0.0,4197985.100000003,2018,8,13,PAYEMENT,400.0,M165886570
4870,409000493210',2018-08-13,Indiaforensic NFS SETT 09-08-201,6600.0,0.0,4191385.100000004,2018,8,13,CHECK_WITHDRAWAL,6600.0,M1955846455
4871,409000493210',2018-08-13,Indiaforensic NFS SETT 09-08-201,900.0,0.0,4190485.100000004,2018,8,13,PAYEMENT,900.0,M1298650532
4872,409000493210',2018-08-13,Indiaforensic NFS SETT 09-08-201,8100.0,0.0,4182385.100000004,2018,8,13,CHECK_WITHDRAWAL,8100.0,M1611382686
4873,409000493210',2018-08-13,Indiaforensic NFS SETT 09-08-201,5000.0,0.0,4177385.100000004,2018,8,13,CHECK_WITHDRAWAL,5000.0,M1924403079
4874,409000493210',2018-08-13,Indiaforensic NFS SETT 09-08-201,4500.0,0.0,4172885.100000004,2018,8,13,DEBIT,4500.0,M431966204
4875,409000493210',2018-08-13,Indiaforensic NFS SETT 09-08-201,7000.0,0.0,4165885.100000004,2018,8,13,CASH_OUT,7000.0,M591902639
4876,409000493210',2018-08-13,Indiaforensic NFS SETT 09-08-201,8500.0,0.0,4157385.100000004,2018,8,13,CASH_OUT,8500.0,M1258801872
4877,409000493210',2018-08-13,Indiaforensic NFS SETT 09-08-201,6000.0,0.0,4151385.100000004,2018,8,13,PAYEMENT,6000.0,M1318348444
4878,409000493210',2018-08-13,Indiaforensic NFS SETT 09-08-201,8500.0,0.0,4142885.100000004,2018,8,13,CASH_OUT,8500.0,M882838692
4879,409000493210',2018-08-13,Indiaforensic NFS SETT 09-08-201,100.0,0.0,4142785.100000004,2018,8,13,CASH_OUT,100.0,M188729048
4880,409000493210',2018-08-13,Indiaforensic NFS SETT 09-08-201,8000.0,0.0,4134785.100000004,2018,8,13,PAYEMENT,8000.0,M1590892341
4881,409000493210',2018-08-13,Indiaforensic NFS SETT 09-08-201,6000.0,0.0,4128785.100000004,2018,8,13,CHECK_WITHDRAWAL,6000.0,M1514969303
4882,409000493210',2018-08-13,Indiaforensic NFS SETT 09-08-201,7500.0,0.0,4121285.100000004,2018,8,13,CHECK_WITHDRAWAL,7500.0,M539425791
4883,409000493210',2018-08-13,Indiaforensic NFS SETT 09-08-201,4000.0,0.0,4117285.100000004,2018,8,13,DEBIT,4000.0,C456172878
4884,409000493210',2018-08-13,Indiaforensic NFS SETT 10-08-201,8500.0,0.0,4108785.100000004,2018,8,13,CHECK_WITHDRAWAL,8500.0,C875761527
4885,409000493210',2018-08-13,Indiaforensic NFS SETT 10-08-201,100.0,0.0,4108685.100000004,2018,8,13,DEBIT,100.0,M358115395
4886,409000493210',2018-08-13,Indiaforensic NFS SETT 10-08-201,8000.0,0.0,4100685.100000004,2018,8,13,CASH_OUT,8000.0,M237711398
4887,409000493210',2018-08-13,Indiaforensic NFS SETT 10-08-201,500.0,0.0,4100185.100000004,2018,8,13,PAYEMENT,500.0,M1861236708
4888,409000493210',2018-08-13,Indiaforensic NFS SETT 10-08-201,6500.0,0.0,4093685.100000004,2018,8,13,CHECK_WITHDRAWAL,6500.0,M774610771
4889,409000493210',2018-08-13,Indiaforensic NFS SETT 10-08-201,8000.0,0.0,4085685.100000004,2018,8,13,PAYEMENT,8000.0,C766681183
4890,409000493210',2018-08-13,Indiaforensic NFS SETT 10-08-201,100.0,0.0,4085585.100000004,2018,8,13,DEBIT,100.0,M1408739590
4891,409000493210',2018-08-13,Indiaforensic NFS SETT 10-08-201,7000.0,0.0,4078585.100000004,2018,8,13,PAYEMENT,7000.0,M146174144
4892,409000493210',2018-08-13,Indiaforensic NFS SETT 10-08-201,500.0,0.0,4078085.100000004,2018,8,13,DEBIT,500.0,M586914348
4893,409000493210',2018-08-13,Indiaforensic NFS SETT 10-08-201,5000.0,0.0,4073085.100000004,2018,8,13,PAYEMENT,5000.0,C1816757085
4894,409000493210',2018-08-13,Indiaforensic NFS SETT 10-08-201,3000.0,0.0,4070085.100000004,2018,8,13,DEBIT,3000.0,M34940856
4895,409000493210',2018-08-13,Indiaforensic NFS SETT 10-08-201,8000.0,0.0,4062085.100000004,2018,8,13,PAYEMENT,8000.0,M2070964440
4896,409000493210',2018-08-13,Indiaforensic NFS SETT 10-08-201,8000.0,0.0,4054085.100000004,2018,8,13,DEBIT,8000.0,C2118255842
4897,409000493210',2018-08-13,Indiaforensic NFS SETT 10-08-201,7000.0,0.0,4047085.100000004,2018,8,13,CHECK_WITHDRAWAL,7000.0,C1750563752
4898,409000493210',2018-08-13,Indiaforensic NFS SETT 10-08-201,1000.0,0.0,4046085.100000004,2018,8,13,CHECK_WITHDRAWAL,1000.0,M1036529258
4899,409000493210',2018-08-13,Indiaforensic NFS SETT 10-08-201,9500.0,0.0,4036585.100000004,2018,8,13,DEBIT,9500.0,M135920409
4900,409000493210',2018-08-13,Indiaforensic NFS SETT 10-08-201,10.0,0.0,4036575.100000004,2018,8,13,DEBIT,10.0,M74259289
4901,409000493210',2018-08-13,Indiaforensic NFS SETT 10-08-201,7000.0,0.0,4029575.100000004,2018,8,13,CASH_OUT,7000.0,C769507769
4902,409000493210',2018-08-13,Indiaforensic NFS SETT 10-08-201,200.0,0.0,4029375.100000004,2018,8,13,CHECK_WITHDRAWAL,200.0,M140163428
4903,409000493210',2018-08-13,Indiaforensic NFS SETT 10-08-201,8000.0,0.0,4021375.100000004,2018,8,13,PAYEMENT,8000.0,M305552344
4904,409000493210',2018-08-13,Indiaforensic NFS SETT 10-08-201,7000.0,0.0,4014375.100000004,2018,8,13,CHECK_WITHDRAWAL,7000.0,C1382717704
4905,409000493210',2018-08-13,Indiaforensic NFS SETT 10-08-201,2000.0,0.0,4012375.100000004,2018,8,13,CHECK_WITHDRAWAL,2000.0,M600296216
4906,409000493210',2018-08-13,Indiaforensic NFS SETT 10-08-201,4000.0,0.0,4008375.100000004,2018,8,13,CHECK_WITHDRAWAL,4000.0,C998351292
4907,409000493210',2018-08-13,Indiaforensic NFS SETT 10-08-201,7000.0,0.0,4001375.100000004,2018,8,13,CASH_OUT,7000.0,M1043154163
4908,409000493210',2018-08-13,Indiaforensic NFS SETT 10-08-201,500.0,0.0,4000875.100000004,2018,8,13,CASH_OUT,500.0,C728526866
4909,409000493210',2018-08-13,Indiaforensic NFS SETT 10-08-201,9000.0,0.0,3991875.100000004,2018,8,13,CASH_OUT,9000.0,C1339858954
4910,409000493210',2018-08-13,Indiaforensic NFS SETT 10-08-201,500.0,0.0,3991375.100000004,2018,8,13,CASH_OUT,500.0,C1446521801
4911,409000493210',2018-08-13,Indiaforensic NFS SETT 10-08-201,1500.0,0.0,3989875.100000004,2018,8,13,CHECK_WITHDRAWAL,1500.0,C306206744
4912,409000493210',2018-08-13,Indiaforensic NFS SETT 10-08-201,500.0,0.0,3989375.100000004,2018,8,13,DEBIT,500.0,C598551831
4913,409000493210',2018-08-13,Indiaforensic NFS SETT 10-08-201,4500.0,0.0,3984875.100000004,2018,8,13,PAYEMENT,4500.0,C1281580764
4914,409000493210',2018-08-13,Indiaforensic NFS SETT 10-08-201,9000.0,0.0,3975875.100000004,2018,8,13,PAYEMENT,9000.0,C977993101
4915,409000493210',2018-08-13,Indiaforensic NFS SETT 10-08-201,1000.0,0.0,3974875.100000004,2018,8,13,PAYEMENT,1000.0,C1721246982
4916,409000493210',2018-08-13,Indiaforensic NFS SETT 10-08-201,500.0,0.0,3974375.100000004,2018,8,13,CASH_OUT,500.0,C1446521801
4917,409000493210',2018-08-13,Indiaforensic NFS SETT 11-08-201,10000.0,0.0,3964375.100000004,2018,8,13,CHECK_WITHDRAWAL,10000.0,C2012808675
4918,409000493210',2018-08-13,Indiaforensic NFS SETT 11-08-201,10000.0,0.0,3954375.100000004,2018,8,13,DEBIT,10000.0,C1774531247
4919,409000493210',2018-08-13,Indiaforensic NFS SETT 11-08-201,7700.0,0.0,3946675.100000004,2018,8,13,CHECK_WITHDRAWAL,7700.0,C2134357721
4920,409000493210',2018-08-13,Indiaforensic NFS SETT 11-08-201,1600.0,0.0,3945075.100000004,2018,8,13,CHECK_WITHDRAWAL,1600.0,C481402298
4921,409000493210',2018-08-13,Indiaforensic NFS SETT 11-08-201,10000.0,0.0,3935075.100000004,2018,8,13,DEBIT,10000.0,C905650857
4922,409000493210',2018-08-13,Indiaforensic NFS SETT 11-08-201,4000.0,0.0,3931075.100000004,2018,8,13,PAYEMENT,4000.0,C1590550415
4923,409000493210',2018-08-13,Indiaforensic NFS SETT 11-08-201,500.0,0.0,3930575.100000004,2018,8,13,CHECK_WITHDRAWAL,500.0,C667346055
4924,409000493210',2018-08-13,Indiaforensic NFS SETT 11-08-201,1900.0,0.0,3928675.100000004,2018,8,13,CASH_OUT,1900.0,C667346055
4925,409000493210',2018-08-13,Indiaforensic NFS SETT 11-08-201,800.0,0.0,3927875.100000004,2018,8,13,CHECK_WITHDRAWAL,800.0,C1261031890
4926,409000493210',2018-08-13,Indiaforensic NFS SETT 11-08-201,7000.0,0.0,3920875.100000004,2018,8,13,CHECK_WITHDRAWAL,7000.0,C909295153
4927,409000493210',2018-08-13,Indiaforensic NFS SETT 11-08-201,500.0,0.0,3920375.100000004,2018,8,13,CASH_OUT,500.0,C766681183
4928,409000493210',2018-08-13,Indiaforensic NFS SETT 11-08-201,8500.0,0.0,3911875.100000004,2018,8,13,DEBIT,8500.0,C1891031939
4929,409000493210',2018-08-13,Indiaforensic NFS SETT 11-08-201,4000.0,0.0,3907875.100000004,2018,8,13,CHECK_WITHDRAWAL,4000.0,C248609774
4930,409000493210',2018-08-13,Indiaforensic NFS SETT 11-08-201,7000.0,0.0,3900875.100000004,2018,8,13,DEBIT,7000.0,C1587143371
4931,409000493210',2018-08-13,Indiaforensic NFS SETT 11-08-201,4000.0,0.0,3896875.100000004,2018,8,13,CHECK_WITHDRAWAL,4000.0,C306206744
4932,409000493210',2018-08-13,Indiaforensic NFS SETT 11-08-201,8500.0,0.0,3888375.100000004,2018,8,13,DEBIT,8500.0,C1670479841
4933,409000493210',2018-08-13,Indiaforensic NFS SETT 11-08-201,7000.0,0.0,3881375.100000004,2018,8,13,CASH_OUT,7000.0,C1146719991
4934,409000493210',2018-08-13,Indiaforensic NFS SETT 11-08-201,500.0,0.0,3880875.100000004,2018,8,13,CASH_OUT,500.0,C33524623
4935,409000493210',2018-08-13,Indiaforensic NFS SETT 11-08-201,500.0,0.0,3880375.100000004,2018,8,13,CHECK_WITHDRAWAL,500.0,C1259769769
4936,409000493210',2018-08-13,Indiaforensic NFS SETT 11-08-201,8000.0,0.0,3872375.100000004,2018,8,13,CHECK_WITHDRAWAL,8000.0,C1234776885
4937,409000493210',2018-08-13,Indiaforensic NFS SETT 11-08-201,600.0,0.0,3871775.100000004,2018,8,13,CASH_OUT,600.0,C1303868418
4938,409000493210',2018-08-13,Indiaforensic NFS SETT 11-08-201,8000.0,0.0,3863775.100000004,2018,8,13,DEBIT,8000.0,C1303868418
4939,409000493210',2018-08-13,Indiaforensic NFS SETT 11-08-201,500.0,0.0,3863275.100000004,2018,8,13,PAYEMENT,500.0,C1590550415
4940,409000493210',2018-08-13,Indiaforensic NFS SETT 11-08-201,300.0,0.0,3862975.100000004,2018,8,13,DEBIT,300.0,C1917025677
4941,409000493210',2018-08-13,Indiaforensic NFS SETT 11-08-201,200.0,0.0,3862775.100000004,2018,8,13,PAYEMENT,200.0,C885951223
4942,409000493210',2018-08-13,Indiaforensic NFS SETT 11-08-201,200.0,0.0,3862575.100000004,2018,8,13,CASH_OUT,200.0,C1446521801
4943,409000493210',2018-08-13,Indiaforensic NFS SETT 11-08-201,4000.0,0.0,3858575.100000004,2018,8,13,PAYEMENT,4000.0,C1674899618
4944,409000493210',2018-08-13,Indiaforensic NFS SETT 11-08-201,4000.0,0.0,3854575.100000004,2018,8,13,CHECK_WITHDRAWAL,4000.0,C542895457
4945,409000493210',2018-08-13,Indiaforensic NFS SETT 11-08-201,5000.0,0.0,3849575.100000004,2018,8,13,CHECK_WITHDRAWAL,5000.0,C832279283
4946,409000493210',2018-08-13,Indiaforensic NFS SETT 11-08-201,8000.0,0.0,3841575.100000004,2018,8,13,CASH_OUT,8000.0,C1590550415
4947,409000493210',2018-08-13,Indiaforensic NFS SETT 11-08-201,1000.0,0.0,3840575.100000004,2018,8,13,DEBIT,1000.0,C1397088232
4948,409000493210',2018-08-13,Indiaforensic NFS SETT 11-08-201,9000.0,0.0,3831575.100000004,2018,8,13,DEBIT,9000.0,C1816757085
4949,409000493210',2018-08-13,Indiaforensic NFS SETT 11-08-201,300.0,0.0,3831275.100000004,2018,8,13,DEBIT,300.0,C1653859230
4950,409000493210',2018-08-13,Indiaforensic NFS SETT 11-08-201,8500.0,0.0,3822775.100000004,2018,8,13,CHECK_WITHDRAWAL,8500.0,C459857341
4951,409000493210',2018-08-13,Indiaforensic NFS SETT 11-08-201,100.0,0.0,3822675.100000004,2018,8,13,CHECK_WITHDRAWAL,100.0,C2118255842
4952,409000493210',2018-08-13,Indiaforensic NFS SETT 11-08-201,5000.0,0.0,3817675.100000004,2018,8,13,PAYEMENT,5000.0,C1761291320
4953,409000493210',2018-08-13,Indiaforensic NFS SETT 11-08-201,3000.0,0.0,3814675.100000004,2018,8,13,PAYEMENT,3000.0,C214774813
4954,409000493210',2018-08-13,Indiaforensic NFS SETT 11-08-201,5500.0,0.0,3809175.100000004,2018,8,13,DEBIT,5500.0,C1303868418
4955,409000493210',2018-08-13,Indiaforensic NFS SETT 11-08-201,2200.0,0.0,3806975.100000004,2018,8,13,DEBIT,2200.0,C985934102
4956,409000493210',2018-08-13,Indiaforensic NFS SETT 11-08-201,9000.0,0.0,3797975.100000004,2018,8,13,PAYEMENT,9000.0,C932583850
4957,409000493210',2018-08-13,Indiaforensic NFS SETT 11-08-201,100.0,0.0,3797875.100000004,2018,8,13,CASH_OUT,100.0,C1794893473
4958,409000493210',2018-08-13,Indiaforensic NFS SETT 11-08-201,100.0,0.0,3797775.100000004,2018,8,13,CHECK_WITHDRAWAL,100.0,C1926673338
4959,409000493210',2018-08-13,Indiaforensic NFS SETT 11-08-201,6000.0,0.0,3791775.100000004,2018,8,13,DEBIT,6000.0,C283747838
4960,409000493210',2018-08-13,Indiaforensic NFS SETT 11-08-201,6000.0,0.0,3785775.100000004,2018,8,13,CASH_OUT,6000.0,C187649742
4961,409000493210',2018-08-13,Indiaforensic NFS SETT 11-08-201,8400.0,0.0,3777375.100000004,2018,8,13,CASH_OUT,8400.0,C451111351
4962,409000493210',2018-08-13,Indiaforensic NFS SETT 12-08-201,2000.0,0.0,3775375.100000004,2018,8,13,PAYEMENT,2000.0,C1076835071
4963,409000493210',2018-08-13,Indiaforensic NFS SETT 12-08-201,500.0,0.0,3774875.100000004,2018,8,13,PAYEMENT,500.0,C1997859171
4964,409000493210',2018-08-13,Indiaforensic NFS SETT 12-08-201,3000.0,0.0,3771875.100000004,2018,8,13,CHECK_WITHDRAWAL,3000.0,C2083562754
4965,409000493210',2018-08-13,Indiaforensic NFS SETT 12-08-201,2000.0,0.0,3769875.100000004,2018,8,13,DEBIT,2000.0,C728526866
4966,409000493210',2018-08-13,Indiaforensic NFS SETT 12-08-201,1000.0,0.0,3768875.100000004,2018,8,13,PAYEMENT,1000.0,C667346055
4967,409000493210',2018-08-13,Indiaforensic NFS SETT 12-08-201,8500.0,0.0,3760375.100000004,2018,8,13,CASH_OUT,8500.0,C662736689
4968,409000493210',2018-08-13,Indiaforensic NFS SETT 12-08-201,500.0,0.0,3759875.100000004,2018,8,13,CASH_OUT,500.0,C1590550415
4969,409000493210',2018-08-13,Indiaforensic NFS SETT 12-08-201,5000.0,0.0,3754875.100000004,2018,8,13,DEBIT,5000.0,C1850042097
4970,409000493210',2018-08-13,Indiaforensic NFS SETT 12-08-201,1000.0,0.0,3753875.100000004,2018,8,13,DEBIT,1000.0,C667346055
4971,409000493210',2018-08-13,Indiaforensic NFS SETT 12-08-201,2000.0,0.0,3751875.100000004,2018,8,13,CHECK_WITHDRAWAL,2000.0,C644345897
4972,409000493210',2018-08-13,Indiaforensic NFS SETT 12-08-201,1000.0,0.0,3750875.100000004,2018,8,13,DEBIT,1000.0,C1674899618
4973,409000493210',2018-08-13,Indiaforensic NFS SETT 12-08-201,100.0,0.0,3750775.100000004,2018,8,13,CHECK_WITHDRAWAL,100.0,C214774813
4974,409000493210',2018-08-13,Indiaforensic NFS SETT 12-08-201,8500.0,0.0,3742275.100000004,2018,8,13,PAYEMENT,8500.0,C71364493
4975,409000493210',2018-08-13,Indiaforensic NFS SETT 12-08-201,10000.0,0.0,3732275.100000004,2018,8,13,CASH_OUT,10000.0,C657736958
4976,409000493210',2018-08-14,Indiaforensic  RUPAY SETT 140818,9111.42,0.0,3723163.680000005,2018,8,14,CASH_OUT,9111.42,C1816757085
4977,409000493210',2018-08-14,Indiaforensic RUPAY STL INTC1408,0.0,63.55,3723227.2300000037,2018,8,14,TRANSFER,63.55,C434091818
4978,409000493210',2018-08-14,Indiaforensic RUPAY STL INTC1408,63.55,0.0,3723163.680000005,2018,8,14,CASH_OUT,63.55,M357751318
4979,409000493210',2018-08-14,Indiaforensic  RUPAY SETT 140818,9347.59,0.0,3713816.090000005,2018,8,14,CHECK_WITHDRAWAL,9347.59,C1590550415
4980,409000493210',2018-08-14,Indiaforensic RUPAY STL INTC1408,0.0,70.64,3713886.730000005,2018,8,14,TRANSFER,70.64,C728526866
4981,409000493210',2018-08-14,Indiaforensic RUPAY STL INTC1408,70.64,0.0,3713816.090000005,2018,8,14,CHECK_WITHDRAWAL,70.64,C1167066016
4982,409000493210',2018-08-14,Indiaforensic NFS SETT 13-08-201,2500.0,0.0,3711316.090000005,2018,8,14,CHECK_WITHDRAWAL,2500.0,C716083600
4983,409000493210',2018-08-14,Indiaforensic NFS SETT 13-08-201,1000.0,0.0,3710316.090000005,2018,8,14,CASH_OUT,1000.0,C392292416
4984,409000493210',2018-08-14,Indiaforensic NFS SETT 13-08-201,9000.0,0.0,3701316.090000005,2018,8,14,CASH_OUT,9000.0,C539058198
4985,409000493210',2018-08-14,Indiaforensic NFS SETT 13-08-201,500.0,0.0,3700816.090000005,2018,8,14,DEBIT,500.0,C660143728
4986,409000493210',2018-08-14,Indiaforensic NFS SETT 13-08-201,100.0,0.0,3700716.090000005,2018,8,14,CASH_OUT,100.0,C1870252780
4987,409000493210',2018-08-14,Indiaforensic NFS SETT 13-08-201,4000.0,0.0,3696716.090000005,2018,8,14,CASH_OUT,4000.0,C1789550256
4988,409000493210',2018-08-14,Indiaforensic NFS SETT 13-08-201,2000.0,0.0,3694716.090000005,2018,8,14,PAYEMENT,2000.0,C634440506
4989,409000493210',2018-08-14,Indiaforensic NFS SETT 13-08-201,5000.0,0.0,3689716.090000005,2018,8,14,DEBIT,5000.0,C1303868418
4990,409000493210',2018-08-14,Indiaforensic NFS SETT 13-08-201,300.0,0.0,3689416.090000005,2018,8,14,DEBIT,300.0,C1782113663
4991,409000493210',2018-08-14,Indiaforensic NFS SETT 13-08-201,7000.0,0.0,3682416.090000005,2018,8,14,CHECK_WITHDRAWAL,7000.0,C1750563752
4992,409000493210',2018-08-14,Indiaforensic NFS SETT 13-08-201,4000.0,0.0,3678416.090000005,2018,8,14,CASH_OUT,4000.0,C1526298704
4993,409000493210',2018-08-14,Indiaforensic NFS SETT 13-08-201,8500.0,0.0,3669916.090000005,2018,8,14,DEBIT,8500.0,C1721246982
4994,409000493210',2018-08-16,TRF FRM  Indiaforensic SERVICES,0.0,105000.0,3774916.090000005,2018,8,16,TRANSFER,105000.0,C985934102
4995,409000493210',2018-08-16,Indiaforensic RUPAY SETT 150818,1744.56,0.0,3773171.530000005,2018,8,16,CHECK_WITHDRAWAL,1744.56,C1163619825
4996,409000493210',2018-08-16,Indiaforensic RUPAY STL INTC1508,0.0,2017.84,3775189.370000004,2018,8,16,TRANSFER,2017.84,C1850042097
4997,409000493210',2018-08-16,Indiaforensic RUPAY STL INTC1508,17.84,0.0,3775171.530000005,2018,8,16,CHECK_WITHDRAWAL,17.84,C991505714
4998,409000493210',2018-08-16,Indiaforensic RUPAY STL INTC1508,0.0,32.0,3775203.530000005,2018,8,16,TRANSFER,32.0,C977993101
4999,409000493210',2018-08-16,Indiaforensic RUPAY SETT 160818,2079.83,0.0,3773123.700000005,2018,8,16,CHECK_WITHDRAWAL,2079.83,C187649742
5000,409000493210',2018-08-16,Indiaforensic RUPAY STL INTC1608,0.0,2013.19,3775136.890000004,2018,8,16,CASH_IN,2013.19,C769507769
5001,409000493210',2018-08-16,Indiaforensic RUPAY STL INTC1608,12.44,0.0,3775124.450000005,2018,8,16,PAYEMENT,12.44,C1459035867
5002,409000493210',2018-08-16,Indiaforensic RUPAY STL INTC1608,0.0,32.0,3775156.450000005,2018,8,16,TRANSFER,32.0,C801142660
5003,409000493210',2018-08-16,Indiaforensic  RUPAY SETT 160818,86.42,0.0,3775070.030000005,2018,8,16,CASH_OUT,86.42,C146305349
5004,409000493210',2018-08-16,Indiaforensic RUPAY STL INTC1608,0.0,0.6,3775070.630000005,2018,8,16,CHECK_CASHING,0.6,C564160838
5005,409000493210',2018-08-16,Indiaforensic RUPAY STL INTC1608,0.6,0.0,3775070.030000005,2018,8,16,CASH_OUT,0.6,C1234776885
5006,409000493210',2018-08-17,Indiaforensic  RUPAY SETT 170818,1553.14,0.0,3773516.890000004,2018,8,17,CASH_OUT,1553.14,C709091500
5007,409000493210',2018-08-17,Indiaforensic RUPAY STL INTC1708,0.0,85.73,3773602.620000004,2018,8,17,CHECK_CASHING,85.73,C1286084959
5008,409000493210',2018-08-17,Indiaforensic RUPAY STL INTC1708,16.81,0.0,3773585.810000004,2018,8,17,CHECK_WITHDRAWAL,16.81,C909295153
5009,409000493210',2018-08-17,Indiaforensic RUPAY STL INTC1708,0.0,0.52,3773586.330000004,2018,8,17,CHECK_CASHING,0.52,C476179877
5010,409000493210',2018-08-17,Indiaforensic NFS SETT 14-08-201,2000.0,0.0,3771586.330000004,2018,8,17,DEBIT,2000.0,C1262822392
5011,409000493210',2018-08-17,Indiaforensic NFS SETT 14-08-201,400.0,0.0,3771186.330000004,2018,8,17,DEBIT,400.0,C662736689
5012,409000493210',2018-08-17,Indiaforensic NFS SETT 14-08-201,3000.0,0.0,3768186.330000004,2018,8,17,DEBIT,3000.0,C1680630881
5013,409000493210',2018-08-17,Indiaforensic NFS SETT 14-08-201,500.0,0.0,3767686.330000004,2018,8,17,CHECK_WITHDRAWAL,500.0,C1883840933
5014,409000493210',2018-08-17,Indiaforensic NFS SETT 14-08-201,8500.0,0.0,3759186.330000004,2018,8,17,CHECK_WITHDRAWAL,8500.0,M861339480
5015,409000493210',2018-08-17,Indiaforensic NFS SETT 14-08-201,400.0,0.0,3758786.330000004,2018,8,17,DEBIT,400.0,M715570093
5016,409000493210',2018-08-17,Indiaforensic NFS SETT 14-08-201,10000.0,0.0,3748786.330000004,2018,8,17,CASH_OUT,10000.0,M1871084300
5017,409000493210',2018-08-17,Indiaforensic NFS SETT 14-08-201,7000.0,0.0,3741786.330000004,2018,8,17,CASH_OUT,7000.0,M1421763091
5018,409000493210',2018-08-17,Indiaforensic NFS SETT 14-08-201,300.0,0.0,3741486.330000004,2018,8,17,CASH_OUT,300.0,M338048780
5019,409000493210',2018-08-17,Indiaforensic NFS SETT 14-08-201,10000.0,0.0,3731486.330000004,2018,8,17,CASH_OUT,10000.0,M787497403
5020,409000493210',2018-08-17,Indiaforensic NFS SETT 14-08-201,2500.0,0.0,3728986.330000004,2018,8,17,PAYEMENT,2500.0,M1616673438
5021,409000493210',2018-08-17,Indiaforensic NFS SETT 15-08-201,500.0,0.0,3728486.330000004,2018,8,17,CHECK_WITHDRAWAL,500.0,M219553950
5022,409000493210',2018-08-17,Indiaforensic NFS SETT 15-08-201,100.0,0.0,3728386.330000004,2018,8,17,DEBIT,100.0,M1985569416
5023,409000493210',2018-08-17,Indiaforensic NFS SETT 15-08-201,700.0,0.0,3727686.330000004,2018,8,17,CHECK_WITHDRAWAL,700.0,M1370456137
5024,409000493210',2018-08-17,Indiaforensic NFS SETT 15-08-201,10000.0,0.0,3717686.330000004,2018,8,17,CHECK_WITHDRAWAL,10000.0,M177901251
5025,409000493210',2018-08-17,Indiaforensic NFS SETT 15-08-201,10000.0,0.0,3707686.330000004,2018,8,17,PAYEMENT,10000.0,M1073835233
5026,409000493210',2018-08-17,Indiaforensic NFS SETT 15-08-201,5000.0,0.0,3702686.330000004,2018,8,17,PAYEMENT,5000.0,M2114259937
5027,409000493210',2018-08-17,Indiaforensic NFS SETT 15-08-201,1000.0,0.0,3701686.330000004,2018,8,17,CASH_OUT,1000.0,M1349166616
5028,409000493210',2018-08-17,Indiaforensic NFS SETT 15-08-201,500.0,0.0,3701186.330000004,2018,8,17,DEBIT,500.0,M493294557
5029,409000493210',2018-08-17,Indiaforensic NFS SETT 15-08-201,3500.0,0.0,3697686.330000004,2018,8,17,CASH_OUT,3500.0,M1055317122
5030,409000493210',2018-08-17,Indiaforensic  RUPAY SETT 170818,300.42,0.0,3697385.910000004,2018,8,17,DEBIT,300.42,M182124057
5031,409000493210',2018-08-17,Indiaforensic RUPAY STL INTC1708,0.0,2.09,3697388.0000000037,2018,8,17,TRANSFER,2.09,M1990268013
5032,409000493210',2018-08-17,Indiaforensic RUPAY STL INTC1708,2.09,0.0,3697385.910000004,2018,8,17,CASH_OUT,2.09,M864469510
5033,409000493210',2018-08-18,Indiaforensic  RUPAY SETT 180818,8588.7,0.0,3688797.2100000037,2018,8,18,DEBIT,8588.7,M1843321088
5034,409000493210',2018-08-18,Indiaforensic RUPAY STL INTC1808,0.0,95.86,3688893.0700000036,2018,8,18,CASH_IN,95.86,M138617961
5035,409000493210',2018-08-18,Indiaforensic RUPAY STL INTC1808,87.23,0.0,3688805.8400000036,2018,8,18,PAYEMENT,87.23,M364998425
5036,409000493210',2018-08-18,Indiaforensic RUPAY STL INTC1808,0.0,0.04,3688805.8800000036,2018,8,18,CHECK_CASHING,0.04,M199676456
5037,409000493210',2018-08-20,Indiaforensic  RUPAY SETT 200818,9350.1,0.0,3679455.7800000035,2018,8,20,CHECK_WITHDRAWAL,9350.1,M2129554451
5038,409000493210',2018-08-20,Indiaforensic RUPAY STL INTC2008,0.0,94.93,3679550.7100000037,2018,8,20,CASH_IN,94.93,M1736230120
5039,409000493210',2018-08-20,Indiaforensic RUPAY STL INTC2008,91.18,0.0,3679459.5300000035,2018,8,20,CHECK_WITHDRAWAL,91.18,M1105778967
5040,409000493210',2018-08-20,Indiaforensic RUPAY STL INTC2008,0.0,0.02,3679459.5500000035,2018,8,20,TRANSFER,0.02,M725579524
5041,409000493210',2018-08-20,Indiaforensic  RUPAY SETT 190818,11490.41,0.0,3667969.140000004,2018,8,20,CASH_OUT,11490.41,M1035062904
5042,409000493210',2018-08-20,Indiaforensic RUPAY STL INTC1908,0.0,95.83,3668064.970000004,2018,8,20,CHECK_CASHING,95.83,C444920847
5043,409000493210',2018-08-20,Indiaforensic RUPAY STL INTC1908,95.08,0.0,3667969.890000004,2018,8,20,CHECK_WITHDRAWAL,95.08,C1725097945
5044,409000493210',2018-08-20,Indiaforensic  RUPAY SETT 200818,177.12,0.0,3667792.7700000037,2018,8,20,CASH_OUT,177.12,C40075281
5045,409000493210',2018-08-20,Indiaforensic RUPAY STL INTC2008,0.0,1.03,3667793.8000000035,2018,8,20,CHECK_CASHING,1.03,C1826334428
5046,409000493210',2018-08-20,Indiaforensic RUPAY STL INTC2008,1.03,0.0,3667792.7700000037,2018,8,20,CASH_OUT,1.03,C598551831
5047,409000493210',2018-08-20,Indiaforensic NFS SETT 18-08-201,300.0,0.0,3667492.7700000037,2018,8,20,PAYEMENT,300.0,M1683866967
5048,409000493210',2018-08-20,Indiaforensic NFS SETT 18-08-201,300.0,0.0,3667192.7700000037,2018,8,20,CHECK_WITHDRAWAL,300.0,M1542221
5049,409000493210',2018-08-20,Indiaforensic NFS SETT 18-08-201,200.0,0.0,3666992.7700000037,2018,8,20,CASH_OUT,200.0,M208875036
5050,409000493210',2018-08-20,Indiaforensic NFS SETT 18-08-201,200.0,0.0,3666792.7700000037,2018,8,20,CHECK_WITHDRAWAL,200.0,M1455696228
5051,409000493210',2018-08-20,Indiaforensic NFS SETT 18-08-201,900.0,0.0,3665892.7700000037,2018,8,20,PAYEMENT,900.0,M873226166
5052,409000493210',2018-08-20,Indiaforensic NFS SETT 18-08-201,1500.0,0.0,3664392.7700000037,2018,8,20,CASH_OUT,1500.0,M1171491314
5053,409000493210',2018-08-20,Indiaforensic NFS SETT 18-08-201,6000.0,0.0,3658392.7700000037,2018,8,20,DEBIT,6000.0,C1211297851
5054,409000493210',2018-08-20,Indiaforensic NFS SETT 19-08-201,400.0,0.0,3657992.7700000037,2018,8,20,CHECK_WITHDRAWAL,400.0,M203829039
5055,409000493210',2018-08-20,Indiaforensic NFS SETT 19-08-201,500.0,0.0,3657492.7700000037,2018,8,20,CHECK_WITHDRAWAL,500.0,M286559682
5056,409000493210',2018-08-20,Indiaforensic NFS SETT 19-08-201,10000.0,0.0,3647492.7700000037,2018,8,20,DEBIT,10000.0,C1937962514
5057,409000493210',2018-08-20,Indiaforensic NFS SETT 19-08-201,1500.0,0.0,3645992.7700000037,2018,8,20,CHECK_WITHDRAWAL,1500.0,M1325077489
5058,409000493210',2018-08-20,Indiaforensic NFS SETT 19-08-201,500.0,0.0,3645492.7700000037,2018,8,20,CHECK_WITHDRAWAL,500.0,M5313207
5059,409000493210',2018-08-21,Indiaforensic  RUPAY SETT 210818,216.07,0.0,3645276.700000004,2018,8,21,PAYEMENT,216.07,M1089579669
5060,409000493210',2018-08-21,Indiaforensic RUPAY STL INTC2108,0.0,2.0,3645278.700000004,2018,8,21,TRANSFER,2.0,M348026124
5061,409000493210',2018-08-21,Indiaforensic RUPAY STL INTC2108,2.0,0.0,3645276.700000004,2018,8,21,CASH_OUT,2.0,M367035925
5062,409000493210',2018-08-21,FDRL/INTERNAL FUND TRANSFE,0.0,100000.0,3745276.700000004,2018,8,21,CASH_IN,100000.0,C453211571
5063,409000493210',2018-08-21,Indiaforensic NFS SETT 16-08-201,700.0,0.0,3744576.700000004,2018,8,21,CASH_OUT,700.0,M1743696656
5064,409000493210',2018-08-21,Indiaforensic NFS SETT 16-08-201,100.0,0.0,3744476.700000004,2018,8,21,PAYEMENT,100.0,M967631271
5065,409000493210',2018-08-21,Indiaforensic NFS SETT 16-08-201,300.0,0.0,3744176.700000004,2018,8,21,PAYEMENT,300.0,M198503937
5066,409000493210',2018-08-21,Indiaforensic NFS SETT 16-08-201,10000.0,0.0,3734176.700000004,2018,8,21,DEBIT,10000.0,M1501976525
5067,409000493210',2018-08-21,Indiaforensic NFS SETT 16-08-201,2000.0,0.0,3732176.700000004,2018,8,21,CHECK_WITHDRAWAL,2000.0,C1234776885
5068,409000493210',2018-08-21,Indiaforensic NFS SETT 16-08-201,4000.0,0.0,3728176.700000004,2018,8,21,PAYEMENT,4000.0,C451111351
5069,409000493210',2018-08-21,Indiaforensic NFS SETT 16-08-201,6900.0,0.0,3721276.700000004,2018,8,21,PAYEMENT,6900.0,C1167066016
5070,409000493210',2018-08-21,Indiaforensic NFS SETT 16-08-201,6000.0,0.0,3715276.700000004,2018,8,21,CASH_OUT,6000.0,C1883840933
5071,409000493210',2018-08-21,Indiaforensic NFS SETT 16-08-201,200.0,0.0,3715076.700000004,2018,8,21,PAYEMENT,200.0,C1413871034
5072,409000493210',2018-08-21,Indiaforensic NFS SETT 16-08-201,2500.0,0.0,3712576.700000004,2018,8,21,DEBIT,2500.0,C1023714065
5073,409000493210',2018-08-21,Indiaforensic NFS SETT 16-08-201,1500.0,0.0,3711076.700000004,2018,8,21,CASH_OUT,1500.0,C306206744
5074,409000493210',2018-08-21,Indiaforensic NFS SETT 16-08-201,8000.0,0.0,3703076.700000004,2018,8,21,CHECK_WITHDRAWAL,8000.0,C665576141
5075,409000493210',2018-08-21,Indiaforensic NFS SETT 16-08-201,500.0,0.0,3702576.700000004,2018,8,21,CASH_OUT,500.0,C20671747
5076,409000493210',2018-08-21,Indiaforensic NFS SETT 16-08-201,100.0,0.0,3702476.700000004,2018,8,21,DEBIT,100.0,C1916720513
5077,409000493210',2018-08-21,Indiaforensic NFS SETT 16-08-201,8700.0,0.0,3693776.700000004,2018,8,21,DEBIT,8700.0,C667346055
5078,409000493210',2018-08-21,Indiaforensic NFS SETT 17-08-201,5000.0,0.0,3688776.700000004,2018,8,21,DEBIT,5000.0,C644345897
5079,409000493210',2018-08-21,Indiaforensic NFS SETT 17-08-201,400.0,0.0,3688376.700000004,2018,8,21,PAYEMENT,400.0,C481402298
5080,409000493210',2018-08-21,Indiaforensic NFS SETT 17-08-201,1000.0,0.0,3687376.700000004,2018,8,21,CASH_OUT,1000.0,C1094528209
5081,409000493210',2018-08-21,Indiaforensic NFS SETT 17-08-201,5900.0,0.0,3681476.700000004,2018,8,21,PAYEMENT,5900.0,C786116491
5082,409000493210',2018-08-21,Indiaforensic NFS SETT 17-08-201,2000.0,0.0,3679476.700000004,2018,8,21,CASH_OUT,2000.0,C909295153
5083,409000493210',2018-08-21,Indiaforensic NFS SETT 17-08-201,300.0,0.0,3679176.700000004,2018,8,21,CHECK_WITHDRAWAL,300.0,C2004013670
5084,409000493210',2018-08-21,Indiaforensic NFS SETT 17-08-201,100.0,0.0,3679076.700000004,2018,8,21,PAYEMENT,100.0,C836514715
5085,409000493210',2018-08-21,Indiaforensic NFS SETT 17-08-201,100.0,0.0,3678976.700000004,2018,8,21,CHECK_WITHDRAWAL,100.0,C248609774
5086,409000493210',2018-08-21,Indiaforensic NFS SETT 17-08-201,100.0,0.0,3678876.700000004,2018,8,21,CASH_OUT,100.0,C1167066016
5087,409000493210',2018-08-21,Indiaforensic NFS SETT 17-08-201,500.0,0.0,3678376.700000004,2018,8,21,CASH_OUT,500.0,C787033725
5088,409000493210',2018-08-21,Indiaforensic NFS SETT 17-08-201,1000.0,0.0,3677376.700000004,2018,8,21,CASH_OUT,1000.0,C1997859171
5089,409000493210',2018-08-21,Indiaforensic NFS SETT 17-08-201,2000.0,0.0,3675376.700000004,2018,8,21,PAYEMENT,2000.0,C1062254208
5090,409000493210',2018-08-21,Indiaforensic NFS SETT 17-08-201,500.0,0.0,3674876.700000004,2018,8,21,CASH_OUT,500.0,C1933965693
5091,409000493210',2018-08-21,Indiaforensic NFS SETT 17-08-201,100.0,0.0,3674776.700000004,2018,8,21,CHECK_WITHDRAWAL,100.0,C1234776885
5092,409000493210',2018-08-21,Indiaforensic NFS SETT 17-08-201,100.0,0.0,3674676.700000004,2018,8,21,DEBIT,100.0,M554241160
5093,409000493210',2018-08-21,Indiaforensic NFS SETT 17-08-201,200.0,0.0,3674476.700000004,2018,8,21,DEBIT,200.0,M1671973814
5094,409000493210',2018-08-21,Indiaforensic NFS SETT 17-08-201,8000.0,0.0,3666476.700000004,2018,8,21,CHECK_WITHDRAWAL,8000.0,M429462686
5095,409000493210',2018-08-21,Indiaforensic NFS SETT 17-08-201,300.0,0.0,3666176.700000004,2018,8,21,PAYEMENT,300.0,M663317819
5096,409000493210',2018-08-21,Indiaforensic NFS SETT 20-08-201,2500.0,0.0,3663676.700000004,2018,8,21,DEBIT,2500.0,M1866142672
5097,409000493210',2018-08-21,Indiaforensic NFS SETT 20-08-201,300.0,0.0,3663376.700000004,2018,8,21,CHECK_WITHDRAWAL,300.0,M1855590605
5098,409000493210',2018-08-21,Indiaforensic NFS SETT 20-08-201,100.0,0.0,3663276.700000004,2018,8,21,PAYEMENT,100.0,M1504987044
5099,409000493210',2018-08-21,Indiaforensic NFS SETT 20-08-201,300.0,0.0,3662976.700000004,2018,8,21,CHECK_WITHDRAWAL,300.0,C769342184
5100,409000493210',2018-08-21,Indiaforensic NFS SETT 20-08-201,5000.0,0.0,3657976.700000004,2018,8,21,CHECK_WITHDRAWAL,5000.0,C1538745405
5101,409000493210',2018-08-21,Indiaforensic NFS SETT 20-08-201,1000.0,0.0,3656976.700000004,2018,8,21,CHECK_WITHDRAWAL,1000.0,M1911586923
5102,409000493210',2018-08-21,Indiaforensic  RUPAY SETT 210818,6931.33,0.0,3650045.370000004,2018,8,21,DEBIT,6931.33,M1546846351
5103,409000493210',2018-08-21,Indiaforensic RUPAY STL INTC2108,0.0,51.98,3650097.350000004,2018,8,21,CASH_IN,51.98,M810646103
5104,409000493210',2018-08-21,Indiaforensic RUPAY STL INTC2108,51.98,0.0,3650045.370000004,2018,8,21,PAYEMENT,51.98,M2041386868
5105,409000493210',2018-08-23,Indiaforensic RUPAY SETT 220818,81.79,0.0,3649963.580000004,2018,8,23,CASH_OUT,81.79,M1039629818
5106,409000493210',2018-08-23,Indiaforensic RUPAY STL INTC2208,0.0,1.36,3649964.9400000037,2018,8,23,CHECK_CASHING,1.36,M1662549347
5107,409000493210',2018-08-23,Indiaforensic RUPAY STL INTC2208,0.61,0.0,3649964.330000004,2018,8,23,PAYEMENT,0.61,M441672036
5108,409000493210',2018-08-23,Indiaforensic RUPAY SETT 230818,6361.51,0.0,3643602.8200000036,2018,8,23,CHECK_WITHDRAWAL,6361.51,M914629851
5109,409000493210',2018-08-23,Indiaforensic RUPAY STL INTC2308,91.34,0.0,3643511.4800000037,2018,8,23,CHECK_WITHDRAWAL,91.34,M1163871363
5110,409000493210',2018-08-23,Indiaforensic RUPAY STL INTC2308,0.0,143.32,3643654.8000000035,2018,8,23,CASH_IN,143.32,C2083562754
5111,409000493210',2018-08-23,Indiaforensic RUPAY STL INTC2308,0.0,0.39,3643655.1900000037,2018,8,23,CASH_IN,0.39,C1839337592
5112,409000493210',2018-08-23,Indiaforensic NFS SETT 21-08-201,2000.0,0.0,3641655.1900000037,2018,8,23,PAYEMENT,2000.0,M806073091
5113,409000493210',2018-08-23,Indiaforensic NFS SETT 21-08-201,400.0,0.0,3641255.1900000037,2018,8,23,CASH_OUT,400.0,M219962610
5114,409000493210',2018-08-23,Indiaforensic NFS SETT 21-08-201,600.0,0.0,3640655.1900000037,2018,8,23,CASH_OUT,600.0,M326611360
5115,409000493210',2018-08-23,Indiaforensic NFS SETT 21-08-201,10000.0,0.0,3630655.1900000037,2018,8,23,PAYEMENT,10000.0,M668707379
5116,409000493210',2018-08-23,Indiaforensic NFS SETT 21-08-201,4000.0,0.0,3626655.1900000037,2018,8,23,CHECK_WITHDRAWAL,4000.0,M989992548
5117,409000493210',2018-08-23,Indiaforensic NFS SETT 21-08-201,2500.0,0.0,3624155.1900000037,2018,8,23,DEBIT,2500.0,M1965650910
5118,409000493210',2018-08-23,Indiaforensic NFS SETT 21-08-201,500.0,0.0,3623655.1900000037,2018,8,23,DEBIT,500.0,M2034036629
5119,409000493210',2018-08-23,Indiaforensic NFS SETT 21-08-201,800.0,0.0,3622855.1900000037,2018,8,23,PAYEMENT,800.0,M108798399
5120,409000493210',2018-08-23,Indiaforensic NFS SETT 21-08-201,200.0,0.0,3622655.1900000037,2018,8,23,CHECK_WITHDRAWAL,200.0,M2045895214
5121,409000493210',2018-08-23,Indiaforensic NFS SETT 22-08-201,2000.0,0.0,3620655.1900000037,2018,8,23,CHECK_WITHDRAWAL,2000.0,M236275784
5122,409000493210',2018-08-23,Indiaforensic NFS SETT 22-08-201,500.0,0.0,3620155.1900000037,2018,8,23,PAYEMENT,500.0,M1627160387
5123,409000493210',2018-08-23,Indiaforensic NFS SETT 22-08-201,200.0,0.0,3619955.1900000037,2018,8,23,CASH_OUT,200.0,C1807010830
5124,409000493210',2018-08-23,Indiaforensic  RUPAY SETT 230818,624.71,0.0,3619330.4800000037,2018,8,23,DEBIT,624.71,C803116137
5125,409000493210',2018-08-23,Indiaforensic RUPAY STL INTC2308,6.86,0.0,3619323.620000004,2018,8,23,CHECK_WITHDRAWAL,6.86,M2009218448
5126,409000493210',2018-08-23,Indiaforensic RUPAY STL INTC2308,0.0,6.86,3619330.4800000037,2018,8,23,CASH_IN,6.86,M1231232251
5127,409000493210',2018-08-24,Indiaforensic  RUPAY SETT 240818,7155.24,0.0,3612175.240000004,2018,8,24,DEBIT,7155.24,M1630790155
5128,409000493210',2018-08-24,Indiaforensic RUPAY STL INTC2408,0.0,54.95,3612230.1900000037,2018,8,24,TRANSFER,54.95,M1630205062
5129,409000493210',2018-08-24,Indiaforensic RUPAY STL INTC2408,54.95,0.0,3612175.240000004,2018,8,24,CHECK_WITHDRAWAL,54.95,M1138670146
5130,409000493210',2018-08-24,Indiaforensic NFS SETT 23-08-201,500.0,0.0,3611675.240000004,2018,8,24,PAYEMENT,500.0,C1438594533
5131,409000493210',2018-08-24,Indiaforensic NFS SETT 23-08-201,500.0,0.0,3611175.240000004,2018,8,24,CHECK_WITHDRAWAL,500.0,M482614135
5132,409000493210',2018-08-24,Indiaforensic NFS SETT 23-08-201,100.0,0.0,3611075.240000004,2018,8,24,CHECK_WITHDRAWAL,100.0,M1855172839
5133,409000493210',2018-08-24,Indiaforensic  RUPAY SETT 240818,0.01,0.0,3611075.2300000037,2018,8,24,CHECK_WITHDRAWAL,0.01,M1657624109
5134,409000493210',2018-08-24,Indiaforensic RUPAY STL INTC2408,0.0,1.5,3611076.7300000037,2018,8,24,TRANSFER,1.5,C456172878
5135,409000493210',2018-08-24,Indiaforensic RUPAY STL INTC2408,0.0,0.01,3611076.740000004,2018,8,24,CHECK_CASHING,0.01,M1739974163
5136,409000493210',2018-08-27,Indiaforensic RUPAY SETT 250818,314.42,0.0,3610762.3200000036,2018,8,27,DEBIT,314.42,M815125505
5137,409000493210',2018-08-27,Indiaforensic RUPAY STL INTC2508,2.23,0.0,3610760.0900000036,2018,8,27,CASH_OUT,2.23,M1752829504
5138,409000493210',2018-08-27,Indiaforensic RUPAY SETT 260818,1569.02,0.0,3609191.0700000036,2018,8,27,CASH_OUT,1569.02,M347436335
5139,409000493210',2018-08-27,Indiaforensic RUPAY STL INTC2608,12.56,0.0,3609178.510000004,2018,8,27,CHECK_WITHDRAWAL,12.56,M866416391
5140,409000493210',2018-08-27,Indiaforensic RUPAY SETT 270818,351.1,0.0,3608827.410000004,2018,8,27,PAYEMENT,351.1,M1913266128
5141,409000493210',2018-08-27,Indiaforensic RUPAY STL INTC2708,2.45,0.0,3608824.9600000037,2018,8,27,CHECK_WITHDRAWAL,2.45,M1253827612
5142,409000493210',2018-08-27,Indiaforensic RUPAY STL INTC2508,0.0,2.23,3608827.1900000037,2018,8,27,CASH_IN,2.23,M1836786457
5143,409000493210',2018-08-27,Indiaforensic RUPAY STL INTC2608,0.0,12.56,3608839.7500000037,2018,8,27,CHECK_CASHING,12.56,M524671817
5144,409000493210',2018-08-27,Indiaforensic RUPAY STL INTC2708,0.0,54.34,3608894.0900000036,2018,8,27,CASH_IN,54.34,M244788961
5145,409000493210',2018-08-27,Indiaforensic RUPAY STL INTC2708,0.0,0.39,3608894.4800000037,2018,8,27,CHECK_CASHING,0.39,M1862946352
5146,409000493210',2018-08-27,Indiaforensic  RUPAY SETT 270818,670.71,0.0,3608223.7700000037,2018,8,27,CHECK_WITHDRAWAL,670.71,M1739111611
5147,409000493210',2018-08-27,Indiaforensic RUPAY STL INTC2708,0.0,10.72,3608234.490000004,2018,8,27,TRANSFER,10.72,M654299840
5148,409000493210',2018-08-27,Indiaforensic RUPAY STL INTC2708,10.72,0.0,3608223.7700000037,2018,8,27,PAYEMENT,10.72,C728885526
5149,409000493210',2018-08-27,Indiaforensic NFS SETT 24-08-201,10000.0,0.0,3598223.7700000037,2018,8,27,DEBIT,10000.0,M2139900147
5150,409000493210',2018-08-27,Indiaforensic NFS SETT 24-08-201,2000.0,0.0,3596223.7700000037,2018,8,27,DEBIT,2000.0,M1825485441
5151,409000493210',2018-08-27,Indiaforensic NFS SETT 24-08-201,100.0,0.0,3596123.7700000037,2018,8,27,PAYEMENT,100.0,M1637627206
5152,409000493210',2018-08-27,Indiaforensic NFS SETT 24-08-201,1000.0,0.0,3595123.7700000037,2018,8,27,CASH_OUT,1000.0,M818609427
5153,409000493210',2018-08-27,Indiaforensic NFS SETT 24-08-201,900.0,0.0,3594223.7700000037,2018,8,27,CASH_OUT,900.0,M496259008
5154,409000493210',2018-08-27,Indiaforensic NFS SETT 24-08-201,2000.0,0.0,3592223.7700000037,2018,8,27,PAYEMENT,2000.0,M460922314
5155,409000493210',2018-08-27,Indiaforensic NFS SETT 24-08-201,300.0,0.0,3591923.7700000037,2018,8,27,PAYEMENT,300.0,M721004015
5156,409000493210',2018-08-27,Indiaforensic NFS SETT 25-08-201,3500.0,0.0,3588423.7700000037,2018,8,27,PAYEMENT,3500.0,M1731654671
5157,409000493210',2018-08-27,Indiaforensic NFS SETT 25-08-201,1000.0,0.0,3587423.7700000037,2018,8,27,PAYEMENT,1000.0,M1967710715
5158,409000493210',2018-08-27,Indiaforensic NFS SETT 25-08-201,400.0,0.0,3587023.7700000037,2018,8,27,DEBIT,400.0,M10044740
5159,409000493210',2018-08-27,Indiaforensic NFS SETT 25-08-201,6000.0,0.0,3581023.7700000037,2018,8,27,PAYEMENT,6000.0,M1863075316
5160,409000493210',2018-08-27,Indiaforensic NFS SETT 25-08-201,6500.0,0.0,3574523.7700000037,2018,8,27,DEBIT,6500.0,C1446521801
5161,409000493210',2018-08-27,Indiaforensic NFS SETT 25-08-201,2000.0,0.0,3572523.7700000037,2018,8,27,CHECK_WITHDRAWAL,2000.0,C1183572822
5162,409000493210',2018-08-27,Indiaforensic NFS SETT 25-08-201,300.0,0.0,3572223.7700000037,2018,8,27,DEBIT,300.0,C1262822392
5163,409000493210',2018-08-27,Indiaforensic NFS SETT 26-08-201,500.0,0.0,3571723.7700000037,2018,8,27,DEBIT,500.0,C766681183
5164,409000493210',2018-08-27,Indiaforensic NFS SETT 26-08-201,100.0,0.0,3571623.7700000037,2018,8,27,DEBIT,100.0,C662736689
5165,409000493210',2018-08-27,Indiaforensic NFS SETT 26-08-201,200.0,0.0,3571423.7700000037,2018,8,27,PAYEMENT,200.0,C766681183
5166,409000493210',2018-08-27,Indiaforensic NFS SETT 26-08-201,3000.0,0.0,3568423.7700000037,2018,8,27,PAYEMENT,3000.0,C97730845
5167,409000493210',2018-08-28,Indiaforensic  RUPAY SETT 280818,7216.25,0.0,3561207.5200000037,2018,8,28,DEBIT,7216.25,C1883840933
5168,409000493210',2018-08-28,Indiaforensic RUPAY STL INTC2808,0.0,64.76,3561272.2800000035,2018,8,28,TRANSFER,64.76,C1303868418
5169,409000493210',2018-08-28,Indiaforensic RUPAY STL INTC2808,64.76,0.0,3561207.5200000037,2018,8,28,CHECK_WITHDRAWAL,64.76,M679681385
5170,409000493210',2018-08-28,Indiaforensic  RUPAY SETT 280818,500.71,0.0,3560706.810000004,2018,8,28,DEBIT,500.71,M1491089257
5171,409000493210',2018-08-28,Indiaforensic RUPAY STL INTC2808,0.0,8.0,3560714.810000004,2018,8,28,TRANSFER,8.0,M1783737980
5172,409000493210',2018-08-28,Indiaforensic RUPAY STL INTC2808,8.0,0.0,3560706.810000004,2018,8,28,DEBIT,8.0,M1483972190
5173,409000493210',2018-08-28,Indiaforensic NFS SETT 27-08-201,500.0,0.0,3560206.810000004,2018,8,28,CASH_OUT,500.0,M694790566
5174,409000493210',2018-08-28,Indiaforensic NFS SETT 27-08-201,2000.0,0.0,3558206.810000004,2018,8,28,CHECK_WITHDRAWAL,2000.0,M1635975151
5175,409000493210',2018-08-28,Indiaforensic NFS SETT 27-08-201,500.0,0.0,3557706.810000004,2018,8,28,PAYEMENT,500.0,M757386713
5176,409000493210',2018-08-28,Indiaforensic NFS SETT 27-08-201,900.0,0.0,3556806.810000004,2018,8,28,CHECK_WITHDRAWAL,900.0,M1180105925
5177,409000493210',2018-08-28,Indiaforensic NFS SETT 27-08-201,400.0,0.0,3556406.810000004,2018,8,28,CHECK_WITHDRAWAL,400.0,M668417314
5178,409000493210',2018-08-28,Indiaforensic NFS SETT 27-08-201,3000.0,0.0,3553406.810000004,2018,8,28,CHECK_WITHDRAWAL,3000.0,M236333621
5179,409000493210',2018-08-28,Indiaforensic NFS SETT 27-08-201,1200.0,0.0,3552206.810000004,2018,8,28,CASH_OUT,1200.0,C740950652
5180,409000493210',2018-08-28,Indiaforensic NFS SETT 27-08-201,500.0,0.0,3551706.810000004,2018,8,28,CHECK_WITHDRAWAL,500.0,M1251502504
5181,409000493210',2018-08-28,Indiaforensic NFS SETT 27-08-201,200.0,0.0,3551506.810000004,2018,8,28,CHECK_WITHDRAWAL,200.0,M1090123277
5182,409000493210',2018-08-28,Indiaforensic NFS SETT 27-08-201,1000.0,0.0,3550506.810000004,2018,8,28,CASH_OUT,1000.0,M1653318246
5183,409000493210',2018-08-28,Indiaforensic NFS SETT 27-08-201,600.0,0.0,3549906.810000004,2018,8,28,DEBIT,600.0,M494367851
5184,409000493210',2018-08-28,Indiaforensic NFS SETT 27-08-201,600.0,0.0,3549306.810000004,2018,8,28,CHECK_WITHDRAWAL,600.0,M1934234778
5185,409000493210',2018-08-28,Indiaforensic NFS SETT 27-08-201,2000.0,0.0,3547306.810000004,2018,8,28,CASH_OUT,2000.0,C1382717704
5186,409000493210',2018-08-28,Indiaforensic NFS SETT 27-08-201,800.0,0.0,3546506.810000004,2018,8,28,PAYEMENT,800.0,M1861043945
5187,409000493210',2018-08-28,Indiaforensic NFS SETT 27-08-201,500.0,0.0,3546006.810000004,2018,8,28,DEBIT,500.0,M1792454213
5188,409000493210',2018-08-28,Indiaforensic NFS SETT 27-08-201,100.0,0.0,3545906.810000004,2018,8,28,CASH_OUT,100.0,M2022950677
5189,409000493210',2018-08-28,Indiaforensic NFS SETT 27-08-201,100.0,0.0,3545806.810000004,2018,8,28,CASH_OUT,100.0,M1762522689
5190,409000493210',2018-08-28,Indiaforensic NFS SETT 27-08-201,100.0,0.0,3545706.810000004,2018,8,28,CHECK_WITHDRAWAL,100.0,M469391891
5191,409000493210',2018-08-28,Indiaforensic NFS SETT 27-08-201,900.0,0.0,3544806.810000004,2018,8,28,CHECK_WITHDRAWAL,900.0,M497507806
5192,409000493210',2018-08-28,Indiaforensic NFS SETT 27-08-201,900.0,0.0,3543906.810000004,2018,8,28,CASH_OUT,900.0,M356318598
5193,409000493210',2018-08-28,Indiaforensic NFS SETT 27-08-201,1500.0,0.0,3542406.810000004,2018,8,28,DEBIT,1500.0,M1499458969
5194,409000493210',2018-08-28,Indiaforensic NFS SETT 27-08-201,500.0,0.0,3541906.810000004,2018,8,28,CHECK_WITHDRAWAL,500.0,M267400033
5195,409000493210',2018-08-28,Indiaforensic NFS SETT 27-08-201,500.0,0.0,3541406.810000004,2018,8,28,DEBIT,500.0,M1603493193
5196,409000493210',2018-08-28,Indiaforensic NFS SETT 27-08-201,1000.0,0.0,3540406.810000004,2018,8,28,DEBIT,1000.0,M1036283684
5197,409000493210',2018-08-29,Indiaforensic  RUPAY SETT 290818,7143.73,0.0,3533263.080000004,2018,8,29,CASH_OUT,7143.73,C510113906
5198,409000493210',2018-08-29,Indiaforensic RUPAY STL INTC2908,0.0,57.71,3533320.7900000038,2018,8,29,TRANSFER,57.71,M163631293
5199,409000493210',2018-08-29,Indiaforensic RUPAY STL INTC2908,57.71,0.0,3533263.080000004,2018,8,29,CHECK_WITHDRAWAL,57.71,M417773355
5200,409000493210',2018-08-29,TRF FROM  Indiaforensic SERVICES,0.0,60000.0,3593263.080000004,2018,8,29,TRANSFER,60000.0,M1051155205
5201,409000493210',2018-08-29,Indiaforensic  RUPAY SETT 290818,0.0,0.83,3593263.910000004,2018,8,29,TRANSFER,0.83,M497501602
5202,409000493210',2018-08-29,Indiaforensic NFS SETT 28-08-201,1000.0,0.0,3592263.910000004,2018,8,29,PAYEMENT,1000.0,M1106043431
5203,409000493210',2018-08-29,Indiaforensic NFS SETT 28-08-201,1000.0,0.0,3591263.910000004,2018,8,29,CHECK_WITHDRAWAL,1000.0,M2031154005
5204,409000493210',2018-08-29,Indiaforensic NFS SETT 28-08-201,500.0,0.0,3590763.910000004,2018,8,29,DEBIT,500.0,M630298110
5205,409000493210',2018-08-29,Indiaforensic NFS SETT 28-08-201,100.0,0.0,3590663.910000004,2018,8,29,CASH_OUT,100.0,M1825856364
5206,409000493210',2018-08-29,Indiaforensic NFS SETT 28-08-201,200.0,0.0,3590463.910000004,2018,8,29,CASH_OUT,200.0,M332149166
5207,409000493210',2018-08-29,Indiaforensic NFS SETT 28-08-201,1000.0,0.0,3589463.910000004,2018,8,29,PAYEMENT,1000.0,M1274699449
5208,409000493210',2018-08-29,Indiaforensic NFS SETT 28-08-201,300.0,0.0,3589163.910000004,2018,8,29,CASH_OUT,300.0,M1477996447
5209,409000493210',2018-08-29,Indiaforensic NFS SETT 28-08-201,300.0,0.0,3588863.910000004,2018,8,29,PAYEMENT,300.0,M523839133
5210,409000493210',2018-08-29,Indiaforensic NFS SETT 28-08-201,300.0,0.0,3588563.910000004,2018,8,29,PAYEMENT,300.0,M1968038739
5211,409000493210',2018-08-29,Indiaforensic NFS SETT 28-08-201,600.0,0.0,3587963.910000004,2018,8,29,PAYEMENT,600.0,M1488550933
5212,409000493210',2018-08-29,Indiaforensic NFS SETT 28-08-201,200.0,0.0,3587763.910000004,2018,8,29,DEBIT,200.0,M1020552337
5213,409000493210',2018-08-29,Indiaforensic NFS SETT 28-08-201,300.0,0.0,3587463.910000004,2018,8,29,PAYEMENT,300.0,M882053845
5214,409000493210',2018-08-29,Indiaforensic NFS SETT 28-08-201,800.0,0.0,3586663.910000004,2018,8,29,PAYEMENT,800.0,M1206580572
5215,409000493210',2018-08-29,Indiaforensic NFS SETT 28-08-201,5000.0,0.0,3581663.910000004,2018,8,29,DEBIT,5000.0,M3027538
5216,409000493210',2018-08-30,Indiaforensic  RUPAY SETT 300818,7345.67,0.0,3574318.240000004,2018,8,30,PAYEMENT,7345.67,M1729992636
5217,409000493210',2018-08-30,Indiaforensic RUPAY STL INTC3008,0.0,302.74,3574620.9800000037,2018,8,30,CASH_IN,302.74,M100805003
5218,409000493210',2018-08-30,Indiaforensic RUPAY STL INTC3008,80.74,0.0,3574540.240000004,2018,8,30,DEBIT,80.74,M345865414
5219,409000493210',2018-08-30,Indiaforensic RUPAY STL INTC3008,0.0,3.55,3574543.7900000038,2018,8,30,CHECK_CASHING,3.55,M222947526
5220,409000493210',2018-08-30,Indiaforensic  RUPAY SETT 300818,326.06,0.0,3574217.7300000037,2018,8,30,CASH_OUT,326.06,M1486277532
5221,409000493210',2018-08-30,Indiaforensic RUPAY STL INTC3008,0.0,48.28,3574266.010000004,2018,8,30,TRANSFER,48.28,M108271693
5222,409000493210',2018-08-30,Indiaforensic RUPAY STL INTC3008,1.63,0.0,3574264.3800000036,2018,8,30,PAYEMENT,1.63,M1479926346
5223,409000493210',2018-08-30,Indiaforensic RUPAY STL INTC3008,0.0,0.35,3574264.7300000037,2018,8,30,CHECK_CASHING,0.35,M1957188885
5224,409000493210',2018-08-30,Indiaforensic NFS SETT 29-08-201,500.0,0.0,3573764.7300000037,2018,8,30,CASH_OUT,500.0,M1040093935
5225,409000493210',2018-08-30,Indiaforensic NFS SETT 29-08-201,100.0,0.0,3573664.7300000037,2018,8,30,DEBIT,100.0,M489549653
5226,409000493210',2018-08-30,Indiaforensic NFS SETT 29-08-201,1000.0,0.0,3572664.7300000037,2018,8,30,CASH_OUT,1000.0,M1860905408
5227,409000493210',2018-08-30,Indiaforensic NFS SETT 29-08-201,500.0,0.0,3572164.7300000037,2018,8,30,DEBIT,500.0,M1872258305
5228,409000493210',2018-08-30,Indiaforensic NFS SETT 29-08-201,500.0,0.0,3571664.7300000037,2018,8,30,PAYEMENT,500.0,M583668290
5229,409000493210',2018-08-30,Indiaforensic NFS SETT 29-08-201,500.0,0.0,3571164.7300000037,2018,8,30,DEBIT,500.0,M2015924099
5230,409000493210',2018-08-30,Indiaforensic NFS SETT 29-08-201,300.0,0.0,3570864.7300000037,2018,8,30,CASH_OUT,300.0,M1542155234
5231,409000493210',2018-08-30,Indiaforensic NFS SETT 29-08-201,300.0,0.0,3570564.7300000037,2018,8,30,PAYEMENT,300.0,M293786079
5232,409000493210',2018-08-30,Indiaforensic NFS SETT 29-08-201,10000.0,0.0,3560564.7300000037,2018,8,30,PAYEMENT,10000.0,M838015776
5233,409000493210',2018-08-30,Indiaforensic NFS SETT 29-08-201,3000.0,0.0,3557564.7300000037,2018,8,30,CHECK_WITHDRAWAL,3000.0,M1263814450
5234,409000493210',2018-08-30,Indiaforensic NFS SETT 29-08-201,8000.0,0.0,3549564.7300000037,2018,8,30,CASH_OUT,8000.0,M1837858473
5235,409000493210',2018-08-30,Indiaforensic NFS SETT 29-08-201,500.0,0.0,3549064.7300000037,2018,8,30,PAYEMENT,500.0,M859653366
5236,409000493210',2018-08-30,Indiaforensic NFS SETT 29-08-201,200.0,0.0,3548864.7300000037,2018,8,30,CASH_OUT,200.0,M63169379
5237,409000493210',2018-08-30,Indiaforensic NFS SETT 29-08-201,5000.0,0.0,3543864.7300000037,2018,8,30,CASH_OUT,5000.0,C254784037
5238,409000493210',2018-08-30,Indiaforensic NFS SETT 29-08-201,400.0,0.0,3543464.7300000037,2018,8,30,PAYEMENT,400.0,M663741480
5239,409000493210',2018-08-30,Indiaforensic NFS SETT 29-08-201,1000.0,0.0,3542464.7300000037,2018,8,30,CASH_OUT,1000.0,M1920199
5240,409000493210',2018-08-31,Indiaforensic  RUPAY SETT 310818,208.84,0.0,3542255.890000004,2018,8,31,DEBIT,208.84,M626972900
5241,409000493210',2018-08-31,Indiaforensic RUPAY STL INTC3108,0.0,2.24,3542258.1300000036,2018,8,31,TRANSFER,2.24,M712753515
5242,409000493210',2018-08-31,Indiaforensic RUPAY STL INTC3108,2.24,0.0,3542255.890000004,2018,8,31,PAYEMENT,2.24,M1120687200
5243,409000493210',2018-08-31,Indiaforensic  RUPAY SETT 310818,500.71,0.0,3541755.180000004,2018,8,31,CHECK_WITHDRAWAL,500.71,M545394160
5244,409000493210',2018-08-31,Indiaforensic RUPAY STL INTC3108,0.0,8.0,3541763.180000004,2018,8,31,CASH_IN,8.0,M542202332
5245,409000493210',2018-08-31,Indiaforensic RUPAY STL INTC3108,8.0,0.0,3541755.180000004,2018,8,31,DEBIT,8.0,M1931327807
5246,409000493210',2018-08-31,Indiaforensic NFS SETT 30-08-201,1000.0,0.0,3540755.180000004,2018,8,31,CHECK_WITHDRAWAL,1000.0,M718451316
5247,409000493210',2018-08-31,Indiaforensic NFS SETT 30-08-201,5000.0,0.0,3535755.180000004,2018,8,31,DEBIT,5000.0,M1897195392
5248,409000493210',2018-08-31,Indiaforensic NFS SETT 30-08-201,5000.0,0.0,3530755.180000004,2018,8,31,CASH_OUT,5000.0,C1458849419
5249,409000493210',2018-08-31,Indiaforensic NFS SETT 30-08-201,10000.0,0.0,3520755.180000004,2018,8,31,CHECK_WITHDRAWAL,10000.0,M1856759576
5250,409000493210',2018-08-31,Indiaforensic NFS SETT 30-08-201,1500.0,0.0,3519255.180000004,2018,8,31,PAYEMENT,1500.0,M261849385
5251,409000493210',2018-08-31,Indiaforensic NFS SETT 30-08-201,1500.0,0.0,3517755.180000004,2018,8,31,PAYEMENT,1500.0,M1150464915
5252,409000493210',2018-08-31,Indiaforensic NFS SETT 30-08-201,500.0,0.0,3517255.180000004,2018,8,31,CASH_OUT,500.0,M104494977
5253,409000493210',2018-08-31,Indiaforensic NFS SETT 30-08-201,500.0,0.0,3516755.180000004,2018,8,31,DEBIT,500.0,C423583818
5254,409000493210',2018-08-31,Indiaforensic NFS SETT 30-08-201,8700.0,0.0,3508055.180000004,2018,8,31,CASH_OUT,8700.0,M774501006
5255,409000493210',2018-09-01,Indiaforensic  RUPAY SETT 010918,441.32,0.0,3507613.8600000036,2018,9,1,PAYEMENT,441.32,M850683953
5256,409000493210',2018-09-01,Indiaforensic  RUPAY SETT 010918,0.0,6.84,3507620.700000004,2018,9,1,CHECK_CASHING,6.84,M839907439
5257,409000493210',2018-09-01,Indiaforensic RUPAY STL INTC0109,6.84,0.0,3507613.8600000036,2018,9,1,CASH_OUT,6.84,M139416025
5258,409000493210',2018-09-01,Indiaforensic NFS SETT 31-08-201,400.0,0.0,3507213.8600000036,2018,9,1,CHECK_WITHDRAWAL,400.0,M137902612
5259,409000493210',2018-09-01,Indiaforensic NFS SETT 31-08-201,8000.0,0.0,3499213.8600000036,2018,9,1,DEBIT,8000.0,M962221884
5260,409000493210',2018-09-01,Indiaforensic NFS SETT 31-08-201,200.0,0.0,3499013.8600000036,2018,9,1,CASH_OUT,200.0,M2118050088
5261,409000493210',2018-09-01,Indiaforensic NFS SETT 31-08-201,1000.0,0.0,3498013.8600000036,2018,9,1,DEBIT,1000.0,M376234567
5262,409000493210',2018-09-01,Indiaforensic NFS SETT 31-08-201,800.0,0.0,3497213.8600000036,2018,9,1,PAYEMENT,800.0,C1922859107
5263,409000493210',2018-09-01,Indiaforensic NFS SETT 31-08-201,500.0,0.0,3496713.8600000036,2018,9,1,PAYEMENT,500.0,M215738773
5264,409000493210',2018-09-01,Indiaforensic NFS SETT 31-08-201,2000.0,0.0,3494713.8600000036,2018,9,1,DEBIT,2000.0,M927690291
5265,409000493210',2018-09-01,Indiaforensic NFS SETT 31-08-201,100.0,0.0,3494613.8600000036,2018,9,1,CASH_OUT,100.0,C2083562754
5266,409000493210',2018-09-01,Indiaforensic  RUPAY SETT 010918,1148.42,0.0,3493465.4400000037,2018,9,1,CASH_OUT,1148.42,C860798122
5267,409000493210',2018-09-01,Indiaforensic  RUPAY SETT 010918,0.0,14.92,3493480.3600000036,2018,9,1,CHECK_CASHING,14.92,M1610818058
5268,409000493210',2018-09-01,Indiaforensic RUPAY STL INTC0109,14.92,0.0,3493465.4400000037,2018,9,1,CASH_OUT,14.92,M361021465
5269,409000493210',2018-09-03,Indiaforensic RUPAY SETT 020918,10992.12,0.0,3482473.3200000036,2018,9,3,CHECK_WITHDRAWAL,10992.12,M1340267778
5270,409000493210',2018-09-03,Indiaforensic RUPAY SETT 020918,0.0,174.74,3482648.060000004,2018,9,3,CHECK_CASHING,174.74,M1477964234
5271,409000493210',2018-09-03,Indiaforensic RUPAY STL INTC0209,174.74,0.0,3482473.3200000036,2018,9,3,CHECK_WITHDRAWAL,174.74,C1587143371
5272,409000493210',2018-09-03,Indiaforensic RUPAY SETT 030918,7593.26,0.0,3474880.060000004,2018,9,3,DEBIT,7593.26,M438772947
5273,409000493210',2018-09-03,Indiaforensic RUPAY SETT 030918,0.0,56.51,3474936.5700000036,2018,9,3,CASH_IN,56.51,C476402209
5274,409000493210',2018-09-03,Indiaforensic RUPAY STL INTC0309,54.17,0.0,3474882.4000000036,2018,9,3,CASH_OUT,54.17,M987252728
5275,409000493210',2018-09-03,Indiaforensic RUPAY STL INTC0309,0.0,0.01,3474882.410000004,2018,9,3,CASH_IN,0.01,M745089008
5276,409000493210',2018-09-03,Indiaforensic  RUPAY SETT 030918,8000.71,0.0,3466881.700000004,2018,9,3,PAYEMENT,8000.71,M644718663
5277,409000493210',2018-09-03,Indiaforensic  RUPAY SETT 030918,0.0,88.0,3466969.700000004,2018,9,3,TRANSFER,88.0,M226771338
5278,409000493210',2018-09-03,Indiaforensic RUPAY STL INTC0309,88.0,0.0,3466881.700000004,2018,9,3,PAYEMENT,88.0,M247855428
5279,409000493210',2018-09-03,Indiaforensic NFS SETT 01-09-201,200.0,0.0,3466681.700000004,2018,9,3,DEBIT,200.0,C1711105800
5280,409000493210',2018-09-03,Indiaforensic NFS SETT 01-09-201,1000.0,0.0,3465681.700000004,2018,9,3,PAYEMENT,1000.0,C476402209
5281,409000493210',2018-09-03,Indiaforensic NFS SETT 01-09-201,500.0,0.0,3465181.700000004,2018,9,3,CASH_OUT,500.0,M417167207
5282,409000493210',2018-09-03,Indiaforensic NFS SETT 02-09-201,200.0,0.0,3464981.700000004,2018,9,3,CHECK_WITHDRAWAL,200.0,M201213864
5283,409000493210',2018-09-03,Indiaforensic NFS SETT 02-09-201,2000.0,0.0,3462981.700000004,2018,9,3,CASH_OUT,2000.0,M1552595422
5284,409000493210',2018-09-03,Indiaforensic NFS SETT 02-09-201,500.0,0.0,3462481.700000004,2018,9,3,DEBIT,500.0,M779857934
5285,409000493210',2018-09-03,Indiaforensic NFS SETT 02-09-201,1000.0,0.0,3461481.700000004,2018,9,3,PAYEMENT,1000.0,M1959931357
5286,409000493210',2018-09-03,Indiaforensic NFS SETT 02-09-201,400.0,0.0,3461081.700000004,2018,9,3,CHECK_WITHDRAWAL,400.0,M1530206433
5287,409000493210',2018-09-03,Indiaforensic NFS SETT 02-09-201,1000.0,0.0,3460081.700000004,2018,9,3,PAYEMENT,1000.0,M982054651
5288,409000493210',2018-09-03,Indiaforensic NFS SETT 02-09-201,1000.0,0.0,3459081.700000004,2018,9,3,CASH_OUT,1000.0,C187019413
5289,409000493210',2018-09-03,Indiaforensic NFS SETT 02-09-201,300.0,0.0,3458781.700000004,2018,9,3,PAYEMENT,300.0,M1533434416
5290,409000493210',2018-09-03,Indiaforensic NFS SETT 02-09-201,200.0,0.0,3458581.700000004,2018,9,3,CASH_OUT,200.0,M1978496274
5291,409000493210',2018-09-04,Indiaforensic  RUPAY SETT 040918,783.13,0.0,3457798.5700000036,2018,9,4,DEBIT,783.13,M871097584
5292,409000493210',2018-09-04,Indiaforensic  RUPAY SETT 040918,0.0,11.52,3457810.0900000036,2018,9,4,CHECK_CASHING,11.52,M689208338
5293,409000493210',2018-09-04,Indiaforensic RUPAY STL INTC0409,9.0,0.0,3457801.0900000036,2018,9,4,CHECK_WITHDRAWAL,9.0,M870649842
5294,409000493210',2018-09-04,Indiaforensic RUPAY STL INTC0409,0.0,0.01,3457801.100000004,2018,9,4,TRANSFER,0.01,M1884109568
5295,409000493210',2018-09-04,Indiaforensic  RUPAY SETT 040918,9391.73,0.0,3448409.370000004,2018,9,4,CASH_OUT,9391.73,M421481829
5296,409000493210',2018-09-04,Indiaforensic  RUPAY SETT 040918,0.0,68.56,3448477.930000004,2018,9,4,CASH_IN,68.56,M1663485420
5297,409000493210',2018-09-04,Indiaforensic RUPAY STL INTC0409,68.56,0.0,3448409.370000004,2018,9,4,CASH_OUT,68.56,M1889371810
5298,409000493210',2018-09-04,Indiaforensic NFS SETT 03-09-201,1000.0,0.0,3447409.370000004,2018,9,4,PAYEMENT,1000.0,M216421817
5299,409000493210',2018-09-04,Indiaforensic NFS SETT 03-09-201,500.0,0.0,3446909.370000004,2018,9,4,DEBIT,500.0,M1462880943
5300,409000493210',2018-09-05,Indiaforensic  RUPAY SETT 050918,646.3,0.0,3446263.0700000036,2018,9,5,CASH_OUT,646.3,M1743186770
5301,409000493210',2018-09-05,Indiaforensic  RUPAY SETT 050918,0.0,6.76,3446269.830000004,2018,9,5,CASH_IN,6.76,M1523941008
5302,409000493210',2018-09-05,Indiaforensic RUPAY STL INTC0509,6.01,0.0,3446263.8200000036,2018,9,5,PAYEMENT,6.01,M1255708407
5303,409000493210',2018-09-05,Indiaforensic  RUPAY SETT 050918,0.48,0.0,3446263.3400000036,2018,9,5,CASH_OUT,0.48,C453211571
5304,409000493210',2018-09-05,Indiaforensic  RUPAY SETT 050918,0.0,64.12,3446327.4600000037,2018,9,5,CASH_IN,64.12,C1235151206
5305,409000493210',2018-09-05,Indiaforensic RUPAY STL INTC0509,0.0,0.48,3446327.9400000037,2018,9,5,CHECK_CASHING,0.48,M1268261468
5306,409000493210',2018-09-05,Indiaforensic NFS SETT 04-09-201,500.0,0.0,3445827.9400000037,2018,9,5,DEBIT,500.0,M1011387188
5307,409000493210',2018-09-05,Indiaforensic NFS SETT 04-09-201,1500.0,0.0,3444327.9400000037,2018,9,5,CHECK_WITHDRAWAL,1500.0,M946260334
5308,409000493210',2018-09-05,Indiaforensic NFS SETT 04-09-201,1900.0,0.0,3442427.9400000037,2018,9,5,DEBIT,1900.0,M1551301860
5309,409000493210',2018-09-05,Indiaforensic NFS SETT 04-09-201,200.0,0.0,3442227.9400000037,2018,9,5,PAYEMENT,200.0,M1409864883
5310,409000493210',2018-09-05,Indiaforensic NFS SETT 04-09-201,200.0,0.0,3442027.9400000037,2018,9,5,CASH_OUT,200.0,M1705282731
5311,409000493210',2018-09-05,Indiaforensic NFS SETT 04-09-201,1500.0,0.0,3440527.9400000037,2018,9,5,PAYEMENT,1500.0,C977993101
5312,409000493210',2018-09-06,Indiaforensic NFS SETT 05-09-201,6000.0,0.0,3434527.9400000037,2018,9,6,PAYEMENT,6000.0,M265096845
5313,409000493210',2018-09-06,Indiaforensic  RUPAY SETT 060918,5152.53,0.0,3429375.4100000043,2018,9,6,DEBIT,5152.53,M440435702
5314,409000493210',2018-09-06,Indiaforensic RUPAY STL INTC0609,79.27,0.0,3429296.1400000043,2018,9,6,CASH_OUT,79.27,M1152113439
5315,409000493210',2018-09-06,Indiaforensic  RUPAY SETT 060918,0.0,80.77,3429376.9100000043,2018,9,6,TRANSFER,80.77,M2094132308
5316,409000493210',2018-09-06,Indiaforensic RUPAY STL INTC0609,0.0,0.01,3429376.9200000037,2018,9,6,TRANSFER,0.01,M1833045213
5317,409000493210',2018-09-06,TRF FRM  Indiaforensic SERVICES,0.0,2000000.0,5429376.920000004,2018,9,6,CASH_IN,2000000.0,M2014481872
5318,409000493210',2018-09-06,TRF FROM  Indiaforensic SERVICES,0.0,283000.0,5712376.920000004,2018,9,6,CASH_IN,283000.0,C380242442
5319,409000493210',2018-09-06,Indiaforensic  RUPAY SETT 060918,115.71,0.0,5712261.210000004,2018,9,6,CHECK_WITHDRAWAL,115.71,C1922859107
5320,409000493210',2018-09-06,Indiaforensic  RUPAY SETT 060918,0.0,0.58,5712261.790000004,2018,9,6,TRANSFER,0.58,M1553616699
5321,409000493210',2018-09-06,Indiaforensic RUPAY STL INTC0609,0.58,0.0,5712261.210000004,2018,9,6,CASH_OUT,0.58,M1864683077
5322,409000493210',2018-09-07,Indiaforensic  RUPAY SETT 070918,7607.12,0.0,5704654.090000004,2018,9,7,CHECK_WITHDRAWAL,7607.12,C787033725
5323,409000493210',2018-09-07,Indiaforensic  RUPAY SETT 070918,0.0,84.16,5704738.250000004,2018,9,7,TRANSFER,84.16,M753570330
5324,409000493210',2018-09-07,Indiaforensic RUPAY STL INTC0709,84.16,0.0,5704654.090000004,2018,9,7,PAYEMENT,84.16,M734097378
5325,409000493210',2018-09-07,Indiaforensic NFS SETT 06-09-201,200.0,0.0,5704454.090000004,2018,9,7,CASH_OUT,200.0,C191614132
5326,409000493210',2018-09-07,Indiaforensic NFS SETT 06-09-201,200.0,0.0,5704254.090000004,2018,9,7,PAYEMENT,200.0,C153950082
5327,409000493210',2018-09-07,Indiaforensic NFS SETT 06-09-201,100.0,0.0,5704154.090000004,2018,9,7,PAYEMENT,100.0,M340418158
5328,409000493210',2018-09-07,Indiaforensic  RUPAY SETT 070918,10441.12,0.0,5693712.9700000025,2018,9,7,CASH_OUT,10441.12,M2112036973
5329,409000493210',2018-09-07,Indiaforensic  RUPAY SETT 070918,0.0,166.13,5693879.100000002,2018,9,7,TRANSFER,166.13,M731081476
5330,409000493210',2018-09-07,Indiaforensic RUPAY STL INTC0709,166.13,0.0,5693712.9700000025,2018,9,7,DEBIT,166.13,M1446362322
5331,409000493210',2018-09-10,Indiaforensic RUPAY SETT 080918,35636.21,0.0,5658076.7600000035,2018,9,10,CASH_OUT,35636.21,C660143728
5332,409000493210',2018-09-10,Indiaforensic RUPAY SETT 080918,0.0,630.19,5658706.950000004,2018,9,10,CHECK_CASHING,630.19,M1455019071
5333,409000493210',2018-09-10,Indiaforensic RUPAY STL INTC0809,556.53,0.0,5658150.420000004,2018,9,10,DEBIT,556.53,C757257137
5334,409000493210',2018-09-10,Indiaforensic RUPAY STL INTC0809,0.0,0.54,5658150.960000004,2018,9,10,CHECK_CASHING,0.54,M1096296601
5335,409000493210',2018-09-10,Indiaforensic RUPAY SETT 090918,15667.91,0.0,5642483.050000004,2018,9,10,PAYEMENT,15667.91,M2112194333
5336,409000493210',2018-09-10,Indiaforensic RUPAY SETT 090918,0.0,207.98,5642691.030000004,2018,9,10,TRANSFER,207.98,M1229511404
5337,409000493210',2018-09-10,Indiaforensic RUPAY STL INTC0909,207.98,0.0,5642483.050000004,2018,9,10,CHECK_WITHDRAWAL,207.98,M18913807
5338,409000493210',2018-09-10,Indiaforensic RUPAY SETT 100918,14530.5,0.0,5627952.550000004,2018,9,10,PAYEMENT,14530.5,M1718705321
5339,409000493210',2018-09-10,Indiaforensic RUPAY SETT 100918,0.0,355.67,5628308.220000003,2018,9,10,CHECK_CASHING,355.67,M1376425471
5340,409000493210',2018-09-10,Indiaforensic RUPAY STL INTC1009,143.81,0.0,5628164.410000004,2018,9,10,CASH_OUT,143.81,M1549218345
5341,409000493210',2018-09-10,Indiaforensic RUPAY STL INTC1009,0.0,3.38,5628167.790000004,2018,9,10,CASH_IN,3.38,C1899073220
5342,409000493210',2018-09-10,Indiaforensic  RUPAY SETT 100918,657.87,0.0,5627509.920000004,2018,9,10,DEBIT,657.87,M1007264592
5343,409000493210',2018-09-10,Indiaforensic RUPAY STL INTC1009,10.1,0.0,5627499.820000004,2018,9,10,PAYEMENT,10.1,C660143728
5344,409000493210',2018-09-10,Indiaforensic  RUPAY SETT 100918,0.0,12.73,5627512.550000005,2018,9,10,TRANSFER,12.73,M1101149296
5345,409000493210',2018-09-10,Indiaforensic RUPAY STL INTC1009,0.0,0.01,5627512.560000003,2018,9,10,TRANSFER,0.01,M967306405
5346,409000493210',2018-09-10,Indiaforensic NFS SETT 07-09-201,7000.0,0.0,5620512.560000003,2018,9,10,PAYEMENT,7000.0,M359463456
5347,409000493210',2018-09-10,Indiaforensic NFS SETT 07-09-201,500.0,0.0,5620012.560000003,2018,9,10,CASH_OUT,500.0,M590966720
5348,409000493210',2018-09-10,Indiaforensic NFS SETT 07-09-201,5000.0,0.0,5615012.560000003,2018,9,10,DEBIT,5000.0,M2120115571
5349,409000493210',2018-09-10,Indiaforensic NFS SETT 07-09-201,1500.0,0.0,5613512.560000003,2018,9,10,CHECK_WITHDRAWAL,1500.0,M1487559828
5350,409000493210',2018-09-10,Indiaforensic NFS SETT 07-09-201,5000.0,0.0,5608512.560000003,2018,9,10,PAYEMENT,5000.0,M1356806123
5351,409000493210',2018-09-10,Indiaforensic NFS SETT 07-09-201,1500.0,0.0,5607012.560000003,2018,9,10,DEBIT,1500.0,M1091844211
5352,409000493210',2018-09-10,Indiaforensic NFS SETT 07-09-201,6000.0,0.0,5601012.560000003,2018,9,10,DEBIT,6000.0,M146540182
5353,409000493210',2018-09-10,Indiaforensic NFS SETT 07-09-201,6500.0,0.0,5594512.560000003,2018,9,10,CASH_OUT,6500.0,M655304911
5354,409000493210',2018-09-10,Indiaforensic NFS SETT 07-09-201,7500.0,0.0,5587012.560000003,2018,9,10,CASH_OUT,7500.0,M1182463628
5355,409000493210',2018-09-10,Indiaforensic NFS SETT 07-09-201,2000.0,0.0,5585012.560000003,2018,9,10,DEBIT,2000.0,M493844439
5356,409000493210',2018-09-10,Indiaforensic NFS SETT 07-09-201,5000.0,0.0,5580012.560000003,2018,9,10,DEBIT,5000.0,M1958310934
5357,409000493210',2018-09-10,Indiaforensic NFS SETT 07-09-201,3500.0,0.0,5576512.560000003,2018,9,10,DEBIT,3500.0,M315059566
5358,409000493210',2018-09-10,Indiaforensic NFS SETT 07-09-201,3500.0,0.0,5573012.560000003,2018,9,10,PAYEMENT,3500.0,M2035743034
5359,409000493210',2018-09-10,Indiaforensic NFS SETT 07-09-201,7000.0,0.0,5566012.560000003,2018,9,10,PAYEMENT,7000.0,M666596577
5360,409000493210',2018-09-10,Indiaforensic NFS SETT 07-09-201,8000.0,0.0,5558012.560000003,2018,9,10,PAYEMENT,8000.0,M775739186
5361,409000493210',2018-09-10,Indiaforensic NFS SETT 07-09-201,500.0,0.0,5557512.560000003,2018,9,10,DEBIT,500.0,M716724378
5362,409000493210',2018-09-10,Indiaforensic NFS SETT 07-09-201,8000.0,0.0,5549512.560000003,2018,9,10,CHECK_WITHDRAWAL,8000.0,M1769640623
5363,409000493210',2018-09-10,Indiaforensic NFS SETT 07-09-201,7500.0,0.0,5542012.560000003,2018,9,10,PAYEMENT,7500.0,M381118552
5364,409000493210',2018-09-10,Indiaforensic NFS SETT 07-09-201,10000.0,0.0,5532012.560000003,2018,9,10,DEBIT,10000.0,M820959908
5365,409000493210',2018-09-10,Indiaforensic NFS SETT 07-09-201,500.0,0.0,5531512.560000003,2018,9,10,CHECK_WITHDRAWAL,500.0,M2137741298
5366,409000493210',2018-09-10,Indiaforensic NFS SETT 07-09-201,2500.0,0.0,5529012.560000003,2018,9,10,DEBIT,2500.0,M1387473776
5367,409000493210',2018-09-10,Indiaforensic NFS SETT 07-09-201,7200.0,0.0,5521812.560000003,2018,9,10,CASH_OUT,7200.0,C716083600
5368,409000493210',2018-09-10,Indiaforensic NFS SETT 07-09-201,9000.0,0.0,5512812.560000003,2018,9,10,CHECK_WITHDRAWAL,9000.0,M1582427182
5369,409000493210',2018-09-10,Indiaforensic NFS SETT 07-09-201,8500.0,0.0,5504312.560000003,2018,9,10,DEBIT,8500.0,M1281743075
5370,409000493210',2018-09-10,Indiaforensic NFS SETT 07-09-201,8300.0,0.0,5496012.560000003,2018,9,10,CASH_OUT,8300.0,M1775113446
5371,409000493210',2018-09-10,Indiaforensic NFS SETT 07-09-201,9000.0,0.0,5487012.560000003,2018,9,10,PAYEMENT,9000.0,M190704044
5372,409000493210',2018-09-10,Indiaforensic NFS SETT 07-09-201,9000.0,0.0,5478012.560000003,2018,9,10,CHECK_WITHDRAWAL,9000.0,M1472057002
5373,409000493210',2018-09-10,Indiaforensic NFS SETT 07-09-201,8000.0,0.0,5470012.560000003,2018,9,10,DEBIT,8000.0,M920914400
5374,409000493210',2018-09-10,Indiaforensic NFS SETT 07-09-201,7000.0,0.0,5463012.560000003,2018,9,10,DEBIT,7000.0,M758104368
5375,409000493210',2018-09-10,Indiaforensic NFS SETT 07-09-201,9000.0,0.0,5454012.560000003,2018,9,10,CASH_OUT,9000.0,M1828724670
5376,409000493210',2018-09-10,Indiaforensic NFS SETT 07-09-201,500.0,0.0,5453512.560000003,2018,9,10,CHECK_WITHDRAWAL,500.0,C54617902
5377,409000493210',2018-09-10,Indiaforensic NFS SETT 07-09-201,500.0,0.0,5453012.560000003,2018,9,10,CASH_OUT,500.0,M1214115553
5378,409000493210',2018-09-10,Indiaforensic NFS SETT 07-09-201,8000.0,0.0,5445012.560000003,2018,9,10,CASH_OUT,8000.0,M950625683
5379,409000493210',2018-09-10,Indiaforensic NFS SETT 07-09-201,8000.0,0.0,5437012.560000003,2018,9,10,PAYEMENT,8000.0,M2063309971
5380,409000493210',2018-09-10,Indiaforensic NFS SETT 07-09-201,7000.0,0.0,5430012.560000003,2018,9,10,DEBIT,7000.0,M1135026238
5381,409000493210',2018-09-10,Indiaforensic NFS SETT 07-09-201,10000.0,0.0,5420012.560000003,2018,9,10,DEBIT,10000.0,M173965920
5382,409000493210',2018-09-10,Indiaforensic NFS SETT 07-09-201,3000.0,0.0,5417012.560000003,2018,9,10,DEBIT,3000.0,M1251724953
5383,409000493210',2018-09-10,Indiaforensic NFS SETT 07-09-201,8000.0,0.0,5409012.560000003,2018,9,10,CASH_OUT,8000.0,C173783788
5384,409000493210',2018-09-10,Indiaforensic NFS SETT 07-09-201,6500.0,0.0,5402512.560000003,2018,9,10,DEBIT,6500.0,C1458849419
5385,409000493210',2018-09-10,Indiaforensic NFS SETT 07-09-201,400.0,0.0,5402112.560000003,2018,9,10,CHECK_WITHDRAWAL,400.0,M1040079319
5386,409000493210',2018-09-10,Indiaforensic NFS SETT 07-09-201,6500.0,0.0,5395612.560000003,2018,9,10,PAYEMENT,6500.0,M1560844138
5387,409000493210',2018-09-10,Indiaforensic NFS SETT 07-09-201,7500.0,0.0,5388112.560000003,2018,9,10,DEBIT,7500.0,M375201108
5388,409000493210',2018-09-10,Indiaforensic NFS SETT 07-09-201,9000.0,0.0,5379112.560000003,2018,9,10,CASH_OUT,9000.0,M1389056701
5389,409000493210',2018-09-10,Indiaforensic NFS SETT 07-09-201,7500.0,0.0,5371612.560000003,2018,9,10,CASH_OUT,7500.0,M1666530975
5390,409000493210',2018-09-10,Indiaforensic NFS SETT 07-09-201,10000.0,0.0,5361612.560000003,2018,9,10,CHECK_WITHDRAWAL,10000.0,M1082073129
5391,409000493210',2018-09-10,Indiaforensic NFS SETT 07-09-201,500.0,0.0,5361112.560000003,2018,9,10,PAYEMENT,500.0,M1173015408
5392,409000493210',2018-09-10,Indiaforensic NFS SETT 07-09-201,1500.0,0.0,5359612.560000003,2018,9,10,PAYEMENT,1500.0,M2050024203
5393,409000493210',2018-09-10,Indiaforensic NFS SETT 07-09-201,2500.0,0.0,5357112.560000003,2018,9,10,DEBIT,2500.0,C831775261
5394,409000493210',2018-09-10,Indiaforensic NFS SETT 07-09-201,10000.0,0.0,5347112.560000003,2018,9,10,CASH_OUT,10000.0,M1913425792
5395,409000493210',2018-09-10,Indiaforensic NFS SETT 07-09-201,3500.0,0.0,5343612.560000003,2018,9,10,CASH_OUT,3500.0,M2009885224
5396,409000493210',2018-09-10,Indiaforensic NFS SETT 07-09-201,1500.0,0.0,5342112.560000003,2018,9,10,CHECK_WITHDRAWAL,1500.0,M492135521
5397,409000493210',2018-09-10,Indiaforensic NFS SETT 07-09-201,500.0,0.0,5341612.560000003,2018,9,10,CHECK_WITHDRAWAL,500.0,M1322359657
5398,409000493210',2018-09-10,Indiaforensic NFS SETT 07-09-201,4500.0,0.0,5337112.560000003,2018,9,10,DEBIT,4500.0,M1868933720
5399,409000493210',2018-09-10,Indiaforensic NFS SETT 07-09-201,7000.0,0.0,5330112.560000003,2018,9,10,PAYEMENT,7000.0,M920102538
5400,409000493210',2018-09-10,Indiaforensic NFS SETT 07-09-201,8000.0,0.0,5322112.560000003,2018,9,10,PAYEMENT,8000.0,M2636011
5401,409000493210',2018-09-10,Indiaforensic NFS SETT 07-09-201,9000.0,0.0,5313112.560000003,2018,9,10,DEBIT,9000.0,M73254846
5402,409000493210',2018-09-10,Indiaforensic NFS SETT 07-09-201,10000.0,0.0,5303112.560000003,2018,9,10,CHECK_WITHDRAWAL,10000.0,C726762476
5403,409000493210',2018-09-10,Indiaforensic NFS SETT 07-09-201,5000.0,0.0,5298112.560000003,2018,9,10,CASH_OUT,5000.0,C407757655
5404,409000493210',2018-09-10,Indiaforensic NFS SETT 07-09-201,8200.0,0.0,5289912.560000003,2018,9,10,DEBIT,8200.0,M669781254
5405,409000493210',2018-09-10,Indiaforensic NFS SETT 07-09-201,500.0,0.0,5289412.560000003,2018,9,10,CASH_OUT,500.0,C1877453512
5406,409000493210',2018-09-10,Indiaforensic NFS SETT 07-09-201,1200.0,0.0,5288212.560000003,2018,9,10,PAYEMENT,1200.0,M1839613624
5407,409000493210',2018-09-10,Indiaforensic NFS SETT 07-09-201,10000.0,0.0,5278212.560000003,2018,9,10,CASH_OUT,10000.0,M977847192
5408,409000493210',2018-09-10,Indiaforensic NFS SETT 07-09-201,9500.0,0.0,5268712.560000003,2018,9,10,DEBIT,9500.0,M1141354562
5409,409000493210',2018-09-10,Indiaforensic NFS SETT 07-09-201,9000.0,0.0,5259712.560000003,2018,9,10,CASH_OUT,9000.0,M1038014730
5410,409000493210',2018-09-10,Indiaforensic NFS SETT 07-09-201,8200.0,0.0,5251512.560000003,2018,9,10,PAYEMENT,8200.0,M44007732
5411,409000493210',2018-09-10,Indiaforensic NFS SETT 07-09-201,9500.0,0.0,5242012.560000003,2018,9,10,PAYEMENT,9500.0,M1014250816
5412,409000493210',2018-09-10,Indiaforensic NFS SETT 07-09-201,10000.0,0.0,5232012.560000003,2018,9,10,CASH_OUT,10000.0,M608486367
5413,409000493210',2018-09-10,Indiaforensic NFS SETT 07-09-201,3600.0,0.0,5228412.560000003,2018,9,10,CASH_OUT,3600.0,M53851094
5414,409000493210',2018-09-10,Indiaforensic NFS SETT 07-09-201,200.0,0.0,5228212.560000003,2018,9,10,DEBIT,200.0,M948208151
5415,409000493210',2018-09-10,Indiaforensic NFS SETT 07-09-201,4400.0,0.0,5223812.560000003,2018,9,10,DEBIT,4400.0,M948070788
5416,409000493210',2018-09-10,Indiaforensic NFS SETT 07-09-201,8700.0,0.0,5215112.560000003,2018,9,10,CASH_OUT,8700.0,M2033090945
5417,409000493210',2018-09-10,Indiaforensic NFS SETT 07-09-201,10000.0,0.0,5205112.560000003,2018,9,10,CHECK_WITHDRAWAL,10000.0,M2054738816
5418,409000493210',2018-09-10,Indiaforensic NFS SETT 07-09-201,5000.0,0.0,5200112.560000003,2018,9,10,CHECK_WITHDRAWAL,5000.0,M599601006
5419,409000493210',2018-09-10,Indiaforensic NFS SETT 07-09-201,9500.0,0.0,5190612.560000003,2018,9,10,DEBIT,9500.0,M607178519
5420,409000493210',2018-09-10,Indiaforensic NFS SETT 07-09-201,3000.0,0.0,5187612.560000003,2018,9,10,CHECK_WITHDRAWAL,3000.0,M1419345767
5421,409000493210',2018-09-10,Indiaforensic NFS SETT 07-09-201,10000.0,0.0,5177612.560000003,2018,9,10,PAYEMENT,10000.0,M698272400
5422,409000493210',2018-09-10,Indiaforensic NFS SETT 07-09-201,6500.0,0.0,5171112.560000003,2018,9,10,CHECK_WITHDRAWAL,6500.0,M124454336
5423,409000493210',2018-09-10,Indiaforensic NFS SETT 07-09-201,9400.0,0.0,5161712.560000003,2018,9,10,CHECK_WITHDRAWAL,9400.0,M1946338463
5424,409000493210',2018-09-10,Indiaforensic NFS SETT 07-09-201,600.0,0.0,5161112.560000003,2018,9,10,CASH_OUT,600.0,M37235503
5425,409000493210',2018-09-10,Indiaforensic NFS SETT 07-09-201,9300.0,0.0,5151812.560000003,2018,9,10,CASH_OUT,9300.0,M1903379555
5426,409000493210',2018-09-10,Indiaforensic NFS SETT 07-09-201,8900.0,0.0,5142912.560000003,2018,9,10,PAYEMENT,8900.0,M2092912524
5427,409000493210',2018-09-10,Indiaforensic NFS SETT 07-09-201,7300.0,0.0,5135612.560000003,2018,9,10,CASH_OUT,7300.0,M1056925766
5428,409000493210',2018-09-10,Indiaforensic NFS SETT 07-09-201,9500.0,0.0,5126112.560000003,2018,9,10,CHECK_WITHDRAWAL,9500.0,M1822634375
5429,409000493210',2018-09-10,Indiaforensic NFS SETT 07-09-201,600.0,0.0,5125512.560000003,2018,9,10,PAYEMENT,600.0,M1595870950
5430,409000493210',2018-09-10,Indiaforensic NFS SETT 07-09-201,8000.0,0.0,5117512.560000003,2018,9,10,CHECK_WITHDRAWAL,8000.0,M1996248711
5431,409000493210',2018-09-10,Indiaforensic NFS SETT 07-09-201,500.0,0.0,5117012.560000003,2018,9,10,DEBIT,500.0,M1949625875
5432,409000493210',2018-09-10,Indiaforensic NFS SETT 07-09-201,8200.0,0.0,5108812.560000003,2018,9,10,CASH_OUT,8200.0,M1358787485
5433,409000493210',2018-09-10,Indiaforensic NFS SETT 07-09-201,600.0,0.0,5108212.560000003,2018,9,10,PAYEMENT,600.0,M218770562
5434,409000493210',2018-09-10,Indiaforensic NFS SETT 07-09-201,200.0,0.0,5108012.560000003,2018,9,10,CASH_OUT,200.0,M2018528489
5435,409000493210',2018-09-10,Indiaforensic NFS SETT 07-09-201,8500.0,0.0,5099512.560000003,2018,9,10,CHECK_WITHDRAWAL,8500.0,M308316550
5436,409000493210',2018-09-10,Indiaforensic NFS SETT 07-09-201,8500.0,0.0,5091012.560000003,2018,9,10,PAYEMENT,8500.0,C1983747920
5437,409000493210',2018-09-10,Indiaforensic NFS SETT 07-09-201,800.0,0.0,5090212.560000003,2018,9,10,DEBIT,800.0,C1870252780
5438,409000493210',2018-09-10,Indiaforensic NFS SETT 07-09-201,8000.0,0.0,5082212.560000003,2018,9,10,CHECK_WITHDRAWAL,8000.0,M820117866
5439,409000493210',2018-09-10,Indiaforensic NFS SETT 07-09-201,8800.0,0.0,5073412.560000003,2018,9,10,PAYEMENT,8800.0,M598183031
5440,409000493210',2018-09-10,Indiaforensic NFS SETT 07-09-201,10000.0,0.0,5063412.560000003,2018,9,10,CASH_OUT,10000.0,C2094777811
5441,409000493210',2018-09-10,Indiaforensic NFS SETT 07-09-201,1000.0,0.0,5062412.560000003,2018,9,10,CASH_OUT,1000.0,C146305349
5442,409000493210',2018-09-10,Indiaforensic NFS SETT 07-09-201,500.0,0.0,5061912.560000003,2018,9,10,PAYEMENT,500.0,M315902506
5443,409000493210',2018-09-10,Indiaforensic NFS SETT 07-09-201,6000.0,0.0,5055912.560000003,2018,9,10,CASH_OUT,6000.0,M2138104388
5444,409000493210',2018-09-10,Indiaforensic NFS SETT 07-09-201,500.0,0.0,5055412.560000003,2018,9,10,PAYEMENT,500.0,M1063573827
5445,409000493210',2018-09-10,Indiaforensic NFS SETT 07-09-201,100.0,0.0,5055312.560000003,2018,9,10,DEBIT,100.0,M1749372629
5446,409000493210',2018-09-10,Indiaforensic NFS SETT 07-09-201,8500.0,0.0,5046812.560000003,2018,9,10,PAYEMENT,8500.0,M1956303740
5447,409000493210',2018-09-10,Indiaforensic NFS SETT 07-09-201,7000.0,0.0,5039812.560000003,2018,9,10,CASH_OUT,7000.0,M1505331921
5448,409000493210',2018-09-10,Indiaforensic NFS SETT 07-09-201,8300.0,0.0,5031512.560000003,2018,9,10,CASH_OUT,8300.0,M2076014264
5449,409000493210',2018-09-10,Indiaforensic NFS SETT 07-09-201,7600.0,0.0,5023912.560000003,2018,9,10,CHECK_WITHDRAWAL,7600.0,C1235151206
5450,409000493210',2018-09-10,Indiaforensic NFS SETT 07-09-201,9500.0,0.0,5014412.560000003,2018,9,10,PAYEMENT,9500.0,M477700359
5451,409000493210',2018-09-10,Indiaforensic NFS SETT 07-09-201,5000.0,0.0,5009412.560000003,2018,9,10,CASH_OUT,5000.0,M1749524107
5452,409000493210',2018-09-10,Indiaforensic NFS SETT 07-09-201,2500.0,0.0,5006912.560000003,2018,9,10,PAYEMENT,2500.0,M456228477
5453,409000493210',2018-09-10,Indiaforensic NFS SETT 07-09-201,2500.0,0.0,5004412.560000003,2018,9,10,CHECK_WITHDRAWAL,2500.0,M1339273738
5454,409000493210',2018-09-10,Indiaforensic NFS SETT 07-09-201,2500.0,0.0,5001912.560000003,2018,9,10,DEBIT,2500.0,M965674262
5455,409000493210',2018-09-10,Indiaforensic NFS SETT 07-09-201,500.0,0.0,5001412.560000003,2018,9,10,CHECK_WITHDRAWAL,500.0,M1454795302
5456,409000493210',2018-09-10,Indiaforensic NFS SETT 07-09-201,500.0,0.0,5000912.560000003,2018,9,10,CASH_OUT,500.0,M1416134608
5457,409000493210',2018-09-10,Indiaforensic NFS SETT 07-09-201,4000.0,0.0,4996912.560000003,2018,9,10,PAYEMENT,4000.0,C2134357721
5458,409000493210',2018-09-10,Indiaforensic NFS SETT 07-09-201,1000.0,0.0,4995912.560000003,2018,9,10,CASH_OUT,1000.0,C932583850
5459,409000493210',2018-09-10,Indiaforensic NFS SETT 07-09-201,5400.0,0.0,4990512.560000003,2018,9,10,DEBIT,5400.0,C1870252780
5460,409000493210',2018-09-10,Indiaforensic NFS SETT 07-09-201,100.0,0.0,4990412.560000003,2018,9,10,PAYEMENT,100.0,C1983747920
5461,409000493210',2018-09-10,Indiaforensic NFS SETT 07-09-201,500.0,0.0,4989912.560000003,2018,9,10,CASH_OUT,500.0,C932583850
5462,409000493210',2018-09-10,Indiaforensic NFS SETT 08-09-201,9500.0,0.0,4980412.560000003,2018,9,10,PAYEMENT,9500.0,C716083600
5463,409000493210',2018-09-10,Indiaforensic NFS SETT 08-09-201,500.0,0.0,4979912.560000003,2018,9,10,DEBIT,500.0,M385131456
5464,409000493210',2018-09-10,Indiaforensic NFS SETT 08-09-201,2000.0,0.0,4977912.560000003,2018,9,10,PAYEMENT,2000.0,M1170475172
5465,409000493210',2018-09-10,Indiaforensic NFS SETT 08-09-201,8000.0,0.0,4969912.560000003,2018,9,10,CASH_OUT,8000.0,M88332821
5466,409000493210',2018-09-10,Indiaforensic NFS SETT 08-09-201,9000.0,0.0,4960912.560000003,2018,9,10,CASH_OUT,9000.0,C746009679
5467,409000493210',2018-09-10,Indiaforensic NFS SETT 08-09-201,800.0,0.0,4960112.560000003,2018,9,10,PAYEMENT,800.0,C922511709
5468,409000493210',2018-09-10,Indiaforensic NFS SETT 08-09-201,8500.0,0.0,4951612.560000003,2018,9,10,CASH_OUT,8500.0,M1978560393
5469,409000493210',2018-09-10,Indiaforensic NFS SETT 08-09-201,700.0,0.0,4950912.560000003,2018,9,10,PAYEMENT,700.0,M896475319
5470,409000493210',2018-09-10,Indiaforensic NFS SETT 08-09-201,8500.0,0.0,4942412.560000003,2018,9,10,CHECK_WITHDRAWAL,8500.0,M1776186092
5471,409000493210',2018-09-10,Indiaforensic NFS SETT 08-09-201,7800.0,0.0,4934612.560000003,2018,9,10,CASH_OUT,7800.0,M1836018857
5472,409000493210',2018-09-10,Indiaforensic NFS SETT 08-09-201,10000.0,0.0,4924612.560000003,2018,9,10,CHECK_WITHDRAWAL,10000.0,M1310342490
5473,409000493210',2018-09-10,Indiaforensic NFS SETT 08-09-201,500.0,0.0,4924112.560000003,2018,9,10,CHECK_WITHDRAWAL,500.0,M905404580
5474,409000493210',2018-09-10,Indiaforensic NFS SETT 08-09-201,10000.0,0.0,4914112.560000003,2018,9,10,PAYEMENT,10000.0,C1446521801
5475,409000493210',2018-09-10,Indiaforensic NFS SETT 08-09-201,4900.0,0.0,4909212.560000003,2018,9,10,CASH_OUT,4900.0,C997608398
5476,409000493210',2018-09-10,Indiaforensic NFS SETT 08-09-201,500.0,0.0,4908712.560000003,2018,9,10,PAYEMENT,500.0,C1916720513
5477,409000493210',2018-09-10,Indiaforensic NFS SETT 08-09-201,9500.0,0.0,4899212.560000003,2018,9,10,DEBIT,9500.0,C1167066016
5478,409000493210',2018-09-10,Indiaforensic NFS SETT 08-09-201,10000.0,0.0,4889212.560000003,2018,9,10,DEBIT,10000.0,C1782113663
5479,409000493210',2018-09-10,Indiaforensic NFS SETT 08-09-201,3000.0,0.0,4886212.560000003,2018,9,10,CHECK_WITHDRAWAL,3000.0,C1721246982
5480,409000493210',2018-09-10,Indiaforensic NFS SETT 08-09-201,7000.0,0.0,4879212.560000003,2018,9,10,DEBIT,7000.0,C1339858954
5481,409000493210',2018-09-10,Indiaforensic NFS SETT 08-09-201,1000.0,0.0,4878212.560000003,2018,9,10,DEBIT,1000.0,C453211571
5482,409000493210',2018-09-10,Indiaforensic NFS SETT 08-09-201,1900.0,0.0,4876312.560000003,2018,9,10,CASH_OUT,1900.0,C1504109395
5483,409000493210',2018-09-10,Indiaforensic NFS SETT 08-09-201,8000.0,0.0,4868312.560000003,2018,9,10,CHECK_WITHDRAWAL,8000.0,C665576141
5484,409000493210',2018-09-10,Indiaforensic NFS SETT 08-09-201,400.0,0.0,4867912.560000003,2018,9,10,CASH_OUT,400.0,C1167066016
5485,409000493210',2018-09-10,Indiaforensic NFS SETT 08-09-201,8000.0,0.0,4859912.560000003,2018,9,10,CHECK_WITHDRAWAL,8000.0,C665576141
5486,409000493210',2018-09-10,Indiaforensic NFS SETT 08-09-201,5600.0,0.0,4854312.560000003,2018,9,10,CASH_OUT,5600.0,C306206744
5487,409000493210',2018-09-10,Indiaforensic NFS SETT 08-09-201,8000.0,0.0,4846312.560000003,2018,9,10,CASH_OUT,8000.0,C248609774
5488,409000493210',2018-09-10,Indiaforensic NFS SETT 08-09-201,2000.0,0.0,4844312.560000003,2018,9,10,DEBIT,2000.0,C1750563752
5489,409000493210',2018-09-10,Indiaforensic NFS SETT 08-09-201,8000.0,0.0,4836312.560000003,2018,9,10,CASH_OUT,8000.0,C2113748097
5490,409000493210',2018-09-10,Indiaforensic NFS SETT 08-09-201,10000.0,0.0,4826312.560000003,2018,9,10,CHECK_WITHDRAWAL,10000.0,M1282393063
5491,409000493210',2018-09-10,Indiaforensic NFS SETT 08-09-201,8000.0,0.0,4818312.560000003,2018,9,10,CASH_OUT,8000.0,C1870252780
5492,409000493210',2018-09-10,Indiaforensic NFS SETT 08-09-201,8000.0,0.0,4810312.560000003,2018,9,10,PAYEMENT,8000.0,C54617902
5493,409000493210',2018-09-10,Indiaforensic NFS SETT 08-09-201,2000.0,0.0,4808312.560000003,2018,9,10,CHECK_WITHDRAWAL,2000.0,C423583818
5494,409000493210',2018-09-10,Indiaforensic NFS SETT 08-09-201,200.0,0.0,4808112.560000003,2018,9,10,DEBIT,200.0,C380242442
5495,409000493210',2018-09-10,Indiaforensic NFS SETT 08-09-201,10000.0,0.0,4798112.560000003,2018,9,10,CASH_OUT,10000.0,C801142660
5496,409000493210',2018-09-10,Indiaforensic NFS SETT 08-09-201,800.0,0.0,4797312.560000003,2018,9,10,CASH_OUT,800.0,C801142660
5497,409000493210',2018-09-10,Indiaforensic NFS SETT 08-09-201,8700.0,0.0,4788612.560000003,2018,9,10,PAYEMENT,8700.0,C33524623
5498,409000493210',2018-09-10,Indiaforensic NFS SETT 08-09-201,5000.0,0.0,4783612.560000003,2018,9,10,CHECK_WITHDRAWAL,5000.0,C728885526
5499,409000493210',2018-09-10,Indiaforensic NFS SETT 08-09-201,4500.0,0.0,4779112.560000003,2018,9,10,CHECK_WITHDRAWAL,4500.0,C1477979030
5500,409000493210',2018-09-10,Indiaforensic NFS SETT 08-09-201,8400.0,0.0,4770712.560000003,2018,9,10,DEBIT,8400.0,C1394526584
5501,409000493210',2018-09-10,Indiaforensic NFS SETT 08-09-201,500.0,0.0,4770212.560000003,2018,9,10,DEBIT,500.0,M705801739
5502,409000493210',2018-09-10,Indiaforensic NFS SETT 08-09-201,9000.0,0.0,4761212.560000003,2018,9,10,PAYEMENT,9000.0,M1532728609
5503,409000493210',2018-09-10,Indiaforensic NFS SETT 08-09-201,100.0,0.0,4761112.560000003,2018,9,10,CHECK_WITHDRAWAL,100.0,M1714507758
5504,409000493210',2018-09-10,Indiaforensic NFS SETT 08-09-201,9000.0,0.0,4752112.560000003,2018,9,10,DEBIT,9000.0,M322981749
5505,409000493210',2018-09-10,Indiaforensic NFS SETT 08-09-201,3000.0,0.0,4749112.560000003,2018,9,10,PAYEMENT,3000.0,M7040976
5506,409000493210',2018-09-10,Indiaforensic NFS SETT 08-09-201,8000.0,0.0,4741112.560000003,2018,9,10,CHECK_WITHDRAWAL,8000.0,M752572788
5507,409000493210',2018-09-10,Indiaforensic NFS SETT 08-09-201,500.0,0.0,4740612.560000003,2018,9,10,CASH_OUT,500.0,M1407492510
5508,409000493210',2018-09-10,Indiaforensic NFS SETT 08-09-201,8000.0,0.0,4732612.560000003,2018,9,10,CASH_OUT,8000.0,M340852643
5509,409000493210',2018-09-10,Indiaforensic NFS SETT 08-09-201,6000.0,0.0,4726612.560000003,2018,9,10,CHECK_WITHDRAWAL,6000.0,M954976358
5510,409000493210',2018-09-10,Indiaforensic NFS SETT 08-09-201,3500.0,0.0,4723112.560000003,2018,9,10,CASH_OUT,3500.0,M2036508486
5511,409000493210',2018-09-10,Indiaforensic NFS SETT 08-09-201,1000.0,0.0,4722112.560000003,2018,9,10,PAYEMENT,1000.0,M2055183685
5512,409000493210',2018-09-10,Indiaforensic NFS SETT 08-09-201,8500.0,0.0,4713612.560000003,2018,9,10,DEBIT,8500.0,C991505714
5513,409000493210',2018-09-10,Indiaforensic NFS SETT 08-09-201,9500.0,0.0,4704112.560000003,2018,9,10,CASH_OUT,9500.0,M155833159
5514,409000493210',2018-09-10,Indiaforensic NFS SETT 08-09-201,7500.0,0.0,4696612.560000003,2018,9,10,PAYEMENT,7500.0,M533053618
5515,409000493210',2018-09-10,Indiaforensic NFS SETT 08-09-201,300.0,0.0,4696312.560000003,2018,9,10,CHECK_WITHDRAWAL,300.0,M45681857
5516,409000493210',2018-09-10,Indiaforensic NFS SETT 08-09-201,2000.0,0.0,4694312.560000003,2018,9,10,CASH_OUT,2000.0,M1809767357
5517,409000493210',2018-09-10,Indiaforensic NFS SETT 08-09-201,6000.0,0.0,4688312.560000003,2018,9,10,CASH_OUT,6000.0,M221033168
5518,409000493210',2018-09-10,Indiaforensic NFS SETT 08-09-201,300.0,0.0,4688012.560000003,2018,9,10,DEBIT,300.0,M817707477
5519,409000493210',2018-09-10,Indiaforensic NFS SETT 08-09-201,4000.0,0.0,4684012.560000003,2018,9,10,DEBIT,4000.0,M1414883107
5520,409000493210',2018-09-10,Indiaforensic NFS SETT 08-09-201,2500.0,0.0,4681512.560000003,2018,9,10,DEBIT,2500.0,M940454850
5521,409000493210',2018-09-10,Indiaforensic NFS SETT 09-09-201,6000.0,0.0,4675512.560000003,2018,9,10,DEBIT,6000.0,C1917025677
5522,409000493210',2018-09-10,Indiaforensic NFS SETT 09-09-201,5000.0,0.0,4670512.560000003,2018,9,10,DEBIT,5000.0,M64330035
5523,409000493210',2018-09-10,Indiaforensic NFS SETT 09-09-201,1000.0,0.0,4669512.560000003,2018,9,10,CHECK_WITHDRAWAL,1000.0,M892626202
5524,409000493210',2018-09-10,Indiaforensic NFS SETT 09-09-201,5000.0,0.0,4664512.560000003,2018,9,10,PAYEMENT,5000.0,M40514511
5525,409000493210',2018-09-10,Indiaforensic NFS SETT 09-09-201,3000.0,0.0,4661512.560000003,2018,9,10,DEBIT,3000.0,M1058155740
5526,409000493210',2018-09-10,Indiaforensic NFS SETT 09-09-201,9500.0,0.0,4652012.560000003,2018,9,10,DEBIT,9500.0,M148018969
5527,409000493210',2018-09-10,Indiaforensic NFS SETT 09-09-201,10000.0,0.0,4642012.560000003,2018,9,10,DEBIT,10000.0,M1275013351
5528,409000493210',2018-09-10,Indiaforensic NFS SETT 09-09-201,9000.0,0.0,4633012.560000003,2018,9,10,CASH_OUT,9000.0,M630313530
5529,409000493210',2018-09-10,Indiaforensic NFS SETT 09-09-201,10000.0,0.0,4623012.560000003,2018,9,10,DEBIT,10000.0,M1586868395
5530,409000493210',2018-09-10,Indiaforensic NFS SETT 09-09-201,8500.0,0.0,4614512.560000003,2018,9,10,PAYEMENT,8500.0,M1943910383
5531,409000493210',2018-09-10,Indiaforensic NFS SETT 09-09-201,1000.0,0.0,4613512.560000003,2018,9,10,CASH_OUT,1000.0,M337314074
5532,409000493210',2018-09-10,Indiaforensic NFS SETT 09-09-201,6500.0,0.0,4607012.560000003,2018,9,10,CHECK_WITHDRAWAL,6500.0,M1728726840
5533,409000493210',2018-09-10,Indiaforensic NFS SETT 09-09-201,200.0,0.0,4606812.560000003,2018,9,10,DEBIT,200.0,M195035534
5534,409000493210',2018-09-10,Indiaforensic NFS SETT 09-09-201,1500.0,0.0,4605312.560000003,2018,9,10,CHECK_WITHDRAWAL,1500.0,M1882695296
5535,409000493210',2018-09-10,Indiaforensic NFS SETT 09-09-201,9000.0,0.0,4596312.560000003,2018,9,10,DEBIT,9000.0,M1108039149
5536,409000493210',2018-09-10,Indiaforensic NFS SETT 09-09-201,5000.0,0.0,4591312.560000003,2018,9,10,PAYEMENT,5000.0,M1122885157
5537,409000493210',2018-09-10,Indiaforensic NFS SETT 09-09-201,7000.0,0.0,4584312.560000003,2018,9,10,CASH_OUT,7000.0,M2010734170
5538,409000493210',2018-09-10,Indiaforensic NFS SETT 09-09-201,1000.0,0.0,4583312.560000003,2018,9,10,CHECK_WITHDRAWAL,1000.0,M1334378672
5539,409000493210',2018-09-10,Indiaforensic NFS SETT 09-09-201,500.0,0.0,4582812.560000003,2018,9,10,DEBIT,500.0,M870900038
5540,409000493210',2018-09-10,Indiaforensic NFS SETT 09-09-201,4000.0,0.0,4578812.560000003,2018,9,10,PAYEMENT,4000.0,M407254816
5541,409000493210',2018-09-10,Indiaforensic NFS SETT 09-09-201,9000.0,0.0,4569812.560000003,2018,9,10,DEBIT,9000.0,M284746450
5542,409000493210',2018-09-10,Indiaforensic NFS SETT 09-09-201,200.0,0.0,4569612.560000003,2018,9,10,DEBIT,200.0,M1330798099
5543,409000493210',2018-09-10,Indiaforensic NFS SETT 09-09-201,8000.0,0.0,4561612.560000003,2018,9,10,CASH_OUT,8000.0,M184147252
5544,409000493210',2018-09-10,Indiaforensic NFS SETT 09-09-201,3000.0,0.0,4558612.560000003,2018,9,10,DEBIT,3000.0,M353786333
5545,409000493210',2018-09-10,Indiaforensic NFS SETT 09-09-201,4800.0,0.0,4553812.560000003,2018,9,10,PAYEMENT,4800.0,M244090091
5546,409000493210',2018-09-11,Indiaforensic  RUPAY SETT 110918,8522.91,0.0,4545289.650000004,2018,9,11,CASH_OUT,8522.91,C193625667
5547,409000493210',2018-09-11,Indiaforensic  RUPAY SETT 110918,0.0,99.02,4545388.670000004,2018,9,11,TRANSFER,99.02,M636050161
5548,409000493210',2018-09-11,Indiaforensic RUPAY STL INTC1109,94.02,0.0,4545294.650000004,2018,9,11,CASH_OUT,94.02,M1715781109
5549,409000493210',2018-09-11,Indiaforensic RUPAY STL INTC1109,0.0,0.08,4545294.730000004,2018,9,11,CASH_IN,0.08,M2090770896
5550,409000493210',2018-09-11,TRF FROM  Indiaforensic SERVICES,0.0,15000.0,4560294.730000004,2018,9,11,CHECK_CASHING,15000.0,M832248951
5551,409000493210',2018-09-11,TRF FROM  Indiaforensic SERVICES,0.0,60000.0,4620294.730000004,2018,9,11,TRANSFER,60000.0,M1373146168
5552,409000493210',2018-09-11,Indiaforensic  RUPAY SETT 110918,2046.54,0.0,4618248.190000004,2018,9,11,DEBIT,2046.54,M1471364137
5553,409000493210',2018-09-11,Indiaforensic  RUPAY SETT 110918,0.0,25.87,4618274.060000003,2018,9,11,CASH_IN,25.87,M322505366
5554,409000493210',2018-09-11,Indiaforensic RUPAY STL INTC1109,25.87,0.0,4618248.190000004,2018,9,11,PAYEMENT,25.87,M1956095316
5555,409000493210',2018-09-11,Indiaforensic NFS SETT 10-09-201,5000.0,0.0,4613248.190000004,2018,9,11,CASH_OUT,5000.0,M107279519
5556,409000493210',2018-09-11,Indiaforensic NFS SETT 10-09-201,1900.0,0.0,4611348.190000004,2018,9,11,PAYEMENT,1900.0,M694103323
5557,409000493210',2018-09-11,Indiaforensic NFS SETT 10-09-201,6000.0,0.0,4605348.190000004,2018,9,11,DEBIT,6000.0,M1155566202
5558,409000493210',2018-09-11,Indiaforensic NFS SETT 10-09-201,10000.0,0.0,4595348.190000004,2018,9,11,CASH_OUT,10000.0,C1662235713
5559,409000493210',2018-09-11,Indiaforensic NFS SETT 10-09-201,10000.0,0.0,4585348.190000004,2018,9,11,DEBIT,10000.0,C1626759869
5560,409000493210',2018-09-11,Indiaforensic NFS SETT 10-09-201,10000.0,0.0,4575348.190000004,2018,9,11,PAYEMENT,10000.0,M127269549
5561,409000493210',2018-09-11,Indiaforensic NFS SETT 10-09-201,1000.0,0.0,4574348.190000004,2018,9,11,CHECK_WITHDRAWAL,1000.0,M1777591638
5562,409000493210',2018-09-11,Indiaforensic NFS SETT 10-09-201,500.0,0.0,4573848.190000004,2018,9,11,CASH_OUT,500.0,M911284082
5563,409000493210',2018-09-11,Indiaforensic NFS SETT 10-09-201,7000.0,0.0,4566848.190000004,2018,9,11,CHECK_WITHDRAWAL,7000.0,M665390309
5564,409000493210',2018-09-11,Indiaforensic NFS SETT 10-09-201,6500.0,0.0,4560348.190000004,2018,9,11,CHECK_WITHDRAWAL,6500.0,M1235247239
5565,409000493210',2018-09-11,Indiaforensic NFS SETT 10-09-201,2900.0,0.0,4557448.190000004,2018,9,11,PAYEMENT,2900.0,M1135930380
5566,409000493210',2018-09-11,Indiaforensic NFS SETT 10-09-201,7000.0,0.0,4550448.190000004,2018,9,11,CASH_OUT,7000.0,M1592099291
5567,409000493210',2018-09-11,Indiaforensic NFS SETT 10-09-201,2000.0,0.0,4548448.190000004,2018,9,11,PAYEMENT,2000.0,M1046396414
5568,409000493210',2018-09-11,Indiaforensic NFS SETT 10-09-201,1000.0,0.0,4547448.190000004,2018,9,11,CASH_OUT,1000.0,C800281454
5569,409000493210',2018-09-11,Indiaforensic NFS SETT 10-09-201,7500.0,0.0,4539948.190000004,2018,9,11,CHECK_WITHDRAWAL,7500.0,M785240035
5570,409000493210',2018-09-11,Indiaforensic NFS SETT 10-09-201,8500.0,0.0,4531448.190000004,2018,9,11,CASH_OUT,8500.0,M541568490
5571,409000493210',2018-09-11,Indiaforensic NFS SETT 10-09-201,1500.0,0.0,4529948.190000004,2018,9,11,CASH_OUT,1500.0,M436625455
5572,409000493210',2018-09-11,Indiaforensic NFS SETT 10-09-201,8000.0,0.0,4521948.190000004,2018,9,11,CASH_OUT,8000.0,M1533854532
5573,409000493210',2018-09-11,Indiaforensic NFS SETT 10-09-201,4000.0,0.0,4517948.190000004,2018,9,11,DEBIT,4000.0,M138306399
5574,409000493210',2018-09-11,Indiaforensic NFS SETT 10-09-201,8500.0,0.0,4509448.190000004,2018,9,11,CASH_OUT,8500.0,M995529850
5575,409000493210',2018-09-11,Indiaforensic NFS SETT 10-09-201,7000.0,0.0,4502448.190000004,2018,9,11,DEBIT,7000.0,M1652114818
5576,409000493210',2018-09-11,Indiaforensic NFS SETT 10-09-201,4000.0,0.0,4498448.190000004,2018,9,11,DEBIT,4000.0,M66588044
5577,409000493210',2018-09-11,Indiaforensic NFS SETT 10-09-201,500.0,0.0,4497948.190000004,2018,9,11,DEBIT,500.0,M96865288
5578,409000493210',2018-09-11,Indiaforensic NFS SETT 10-09-201,3000.0,0.0,4494948.190000004,2018,9,11,PAYEMENT,3000.0,M1608757336
5579,409000493210',2018-09-11,Indiaforensic NFS SETT 10-09-201,7000.0,0.0,4487948.190000004,2018,9,11,CASH_OUT,7000.0,M527826205
5580,409000493210',2018-09-11,TRF FRM  Indiaforensic SERVICES,0.0,36164.0,4524112.190000004,2018,9,11,CHECK_CASHING,36164.0,C1838584624
5581,409000493210',2018-09-12,Indiaforensic  RUPAY SETT 120918,5386.74,0.0,4518725.450000004,2018,9,12,DEBIT,5386.74,C1675375648
5582,409000493210',2018-09-12,Indiaforensic  RUPAY SETT 120918,0.0,63.98,4518789.430000003,2018,9,12,CASH_IN,63.98,M1238166297
5583,409000493210',2018-09-12,Indiaforensic RUPAY STL INTC1209,63.23,0.0,4518726.200000004,2018,9,12,DEBIT,63.23,M320706431
5584,409000493210',2018-09-12,Indiaforensic NFS SETT 11-09-201,2000.0,0.0,4516726.200000004,2018,9,12,CHECK_WITHDRAWAL,2000.0,M1330981538
5585,409000493210',2018-09-12,Indiaforensic NFS SETT 11-09-201,1000.0,0.0,4515726.200000004,2018,9,12,PAYEMENT,1000.0,C997608398
5586,409000493210',2018-09-12,Indiaforensic NFS SETT 11-09-201,4500.0,0.0,4511226.200000004,2018,9,12,PAYEMENT,4500.0,M1579775434
5587,409000493210',2018-09-12,Indiaforensic NFS SETT 11-09-201,500.0,0.0,4510726.200000004,2018,9,12,CHECK_WITHDRAWAL,500.0,M2068191651
5588,409000493210',2018-09-12,Indiaforensic NFS SETT 11-09-201,500.0,0.0,4510226.200000004,2018,9,12,CHECK_WITHDRAWAL,500.0,C1234776885
5589,409000493210',2018-09-12,Indiaforensic NFS SETT 11-09-201,7000.0,0.0,4503226.200000004,2018,9,12,PAYEMENT,7000.0,C481402298
5590,409000493210',2018-09-12,Indiaforensic NFS SETT 11-09-201,8000.0,0.0,4495226.200000004,2018,9,12,DEBIT,8000.0,M354980344
5591,409000493210',2018-09-12,Indiaforensic NFS SETT 11-09-201,4000.0,0.0,4491226.200000004,2018,9,12,DEBIT,4000.0,C843467284
5592,409000493210',2018-09-12,Indiaforensic NFS SETT 11-09-201,4000.0,0.0,4487226.200000004,2018,9,12,CHECK_WITHDRAWAL,4000.0,M190235170
5593,409000493210',2018-09-12,Indiaforensic NFS SETT 11-09-201,2500.0,0.0,4484726.200000004,2018,9,12,CHECK_WITHDRAWAL,2500.0,M1308079276
5594,409000493210',2018-09-12,Indiaforensic NFS SETT 11-09-201,6000.0,0.0,4478726.200000004,2018,9,12,DEBIT,6000.0,M1102932495
5595,409000493210',2018-09-12,Indiaforensic NFS SETT 11-09-201,9000.0,0.0,4469726.200000004,2018,9,12,PAYEMENT,9000.0,M1791706561
5596,409000493210',2018-09-12,Indiaforensic NFS SETT 11-09-201,500.0,0.0,4469226.200000004,2018,9,12,CHECK_WITHDRAWAL,500.0,M51101315
5597,409000493210',2018-09-12,Indiaforensic NFS SETT 11-09-201,200.0,0.0,4469026.200000004,2018,9,12,CHECK_WITHDRAWAL,200.0,M1743032972
5598,409000493210',2018-09-12,Indiaforensic NFS SETT 11-09-201,1000.0,0.0,4468026.200000004,2018,9,12,PAYEMENT,1000.0,M1927763846
5599,409000493210',2018-09-12,Indiaforensic NFS SETT 11-09-201,3500.0,0.0,4464526.200000004,2018,9,12,CHECK_WITHDRAWAL,3500.0,M1874622547
5600,409000493210',2018-09-12,Indiaforensic NFS SETT 11-09-201,10000.0,0.0,4454526.200000004,2018,9,12,CHECK_WITHDRAWAL,10000.0,M992775130
5601,409000493210',2018-09-12,Indiaforensic NFS SETT 11-09-201,4000.0,0.0,4450526.200000004,2018,9,12,DEBIT,4000.0,M1686106686
5602,409000493210',2018-09-13,TRF FRM  Indiaforensic SERVICES,0.0,169047.0,4619573.200000004,2018,9,13,CASH_IN,169047.0,M900327013
5603,409000493210',2018-09-13,Indiaforensic  RUPAY SETT 120918,9293.12,0.0,4610280.080000004,2018,9,13,DEBIT,9293.12,M769526324
5604,409000493210',2018-09-13,Indiaforensic  RUPAY SETT 120918,0.0,65.58,4610345.660000004,2018,9,13,CHECK_CASHING,65.58,M459482178
5605,409000493210',2018-09-13,Indiaforensic RUPAY STL INTC1209,65.58,0.0,4610280.080000004,2018,9,13,PAYEMENT,65.58,M796240305
5606,409000493210',2018-09-13,Indiaforensic  RUPAY SETT 130918,4999.66,0.0,4605280.420000004,2018,9,13,CASH_OUT,4999.66,M1470726905
5607,409000493210',2018-09-13,Indiaforensic  RUPAY SETT 130918,0.0,46.21,4605326.630000004,2018,9,13,TRANSFER,46.21,M459930631
5608,409000493210',2018-09-13,Indiaforensic RUPAY STL INTC1309,46.21,0.0,4605280.420000004,2018,9,13,PAYEMENT,46.21,M38659643
5609,409000493210',2018-09-13,Indiaforensic  RUPAY SETT 130918,922.07,0.0,4604358.350000003,2018,9,13,CASH_OUT,922.07,M1357927175
5610,409000493210',2018-09-13,Indiaforensic  RUPAY SETT 130918,0.0,5.0,4604363.350000003,2018,9,13,CASH_IN,5.0,M1683834425
5611,409000493210',2018-09-13,Indiaforensic RUPAY STL INTC1309,5.0,0.0,4604358.350000003,2018,9,13,PAYEMENT,5.0,M1523843460
5612,409000493210',2018-09-14,Indiaforensic  RUPAY SETT 140918,3386.53,0.0,4600971.820000003,2018,9,14,DEBIT,3386.53,M1027286826
5613,409000493210',2018-09-14,Indiaforensic  RUPAY SETT 140918,0.0,47.79,4601019.610000003,2018,9,14,CHECK_CASHING,47.79,M1066437568
5614,409000493210',2018-09-14,Indiaforensic RUPAY STL INTC1409,37.79,0.0,4600981.820000003,2018,9,14,CASH_OUT,37.79,C1129670968
5615,409000493210',2018-09-14,Indiaforensic RUPAY STL INTC1409,0.0,0.16,4600981.980000003,2018,9,14,TRANSFER,0.16,M1887389255
5616,409000493210',2018-09-14,Indiaforensic  RUPAY SETT 140918,190.71,0.0,4600791.270000003,2018,9,14,CHECK_WITHDRAWAL,190.71,M1425241044
5617,409000493210',2018-09-14,Indiaforensic  RUPAY SETT 140918,0.0,0.95,4600792.220000003,2018,9,14,TRANSFER,0.95,M378838522
5618,409000493210',2018-09-14,Indiaforensic RUPAY STL INTC1409,0.95,0.0,4600791.270000003,2018,9,14,CHECK_WITHDRAWAL,0.95,M1120917396
5619,409000493210',2018-09-14,TRF FRM  Indiaforensic SERVICES,0.0,162000.0,4762791.270000003,2018,9,14,CASH_IN,162000.0,M1908321704
5620,409000493210',2018-09-14,Indiaforensic NFS SETT 12-09-201,10000.0,0.0,4752791.270000003,2018,9,14,CHECK_WITHDRAWAL,10000.0,M725291300
5621,409000493210',2018-09-14,Indiaforensic NFS SETT 12-09-201,8000.0,0.0,4744791.270000003,2018,9,14,CASH_OUT,8000.0,M1350518777
5622,409000493210',2018-09-14,Indiaforensic NFS SETT 12-09-201,500.0,0.0,4744291.270000003,2018,9,14,DEBIT,500.0,M340017397
5623,409000493210',2018-09-14,Indiaforensic NFS SETT 12-09-201,8000.0,0.0,4736291.270000003,2018,9,14,PAYEMENT,8000.0,M688392165
5624,409000493210',2018-09-14,Indiaforensic NFS SETT 12-09-201,8500.0,0.0,4727791.270000003,2018,9,14,CHECK_WITHDRAWAL,8500.0,C667346055
5625,409000493210',2018-09-14,Indiaforensic NFS SETT 12-09-201,400.0,0.0,4727391.270000003,2018,9,14,PAYEMENT,400.0,C1668376627
5626,409000493210',2018-09-14,Indiaforensic NFS SETT 12-09-201,8000.0,0.0,4719391.270000003,2018,9,14,CASH_OUT,8000.0,C803116137
5627,409000493210',2018-09-14,Indiaforensic NFS SETT 12-09-201,10000.0,0.0,4709391.270000003,2018,9,14,DEBIT,10000.0,C1838584624
5628,409000493210',2018-09-14,Indiaforensic NFS SETT 12-09-201,800.0,0.0,4708591.270000003,2018,9,14,DEBIT,800.0,C1838584624
5629,409000493210',2018-09-14,Indiaforensic NFS SETT 12-09-201,5000.0,0.0,4703591.270000003,2018,9,14,PAYEMENT,5000.0,C1590550415
5630,409000493210',2018-09-14,Indiaforensic NFS SETT 12-09-201,500.0,0.0,4703091.270000003,2018,9,14,CASH_OUT,500.0,C1983747920
5631,409000493210',2018-09-14,Indiaforensic NFS SETT 12-09-201,3000.0,0.0,4700091.270000003,2018,9,14,CHECK_WITHDRAWAL,3000.0,C909295153
5632,409000493210',2018-09-14,Indiaforensic NFS SETT 12-09-201,1000.0,0.0,4699091.270000003,2018,9,14,CASH_OUT,1000.0,C1922859107
5633,409000493210',2018-09-14,Indiaforensic NFS SETT 12-09-201,8000.0,0.0,4691091.270000003,2018,9,14,DEBIT,8000.0,C1838584624
5634,409000493210',2018-09-14,Indiaforensic NFS SETT 12-09-201,1000.0,0.0,4690091.270000003,2018,9,14,CHECK_WITHDRAWAL,1000.0,C1360767589
5635,409000493210',2018-09-14,Indiaforensic NFS SETT 12-09-201,1000.0,0.0,4689091.270000003,2018,9,14,DEBIT,1000.0,C657736958
5636,409000493210',2018-09-14,Indiaforensic NFS SETT 12-09-201,3000.0,0.0,4686091.270000003,2018,9,14,CHECK_WITHDRAWAL,3000.0,C1632716597
5637,409000493210',2018-09-14,Indiaforensic NFS SETT 12-09-201,400.0,0.0,4685691.270000003,2018,9,14,DEBIT,400.0,M883110723
5638,409000493210',2018-09-14,Indiaforensic NFS SETT 12-09-201,7000.0,0.0,4678691.270000003,2018,9,14,CHECK_WITHDRAWAL,7000.0,M1167987211
5639,409000493210',2018-09-14,Indiaforensic NFS SETT 12-09-201,8000.0,0.0,4670691.270000003,2018,9,14,PAYEMENT,8000.0,M574790161
5640,409000493210',2018-09-14,Indiaforensic NFS SETT 12-09-201,200.0,0.0,4670491.270000003,2018,9,14,PAYEMENT,200.0,M660144865
5641,409000493210',2018-09-14,Indiaforensic NFS SETT 12-09-201,8000.0,0.0,4662491.270000003,2018,9,14,DEBIT,8000.0,M719068804
5642,409000493210',2018-09-14,Indiaforensic NFS SETT 13-09-201,4000.0,0.0,4658491.270000003,2018,9,14,CASH_OUT,4000.0,M1169734591
5643,409000493210',2018-09-14,Indiaforensic NFS SETT 13-09-201,600.0,0.0,4657891.270000003,2018,9,14,CASH_OUT,600.0,M1469217737
5644,409000493210',2018-09-14,Indiaforensic NFS SETT 13-09-201,1500.0,0.0,4656391.270000003,2018,9,14,CHECK_WITHDRAWAL,1500.0,M853264965
5645,409000493210',2018-09-14,Indiaforensic NFS SETT 13-09-201,1500.0,0.0,4654891.270000003,2018,9,14,CHECK_WITHDRAWAL,1500.0,M1749755575
5646,409000493210',2018-09-14,Indiaforensic NFS SETT 13-09-201,500.0,0.0,4654391.270000003,2018,9,14,DEBIT,500.0,C560041895
5647,409000493210',2018-09-14,Indiaforensic NFS SETT 13-09-201,500.0,0.0,4653891.270000003,2018,9,14,CASH_OUT,500.0,M2006056784
5648,409000493210',2018-09-14,Indiaforensic NFS SETT 13-09-201,2000.0,0.0,4651891.270000003,2018,9,14,PAYEMENT,2000.0,M1432888450
5649,409000493210',2018-09-14,Indiaforensic NFS SETT 13-09-201,500.0,0.0,4651391.270000003,2018,9,14,CHECK_WITHDRAWAL,500.0,M2040509534
5650,409000493210',2018-09-14,Indiaforensic NFS SETT 13-09-201,400.0,0.0,4650991.270000003,2018,9,14,CHECK_WITHDRAWAL,400.0,C1085479446
5651,409000493210',2018-09-14,Indiaforensic NFS SETT 13-09-201,3000.0,0.0,4647991.270000003,2018,9,14,PAYEMENT,3000.0,M1061774578
5652,409000493210',2018-09-14,Indiaforensic NFS SETT 13-09-201,200.0,0.0,4647791.270000003,2018,9,14,CHECK_WITHDRAWAL,200.0,M698133256
5653,409000493210',2018-09-14,Indiaforensic NFS SETT 13-09-201,5000.0,0.0,4642791.270000003,2018,9,14,CASH_OUT,5000.0,M409957428
5654,409000493210',2018-09-14,Indiaforensic NFS SETT 13-09-201,5000.0,0.0,4637791.270000003,2018,9,14,CHECK_WITHDRAWAL,5000.0,M1878814375
5655,409000493210',2018-09-14,Indiaforensic NFS SETT 13-09-201,5000.0,0.0,4632791.270000003,2018,9,14,CASH_OUT,5000.0,M1341785997
5656,409000493210',2018-09-14,Indiaforensic NFS SETT 13-09-201,6000.0,0.0,4626791.270000003,2018,9,14,CASH_OUT,6000.0,M1109622904
5657,409000493210',2018-09-14,Indiaforensic NFS SETT 13-09-201,5000.0,0.0,4621791.270000003,2018,9,14,DEBIT,5000.0,M1241385933
5658,409000493210',2018-09-14,Indiaforensic NFS SETT 13-09-201,4000.0,0.0,4617791.270000003,2018,9,14,DEBIT,4000.0,M1810419227
5659,409000493210',2018-09-14,Indiaforensic NFS SETT 13-09-201,9000.0,0.0,4608791.270000003,2018,9,14,CASH_OUT,9000.0,M964301023
5660,409000493210',2018-09-14,Indiaforensic NFS SETT 13-09-201,1500.0,0.0,4607291.270000003,2018,9,14,PAYEMENT,1500.0,M337509625
5661,409000493210',2018-09-14,Indiaforensic NFS SETT 13-09-201,5500.0,0.0,4601791.270000003,2018,9,14,CASH_OUT,5500.0,M1676585156
5662,409000493210',2018-09-14,Indiaforensic NFS SETT 13-09-201,100.0,0.0,4601691.270000003,2018,9,14,DEBIT,100.0,M1645449962
5663,409000493210',2018-09-15,Indiaforensic  RUPAY SETT 150918,8745.61,0.0,4592945.660000003,2018,9,15,PAYEMENT,8745.61,M602694575
5664,409000493210',2018-09-15,Indiaforensic  RUPAY SETT 150918,0.0,111.08,4593056.740000003,2018,9,15,CASH_IN,111.08,M1459038473
5665,409000493210',2018-09-15,Indiaforensic RUPAY STL INTC1509,106.58,0.0,4592950.160000003,2018,9,15,DEBIT,106.58,M832152066
5666,409000493210',2018-09-15,Indiaforensic RUPAY STL INTC1509,0.0,0.02,4592950.1800000025,2018,9,15,CASH_IN,0.02,M500580931
5667,409000493210',2018-09-15,Indiaforensic  RUPAY SETT 150918,1027.14,0.0,4591923.040000003,2018,9,15,PAYEMENT,1027.14,M1376533963
5668,409000493210',2018-09-15,Indiaforensic  RUPAY SETT 150918,0.0,13.4,4591936.440000003,2018,9,15,CHECK_CASHING,13.4,M993293369
5669,409000493210',2018-09-15,Indiaforensic RUPAY STL INTC1509,10.68,0.0,4591925.7600000035,2018,9,15,CHECK_WITHDRAWAL,10.68,C1721246982
5670,409000493210',2018-09-15,Indiaforensic RUPAY STL INTC1509,0.0,0.02,4591925.780000003,2018,9,15,CASH_IN,0.02,C1590550415
5671,409000493210',2018-09-15,Indiaforensic NFS SETT 14-09-201,4000.0,0.0,4587925.780000003,2018,9,15,DEBIT,4000.0,C997608398
5672,409000493210',2018-09-15,Indiaforensic NFS SETT 14-09-201,5000.0,0.0,4582925.780000003,2018,9,15,PAYEMENT,5000.0,C1167066016
5673,409000493210',2018-09-15,Indiaforensic NFS SETT 14-09-201,2500.0,0.0,4580425.780000003,2018,9,15,CHECK_WITHDRAWAL,2500.0,C145693769
5674,409000493210',2018-09-15,Indiaforensic NFS SETT 14-09-201,8000.0,0.0,4572425.780000003,2018,9,15,PAYEMENT,8000.0,C1829344035
5675,409000493210',2018-09-15,Indiaforensic NFS SETT 14-09-201,9000.0,0.0,4563425.780000003,2018,9,15,CASH_OUT,9000.0,C769342184
5676,409000493210',2018-09-15,Indiaforensic NFS SETT 14-09-201,1000.0,0.0,4562425.780000003,2018,9,15,DEBIT,1000.0,C90250170
5677,409000493210',2018-09-15,Indiaforensic NFS SETT 14-09-201,6000.0,0.0,4556425.780000003,2018,9,15,DEBIT,6000.0,C1590550415
5678,409000493210',2018-09-15,Indiaforensic NFS SETT 14-09-201,400.0,0.0,4556025.780000003,2018,9,15,PAYEMENT,400.0,C1899073220
5679,409000493210',2018-09-15,Indiaforensic NFS SETT 14-09-201,1000.0,0.0,4555025.780000003,2018,9,15,CASH_OUT,1000.0,C248609774
5680,409000493210',2018-09-15,Indiaforensic NFS SETT 14-09-201,200.0,0.0,4554825.780000003,2018,9,15,CHECK_WITHDRAWAL,200.0,C1636786811
5681,409000493210',2018-09-15,Indiaforensic NFS SETT 14-09-201,100.0,0.0,4554725.780000003,2018,9,15,CHECK_WITHDRAWAL,100.0,C1339858954
5682,409000493210',2018-09-15,Indiaforensic NFS SETT 14-09-201,5600.0,0.0,4549125.780000003,2018,9,15,CHECK_WITHDRAWAL,5600.0,C769342184
5683,409000493210',2018-09-15,Indiaforensic NFS SETT 14-09-201,5500.0,0.0,4543625.780000003,2018,9,15,PAYEMENT,5500.0,C701692548
5684,409000493210',2018-09-15,Indiaforensic NFS SETT 14-09-201,7000.0,0.0,4536625.780000003,2018,9,15,DEBIT,7000.0,C787033725
5685,409000493210',2018-09-15,Indiaforensic NFS SETT 14-09-201,4000.0,0.0,4532625.780000003,2018,9,15,DEBIT,4000.0,C1183572822
5686,409000493210',2018-09-15,Indiaforensic NFS SETT 14-09-201,8000.0,0.0,4524625.780000003,2018,9,15,DEBIT,8000.0,C1789550256
5687,409000493210',2018-09-15,Indiaforensic NFS SETT 14-09-201,100.0,0.0,4524525.780000003,2018,9,15,DEBIT,100.0,C1477979030
5688,409000493210',2018-09-15,Indiaforensic NFS SETT 14-09-201,100.0,0.0,4524425.780000003,2018,9,15,CHECK_WITHDRAWAL,100.0,C1926673338
5689,409000493210',2018-09-15,Indiaforensic NFS SETT 14-09-201,400.0,0.0,4524025.780000003,2018,9,15,PAYEMENT,400.0,C1246439562
5690,409000493210',2018-09-15,Indiaforensic NFS SETT 14-09-201,5000.0,0.0,4519025.780000003,2018,9,15,PAYEMENT,5000.0,C1750563752
5691,409000493210',2018-09-15,Indiaforensic NFS SETT 14-09-201,4000.0,0.0,4515025.780000003,2018,9,15,CHECK_WITHDRAWAL,4000.0,C1396827930
5692,409000493210',2018-09-15,Indiaforensic NFS SETT 14-09-201,2000.0,0.0,4513025.780000003,2018,9,15,DEBIT,2000.0,C665576141
5693,409000493210',2018-09-15,Indiaforensic NFS SETT 14-09-201,1100.0,0.0,4511925.780000003,2018,9,15,DEBIT,1100.0,C306206744
5694,409000493210',2018-09-15,Indiaforensic NFS SETT 14-09-201,1500.0,0.0,4510425.780000003,2018,9,15,CHECK_WITHDRAWAL,1500.0,C911998047
5695,409000493210',2018-09-15,Indiaforensic NFS SETT 14-09-201,200.0,0.0,4510225.780000003,2018,9,15,CHECK_WITHDRAWAL,200.0,C766681183
5696,409000493210',2018-09-15,Indiaforensic NFS SETT 14-09-201,1000.0,0.0,4509225.780000003,2018,9,15,CHECK_WITHDRAWAL,1000.0,C977993101
5697,409000493210',2018-09-15,Indiaforensic NFS SETT 14-09-201,6000.0,0.0,4503225.780000003,2018,9,15,DEBIT,6000.0,C644345897
5698,409000493210',2018-09-15,Indiaforensic NFS SETT 14-09-201,100.0,0.0,4503125.780000003,2018,9,15,CASH_OUT,100.0,M1845590352
5699,409000493210',2018-09-15,Indiaforensic NFS SETT 14-09-201,7000.0,0.0,4496125.780000003,2018,9,15,DEBIT,7000.0,C1814361629
5700,409000493210',2018-09-15,Indiaforensic NFS SETT 14-09-201,500.0,0.0,4495625.780000003,2018,9,15,CHECK_WITHDRAWAL,500.0,M1878782124
5701,409000493210',2018-09-15,Indiaforensic NFS SETT 14-09-201,10000.0,0.0,4485625.780000003,2018,9,15,CHECK_WITHDRAWAL,10000.0,M595239111
5702,409000493210',2018-09-15,Indiaforensic NFS SETT 14-09-201,3000.0,0.0,4482625.780000003,2018,9,15,PAYEMENT,3000.0,M725617616
5703,409000493210',2018-09-15,Indiaforensic NFS SETT 14-09-201,10000.0,0.0,4472625.780000003,2018,9,15,DEBIT,10000.0,M2034523899
5704,409000493210',2018-09-15,Indiaforensic NFS SETT 14-09-201,10000.0,0.0,4462625.780000003,2018,9,15,CHECK_WITHDRAWAL,10000.0,C1297685781
5705,409000493210',2018-09-15,Indiaforensic NFS SETT 14-09-201,10000.0,0.0,4452625.780000003,2018,9,15,PAYEMENT,10000.0,M1145680499
5706,409000493210',2018-09-15,Indiaforensic NFS SETT 14-09-201,1000.0,0.0,4451625.780000003,2018,9,15,CHECK_WITHDRAWAL,1000.0,M496751062
5707,409000493210',2018-09-15,Indiaforensic NFS SETT 14-09-201,9000.0,0.0,4442625.780000003,2018,9,15,DEBIT,9000.0,M293583290
5708,409000493210',2018-09-17,Indiaforensic RUPAY SETT 160918,3832.92,0.0,4438792.860000003,2018,9,17,CASH_OUT,3832.92,M1105700164
5709,409000493210',2018-09-17,Indiaforensic RUPAY SETT 160918,0.0,45.13,4438837.990000003,2018,9,17,TRANSFER,45.13,M1463316683
5710,409000493210',2018-09-17,Indiaforensic RUPAY STL INTC1609,44.38,0.0,4438793.610000003,2018,9,17,CASH_OUT,44.38,M658107584
5711,409000493210',2018-09-17,Indiaforensic RUPAY SETT 170918,5738.35,0.0,4433055.2600000035,2018,9,17,CASH_OUT,5738.35,M1033400986
5712,409000493210',2018-09-17,Indiaforensic RUPAY SETT 170918,0.0,60.7,4433115.960000004,2018,9,17,TRANSFER,60.7,M1271012916
5713,409000493210',2018-09-17,Indiaforensic RUPAY STL INTC1709,58.97,0.0,4433056.990000004,2018,9,17,CASH_OUT,58.97,M196511386
5714,409000493210',2018-09-17,Indiaforensic RUPAY STL INTC1709,0.0,0.01,4433057.000000004,2018,9,17,TRANSFER,0.01,M1592671657
5715,409000493210',2018-09-17,Indiaforensic  RUPAY SETT 170918,3257.0,0.0,4429800.000000004,2018,9,17,PAYEMENT,3257.0,M896786845
5716,409000493210',2018-09-17,Indiaforensic  RUPAY SETT 170918,0.0,26.66,4429826.660000004,2018,9,17,CASH_IN,26.66,M711834492
5717,409000493210',2018-09-17,Indiaforensic RUPAY STL INTC1709,26.66,0.0,4429800.000000004,2018,9,17,CHECK_WITHDRAWAL,26.66,M2066569446
5718,409000493210',2018-09-17,Indiaforensic NFS SETT 15-09-201,10000.0,0.0,4419800.000000004,2018,9,17,CASH_OUT,10000.0,M931041456
5719,409000493210',2018-09-17,Indiaforensic NFS SETT 15-09-201,10000.0,0.0,4409800.000000004,2018,9,17,CHECK_WITHDRAWAL,10000.0,M919541414
5720,409000493210',2018-09-17,Indiaforensic NFS SETT 15-09-201,200.0,0.0,4409600.000000004,2018,9,17,CASH_OUT,200.0,M2129636512
5721,409000493210',2018-09-17,Indiaforensic NFS SETT 15-09-201,6000.0,0.0,4403600.000000004,2018,9,17,PAYEMENT,6000.0,M871019240
5722,409000493210',2018-09-17,Indiaforensic NFS SETT 15-09-201,7500.0,0.0,4396100.000000004,2018,9,17,PAYEMENT,7500.0,M926303796
5723,409000493210',2018-09-17,Indiaforensic NFS SETT 15-09-201,400.0,0.0,4395700.000000004,2018,9,17,CASH_OUT,400.0,M1542975839
5724,409000493210',2018-09-17,Indiaforensic NFS SETT 15-09-201,1000.0,0.0,4394700.000000004,2018,9,17,DEBIT,1000.0,M288398804
5725,409000493210',2018-09-17,Indiaforensic NFS SETT 15-09-201,5500.0,0.0,4389200.000000004,2018,9,17,PAYEMENT,5500.0,M735344652
5726,409000493210',2018-09-17,Indiaforensic NFS SETT 15-09-201,5500.0,0.0,4383700.000000004,2018,9,17,CASH_OUT,5500.0,M962507619
5727,409000493210',2018-09-17,Indiaforensic NFS SETT 15-09-201,7000.0,0.0,4376700.000000004,2018,9,17,CASH_OUT,7000.0,M369444529
5728,409000493210',2018-09-17,Indiaforensic NFS SETT 15-09-201,5000.0,0.0,4371700.000000004,2018,9,17,CHECK_WITHDRAWAL,5000.0,M1547112627
5729,409000493210',2018-09-17,Indiaforensic NFS SETT 15-09-201,700.0,0.0,4371000.000000004,2018,9,17,CASH_OUT,700.0,M884858691
5730,409000493210',2018-09-17,Indiaforensic NFS SETT 15-09-201,500.0,0.0,4370500.000000004,2018,9,17,CHECK_WITHDRAWAL,500.0,M861255935
5731,409000493210',2018-09-17,Indiaforensic NFS SETT 15-09-201,500.0,0.0,4370000.000000004,2018,9,17,PAYEMENT,500.0,M1761208327
5732,409000493210',2018-09-17,Indiaforensic NFS SETT 15-09-201,5000.0,0.0,4365000.000000004,2018,9,17,DEBIT,5000.0,M1039948229
5733,409000493210',2018-09-17,Indiaforensic NFS SETT 15-09-201,400.0,0.0,4364600.000000004,2018,9,17,CHECK_WITHDRAWAL,400.0,M190920427
5734,409000493210',2018-09-17,Indiaforensic NFS SETT 15-09-201,10000.0,0.0,4354600.000000004,2018,9,17,PAYEMENT,10000.0,M1931691665
5735,409000493210',2018-09-17,Indiaforensic NFS SETT 15-09-201,200.0,0.0,4354400.000000004,2018,9,17,PAYEMENT,200.0,M655068202
5736,409000493210',2018-09-17,Indiaforensic NFS SETT 15-09-201,7000.0,0.0,4347400.000000004,2018,9,17,CHECK_WITHDRAWAL,7000.0,C1531333864
5737,409000493210',2018-09-17,Indiaforensic NFS SETT 15-09-201,200.0,0.0,4347200.000000004,2018,9,17,CASH_OUT,200.0,M1315022947
5738,409000493210',2018-09-17,Indiaforensic NFS SETT 16-09-201,8000.0,0.0,4339200.000000004,2018,9,17,DEBIT,8000.0,M803904123
5739,409000493210',2018-09-17,Indiaforensic NFS SETT 16-09-201,1000.0,0.0,4338200.000000004,2018,9,17,DEBIT,1000.0,M1774316039
5740,409000493210',2018-09-17,Indiaforensic NFS SETT 16-09-201,1000.0,0.0,4337200.000000004,2018,9,17,DEBIT,1000.0,M670827031
5741,409000493210',2018-09-17,Indiaforensic NFS SETT 16-09-201,7000.0,0.0,4330200.000000004,2018,9,17,CASH_OUT,7000.0,M1752069395
5742,409000493210',2018-09-17,Indiaforensic NFS SETT 16-09-201,1000.0,0.0,4329200.000000004,2018,9,17,DEBIT,1000.0,M12691277
5743,409000493210',2018-09-17,Indiaforensic NFS SETT 16-09-201,400.0,0.0,4328800.000000004,2018,9,17,CASH_OUT,400.0,M1559898821
5744,409000493210',2018-09-17,Indiaforensic NFS SETT 16-09-201,8000.0,0.0,4320800.000000004,2018,9,17,DEBIT,8000.0,C127252077
5745,409000493210',2018-09-17,Indiaforensic NFS SETT 16-09-201,5000.0,0.0,4315800.000000004,2018,9,17,DEBIT,5000.0,M1042853700
5746,409000493210',2018-09-17,Indiaforensic NFS SETT 16-09-201,5000.0,0.0,4310800.000000004,2018,9,17,CHECK_WITHDRAWAL,5000.0,C41792607
5747,409000493210',2018-09-18,Indiaforensic  RUPAY SETT 180918,3015.8,0.0,4307784.200000004,2018,9,18,CHECK_WITHDRAWAL,3015.8,C451934410
5748,409000493210',2018-09-18,Indiaforensic  RUPAY SETT 180918,0.0,37.38,4307821.580000004,2018,9,18,TRANSFER,37.38,M1954689180
5749,409000493210',2018-09-18,Indiaforensic RUPAY STL INTC1809,37.38,0.0,4307784.200000004,2018,9,18,DEBIT,37.38,C1675375648
5750,409000493210',2018-09-18,Indiaforensic NFS SETT 17-09-201,2000.0,0.0,4305784.200000004,2018,9,18,CASH_OUT,2000.0,M992309406
5751,409000493210',2018-09-18,Indiaforensic NFS SETT 17-09-201,100.0,0.0,4305684.200000004,2018,9,18,CASH_OUT,100.0,M1073819729
5752,409000493210',2018-09-18,Indiaforensic NFS SETT 17-09-201,9000.0,0.0,4296684.200000004,2018,9,18,DEBIT,9000.0,M1631826609
5753,409000493210',2018-09-18,Indiaforensic NFS SETT 17-09-201,2500.0,0.0,4294184.200000004,2018,9,18,CHECK_WITHDRAWAL,2500.0,M1126780571
5754,409000493210',2018-09-18,Indiaforensic NFS SETT 17-09-201,500.0,0.0,4293684.200000004,2018,9,18,CHECK_WITHDRAWAL,500.0,M1517860139
5755,409000493210',2018-09-18,Indiaforensic  RUPAY SETT 180918,404.11,0.0,4293280.090000004,2018,9,18,CASH_OUT,404.11,M1124055734
5756,409000493210',2018-09-18,Indiaforensic  RUPAY SETT 180918,0.0,172.2,4293452.290000004,2018,9,18,CHECK_CASHING,172.2,M1773970438
5757,409000493210',2018-09-18,Indiaforensic RUPAY STL INTC1809,4.2,0.0,4293448.090000004,2018,9,18,CASH_OUT,4.2,C97730845
5758,409000493210',2018-09-18,Indiaforensic RUPAY STL INTC1809,0.0,2.69,4293450.780000004,2018,9,18,TRANSFER,2.69,C451111351
5759,409000493210',2018-09-19,Indiaforensic  RUPAY SETT 190918,35590.25,0.0,4257860.530000004,2018,9,19,CASH_OUT,35590.25,C202149782
5760,409000493210',2018-09-19,Indiaforensic RUPAY STL INTC1909,275.18,0.0,4257585.350000003,2018,9,19,PAYEMENT,275.18,C1816757085
5761,409000493210',2018-09-19,Indiaforensic  RUPAY SETT 190918,0.0,275.18,4257860.530000004,2018,9,19,TRANSFER,275.18,C1303868418
5762,409000493210',2018-09-19,Indiaforensic NFS SETT 18-09-201,500.0,0.0,4257360.530000004,2018,9,19,DEBIT,500.0,C1129670968
5763,409000493210',2018-09-19,Indiaforensic NFS SETT 18-09-201,6000.0,0.0,4251360.530000004,2018,9,19,DEBIT,6000.0,C1475395523
5764,409000493210',2018-09-19,Indiaforensic NFS SETT 18-09-201,10000.0,0.0,4241360.530000004,2018,9,19,CHECK_WITHDRAWAL,10000.0,C1789550256
5765,409000493210',2018-09-19,Indiaforensic NFS SETT 18-09-201,1000.0,0.0,4240360.530000004,2018,9,19,CHECK_WITHDRAWAL,1000.0,C1636786811
5766,409000493210',2018-09-19,Indiaforensic NFS SETT 18-09-201,5000.0,0.0,4235360.530000004,2018,9,19,DEBIT,5000.0,C1778801068
5767,409000493210',2018-09-19,Indiaforensic NFS SETT 18-09-201,200.0,0.0,4235160.530000004,2018,9,19,CASH_OUT,200.0,C657736958
5768,409000493210',2018-09-19,Indiaforensic NFS SETT 18-09-201,1500.0,0.0,4233660.530000004,2018,9,19,CHECK_WITHDRAWAL,1500.0,C716083600
5769,409000493210',2018-09-19,Indiaforensic NFS SETT 18-09-201,10000.0,0.0,4223660.530000004,2018,9,19,CASH_OUT,10000.0,C252760149
5770,409000493210',2018-09-19,Indiaforensic NFS SETT 18-09-201,200.0,0.0,4223460.530000004,2018,9,19,PAYEMENT,200.0,C1167066016
5771,409000493210',2018-09-19,Indiaforensic NFS SETT 18-09-201,200.0,0.0,4223260.530000004,2018,9,19,DEBIT,200.0,C194746285
5772,409000493210',2018-09-19,Indiaforensic NFS SETT 18-09-201,1500.0,0.0,4221760.530000004,2018,9,19,PAYEMENT,1500.0,C697172013
5773,409000493210',2018-09-19,Indiaforensic NFS SETT 18-09-201,5000.0,0.0,4216760.530000004,2018,9,19,DEBIT,5000.0,C1013700132
5774,409000493210',2018-09-19,Indiaforensic NFS SETT 18-09-201,400.0,0.0,4216360.530000004,2018,9,19,DEBIT,400.0,C766681183
5775,409000493210',2018-09-19,Indiaforensic NFS SETT 18-09-201,300.0,0.0,4216060.530000004,2018,9,19,CHECK_WITHDRAWAL,300.0,C1675375648
5776,409000493210',2018-09-19,Indiaforensic NFS SETT 18-09-201,400.0,0.0,4215660.530000004,2018,9,19,PAYEMENT,400.0,C380242442
5777,409000493210',2018-09-19,Indiaforensic  RUPAY SETT 190918,5563.25,0.0,4210097.280000004,2018,9,19,DEBIT,5563.25,C1899073220
5778,409000493210',2018-09-19,Indiaforensic  RUPAY SETT 190918,0.0,69.93,4210167.210000004,2018,9,19,CHECK_CASHING,69.93,C1360767589
5779,409000493210',2018-09-19,Indiaforensic RUPAY STL INTC1909,69.93,0.0,4210097.280000004,2018,9,19,CHECK_WITHDRAWAL,69.93,C1360767589
5780,409000493210',2018-09-20,Indiaforensic RUPAY SETT 200918,2505.54,0.0,4207591.740000004,2018,9,20,PAYEMENT,2505.54,C1892646174
5781,409000493210',2018-09-20,Indiaforensic RUPAY SETT 200918,0.0,43.74,4207635.480000004,2018,9,20,TRANSFER,43.74,C1094528209
5782,409000493210',2018-09-20,Indiaforensic RUPAY STL INTC2009,28.24,0.0,4207607.240000004,2018,9,20,DEBIT,28.24,C1816757085
5783,409000493210',2018-09-20,Indiaforensic RUPAY STL INTC2009,0.0,0.12,4207607.360000004,2018,9,20,CHECK_CASHING,0.12,C1504109395
5784,409000493210',2018-09-20,Indiaforensic RUPAY SETT 200918-,682.12,0.0,4206925.240000004,2018,9,20,CASH_OUT,682.12,C932583850
5785,409000493210',2018-09-20,Indiaforensic RUPAY SETT 200918-,0.0,6.4,4206931.640000003,2018,9,20,TRANSFER,6.4,C1816757085
5786,409000493210',2018-09-20,Indiaforensic RUPAY STL INTC2009,6.4,0.0,4206925.240000004,2018,9,20,CASH_OUT,6.4,C803116137
5787,409000493210',2018-09-21,Indiaforensic RUPAY SETT 210918,1084.47,0.0,4205840.770000004,2018,9,21,DEBIT,1084.47,C803116137
5788,409000493210',2018-09-21,Indiaforensic RUPAY SETT 210918,0.0,269.03,4206109.800000005,2018,9,21,CASH_IN,269.03,C1590550415
5789,409000493210',2018-09-21,Indiaforensic RUPAY STL INTC2109,10.21,0.0,4206099.590000005,2018,9,21,CASH_OUT,10.21,C1668376627
5790,409000493210',2018-09-21,Indiaforensic RUPAY STL INTC2109,0.0,1.93,4206101.520000004,2018,9,21,CASH_IN,1.93,C905650857
5791,409000493210',2018-09-21,Indiaforensic RUPAY SETT 210918-,303.97,0.0,4205797.550000005,2018,9,21,CHECK_WITHDRAWAL,303.97,C1721246982
5792,409000493210',2018-09-21,Indiaforensic RUPAY SETT 210918-,0.0,4.72,4205802.270000004,2018,9,21,CASH_IN,4.72,C1590550415
5793,409000493210',2018-09-21,Indiaforensic RUPAY STL INTC2109,4.72,0.0,4205797.550000005,2018,9,21,CASH_OUT,4.72,C173783788
5794,409000493210',2018-09-21,Indiaforensic NFS SETT 19-09-201,1500.0,0.0,4204297.550000005,2018,9,21,CHECK_WITHDRAWAL,1500.0,C1235151206
5795,409000493210',2018-09-21,Indiaforensic NFS SETT 19-09-201,500.0,0.0,4203797.550000005,2018,9,21,DEBIT,500.0,C399685190
5796,409000493210',2018-09-21,Indiaforensic NFS SETT 19-09-201,5000.0,0.0,4198797.550000005,2018,9,21,CASH_OUT,5000.0,C54617902
5797,409000493210',2018-09-21,Indiaforensic NFS SETT 19-09-201,500.0,0.0,4198297.550000005,2018,9,21,CHECK_WITHDRAWAL,500.0,C909295153
5798,409000493210',2018-09-21,Indiaforensic NFS SETT 19-09-201,200.0,0.0,4198097.550000005,2018,9,21,DEBIT,200.0,C1782113663
5799,409000493210',2018-09-21,Indiaforensic NFS SETT 20-09-201,2000.0,0.0,4196097.550000005,2018,9,21,CASH_OUT,2000.0,C1820528317
5800,409000493210',2018-09-21,Indiaforensic NFS SETT 20-09-201,9000.0,0.0,4187097.550000005,2018,9,21,CHECK_WITHDRAWAL,9000.0,C665576141
5801,409000493210',2018-09-21,Indiaforensic NFS SETT 20-09-201,3500.0,0.0,4183597.550000005,2018,9,21,CHECK_WITHDRAWAL,3500.0,C1778801068
5802,409000493210',2018-09-21,Indiaforensic NFS SETT 20-09-201,10000.0,0.0,4173597.550000005,2018,9,21,CASH_OUT,10000.0,C1394526584
5803,409000493210',2018-09-21,Indiaforensic NFS SETT 20-09-201,900.0,0.0,4172697.550000005,2018,9,21,DEBIT,900.0,C800281454
5804,409000493210',2018-09-24,Indiaforensic RUPAY SETT 220918,1272.42,0.0,4171425.130000005,2018,9,24,PAYEMENT,1272.42,C1615535645
5805,409000493210',2018-09-24,Indiaforensic RUPAY SETT 220918,0.0,13.98,4171439.110000005,2018,9,24,CHECK_CASHING,13.98,C644345897
5806,409000493210',2018-09-24,Indiaforensic RUPAY STL INTC2209,13.98,0.0,4171425.130000005,2018,9,24,CHECK_WITHDRAWAL,13.98,C985934102
5807,409000493210',2018-09-24,Indiaforensic RUPAY SETT 230918,5732.95,0.0,4165692.180000005,2018,9,24,DEBIT,5732.95,C1880332929
5808,409000493210',2018-09-24,Indiaforensic RUPAY STL INTC2309,55.93,0.0,4165636.2500000037,2018,9,24,DEBIT,55.93,C187019413
5809,409000493210',2018-09-24,Indiaforensic RUPAY SETT 240918,14688.52,0.0,4150947.7300000037,2018,9,24,DEBIT,14688.52,C701692548
5810,409000493210',2018-09-24,Indiaforensic RUPAY STL INTC2409,138.34,0.0,4150809.390000004,2018,9,24,CASH_OUT,138.34,C1926673338
5811,409000493210',2018-09-24,Indiaforensic RUPAY SETT 230918,0.0,55.93,4150865.320000005,2018,9,24,CASH_IN,55.93,M451833108
5812,409000493210',2018-09-24,Indiaforensic RUPAY SETT 240918,0.0,138.34,4151003.660000004,2018,9,24,CHECK_CASHING,138.34,M1551109210
5813,409000493210',2018-09-24,Indiaforensic NFS SETT 21-09-201,1000.0,0.0,4150003.660000004,2018,9,24,CASH_OUT,1000.0,M373158489
5814,409000493210',2018-09-24,Indiaforensic NFS SETT 21-09-201,500.0,0.0,4149503.660000004,2018,9,24,PAYEMENT,500.0,C1134894336
5815,409000493210',2018-09-24,Indiaforensic NFS SETT 21-09-201,200.0,0.0,4149303.660000004,2018,9,24,DEBIT,200.0,M1454854577
5816,409000493210',2018-09-24,Indiaforensic NFS SETT 21-09-201,2000.0,0.0,4147303.660000004,2018,9,24,CASH_OUT,2000.0,C503195940
5817,409000493210',2018-09-24,Indiaforensic NFS SETT 21-09-201,8000.0,0.0,4139303.660000004,2018,9,24,CASH_OUT,8000.0,M95788093
5818,409000493210',2018-09-24,Indiaforensic NFS SETT 22-09-201,1000.0,0.0,4138303.660000004,2018,9,24,DEBIT,1000.0,M1221795109
5819,409000493210',2018-09-24,Indiaforensic NFS SETT 22-09-201,500.0,0.0,4137803.660000004,2018,9,24,PAYEMENT,500.0,M1868931587
5820,409000493210',2018-09-24,Indiaforensic NFS SETT 22-09-201,1000.0,0.0,4136803.660000004,2018,9,24,CASH_OUT,1000.0,M1306613962
5821,409000493210',2018-09-24,Indiaforensic NFS SETT 22-09-201,4000.0,0.0,4132803.660000004,2018,9,24,CHECK_WITHDRAWAL,4000.0,M219679073
5822,409000493210',2018-09-24,Indiaforensic NFS SETT 22-09-201,1500.0,0.0,4131303.660000004,2018,9,24,PAYEMENT,1500.0,M228035257
5823,409000493210',2018-09-24,Indiaforensic NFS SETT 22-09-201,700.0,0.0,4130603.660000004,2018,9,24,CHECK_WITHDRAWAL,700.0,M1911435263
5824,409000493210',2018-09-24,Indiaforensic NFS SETT 22-09-201,2000.0,0.0,4128603.660000004,2018,9,24,CHECK_WITHDRAWAL,2000.0,M939303753
5825,409000493210',2018-09-24,Indiaforensic NFS SETT 23-09-201,100.0,0.0,4128503.660000004,2018,9,24,PAYEMENT,100.0,M141697265
5826,409000493210',2018-09-24,Indiaforensic NFS SETT 23-09-201,1000.0,0.0,4127503.660000004,2018,9,24,CASH_OUT,1000.0,M623742454
5827,409000493210',2018-09-24,Indiaforensic NFS SETT 23-09-201,400.0,0.0,4127103.660000004,2018,9,24,PAYEMENT,400.0,M797917388
5828,409000493210',2018-09-24,Indiaforensic NFS SETT 23-09-201,4000.0,0.0,4123103.660000004,2018,9,24,CHECK_WITHDRAWAL,4000.0,M1574138492
5829,409000493210',2018-09-25,Indiaforensic  RUPAY SETT 250918,2715.07,0.0,4120388.590000005,2018,9,25,PAYEMENT,2715.07,M580695256
5830,409000493210',2018-09-25,Indiaforensic  RUPAY SETT 250918,0.0,31.22,4120419.810000005,2018,9,25,CASH_IN,31.22,M820982507
5831,409000493210',2018-09-25,Indiaforensic RUPAY STL INTC2509,28.22,0.0,4120391.590000005,2018,9,25,CASH_OUT,28.22,M12279709
5832,409000493210',2018-09-25,Indiaforensic RUPAY STL INTC2509,0.0,0.02,4120391.610000005,2018,9,25,CASH_IN,0.02,M1881996254
5833,409000493210',2018-09-25,Indiaforensic NFS SETT 24-09-201,1000.0,0.0,4119391.610000005,2018,9,25,PAYEMENT,1000.0,C1321530272
5834,409000493210',2018-09-25,Indiaforensic NFS SETT 24-09-201,200.0,0.0,4119191.610000005,2018,9,25,DEBIT,200.0,C878506901
5835,409000493210',2018-09-25,Indiaforensic NFS SETT 24-09-201,10000.0,0.0,4109191.610000005,2018,9,25,CASH_OUT,10000.0,M471031651
5836,409000493210',2018-09-25,Indiaforensic NFS SETT 24-09-201,10000.0,0.0,4099191.610000005,2018,9,25,CHECK_WITHDRAWAL,10000.0,M700262294
5837,409000493210',2018-09-25,Indiaforensic NFS SETT 24-09-201,5000.0,0.0,4094191.610000005,2018,9,25,DEBIT,5000.0,M287649987
5838,409000493210',2018-09-25,Indiaforensic NFS SETT 24-09-201,4500.0,0.0,4089691.610000005,2018,9,25,CHECK_WITHDRAWAL,4500.0,M894735295
5839,409000493210',2018-09-25,Indiaforensic NFS SETT 24-09-201,200.0,0.0,4089491.610000005,2018,9,25,PAYEMENT,200.0,M1177018330
5840,409000493210',2018-09-25,Indiaforensic NFS SETT 24-09-201,1000.0,0.0,4088491.610000005,2018,9,25,CHECK_WITHDRAWAL,1000.0,M250331355
5841,409000493210',2018-09-25,Indiaforensic NFS SETT 24-09-201,1000.0,0.0,4087491.610000005,2018,9,25,CASH_OUT,1000.0,M1790250268
5842,409000493210',2018-09-25,Indiaforensic NFS SETT 24-09-201,500.0,0.0,4086991.610000005,2018,9,25,PAYEMENT,500.0,C481402298
5843,409000493210',2018-09-25,Indiaforensic  RUPAY SETT 250918,18179.7,0.0,4068811.910000004,2018,9,25,DEBIT,18179.7,C304406966
5844,409000493210',2018-09-25,Indiaforensic  RUPAY SETT 250918,0.0,194.46,4069006.370000004,2018,9,25,CHECK_CASHING,194.46,M1212351214
5845,409000493210',2018-09-25,Indiaforensic RUPAY STL INTC2509,194.46,0.0,4068811.910000004,2018,9,25,CASH_OUT,194.46,M2004981696
5846,409000493210',2018-09-26,TRF FROM  Indiaforensic SERVICES,0.0,171000.0,4239811.910000004,2018,9,26,CHECK_CASHING,171000.0,C478124129
5847,409000493210',2018-09-26,Indiaforensic  RUPAY SETT 260918,2622.56,0.0,4237189.350000003,2018,9,26,DEBIT,2622.56,M567859829
5848,409000493210',2018-09-26,Indiaforensic  RUPAY SETT 260918,0.0,48.99,4237238.340000005,2018,9,26,CHECK_CASHING,48.99,M547964633
5849,409000493210',2018-09-26,Indiaforensic RUPAY STL INTC2609,25.29,0.0,4237213.050000005,2018,9,26,CHECK_WITHDRAWAL,25.29,M1286460628
5850,409000493210',2018-09-26,Indiaforensic RUPAY STL INTC2609,0.0,0.18,4237213.230000004,2018,9,26,CHECK_CASHING,0.18,C1038678108
5851,409000493210',2018-09-26,Indiaforensic  RUPAY SETT 260918,0.04,0.0,4237213.190000004,2018,9,26,CASH_OUT,0.04,M963585828
5852,409000493210',2018-09-26,Indiaforensic  RUPAY SETT 260918,0.0,7.49,4237220.680000003,2018,9,26,CHECK_CASHING,7.49,C1956477953
5853,409000493210',2018-09-26,Indiaforensic RUPAY STL INTC2609,0.0,0.04,4237220.720000003,2018,9,26,CASH_IN,0.04,C256417920
5854,409000493210',2018-09-26,Indiaforensic NFS SETT 25-09-201,2500.0,0.0,4234720.720000003,2018,9,26,DEBIT,2500.0,M429393578
5855,409000493210',2018-09-26,Indiaforensic NFS SETT 25-09-201,400.0,0.0,4234320.720000003,2018,9,26,PAYEMENT,400.0,M262217690
5856,409000493210',2018-09-26,Indiaforensic NFS SETT 25-09-201,500.0,0.0,4233820.720000003,2018,9,26,PAYEMENT,500.0,M2106922602
5857,409000493210',2018-09-26,Indiaforensic NFS SETT 25-09-201,2000.0,0.0,4231820.720000003,2018,9,26,CHECK_WITHDRAWAL,2000.0,M535517293
5858,409000493210',2018-09-26,Indiaforensic NFS SETT 25-09-201,5000.0,0.0,4226820.720000003,2018,9,26,DEBIT,5000.0,M1629105538
5859,409000493210',2018-09-26,Indiaforensic NFS SETT 25-09-201,5600.0,0.0,4221220.720000003,2018,9,26,CASH_OUT,5600.0,M580515543
5860,409000493210',2018-09-26,Indiaforensic NFS SETT 25-09-201,3000.0,0.0,4218220.720000003,2018,9,26,CHECK_WITHDRAWAL,3000.0,M1821462977
5861,409000493210',2018-09-26,Indiaforensic NFS SETT 25-09-201,200.0,0.0,4218020.720000003,2018,9,26,CASH_OUT,200.0,M1106513402
5862,409000493210',2018-09-26,Indiaforensic NFS SETT 25-09-201,10000.0,0.0,4208020.720000003,2018,9,26,DEBIT,10000.0,M1127333424
5863,409000493210',2018-09-26,DIFF OF VIRTUAL VISA EOD,2563478.13,0.0,1644542.5900000043,2018,9,26,CHECK_WITHDRAWAL,2563478.13,M1034769247
5864,409000493210',2018-09-26,TRF FROM  Indiaforensic SERVICES,0.0,129225.0,1773767.5900000043,2018,9,26,CASH_IN,129225.0,C1869400026
5865,409000493210',2018-09-27,Indiaforensic  RUPAY SETT 270918,3909.09,0.0,1769858.5000000044,2018,9,27,DEBIT,3909.09,M1974325564
5866,409000493210',2018-09-27,Indiaforensic  RUPAY SETT 270918,0.0,51.01,1769909.5100000044,2018,9,27,CASH_IN,51.01,M1158484171
5867,409000493210',2018-09-27,Indiaforensic RUPAY STL INTC2709,48.58,0.0,1769860.9300000044,2018,9,27,PAYEMENT,48.58,M6987253
5868,409000493210',2018-09-27,Indiaforensic RUPAY STL INTC2709,0.0,0.01,1769860.9400000044,2018,9,27,CASH_IN,0.01,M1708276387
5869,409000493210',2018-09-27,Indiaforensic  RUPAY SETT 270918,5146.12,0.0,1764714.8200000045,2018,9,27,CASH_OUT,5146.12,M104664717
5870,409000493210',2018-09-27,Indiaforensic  RUPAY SETT 270918,0.0,41.79,1764756.6100000043,2018,9,27,TRANSFER,41.79,M500450241
5871,409000493210',2018-09-27,Indiaforensic RUPAY STL INTC2709,41.79,0.0,1764714.8200000045,2018,9,27,CHECK_WITHDRAWAL,41.79,M1149801201
5872,409000493210',2018-09-27,TRF FROM  Indiaforensic SERVICES,0.0,407100.0,2171814.820000004,2018,9,27,CASH_IN,407100.0,M693317265
5873,409000493210',2018-09-27,Indiaforensic NFS SETT 26-09-201,4000.0,0.0,2167814.820000004,2018,9,27,CHECK_WITHDRAWAL,4000.0,M2130054146
5874,409000493210',2018-09-27,Indiaforensic NFS SETT 26-09-201,10000.0,0.0,2157814.820000004,2018,9,27,CASH_OUT,10000.0,M1829377218
5875,409000493210',2018-09-27,Indiaforensic NFS SETT 26-09-201,600.0,0.0,2157214.820000004,2018,9,27,CHECK_WITHDRAWAL,600.0,M356279811
5876,409000493210',2018-09-27,Indiaforensic NFS SETT 26-09-201,300.0,0.0,2156914.820000004,2018,9,27,PAYEMENT,300.0,M427006214
5877,409000493210',2018-09-27,Indiaforensic NFS SETT 26-09-201,10000.0,0.0,2146914.820000004,2018,9,27,DEBIT,10000.0,C716083600
5878,409000493210',2018-09-27,Indiaforensic NFS SETT 26-09-201,10000.0,0.0,2136914.820000004,2018,9,27,DEBIT,10000.0,C803116137
5879,409000493210',2018-09-27,Indiaforensic NFS SETT 26-09-201,2000.0,0.0,2134914.820000004,2018,9,27,CHECK_WITHDRAWAL,2000.0,C2083562754
5880,409000493210',2018-09-27,Indiaforensic NFS SETT 26-09-201,9000.0,0.0,2125914.820000004,2018,9,27,CASH_OUT,9000.0,C1636786811
5881,409000493210',2018-09-27,Indiaforensic NFS SETT 26-09-201,100.0,0.0,2125814.820000004,2018,9,27,CASH_OUT,100.0,C1360767589
5882,409000493210',2018-09-27,Indiaforensic NFS SETT 26-09-201,1000.0,0.0,2124814.820000004,2018,9,27,CASH_OUT,1000.0,C451111351
5883,409000493210',2018-09-27,Indiaforensic NFS SETT 26-09-201,1500.0,0.0,2123314.820000004,2018,9,27,CASH_OUT,1500.0,C214774813
5884,409000493210',2018-09-27,Indiaforensic NFS SETT 26-09-201,500.0,0.0,2122814.820000004,2018,9,27,DEBIT,500.0,C1446521801
5885,409000493210',2018-09-27,Indiaforensic NFS SETT 26-09-201,500.0,0.0,2122314.820000004,2018,9,27,CHECK_WITHDRAWAL,500.0,C1838584624
5886,409000493210',2018-09-27,Indiaforensic NFS SETT 26-09-201,1000.0,0.0,2121314.820000004,2018,9,27,PAYEMENT,1000.0,C662736689
5887,409000493210',2018-09-27,Indiaforensic NFS SETT 26-09-201,1500.0,0.0,2119814.820000004,2018,9,27,DEBIT,1500.0,C248609774
5888,409000493210',2018-09-27,Indiaforensic NFS SETT 26-09-201,500.0,0.0,2119314.820000004,2018,9,27,PAYEMENT,500.0,C2083562754
5889,409000493210',2018-09-27,Indiaforensic NFS SETT 26-09-201,1500.0,0.0,2117814.820000004,2018,9,27,CASH_OUT,1500.0,C451111351
5890,409000493210',2018-09-27,Indiaforensic NFS SETT 26-09-201,1500.0,0.0,2116314.820000004,2018,9,27,CHECK_WITHDRAWAL,1500.0,C1538745405
5891,409000493210',2018-09-27,Indiaforensic NFS SETT 26-09-201,300.0,0.0,2116014.820000004,2018,9,27,DEBIT,300.0,C1782113663
5892,409000493210',2018-09-27,Indiaforensic NFS SETT 26-09-201,100.0,0.0,2115914.820000004,2018,9,27,DEBIT,100.0,C653745564
5893,409000493210',2018-09-27,Indiaforensic NFS SETT 26-09-201,200.0,0.0,2115714.820000004,2018,9,27,CHECK_WITHDRAWAL,200.0,C1022680775
5894,409000493210',2018-09-27,Indiaforensic NFS SETT 26-09-201,500.0,0.0,2115214.820000004,2018,9,27,CHECK_WITHDRAWAL,500.0,M680584313
5895,409000493210',2018-09-27,Indiaforensic NFS SETT 26-09-201,2000.0,0.0,2113214.820000004,2018,9,27,DEBIT,2000.0,M1961147937
5896,409000493210',2018-09-27,Indiaforensic NFS SETT 26-09-201,500.0,0.0,2112714.820000004,2018,9,27,CASH_OUT,500.0,M1653331838
5897,409000493210',2018-09-27,Indiaforensic NFS SETT 26-09-201,300.0,0.0,2112414.820000004,2018,9,27,CASH_OUT,300.0,M1567903868
5898,409000493210',2018-09-27,Indiaforensic NFS SETT 26-09-201,100.0,0.0,2112314.820000004,2018,9,27,CASH_OUT,100.0,M378817368
5899,409000493210',2018-09-27,Indiaforensic NFS SETT 26-09-201,500.0,0.0,2111814.820000004,2018,9,27,DEBIT,500.0,C2043975568
5900,409000493210',2018-09-27,Indiaforensic NFS SETT 26-09-201,10000.0,0.0,2101814.820000004,2018,9,27,CHECK_WITHDRAWAL,10000.0,M168702939
5901,409000493210',2018-09-27,Indiaforensic NFS SETT 26-09-201,2000.0,0.0,2099814.820000004,2018,9,27,CHECK_WITHDRAWAL,2000.0,M1085622114
5902,409000493210',2018-09-27,Indiaforensic NFS SETT 26-09-201,10000.0,0.0,2089814.820000004,2018,9,27,CHECK_WITHDRAWAL,10000.0,C1329589315
5903,409000493210',2018-09-28,Indiaforensic RUPAY SETT 280918,4787.87,0.0,2085026.9500000041,2018,9,28,PAYEMENT,4787.87,M1708804701
5904,409000493210',2018-09-28,Indiaforensic RUPAY SETT 280918,0.0,67.86,2085094.810000004,2018,9,28,TRANSFER,67.86,M447899837
5905,409000493210',2018-09-28,Indiaforensic RUPAY STL INTC2809,38.15,0.0,2085056.660000004,2018,9,28,PAYEMENT,38.15,M403740863
5906,409000493210',2018-09-28,Indiaforensic RUPAY STL INTC2809,0.0,0.16,2085056.820000004,2018,9,28,TRANSFER,0.16,C621014131
5907,409000493210',2018-09-28,Indiaforensic NFS SETT 27-09-201,400.0,0.0,2084656.820000004,2018,9,28,CASH_OUT,400.0,M940943313
5908,409000493210',2018-09-28,Indiaforensic NFS SETT 27-09-201,9000.0,0.0,2075656.820000004,2018,9,28,DEBIT,9000.0,M489508218
5909,409000493210',2018-09-28,Indiaforensic NFS SETT 27-09-201,9500.0,0.0,2066156.820000004,2018,9,28,DEBIT,9500.0,M1270612719
5910,409000493210',2018-09-28,Indiaforensic NFS SETT 27-09-201,1500.0,0.0,2064656.820000004,2018,9,28,PAYEMENT,1500.0,M2017312999
5911,409000493210',2018-09-28,Indiaforensic NFS SETT 27-09-201,10000.0,0.0,2054656.820000004,2018,9,28,DEBIT,10000.0,M497021410
5912,409000493210',2018-09-28,Indiaforensic NFS SETT 27-09-201,500.0,0.0,2054156.820000004,2018,9,28,DEBIT,500.0,M1686632440
5913,409000493210',2018-09-28,Indiaforensic NFS SETT 27-09-201,500.0,0.0,2053656.820000004,2018,9,28,DEBIT,500.0,M1234219829
5914,409000493210',2018-09-28,Indiaforensic NFS SETT 27-09-201,7000.0,0.0,2046656.820000004,2018,9,28,DEBIT,7000.0,M967730184
5915,409000493210',2018-09-28,Indiaforensic NFS SETT 27-09-201,6500.0,0.0,2040156.820000004,2018,9,28,CASH_OUT,6500.0,M1284161223
5916,409000493210',2018-09-28,Indiaforensic NFS SETT 27-09-201,10000.0,0.0,2030156.820000004,2018,9,28,CASH_OUT,10000.0,M255259469
5917,409000493210',2018-09-28,Indiaforensic NFS SETT 27-09-201,500.0,0.0,2029656.820000004,2018,9,28,PAYEMENT,500.0,M1803977322
5918,409000493210',2018-09-28,Indiaforensic NFS SETT 27-09-201,1500.0,0.0,2028156.820000004,2018,9,28,CASH_OUT,1500.0,M79297071
5919,409000493210',2018-09-28,Indiaforensic NFS SETT 27-09-201,1200.0,0.0,2026956.820000004,2018,9,28,DEBIT,1200.0,M852143641
5920,409000493210',2018-09-28,Indiaforensic NFS SETT 27-09-201,500.0,0.0,2026456.820000004,2018,9,28,DEBIT,500.0,M734370487
5921,409000493210',2018-09-28,Indiaforensic NFS SETT 27-09-201,500.0,0.0,2025956.820000004,2018,9,28,CHECK_WITHDRAWAL,500.0,C194746285
5922,409000493210',2018-09-28,Indiaforensic NFS SETT 27-09-201,10000.0,0.0,2015956.820000004,2018,9,28,CHECK_WITHDRAWAL,10000.0,M1963448684
5923,409000493210',2018-09-28,Indiaforensic NFS SETT 27-09-201,5900.0,0.0,2010056.820000004,2018,9,28,CHECK_WITHDRAWAL,5900.0,M1236908650
5924,409000493210',2018-09-28,Indiaforensic NFS SETT 27-09-201,500.0,0.0,2009556.820000004,2018,9,28,PAYEMENT,500.0,M820069375
5925,409000493210',2018-09-28,Indiaforensic NFS SETT 27-09-201,500.0,0.0,2009056.820000004,2018,9,28,PAYEMENT,500.0,M1094732450
5926,409000493210',2018-09-28,Indiaforensic NFS SETT 27-09-201,200.0,0.0,2008856.820000004,2018,9,28,DEBIT,200.0,M836903781
5927,409000493210',2018-09-28,Indiaforensic NFS SETT 27-09-201,10000.0,0.0,1998856.820000004,2018,9,28,DEBIT,10000.0,M1102948993
5928,409000493210',2018-09-28,Indiaforensic NFS SETT 27-09-201,400.0,0.0,1998456.820000004,2018,9,28,PAYEMENT,400.0,M1505791217
5929,409000493210',2018-09-28,Indiaforensic NFS SETT 27-09-201,9900.0,0.0,1988556.820000004,2018,9,28,CASH_OUT,9900.0,M681200528
5930,409000493210',2018-09-28,Indiaforensic NFS SETT 27-09-201,10000.0,0.0,1978556.820000004,2018,9,28,CASH_OUT,10000.0,M1195834252
5931,409000493210',2018-09-28,Indiaforensic NFS SETT 27-09-201,900.0,0.0,1977656.820000004,2018,9,28,DEBIT,900.0,M1104705467
5932,409000493210',2018-09-28,Indiaforensic NFS SETT 27-09-201,10000.0,0.0,1967656.820000004,2018,9,28,CASH_OUT,10000.0,M1227859754
5933,409000493210',2018-09-28,Indiaforensic NFS SETT 27-09-201,900.0,0.0,1966756.820000004,2018,9,28,CHECK_WITHDRAWAL,900.0,C1360767589
5934,409000493210',2018-09-28,Indiaforensic NFS SETT 27-09-201,9900.0,0.0,1956856.820000004,2018,9,28,PAYEMENT,9900.0,M1191261658
5935,409000493210',2018-09-28,Indiaforensic NFS SETT 27-09-201,9900.0,0.0,1946956.820000004,2018,9,28,PAYEMENT,9900.0,M1600712390
5936,409000493210',2018-09-28,Indiaforensic NFS SETT 27-09-201,3000.0,0.0,1943956.820000004,2018,9,28,DEBIT,3000.0,M18392277
5937,409000493210',2018-09-28,Indiaforensic NFS SETT 27-09-201,8000.0,0.0,1935956.820000004,2018,9,28,CASH_OUT,8000.0,M1958168955
5938,409000493210',2018-09-28,Indiaforensic RUPAY SETT 280918-,100.71,0.0,1935856.110000004,2018,9,28,PAYEMENT,100.71,M814507488
5939,409000493210',2018-09-28,Indiaforensic RUPAY SETT 280918-,0.0,1.1,1935857.2100000042,2018,9,28,TRANSFER,1.1,M508047053
5940,409000493210',2018-09-28,Indiaforensic RUPAY STL INTC2809,1.1,0.0,1935856.110000004,2018,9,28,PAYEMENT,1.1,M197470785
5941,409000493210',2018-09-28,FDRL/INTERNAL FUND TRANSFE,0.0,100000.0,2035856.110000004,2018,9,28,CHECK_CASHING,100000.0,M1444280365
5942,409000493210',2018-09-29,Indiaforensic RUPAY SETT 290918,29647.2,0.0,2006208.910000004,2018,9,29,DEBIT,29647.2,M64761620
5943,409000493210',2018-09-29,Indiaforensic RUPAY SETT 290918,0.0,290.32,2006499.2300000042,2018,9,29,CHECK_CASHING,290.32,M1462028250
5944,409000493210',2018-09-29,Indiaforensic RUPAY STL INTC2909,268.77,0.0,2006230.4600000042,2018,9,29,DEBIT,268.77,M1477752059
5945,409000493210',2018-09-29,Indiaforensic RUPAY STL INTC2909,0.0,0.16,2006230.620000004,2018,9,29,CHECK_CASHING,0.16,M1268858861
5946,409000493210',2018-09-29,Indiaforensic  RUPAY SETT 290918,4125.84,0.0,2002104.780000004,2018,9,29,CHECK_WITHDRAWAL,4125.84,M416427727
5947,409000493210',2018-09-29,Indiaforensic  RUPAY SETT 290918,0.0,36.38,2002141.160000004,2018,9,29,CHECK_CASHING,36.38,M826553984
5948,409000493210',2018-09-29,Indiaforensic RUPAY STL INTC2909,36.38,0.0,2002104.780000004,2018,9,29,PAYEMENT,36.38,M983073433
5949,409000493210',2018-09-29,Indiaforensic NFS SETT 28-09-201,1000.0,0.0,2001104.780000004,2018,9,29,DEBIT,1000.0,M404240651
5950,409000493210',2018-09-29,Indiaforensic NFS SETT 28-09-201,200.0,0.0,2000904.780000004,2018,9,29,CHECK_WITHDRAWAL,200.0,M2129964267
5951,409000493210',2018-09-29,Indiaforensic NFS SETT 28-09-201,500.0,0.0,2000404.780000004,2018,9,29,PAYEMENT,500.0,M1749018549
5952,409000493210',2018-09-29,Indiaforensic NFS SETT 28-09-201,10000.0,0.0,1990404.780000004,2018,9,29,DEBIT,10000.0,M9698116
5953,409000493210',2018-09-29,Indiaforensic NFS SETT 28-09-201,10000.0,0.0,1980404.780000004,2018,9,29,CASH_OUT,10000.0,M347377465
5954,409000493210',2018-09-29,Indiaforensic NFS SETT 28-09-201,5000.0,0.0,1975404.780000004,2018,9,29,CHECK_WITHDRAWAL,5000.0,M210204797
5955,409000493210',2018-09-29,Indiaforensic NFS SETT 28-09-201,1200.0,0.0,1974204.780000004,2018,9,29,CASH_OUT,1200.0,M826490361
5956,409000493210',2018-09-29,Indiaforensic NFS SETT 28-09-201,1200.0,0.0,1973004.780000004,2018,9,29,DEBIT,1200.0,C134604590
5957,409000493210',2018-09-29,Indiaforensic NFS SETT 28-09-201,1000.0,0.0,1972004.780000004,2018,9,29,DEBIT,1000.0,M1850630389
5958,409000493210',2018-09-29,Indiaforensic NFS SETT 28-09-201,10000.0,0.0,1962004.780000004,2018,9,29,DEBIT,10000.0,M1003412230
5959,409000493210',2018-09-29,Indiaforensic NFS SETT 28-09-201,400.0,0.0,1961604.780000004,2018,9,29,PAYEMENT,400.0,C691404076
5960,409000493210',2018-09-29,Indiaforensic NFS SETT 28-09-201,2500.0,0.0,1959104.780000004,2018,9,29,CASH_OUT,2500.0,M1706225206
5961,409000493210',2018-09-29,Indiaforensic NFS SETT 28-09-201,1000.0,0.0,1958104.780000004,2018,9,29,PAYEMENT,1000.0,M382992974
5962,409000493210',2018-09-29,Indiaforensic NFS SETT 28-09-201,200.0,0.0,1957904.780000004,2018,9,29,PAYEMENT,200.0,M1674824156
5963,409000493210',2018-09-29,Indiaforensic NFS SETT 28-09-201,1000.0,0.0,1956904.780000004,2018,9,29,DEBIT,1000.0,M902894836
5964,409000493210',2018-09-29,Indiaforensic NFS SETT 28-09-201,4000.0,0.0,1952904.780000004,2018,9,29,CASH_OUT,4000.0,C1615804266
5965,409000493210',2018-09-29,Indiaforensic NFS SETT 28-09-201,5000.0,0.0,1947904.780000004,2018,9,29,CASH_OUT,5000.0,M1162780005
5966,409000493210',2018-09-29,Indiaforensic NFS SETT 28-09-201,800.0,0.0,1947104.780000004,2018,9,29,CASH_OUT,800.0,M1745328286
5967,409000493210',2018-09-29,Indiaforensic NFS SETT 28-09-201,10000.0,0.0,1937104.780000004,2018,9,29,PAYEMENT,10000.0,M823672546
5968,409000493210',2018-09-29,Indiaforensic NFS SETT 28-09-201,10000.0,0.0,1927104.780000004,2018,9,29,PAYEMENT,10000.0,M937726434
5969,409000493210',2018-09-29,Indiaforensic NFS SETT 28-09-201,1000.0,0.0,1926104.780000004,2018,9,29,CASH_OUT,1000.0,M644323208
5970,409000493210',2018-09-29,Indiaforensic NFS SETT 28-09-201,10000.0,0.0,1916104.780000004,2018,9,29,CHECK_WITHDRAWAL,10000.0,M1327842480
5971,409000493210',2018-09-29,Indiaforensic NFS SETT 28-09-201,1000.0,0.0,1915104.780000004,2018,9,29,CASH_OUT,1000.0,M1106002545
5972,409000493210',2018-09-29,Indiaforensic NFS SETT 28-09-201,200.0,0.0,1914904.780000004,2018,9,29,CHECK_WITHDRAWAL,200.0,C1916720513
5973,409000493210',2018-09-29,Indiaforensic NFS SETT 28-09-201,1200.0,0.0,1913704.780000004,2018,9,29,DEBIT,1200.0,M620301055
5974,409000493210',2018-09-29,Indiaforensic NFS SETT 28-09-201,1200.0,0.0,1912504.780000004,2018,9,29,CASH_OUT,1200.0,M636094094
5975,409000493210',2018-09-29,Indiaforensic NFS SETT 28-09-201,400.0,0.0,1912104.780000004,2018,9,29,CHECK_WITHDRAWAL,400.0,M538611367
5976,409000493210',2018-10-01,Indiaforensic  RUPAY SETT 300918,14088.49,0.0,1898016.290000004,2018,10,1,CASH_OUT,14088.49,C1955948959
5977,409000493210',2018-10-01,Indiaforensic  RUPAY SETT 300918,0.0,121.62,1898137.910000004,2018,10,1,CHECK_CASHING,121.62,M1911551651
5978,409000493210',2018-10-01,Indiaforensic RUPAY STL INTC3009,119.1,0.0,1898018.810000004,2018,10,1,PAYEMENT,119.1,M1935247567
5979,409000493210',2018-10-01,Indiaforensic RUPAY STL INTC3009,0.0,0.01,1898018.820000004,2018,10,1,TRANSFER,0.01,M594169136
5980,409000493210',2018-10-01,Indiaforensic  RUPAY SETT 011018,40494.07,0.0,1857524.750000004,2018,10,1,DEBIT,40494.07,M949389138
5981,409000493210',2018-10-01,Indiaforensic  RUPAY SETT 011018,0.0,404.53,1857929.280000004,2018,10,1,CASH_IN,404.53,M325461513
5982,409000493210',2018-10-01,Indiaforensic RUPAY STL INTC0110,254.53,0.0,1857674.750000004,2018,10,1,PAYEMENT,254.53,M729827711
5983,409000493210',2018-10-01,Indiaforensic RUPAY STL INTC0110,0.0,1.13,1857675.880000004,2018,10,1,CASH_IN,1.13,M1275071684
5984,409000493210',2018-10-01,TRF FRM  Indiaforensic SERVICES,0.0,82600.0,1940275.880000004,2018,10,1,CASH_IN,82600.0,M1171546708
5985,409000493210',2018-10-01,Indiaforensic  RUPAY SETT 011018,30099.61,0.0,1910176.270000004,2018,10,1,CHECK_WITHDRAWAL,30099.61,M1175347198
5986,409000493210',2018-10-01,Indiaforensic RUPAY STL INTC0110,261.89,0.0,1909914.380000004,2018,10,1,PAYEMENT,261.89,C1356054329
5987,409000493210',2018-10-01,Indiaforensic  RUPAY SETT 011018,0.0,261.89,1910176.270000004,2018,10,1,TRANSFER,261.89,M1447044674
5988,409000493210',2018-10-01,Indiaforensic NFS SETT 29-09-201,400.0,0.0,1909776.270000004,2018,10,1,PAYEMENT,400.0,C295372946
5989,409000493210',2018-10-01,Indiaforensic NFS SETT 29-09-201,4000.0,0.0,1905776.270000004,2018,10,1,CHECK_WITHDRAWAL,4000.0,M75340801
5990,409000493210',2018-10-01,Indiaforensic NFS SETT 29-09-201,500.0,0.0,1905276.270000004,2018,10,1,DEBIT,500.0,M436399072
5991,409000493210',2018-10-01,Indiaforensic NFS SETT 29-09-201,500.0,0.0,1904776.270000004,2018,10,1,CHECK_WITHDRAWAL,500.0,C769342184
5992,409000493210',2018-10-01,Indiaforensic NFS SETT 29-09-201,9500.0,0.0,1895276.270000004,2018,10,1,CASH_OUT,9500.0,M2020883928
5993,409000493210',2018-10-01,Indiaforensic NFS SETT 29-09-201,300.0,0.0,1894976.270000004,2018,10,1,CHECK_WITHDRAWAL,300.0,M696664702
5994,409000493210',2018-10-01,Indiaforensic NFS SETT 29-09-201,500.0,0.0,1894476.270000004,2018,10,1,CHECK_WITHDRAWAL,500.0,C904300960
5995,409000493210',2018-10-01,Indiaforensic NFS SETT 29-09-201,4400.0,0.0,1890076.270000004,2018,10,1,CHECK_WITHDRAWAL,4400.0,C1249547869
5996,409000493210',2018-10-01,Indiaforensic NFS SETT 29-09-201,10000.0,0.0,1880076.270000004,2018,10,1,DEBIT,10000.0,M650520717
5997,409000493210',2018-10-01,Indiaforensic NFS SETT 29-09-201,3800.0,0.0,1876276.270000004,2018,10,1,CHECK_WITHDRAWAL,3800.0,M1682663597
5998,409000493210',2018-10-01,Indiaforensic NFS SETT 29-09-201,500.0,0.0,1875776.270000004,2018,10,1,DEBIT,500.0,M237789822
5999,409000493210',2018-10-01,Indiaforensic NFS SETT 29-09-201,10000.0,0.0,1865776.270000004,2018,10,1,CHECK_WITHDRAWAL,10000.0,M175825728
6000,409000493210',2018-10-01,Indiaforensic NFS SETT 29-09-201,5000.0,0.0,1860776.270000004,2018,10,1,PAYEMENT,5000.0,M861500069
6001,409000493210',2018-10-01,Indiaforensic NFS SETT 29-09-201,8000.0,0.0,1852776.270000004,2018,10,1,CHECK_WITHDRAWAL,8000.0,C1013700132
6002,409000493210',2018-10-01,Indiaforensic NFS SETT 29-09-201,10000.0,0.0,1842776.270000004,2018,10,1,CASH_OUT,10000.0,C1880332929
6003,409000493210',2018-10-01,Indiaforensic NFS SETT 29-09-201,2000.0,0.0,1840776.270000004,2018,10,1,PAYEMENT,2000.0,C1286084959
6004,409000493210',2018-10-01,Indiaforensic NFS SETT 29-09-201,10000.0,0.0,1830776.270000004,2018,10,1,DEBIT,10000.0,C657736958
6005,409000493210',2018-10-01,Indiaforensic NFS SETT 29-09-201,3500.0,0.0,1827276.270000004,2018,10,1,PAYEMENT,3500.0,C766681183
6006,409000493210',2018-10-01,Indiaforensic NFS SETT 29-09-201,300.0,0.0,1826976.270000004,2018,10,1,PAYEMENT,300.0,C1870252780
6007,409000493210',2018-10-01,Indiaforensic NFS SETT 29-09-201,100.0,0.0,1826876.270000004,2018,10,1,PAYEMENT,100.0,C1023714065
6008,409000493210',2018-10-01,Indiaforensic NFS SETT 29-09-201,6000.0,0.0,1820876.270000004,2018,10,1,DEBIT,6000.0,C909295153
6009,409000493210',2018-10-01,Indiaforensic NFS SETT 29-09-201,7500.0,0.0,1813376.270000004,2018,10,1,CHECK_WITHDRAWAL,7500.0,C1360767589
6010,409000493210',2018-10-01,Indiaforensic NFS SETT 29-09-201,10000.0,0.0,1803376.270000004,2018,10,1,DEBIT,10000.0,C1255024717
6011,409000493210',2018-10-01,Indiaforensic NFS SETT 30-09-201,10000.0,0.0,1793376.2700000037,2018,10,1,PAYEMENT,10000.0,C1590550415
6012,409000493210',2018-10-01,Indiaforensic NFS SETT 30-09-201,5000.0,0.0,1788376.2700000037,2018,10,1,CASH_OUT,5000.0,C1816757085
6013,409000493210',2018-10-01,Indiaforensic NFS SETT 30-09-201,500.0,0.0,1787876.2700000037,2018,10,1,CASH_OUT,500.0,C1234776885
6014,409000493210',2018-10-01,Indiaforensic NFS SETT 30-09-201,800.0,0.0,1787076.2700000037,2018,10,1,DEBIT,800.0,C1883840933
6015,409000493210',2018-10-01,Indiaforensic NFS SETT 30-09-201,300.0,0.0,1786776.2700000037,2018,10,1,PAYEMENT,300.0,C503485607
6016,409000493210',2018-10-01,Indiaforensic NFS SETT 30-09-201,100.0,0.0,1786676.2700000037,2018,10,1,DEBIT,100.0,C1013700132
6017,409000493210',2018-10-01,Indiaforensic NFS SETT 30-09-201,100.0,0.0,1786576.2700000037,2018,10,1,CASH_OUT,100.0,C1883840933
6018,409000493210',2018-10-01,Indiaforensic NFS SETT 30-09-201,400.0,0.0,1786176.2700000037,2018,10,1,PAYEMENT,400.0,C769342184
6019,409000493210',2018-10-01,Indiaforensic NFS SETT 30-09-201,10000.0,0.0,1776176.2700000037,2018,10,1,PAYEMENT,10000.0,C1540270363
6020,409000493210',2018-10-01,Indiaforensic NFS SETT 30-09-201,4500.0,0.0,1771676.2700000037,2018,10,1,CHECK_WITHDRAWAL,4500.0,M1049295917
6021,409000493210',2018-10-01,Indiaforensic NFS SETT 30-09-201,2000.0,0.0,1769676.2700000037,2018,10,1,CHECK_WITHDRAWAL,2000.0,C1281580764
6022,409000493210',2018-10-03,Indiaforensic RUPAY SETT 021018,8502.57,0.0,1761173.7000000037,2018,10,3,CASH_OUT,8502.57,C1281580764
6023,409000493210',2018-10-03,Indiaforensic RUPAY SETT 021018,0.0,163.43,1761337.1300000038,2018,10,3,TRANSFER,163.43,M1632424327
6024,409000493210',2018-10-03,Indiaforensic RUPAY STL INTC0210,81.64,0.0,1761255.4900000037,2018,10,3,DEBIT,81.64,C1531333864
6025,409000493210',2018-10-03,Indiaforensic RUPAY STL INTC0210,0.0,0.61,1761256.1000000038,2018,10,3,CASH_IN,0.61,C267527788
6026,409000493210',2018-10-03,Indiaforensic RUPAY SETT 031018,18569.74,0.0,1742686.3600000038,2018,10,3,CHECK_WITHDRAWAL,18569.74,C423583818
6027,409000493210',2018-10-03,Indiaforensic RUPAY SETT 031018,0.0,217.4,1742903.7600000037,2018,10,3,CHECK_CASHING,217.4,C769342184
6028,409000493210',2018-10-03,Indiaforensic RUPAY STL INTC0310,189.27,0.0,1742714.4900000037,2018,10,3,DEBIT,189.27,C673068808
6029,409000493210',2018-10-03,Indiaforensic RUPAY STL INTC0310,0.0,0.21,1742714.7000000037,2018,10,3,CASH_IN,0.21,C657736958
6030,409000493210',2018-10-03,Indiaforensic  RUPAY SETT 031018,5811.42,0.0,1736903.2800000038,2018,10,3,PAYEMENT,5811.42,C1255024717
6031,409000493210',2018-10-03,Indiaforensic  RUPAY SETT 031018,0.0,43.58,1736946.8600000038,2018,10,3,CASH_IN,43.58,M309476445
6032,409000493210',2018-10-03,Indiaforensic RUPAY STL INTC0310,43.58,0.0,1736903.2800000038,2018,10,3,CASH_OUT,43.58,M2002705120
6033,409000493210',2018-10-03,Indiaforensic NFS SETT 01-10-201,2000.0,0.0,1734903.2800000038,2018,10,3,DEBIT,2000.0,M627556497
6034,409000493210',2018-10-03,Indiaforensic NFS SETT 01-10-201,10000.0,0.0,1724903.2800000038,2018,10,3,CHECK_WITHDRAWAL,10000.0,M1993314761
6035,409000493210',2018-10-03,Indiaforensic NFS SETT 01-10-201,6000.0,0.0,1718903.2800000038,2018,10,3,DEBIT,6000.0,M1875372072
6036,409000493210',2018-10-03,Indiaforensic NFS SETT 01-10-201,2000.0,0.0,1716903.2800000038,2018,10,3,CASH_OUT,2000.0,M753027610
6037,409000493210',2018-10-03,Indiaforensic NFS SETT 01-10-201,3000.0,0.0,1713903.2800000038,2018,10,3,DEBIT,3000.0,M1995103322
6038,409000493210',2018-10-03,Indiaforensic NFS SETT 01-10-201,100.0,0.0,1713803.2800000038,2018,10,3,CHECK_WITHDRAWAL,100.0,M546392117
6039,409000493210',2018-10-03,Indiaforensic NFS SETT 01-10-201,700.0,0.0,1713103.2800000038,2018,10,3,CHECK_WITHDRAWAL,700.0,M1098139353
6040,409000493210',2018-10-03,Indiaforensic NFS SETT 01-10-201,500.0,0.0,1712603.2800000038,2018,10,3,CHECK_WITHDRAWAL,500.0,M511524231
6041,409000493210',2018-10-03,Indiaforensic NFS SETT 01-10-201,1500.0,0.0,1711103.2800000038,2018,10,3,CHECK_WITHDRAWAL,1500.0,M2121705071
6042,409000493210',2018-10-03,Indiaforensic NFS SETT 02-10-201,500.0,0.0,1710603.2800000038,2018,10,3,PAYEMENT,500.0,M96858414
6043,409000493210',2018-10-03,Indiaforensic NFS SETT 02-10-201,200.0,0.0,1710403.2800000038,2018,10,3,CHECK_WITHDRAWAL,200.0,C456172878
6044,409000493210',2018-10-03,Indiaforensic NFS SETT 02-10-201,1000.0,0.0,1709403.2800000038,2018,10,3,CASH_OUT,1000.0,C154319946
6045,409000493210',2018-10-04,Indiaforensic  RUPAY SETT 041018,5193.85,0.0,1704209.4300000037,2018,10,4,DEBIT,5193.85,M721783805
6046,409000493210',2018-10-04,Indiaforensic  RUPAY SETT 041018,0.0,221.91,1704431.3400000038,2018,10,4,CHECK_CASHING,221.91,M348817596
6047,409000493210',2018-10-04,Indiaforensic RUPAY STL INTC0410,57.06,0.0,1704374.2800000038,2018,10,4,PAYEMENT,57.06,M140301331
6048,409000493210',2018-10-04,Indiaforensic RUPAY STL INTC0410,0.0,1.19,1704375.4700000037,2018,10,4,CASH_IN,1.19,C1916720513
6049,409000493210',2018-10-04,Indiaforensic RUPAY SETT 240918-,5725.85,0.0,1698649.6200000034,2018,10,4,CHECK_WITHDRAWAL,5725.85,M673231721
6050,409000493210',2018-10-04,Indiaforensic RUPAY SETT 240918-,0.0,39.35,1698688.9700000037,2018,10,4,CHECK_CASHING,39.35,C843467284
6051,409000493210',2018-10-04,Indiaforensic RUPAY STL INTC2409,36.35,0.0,1698652.6200000034,2018,10,4,CASH_OUT,36.35,M2031373582
6052,409000493210',2018-10-04,Indiaforensic RUPAY STL INTC2409,0.0,0.02,1698652.6400000034,2018,10,4,TRANSFER,0.02,M39296394
6053,409000493210',2018-10-04,Indiaforensic NFS SETT 03-10-201,10000.0,0.0,1688652.6400000034,2018,10,4,PAYEMENT,10000.0,M2116089059
6054,409000493210',2018-10-04,Indiaforensic NFS SETT 03-10-201,5000.0,0.0,1683652.6400000034,2018,10,4,PAYEMENT,5000.0,M83296098
6055,409000493210',2018-10-04,Indiaforensic NFS SETT 03-10-201,10000.0,0.0,1673652.6400000034,2018,10,4,CHECK_WITHDRAWAL,10000.0,M1696377390
6056,409000493210',2018-10-04,Indiaforensic NFS SETT 03-10-201,100.0,0.0,1673552.6400000034,2018,10,4,PAYEMENT,100.0,M1887701594
6057,409000493210',2018-10-04,Indiaforensic NFS SETT 03-10-201,8000.0,0.0,1665552.6400000034,2018,10,4,PAYEMENT,8000.0,M2050277878
6058,409000493210',2018-10-04,Indiaforensic  RUPAY SETT 041018,36124.26,0.0,1629428.3800000034,2018,10,4,CHECK_WITHDRAWAL,36124.26,M1050247219
6059,409000493210',2018-10-04,Indiaforensic  RUPAY SETT 041018,0.0,188.81,1629617.1900000034,2018,10,4,CHECK_CASHING,188.81,M1383947848
6060,409000493210',2018-10-04,Indiaforensic RUPAY STL INTC0410,188.81,0.0,1629428.3800000034,2018,10,4,DEBIT,188.81,M848419266
6061,409000493210',2018-10-05,Indiaforensic  RUPAY SETT 051018,38630.64,0.0,1590797.7400000037,2018,10,5,PAYEMENT,38630.64,M1422562336
6062,409000493210',2018-10-05,Indiaforensic  RUPAY SETT 051018,0.0,405.17,1591202.9100000034,2018,10,5,TRANSFER,405.17,M1925645553
6063,409000493210',2018-10-05,Indiaforensic RUPAY STL INTC0510,365.31,0.0,1590837.6000000034,2018,10,5,CHECK_WITHDRAWAL,365.31,C1234776885
6064,409000493210',2018-10-05,Indiaforensic RUPAY STL INTC0510,0.0,0.29,1590837.8900000034,2018,10,5,CHECK_CASHING,0.29,M470092156
6065,409000493210',2018-10-05,Indiaforensic NFS SETT 04-10-201,6000.0,0.0,1584837.8900000034,2018,10,5,DEBIT,6000.0,C1816757085
6066,409000493210',2018-10-05,Indiaforensic NFS SETT 04-10-201,500.0,0.0,1584337.8900000034,2018,10,5,DEBIT,500.0,C2118255842
6067,409000493210',2018-10-05,Indiaforensic NFS SETT 04-10-201,500.0,0.0,1583837.8900000034,2018,10,5,CHECK_WITHDRAWAL,500.0,C1822045793
6068,409000493210',2018-10-05,Indiaforensic NFS SETT 04-10-201,300.0,0.0,1583537.8900000034,2018,10,5,CHECK_WITHDRAWAL,300.0,C11003494
6069,409000493210',2018-10-05,Indiaforensic NFS SETT 04-10-201,200.0,0.0,1583337.8900000034,2018,10,5,DEBIT,200.0,C214774813
6070,409000493210',2018-10-05,Indiaforensic NFS SETT 04-10-201,10000.0,0.0,1573337.8900000034,2018,10,5,DEBIT,10000.0,C1922859107
6071,409000493210',2018-10-05,Indiaforensic NFS SETT 04-10-201,10000.0,0.0,1563337.8900000034,2018,10,5,CHECK_WITHDRAWAL,10000.0,C173783788
6072,409000493210',2018-10-05,Indiaforensic NFS SETT 04-10-201,9000.0,0.0,1554337.8900000034,2018,10,5,CHECK_WITHDRAWAL,9000.0,C832279283
6073,409000493210',2018-10-05,Indiaforensic NFS SETT 04-10-201,10000.0,0.0,1544337.8900000034,2018,10,5,CHECK_WITHDRAWAL,10000.0,C2118255842
6074,409000493210',2018-10-05,Indiaforensic NFS SETT 04-10-201,2000.0,0.0,1542337.8900000034,2018,10,5,CASH_OUT,2000.0,C1997859171
6075,409000493210',2018-10-05,TRF FROM  Indiaforensic SERVICES,0.0,1300000.0,2842337.890000004,2018,10,5,CASH_IN,1300000.0,C1721246982
6076,409000493210',2018-10-05,Indiaforensic  RUPAY SETT 051018,6085.59,0.0,2836252.3000000035,2018,10,5,CASH_OUT,6085.59,C407757655
6077,409000493210',2018-10-05,Indiaforensic  RUPAY SETT 051018,0.0,77.21,2836329.510000004,2018,10,5,CASH_IN,77.21,M1087439460
6078,409000493210',2018-10-05,Indiaforensic RUPAY STL INTC0510,77.21,0.0,2836252.3000000035,2018,10,5,CHECK_WITHDRAWAL,77.21,M1402047326
6079,409000493210',2018-10-06,Indiaforensic  RUPAY SETT 061018,5553.91,0.0,2830698.390000004,2018,10,6,DEBIT,5553.91,C1254526270
6080,409000493210',2018-10-06,Indiaforensic  RUPAY SETT 061018,0.0,289.95,2830988.3400000036,2018,10,6,TRANSFER,289.95,C1883788127
6081,409000493210',2018-10-06,Indiaforensic RUPAY STL INTC0610,61.57,0.0,2830926.7700000037,2018,10,6,CHECK_WITHDRAWAL,61.57,M1088348283
6082,409000493210',2018-10-06,Indiaforensic RUPAY STL INTC0610,0.0,3.29,2830930.060000004,2018,10,6,TRANSFER,3.29,M1603964380
6083,409000493210',2018-10-06,Indiaforensic NFS SETT 05-10-201,10000.0,0.0,2820930.060000004,2018,10,6,CHECK_WITHDRAWAL,10000.0,M627727856
6084,409000493210',2018-10-06,Indiaforensic NFS SETT 05-10-201,2000.0,0.0,2818930.060000004,2018,10,6,DEBIT,2000.0,M320305128
6085,409000493210',2018-10-06,Indiaforensic NFS SETT 05-10-201,400.0,0.0,2818530.060000004,2018,10,6,CASH_OUT,400.0,M1940248684
6086,409000493210',2018-10-06,Indiaforensic NFS SETT 05-10-201,400.0,0.0,2818130.060000004,2018,10,6,CASH_OUT,400.0,M74974017
6087,409000493210',2018-10-06,Indiaforensic NFS SETT 05-10-201,500.0,0.0,2817630.060000004,2018,10,6,PAYEMENT,500.0,M1630192523
6088,409000493210',2018-10-06,Indiaforensic NFS SETT 05-10-201,7000.0,0.0,2810630.0600000042,2018,10,6,CASH_OUT,7000.0,M1305777754
6089,409000493210',2018-10-06,Indiaforensic NFS SETT 05-10-201,1000.0,0.0,2809630.0600000042,2018,10,6,DEBIT,1000.0,M1311152251
6090,409000493210',2018-10-06,Indiaforensic  RUPAY SETT 061018,4829.42,0.0,2804800.640000004,2018,10,6,CASH_OUT,4829.42,M959718932
6091,409000493210',2018-10-06,Indiaforensic RUPAY STL INTC0610,33.8,0.0,2804766.840000004,2018,10,6,CASH_OUT,33.8,M52313140
6092,409000493210',2018-10-06,Indiaforensic  RUPAY SETT 061018,0.0,33.8,2804800.640000004,2018,10,6,CHECK_CASHING,33.8,M332464215
6093,409000493210',2018-10-08,TRF FROM  Indiaforensic SERVICES,0.0,341292.0,3146092.640000004,2018,10,8,TRANSFER,341292.0,M345584390
6094,409000493210',2018-10-08,Indiaforensic RUPAY SETT 071018,15791.57,0.0,3130301.0700000036,2018,10,8,CASH_OUT,15791.57,M1751574336
6095,409000493210',2018-10-08,Indiaforensic RUPAY SETT 071018,0.0,2084.21,3132385.2800000035,2018,10,8,CHECK_CASHING,2084.21,M1896461827
6096,409000493210',2018-10-08,Indiaforensic RUPAY STL INTC0710,143.33,0.0,3132241.950000004,2018,10,8,CASH_OUT,143.33,M699787227
6097,409000493210',2018-10-08,Indiaforensic RUPAY SETT 081018,11882.57,0.0,3120359.3800000036,2018,10,8,DEBIT,11882.57,M342419584
6098,409000493210',2018-10-08,Indiaforensic RUPAY STL INTC0810,112.23,0.0,3120247.1500000036,2018,10,8,CASH_OUT,112.23,M1443030336
6099,409000493210',2018-10-08,Indiaforensic RUPAY STL INTC0710,0.0,29.78,3120276.930000004,2018,10,8,CASH_IN,29.78,C662736689
6100,409000493210',2018-10-08,Indiaforensic RUPAY SETT 081018,0.0,220.48,3120497.410000004,2018,10,8,TRANSFER,220.48,M1753110043
6101,409000493210',2018-10-08,Indiaforensic RUPAY STL INTC0810,0.0,1.67,3120499.080000004,2018,10,8,TRANSFER,1.67,M1979242928
6102,409000493210',2018-10-08,Indiaforensic  RUPAY SETT 081018,1788.54,0.0,3118710.5400000038,2018,10,8,PAYEMENT,1788.54,M505671182
6103,409000493210',2018-10-08,Indiaforensic  RUPAY SETT 081018,0.0,18.31,3118728.850000004,2018,10,8,TRANSFER,18.31,C557041912
6104,409000493210',2018-10-08,Indiaforensic RUPAY STL INTC0810,18.31,0.0,3118710.5400000038,2018,10,8,CHECK_WITHDRAWAL,18.31,M28064367
6105,409000493210',2018-10-08,FDRL/INTERNAL FUND TRANSFE,0.0,100000.0,3218710.5400000038,2018,10,8,TRANSFER,100000.0,C1838584624
6106,409000493210',2018-10-08,FDRL/INTERNAL FUND TRANSFE,0.0,100000.0,3318710.5400000038,2018,10,8,TRANSFER,100000.0,M1355074
6107,409000493210',2018-10-09,Indiaforensic NFS SETT 06-10-201,10000.0,0.0,3308710.5400000038,2018,10,9,DEBIT,10000.0,C193864812
6108,409000493210',2018-10-09,Indiaforensic NFS SETT 06-10-201,9500.0,0.0,3299210.5400000038,2018,10,9,CASH_OUT,9500.0,M2115461862
6109,409000493210',2018-10-09,Indiaforensic NFS SETT 06-10-201,300.0,0.0,3298910.5400000038,2018,10,9,CHECK_WITHDRAWAL,300.0,M1735935287
6110,409000493210',2018-10-09,Indiaforensic NFS SETT 06-10-201,9500.0,0.0,3289410.5400000038,2018,10,9,DEBIT,9500.0,M1378422371
6111,409000493210',2018-10-09,Indiaforensic NFS SETT 06-10-201,4000.0,0.0,3285410.5400000038,2018,10,9,CASH_OUT,4000.0,M1238989252
6112,409000493210',2018-10-09,Indiaforensic NFS SETT 06-10-201,1500.0,0.0,3283910.5400000038,2018,10,9,DEBIT,1500.0,M644950072
6113,409000493210',2018-10-09,Indiaforensic NFS SETT 06-10-201,9500.0,0.0,3274410.5400000038,2018,10,9,CASH_OUT,9500.0,M646909939
6114,409000493210',2018-10-09,Indiaforensic NFS SETT 06-10-201,8500.0,0.0,3265910.5400000038,2018,10,9,CHECK_WITHDRAWAL,8500.0,C40075281
6115,409000493210',2018-10-09,Indiaforensic NFS SETT 06-10-201,500.0,0.0,3265410.5400000038,2018,10,9,CASH_OUT,500.0,M1212897825
6116,409000493210',2018-10-09,Indiaforensic NFS SETT 06-10-201,500.0,0.0,3264910.5400000038,2018,10,9,DEBIT,500.0,C1789550256
6117,409000493210',2018-10-09,Indiaforensic NFS SETT 06-10-201,1500.0,0.0,3263410.5400000038,2018,10,9,PAYEMENT,1500.0,C1262822392
6118,409000493210',2018-10-09,Indiaforensic NFS SETT 06-10-201,500.0,0.0,3262910.5400000038,2018,10,9,CASH_OUT,500.0,M1433690944
6119,409000493210',2018-10-09,Indiaforensic NFS SETT 06-10-201,8000.0,0.0,3254910.5400000038,2018,10,9,CHECK_WITHDRAWAL,8000.0,M2132465734
6120,409000493210',2018-10-09,Indiaforensic NFS SETT 06-10-201,8100.0,0.0,3246810.5400000038,2018,10,9,CASH_OUT,8100.0,M734191650
6121,409000493210',2018-10-09,Indiaforensic NFS SETT 06-10-201,8000.0,0.0,3238810.5400000038,2018,10,9,CASH_OUT,8000.0,M199344266
6122,409000493210',2018-10-09,Indiaforensic NFS SETT 06-10-201,7000.0,0.0,3231810.5400000038,2018,10,9,PAYEMENT,7000.0,M1031486232
6123,409000493210',2018-10-09,Indiaforensic NFS SETT 06-10-201,8000.0,0.0,3223810.5400000038,2018,10,9,DEBIT,8000.0,M487435538
6124,409000493210',2018-10-09,Indiaforensic NFS SETT 06-10-201,8100.0,0.0,3215710.5400000038,2018,10,9,CASH_OUT,8100.0,M1487465071
6125,409000493210',2018-10-09,Indiaforensic NFS SETT 06-10-201,600.0,0.0,3215110.5400000038,2018,10,9,PAYEMENT,600.0,M1585347198
6126,409000493210',2018-10-09,Indiaforensic NFS SETT 06-10-201,9500.0,0.0,3205610.5400000038,2018,10,9,PAYEMENT,9500.0,M1859855
6127,409000493210',2018-10-09,Indiaforensic NFS SETT 06-10-201,10000.0,0.0,3195610.5400000038,2018,10,9,PAYEMENT,10000.0,C1504109395
6128,409000493210',2018-10-09,Indiaforensic NFS SETT 06-10-201,6500.0,0.0,3189110.5400000038,2018,10,9,DEBIT,6500.0,M96665725
6129,409000493210',2018-10-09,Indiaforensic NFS SETT 06-10-201,7700.0,0.0,3181410.5400000038,2018,10,9,PAYEMENT,7700.0,M1922498059
6130,409000493210',2018-10-09,Indiaforensic NFS SETT 06-10-201,9000.0,0.0,3172410.5400000038,2018,10,9,PAYEMENT,9000.0,M1468876586
6131,409000493210',2018-10-09,Indiaforensic NFS SETT 06-10-201,9500.0,0.0,3162910.5400000038,2018,10,9,CASH_OUT,9500.0,M1421004802
6132,409000493210',2018-10-09,Indiaforensic NFS SETT 06-10-201,5000.0,0.0,3157910.5400000038,2018,10,9,PAYEMENT,5000.0,M546685745
6133,409000493210',2018-10-09,Indiaforensic NFS SETT 06-10-201,8500.0,0.0,3149410.5400000038,2018,10,9,CASH_OUT,8500.0,M2071551415
6134,409000493210',2018-10-09,Indiaforensic NFS SETT 06-10-201,8000.0,0.0,3141410.5400000038,2018,10,9,CHECK_WITHDRAWAL,8000.0,M193240998
6135,409000493210',2018-10-09,Indiaforensic NFS SETT 06-10-201,9000.0,0.0,3132410.5400000038,2018,10,9,CHECK_WITHDRAWAL,9000.0,M1319019311
6136,409000493210',2018-10-09,Indiaforensic NFS SETT 06-10-201,500.0,0.0,3131910.5400000038,2018,10,9,CHECK_WITHDRAWAL,500.0,M1455066764
6137,409000493210',2018-10-09,Indiaforensic NFS SETT 06-10-201,5000.0,0.0,3126910.5400000038,2018,10,9,CHECK_WITHDRAWAL,5000.0,C2066777507
6138,409000493210',2018-10-09,Indiaforensic NFS SETT 06-10-201,8600.0,0.0,3118310.5400000038,2018,10,9,PAYEMENT,8600.0,M1471857648
6139,409000493210',2018-10-09,Indiaforensic NFS SETT 06-10-201,7000.0,0.0,3111310.5400000038,2018,10,9,CHECK_WITHDRAWAL,7000.0,M1088287545
6140,409000493210',2018-10-09,Indiaforensic NFS SETT 06-10-201,8000.0,0.0,3103310.5400000038,2018,10,9,CHECK_WITHDRAWAL,8000.0,M220666452
6141,409000493210',2018-10-09,Indiaforensic NFS SETT 06-10-201,10000.0,0.0,3093310.5400000038,2018,10,9,CHECK_WITHDRAWAL,10000.0,M1083413945
6142,409000493210',2018-10-09,Indiaforensic NFS SETT 06-10-201,200.0,0.0,3093110.5400000038,2018,10,9,CASH_OUT,200.0,M1722316058
6143,409000493210',2018-10-09,Indiaforensic NFS SETT 06-10-201,5000.0,0.0,3088110.5400000038,2018,10,9,CHECK_WITHDRAWAL,5000.0,M304088688
6144,409000493210',2018-10-09,Indiaforensic NFS SETT 06-10-201,6500.0,0.0,3081610.5400000038,2018,10,9,CASH_OUT,6500.0,M628831585
6145,409000493210',2018-10-09,Indiaforensic NFS SETT 06-10-201,100.0,0.0,3081510.5400000038,2018,10,9,CHECK_WITHDRAWAL,100.0,C1477979030
6146,409000493210',2018-10-09,Indiaforensic NFS SETT 06-10-201,400.0,0.0,3081110.5400000038,2018,10,9,DEBIT,400.0,M514587349
6147,409000493210',2018-10-09,Indiaforensic NFS SETT 06-10-201,7700.0,0.0,3073410.5400000038,2018,10,9,CASH_OUT,7700.0,M707108719
6148,409000493210',2018-10-09,Indiaforensic NFS SETT 06-10-201,9000.0,0.0,3064410.5400000038,2018,10,9,DEBIT,9000.0,C1590550415
6149,409000493210',2018-10-09,Indiaforensic NFS SETT 06-10-201,7000.0,0.0,3057410.5400000038,2018,10,9,CHECK_WITHDRAWAL,7000.0,C97730845
6150,409000493210',2018-10-09,Indiaforensic NFS SETT 06-10-201,500.0,0.0,3056910.5400000038,2018,10,9,CASH_OUT,500.0,M1641292405
6151,409000493210',2018-10-09,Indiaforensic NFS SETT 06-10-201,9500.0,0.0,3047410.5400000038,2018,10,9,DEBIT,9500.0,M1095290435
6152,409000493210',2018-10-09,Indiaforensic NFS SETT 06-10-201,9500.0,0.0,3037910.5400000038,2018,10,9,CASH_OUT,9500.0,C985934102
6153,409000493210',2018-10-09,Indiaforensic NFS SETT 06-10-201,8500.0,0.0,3029410.5400000038,2018,10,9,CHECK_WITHDRAWAL,8500.0,M1097558044
6154,409000493210',2018-10-09,Indiaforensic NFS SETT 06-10-201,10000.0,0.0,3019410.5400000038,2018,10,9,PAYEMENT,10000.0,C1360767589
6155,409000493210',2018-10-09,Indiaforensic NFS SETT 06-10-201,5000.0,0.0,3014410.5400000038,2018,10,9,PAYEMENT,5000.0,M1015178392
6156,409000493210',2018-10-09,Indiaforensic NFS SETT 06-10-201,300.0,0.0,3014110.5400000038,2018,10,9,DEBIT,300.0,M1425169218
6157,409000493210',2018-10-09,Indiaforensic NFS SETT 06-10-201,3500.0,0.0,3010610.5400000038,2018,10,9,CASH_OUT,3500.0,M2098556815
6158,409000493210',2018-10-09,Indiaforensic NFS SETT 06-10-201,8500.0,0.0,3002110.5400000038,2018,10,9,CHECK_WITHDRAWAL,8500.0,M57973803
6159,409000493210',2018-10-09,Indiaforensic NFS SETT 06-10-201,8500.0,0.0,2993610.5400000038,2018,10,9,CASH_OUT,8500.0,M1691955350
6160,409000493210',2018-10-09,Indiaforensic NFS SETT 06-10-201,8000.0,0.0,2985610.5400000038,2018,10,9,DEBIT,8000.0,M1373579841
6161,409000493210',2018-10-09,Indiaforensic NFS SETT 06-10-201,100.0,0.0,2985510.5400000038,2018,10,9,CHECK_WITHDRAWAL,100.0,M2081098713
6162,409000493210',2018-10-09,Indiaforensic NFS SETT 06-10-201,100.0,0.0,2985410.5400000038,2018,10,9,PAYEMENT,100.0,C1394526584
6163,409000493210',2018-10-09,Indiaforensic NFS SETT 06-10-201,8500.0,0.0,2976910.5400000038,2018,10,9,PAYEMENT,8500.0,M1189496205
6164,409000493210',2018-10-09,Indiaforensic NFS SETT 06-10-201,2000.0,0.0,2974910.5400000038,2018,10,9,PAYEMENT,2000.0,M106784320
6165,409000493210',2018-10-09,Indiaforensic NFS SETT 06-10-201,500.0,0.0,2974410.5400000038,2018,10,9,CASH_OUT,500.0,C1335946878
6166,409000493210',2018-10-09,Indiaforensic NFS SETT 06-10-201,7500.0,0.0,2966910.5400000038,2018,10,9,DEBIT,7500.0,M1333929103
6167,409000493210',2018-10-09,Indiaforensic NFS SETT 06-10-201,1000.0,0.0,2965910.5400000038,2018,10,9,CASH_OUT,1000.0,C553264065
6168,409000493210',2018-10-09,Indiaforensic NFS SETT 06-10-201,3500.0,0.0,2962410.5400000038,2018,10,9,CHECK_WITHDRAWAL,3500.0,M568787640
6169,409000493210',2018-10-09,Indiaforensic NFS SETT 06-10-201,10000.0,0.0,2952410.5400000038,2018,10,9,PAYEMENT,10000.0,M1553874177
6170,409000493210',2018-10-09,Indiaforensic NFS SETT 06-10-201,8400.0,0.0,2944010.5400000038,2018,10,9,CHECK_WITHDRAWAL,8400.0,C1345063038
6171,409000493210',2018-10-09,Indiaforensic NFS SETT 06-10-201,7500.0,0.0,2936510.5400000038,2018,10,9,PAYEMENT,7500.0,M81788921
6172,409000493210',2018-10-09,Indiaforensic NFS SETT 06-10-201,8900.0,0.0,2927610.5400000038,2018,10,9,CASH_OUT,8900.0,M2075283526
6173,409000493210',2018-10-09,Indiaforensic NFS SETT 06-10-201,100.0,0.0,2927510.5400000038,2018,10,9,CASH_OUT,100.0,M308998656
6174,409000493210',2018-10-09,Indiaforensic NFS SETT 06-10-201,5000.0,0.0,2922510.5400000038,2018,10,9,CASH_OUT,5000.0,M2010733041
6175,409000493210',2018-10-09,Indiaforensic NFS SETT 06-10-201,8400.0,0.0,2914110.5400000038,2018,10,9,PAYEMENT,8400.0,M1425445649
6176,409000493210',2018-10-09,Indiaforensic NFS SETT 06-10-201,8500.0,0.0,2905610.5400000038,2018,10,9,CASH_OUT,8500.0,M2006168925
6177,409000493210',2018-10-09,Indiaforensic NFS SETT 06-10-201,8000.0,0.0,2897610.5400000038,2018,10,9,DEBIT,8000.0,C1440325059
6178,409000493210',2018-10-09,Indiaforensic NFS SETT 06-10-201,7400.0,0.0,2890210.5400000038,2018,10,9,DEBIT,7400.0,C1330106945
6179,409000493210',2018-10-09,Indiaforensic NFS SETT 06-10-201,100.0,0.0,2890110.5400000038,2018,10,9,CHECK_WITHDRAWAL,100.0,M696007235
6180,409000493210',2018-10-09,Indiaforensic NFS SETT 06-10-201,9000.0,0.0,2881110.5400000038,2018,10,9,DEBIT,9000.0,M979620424
6181,409000493210',2018-10-09,Indiaforensic NFS SETT 06-10-201,9500.0,0.0,2871610.5400000038,2018,10,9,PAYEMENT,9500.0,M1260527949
6182,409000493210',2018-10-09,Indiaforensic NFS SETT 06-10-201,10000.0,0.0,2861610.5400000038,2018,10,9,PAYEMENT,10000.0,M1843272693
6183,409000493210',2018-10-09,Indiaforensic NFS SETT 06-10-201,2000.0,0.0,2859610.5400000038,2018,10,9,CASH_OUT,2000.0,M287628665
6184,409000493210',2018-10-09,Indiaforensic NFS SETT 06-10-201,8000.0,0.0,2851610.5400000038,2018,10,9,CHECK_WITHDRAWAL,8000.0,M514420722
6185,409000493210',2018-10-09,Indiaforensic NFS SETT 06-10-201,500.0,0.0,2851110.5400000038,2018,10,9,CASH_OUT,500.0,C490766432
6186,409000493210',2018-10-09,Indiaforensic NFS SETT 06-10-201,8000.0,0.0,2843110.5400000038,2018,10,9,CHECK_WITHDRAWAL,8000.0,M2049393953
6187,409000493210',2018-10-09,Indiaforensic NFS SETT 06-10-201,400.0,0.0,2842710.5400000038,2018,10,9,CHECK_WITHDRAWAL,400.0,M56115670
6188,409000493210',2018-10-09,Indiaforensic NFS SETT 06-10-201,4500.0,0.0,2838210.5400000038,2018,10,9,CHECK_WITHDRAWAL,4500.0,M508619583
6189,409000493210',2018-10-09,Indiaforensic NFS SETT 06-10-201,6000.0,0.0,2832210.5400000038,2018,10,9,CHECK_WITHDRAWAL,6000.0,M1400132053
6190,409000493210',2018-10-09,Indiaforensic NFS SETT 06-10-201,8500.0,0.0,2823710.5400000038,2018,10,9,DEBIT,8500.0,M1632468927
6191,409000493210',2018-10-09,Indiaforensic NFS SETT 06-10-201,9000.0,0.0,2814710.540000004,2018,10,9,DEBIT,9000.0,M495828752
6192,409000493210',2018-10-09,Indiaforensic NFS SETT 06-10-201,9500.0,0.0,2805210.540000004,2018,10,9,DEBIT,9500.0,M78461289
6193,409000493210',2018-10-09,Indiaforensic NFS SETT 06-10-201,1000.0,0.0,2804210.540000004,2018,10,9,CHECK_WITHDRAWAL,1000.0,M763011729
6194,409000493210',2018-10-09,Indiaforensic NFS SETT 06-10-201,200.0,0.0,2804010.540000004,2018,10,9,DEBIT,200.0,M1982652230
6195,409000493210',2018-10-09,Indiaforensic NFS SETT 06-10-201,10000.0,0.0,2794010.540000004,2018,10,9,DEBIT,10000.0,C214774813
6196,409000493210',2018-10-09,Indiaforensic NFS SETT 06-10-201,1000.0,0.0,2793010.540000004,2018,10,9,DEBIT,1000.0,C803116137
6197,409000493210',2018-10-09,Indiaforensic NFS SETT 06-10-201,5000.0,0.0,2788010.540000004,2018,10,9,CHECK_WITHDRAWAL,5000.0,M434297724
6198,409000493210',2018-10-09,Indiaforensic NFS SETT 06-10-201,100.0,0.0,2787910.540000004,2018,10,9,CASH_OUT,100.0,M1397735927
6199,409000493210',2018-10-09,Indiaforensic NFS SETT 06-10-201,100.0,0.0,2787810.540000004,2018,10,9,CHECK_WITHDRAWAL,100.0,M1928075000
6200,409000493210',2018-10-09,Indiaforensic NFS SETT 06-10-201,100.0,0.0,2787710.540000004,2018,10,9,PAYEMENT,100.0,C18928637
6201,409000493210',2018-10-09,Indiaforensic NFS SETT 06-10-201,4000.0,0.0,2783710.540000004,2018,10,9,CHECK_WITHDRAWAL,4000.0,M668762558
6202,409000493210',2018-10-09,Indiaforensic NFS SETT 06-10-201,8500.0,0.0,2775210.540000004,2018,10,9,DEBIT,8500.0,C1346667529
6203,409000493210',2018-10-09,Indiaforensic NFS SETT 06-10-201,7800.0,0.0,2767410.540000004,2018,10,9,CASH_OUT,7800.0,M1901543742
6204,409000493210',2018-10-09,Indiaforensic NFS SETT 06-10-201,100.0,0.0,2767310.540000004,2018,10,9,CASH_OUT,100.0,M789479336
6205,409000493210',2018-10-09,Indiaforensic NFS SETT 06-10-201,8100.0,0.0,2759210.540000004,2018,10,9,CASH_OUT,8100.0,C193864812
6206,409000493210',2018-10-09,Indiaforensic NFS SETT 06-10-201,8100.0,0.0,2751110.540000004,2018,10,9,PAYEMENT,8100.0,C1880332929
6207,409000493210',2018-10-09,Indiaforensic NFS SETT 06-10-201,8300.0,0.0,2742810.540000004,2018,10,9,CASH_OUT,8300.0,M776691105
6208,409000493210',2018-10-09,Indiaforensic NFS SETT 06-10-201,8200.0,0.0,2734610.540000004,2018,10,9,DEBIT,8200.0,C361843637
6209,409000493210',2018-10-09,Indiaforensic NFS SETT 06-10-201,8900.0,0.0,2725710.540000004,2018,10,9,PAYEMENT,8900.0,C33524623
6210,409000493210',2018-10-09,Indiaforensic NFS SETT 06-10-201,9300.0,0.0,2716410.540000004,2018,10,9,CASH_OUT,9300.0,M1752820099
6211,409000493210',2018-10-09,Indiaforensic NFS SETT 06-10-201,8100.0,0.0,2708310.540000004,2018,10,9,CHECK_WITHDRAWAL,8100.0,C766681183
6212,409000493210',2018-10-09,Indiaforensic NFS SETT 06-10-201,10000.0,0.0,2698310.540000004,2018,10,9,CASH_OUT,10000.0,C1303868418
6213,409000493210',2018-10-09,Indiaforensic NFS SETT 07-10-201,5000.0,0.0,2693310.540000004,2018,10,9,CASH_OUT,5000.0,C499052031
6214,409000493210',2018-10-09,Indiaforensic NFS SETT 07-10-201,7000.0,0.0,2686310.540000004,2018,10,9,DEBIT,7000.0,M1421622223
6215,409000493210',2018-10-09,Indiaforensic NFS SETT 07-10-201,8000.0,0.0,2678310.540000004,2018,10,9,DEBIT,8000.0,M326190931
6216,409000493210',2018-10-09,Indiaforensic NFS SETT 07-10-201,1500.0,0.0,2676810.540000004,2018,10,9,CHECK_WITHDRAWAL,1500.0,M158065070
6217,409000493210',2018-10-09,Indiaforensic NFS SETT 07-10-201,5000.0,0.0,2671810.540000004,2018,10,9,PAYEMENT,5000.0,M2011639997
6218,409000493210',2018-10-09,Indiaforensic NFS SETT 07-10-201,7500.0,0.0,2664310.540000004,2018,10,9,PAYEMENT,7500.0,M2072818307
6219,409000493210',2018-10-09,Indiaforensic NFS SETT 07-10-201,1000.0,0.0,2663310.540000004,2018,10,9,PAYEMENT,1000.0,M1981414375
6220,409000493210',2018-10-09,Indiaforensic NFS SETT 07-10-201,400.0,0.0,2662910.540000004,2018,10,9,PAYEMENT,400.0,M669807779
6221,409000493210',2018-10-09,Indiaforensic NFS SETT 07-10-201,200.0,0.0,2662710.540000004,2018,10,9,CASH_OUT,200.0,M201327799
6222,409000493210',2018-10-09,Indiaforensic NFS SETT 07-10-201,10000.0,0.0,2652710.540000004,2018,10,9,CHECK_WITHDRAWAL,10000.0,M654651991
6223,409000493210',2018-10-09,Indiaforensic NFS SETT 07-10-201,7600.0,0.0,2645110.540000004,2018,10,9,CHECK_WITHDRAWAL,7600.0,M1713836982
6224,409000493210',2018-10-09,Indiaforensic NFS SETT 07-10-201,100.0,0.0,2645010.540000004,2018,10,9,CHECK_WITHDRAWAL,100.0,M1271565999
6225,409000493210',2018-10-09,Indiaforensic NFS SETT 07-10-201,1000.0,0.0,2644010.540000004,2018,10,9,CHECK_WITHDRAWAL,1000.0,M193020660
6226,409000493210',2018-10-09,Indiaforensic NFS SETT 07-10-201,10000.0,0.0,2634010.540000004,2018,10,9,CHECK_WITHDRAWAL,10000.0,M1299564036
6227,409000493210',2018-10-09,Indiaforensic NFS SETT 07-10-201,9000.0,0.0,2625010.540000004,2018,10,9,CHECK_WITHDRAWAL,9000.0,M871557892
6228,409000493210',2018-10-09,Indiaforensic NFS SETT 07-10-201,7800.0,0.0,2617210.540000004,2018,10,9,CHECK_WITHDRAWAL,7800.0,M785880972
6229,409000493210',2018-10-09,Indiaforensic NFS SETT 07-10-201,10000.0,0.0,2607210.540000004,2018,10,9,CHECK_WITHDRAWAL,10000.0,M342373282
6230,409000493210',2018-10-09,Indiaforensic NFS SETT 07-10-201,8900.0,0.0,2598310.540000004,2018,10,9,CHECK_WITHDRAWAL,8900.0,M1112151343
6231,409000493210',2018-10-09,Indiaforensic NFS SETT 07-10-201,500.0,0.0,2597810.540000004,2018,10,9,CASH_OUT,500.0,M363682507
6232,409000493210',2018-10-09,Indiaforensic NFS SETT 07-10-201,7000.0,0.0,2590810.540000004,2018,10,9,CASH_OUT,7000.0,M1270478804
6233,409000493210',2018-10-09,Indiaforensic NFS SETT 07-10-201,10000.0,0.0,2580810.540000004,2018,10,9,DEBIT,10000.0,M406780058
6234,409000493210',2018-10-09,Indiaforensic NFS SETT 07-10-201,7400.0,0.0,2573410.540000004,2018,10,9,DEBIT,7400.0,M117079268
6235,409000493210',2018-10-09,Indiaforensic NFS SETT 07-10-201,300.0,0.0,2573110.540000004,2018,10,9,PAYEMENT,300.0,M1519076003
6236,409000493210',2018-10-09,Indiaforensic NFS SETT 07-10-201,3000.0,0.0,2570110.540000004,2018,10,9,CHECK_WITHDRAWAL,3000.0,M1141927461
6237,409000493210',2018-10-09,Indiaforensic NFS SETT 07-10-201,4000.0,0.0,2566110.540000004,2018,10,9,PAYEMENT,4000.0,M90480469
6238,409000493210',2018-10-09,Indiaforensic NFS SETT 07-10-201,3000.0,0.0,2563110.540000004,2018,10,9,PAYEMENT,3000.0,M304548353
6239,409000493210',2018-10-09,Indiaforensic NFS SETT 07-10-201,1000.0,0.0,2562110.540000004,2018,10,9,PAYEMENT,1000.0,M1684887757
6240,409000493210',2018-10-09,Indiaforensic NFS SETT 07-10-201,500.0,0.0,2561610.540000004,2018,10,9,PAYEMENT,500.0,C453211571
6241,409000493210',2018-10-09,Indiaforensic NFS SETT 07-10-201,7500.0,0.0,2554110.540000004,2018,10,9,CASH_OUT,7500.0,C1477979030
6242,409000493210',2018-10-09,Indiaforensic NFS SETT 07-10-201,8000.0,0.0,2546110.540000004,2018,10,9,DEBIT,8000.0,M1312744535
6243,409000493210',2018-10-09,Indiaforensic NFS SETT 07-10-201,9500.0,0.0,2536610.540000004,2018,10,9,CHECK_WITHDRAWAL,9500.0,M263373555
6244,409000493210',2018-10-09,Indiaforensic NFS SETT 07-10-201,200.0,0.0,2536410.540000004,2018,10,9,CHECK_WITHDRAWAL,200.0,M757762073
6245,409000493210',2018-10-09,Indiaforensic NFS SETT 07-10-201,3000.0,0.0,2533410.540000004,2018,10,9,CASH_OUT,3000.0,M1801764705
6246,409000493210',2018-10-09,Indiaforensic NFS SETT 07-10-201,8500.0,0.0,2524910.540000004,2018,10,9,CASH_OUT,8500.0,C638590716
6247,409000493210',2018-10-09,Indiaforensic NFS SETT 07-10-201,9000.0,0.0,2515910.540000004,2018,10,9,CASH_OUT,9000.0,C1112414583
6248,409000493210',2018-10-09,Indiaforensic NFS SETT 07-10-201,1500.0,0.0,2514410.540000004,2018,10,9,CHECK_WITHDRAWAL,1500.0,M101406015
6249,409000493210',2018-10-09,Indiaforensic NFS SETT 07-10-201,1500.0,0.0,2512910.540000004,2018,10,9,CHECK_WITHDRAWAL,1500.0,M1722528506
6250,409000493210',2018-10-09,Indiaforensic NFS SETT 07-10-201,8500.0,0.0,2504410.540000004,2018,10,9,CASH_OUT,8500.0,M557037330
6251,409000493210',2018-10-09,Indiaforensic NFS SETT 07-10-201,2000.0,0.0,2502410.540000004,2018,10,9,CASH_OUT,2000.0,M1895373539
6252,409000493210',2018-10-09,Indiaforensic NFS SETT 07-10-201,2000.0,0.0,2500410.540000004,2018,10,9,DEBIT,2000.0,M1546272524
6253,409000493210',2018-10-09,Indiaforensic NFS SETT 07-10-201,1000.0,0.0,2499410.540000004,2018,10,9,PAYEMENT,1000.0,M1569980193
6254,409000493210',2018-10-09,Indiaforensic NFS SETT 07-10-201,6000.0,0.0,2493410.540000004,2018,10,9,DEBIT,6000.0,C1058634310
6255,409000493210',2018-10-09,Indiaforensic NFS SETT 07-10-201,6500.0,0.0,2486910.540000004,2018,10,9,CHECK_WITHDRAWAL,6500.0,M395436593
6256,409000493210',2018-10-09,Indiaforensic NFS SETT 07-10-201,8000.0,0.0,2478910.540000004,2018,10,9,CHECK_WITHDRAWAL,8000.0,C403147759
6257,409000493210',2018-10-09,Indiaforensic NFS SETT 07-10-201,7500.0,0.0,2471410.540000004,2018,10,9,CHECK_WITHDRAWAL,7500.0,M615280623
6258,409000493210',2018-10-09,Indiaforensic NFS SETT 07-10-201,6000.0,0.0,2465410.540000004,2018,10,9,CHECK_WITHDRAWAL,6000.0,C1013700132
6259,409000493210',2018-10-09,Indiaforensic NFS SETT 07-10-201,10000.0,0.0,2455410.540000004,2018,10,9,PAYEMENT,10000.0,M1279399383
6260,409000493210',2018-10-09,Indiaforensic NFS SETT 07-10-201,500.0,0.0,2454910.540000004,2018,10,9,PAYEMENT,500.0,M334720373
6261,409000493210',2018-10-09,Indiaforensic NFS SETT 07-10-201,300.0,0.0,2454610.540000004,2018,10,9,DEBIT,300.0,M827715984
6262,409000493210',2018-10-09,Indiaforensic NFS SETT 07-10-201,3500.0,0.0,2451110.540000004,2018,10,9,CHECK_WITHDRAWAL,3500.0,M82565330
6263,409000493210',2018-10-09,Indiaforensic  RUPAY SETT 091018,2853.68,0.0,2448256.860000004,2018,10,9,PAYEMENT,2853.68,M1516501617
6264,409000493210',2018-10-09,Indiaforensic  RUPAY SETT 091018,0.0,28.14,2448285.000000004,2018,10,9,TRANSFER,28.14,M1343796587
6265,409000493210',2018-10-09,Indiaforensic RUPAY STL INTC0910,24.39,0.0,2448260.610000004,2018,10,9,PAYEMENT,24.39,M1937765828
6266,409000493210',2018-10-09,Indiaforensic RUPAY STL INTC0910,0.0,0.02,2448260.630000004,2018,10,9,CHECK_CASHING,0.02,C985934102
6267,409000493210',2018-10-09,FDRL/INTERNAL FUND TRANSFE,0.0,100000.0,2548260.630000004,2018,10,9,CASH_IN,100000.0,M1974105859
6268,409000493210',2018-10-09,TRF FROM  Indiaforensic SERVICES,0.0,32047.0,2580307.630000004,2018,10,9,CHECK_CASHING,32047.0,M865452711
6269,409000493210',2018-10-09,Indiaforensic NFS SETT 08-10-201,4000.0,0.0,2576307.630000004,2018,10,9,PAYEMENT,4000.0,M2016530858
6270,409000493210',2018-10-09,Indiaforensic NFS SETT 08-10-201,100.0,0.0,2576207.630000004,2018,10,9,CASH_OUT,100.0,M661941342
6271,409000493210',2018-10-09,Indiaforensic NFS SETT 08-10-201,5000.0,0.0,2571207.630000004,2018,10,9,CHECK_WITHDRAWAL,5000.0,M577828237
6272,409000493210',2018-10-09,Indiaforensic NFS SETT 08-10-201,6500.0,0.0,2564707.630000004,2018,10,9,CHECK_WITHDRAWAL,6500.0,M1416852258
6273,409000493210',2018-10-09,Indiaforensic NFS SETT 08-10-201,600.0,0.0,2564107.630000004,2018,10,9,DEBIT,600.0,M1931723660
6274,409000493210',2018-10-09,Indiaforensic NFS SETT 08-10-201,5000.0,0.0,2559107.630000004,2018,10,9,PAYEMENT,5000.0,M1671900358
6275,409000493210',2018-10-09,Indiaforensic NFS SETT 08-10-201,10000.0,0.0,2549107.630000004,2018,10,9,CASH_OUT,10000.0,C934085675
6276,409000493210',2018-10-09,Indiaforensic NFS SETT 08-10-201,3000.0,0.0,2546107.630000004,2018,10,9,CASH_OUT,3000.0,C662045021
6277,409000493210',2018-10-09,Indiaforensic NFS SETT 08-10-201,8000.0,0.0,2538107.630000004,2018,10,9,PAYEMENT,8000.0,M1867499583
6278,409000493210',2018-10-09,Indiaforensic NFS SETT 08-10-201,4500.0,0.0,2533607.630000004,2018,10,9,CASH_OUT,4500.0,M384097113
6279,409000493210',2018-10-09,Indiaforensic NFS SETT 08-10-201,10000.0,0.0,2523607.630000004,2018,10,9,CASH_OUT,10000.0,M312529481
6280,409000493210',2018-10-09,Indiaforensic NFS SETT 08-10-201,400.0,0.0,2523207.630000004,2018,10,9,DEBIT,400.0,C1899073220
6281,409000493210',2018-10-09,Indiaforensic NFS SETT 08-10-201,1000.0,0.0,2522207.630000004,2018,10,9,PAYEMENT,1000.0,C1777369261
6282,409000493210',2018-10-09,Indiaforensic NFS SETT 08-10-201,800.0,0.0,2521407.630000004,2018,10,9,CHECK_WITHDRAWAL,800.0,C728885526
6283,409000493210',2018-10-09,Indiaforensic NFS SETT 08-10-201,300.0,0.0,2521107.630000004,2018,10,9,CASH_OUT,300.0,M1297242263
6284,409000493210',2018-10-09,Indiaforensic NFS SETT 08-10-201,10000.0,0.0,2511107.630000004,2018,10,9,CASH_OUT,10000.0,C1339257929
6285,409000493210',2018-10-09,Indiaforensic NFS SETT 08-10-201,6000.0,0.0,2505107.630000004,2018,10,9,PAYEMENT,6000.0,M79702169
6286,409000493210',2018-10-09,Indiaforensic NFS SETT 08-10-201,6000.0,0.0,2499107.630000004,2018,10,9,PAYEMENT,6000.0,M1948456514
6287,409000493210',2018-10-09,Indiaforensic NFS SETT 08-10-201,8000.0,0.0,2491107.630000004,2018,10,9,CHECK_WITHDRAWAL,8000.0,M1341047172
6288,409000493210',2018-10-09,Indiaforensic NFS SETT 08-10-201,10000.0,0.0,2481107.630000004,2018,10,9,DEBIT,10000.0,M846778469
6289,409000493210',2018-10-09,Indiaforensic NFS SETT 08-10-201,2000.0,0.0,2479107.630000004,2018,10,9,CHECK_WITHDRAWAL,2000.0,M1017049979
6290,409000493210',2018-10-09,Indiaforensic NFS SETT 08-10-201,9000.0,0.0,2470107.630000004,2018,10,9,DEBIT,9000.0,M1015503057
6291,409000493210',2018-10-09,Indiaforensic NFS SETT 08-10-201,7000.0,0.0,2463107.630000004,2018,10,9,CHECK_WITHDRAWAL,7000.0,M1571025706
6292,409000493210',2018-10-09,Indiaforensic NFS SETT 08-10-201,300.0,0.0,2462807.630000004,2018,10,9,DEBIT,300.0,M1374962590
6293,409000493210',2018-10-09,Indiaforensic NFS SETT 08-10-201,9000.0,0.0,2453807.630000004,2018,10,9,CHECK_WITHDRAWAL,9000.0,C1345063038
6294,409000493210',2018-10-09,Indiaforensic NFS SETT 08-10-201,9000.0,0.0,2444807.630000004,2018,10,9,DEBIT,9000.0,M576577375
6295,409000493210',2018-10-09,Indiaforensic NFS SETT 08-10-201,10000.0,0.0,2434807.630000004,2018,10,9,CHECK_WITHDRAWAL,10000.0,M493177695
6296,409000493210',2018-10-09,Indiaforensic NFS SETT 08-10-201,10000.0,0.0,2424807.630000004,2018,10,9,PAYEMENT,10000.0,M456577608
6297,409000493210',2018-10-09,Indiaforensic NFS SETT 08-10-201,1000.0,0.0,2423807.630000004,2018,10,9,CASH_OUT,1000.0,M1234980193
6298,409000493210',2018-10-09,Indiaforensic NFS SETT 08-10-201,2000.0,0.0,2421807.630000004,2018,10,9,DEBIT,2000.0,C1592415783
6299,409000493210',2018-10-09,Indiaforensic NFS SETT 08-10-201,9000.0,0.0,2412807.630000004,2018,10,9,CASH_OUT,9000.0,C1396827930
6300,409000493210',2018-10-09,Indiaforensic NFS SETT 08-10-201,3000.0,0.0,2409807.630000004,2018,10,9,CASH_OUT,3000.0,M709955086
6301,409000493210',2018-10-09,Indiaforensic NFS SETT 08-10-201,3000.0,0.0,2406807.630000004,2018,10,9,CHECK_WITHDRAWAL,3000.0,C476800120
6302,409000493210',2018-10-09,Indiaforensic NFS SETT 08-10-201,8000.0,0.0,2398807.630000004,2018,10,9,CHECK_WITHDRAWAL,8000.0,M587141615
6303,409000493210',2018-10-09,Indiaforensic NFS SETT 08-10-201,400.0,0.0,2398407.630000004,2018,10,9,CASH_OUT,400.0,M37590923
6304,409000493210',2018-10-09,Indiaforensic NFS SETT 08-10-201,7000.0,0.0,2391407.630000004,2018,10,9,PAYEMENT,7000.0,M1725760738
6305,409000493210',2018-10-09,Indiaforensic NFS SETT 08-10-201,2000.0,0.0,2389407.630000004,2018,10,9,DEBIT,2000.0,M1786422901
6306,409000493210',2018-10-09,Indiaforensic NFS SETT 08-10-201,8500.0,0.0,2380907.630000004,2018,10,9,CHECK_WITHDRAWAL,8500.0,M1613378103
6307,409000493210',2018-10-09,Indiaforensic NFS SETT 08-10-201,500.0,0.0,2380407.630000004,2018,10,9,PAYEMENT,500.0,M1957118064
6308,409000493210',2018-10-09,Indiaforensic NFS SETT 08-10-201,3500.0,0.0,2376907.630000004,2018,10,9,DEBIT,3500.0,M1575171535
6309,409000493210',2018-10-09,Indiaforensic NFS SETT 08-10-201,400.0,0.0,2376507.630000004,2018,10,9,CASH_OUT,400.0,M1357442420
6310,409000493210',2018-10-09,Indiaforensic NFS SETT 08-10-201,1500.0,0.0,2375007.630000004,2018,10,9,PAYEMENT,1500.0,M811843176
6311,409000493210',2018-10-09,Indiaforensic NFS SETT 08-10-201,8000.0,0.0,2367007.630000004,2018,10,9,CASH_OUT,8000.0,M758057380
6312,409000493210',2018-10-09,Indiaforensic NFS SETT 08-10-201,3600.0,0.0,2363407.630000004,2018,10,9,CASH_OUT,3600.0,M559546980
6313,409000493210',2018-10-09,Indiaforensic NFS SETT 08-10-201,1000.0,0.0,2362407.630000004,2018,10,9,CASH_OUT,1000.0,M271874232
6314,409000493210',2018-10-09,Indiaforensic NFS SETT 08-10-201,7500.0,0.0,2354907.630000004,2018,10,9,CHECK_WITHDRAWAL,7500.0,M1454834922
6315,409000493210',2018-10-09,Indiaforensic NFS SETT 08-10-201,7500.0,0.0,2347407.630000004,2018,10,9,PAYEMENT,7500.0,M972458732
6316,409000493210',2018-10-09,Indiaforensic NFS SETT 08-10-201,8000.0,0.0,2339407.630000004,2018,10,9,PAYEMENT,8000.0,M193041293
6317,409000493210',2018-10-09,Indiaforensic NFS SETT 08-10-201,9500.0,0.0,2329907.630000004,2018,10,9,CASH_OUT,9500.0,M715194034
6318,409000493210',2018-10-09,Indiaforensic NFS SETT 08-10-201,10000.0,0.0,2319907.630000004,2018,10,9,CASH_OUT,10000.0,M839291796
6319,409000493210',2018-10-09,Indiaforensic NFS SETT 08-10-201,1000.0,0.0,2318907.630000004,2018,10,9,CASH_OUT,1000.0,M1572487132
6320,409000493210',2018-10-09,Indiaforensic NFS SETT 08-10-201,300.0,0.0,2318607.630000004,2018,10,9,CASH_OUT,300.0,M234287515
6321,409000493210',2018-10-09,Indiaforensic NFS SETT 08-10-201,1500.0,0.0,2317107.630000004,2018,10,9,DEBIT,1500.0,M1632419524
6322,409000493210',2018-10-09,Indiaforensic NFS SETT 08-10-201,2000.0,0.0,2315107.630000004,2018,10,9,PAYEMENT,2000.0,C1419794148
6323,409000493210',2018-10-09,Indiaforensic NFS SETT 08-10-201,1000.0,0.0,2314107.630000004,2018,10,9,DEBIT,1000.0,C127252077
6324,409000493210',2018-10-09,Indiaforensic NFS SETT 08-10-201,9000.0,0.0,2305107.630000004,2018,10,9,CHECK_WITHDRAWAL,9000.0,C453211571
6325,409000493210',2018-10-09,Indiaforensic  RUPAY SETT 091018,2533.82,0.0,2302573.8100000042,2018,10,9,CASH_OUT,2533.82,C193864812
6326,409000493210',2018-10-09,Indiaforensic  RUPAY SETT 091018,0.0,17.99,2302591.800000004,2018,10,9,TRANSFER,17.99,C503195940
6327,409000493210',2018-10-09,Indiaforensic RUPAY STL INTC0910,17.99,0.0,2302573.8100000042,2018,10,9,DEBIT,17.99,C11003494
6328,409000493210',2018-10-10,Indiaforensic  RUPAY SETT 101018,19868.74,0.0,2282705.070000004,2018,10,10,CHECK_WITHDRAWAL,19868.74,C1477979030
6329,409000493210',2018-10-10,Indiaforensic  RUPAY SETT 101018,0.0,249.33,2282954.400000004,2018,10,10,TRANSFER,249.33,C1538745405
6330,409000493210',2018-10-10,Indiaforensic RUPAY STL INTC1010,210.63,0.0,2282743.770000004,2018,10,10,PAYEMENT,210.63,C798678484
6331,409000493210',2018-10-10,Indiaforensic RUPAY STL INTC1010,0.0,0.29,2282744.0600000042,2018,10,10,TRANSFER,0.29,C1255024717
6332,409000493210',2018-10-10,Indiaforensic NFS SETT 09-10-201,10000.0,0.0,2272744.0600000042,2018,10,10,DEBIT,10000.0,C2118255842
6333,409000493210',2018-10-10,Indiaforensic NFS SETT 09-10-201,1100.0,0.0,2271644.0600000042,2018,10,10,DEBIT,1100.0,C667346055
6334,409000493210',2018-10-10,Indiaforensic NFS SETT 09-10-201,3500.0,0.0,2268144.0600000042,2018,10,10,PAYEMENT,3500.0,C1297685781
6335,409000493210',2018-10-10,Indiaforensic NFS SETT 09-10-201,7500.0,0.0,2260644.0600000042,2018,10,10,PAYEMENT,7500.0,M528846922
6336,409000493210',2018-10-10,Indiaforensic NFS SETT 09-10-201,10000.0,0.0,2250644.0600000042,2018,10,10,PAYEMENT,10000.0,M1664750059
6337,409000493210',2018-10-10,Indiaforensic NFS SETT 09-10-201,400.0,0.0,2250244.0600000042,2018,10,10,CHECK_WITHDRAWAL,400.0,C1234059684
6338,409000493210',2018-10-10,Indiaforensic NFS SETT 09-10-201,10000.0,0.0,2240244.0600000042,2018,10,10,PAYEMENT,10000.0,C1778801068
6339,409000493210',2018-10-10,Indiaforensic NFS SETT 09-10-201,4000.0,0.0,2236244.0600000042,2018,10,10,CASH_OUT,4000.0,C453211571
6340,409000493210',2018-10-10,Indiaforensic NFS SETT 09-10-201,200.0,0.0,2236044.0600000042,2018,10,10,DEBIT,200.0,C1183572822
6341,409000493210',2018-10-10,Indiaforensic NFS SETT 09-10-201,1500.0,0.0,2234544.0600000042,2018,10,10,CHECK_WITHDRAWAL,1500.0,C769342184
6342,409000493210',2018-10-10,Indiaforensic NFS SETT 09-10-201,4000.0,0.0,2230544.0600000042,2018,10,10,CASH_OUT,4000.0,C1674899618
6343,409000493210',2018-10-10,Indiaforensic NFS SETT 09-10-201,4000.0,0.0,2226544.0600000042,2018,10,10,PAYEMENT,4000.0,C11003494
6344,409000493210',2018-10-10,Indiaforensic NFS SETT 09-10-201,10000.0,0.0,2216544.0600000042,2018,10,10,CHECK_WITHDRAWAL,10000.0,C407757655
6345,409000493210',2018-10-10,Indiaforensic NFS SETT 09-10-201,4700.0,0.0,2211844.0600000042,2018,10,10,PAYEMENT,4700.0,C932583850
6346,409000493210',2018-10-10,Indiaforensic NFS SETT 09-10-201,8000.0,0.0,2203844.0600000042,2018,10,10,DEBIT,8000.0,C1750905143
6347,409000493210',2018-10-10,Indiaforensic NFS SETT 09-10-201,100.0,0.0,2203744.0600000042,2018,10,10,CASH_OUT,100.0,C434091818
6348,409000493210',2018-10-10,Indiaforensic NFS SETT 09-10-201,3400.0,0.0,2200344.0600000042,2018,10,10,CASH_OUT,3400.0,C662736689
6349,409000493210',2018-10-10,Indiaforensic NFS SETT 09-10-201,200.0,0.0,2200144.0600000042,2018,10,10,CASH_OUT,200.0,C1675375648
6350,409000493210',2018-10-10,Indiaforensic NFS SETT 09-10-201,7000.0,0.0,2193144.0600000042,2018,10,10,CHECK_WITHDRAWAL,7000.0,C2057394816
6351,409000493210',2018-10-10,Indiaforensic NFS SETT 09-10-201,4000.0,0.0,2189144.0600000042,2018,10,10,PAYEMENT,4000.0,C665576141
6352,409000493210',2018-10-10,Indiaforensic NFS SETT 09-10-201,300.0,0.0,2188844.0600000042,2018,10,10,PAYEMENT,300.0,C932583850
6353,409000493210',2018-10-10,Indiaforensic NFS SETT 09-10-201,500.0,0.0,2188344.0600000042,2018,10,10,DEBIT,500.0,C1504109395
6354,409000493210',2018-10-10,Indiaforensic NFS SETT 09-10-201,4500.0,0.0,2183844.0600000042,2018,10,10,PAYEMENT,4500.0,C1013700132
6355,409000493210',2018-10-10,Indiaforensic NFS SETT 09-10-201,7000.0,0.0,2176844.0600000042,2018,10,10,PAYEMENT,7000.0,C173783788
6356,409000493210',2018-10-10,Indiaforensic NFS SETT 09-10-201,500.0,0.0,2176344.0600000042,2018,10,10,CASH_OUT,500.0,C297785169
6357,409000493210',2018-10-10,Indiaforensic NFS SETT 09-10-201,10000.0,0.0,2166344.0600000042,2018,10,10,PAYEMENT,10000.0,C738590621
6358,409000493210',2018-10-10,Indiaforensic NFS SETT 09-10-201,400.0,0.0,2165944.0600000042,2018,10,10,DEBIT,400.0,C1022680775
6359,409000493210',2018-10-10,Indiaforensic  RUPAY SETT 101018,23984.26,0.0,2141959.800000004,2018,10,10,DEBIT,23984.26,C1922859107
6360,409000493210',2018-10-10,Indiaforensic RUPAY STL INTC1010,153.21,0.0,2141806.590000004,2018,10,10,DEBIT,153.21,C478124129
6361,409000493210',2018-10-10,Indiaforensic  RUPAY SETT 101018,0.0,153.21,2141959.800000004,2018,10,10,CHECK_CASHING,153.21,C736709391
6362,409000493210',2018-10-11,Indiaforensic NFS SETT 10-10-201,6000.0,0.0,2135959.800000004,2018,10,11,CASH_OUT,6000.0,C1983747920
6363,409000493210',2018-10-11,Indiaforensic NFS SETT 10-10-201,500.0,0.0,2135459.800000004,2018,10,11,PAYEMENT,500.0,C2043975568
6364,409000493210',2018-10-11,Indiaforensic NFS SETT 10-10-201,10000.0,0.0,2125459.800000004,2018,10,11,PAYEMENT,10000.0,C423583818
6365,409000493210',2018-10-11,Indiaforensic NFS SETT 10-10-201,1500.0,0.0,2123959.800000004,2018,10,11,DEBIT,1500.0,C1254526270
6366,409000493210',2018-10-11,Indiaforensic NFS SETT 10-10-201,2000.0,0.0,2121959.800000004,2018,10,11,CHECK_WITHDRAWAL,2000.0,C1746150957
6367,409000493210',2018-10-11,Indiaforensic NFS SETT 10-10-201,2000.0,0.0,2119959.800000004,2018,10,11,PAYEMENT,2000.0,C1289462509
6368,409000493210',2018-10-11,Indiaforensic NFS SETT 10-10-201,1500.0,0.0,2118459.800000004,2018,10,11,PAYEMENT,1500.0,C456172878
6369,409000493210',2018-10-11,Indiaforensic NFS SETT 10-10-201,400.0,0.0,2118059.800000004,2018,10,11,PAYEMENT,400.0,C1782113663
6370,409000493210',2018-10-11,Indiaforensic NFS SETT 10-10-201,500.0,0.0,2117559.800000004,2018,10,11,DEBIT,500.0,C798678484
6371,409000493210',2018-10-11,Indiaforensic NFS SETT 10-10-201,1000.0,0.0,2116559.800000004,2018,10,11,PAYEMENT,1000.0,C1750563752
6372,409000493210',2018-10-11,Indiaforensic NFS SETT 10-10-201,1000.0,0.0,2115559.800000004,2018,10,11,PAYEMENT,1000.0,C476179877
6373,409000493210',2018-10-11,Indiaforensic NFS SETT 10-10-201,9000.0,0.0,2106559.800000004,2018,10,11,CHECK_WITHDRAWAL,9000.0,C522173599
6374,409000493210',2018-10-11,Indiaforensic NFS SETT 10-10-201,9500.0,0.0,2097059.800000004,2018,10,11,PAYEMENT,9500.0,C1674899618
6375,409000493210',2018-10-11,Indiaforensic NFS SETT 10-10-201,10000.0,0.0,2087059.800000004,2018,10,11,DEBIT,10000.0,C728526866
6376,409000493210',2018-10-11,Indiaforensic NFS SETT 10-10-201,6000.0,0.0,2081059.800000004,2018,10,11,CASH_OUT,6000.0,C728885526
6377,409000493210',2018-10-11,Indiaforensic NFS SETT 10-10-201,2000.0,0.0,2079059.800000004,2018,10,11,DEBIT,2000.0,C869665662
6378,409000493210',2018-10-11,Indiaforensic NFS SETT 10-10-201,1000.0,0.0,2078059.800000004,2018,10,11,CASH_OUT,1000.0,C1540270363
6379,409000493210',2018-10-11,Indiaforensic NFS SETT 10-10-201,700.0,0.0,2077359.800000004,2018,10,11,CASH_OUT,700.0,C766681183
6380,409000493210',2018-10-11,Indiaforensic NFS SETT 10-10-201,200.0,0.0,2077159.800000004,2018,10,11,DEBIT,200.0,C1032986144
6381,409000493210',2018-10-11,Indiaforensic NFS SETT 10-10-201,300.0,0.0,2076859.800000004,2018,10,11,PAYEMENT,300.0,C1382717704
6382,409000493210',2018-10-11,Indiaforensic NFS SETT 10-10-201,1000.0,0.0,2075859.800000004,2018,10,11,CASH_OUT,1000.0,M748761773
6383,409000493210',2018-10-11,Indiaforensic NFS SETT 10-10-201,9000.0,0.0,2066859.800000004,2018,10,11,PAYEMENT,9000.0,C728885526
6384,409000493210',2018-10-11,Indiaforensic NFS SETT 10-10-201,5000.0,0.0,2061859.800000004,2018,10,11,DEBIT,5000.0,C1419794148
6385,409000493210',2018-10-11,Indiaforensic NFS SETT 10-10-201,3000.0,0.0,2058859.800000004,2018,10,11,DEBIT,3000.0,M984302294
6386,409000493210',2018-10-11,Indiaforensic NFS SETT 10-10-201,200.0,0.0,2058659.800000004,2018,10,11,CASH_OUT,200.0,C214774813
6387,409000493210',2018-10-11,Indiaforensic NFS SETT 10-10-201,8500.0,0.0,2050159.800000004,2018,10,11,CASH_OUT,8500.0,M389226553
6388,409000493210',2018-10-11,Indiaforensic NFS SETT 10-10-201,1000.0,0.0,2049159.800000004,2018,10,11,CASH_OUT,1000.0,M1900120650
6389,409000493210',2018-10-11,Indiaforensic NFS SETT 10-10-201,500.0,0.0,2048659.800000004,2018,10,11,CASH_OUT,500.0,M1775247809
6390,409000493210',2018-10-11,Indiaforensic  RUPAY SETT 111018,20851.25,0.0,2027808.550000004,2018,10,11,PAYEMENT,20851.25,M272354463
6391,409000493210',2018-10-11,Indiaforensic RUPAY STL INTC1110,280.75,0.0,2027527.800000004,2018,10,11,CASH_OUT,280.75,M2019489551
6392,409000493210',2018-10-11,Indiaforensic  RUPAY SETT 111018,0.0,280.75,2027808.550000004,2018,10,11,CHECK_CASHING,280.75,M1931130011
6393,409000493210',2018-10-11,Indiaforensic  RUPAY SETT 111018,4234.34,0.0,2023574.2100000042,2018,10,11,PAYEMENT,4234.34,M752679590
6394,409000493210',2018-10-11,Indiaforensic  RUPAY SETT 111018,0.0,48.82,2023623.030000004,2018,10,11,CHECK_CASHING,48.82,C1496102000
6395,409000493210',2018-10-11,Indiaforensic RUPAY STL INTC1110,43.42,0.0,2023579.610000004,2018,10,11,CHECK_WITHDRAWAL,43.42,C2066777507
6396,409000493210',2018-10-11,Indiaforensic RUPAY STL INTC1110,0.0,0.03,2023579.640000004,2018,10,11,CASH_IN,0.03,C1445567246
6397,409000493210',2018-10-12,Indiaforensic  RUPAY SETT 121018,4492.91,0.0,2019086.7300000042,2018,10,12,CHECK_WITHDRAWAL,4492.91,C991363637
6398,409000493210',2018-10-12,Indiaforensic  RUPAY SETT 121018,0.0,53.87,2019140.6000000043,2018,10,12,CHECK_CASHING,53.87,C717951588
6399,409000493210',2018-10-12,Indiaforensic RUPAY STL INTC1210,44.11,0.0,2019096.490000004,2018,10,12,DEBIT,44.11,C1394526584
6400,409000493210',2018-10-12,Indiaforensic RUPAY STL INTC1210,0.0,0.05,2019096.540000004,2018,10,12,CASH_IN,0.05,C977993101
6401,409000493210',2018-10-12,Indiaforensic  RUPAY SETT 121018,1073.18,0.0,2018023.3600000043,2018,10,12,DEBIT,1073.18,C1335946878
6402,409000493210',2018-10-12,Indiaforensic RUPAY STL INTC1210,10.92,0.0,2018012.4400000044,2018,10,12,CHECK_WITHDRAWAL,10.92,C1916720513
6403,409000493210',2018-10-12,Indiaforensic  RUPAY SETT 121018,0.0,10.92,2018023.3600000043,2018,10,12,CHECK_CASHING,10.92,C1013700132
6404,409000493210',2018-10-12,Indiaforensic NFS SETT 11-10-201,1500.0,0.0,2016523.3600000043,2018,10,12,PAYEMENT,1500.0,C459857341
6405,409000493210',2018-10-12,Indiaforensic NFS SETT 11-10-201,2000.0,0.0,2014523.3600000043,2018,10,12,DEBIT,2000.0,C1782113663
6406,409000493210',2018-10-12,Indiaforensic NFS SETT 11-10-201,4000.0,0.0,2010523.3600000043,2018,10,12,CASH_OUT,4000.0,C1286084959
6407,409000493210',2018-10-12,Indiaforensic NFS SETT 11-10-201,5000.0,0.0,2005523.3600000043,2018,10,12,CASH_OUT,5000.0,C1838584624
6408,409000493210',2018-10-12,Indiaforensic NFS SETT 11-10-201,7000.0,0.0,1998523.3600000043,2018,10,12,DEBIT,7000.0,C183354406
6409,409000493210',2018-10-12,Indiaforensic NFS SETT 11-10-201,1500.0,0.0,1997023.3600000043,2018,10,12,DEBIT,1500.0,C1468559919
6410,409000493210',2018-10-12,Indiaforensic NFS SETT 11-10-201,1200.0,0.0,1995823.3600000043,2018,10,12,CHECK_WITHDRAWAL,1200.0,C1005928818
6411,409000493210',2018-10-12,Indiaforensic NFS SETT 11-10-201,6000.0,0.0,1989823.3600000043,2018,10,12,CASH_OUT,6000.0,C481402298
6412,409000493210',2018-10-12,Indiaforensic NFS SETT 11-10-201,3000.0,0.0,1986823.3600000043,2018,10,12,PAYEMENT,3000.0,C1292838001
6413,409000493210',2018-10-12,Indiaforensic NFS SETT 11-10-201,500.0,0.0,1986323.3600000043,2018,10,12,DEBIT,500.0,C1123629720
6414,409000493210',2018-10-12,Indiaforensic NFS SETT 11-10-201,7000.0,0.0,1979323.3600000043,2018,10,12,PAYEMENT,7000.0,C1396827930
6415,409000493210',2018-10-12,Indiaforensic NFS SETT 11-10-201,8500.0,0.0,1970823.3600000043,2018,10,12,PAYEMENT,8500.0,C194746285
6416,409000493210',2018-10-12,Indiaforensic NFS SETT 11-10-201,2000.0,0.0,1968823.3600000043,2018,10,12,CHECK_WITHDRAWAL,2000.0,C1394526584
6417,409000493210',2018-10-12,Indiaforensic NFS SETT 11-10-201,2000.0,0.0,1966823.3600000043,2018,10,12,CHECK_WITHDRAWAL,2000.0,C451934410
6418,409000493210',2018-10-15,Indiaforensic RUPAY SETT 131018,20683.02,0.0,1946140.3400000043,2018,10,15,CHECK_WITHDRAWAL,20683.02,C1419794148
6419,409000493210',2018-10-15,Indiaforensic RUPAY STL INTC1310,183.47,0.0,1945956.8700000043,2018,10,15,CASH_OUT,183.47,C2066777507
6420,409000493210',2018-10-15,Indiaforensic RUPAY SETT 141018,25492.51,0.0,1920464.3600000043,2018,10,15,CASH_OUT,25492.51,C1789550256
6421,409000493210',2018-10-15,Indiaforensic RUPAY STL INTC1410,210.62,0.0,1920253.740000004,2018,10,15,DEBIT,210.62,C481402298
6422,409000493210',2018-10-15,Indiaforensic RUPAY SETT 131018,0.0,186.55,1920440.290000004,2018,10,15,TRANSFER,186.55,C985934102
6423,409000493210',2018-10-15,Indiaforensic RUPAY STL INTC1310,0.0,0.01,1920440.300000004,2018,10,15,CASH_IN,0.01,C11003494
6424,409000493210',2018-10-15,Indiaforensic RUPAY SETT 141018,0.0,215.39,1920655.6900000041,2018,10,15,CHECK_CASHING,215.39,M909315048
6425,409000493210',2018-10-15,Indiaforensic RUPAY STL INTC1410,0.0,0.03,1920655.7200000042,2018,10,15,TRANSFER,0.03,M1106392217
6426,409000493210',2018-10-15,Indiaforensic RUPAY SETT 151018,17977.31,0.0,1902678.410000004,2018,10,15,DEBIT,17977.31,M521786403
6427,409000493210',2018-10-15,Indiaforensic RUPAY SETT 151018,0.0,153.37,1902831.780000004,2018,10,15,CASH_IN,153.37,M596848689
6428,409000493210',2018-10-15,Indiaforensic RUPAY STL INTC1510,149.28,0.0,1902682.500000004,2018,10,15,CHECK_WITHDRAWAL,149.28,M484573851
6429,409000493210',2018-10-15,Indiaforensic RUPAY STL INTC1510,0.0,0.02,1902682.520000004,2018,10,15,CASH_IN,0.02,M2032247677
6430,409000493210',2018-10-15,Indiaforensic  RUPAY SETT 151018,24502.98,0.0,1878179.540000004,2018,10,15,CASH_OUT,24502.98,M1664659426
6431,409000493210',2018-10-15,Indiaforensic  RUPAY SETT 151018,0.0,177.2,1878356.740000004,2018,10,15,TRANSFER,177.2,M477655945
6432,409000493210',2018-10-15,Indiaforensic RUPAY STL INTC1510,156.78,0.0,1878199.9600000042,2018,10,15,DEBIT,156.78,M1095918240
6433,409000493210',2018-10-15,Indiaforensic RUPAY STL INTC1510,0.0,0.15,1878200.110000004,2018,10,15,TRANSFER,0.15,M1190799998
6434,409000493210',2018-10-16,Indiaforensic  RUPAY SETT 161018,23212.3,0.0,1854987.810000004,2018,10,16,DEBIT,23212.3,M1863834886
6435,409000493210',2018-10-16,Indiaforensic  RUPAY SETT 161018,0.0,358.84,1855346.650000004,2018,10,16,CASH_IN,358.84,M1858702540
6436,409000493210',2018-10-16,Indiaforensic RUPAY STL INTC1610,291.34,0.0,1855055.310000004,2018,10,16,CHECK_WITHDRAWAL,291.34,C183354406
6437,409000493210',2018-10-16,Indiaforensic RUPAY STL INTC1610,0.0,0.51,1855055.820000004,2018,10,16,CASH_IN,0.51,C609116570
6438,409000493210',2018-10-16,Indiaforensic  RUPAY SETT 161018,31085.98,0.0,1823969.840000004,2018,10,16,DEBIT,31085.98,C1251686742
6439,409000493210',2018-10-16,Indiaforensic  RUPAY SETT 161018,0.0,253.76,1824223.600000004,2018,10,16,CHECK_CASHING,253.76,C1155337528
6440,409000493210',2018-10-16,Indiaforensic RUPAY STL INTC1610,253.76,0.0,1823969.840000004,2018,10,16,PAYEMENT,253.76,M1356228258
6441,409000493210',2018-10-16,Indiaforensic NFS SETT 12-10-201,500.0,0.0,1823469.840000004,2018,10,16,PAYEMENT,500.0,M408544604
6442,409000493210',2018-10-16,Indiaforensic NFS SETT 12-10-201,500.0,0.0,1822969.840000004,2018,10,16,CASH_OUT,500.0,C1526298704
6443,409000493210',2018-10-16,Indiaforensic NFS SETT 12-10-201,2000.0,0.0,1820969.840000004,2018,10,16,CASH_OUT,2000.0,M220371218
6444,409000493210',2018-10-16,Indiaforensic NFS SETT 12-10-201,2000.0,0.0,1818969.840000004,2018,10,16,DEBIT,2000.0,M470610323
6445,409000493210',2018-10-16,Indiaforensic NFS SETT 12-10-201,10000.0,0.0,1808969.840000004,2018,10,16,CASH_OUT,10000.0,M606440276
6446,409000493210',2018-10-16,Indiaforensic NFS SETT 12-10-201,500.0,0.0,1808469.840000004,2018,10,16,PAYEMENT,500.0,C1339257929
6447,409000493210',2018-10-16,Indiaforensic NFS SETT 12-10-201,500.0,0.0,1807969.840000004,2018,10,16,CHECK_WITHDRAWAL,500.0,M1013313550
6448,409000493210',2018-10-16,Indiaforensic NFS SETT 12-10-201,8000.0,0.0,1799969.840000004,2018,10,16,CHECK_WITHDRAWAL,8000.0,C424918165
6449,409000493210',2018-10-16,Indiaforensic NFS SETT 12-10-201,4000.0,0.0,1795969.840000004,2018,10,16,PAYEMENT,4000.0,M273401463
6450,409000493210',2018-10-16,Indiaforensic NFS SETT 12-10-201,4200.0,0.0,1791769.840000004,2018,10,16,CASH_OUT,4200.0,M571598641
6451,409000493210',2018-10-16,Indiaforensic NFS SETT 12-10-201,800.0,0.0,1790969.840000004,2018,10,16,CHECK_WITHDRAWAL,800.0,M1037406649
6452,409000493210',2018-10-16,Indiaforensic NFS SETT 12-10-201,10000.0,0.0,1780969.840000004,2018,10,16,CHECK_WITHDRAWAL,10000.0,M2123127037
6453,409000493210',2018-10-16,Indiaforensic NFS SETT 12-10-201,6000.0,0.0,1774969.840000004,2018,10,16,PAYEMENT,6000.0,C977993101
6454,409000493210',2018-10-16,Indiaforensic NFS SETT 12-10-201,2500.0,0.0,1772469.840000004,2018,10,16,DEBIT,2500.0,C1419794148
6455,409000493210',2018-10-16,Indiaforensic NFS SETT 12-10-201,1500.0,0.0,1770969.840000004,2018,10,16,PAYEMENT,1500.0,C481402298
6456,409000493210',2018-10-16,Indiaforensic NFS SETT 12-10-201,5000.0,0.0,1765969.840000004,2018,10,16,DEBIT,5000.0,C1255024717
6457,409000493210',2018-10-16,Indiaforensic NFS SETT 12-10-201,2000.0,0.0,1763969.840000004,2018,10,16,DEBIT,2000.0,C1262822392
6458,409000493210',2018-10-16,Indiaforensic NFS SETT 12-10-201,1000.0,0.0,1762969.840000004,2018,10,16,CHECK_WITHDRAWAL,1000.0,C1880332929
6459,409000493210',2018-10-16,Indiaforensic NFS SETT 12-10-201,2000.0,0.0,1760969.840000004,2018,10,16,DEBIT,2000.0,C481402298
6460,409000493210',2018-10-16,Indiaforensic NFS SETT 12-10-201,500.0,0.0,1760469.840000004,2018,10,16,CHECK_WITHDRAWAL,500.0,C1880332929
6461,409000493210',2018-10-16,Indiaforensic NFS SETT 12-10-201,1000.0,0.0,1759469.840000004,2018,10,16,CHECK_WITHDRAWAL,1000.0,C1360767589
6462,409000493210',2018-10-16,Indiaforensic NFS SETT 12-10-201,500.0,0.0,1758969.840000004,2018,10,16,CASH_OUT,500.0,C1674899618
6463,409000493210',2018-10-16,Indiaforensic NFS SETT 13-10-201,2000.0,0.0,1756969.840000004,2018,10,16,CASH_OUT,2000.0,C909295153
6464,409000493210',2018-10-16,Indiaforensic NFS SETT 13-10-201,1000.0,0.0,1755969.840000004,2018,10,16,DEBIT,1000.0,C1419794148
6465,409000493210',2018-10-16,Indiaforensic NFS SETT 13-10-201,6000.0,0.0,1749969.840000004,2018,10,16,CASH_OUT,6000.0,C985934102
6466,409000493210',2018-10-16,Indiaforensic NFS SETT 13-10-201,4000.0,0.0,1745969.840000004,2018,10,16,PAYEMENT,4000.0,C1504109395
6467,409000493210',2018-10-16,Indiaforensic NFS SETT 13-10-201,500.0,0.0,1745469.840000004,2018,10,16,CHECK_WITHDRAWAL,500.0,C803116137
6468,409000493210',2018-10-16,Indiaforensic NFS SETT 13-10-201,100.0,0.0,1745369.840000004,2018,10,16,CHECK_WITHDRAWAL,100.0,C766681183
6469,409000493210',2018-10-16,Indiaforensic NFS SETT 13-10-201,900.0,0.0,1744469.840000004,2018,10,16,PAYEMENT,900.0,C1782113663
6470,409000493210',2018-10-16,Indiaforensic NFS SETT 13-10-201,5000.0,0.0,1739469.840000004,2018,10,16,CHECK_WITHDRAWAL,5000.0,C1255024717
6471,409000493210',2018-10-16,Indiaforensic NFS SETT 13-10-201,500.0,0.0,1738969.840000004,2018,10,16,CHECK_WITHDRAWAL,500.0,M502921158
6472,409000493210',2018-10-16,Indiaforensic NFS SETT 13-10-201,1500.0,0.0,1737469.840000004,2018,10,16,CASH_OUT,1500.0,C1182908789
6473,409000493210',2018-10-16,Indiaforensic NFS SETT 13-10-201,5000.0,0.0,1732469.840000004,2018,10,16,DEBIT,5000.0,M1894617130
6474,409000493210',2018-10-16,Indiaforensic NFS SETT 13-10-201,5000.0,0.0,1727469.840000004,2018,10,16,PAYEMENT,5000.0,M1016633374
6475,409000493210',2018-10-16,Indiaforensic NFS SETT 13-10-201,500.0,0.0,1726969.840000004,2018,10,16,PAYEMENT,500.0,M1899907523
6476,409000493210',2018-10-16,Indiaforensic NFS SETT 14-10-201,2000.0,0.0,1724969.840000004,2018,10,16,CHECK_WITHDRAWAL,2000.0,M1811235424
6477,409000493210',2018-10-16,Indiaforensic NFS SETT 14-10-201,1000.0,0.0,1723969.840000004,2018,10,16,CHECK_WITHDRAWAL,1000.0,M1914077784
6478,409000493210',2018-10-16,Indiaforensic NFS SETT 14-10-201,1400.0,0.0,1722569.840000004,2018,10,16,DEBIT,1400.0,M190838539
6479,409000493210',2018-10-16,Indiaforensic NFS SETT 14-10-201,7000.0,0.0,1715569.840000004,2018,10,16,CHECK_WITHDRAWAL,7000.0,M290172400
6480,409000493210',2018-10-16,Indiaforensic NFS SETT 14-10-201,800.0,0.0,1714769.840000004,2018,10,16,DEBIT,800.0,C1167066016
6481,409000493210',2018-10-16,Indiaforensic NFS SETT 14-10-201,5000.0,0.0,1709769.840000004,2018,10,16,PAYEMENT,5000.0,C1471633238
6482,409000493210',2018-10-16,Indiaforensic NFS SETT 14-10-201,500.0,0.0,1709269.840000004,2018,10,16,PAYEMENT,500.0,M956958624
6483,409000493210',2018-10-16,Indiaforensic NFS SETT 14-10-201,7700.0,0.0,1701569.840000004,2018,10,16,PAYEMENT,7700.0,M1462452338
6484,409000493210',2018-10-16,Indiaforensic NFS SETT 14-10-201,10000.0,0.0,1691569.840000004,2018,10,16,DEBIT,10000.0,M1534365740
6485,409000493210',2018-10-16,Indiaforensic NFS SETT 14-10-201,2000.0,0.0,1689569.840000004,2018,10,16,PAYEMENT,2000.0,M1139678455
6486,409000493210',2018-10-16,FDRL/INTERNAL FUND TRANSFE,0.0,100000.0,1789569.840000004,2018,10,16,CASH_IN,100000.0,M1528782796
6487,409000493210',2018-10-16,FDRL/INTERNAL FUND TRANSFE,0.0,100000.0,1889569.840000004,2018,10,16,CHECK_CASHING,100000.0,M2031311416
6488,409000493210',2018-10-17,Indiaforensic  RUPAY SETT 171018,1796.51,0.0,1887773.330000004,2018,10,17,CASH_OUT,1796.51,M1446787786
6489,409000493210',2018-10-17,Indiaforensic  RUPAY SETT 171018,0.0,14.71,1887788.040000004,2018,10,17,CHECK_CASHING,14.71,M817902707
6490,409000493210',2018-10-17,Indiaforensic RUPAY STL INTC1710,14.71,0.0,1887773.330000004,2018,10,17,DEBIT,14.71,M396875464
6491,409000493210',2018-10-17,TRF FROM  Indiaforensic SERVICES,0.0,225958.0,2113731.3300000043,2018,10,17,TRANSFER,225958.0,M2130299045
6492,409000493210',2018-10-17,Indiaforensic  RUPAY SETT 171018,4956.38,0.0,2108774.950000004,2018,10,17,CASH_OUT,4956.38,M635097653
6493,409000493210',2018-10-17,Indiaforensic  RUPAY SETT 171018,0.0,231.19,2109006.140000004,2018,10,17,CASH_IN,231.19,M43951584
6494,409000493210',2018-10-17,Indiaforensic RUPAY STL INTC1710,53.58,0.0,2108952.5600000042,2018,10,17,PAYEMENT,53.58,M1878900463
6495,409000493210',2018-10-17,Indiaforensic RUPAY STL INTC1710,0.0,1.3,2108953.860000004,2018,10,17,TRANSFER,1.3,M1030952115
6496,409000493210',2018-10-17,Indiaforensic NFS SETT 15-10-201,2000.0,0.0,2106953.860000004,2018,10,17,PAYEMENT,2000.0,M267368044
6497,409000493210',2018-10-17,Indiaforensic NFS SETT 15-10-201,10000.0,0.0,2096953.860000004,2018,10,17,PAYEMENT,10000.0,M1216741689
6498,409000493210',2018-10-17,Indiaforensic NFS SETT 15-10-201,500.0,0.0,2096453.860000004,2018,10,17,CASH_OUT,500.0,M212207240
6499,409000493210',2018-10-17,Indiaforensic NFS SETT 15-10-201,1000.0,0.0,2095453.860000004,2018,10,17,DEBIT,1000.0,M861310502
6500,409000493210',2018-10-17,Indiaforensic NFS SETT 15-10-201,8700.0,0.0,2086753.860000004,2018,10,17,DEBIT,8700.0,M894783813
6501,409000493210',2018-10-17,Indiaforensic NFS SETT 15-10-201,1000.0,0.0,2085753.860000004,2018,10,17,PAYEMENT,1000.0,M1998372115
6502,409000493210',2018-10-17,Indiaforensic NFS SETT 15-10-201,500.0,0.0,2085253.860000004,2018,10,17,PAYEMENT,500.0,M1029176222
6503,409000493210',2018-10-17,Indiaforensic NFS SETT 15-10-201,6000.0,0.0,2079253.860000004,2018,10,17,PAYEMENT,6000.0,M1044945601
6504,409000493210',2018-10-17,Indiaforensic NFS SETT 15-10-201,5700.0,0.0,2073553.860000004,2018,10,17,CHECK_WITHDRAWAL,5700.0,M604047477
6505,409000493210',2018-10-18,Indiaforensic  RUPAY SETT 181018,1772.12,0.0,2071781.740000004,2018,10,18,DEBIT,1772.12,M15076442
6506,409000493210',2018-10-18,Indiaforensic  RUPAY SETT 181018,0.0,12.43,2071794.1700000041,2018,10,18,CASH_IN,12.43,M1308823531
6507,409000493210',2018-10-18,Indiaforensic RUPAY STL INTC1810,12.43,0.0,2071781.740000004,2018,10,18,DEBIT,12.43,M338027825
6508,409000493210',2018-10-18,Indiaforensic  RUPAY SETT 181018,23525.54,0.0,2048256.2000000041,2018,10,18,CHECK_WITHDRAWAL,23525.54,M1340362810
6509,409000493210',2018-10-18,Indiaforensic  RUPAY SETT 181018,0.0,141.23,2048397.4300000041,2018,10,18,CHECK_CASHING,141.23,M1562570092
6510,409000493210',2018-10-18,Indiaforensic RUPAY STL INTC1810,141.23,0.0,2048256.2000000041,2018,10,18,CHECK_WITHDRAWAL,141.23,C146305349
6511,409000493210',2018-10-18,TRF FROM  Indiaforensic SERVICES,0.0,315000.0,2363256.200000004,2018,10,18,CASH_IN,315000.0,C214774813
6512,409000493210',2018-10-19,Indiaforensic NFS SETT 16-10-201,8800.0,0.0,2354456.200000004,2018,10,19,CHECK_WITHDRAWAL,8800.0,M1519407613
6513,409000493210',2018-10-19,Indiaforensic NFS SETT 16-10-201,2000.0,0.0,2352456.200000004,2018,10,19,DEBIT,2000.0,C421163163
6514,409000493210',2018-10-19,Indiaforensic NFS SETT 16-10-201,2000.0,0.0,2350456.200000004,2018,10,19,DEBIT,2000.0,C403147759
6515,409000493210',2018-10-19,Indiaforensic NFS SETT 16-10-201,10000.0,0.0,2340456.200000004,2018,10,19,DEBIT,10000.0,C728526866
6516,409000493210',2018-10-19,Indiaforensic NFS SETT 16-10-201,6000.0,0.0,2334456.200000004,2018,10,19,CHECK_WITHDRAWAL,6000.0,C2083562754
6517,409000493210',2018-10-19,Indiaforensic NFS SETT 16-10-201,10000.0,0.0,2324456.200000004,2018,10,19,PAYEMENT,10000.0,C248609774
6518,409000493210',2018-10-19,Indiaforensic NFS SETT 16-10-201,10000.0,0.0,2314456.200000004,2018,10,19,CHECK_WITHDRAWAL,10000.0,C453211571
6519,409000493210',2018-10-19,Indiaforensic NFS SETT 16-10-201,500.0,0.0,2313956.200000004,2018,10,19,DEBIT,500.0,C1504109395
6520,409000493210',2018-10-19,Indiaforensic NFS SETT 16-10-201,10000.0,0.0,2303956.200000004,2018,10,19,CASH_OUT,10000.0,C1165398731
6521,409000493210',2018-10-19,Indiaforensic NFS SETT 16-10-201,10000.0,0.0,2293956.200000004,2018,10,19,CHECK_WITHDRAWAL,10000.0,C1085479446
6522,409000493210',2018-10-19,Indiaforensic NFS SETT 16-10-201,10000.0,0.0,2283956.200000004,2018,10,19,CASH_OUT,10000.0,C1568059495
6523,409000493210',2018-10-19,Indiaforensic NFS SETT 16-10-201,900.0,0.0,2283056.200000004,2018,10,19,CASH_OUT,900.0,C798678484
6524,409000493210',2018-10-19,Indiaforensic NFS SETT 16-10-201,10000.0,0.0,2273056.200000004,2018,10,19,DEBIT,10000.0,C787033725
6525,409000493210',2018-10-19,Indiaforensic NFS SETT 16-10-201,9500.0,0.0,2263556.200000004,2018,10,19,DEBIT,9500.0,C1746150957
6526,409000493210',2018-10-19,Indiaforensic NFS SETT 16-10-201,9000.0,0.0,2254556.200000004,2018,10,19,CHECK_WITHDRAWAL,9000.0,C621014131
6527,409000493210',2018-10-19,Indiaforensic NFS SETT 16-10-201,8000.0,0.0,2246556.200000004,2018,10,19,DEBIT,8000.0,C146305349
6528,409000493210',2018-10-19,Indiaforensic NFS SETT 16-10-201,300.0,0.0,2246256.200000004,2018,10,19,PAYEMENT,300.0,C1674899618
6529,409000493210',2018-10-19,Indiaforensic NFS SETT 16-10-201,2000.0,0.0,2244256.200000004,2018,10,19,DEBIT,2000.0,M1364803759
6530,409000493210',2018-10-19,Indiaforensic NFS SETT 16-10-201,9800.0,0.0,2234456.200000004,2018,10,19,CASH_OUT,9800.0,M484878781
6531,409000493210',2018-10-19,Indiaforensic NFS SETT 16-10-201,1000.0,0.0,2233456.200000004,2018,10,19,PAYEMENT,1000.0,M1359003971
6532,409000493210',2018-10-19,Indiaforensic NFS SETT 16-10-201,3000.0,0.0,2230456.200000004,2018,10,19,DEBIT,3000.0,M994228009
6533,409000493210',2018-10-19,Indiaforensic NFS SETT 16-10-201,500.0,0.0,2229956.200000004,2018,10,19,CASH_OUT,500.0,M466322841
6534,409000493210',2018-10-19,Indiaforensic NFS SETT 16-10-201,3000.0,0.0,2226956.200000004,2018,10,19,PAYEMENT,3000.0,C1880332929
6535,409000493210',2018-10-19,Indiaforensic NFS SETT 16-10-201,10000.0,0.0,2216956.200000004,2018,10,19,DEBIT,10000.0,M1537618192
6536,409000493210',2018-10-19,Indiaforensic NFS SETT 16-10-201,1500.0,0.0,2215456.200000004,2018,10,19,CHECK_WITHDRAWAL,1500.0,M792516391
6537,409000493210',2018-10-19,Indiaforensic NFS SETT 16-10-201,8000.0,0.0,2207456.200000004,2018,10,19,PAYEMENT,8000.0,M1883027286
6538,409000493210',2018-10-19,Indiaforensic NFS SETT 16-10-201,1400.0,0.0,2206056.200000004,2018,10,19,CASH_OUT,1400.0,M299617083
6539,409000493210',2018-10-19,Indiaforensic NFS SETT 16-10-201,200.0,0.0,2205856.200000004,2018,10,19,DEBIT,200.0,C1519216494
6540,409000493210',2018-10-19,Indiaforensic NFS SETT 16-10-201,500.0,0.0,2205356.200000004,2018,10,19,CHECK_WITHDRAWAL,500.0,M974386787
6541,409000493210',2018-10-19,Indiaforensic NFS SETT 16-10-201,3000.0,0.0,2202356.200000004,2018,10,19,CASH_OUT,3000.0,M396851838
6542,409000493210',2018-10-19,Indiaforensic NFS SETT 16-10-201,900.0,0.0,2201456.200000004,2018,10,19,CASH_OUT,900.0,M1493257982
6543,409000493210',2018-10-19,Indiaforensic NFS SETT 16-10-201,200.0,0.0,2201256.200000004,2018,10,19,CHECK_WITHDRAWAL,200.0,M1937889008
6544,409000493210',2018-10-19,Indiaforensic NFS SETT 16-10-201,200.0,0.0,2201056.200000004,2018,10,19,CASH_OUT,200.0,C1916720513
6545,409000493210',2018-10-19,Indiaforensic  RUPAY SETT 191018,61460.21,0.0,2139595.990000004,2018,10,19,CASH_OUT,61460.21,C466505482
6546,409000493210',2018-10-19,Indiaforensic  RUPAY SETT 191018,0.0,441.86,2140037.8500000043,2018,10,19,CHECK_CASHING,441.86,C991363637
6547,409000493210',2018-10-19,Indiaforensic RUPAY STL INTC1910,419.28,0.0,2139618.570000004,2018,10,19,CHECK_WITHDRAWAL,419.28,C985934102
6548,409000493210',2018-10-19,Indiaforensic RUPAY STL INTC1910,0.0,0.16,2139618.730000004,2018,10,19,CHECK_CASHING,0.16,C1023714065
6549,409000493210',2018-10-19,Indiaforensic  RUPAY SETT 191018,10297.23,0.0,2129321.500000004,2018,10,19,CASH_OUT,10297.23,C451111351
6550,409000493210',2018-10-19,Indiaforensic  RUPAY SETT 191018,0.0,109.48,2129430.980000004,2018,10,19,CASH_IN,109.48,C193864812
6551,409000493210',2018-10-19,Indiaforensic RUPAY STL INTC1910,107.68,0.0,2129323.3000000035,2018,10,19,PAYEMENT,107.68,C932583850
6552,409000493210',2018-10-19,Indiaforensic RUPAY STL INTC1910,0.0,0.01,2129323.3100000042,2018,10,19,CASH_IN,0.01,C1303868418
6553,409000493210',2018-10-20,Indiaforensic  RUPAY SETT 201018,10472.17,0.0,2118851.140000004,2018,10,20,CHECK_WITHDRAWAL,10472.17,C295372946
6554,409000493210',2018-10-20,Indiaforensic  RUPAY SETT 201018,0.0,59.68,2118910.820000004,2018,10,20,CHECK_CASHING,59.68,C1504109395
6555,409000493210',2018-10-20,Indiaforensic RUPAY STL INTC2010,59.68,0.0,2118851.140000004,2018,10,20,PAYEMENT,59.68,C1782113663
6556,409000493210',2018-10-20,Indiaforensic NFS SETT 17-10-201,9000.0,0.0,2109851.140000004,2018,10,20,CASH_OUT,9000.0,C728526866
6557,409000493210',2018-10-20,Indiaforensic NFS SETT 17-10-201,6000.0,0.0,2103851.140000004,2018,10,20,CASH_OUT,6000.0,C1477979030
6558,409000493210',2018-10-20,Indiaforensic NFS SETT 17-10-201,9500.0,0.0,2094351.140000004,2018,10,20,PAYEMENT,9500.0,C154319946
6559,409000493210',2018-10-20,Indiaforensic NFS SETT 17-10-201,400.0,0.0,2093951.140000004,2018,10,20,PAYEMENT,400.0,C484258212
6560,409000493210',2018-10-20,Indiaforensic NFS SETT 17-10-201,400.0,0.0,2093551.140000004,2018,10,20,DEBIT,400.0,C728526866
6561,409000493210',2018-10-20,Indiaforensic NFS SETT 17-10-201,200.0,0.0,2093351.140000004,2018,10,20,DEBIT,200.0,M1272902791
6562,409000493210',2018-10-20,Indiaforensic NFS SETT 17-10-201,10000.0,0.0,2083351.140000004,2018,10,20,CASH_OUT,10000.0,C292665982
6563,409000493210',2018-10-20,Indiaforensic NFS SETT 17-10-201,10000.0,0.0,2073351.140000004,2018,10,20,CHECK_WITHDRAWAL,10000.0,M1543664352
6564,409000493210',2018-10-20,Indiaforensic NFS SETT 17-10-201,1000.0,0.0,2072351.140000004,2018,10,20,CHECK_WITHDRAWAL,1000.0,M2000880842
6565,409000493210',2018-10-20,Indiaforensic NFS SETT 17-10-201,8000.0,0.0,2064351.140000004,2018,10,20,DEBIT,8000.0,M1289292854
6566,409000493210',2018-10-20,Indiaforensic NFS SETT 17-10-201,9900.0,0.0,2054451.140000004,2018,10,20,PAYEMENT,9900.0,M1705512923
6567,409000493210',2018-10-20,Indiaforensic NFS SETT 18-10-201,1000.0,0.0,2053451.140000004,2018,10,20,CHECK_WITHDRAWAL,1000.0,M2102730438
6568,409000493210',2018-10-20,Indiaforensic NFS SETT 18-10-201,10000.0,0.0,2043451.140000004,2018,10,20,CHECK_WITHDRAWAL,10000.0,M1139273988
6569,409000493210',2018-10-20,Indiaforensic NFS SETT 18-10-201,3500.0,0.0,2039951.140000004,2018,10,20,PAYEMENT,3500.0,M660743486
6570,409000493210',2018-10-20,Indiaforensic NFS SETT 18-10-201,100.0,0.0,2039851.140000004,2018,10,20,CASH_OUT,100.0,M448945595
6571,409000493210',2018-10-20,Indiaforensic NFS SETT 18-10-201,2300.0,0.0,2037551.140000004,2018,10,20,DEBIT,2300.0,M2076770236
6572,409000493210',2018-10-20,Indiaforensic NFS SETT 18-10-201,10000.0,0.0,2027551.140000004,2018,10,20,DEBIT,10000.0,C1721246982
6573,409000493210',2018-10-20,Indiaforensic NFS SETT 18-10-201,2000.0,0.0,2025551.140000004,2018,10,20,DEBIT,2000.0,M2092841477
6574,409000493210',2018-10-20,Indiaforensic NFS SETT 18-10-201,2500.0,0.0,2023051.140000004,2018,10,20,CHECK_WITHDRAWAL,2500.0,C985934102
6575,409000493210',2018-10-20,Indiaforensic NFS SETT 18-10-201,1000.0,0.0,2022051.140000004,2018,10,20,CHECK_WITHDRAWAL,1000.0,M1969632323
6576,409000493210',2018-10-20,Indiaforensic NFS SETT 18-10-201,7000.0,0.0,2015051.140000004,2018,10,20,DEBIT,7000.0,M11731022
6577,409000493210',2018-10-20,Indiaforensic  RUPAY SETT 201018,12100.54,0.0,2002950.600000004,2018,10,20,CHECK_WITHDRAWAL,12100.54,M287096026
6578,409000493210',2018-10-20,Indiaforensic  RUPAY SETT 201018,0.0,132.05,2003082.650000004,2018,10,20,TRANSFER,132.05,C836514715
6579,409000493210',2018-10-20,Indiaforensic RUPAY STL INTC2010,132.05,0.0,2002950.600000004,2018,10,20,CASH_OUT,132.05,M1821268676
6580,409000493210',2018-10-20,Indiaforensic NFS SETT 19-10-201,10000.0,0.0,1992950.600000004,2018,10,20,CASH_OUT,10000.0,M998983750
6581,409000493210',2018-10-20,Indiaforensic NFS SETT 19-10-201,4500.0,0.0,1988450.600000004,2018,10,20,DEBIT,4500.0,C202149782
6582,409000493210',2018-10-20,Indiaforensic NFS SETT 19-10-201,10000.0,0.0,1978450.600000004,2018,10,20,CASH_OUT,10000.0,C1850180796
6583,409000493210',2018-10-20,Indiaforensic NFS SETT 19-10-201,3500.0,0.0,1974950.600000004,2018,10,20,CASH_OUT,3500.0,C1315078366
6584,409000493210',2018-10-20,Indiaforensic NFS SETT 19-10-201,1100.0,0.0,1973850.600000004,2018,10,20,CHECK_WITHDRAWAL,1100.0,C7881234
6585,409000493210',2018-10-20,Indiaforensic NFS SETT 19-10-201,900.0,0.0,1972950.600000004,2018,10,20,DEBIT,900.0,M1591387506
6586,409000493210',2018-10-20,ATM REV 828916002393/BHBF,0.0,500.0,1973450.600000004,2018,10,20,TRANSFER,500.0,C991505714
6587,409000493210',2018-10-22,Indiaforensic RUPAY SETT 211018,31058.69,0.0,1942391.910000004,2018,10,22,DEBIT,31058.69,C517653428
6588,409000493210',2018-10-22,Indiaforensic RUPAY SETT 211018,0.0,450.65,1942842.560000004,2018,10,22,CASH_IN,450.65,C1321128627
6589,409000493210',2018-10-22,Indiaforensic RUPAY STL INTC2110,259.07,0.0,1942583.490000004,2018,10,22,DEBIT,259.07,C1022680775
6590,409000493210',2018-10-22,Indiaforensic RUPAY STL INTC2110,0.0,1.44,1942584.9300000032,2018,10,22,CASH_IN,1.44,C542766981
6591,409000493210',2018-10-22,Indiaforensic RUPAY SETT 221018,14892.51,0.0,1927692.4200000032,2018,10,22,CASH_OUT,14892.51,C1005928818
6592,409000493210',2018-10-22,Indiaforensic RUPAY STL INTC2210,131.07,0.0,1927561.3500000031,2018,10,22,PAYEMENT,131.07,C146305349
6593,409000493210',2018-10-22,Indiaforensic RUPAY SETT 221018,0.0,134.92,1927696.270000003,2018,10,22,CHECK_CASHING,134.92,C1120735174
6594,409000493210',2018-10-22,Indiaforensic RUPAY STL INTC2210,0.0,0.02,1927696.290000003,2018,10,22,CHECK_CASHING,0.02,C1467806809
6595,409000493210',2018-10-22,Indiaforensic  RUPAY SETT 221018,11730.96,0.0,1915965.330000003,2018,10,22,CASH_OUT,11730.96,C1789550256
6596,409000493210',2018-10-22,Indiaforensic  RUPAY SETT 221018,0.0,128.5,1916093.830000003,2018,10,22,CASH_IN,128.5,C1632716597
6597,409000493210',2018-10-22,Indiaforensic RUPAY STL INTC2210,128.5,0.0,1915965.330000003,2018,10,22,CHECK_WITHDRAWAL,128.5,M1169338605
6598,409000493210',2018-10-23,Indiaforensic NFS SETT 20-10-201,3000.0,0.0,1912965.330000003,2018,10,23,DEBIT,3000.0,C2011996123
6599,409000493210',2018-10-23,Indiaforensic NFS SETT 20-10-201,4000.0,0.0,1908965.330000003,2018,10,23,CASH_OUT,4000.0,M1562772628
6600,409000493210',2018-10-23,Indiaforensic NFS SETT 20-10-201,9000.0,0.0,1899965.330000003,2018,10,23,CASH_OUT,9000.0,M47843184
6601,409000493210',2018-10-23,Indiaforensic NFS SETT 20-10-201,100.0,0.0,1899865.330000003,2018,10,23,CASH_OUT,100.0,M1393726189
6602,409000493210',2018-10-23,Indiaforensic NFS SETT 20-10-201,6500.0,0.0,1893365.330000003,2018,10,23,CHECK_WITHDRAWAL,6500.0,M325119885
6603,409000493210',2018-10-23,Indiaforensic NFS SETT 20-10-201,10000.0,0.0,1883365.330000003,2018,10,23,PAYEMENT,10000.0,M51432525
6604,409000493210',2018-10-23,Indiaforensic NFS SETT 20-10-201,500.0,0.0,1882865.330000003,2018,10,23,CASH_OUT,500.0,M1243354278
6605,409000493210',2018-10-23,Indiaforensic NFS SETT 20-10-201,5000.0,0.0,1877865.330000003,2018,10,23,PAYEMENT,5000.0,M506883855
6606,409000493210',2018-10-23,Indiaforensic NFS SETT 20-10-201,5000.0,0.0,1872865.330000003,2018,10,23,PAYEMENT,5000.0,M1315483358
6607,409000493210',2018-10-23,Indiaforensic NFS SETT 20-10-201,5000.0,0.0,1867865.330000003,2018,10,23,CHECK_WITHDRAWAL,5000.0,M1971858114
6608,409000493210',2018-10-23,Indiaforensic NFS SETT 21-10-201,100.0,0.0,1867765.330000003,2018,10,23,DEBIT,100.0,M1126522769
6609,409000493210',2018-10-23,Indiaforensic NFS SETT 21-10-201,1500.0,0.0,1866265.330000003,2018,10,23,PAYEMENT,1500.0,M1960957451
6610,409000493210',2018-10-23,Indiaforensic NFS SETT 21-10-201,200.0,0.0,1866065.330000003,2018,10,23,PAYEMENT,200.0,C701279123
6611,409000493210',2018-10-23,Indiaforensic NFS SETT 21-10-201,700.0,0.0,1865365.330000003,2018,10,23,CHECK_WITHDRAWAL,700.0,M1281098502
6612,409000493210',2018-10-23,Indiaforensic NFS SETT 21-10-201,2000.0,0.0,1863365.330000003,2018,10,23,CASH_OUT,2000.0,M1159219582
6613,409000493210',2018-10-23,Indiaforensic NFS SETT 21-10-201,2000.0,0.0,1861365.330000003,2018,10,23,DEBIT,2000.0,M1938311278
6614,409000493210',2018-10-23,Indiaforensic NFS SETT 21-10-201,2000.0,0.0,1859365.330000003,2018,10,23,CASH_OUT,2000.0,C665576141
6615,409000493210',2018-10-23,Indiaforensic  RUPAY SETT 231018,32673.81,0.0,1826691.520000003,2018,10,23,CASH_OUT,32673.81,C503195940
6616,409000493210',2018-10-23,Indiaforensic  RUPAY SETT 231018,0.0,387.49,1827079.010000003,2018,10,23,CHECK_CASHING,387.49,M325732352
6617,409000493210',2018-10-23,Indiaforensic RUPAY STL INTC2310,248.74,0.0,1826830.270000003,2018,10,23,DEBIT,248.74,M858989662
6618,409000493210',2018-10-23,Indiaforensic RUPAY STL INTC2310,0.0,1.04,1826831.310000003,2018,10,23,CASH_IN,1.04,M1427580388
6619,409000493210',2018-10-23,Indiaforensic  RUPAY SETT 231018,6678.25,0.0,1820153.060000003,2018,10,23,DEBIT,6678.25,M1555478555
6620,409000493210',2018-10-23,Indiaforensic  RUPAY SETT 231018,0.0,20.37,1820173.4300000032,2018,10,23,CASH_IN,20.37,M1187091280
6621,409000493210',2018-10-23,Indiaforensic RUPAY STL INTC2310,20.37,0.0,1820153.060000003,2018,10,23,CASH_OUT,20.37,M852779561
6622,409000493210',2018-10-23,TRF FROM  Indiaforensic SERVICES,0.0,10400.0,1830553.060000003,2018,10,23,CASH_IN,10400.0,C1335946878
6623,409000493210',2018-10-23,FDRL/INTERNAL FUND TRANSFE,0.0,100000.0,1930553.060000003,2018,10,23,CASH_IN,100000.0,C1924259657
6624,409000493210',2018-10-23,FDRL/INTERNAL FUND TRANSFE,0.0,100000.0,2030553.060000003,2018,10,23,CASH_IN,100000.0,C2118255842
6625,409000493210',2018-10-23,Indiaforensic NFS SETT 22-10-201,3800.0,0.0,2026753.060000003,2018,10,23,DEBIT,3800.0,C644345897
6626,409000493210',2018-10-23,Indiaforensic NFS SETT 22-10-201,210.0,0.0,2026543.060000003,2018,10,23,CHECK_WITHDRAWAL,210.0,C28783325
6627,409000493210',2018-10-23,Indiaforensic NFS SETT 22-10-201,2500.0,0.0,2024043.060000003,2018,10,23,PAYEMENT,2500.0,C1590550415
6628,409000493210',2018-10-23,Indiaforensic NFS SETT 22-10-201,500.0,0.0,2023543.060000003,2018,10,23,CHECK_WITHDRAWAL,500.0,C1495761010
6629,409000493210',2018-10-23,Indiaforensic NFS SETT 22-10-201,1000.0,0.0,2022543.060000003,2018,10,23,CHECK_WITHDRAWAL,1000.0,C1880332929
6630,409000493210',2018-10-23,Indiaforensic NFS SETT 22-10-201,10000.0,0.0,2012543.060000003,2018,10,23,CHECK_WITHDRAWAL,10000.0,C392292416
6631,409000493210',2018-10-23,Indiaforensic NFS SETT 22-10-201,200.0,0.0,2012343.060000003,2018,10,23,CHECK_WITHDRAWAL,200.0,C1519216494
6632,409000493210',2018-10-23,Indiaforensic NFS SETT 22-10-201,100.0,0.0,2012243.060000003,2018,10,23,CASH_OUT,100.0,C1477979030
6633,409000493210',2018-10-23,Indiaforensic NFS SETT 22-10-201,1800.0,0.0,2010443.060000003,2018,10,23,DEBIT,1800.0,C75457651
6634,409000493210',2018-10-23,Indiaforensic NFS SETT 22-10-201,3000.0,0.0,2007443.060000003,2018,10,23,PAYEMENT,3000.0,C1360913629
6635,409000493210',2018-10-24,Indiaforensic  RUPAY SETT 241018,18130.7,0.0,1989312.3600000031,2018,10,24,CHECK_WITHDRAWAL,18130.7,C824197891
6636,409000493210',2018-10-24,Indiaforensic  RUPAY SETT 241018,0.0,238.17,1989550.530000003,2018,10,24,CHECK_CASHING,238.17,C1922859107
6637,409000493210',2018-10-24,Indiaforensic RUPAY STL INTC2410,237.42,0.0,1989313.1100000031,2018,10,24,PAYEMENT,237.42,C655381473
6638,409000493210',2018-10-24,Indiaforensic  RUPAY SETT 241018,3303.16,0.0,1986009.9500000032,2018,10,24,PAYEMENT,3303.16,C1467806809
6639,409000493210',2018-10-24,Indiaforensic  RUPAY SETT 241018,0.0,33.62,1986043.570000004,2018,10,24,CHECK_CASHING,33.62,C453211571
6640,409000493210',2018-10-24,Indiaforensic RUPAY STL INTC2410,33.62,0.0,1986009.9500000032,2018,10,24,PAYEMENT,33.62,C1013700132
6641,409000493210',2018-10-24,Indiaforensic NFS SETT 23-10-201,10000.0,0.0,1976009.9500000032,2018,10,24,DEBIT,10000.0,C1670989986
6642,409000493210',2018-10-24,Indiaforensic NFS SETT 23-10-201,10000.0,0.0,1966009.9500000032,2018,10,24,DEBIT,10000.0,C691404076
6643,409000493210',2018-10-24,Indiaforensic NFS SETT 23-10-201,400.0,0.0,1965609.9500000032,2018,10,24,DEBIT,400.0,C232834050
6644,409000493210',2018-10-24,Indiaforensic NFS SETT 23-10-201,6000.0,0.0,1959609.9500000032,2018,10,24,DEBIT,6000.0,C2066777507
6645,409000493210',2018-10-24,Indiaforensic NFS SETT 23-10-201,3000.0,0.0,1956609.9500000032,2018,10,24,CASH_OUT,3000.0,C1946866478
6646,409000493210',2018-10-24,Indiaforensic NFS SETT 23-10-201,3000.0,0.0,1953609.9500000032,2018,10,24,PAYEMENT,3000.0,C1909504164
6647,409000493210',2018-10-24,Indiaforensic NFS SETT 23-10-201,10000.0,0.0,1943609.9500000032,2018,10,24,CHECK_WITHDRAWAL,10000.0,C1331052438
6648,409000493210',2018-10-24,Indiaforensic NFS SETT 23-10-201,1000.0,0.0,1942609.9500000032,2018,10,24,DEBIT,1000.0,C1254893565
6649,409000493210',2018-10-24,Indiaforensic NFS SETT 23-10-201,3000.0,0.0,1939609.9500000032,2018,10,24,PAYEMENT,3000.0,C1916720513
6650,409000493210',2018-10-24,Indiaforensic NFS SETT 23-10-201,8000.0,0.0,1931609.9500000032,2018,10,24,PAYEMENT,8000.0,C232834050
6651,409000493210',2018-10-24,Indiaforensic NFS SETT 23-10-201,1000.0,0.0,1930609.9500000032,2018,10,24,CASH_OUT,1000.0,C1880332929
6652,409000493210',2018-10-24,Indiaforensic NFS SETT 23-10-201,5000.0,0.0,1925609.9500000032,2018,10,24,PAYEMENT,5000.0,C665576141
6653,409000493210',2018-10-25,FDRL/INTERNAL FUND TRANSFE,0.0,100000.0,2025609.9500000032,2018,10,25,TRANSFER,100000.0,C1850180796
6654,409000493210',2018-10-25,FDRL/INTERNAL FUND TRANSFE,0.0,100000.0,2125609.950000003,2018,10,25,CASH_IN,100000.0,C1167066016
6655,409000493210',2018-10-25,FDRL/INTERNAL FUND TRANSFE,0.0,100000.0,2225609.950000003,2018,10,25,TRANSFER,100000.0,C749524318
6656,409000493210',2018-10-25,FDRL/INTERNAL FUND TRANSFE,0.0,100000.0,2325609.950000003,2018,10,25,TRANSFER,100000.0,C1674899618
6657,409000493210',2018-10-25,FDRL/INTERNAL FUND TRANSFE,0.0,100000.0,2425609.950000003,2018,10,25,TRANSFER,100000.0,C1979080020
6658,409000493210',2018-10-25,Indiaforensic  RUPAY SETT 251018,10835.38,0.0,2414774.570000003,2018,10,25,DEBIT,10835.38,C1531812826
6659,409000493210',2018-10-25,Indiaforensic  RUPAY SETT 251018,0.0,96.01,2414870.5800000043,2018,10,25,CASH_IN,96.01,C18996450
6660,409000493210',2018-10-25,Indiaforensic RUPAY STL INTC2510,96.01,0.0,2414774.570000003,2018,10,25,CHECK_WITHDRAWAL,96.01,C1515704208
6661,409000493210',2018-10-25,Indiaforensic  RUPAY SETT 251018,26937.54,0.0,2387837.030000003,2018,10,25,CHECK_WITHDRAWAL,26937.54,C1113560279
6662,409000493210',2018-10-25,Indiaforensic  RUPAY SETT 251018,0.0,283.16,2388120.190000003,2018,10,25,CASH_IN,283.16,C803116137
6663,409000493210',2018-10-25,Indiaforensic RUPAY STL INTC2510,283.16,0.0,2387837.030000003,2018,10,25,CHECK_WITHDRAWAL,283.16,C985934102
6664,409000493210',2018-10-26,Indiaforensic  RUPAY SETT 261018,60397.67,0.0,2327439.360000003,2018,10,26,PAYEMENT,60397.67,C625088521
6665,409000493210',2018-10-26,Indiaforensic  RUPAY SETT 261018,0.0,626.07,2328065.430000003,2018,10,26,TRANSFER,626.07,C1095666481
6666,409000493210',2018-10-26,Indiaforensic RUPAY STL INTC2610,616.8,0.0,2327448.630000003,2018,10,26,PAYEMENT,616.8,C1870252780
6667,409000493210',2018-10-26,Indiaforensic RUPAY STL INTC2610,0.0,0.05,2327448.680000003,2018,10,26,CASH_IN,0.05,C1761291320
6668,409000493210',2018-10-26,FDRL/INTERNAL FUND TRANSFE,0.0,100000.0,2427448.680000003,2018,10,26,CHECK_CASHING,100000.0,C503195940
6669,409000493210',2018-10-26,FDRL/INTERNAL FUND TRANSFE,0.0,100000.0,2527448.680000003,2018,10,26,TRANSFER,100000.0,C1113560279
6670,409000493210',2018-10-26,Indiaforensic RUPAY SETT 261018-,20386.37,0.0,2507062.3100000042,2018,10,26,CHECK_WITHDRAWAL,20386.37,C340368210
6671,409000493210',2018-10-26,Indiaforensic RUPAY SETT 261018-,0.0,144.78,2507207.0900000026,2018,10,26,CASH_IN,144.78,C864078397
6672,409000493210',2018-10-26,Indiaforensic RUPAY STL INTC2610,144.78,0.0,2507062.3100000042,2018,10,26,DEBIT,144.78,C481402298
6673,409000493210',2018-10-29,Indiaforensic RUPAY SETT 271018,11625.27,0.0,2495437.040000004,2018,10,29,DEBIT,11625.27,C1554540309
6674,409000493210',2018-10-29,Indiaforensic RUPAY STL INTC2710,99.15,0.0,2495337.890000003,2018,10,29,CHECK_WITHDRAWAL,99.15,C1356054329
6675,409000493210',2018-10-29,Indiaforensic RUPAY SETT 281018,68182.64,0.0,2427155.250000004,2018,10,29,CHECK_WITHDRAWAL,68182.64,C40075281
6676,409000493210',2018-10-29,Indiaforensic RUPAY STL INTC2810,508.4,0.0,2426646.8500000043,2018,10,29,CASH_OUT,508.4,C1083142315
6677,409000493210',2018-10-29,Indiaforensic RUPAY SETT 271018,0.0,106.73,2426753.5800000043,2018,10,29,CASH_IN,106.73,C629598328
6678,409000493210',2018-10-29,Indiaforensic RUPAY STL INTC2710,0.0,0.03,2426753.6100000027,2018,10,29,CHECK_CASHING,0.03,C769507769
6679,409000493210',2018-10-29,Indiaforensic RUPAY SETT 281018,0.0,508.4,2427262.0100000026,2018,10,29,TRANSFER,508.4,C251155815
6680,409000493210',2018-10-29,Indiaforensic RUPAY SETT 291018,29431.61,0.0,2397830.4000000027,2018,10,29,DEBIT,29431.61,C1254893565
6681,409000493210',2018-10-29,Indiaforensic RUPAY SETT 291018,0.0,313.08,2398143.4800000032,2018,10,29,CHECK_CASHING,313.08,C1880332929
6682,409000493210',2018-10-29,Indiaforensic RUPAY STL INTC2910,289.59,0.0,2397853.890000003,2018,10,29,CASH_OUT,289.59,C97730845
6683,409000493210',2018-10-29,Indiaforensic RUPAY STL INTC2910,0.0,0.17,2397854.0600000042,2018,10,29,CASH_IN,0.17,C665576141
6684,409000493210',2018-10-29,Indiaforensic  RUPAY SETT 291018,31601.97,0.0,2366252.0900000026,2018,10,29,CHECK_WITHDRAWAL,31601.97,C173783788
6685,409000493210',2018-10-29,Indiaforensic  RUPAY SETT 291018,0.0,208.58,2366460.6700000027,2018,10,29,CHECK_CASHING,208.58,C1428195532
6686,409000493210',2018-10-29,Indiaforensic RUPAY STL INTC2910,208.58,0.0,2366252.0900000026,2018,10,29,CHECK_WITHDRAWAL,208.58,C2083562754
6687,409000493210',2018-10-30,Indiaforensic NFS SETT 26-10-201,2500.0,0.0,2363752.0900000026,2018,10,30,CASH_OUT,2500.0,C1590550415
6688,409000493210',2018-10-30,Indiaforensic NFS SETT 26-10-201,1500.0,0.0,2362252.0900000026,2018,10,30,DEBIT,1500.0,C214774813
6689,409000493210',2018-10-30,Indiaforensic NFS SETT 26-10-201,6500.0,0.0,2355752.0900000026,2018,10,30,CHECK_WITHDRAWAL,6500.0,C451111351
6690,409000493210',2018-10-30,Indiaforensic NFS SETT 26-10-201,1900.0,0.0,2353852.0900000026,2018,10,30,CHECK_WITHDRAWAL,1900.0,C1778801068
6691,409000493210',2018-10-30,Indiaforensic NFS SETT 26-10-201,4000.0,0.0,2349852.0900000026,2018,10,30,DEBIT,4000.0,C757257137
6692,409000493210',2018-10-30,Indiaforensic NFS SETT 26-10-201,1100.0,0.0,2348752.0900000026,2018,10,30,PAYEMENT,1100.0,C956986674
6693,409000493210',2018-10-30,Indiaforensic NFS SETT 26-10-201,500.0,0.0,2348252.0900000026,2018,10,30,CASH_OUT,500.0,C2101977504
6694,409000493210',2018-10-30,Indiaforensic NFS SETT 26-10-201,100.0,0.0,2348152.0900000026,2018,10,30,CASH_OUT,100.0,C1354952534
6695,409000493210',2018-10-30,Indiaforensic NFS SETT 26-10-201,2000.0,0.0,2346152.0900000026,2018,10,30,CHECK_WITHDRAWAL,2000.0,C468154998
6696,409000493210',2018-10-30,Indiaforensic NFS SETT 26-10-201,10000.0,0.0,2336152.0900000026,2018,10,30,CHECK_WITHDRAWAL,10000.0,M2026237784
6697,409000493210',2018-10-30,Indiaforensic NFS SETT 26-10-201,4500.0,0.0,2331652.0900000026,2018,10,30,CASH_OUT,4500.0,M131354283
6698,409000493210',2018-10-30,Indiaforensic NFS SETT 26-10-201,200.0,0.0,2331452.0900000026,2018,10,30,CHECK_WITHDRAWAL,200.0,M1645181497
6699,409000493210',2018-10-30,Indiaforensic NFS SETT 26-10-201,5000.0,0.0,2326452.0900000026,2018,10,30,CHECK_WITHDRAWAL,5000.0,M727491956
6700,409000493210',2018-10-30,Indiaforensic NFS SETT 26-10-201,5000.0,0.0,2321452.0900000026,2018,10,30,CASH_OUT,5000.0,M949072944
6701,409000493210',2018-10-30,Indiaforensic NFS SETT 26-10-201,5000.0,0.0,2316452.0900000026,2018,10,30,DEBIT,5000.0,M950410369
6702,409000493210',2018-10-30,Indiaforensic NFS SETT 26-10-201,600.0,0.0,2315852.0900000026,2018,10,30,CASH_OUT,600.0,C1589547066
6703,409000493210',2018-10-30,Indiaforensic NFS SETT 26-10-201,800.0,0.0,2315052.0900000026,2018,10,30,DEBIT,800.0,C522173599
6704,409000493210',2018-10-30,Indiaforensic NFS SETT 26-10-201,1400.0,0.0,2313652.0900000026,2018,10,30,CHECK_WITHDRAWAL,1400.0,M526339400
6705,409000493210',2018-10-30,Indiaforensic NFS SETT 26-10-201,2000.0,0.0,2311652.0900000026,2018,10,30,PAYEMENT,2000.0,M46719126
6706,409000493210',2018-10-30,Indiaforensic NFS SETT 26-10-201,500.0,0.0,2311152.0900000026,2018,10,30,CASH_OUT,500.0,C1379589736
6707,409000493210',2018-10-30,Indiaforensic NFS SETT 26-10-201,1500.0,0.0,2309652.0900000026,2018,10,30,CASH_OUT,1500.0,C978609035
6708,409000493210',2018-10-30,Indiaforensic NFS SETT 26-10-201,100.0,0.0,2309552.0900000026,2018,10,30,PAYEMENT,100.0,M549003710
6709,409000493210',2018-10-30,Indiaforensic NFS SETT 26-10-201,1400.0,0.0,2308152.0900000026,2018,10,30,PAYEMENT,1400.0,M1148337557
6710,409000493210',2018-10-30,Indiaforensic NFS SETT 26-10-201,1700.0,0.0,2306452.0900000026,2018,10,30,CHECK_WITHDRAWAL,1700.0,M1307655038
6711,409000493210',2018-10-30,Indiaforensic NFS SETT 26-10-201,2200.0,0.0,2304252.0900000026,2018,10,30,DEBIT,2200.0,M313945225
6712,409000493210',2018-10-30,Indiaforensic NFS SETT 26-10-201,1200.0,0.0,2303052.0900000026,2018,10,30,DEBIT,1200.0,M275122069
6713,409000493210',2018-10-30,Indiaforensic NFS SETT 26-10-201,300.0,0.0,2302752.0900000026,2018,10,30,PAYEMENT,300.0,M499105172
6714,409000493210',2018-10-30,Indiaforensic NFS SETT 26-10-201,10000.0,0.0,2292752.0900000026,2018,10,30,CHECK_WITHDRAWAL,10000.0,M775635860
6715,409000493210',2018-10-30,Indiaforensic NFS SETT 26-10-201,500.0,0.0,2292252.0900000026,2018,10,30,DEBIT,500.0,M285205295
6716,409000493210',2018-10-30,Indiaforensic NFS SETT 26-10-201,200.0,0.0,2292052.0900000026,2018,10,30,CASH_OUT,200.0,M1742035526
6717,409000493210',2018-10-30,Indiaforensic NFS SETT 26-10-201,1400.0,0.0,2290652.0900000026,2018,10,30,CASH_OUT,1400.0,C1706891711
6718,409000493210',2018-10-30,Indiaforensic NFS SETT 27-10-201,500.0,0.0,2290152.0900000026,2018,10,30,CASH_OUT,500.0,M987450568
6719,409000493210',2018-10-30,Indiaforensic NFS SETT 27-10-201,10000.0,0.0,2280152.0900000026,2018,10,30,CASH_OUT,10000.0,M261801753
6720,409000493210',2018-10-30,Indiaforensic NFS SETT 27-10-201,700.0,0.0,2279452.0900000026,2018,10,30,PAYEMENT,700.0,M863917883
6721,409000493210',2018-10-30,Indiaforensic NFS SETT 27-10-201,2500.0,0.0,2276952.0900000026,2018,10,30,DEBIT,2500.0,M341778327
6722,409000493210',2018-10-30,Indiaforensic NFS SETT 27-10-201,500.0,0.0,2276452.0900000026,2018,10,30,CHECK_WITHDRAWAL,500.0,C991505714
6723,409000493210',2018-10-30,Indiaforensic NFS SETT 27-10-201,500.0,0.0,2275952.0900000026,2018,10,30,DEBIT,500.0,M1908883473
6724,409000493210',2018-10-30,Indiaforensic NFS SETT 27-10-201,500.0,0.0,2275452.0900000026,2018,10,30,CASH_OUT,500.0,M1657936637
6725,409000493210',2018-10-30,Indiaforensic NFS SETT 27-10-201,1000.0,0.0,2274452.0900000026,2018,10,30,DEBIT,1000.0,M627863418
6726,409000493210',2018-10-30,Indiaforensic NFS SETT 27-10-201,500.0,0.0,2273952.0900000026,2018,10,30,PAYEMENT,500.0,C798678484
6727,409000493210',2018-10-30,Indiaforensic NFS SETT 27-10-201,300.0,0.0,2273652.0900000026,2018,10,30,DEBIT,300.0,C1782113663
6728,409000493210',2018-10-30,Indiaforensic NFS SETT 27-10-201,300.0,0.0,2273352.0900000026,2018,10,30,PAYEMENT,300.0,C1401316767
6729,409000493210',2018-10-30,Indiaforensic NFS SETT 27-10-201,300.0,0.0,2273052.0900000026,2018,10,30,DEBIT,300.0,C391903689
6730,409000493210',2018-10-30,Indiaforensic NFS SETT 27-10-201,500.0,0.0,2272552.0900000026,2018,10,30,PAYEMENT,500.0,M1850981199
6731,409000493210',2018-10-30,Indiaforensic NFS SETT 27-10-201,100.0,0.0,2272452.0900000026,2018,10,30,PAYEMENT,100.0,M627747774
6732,409000493210',2018-10-30,Indiaforensic NFS SETT 27-10-201,1200.0,0.0,2271252.0900000026,2018,10,30,CASH_OUT,1200.0,M411064571
6733,409000493210',2018-10-30,Indiaforensic NFS SETT 27-10-201,300.0,0.0,2270952.0900000026,2018,10,30,CASH_OUT,300.0,M2043922005
6734,409000493210',2018-10-30,Indiaforensic NFS SETT 27-10-201,500.0,0.0,2270452.0900000026,2018,10,30,DEBIT,500.0,M1480051614
6735,409000493210',2018-10-30,Indiaforensic NFS SETT 27-10-201,1000.0,0.0,2269452.0900000026,2018,10,30,CHECK_WITHDRAWAL,1000.0,M324346512
6736,409000493210',2018-10-30,Indiaforensic NFS SETT 27-10-201,1000.0,0.0,2268452.0900000026,2018,10,30,DEBIT,1000.0,M1728445186
6737,409000493210',2018-10-30,Indiaforensic NFS SETT 28-10-201,1200.0,0.0,2267252.0900000026,2018,10,30,PAYEMENT,1200.0,M878535710
6738,409000493210',2018-10-30,Indiaforensic NFS SETT 28-10-201,500.0,0.0,2266752.0900000026,2018,10,30,PAYEMENT,500.0,M953718248
6739,409000493210',2018-10-30,Indiaforensic NFS SETT 28-10-201,700.0,0.0,2266052.0900000026,2018,10,30,PAYEMENT,700.0,M1573989401
6740,409000493210',2018-10-30,Indiaforensic NFS SETT 28-10-201,1000.0,0.0,2265052.0900000026,2018,10,30,CASH_OUT,1000.0,M1021494774
6741,409000493210',2018-10-30,Indiaforensic NFS SETT 28-10-201,500.0,0.0,2264552.0900000026,2018,10,30,CHECK_WITHDRAWAL,500.0,M1950774259
6742,409000493210',2018-10-30,Indiaforensic NFS SETT 28-10-201,100.0,0.0,2264452.0900000026,2018,10,30,PAYEMENT,100.0,M1430094474
6743,409000493210',2018-10-30,Indiaforensic NFS SETT 28-10-201,1000.0,0.0,2263452.0900000026,2018,10,30,CHECK_WITHDRAWAL,1000.0,M732526171
6744,409000493210',2018-10-30,Indiaforensic NFS SETT 28-10-201,100.0,0.0,2263352.0900000026,2018,10,30,CASH_OUT,100.0,M1013106719
6745,409000493210',2018-10-30,Indiaforensic NFS SETT 28-10-201,100.0,0.0,2263252.0900000026,2018,10,30,DEBIT,100.0,M171376395
6746,409000493210',2018-10-30,Indiaforensic NFS SETT 28-10-201,100.0,0.0,2263152.0900000026,2018,10,30,CASH_OUT,100.0,M877095353
6747,409000493210',2018-10-30,Indiaforensic NFS SETT 28-10-201,300.0,0.0,2262852.0900000026,2018,10,30,DEBIT,300.0,M163843907
6748,409000493210',2018-10-30,Indiaforensic NFS SETT 28-10-201,6000.0,0.0,2256852.0900000026,2018,10,30,CASH_OUT,6000.0,M1663673785
6749,409000493210',2018-10-30,Indiaforensic NFS SETT 28-10-201,500.0,0.0,2256352.0900000026,2018,10,30,CASH_OUT,500.0,M1157955931
6750,409000493210',2018-10-30,Indiaforensic NFS SETT 24-10-201,200.0,0.0,2256152.0900000026,2018,10,30,PAYEMENT,200.0,M1729527695
6751,409000493210',2018-10-30,Indiaforensic NFS SETT 24-10-201,100.0,0.0,2256052.0900000026,2018,10,30,CHECK_WITHDRAWAL,100.0,M1932740085
6752,409000493210',2018-10-30,Indiaforensic NFS SETT 24-10-201,10000.0,0.0,2246052.0900000026,2018,10,30,PAYEMENT,10000.0,M241403219
6753,409000493210',2018-10-30,Indiaforensic NFS SETT 24-10-201,9000.0,0.0,2237052.0900000026,2018,10,30,DEBIT,9000.0,M1976617670
6754,409000493210',2018-10-30,Indiaforensic NFS SETT 24-10-201,2000.0,0.0,2235052.0900000026,2018,10,30,PAYEMENT,2000.0,M1450945109
6755,409000493210',2018-10-30,Indiaforensic NFS SETT 24-10-201,100.0,0.0,2234952.0900000026,2018,10,30,DEBIT,100.0,M274521953
6756,409000493210',2018-10-30,Indiaforensic NFS SETT 24-10-201,500.0,0.0,2234452.0900000026,2018,10,30,DEBIT,500.0,M1487529549
6757,409000493210',2018-10-30,Indiaforensic NFS SETT 24-10-201,500.0,0.0,2233952.0900000026,2018,10,30,PAYEMENT,500.0,C404279307
6758,409000493210',2018-10-30,Indiaforensic NFS SETT 24-10-201,1000.0,0.0,2232952.0900000026,2018,10,30,CASH_OUT,1000.0,M221971351
6759,409000493210',2018-10-30,Indiaforensic NFS SETT 24-10-201,100.0,0.0,2232852.0900000026,2018,10,30,CASH_OUT,100.0,M1388117264
6760,409000493210',2018-10-30,Indiaforensic NFS SETT 24-10-201,2000.0,0.0,2230852.0900000026,2018,10,30,CASH_OUT,2000.0,M848995025
6761,409000493210',2018-10-30,Indiaforensic NFS SETT 24-10-201,2000.0,0.0,2228852.0900000026,2018,10,30,CHECK_WITHDRAWAL,2000.0,C97730845
6762,409000493210',2018-10-30,Indiaforensic NFS SETT 24-10-201,500.0,0.0,2228352.0900000026,2018,10,30,CHECK_WITHDRAWAL,500.0,M59725469
6763,409000493210',2018-10-30,Indiaforensic NFS SETT 24-10-201,300.0,0.0,2228052.0900000026,2018,10,30,DEBIT,300.0,M1968869542
6764,409000493210',2018-10-30,Indiaforensic NFS SETT 24-10-201,1000.0,0.0,2227052.0900000026,2018,10,30,PAYEMENT,1000.0,M555754759
6765,409000493210',2018-10-30,Indiaforensic NFS SETT 24-10-201,9000.0,0.0,2218052.0900000026,2018,10,30,CHECK_WITHDRAWAL,9000.0,C191614132
6766,409000493210',2018-10-30,Indiaforensic NFS SETT 25-10-201,200.0,0.0,2217852.0900000026,2018,10,30,CHECK_WITHDRAWAL,200.0,M235873926
6767,409000493210',2018-10-30,Indiaforensic NFS SETT 25-10-201,6000.0,0.0,2211852.0900000026,2018,10,30,CASH_OUT,6000.0,M1888859784
6768,409000493210',2018-10-30,Indiaforensic NFS SETT 25-10-201,3000.0,0.0,2208852.0900000026,2018,10,30,DEBIT,3000.0,M199076892
6769,409000493210',2018-10-30,Indiaforensic NFS SETT 25-10-201,200.0,0.0,2208652.0900000026,2018,10,30,DEBIT,200.0,M1099109905
6770,409000493210',2018-10-30,Indiaforensic NFS SETT 25-10-201,1000.0,0.0,2207652.0900000026,2018,10,30,CHECK_WITHDRAWAL,1000.0,M1464460851
6771,409000493210',2018-10-30,Indiaforensic NFS SETT 25-10-201,1000.0,0.0,2206652.0900000026,2018,10,30,CHECK_WITHDRAWAL,1000.0,C292665982
6772,409000493210',2018-10-30,Indiaforensic NFS SETT 25-10-201,200.0,0.0,2206452.0900000026,2018,10,30,DEBIT,200.0,M1292956034
6773,409000493210',2018-10-30,Indiaforensic NFS SETT 25-10-201,10000.0,0.0,2196452.0900000026,2018,10,30,PAYEMENT,10000.0,M2117015229
6774,409000493210',2018-10-30,Indiaforensic NFS SETT 25-10-201,500.0,0.0,2195952.0900000026,2018,10,30,DEBIT,500.0,M328838504
6775,409000493210',2018-10-30,Indiaforensic NFS SETT 25-10-201,8000.0,0.0,2187952.0900000026,2018,10,30,DEBIT,8000.0,M1205094026
6776,409000493210',2018-10-30,Indiaforensic  RUPAY SETT 301018,13538.31,0.0,2174413.7800000026,2018,10,30,CASH_OUT,13538.31,M1053392896
6777,409000493210',2018-10-30,Indiaforensic  RUPAY SETT 301018,0.0,198.53,2174612.3100000024,2018,10,30,TRANSFER,198.53,M1532216261
6778,409000493210',2018-10-30,Indiaforensic RUPAY STL INTC3010,106.0,0.0,2174506.3100000024,2018,10,30,CHECK_WITHDRAWAL,106.0,M1708990865
6779,409000493210',2018-10-30,Indiaforensic RUPAY STL INTC3010,0.0,0.7,2174507.0100000026,2018,10,30,CASH_IN,0.7,M798555759
6780,409000493210',2018-10-30,Indiaforensic  RUPAY SETT 301018,10746.27,0.0,2163760.7400000026,2018,10,30,CHECK_WITHDRAWAL,10746.27,M131084586
6781,409000493210',2018-10-30,Indiaforensic  RUPAY SETT 301018,0.0,86.8,2163847.5400000024,2018,10,30,CHECK_CASHING,86.8,M126039047
6782,409000493210',2018-10-30,Indiaforensic RUPAY STL INTC3010,86.8,0.0,2163760.7400000026,2018,10,30,DEBIT,86.8,M1618190026
6783,409000493210',2018-10-31,TRF FROM  Indiaforensic SERVICES,0.0,230000.0,2393760.7400000026,2018,10,31,CHECK_CASHING,230000.0,M394737730
6784,409000493210',2018-10-31,Indiaforensic RUPAY SETT 311018,14746.18,0.0,2379014.5600000024,2018,10,31,CHECK_WITHDRAWAL,14746.18,M1753450343
6785,409000493210',2018-10-31,Indiaforensic RUPAY SETT 311018,0.0,170.14,2379184.7000000025,2018,10,31,CHECK_CASHING,170.14,M523771567
6786,409000493210',2018-10-31,Indiaforensic RUPAY STL INTC3110,131.89,0.0,2379052.8100000024,2018,10,31,CHECK_WITHDRAWAL,131.89,M691774060
6787,409000493210',2018-10-31,Indiaforensic RUPAY STL INTC3110,0.0,0.29,2379053.1000000024,2018,10,31,TRANSFER,0.29,M1560243485
6788,409000493210',2018-10-31,Indiaforensic RUPAY SETT 311018-,24250.3,0.0,2354802.8000000026,2018,10,31,DEBIT,24250.3,M1212473931
6789,409000493210',2018-10-31,Indiaforensic RUPAY SETT 311018-,0.0,153.63,2354956.4300000025,2018,10,31,TRANSFER,153.63,M37858242
6790,409000493210',2018-10-31,Indiaforensic RUPAY STL INTC3110,153.63,0.0,2354802.8000000026,2018,10,31,CASH_OUT,153.63,M291996777
6791,409000493210',2018-11-01,Indiaforensic NFS SETT 30-10-201,400.0,0.0,2354402.8000000026,2018,11,1,CASH_OUT,400.0,M918664959
6792,409000493210',2018-11-01,Indiaforensic NFS SETT 30-10-201,100.0,0.0,2354302.8000000026,2018,11,1,PAYEMENT,100.0,M381760603
6793,409000493210',2018-11-01,Indiaforensic NFS SETT 30-10-201,100.0,0.0,2354202.8000000026,2018,11,1,PAYEMENT,100.0,M474059546
6794,409000493210',2018-11-01,Indiaforensic NFS SETT 30-10-201,100.0,0.0,2354102.8000000026,2018,11,1,DEBIT,100.0,M2109146260
6795,409000493210',2018-11-01,Indiaforensic NFS SETT 30-10-201,10000.0,0.0,2344102.8000000026,2018,11,1,CASH_OUT,10000.0,M801808302
6796,409000493210',2018-11-01,Indiaforensic NFS SETT 30-10-201,1000.0,0.0,2343102.8000000026,2018,11,1,CASH_OUT,1000.0,M1423083642
6797,409000493210',2018-11-01,Indiaforensic NFS SETT 30-10-201,10000.0,0.0,2333102.8000000026,2018,11,1,DEBIT,10000.0,M145423728
6798,409000493210',2018-11-01,Indiaforensic NFS SETT 30-10-201,2000.0,0.0,2331102.8000000026,2018,11,1,CHECK_WITHDRAWAL,2000.0,M2090905694
6799,409000493210',2018-11-01,Indiaforensic NFS SETT 30-10-201,10000.0,0.0,2321102.8000000026,2018,11,1,CASH_OUT,10000.0,M1640037138
6800,409000493210',2018-11-01,Indiaforensic NFS SETT 30-10-201,2000.0,0.0,2319102.8000000026,2018,11,1,PAYEMENT,2000.0,M799729654
6801,409000493210',2018-11-01,Indiaforensic NFS SETT 30-10-201,10000.0,0.0,2309102.8000000026,2018,11,1,PAYEMENT,10000.0,M21247289
6802,409000493210',2018-11-01,Indiaforensic NFS SETT 30-10-201,7000.0,0.0,2302102.8000000026,2018,11,1,PAYEMENT,7000.0,M595319755
6803,409000493210',2018-11-01,Indiaforensic NFS SETT 30-10-201,10000.0,0.0,2292102.8000000026,2018,11,1,PAYEMENT,10000.0,M921452657
6804,409000493210',2018-11-01,Indiaforensic NFS SETT 30-10-201,3000.0,0.0,2289102.8000000026,2018,11,1,DEBIT,3000.0,C871895680
6805,409000493210',2018-11-01,Indiaforensic NFS SETT 30-10-201,10000.0,0.0,2279102.8000000026,2018,11,1,CHECK_WITHDRAWAL,10000.0,M1022837566
6806,409000493210',2018-11-01,Indiaforensic NFS SETT 30-10-201,3000.0,0.0,2276102.8000000026,2018,11,1,CHECK_WITHDRAWAL,3000.0,M1024412356
6807,409000493210',2018-11-01,Indiaforensic NFS SETT 30-10-201,1000.0,0.0,2275102.8000000026,2018,11,1,CASH_OUT,1000.0,C146305349
6808,409000493210',2018-11-01,Indiaforensic NFS SETT 29-10-201,5000.0,0.0,2270102.8000000026,2018,11,1,CASH_OUT,5000.0,C1452722471
6809,409000493210',2018-11-01,Indiaforensic NFS SETT 29-10-201,5400.0,0.0,2264702.8000000026,2018,11,1,PAYEMENT,5400.0,M510536150
6810,409000493210',2018-11-01,Indiaforensic NFS SETT 29-10-201,3000.0,0.0,2261702.8000000026,2018,11,1,CASH_OUT,3000.0,M1526336282
6811,409000493210',2018-11-01,Indiaforensic NFS SETT 29-10-201,2300.0,0.0,2259402.8000000026,2018,11,1,CASH_OUT,2300.0,C1983747920
6812,409000493210',2018-11-01,Indiaforensic NFS SETT 29-10-201,1200.0,0.0,2258202.8000000026,2018,11,1,PAYEMENT,1200.0,M1349400619
6813,409000493210',2018-11-01,Indiaforensic NFS SETT 29-10-201,10000.0,0.0,2248202.8000000026,2018,11,1,DEBIT,10000.0,M386863062
6814,409000493210',2018-11-01,Indiaforensic NFS SETT 29-10-201,7000.0,0.0,2241202.8000000026,2018,11,1,CASH_OUT,7000.0,M1767672626
6815,409000493210',2018-11-01,Indiaforensic RUPAY SETT 011118,20512.26,0.0,2220690.540000004,2018,11,1,DEBIT,20512.26,M1857237713
6816,409000493210',2018-11-01,Indiaforensic RUPAY SETT 011118,0.0,280.74,2220971.280000003,2018,11,1,TRANSFER,280.74,M962124674
6817,409000493210',2018-11-01,Indiaforensic RUPAY STL INTC0111,213.88,0.0,2220757.400000003,2018,11,1,CASH_OUT,213.88,M539825188
6818,409000493210',2018-11-01,Indiaforensic RUPAY STL INTC0111,0.0,0.5,2220757.900000003,2018,11,1,TRANSFER,0.5,M1840107352
6819,409000493210',2018-11-01,Indiaforensic RUPAY SETT 011118-,17269.42,0.0,2203488.4800000032,2018,11,1,PAYEMENT,17269.42,C1494895909
6820,409000493210',2018-11-01,Indiaforensic RUPAY SETT 011118-,0.0,164.16,2203652.640000004,2018,11,1,CASH_IN,164.16,M676470485
6821,409000493210',2018-11-01,Indiaforensic RUPAY STL INTC0111,164.16,0.0,2203488.4800000032,2018,11,1,CASH_OUT,164.16,M1285287269
6822,409000493210',2018-11-01,Indiaforensic NFS SETT 31-10-201,200.0,0.0,2203288.4800000032,2018,11,1,CHECK_WITHDRAWAL,200.0,M2117457731
6823,409000493210',2018-11-01,Indiaforensic NFS SETT 31-10-201,10000.0,0.0,2193288.4800000032,2018,11,1,CHECK_WITHDRAWAL,10000.0,C709906087
6824,409000493210',2018-11-01,Indiaforensic NFS SETT 31-10-201,3000.0,0.0,2190288.4800000032,2018,11,1,PAYEMENT,3000.0,C1334973394
6825,409000493210',2018-11-01,Indiaforensic NFS SETT 31-10-201,100.0,0.0,2190188.4800000032,2018,11,1,CHECK_WITHDRAWAL,100.0,M683674317
6826,409000493210',2018-11-01,Indiaforensic NFS SETT 31-10-201,10000.0,0.0,2180188.4800000032,2018,11,1,CHECK_WITHDRAWAL,10000.0,M577220795
6827,409000493210',2018-11-01,Indiaforensic NFS SETT 31-10-201,4500.0,0.0,2175688.4800000032,2018,11,1,CASH_OUT,4500.0,C1100767002
6828,409000493210',2018-11-01,Indiaforensic NFS SETT 31-10-201,2000.0,0.0,2173688.4800000032,2018,11,1,PAYEMENT,2000.0,M768047458
6829,409000493210',2018-11-01,Indiaforensic NFS SETT 31-10-201,10000.0,0.0,2163688.4800000032,2018,11,1,PAYEMENT,10000.0,M275466090
6830,409000493210',2018-11-01,Indiaforensic NFS SETT 31-10-201,10000.0,0.0,2153688.4800000032,2018,11,1,DEBIT,10000.0,M2068113806
6831,409000493210',2018-11-01,Indiaforensic NFS SETT 31-10-201,400.0,0.0,2153288.4800000032,2018,11,1,CHECK_WITHDRAWAL,400.0,M1412536057
6832,409000493210',2018-11-01,Indiaforensic NFS SETT 31-10-201,10000.0,0.0,2143288.4800000032,2018,11,1,DEBIT,10000.0,M288043672
6833,409000493210',2018-11-01,TRF FROM  Indiaforensic SERVICES,0.0,229969.0,2373257.4800000032,2018,11,1,CASH_IN,229969.0,C1619402333
6834,409000493210',2018-11-02,Indiaforensic RUPAY SETT 021118,6593.17,0.0,2366664.3100000042,2018,11,2,DEBIT,6593.17,M965874704
6835,409000493210',2018-11-02,Indiaforensic RUPAY SETT 021118,0.0,67.8,2366732.110000003,2018,11,2,CHECK_CASHING,67.8,M912877601
6836,409000493210',2018-11-02,Indiaforensic RUPAY STL INTC0211,51.41,0.0,2366680.700000003,2018,11,2,CHECK_WITHDRAWAL,51.41,M1989843834
6837,409000493210',2018-11-02,Indiaforensic RUPAY STL INTC0211,0.0,0.08,2366680.780000003,2018,11,2,CHECK_CASHING,0.08,M1342423316
6838,409000493210',2018-11-02,Indiaforensic RUPAY SETT 021118-,46212.65,0.0,2320468.130000003,2018,11,2,CASH_OUT,46212.65,M612873761
6839,409000493210',2018-11-02,Indiaforensic RUPAY STL INTC0211,325.09,0.0,2320143.040000004,2018,11,2,CASH_OUT,325.09,M1936362218
6840,409000493210',2018-11-02,Indiaforensic RUPAY SETT 021118-,0.0,325.09,2320468.130000003,2018,11,2,CASH_IN,325.09,M1231345665
6841,409000493210',2018-11-02,TRF TO  Indiaforensic SERVICES I,800000.0,0.0,1520468.1300000031,2018,11,2,DEBIT,800000.0,M749377126
6842,409000493210',2018-11-02,FDRL/INTERNAL FUND TRANSFE,0.0,100000.0,1620468.1300000031,2018,11,2,TRANSFER,100000.0,M1232346752
6843,409000493210',2018-11-02,FDRL/INTERNAL FUND TRANSFE,0.0,100000.0,1720468.1300000031,2018,11,2,TRANSFER,100000.0,M967635335
6844,409000493210',2018-11-02,FDRL/INTERNAL FUND TRANSFE,0.0,50000.0,1770468.1300000031,2018,11,2,CHECK_CASHING,50000.0,C1870436181
6845,409000493210',2018-11-02,FDRL/INTERNAL FUND TRANSFE,0.0,100000.0,1870468.1300000031,2018,11,2,CHECK_CASHING,100000.0,M646359041
6846,409000493210',2018-11-02,FDRL/INTERNAL FUND TRANSFE,0.0,100000.0,1970468.1300000031,2018,11,2,TRANSFER,100000.0,M1332370633
6847,409000493210',2018-11-02,FDRL/INTERNAL FUND TRANSFE,0.0,100000.0,2070468.1300000031,2018,11,2,TRANSFER,100000.0,M1324420411
6848,409000493210',2018-11-02,FDRL/INTERNAL FUND TRANSFE,0.0,50000.0,2120468.130000003,2018,11,2,CHECK_CASHING,50000.0,M1762556809
6849,409000493210',2018-11-02,FDRL/INTERNAL FUND TRANSFE,0.0,100000.0,2220468.130000003,2018,11,2,CHECK_CASHING,100000.0,M1368067090
6850,409000493210',2018-11-02,FDRL/INTERNAL FUND TRANSFE,0.0,100000.0,2320468.130000003,2018,11,2,CHECK_CASHING,100000.0,M1085888709
6851,409000493210',2018-11-03,Indiaforensic NFS SETT 01-11-201,3500.0,0.0,2316968.130000003,2018,11,3,CHECK_WITHDRAWAL,3500.0,M1957398032
6852,409000493210',2018-11-03,Indiaforensic NFS SETT 01-11-201,10000.0,0.0,2306968.130000003,2018,11,3,PAYEMENT,10000.0,M694766024
6853,409000493210',2018-11-03,Indiaforensic NFS SETT 01-11-201,10000.0,0.0,2296968.130000003,2018,11,3,PAYEMENT,10000.0,M860892414
6854,409000493210',2018-11-03,Indiaforensic NFS SETT 01-11-201,10000.0,0.0,2286968.130000003,2018,11,3,CHECK_WITHDRAWAL,10000.0,M291054778
6855,409000493210',2018-11-03,Indiaforensic NFS SETT 01-11-201,5000.0,0.0,2281968.130000003,2018,11,3,CASH_OUT,5000.0,M623717056
6856,409000493210',2018-11-03,Indiaforensic NFS SETT 01-11-201,10000.0,0.0,2271968.130000003,2018,11,3,CHECK_WITHDRAWAL,10000.0,M1739573686
6857,409000493210',2018-11-03,Indiaforensic NFS SETT 01-11-201,5000.0,0.0,2266968.130000003,2018,11,3,PAYEMENT,5000.0,M2054805916
6858,409000493210',2018-11-03,Indiaforensic NFS SETT 01-11-201,10000.0,0.0,2256968.130000003,2018,11,3,DEBIT,10000.0,M115112831
6859,409000493210',2018-11-03,Indiaforensic NFS SETT 01-11-201,500.0,0.0,2256468.130000003,2018,11,3,CASH_OUT,500.0,M1881420492
6860,409000493210',2018-11-03,Indiaforensic  RUPAY SETT 031118,3274.61,0.0,2253193.520000004,2018,11,3,PAYEMENT,3274.61,M895175732
6861,409000493210',2018-11-03,Indiaforensic  RUPAY SETT 031118,0.0,25.16,2253218.680000004,2018,11,3,CASH_IN,25.16,M230944166
6862,409000493210',2018-11-03,Indiaforensic RUPAY STL INTC0311,25.16,0.0,2253193.520000004,2018,11,3,DEBIT,25.16,M2091367901
6863,409000493210',2018-11-03,Indiaforensic  RUPAY SETT 031118,11483.55,0.0,2241709.970000004,2018,11,3,CASH_OUT,11483.55,M844248821
6864,409000493210',2018-11-03,Indiaforensic  RUPAY SETT 031118,0.0,136.21,2241846.180000004,2018,11,3,CHECK_CASHING,136.21,M1935880752
6865,409000493210',2018-11-03,Indiaforensic RUPAY STL INTC0311,133.86,0.0,2241712.320000004,2018,11,3,CHECK_WITHDRAWAL,133.86,M34994391
6866,409000493210',2018-11-03,Indiaforensic RUPAY STL INTC0311,0.0,0.01,2241712.3300000043,2018,11,3,CASH_IN,0.01,M55220696
6867,409000493210',2018-11-05,Indiaforensic RUPAY SETT 041118,60629.44,0.0,2181082.890000004,2018,11,5,PAYEMENT,60629.44,M333890884
6868,409000493210',2018-11-05,Indiaforensic RUPAY SETT 041118,0.0,594.46,2181677.3500000043,2018,11,5,TRANSFER,594.46,M993731216
6869,409000493210',2018-11-05,Indiaforensic RUPAY STL INTC0411,594.46,0.0,2181082.890000004,2018,11,5,PAYEMENT,594.46,M1648285165
6870,409000493210',2018-11-05,Indiaforensic RUPAY SETT 051118,43645.94,0.0,2137436.950000004,2018,11,5,DEBIT,43645.94,M732214059
6871,409000493210',2018-11-05,Indiaforensic RUPAY STL INTC0511,321.99,0.0,2137114.960000003,2018,11,5,PAYEMENT,321.99,M1202402952
6872,409000493210',2018-11-05,Indiaforensic RUPAY SETT 051118,0.0,502.37,2137617.3300000043,2018,11,5,CHECK_CASHING,502.37,M1229465441
6873,409000493210',2018-11-05,Indiaforensic RUPAY STL INTC0511,0.0,1.34,2137618.670000003,2018,11,5,TRANSFER,1.34,M1950456251
6874,409000493210',2018-11-05,Indiaforensic  RUPAY SETT 051118,37924.25,0.0,2099694.420000003,2018,11,5,CASH_OUT,37924.25,M1679027895
6875,409000493210',2018-11-05,Indiaforensic  RUPAY SETT 051118,0.0,350.39,2100044.8100000042,2018,11,5,CHECK_CASHING,350.39,M1898058733
6876,409000493210',2018-11-05,Indiaforensic RUPAY STL INTC0511,350.39,0.0,2099694.420000003,2018,11,5,CHECK_WITHDRAWAL,350.39,M587573968
6877,409000493210',2018-11-05,TRF FROM  Indiaforensic SERVICES,0.0,1300000.0,3399694.420000003,2018,11,5,CASH_IN,1300000.0,M2110350270
6878,409000493210',2018-11-06,Indiaforensic  RUPAY SETT 061118,17597.14,0.0,3382097.280000003,2018,11,6,CASH_OUT,17597.14,M1872337398
6879,409000493210',2018-11-06,Indiaforensic  RUPAY SETT 061118,0.0,161.54,3382258.820000003,2018,11,6,TRANSFER,161.54,M1760173749
6880,409000493210',2018-11-06,Indiaforensic RUPAY STL INTC0611,155.08,0.0,3382103.740000003,2018,11,6,CHECK_WITHDRAWAL,155.08,M226230494
6881,409000493210',2018-11-06,Indiaforensic RUPAY STL INTC0611,0.0,0.03,3382103.7700000037,2018,11,6,TRANSFER,0.03,M702392974
6882,409000493210',2018-11-06,Indiaforensic NFS SETT 02-11-201,10000.0,0.0,3372103.7700000037,2018,11,6,CASH_OUT,10000.0,M560990653
6883,409000493210',2018-11-06,Indiaforensic NFS SETT 02-11-201,10000.0,0.0,3362103.7700000037,2018,11,6,PAYEMENT,10000.0,M613131516
6884,409000493210',2018-11-06,Indiaforensic NFS SETT 02-11-201,5000.0,0.0,3357103.7700000037,2018,11,6,CHECK_WITHDRAWAL,5000.0,M1968190405
6885,409000493210',2018-11-06,Indiaforensic NFS SETT 02-11-201,10000.0,0.0,3347103.7700000037,2018,11,6,CHECK_WITHDRAWAL,10000.0,C1211297851
6886,409000493210',2018-11-06,Indiaforensic NFS SETT 02-11-201,500.0,0.0,3346603.7700000037,2018,11,6,PAYEMENT,500.0,M1755229011
6887,409000493210',2018-11-06,Indiaforensic NFS SETT 02-11-201,10000.0,0.0,3336603.7700000037,2018,11,6,CASH_OUT,10000.0,M1553033411
6888,409000493210',2018-11-06,Indiaforensic NFS SETT 02-11-201,300.0,0.0,3336303.7700000037,2018,11,6,DEBIT,300.0,C1515704208
6889,409000493210',2018-11-06,Indiaforensic NFS SETT 02-11-201,10000.0,0.0,3326303.7700000037,2018,11,6,PAYEMENT,10000.0,C424743902
6890,409000493210',2018-11-06,Indiaforensic NFS SETT 03-11-201,10000.0,0.0,3316303.7700000037,2018,11,6,DEBIT,10000.0,M1058937009
6891,409000493210',2018-11-06,Indiaforensic NFS SETT 03-11-201,10000.0,0.0,3306303.7700000037,2018,11,6,CHECK_WITHDRAWAL,10000.0,M1843660571
6892,409000493210',2018-11-06,Indiaforensic NFS SETT 03-11-201,500.0,0.0,3305803.7700000037,2018,11,6,PAYEMENT,500.0,C408553489
6893,409000493210',2018-11-06,Indiaforensic NFS SETT 03-11-201,10000.0,0.0,3295803.7700000037,2018,11,6,PAYEMENT,10000.0,C1318822808
6894,409000493210',2018-11-06,Indiaforensic NFS SETT 03-11-201,10000.0,0.0,3285803.7700000037,2018,11,6,CASH_OUT,10000.0,C1746150957
6895,409000493210',2018-11-06,Indiaforensic NFS SETT 03-11-201,3000.0,0.0,3282803.7700000037,2018,11,6,CASH_OUT,3000.0,M587108575
6896,409000493210',2018-11-06,Indiaforensic NFS SETT 04-11-201,8000.0,0.0,3274803.7700000037,2018,11,6,PAYEMENT,8000.0,C1013700132
6897,409000493210',2018-11-06,Indiaforensic NFS SETT 04-11-201,700.0,0.0,3274103.7700000037,2018,11,6,CASH_OUT,700.0,C1790657739
6898,409000493210',2018-11-06,Indiaforensic NFS SETT 04-11-201,1000.0,0.0,3273103.7700000037,2018,11,6,DEBIT,1000.0,C418964192
6899,409000493210',2018-11-06,Indiaforensic NFS SETT 04-11-201,10000.0,0.0,3263103.7700000037,2018,11,6,CASH_OUT,10000.0,M294395818
6900,409000493210',2018-11-06,Indiaforensic NFS SETT 04-11-201,5000.0,0.0,3258103.7700000037,2018,11,6,CHECK_WITHDRAWAL,5000.0,M161445348
6901,409000493210',2018-11-06,Indiaforensic NFS SETT 04-11-201,10000.0,0.0,3248103.7700000037,2018,11,6,DEBIT,10000.0,C7313260
6902,409000493210',2018-11-06,Indiaforensic NFS SETT 04-11-201,5000.0,0.0,3243103.7700000037,2018,11,6,CASH_OUT,5000.0,C1019670582
6903,409000493210',2018-11-06,Indiaforensic NFS SETT 04-11-201,10000.0,0.0,3233103.7700000037,2018,11,6,DEBIT,10000.0,M134963352
6904,409000493210',2018-11-06,Indiaforensic  RUPAY SETT 061118,1711.42,0.0,3231392.350000004,2018,11,6,PAYEMENT,1711.42,M2015874556
6905,409000493210',2018-11-06,Indiaforensic  RUPAY SETT 061118,0.0,18.82,3231411.1700000027,2018,11,6,TRANSFER,18.82,M433321211
6906,409000493210',2018-11-06,Indiaforensic RUPAY STL INTC0611,18.82,0.0,3231392.350000004,2018,11,6,CHECK_WITHDRAWAL,18.82,C1896545607
6907,409000493210',2018-11-07,Indiaforensic  RUPAY SETT 071118,61047.61,0.0,3170344.740000003,2018,11,7,CASH_OUT,61047.61,M896185192
6908,409000493210',2018-11-07,Indiaforensic  RUPAY SETT 071118,0.0,538.61,3170883.350000004,2018,11,7,CHECK_CASHING,538.61,C71555810
6909,409000493210',2018-11-07,Indiaforensic RUPAY STL INTC0711,538.61,0.0,3170344.740000003,2018,11,7,CHECK_WITHDRAWAL,538.61,M105784446
6910,409000493210',2018-11-07,Indiaforensic  RUPAY SETT 071118,47953.76,0.0,3122390.9800000032,2018,11,7,CHECK_WITHDRAWAL,47953.76,M307996568
6911,409000493210',2018-11-07,Indiaforensic  RUPAY SETT 071118,0.0,313.15,3122704.130000003,2018,11,7,CHECK_CASHING,313.15,M1136787778
6912,409000493210',2018-11-07,Indiaforensic RUPAY STL INTC0711,310.83,0.0,3122393.300000003,2018,11,7,PAYEMENT,310.83,M328940073
6913,409000493210',2018-11-07,Indiaforensic RUPAY STL INTC0711,0.0,0.01,3122393.310000004,2018,11,7,CASH_IN,0.01,M836432020
6914,409000493210',2018-11-08,Indiaforensic RUPAY SETT 081118,21864.25,0.0,3100529.060000004,2018,11,8,DEBIT,21864.25,M1042700305
6915,409000493210',2018-11-08,Indiaforensic RUPAY SETT 081118,0.0,236.18,3100765.240000003,2018,11,8,TRANSFER,236.18,M865627111
6916,409000493210',2018-11-08,Indiaforensic RUPAY STL INTC0811,236.18,0.0,3100529.060000004,2018,11,8,CASH_OUT,236.18,M2028313348
6917,409000493210',2018-11-08,Indiaforensic RUPAY SETT 081118-,10094.54,0.0,3090434.5200000037,2018,11,8,CHECK_WITHDRAWAL,10094.54,M1591250481
6918,409000493210',2018-11-08,Indiaforensic RUPAY SETT 081118-,0.0,107.98,3090542.5000000037,2018,11,8,CHECK_CASHING,107.98,C1096283470
6919,409000493210',2018-11-08,Indiaforensic RUPAY STL INTC0811,107.98,0.0,3090434.5200000037,2018,11,8,CASH_OUT,107.98,M1433290120
6920,409000493210',2018-11-09,Indiaforensic  RUPAY SETT 091118,8035.17,0.0,3082399.350000004,2018,11,9,DEBIT,8035.17,C75457651
6921,409000493210',2018-11-09,Indiaforensic  RUPAY SETT 091118,0.0,63.05,3082462.4000000027,2018,11,9,CASH_IN,63.05,C1297685781
6922,409000493210',2018-11-09,Indiaforensic RUPAY STL INTC0911,63.05,0.0,3082399.350000004,2018,11,9,CHECK_WITHDRAWAL,63.05,M1890262240
6923,409000493210',2018-11-09,Indiaforensic RUPAY SETT 091118-,23196.06,0.0,3059203.2900000038,2018,11,9,DEBIT,23196.06,M1985918977
6924,409000493210',2018-11-09,Indiaforensic RUPAY SETT 091118-,0.0,159.25,3059362.5400000038,2018,11,9,CHECK_CASHING,159.25,M2078138276
6925,409000493210',2018-11-09,Indiaforensic RUPAY STL INTC0911,159.25,0.0,3059203.2900000038,2018,11,9,CHECK_WITHDRAWAL,159.25,M487571644
6926,409000493210',2018-11-09,Indiaforensic NFS SETT 06-11-201,2500.0,0.0,3056703.2900000038,2018,11,9,DEBIT,2500.0,M389407172
6927,409000493210',2018-11-09,Indiaforensic NFS SETT 06-11-201,5000.0,0.0,3051703.2900000038,2018,11,9,PAYEMENT,5000.0,C2020152163
6928,409000493210',2018-11-09,Indiaforensic NFS SETT 06-11-201,1000.0,0.0,3050703.2900000038,2018,11,9,DEBIT,1000.0,C296121376
6929,409000493210',2018-11-09,Indiaforensic NFS SETT 06-11-201,5000.0,0.0,3045703.2900000038,2018,11,9,PAYEMENT,5000.0,M1189050702
6930,409000493210',2018-11-09,Indiaforensic NFS SETT 06-11-201,1000.0,0.0,3044703.2900000038,2018,11,9,DEBIT,1000.0,M1825984578
6931,409000493210',2018-11-09,Indiaforensic NFS SETT 06-11-201,8000.0,0.0,3036703.2900000038,2018,11,9,PAYEMENT,8000.0,M1264380765
6932,409000493210',2018-11-09,Indiaforensic NFS SETT 06-11-201,8000.0,0.0,3028703.2900000038,2018,11,9,DEBIT,8000.0,M2091447767
6933,409000493210',2018-11-09,Indiaforensic NFS SETT 06-11-201,8000.0,0.0,3020703.2900000038,2018,11,9,CASH_OUT,8000.0,M23660841
6934,409000493210',2018-11-09,Indiaforensic NFS SETT 06-11-201,7000.0,0.0,3013703.2900000038,2018,11,9,DEBIT,7000.0,M267331432
6935,409000493210',2018-11-09,Indiaforensic NFS SETT 06-11-201,500.0,0.0,3013203.2900000038,2018,11,9,DEBIT,500.0,M1933458457
6936,409000493210',2018-11-09,Indiaforensic NFS SETT 06-11-201,8000.0,0.0,3005203.2900000038,2018,11,9,PAYEMENT,8000.0,M582627504
6937,409000493210',2018-11-09,Indiaforensic NFS SETT 06-11-201,8800.0,0.0,2996403.2900000038,2018,11,9,CASH_OUT,8800.0,M543198964
6938,409000493210',2018-11-09,Indiaforensic NFS SETT 06-11-201,9500.0,0.0,2986903.2900000038,2018,11,9,DEBIT,9500.0,M1131228089
6939,409000493210',2018-11-09,Indiaforensic NFS SETT 06-11-201,500.0,0.0,2986403.2900000038,2018,11,9,PAYEMENT,500.0,M539452434
6940,409000493210',2018-11-09,Indiaforensic NFS SETT 06-11-201,800.0,0.0,2985603.2900000038,2018,11,9,DEBIT,800.0,M934563470
6941,409000493210',2018-11-09,Indiaforensic NFS SETT 06-11-201,8200.0,0.0,2977403.2900000038,2018,11,9,DEBIT,8200.0,M175168244
6942,409000493210',2018-11-09,Indiaforensic NFS SETT 06-11-201,4000.0,0.0,2973403.2900000038,2018,11,9,CHECK_WITHDRAWAL,4000.0,M1980883605
6943,409000493210',2018-11-09,Indiaforensic NFS SETT 06-11-201,9000.0,0.0,2964403.2900000038,2018,11,9,PAYEMENT,9000.0,M176150399
6944,409000493210',2018-11-09,Indiaforensic NFS SETT 06-11-201,7000.0,0.0,2957403.2900000038,2018,11,9,CHECK_WITHDRAWAL,7000.0,M805744373
6945,409000493210',2018-11-09,Indiaforensic NFS SETT 06-11-201,7000.0,0.0,2950403.2900000038,2018,11,9,DEBIT,7000.0,M1645577752
6946,409000493210',2018-11-09,Indiaforensic NFS SETT 06-11-201,7000.0,0.0,2943403.2900000038,2018,11,9,CASH_OUT,7000.0,M2034604138
6947,409000493210',2018-11-09,Indiaforensic NFS SETT 06-11-201,500.0,0.0,2942903.2900000038,2018,11,9,PAYEMENT,500.0,M181021195
6948,409000493210',2018-11-09,Indiaforensic NFS SETT 06-11-201,5800.0,0.0,2937103.2900000038,2018,11,9,DEBIT,5800.0,M752571350
6949,409000493210',2018-11-09,Indiaforensic NFS SETT 06-11-201,8500.0,0.0,2928603.2900000038,2018,11,9,CASH_OUT,8500.0,M964416619
6950,409000493210',2018-11-09,Indiaforensic NFS SETT 06-11-201,9500.0,0.0,2919103.2900000038,2018,11,9,PAYEMENT,9500.0,M1995167125
6951,409000493210',2018-11-09,Indiaforensic NFS SETT 06-11-201,10000.0,0.0,2909103.2900000038,2018,11,9,CASH_OUT,10000.0,M576698206
6952,409000493210',2018-11-09,Indiaforensic NFS SETT 06-11-201,3200.0,0.0,2905903.2900000038,2018,11,9,CASH_OUT,3200.0,M1228340166
6953,409000493210',2018-11-09,Indiaforensic NFS SETT 06-11-201,9000.0,0.0,2896903.2900000038,2018,11,9,CHECK_WITHDRAWAL,9000.0,M1425418950
6954,409000493210',2018-11-09,Indiaforensic NFS SETT 06-11-201,7500.0,0.0,2889403.2900000038,2018,11,9,PAYEMENT,7500.0,M100550728
6955,409000493210',2018-11-09,Indiaforensic NFS SETT 06-11-201,1000.0,0.0,2888403.2900000038,2018,11,9,PAYEMENT,1000.0,M265668598
6956,409000493210',2018-11-09,Indiaforensic NFS SETT 06-11-201,10000.0,0.0,2878403.2900000038,2018,11,9,PAYEMENT,10000.0,M1089411380
6957,409000493210',2018-11-09,Indiaforensic NFS SETT 06-11-201,2000.0,0.0,2876403.2900000038,2018,11,9,DEBIT,2000.0,M140425810
6958,409000493210',2018-11-09,Indiaforensic NFS SETT 06-11-201,8000.0,0.0,2868403.2900000038,2018,11,9,PAYEMENT,8000.0,M573207593
6959,409000493210',2018-11-09,Indiaforensic NFS SETT 06-11-201,500.0,0.0,2867903.2900000038,2018,11,9,DEBIT,500.0,M1599695386
6960,409000493210',2018-11-09,Indiaforensic NFS SETT 06-11-201,500.0,0.0,2867403.2900000038,2018,11,9,CASH_OUT,500.0,M334348732
6961,409000493210',2018-11-09,Indiaforensic NFS SETT 06-11-201,2500.0,0.0,2864903.2900000038,2018,11,9,DEBIT,2500.0,M1677584330
6962,409000493210',2018-11-09,Indiaforensic NFS SETT 06-11-201,2500.0,0.0,2862403.2900000038,2018,11,9,PAYEMENT,2500.0,M1199169341
6963,409000493210',2018-11-09,Indiaforensic NFS SETT 06-11-201,200.0,0.0,2862203.2900000038,2018,11,9,PAYEMENT,200.0,C97730845
6964,409000493210',2018-11-09,Indiaforensic NFS SETT 06-11-201,500.0,0.0,2861703.2900000038,2018,11,9,DEBIT,500.0,M608616031
6965,409000493210',2018-11-09,Indiaforensic NFS SETT 06-11-201,5000.0,0.0,2856703.2900000038,2018,11,9,PAYEMENT,5000.0,M1531478195
6966,409000493210',2018-11-09,Indiaforensic NFS SETT 06-11-201,5000.0,0.0,2851703.2900000038,2018,11,9,PAYEMENT,5000.0,M1271109184
6967,409000493210',2018-11-09,Indiaforensic NFS SETT 06-11-201,7000.0,0.0,2844703.2900000038,2018,11,9,CHECK_WITHDRAWAL,7000.0,M23436669
6968,409000493210',2018-11-09,Indiaforensic NFS SETT 06-11-201,500.0,0.0,2844203.2900000038,2018,11,9,CHECK_WITHDRAWAL,500.0,C638590716
6969,409000493210',2018-11-09,Indiaforensic NFS SETT 06-11-201,2300.0,0.0,2841903.2900000038,2018,11,9,DEBIT,2300.0,M528162154
6970,409000493210',2018-11-09,Indiaforensic NFS SETT 06-11-201,6500.0,0.0,2835403.2900000038,2018,11,9,CASH_OUT,6500.0,M1284775193
6971,409000493210',2018-11-09,Indiaforensic NFS SETT 06-11-201,4800.0,0.0,2830603.2900000038,2018,11,9,CHECK_WITHDRAWAL,4800.0,M354359092
6972,409000493210',2018-11-09,Indiaforensic NFS SETT 06-11-201,8000.0,0.0,2822603.2900000038,2018,11,9,CASH_OUT,8000.0,M210688344
6973,409000493210',2018-11-09,Indiaforensic NFS SETT 06-11-201,500.0,0.0,2822103.2900000038,2018,11,9,DEBIT,500.0,M1964740634
6974,409000493210',2018-11-09,Indiaforensic NFS SETT 06-11-201,10000.0,0.0,2812103.290000004,2018,11,9,PAYEMENT,10000.0,M483189093
6975,409000493210',2018-11-09,Indiaforensic NFS SETT 06-11-201,10000.0,0.0,2802103.290000004,2018,11,9,CHECK_WITHDRAWAL,10000.0,M690419645
6976,409000493210',2018-11-09,Indiaforensic NFS SETT 06-11-201,2000.0,0.0,2800103.290000004,2018,11,9,CASH_OUT,2000.0,M555545211
6977,409000493210',2018-11-09,Indiaforensic NFS SETT 07-11-201,5000.0,0.0,2795103.290000004,2018,11,9,PAYEMENT,5000.0,C804836251
6978,409000493210',2018-11-09,Indiaforensic NFS SETT 07-11-201,3000.0,0.0,2792103.290000004,2018,11,9,PAYEMENT,3000.0,M1133143463
6979,409000493210',2018-11-09,Indiaforensic NFS SETT 07-11-201,8700.0,0.0,2783403.290000004,2018,11,9,CHECK_WITHDRAWAL,8700.0,M1978943199
6980,409000493210',2018-11-09,Indiaforensic NFS SETT 07-11-201,7500.0,0.0,2775903.290000004,2018,11,9,CHECK_WITHDRAWAL,7500.0,M669406950
6981,409000493210',2018-11-09,Indiaforensic NFS SETT 07-11-201,200.0,0.0,2775703.290000004,2018,11,9,CASH_OUT,200.0,M1802493587
6982,409000493210',2018-11-09,Indiaforensic NFS SETT 07-11-201,2500.0,0.0,2773203.290000004,2018,11,9,CHECK_WITHDRAWAL,2500.0,M1142383288
6983,409000493210',2018-11-09,Indiaforensic NFS SETT 07-11-201,8000.0,0.0,2765203.290000004,2018,11,9,CHECK_WITHDRAWAL,8000.0,M941702906
6984,409000493210',2018-11-09,Indiaforensic NFS SETT 07-11-201,5000.0,0.0,2760203.290000004,2018,11,9,CASH_OUT,5000.0,M205284289
6985,409000493210',2018-11-09,Indiaforensic NFS SETT 07-11-201,1600.0,0.0,2758603.290000004,2018,11,9,DEBIT,1600.0,C410033330
6986,409000493210',2018-11-09,Indiaforensic NFS SETT 07-11-201,500.0,0.0,2758103.290000004,2018,11,9,CASH_OUT,500.0,C991505714
6987,409000493210',2018-11-09,Indiaforensic NFS SETT 07-11-201,9200.0,0.0,2748903.290000004,2018,11,9,DEBIT,9200.0,C1286084959
6988,409000493210',2018-11-09,Indiaforensic NFS SETT 07-11-201,9500.0,0.0,2739403.290000004,2018,11,9,DEBIT,9500.0,C1619402333
6989,409000493210',2018-11-09,Indiaforensic NFS SETT 07-11-201,6000.0,0.0,2733403.290000004,2018,11,9,DEBIT,6000.0,C1587143371
6990,409000493210',2018-11-09,Indiaforensic NFS SETT 07-11-201,5000.0,0.0,2728403.290000004,2018,11,9,PAYEMENT,5000.0,C1587143371
6991,409000493210',2018-11-09,Indiaforensic NFS SETT 07-11-201,800.0,0.0,2727603.290000004,2018,11,9,PAYEMENT,800.0,C2072865894
6992,409000493210',2018-11-09,Indiaforensic NFS SETT 07-11-201,400.0,0.0,2727203.290000004,2018,11,9,CHECK_WITHDRAWAL,400.0,C991505714
6993,409000493210',2018-11-09,Indiaforensic NFS SETT 07-11-201,7100.0,0.0,2720103.290000004,2018,11,9,CHECK_WITHDRAWAL,7100.0,C991363637
6994,409000493210',2018-11-09,Indiaforensic NFS SETT 07-11-201,7500.0,0.0,2712603.290000004,2018,11,9,DEBIT,7500.0,C125722707
6995,409000493210',2018-11-09,Indiaforensic NFS SETT 07-11-201,1000.0,0.0,2711603.290000004,2018,11,9,CASH_OUT,1000.0,C1085479446
6996,409000493210',2018-11-09,Indiaforensic NFS SETT 07-11-201,10000.0,0.0,2701603.290000004,2018,11,9,CASH_OUT,10000.0,C183354406
6997,409000493210',2018-11-09,Indiaforensic NFS SETT 07-11-201,6000.0,0.0,2695603.290000004,2018,11,9,PAYEMENT,6000.0,C1337741679
6998,409000493210',2018-11-09,Indiaforensic NFS SETT 07-11-201,3500.0,0.0,2692103.290000004,2018,11,9,PAYEMENT,3500.0,M698473139
6999,409000493210',2018-11-09,Indiaforensic NFS SETT 07-11-201,10000.0,0.0,2682103.290000004,2018,11,9,CASH_OUT,10000.0,M1794130044
7000,409000493210',2018-11-09,Indiaforensic NFS SETT 07-11-201,500.0,0.0,2681603.290000004,2018,11,9,DEBIT,500.0,M550451891
7001,409000493210',2018-11-09,Indiaforensic NFS SETT 07-11-201,9000.0,0.0,2672603.290000004,2018,11,9,PAYEMENT,9000.0,M1918144733
7002,409000493210',2018-11-09,Indiaforensic NFS SETT 07-11-201,4000.0,0.0,2668603.290000004,2018,11,9,CHECK_WITHDRAWAL,4000.0,C908043384
7003,409000493210',2018-11-09,Indiaforensic NFS SETT 07-11-201,6000.0,0.0,2662603.290000004,2018,11,9,DEBIT,6000.0,C801412408
7004,409000493210',2018-11-09,Indiaforensic NFS SETT 07-11-201,6000.0,0.0,2656603.290000004,2018,11,9,CHECK_WITHDRAWAL,6000.0,M2116330210
7005,409000493210',2018-11-09,Indiaforensic NFS SETT 07-11-201,8200.0,0.0,2648403.290000004,2018,11,9,CASH_OUT,8200.0,M989251186
7006,409000493210',2018-11-09,Indiaforensic NFS SETT 07-11-201,9500.0,0.0,2638903.290000004,2018,11,9,CHECK_WITHDRAWAL,9500.0,C466505482
7007,409000493210',2018-11-09,Indiaforensic NFS SETT 07-11-201,10000.0,0.0,2628903.290000004,2018,11,9,CASH_OUT,10000.0,M2098396037
7008,409000493210',2018-11-09,Indiaforensic NFS SETT 07-11-201,1000.0,0.0,2627903.290000004,2018,11,9,DEBIT,1000.0,M1191890972
7009,409000493210',2018-11-09,Indiaforensic NFS SETT 07-11-201,9500.0,0.0,2618403.290000004,2018,11,9,DEBIT,9500.0,C414386513
7010,409000493210',2018-11-09,Indiaforensic NFS SETT 07-11-201,200.0,0.0,2618203.290000004,2018,11,9,PAYEMENT,200.0,M777588278
7011,409000493210',2018-11-09,Indiaforensic NFS SETT 07-11-201,6400.0,0.0,2611803.290000004,2018,11,9,CHECK_WITHDRAWAL,6400.0,M1965965859
7012,409000493210',2018-11-09,Indiaforensic NFS SETT 07-11-201,9000.0,0.0,2602803.290000004,2018,11,9,DEBIT,9000.0,M325488817
7013,409000493210',2018-11-09,Indiaforensic NFS SETT 07-11-201,8700.0,0.0,2594103.290000004,2018,11,9,CHECK_WITHDRAWAL,8700.0,C266418454
7014,409000493210',2018-11-09,Indiaforensic NFS SETT 07-11-201,8500.0,0.0,2585603.290000004,2018,11,9,CASH_OUT,8500.0,C1163619825
7015,409000493210',2018-11-09,Indiaforensic NFS SETT 07-11-201,5000.0,0.0,2580603.290000004,2018,11,9,PAYEMENT,5000.0,M740654090
7016,409000493210',2018-11-09,Indiaforensic NFS SETT 07-11-201,8500.0,0.0,2572103.290000004,2018,11,9,DEBIT,8500.0,M1749810089
7017,409000493210',2018-11-09,Indiaforensic NFS SETT 07-11-201,9500.0,0.0,2562603.290000004,2018,11,9,DEBIT,9500.0,M1750711252
7018,409000493210',2018-11-09,Indiaforensic NFS SETT 07-11-201,300.0,0.0,2562303.290000004,2018,11,9,DEBIT,300.0,C715819458
7019,409000493210',2018-11-09,Indiaforensic NFS SETT 07-11-201,7000.0,0.0,2555303.290000004,2018,11,9,CHECK_WITHDRAWAL,7000.0,C35126588
7020,409000493210',2018-11-09,Indiaforensic NFS SETT 07-11-201,9500.0,0.0,2545803.290000004,2018,11,9,CHECK_WITHDRAWAL,9500.0,M1836569193
7021,409000493210',2018-11-09,Indiaforensic NFS SETT 07-11-201,1800.0,0.0,2544003.290000004,2018,11,9,CASH_OUT,1800.0,M1393182452
7022,409000493210',2018-11-09,Indiaforensic NFS SETT 07-11-201,8000.0,0.0,2536003.290000004,2018,11,9,CHECK_WITHDRAWAL,8000.0,C1794607688
7023,409000493210',2018-11-09,Indiaforensic NFS SETT 07-11-201,6000.0,0.0,2530003.290000004,2018,11,9,PAYEMENT,6000.0,C1899073220
7024,409000493210',2018-11-09,Indiaforensic NFS SETT 07-11-201,6000.0,0.0,2524003.290000004,2018,11,9,DEBIT,6000.0,M976673374
7025,409000493210',2018-11-09,Indiaforensic NFS SETT 07-11-201,9000.0,0.0,2515003.290000004,2018,11,9,PAYEMENT,9000.0,C1850180796
7026,409000493210',2018-11-09,Indiaforensic NFS SETT 07-11-201,300.0,0.0,2514703.290000004,2018,11,9,CASH_OUT,300.0,M964661854
7027,409000493210',2018-11-09,Indiaforensic NFS SETT 07-11-201,3000.0,0.0,2511703.290000004,2018,11,9,PAYEMENT,3000.0,M1196288844
7028,409000493210',2018-11-09,Indiaforensic NFS SETT 07-11-201,400.0,0.0,2511303.290000004,2018,11,9,CASH_OUT,400.0,M780709176
7029,409000493210',2018-11-09,Indiaforensic NFS SETT 07-11-201,9000.0,0.0,2502303.290000004,2018,11,9,CHECK_WITHDRAWAL,9000.0,C527482085
7030,409000493210',2018-11-09,Indiaforensic NFS SETT 07-11-201,9500.0,0.0,2492803.290000004,2018,11,9,CASH_OUT,9500.0,C382431057
7031,409000493210',2018-11-09,Indiaforensic NFS SETT 07-11-201,9700.0,0.0,2483103.290000004,2018,11,9,PAYEMENT,9700.0,M147646893
7032,409000493210',2018-11-09,Indiaforensic NFS SETT 07-11-201,9200.0,0.0,2473903.290000004,2018,11,9,CHECK_WITHDRAWAL,9200.0,M1558246666
7033,409000493210',2018-11-09,Indiaforensic NFS SETT 07-11-201,9200.0,0.0,2464703.290000004,2018,11,9,CASH_OUT,9200.0,M1666456788
7034,409000493210',2018-11-09,Indiaforensic NFS SETT 07-11-201,100.0,0.0,2464603.290000004,2018,11,9,DEBIT,100.0,M2046967348
7035,409000493210',2018-11-09,Indiaforensic NFS SETT 07-11-201,9300.0,0.0,2455303.290000004,2018,11,9,DEBIT,9300.0,M1711152967
7036,409000493210',2018-11-09,Indiaforensic NFS SETT 07-11-201,100.0,0.0,2455203.290000004,2018,11,9,DEBIT,100.0,C1487669283
7037,409000493210',2018-11-09,Indiaforensic NFS SETT 07-11-201,9500.0,0.0,2445703.290000004,2018,11,9,PAYEMENT,9500.0,C681835572
7038,409000493210',2018-11-09,Indiaforensic NFS SETT 07-11-201,9000.0,0.0,2436703.290000004,2018,11,9,CHECK_WITHDRAWAL,9000.0,M1787476367
7039,409000493210',2018-11-09,Indiaforensic NFS SETT 07-11-201,5000.0,0.0,2431703.290000004,2018,11,9,CASH_OUT,5000.0,M1117642317
7040,409000493210',2018-11-09,Indiaforensic NFS SETT 07-11-201,1000.0,0.0,2430703.290000004,2018,11,9,DEBIT,1000.0,C1206868531
7041,409000493210',2018-11-09,Indiaforensic NFS SETT 07-11-201,5000.0,0.0,2425703.290000004,2018,11,9,PAYEMENT,5000.0,M128026509
7042,409000493210',2018-11-09,Indiaforensic NFS SETT 07-11-201,8400.0,0.0,2417303.290000004,2018,11,9,CASH_OUT,8400.0,C1479450980
7043,409000493210',2018-11-09,Indiaforensic NFS SETT 07-11-201,8400.0,0.0,2408903.290000004,2018,11,9,CHECK_WITHDRAWAL,8400.0,M1488129598
7044,409000493210',2018-11-09,Indiaforensic NFS SETT 07-11-201,4000.0,0.0,2404903.290000004,2018,11,9,DEBIT,4000.0,M1779082722
7045,409000493210',2018-11-09,Indiaforensic NFS SETT 07-11-201,1000.0,0.0,2403903.290000004,2018,11,9,PAYEMENT,1000.0,M596243782
7046,409000493210',2018-11-09,Indiaforensic NFS SETT 07-11-201,6000.0,0.0,2397903.290000004,2018,11,9,PAYEMENT,6000.0,M1685344880
7047,409000493210',2018-11-09,Indiaforensic NFS SETT 07-11-201,5500.0,0.0,2392403.290000004,2018,11,9,DEBIT,5500.0,C508000580
7048,409000493210',2018-11-09,Indiaforensic NFS SETT 07-11-201,7500.0,0.0,2384903.290000004,2018,11,9,PAYEMENT,7500.0,M413880637
7049,409000493210',2018-11-09,Indiaforensic NFS SETT 07-11-201,300.0,0.0,2384603.290000004,2018,11,9,CASH_OUT,300.0,C365212068
7050,409000493210',2018-11-09,Indiaforensic NFS SETT 07-11-201,400.0,0.0,2384203.290000004,2018,11,9,CHECK_WITHDRAWAL,400.0,M1295769221
7051,409000493210',2018-11-09,Indiaforensic NFS SETT 07-11-201,200.0,0.0,2384003.290000004,2018,11,9,PAYEMENT,200.0,M39898352
7052,409000493210',2018-11-09,Indiaforensic NFS SETT 07-11-201,4500.0,0.0,2379503.290000004,2018,11,9,CASH_OUT,4500.0,M909773218
7053,409000493210',2018-11-09,Indiaforensic NFS SETT 07-11-201,9000.0,0.0,2370503.290000004,2018,11,9,PAYEMENT,9000.0,M1733433977
7054,409000493210',2018-11-09,Indiaforensic NFS SETT 07-11-201,9000.0,0.0,2361503.290000004,2018,11,9,DEBIT,9000.0,M353562601
7055,409000493210',2018-11-09,Indiaforensic NFS SETT 07-11-201,5000.0,0.0,2356503.290000004,2018,11,9,PAYEMENT,5000.0,M196196466
7056,409000493210',2018-11-09,Indiaforensic NFS SETT 07-11-201,5000.0,0.0,2351503.290000004,2018,11,9,CASH_OUT,5000.0,M1724619363
7057,409000493210',2018-11-09,Indiaforensic NFS SETT 07-11-201,1000.0,0.0,2350503.290000004,2018,11,9,PAYEMENT,1000.0,M588890592
7058,409000493210',2018-11-09,Indiaforensic NFS SETT 07-11-201,4000.0,0.0,2346503.290000004,2018,11,9,DEBIT,4000.0,M1597802092
7059,409000493210',2018-11-09,Indiaforensic NFS SETT 07-11-201,4000.0,0.0,2342503.290000004,2018,11,9,PAYEMENT,4000.0,M2073782870
7060,409000493210',2018-11-09,Indiaforensic NFS SETT 07-11-201,8500.0,0.0,2334003.290000004,2018,11,9,DEBIT,8500.0,M1436937891
7061,409000493210',2018-11-09,Indiaforensic NFS SETT 08-11-201,500.0,0.0,2333503.290000004,2018,11,9,DEBIT,500.0,M1715635474
7062,409000493210',2018-11-09,Indiaforensic NFS SETT 08-11-201,4000.0,0.0,2329503.290000004,2018,11,9,CHECK_WITHDRAWAL,4000.0,M2051550010
7063,409000493210',2018-11-09,Indiaforensic NFS SETT 08-11-201,500.0,0.0,2329003.290000004,2018,11,9,DEBIT,500.0,M311642344
7064,409000493210',2018-11-09,Indiaforensic NFS SETT 08-11-201,10000.0,0.0,2319003.290000004,2018,11,9,CASH_OUT,10000.0,M966802636
7065,409000493210',2018-11-09,Indiaforensic NFS SETT 08-11-201,10000.0,0.0,2309003.290000004,2018,11,9,DEBIT,10000.0,C758991444
7066,409000493210',2018-11-09,Indiaforensic NFS SETT 08-11-201,4000.0,0.0,2305003.290000004,2018,11,9,CASH_OUT,4000.0,M1551722332
7067,409000493210',2018-11-09,Indiaforensic NFS SETT 08-11-201,9000.0,0.0,2296003.290000004,2018,11,9,PAYEMENT,9000.0,M159504850
7068,409000493210',2018-11-09,Indiaforensic NFS SETT 08-11-201,9000.0,0.0,2287003.290000004,2018,11,9,CASH_OUT,9000.0,C1464984894
7069,409000493210',2018-11-09,Indiaforensic NFS SETT 08-11-201,8000.0,0.0,2279003.290000004,2018,11,9,DEBIT,8000.0,C191614132
7070,409000493210',2018-11-09,Indiaforensic NFS SETT 08-11-201,10000.0,0.0,2269003.290000004,2018,11,9,DEBIT,10000.0,C798678484
7071,409000493210',2018-11-09,Indiaforensic NFS SETT 08-11-201,2500.0,0.0,2266503.290000004,2018,11,9,PAYEMENT,2500.0,C1260651126
7072,409000493210',2018-11-09,Indiaforensic NFS SETT 08-11-201,200.0,0.0,2266303.290000004,2018,11,9,DEBIT,200.0,C909295153
7073,409000493210',2018-11-09,Indiaforensic NFS SETT 08-11-201,2000.0,0.0,2264303.290000004,2018,11,9,DEBIT,2000.0,C1632716597
7074,409000493210',2018-11-09,Indiaforensic NFS SETT 08-11-201,1000.0,0.0,2263303.290000004,2018,11,9,DEBIT,1000.0,C18996450
7075,409000493210',2018-11-09,Indiaforensic NFS SETT 08-11-201,100.0,0.0,2263203.290000004,2018,11,9,CASH_OUT,100.0,C1816757085
7076,409000493210',2018-11-09,Indiaforensic NFS SETT 08-11-201,9000.0,0.0,2254203.290000004,2018,11,9,CHECK_WITHDRAWAL,9000.0,C985934102
7077,409000493210',2018-11-09,Indiaforensic NFS SETT 08-11-201,8000.0,0.0,2246203.290000004,2018,11,9,CHECK_WITHDRAWAL,8000.0,C510382951
7078,409000493210',2018-11-09,Indiaforensic NFS SETT 08-11-201,800.0,0.0,2245403.290000004,2018,11,9,CASH_OUT,800.0,C798678484
7079,409000493210',2018-11-09,Indiaforensic NFS SETT 08-11-201,10000.0,0.0,2235403.290000004,2018,11,9,CHECK_WITHDRAWAL,10000.0,C1529639302
7080,409000493210',2018-11-09,Indiaforensic NFS SETT 08-11-201,5000.0,0.0,2230403.290000004,2018,11,9,DEBIT,5000.0,C1450133081
7081,409000493210',2018-11-09,Indiaforensic NFS SETT 08-11-201,8000.0,0.0,2222403.290000004,2018,11,9,DEBIT,8000.0,C1281580764
7082,409000493210',2018-11-09,Indiaforensic NFS SETT 08-11-201,2000.0,0.0,2220403.290000004,2018,11,9,CHECK_WITHDRAWAL,2000.0,C2012808675
7083,409000493210',2018-11-09,Indiaforensic NFS SETT 08-11-201,300.0,0.0,2220103.290000004,2018,11,9,CHECK_WITHDRAWAL,300.0,C503195940
7084,409000493210',2018-11-09,Indiaforensic NFS SETT 08-11-201,3000.0,0.0,2217103.290000004,2018,11,9,PAYEMENT,3000.0,C1529639302
7085,409000493210',2018-11-09,Indiaforensic NFS SETT 08-11-201,1000.0,0.0,2216103.290000004,2018,11,9,PAYEMENT,1000.0,C128846374
7086,409000493210',2018-11-09,Indiaforensic NFS SETT 08-11-201,9000.0,0.0,2207103.290000004,2018,11,9,PAYEMENT,9000.0,C638590716
7087,409000493210',2018-11-09,Indiaforensic NFS SETT 08-11-201,4500.0,0.0,2202603.290000004,2018,11,9,DEBIT,4500.0,C265108079
7088,409000493210',2018-11-09,Indiaforensic NFS SETT 08-11-201,7500.0,0.0,2195103.290000004,2018,11,9,CASH_OUT,7500.0,C598551831
7089,409000493210',2018-11-09,Indiaforensic NFS SETT 08-11-201,2000.0,0.0,2193103.290000004,2018,11,9,PAYEMENT,2000.0,C1487669283
7090,409000493210',2018-11-09,Indiaforensic NFS SETT 08-11-201,9500.0,0.0,2183603.290000004,2018,11,9,CHECK_WITHDRAWAL,9500.0,C932583850
7091,409000493210',2018-11-09,Indiaforensic NFS SETT 08-11-201,9500.0,0.0,2174103.290000004,2018,11,9,DEBIT,9500.0,C668345982
7092,409000493210',2018-11-09,Indiaforensic NFS SETT 08-11-201,8500.0,0.0,2165603.290000004,2018,11,9,PAYEMENT,8500.0,C16344660
7093,409000493210',2018-11-09,Indiaforensic NFS SETT 02-11-201,6000.0,0.0,2159603.290000004,2018,11,9,CHECK_WITHDRAWAL,6000.0,C1255024717
7094,409000493210',2018-11-09,Indiaforensic NFS SETT 02-11-201,400.0,0.0,2159203.290000004,2018,11,9,CASH_OUT,400.0,C787033725
7095,409000493210',2018-11-09,Indiaforensic NFS SETT 02-11-201,5500.0,0.0,2153703.290000004,2018,11,9,PAYEMENT,5500.0,C392226440
7096,409000493210',2018-11-12,Indiaforensic RUPAY SETT 101118,6235.88,0.0,2147467.410000003,2018,11,12,PAYEMENT,6235.88,C424743902
7097,409000493210',2018-11-12,Indiaforensic RUPAY STL INTC1011,53.69,0.0,2147413.720000003,2018,11,12,CASH_OUT,53.69,C1137422246
7098,409000493210',2018-11-12,Indiaforensic RUPAY SETT 111118,36482.28,0.0,2110931.440000003,2018,11,12,PAYEMENT,36482.28,C1694262384
7099,409000493210',2018-11-12,Indiaforensic RUPAY STL INTC1111,355.29,0.0,2110576.150000003,2018,11,12,DEBIT,355.29,C1121686878
7100,409000493210',2018-11-12,Indiaforensic RUPAY SETT 121118,12760.55,0.0,2097815.6000000043,2018,11,12,PAYEMENT,12760.55,C769342184
7101,409000493210',2018-11-12,Indiaforensic RUPAY STL INTC1211,106.52,0.0,2097709.0800000043,2018,11,12,PAYEMENT,106.52,C1467806809
7102,409000493210',2018-11-12,Indiaforensic RUPAY SETT 101118,0.0,378.11,2098087.190000003,2018,11,12,CASH_IN,378.11,C11003494
7103,409000493210',2018-11-12,Indiaforensic RUPAY STL INTC1011,0.0,2.39,2098089.5800000043,2018,11,12,CASH_IN,2.39,C1254526270
7104,409000493210',2018-11-12,Indiaforensic RUPAY SETT 111118,0.0,355.29,2098444.870000004,2018,11,12,CASH_IN,355.29,C1975607158
7105,409000493210',2018-11-12,Indiaforensic RUPAY SETT 121118,0.0,124.52,2098569.390000004,2018,11,12,CHECK_CASHING,124.52,C323287038
7106,409000493210',2018-11-12,Indiaforensic RUPAY STL INTC1211,0.0,0.14,2098569.5300000035,2018,11,12,CHECK_CASHING,0.14,C71555810
7107,409000493210',2018-11-12,Indiaforensic RUPAY SETT 121118-,421.92,0.0,2098147.610000004,2018,11,12,DEBIT,421.92,C1321128627
7108,409000493210',2018-11-12,Indiaforensic RUPAY SETT 121118-,0.0,4.13,2098151.740000004,2018,11,12,TRANSFER,4.13,C1496102000
7109,409000493210',2018-11-12,Indiaforensic RUPAY STL INTC1211,4.13,0.0,2098147.610000004,2018,11,12,PAYEMENT,4.13,C842984696
7110,409000493210',2018-11-12,TRF FROM  Indiaforensic SERVICES,0.0,800000.0,2898147.6100000036,2018,11,12,TRANSFER,800000.0,C715819458
7111,409000493210',2018-11-13,Indiaforensic  RUPAY SETT 131118,72509.33,0.0,2825638.2800000035,2018,11,13,DEBIT,72509.33,C1697258007
7112,409000493210',2018-11-13,Indiaforensic  RUPAY SETT 131118,0.0,631.0,2826269.2800000035,2018,11,13,TRANSFER,631.0,C409821235
7113,409000493210',2018-11-13,Indiaforensic RUPAY STL INTC1311,587.44,0.0,2825681.8400000036,2018,11,13,DEBIT,587.44,C1880332929
7114,409000493210',2018-11-13,Indiaforensic RUPAY STL INTC1311,0.0,0.28,2825682.120000004,2018,11,13,CASH_IN,0.28,C1446521801
7115,409000493210',2018-11-13,Indiaforensic NFS SETT 09-11-201,3000.0,0.0,2822682.120000004,2018,11,13,PAYEMENT,3000.0,C157316544
7116,409000493210',2018-11-13,Indiaforensic NFS SETT 09-11-201,4000.0,0.0,2818682.120000004,2018,11,13,PAYEMENT,4000.0,C1329589315
7117,409000493210',2018-11-13,Indiaforensic NFS SETT 09-11-201,800.0,0.0,2817882.120000004,2018,11,13,DEBIT,800.0,C125722707
7118,409000493210',2018-11-13,Indiaforensic NFS SETT 09-11-201,10000.0,0.0,2807882.120000004,2018,11,13,CASH_OUT,10000.0,C1746150957
7119,409000493210',2018-11-13,Indiaforensic NFS SETT 09-11-201,5000.0,0.0,2802882.120000004,2018,11,13,CHECK_WITHDRAWAL,5000.0,C1538745405
7120,409000493210',2018-11-13,Indiaforensic NFS SETT 09-11-201,8000.0,0.0,2794882.120000004,2018,11,13,CHECK_WITHDRAWAL,8000.0,C1360767589
7121,409000493210',2018-11-13,Indiaforensic NFS SETT 09-11-201,3000.0,0.0,2791882.120000004,2018,11,13,PAYEMENT,3000.0,C1883840933
7122,409000493210',2018-11-13,Indiaforensic NFS SETT 09-11-201,200.0,0.0,2791682.120000004,2018,11,13,CASH_OUT,200.0,C1951379728
7123,409000493210',2018-11-13,Indiaforensic NFS SETT 09-11-201,900.0,0.0,2790782.120000004,2018,11,13,PAYEMENT,900.0,C985934102
7124,409000493210',2018-11-13,Indiaforensic NFS SETT 09-11-201,3000.0,0.0,2787782.120000004,2018,11,13,PAYEMENT,3000.0,C300836639
7125,409000493210',2018-11-13,Indiaforensic NFS SETT 09-11-201,5000.0,0.0,2782782.120000004,2018,11,13,CASH_OUT,5000.0,C1838584624
7126,409000493210',2018-11-13,Indiaforensic NFS SETT 09-11-201,2000.0,0.0,2780782.120000004,2018,11,13,CHECK_WITHDRAWAL,2000.0,C1496102000
7127,409000493210',2018-11-13,Indiaforensic NFS SETT 09-11-201,1000.0,0.0,2779782.120000004,2018,11,13,PAYEMENT,1000.0,C1515704208
7128,409000493210',2018-11-13,Indiaforensic NFS SETT 09-11-201,500.0,0.0,2779282.120000004,2018,11,13,CASH_OUT,500.0,C347725669
7129,409000493210',2018-11-13,Indiaforensic NFS SETT 09-11-201,1000.0,0.0,2778282.120000004,2018,11,13,DEBIT,1000.0,C2066777507
7130,409000493210',2018-11-13,Indiaforensic NFS SETT 09-11-201,10000.0,0.0,2768282.120000004,2018,11,13,CHECK_WITHDRAWAL,10000.0,M1058885327
7131,409000493210',2018-11-13,Indiaforensic NFS SETT 09-11-201,5000.0,0.0,2763282.120000004,2018,11,13,DEBIT,5000.0,M1314113263
7132,409000493210',2018-11-13,Indiaforensic NFS SETT 09-11-201,5000.0,0.0,2758282.120000004,2018,11,13,DEBIT,5000.0,C343534938
7133,409000493210',2018-11-13,Indiaforensic NFS SETT 09-11-201,9500.0,0.0,2748782.120000004,2018,11,13,CASH_OUT,9500.0,M157567214
7134,409000493210',2018-11-13,Indiaforensic NFS SETT 09-11-201,9000.0,0.0,2739782.120000004,2018,11,13,DEBIT,9000.0,M493732536
7135,409000493210',2018-11-13,Indiaforensic NFS SETT 10-11-201,5000.0,0.0,2734782.120000004,2018,11,13,PAYEMENT,5000.0,M1439651366
7136,409000493210',2018-11-13,Indiaforensic NFS SETT 10-11-201,10000.0,0.0,2724782.120000004,2018,11,13,PAYEMENT,10000.0,M2069229734
7137,409000493210',2018-11-13,Indiaforensic NFS SETT 10-11-201,1000.0,0.0,2723782.120000004,2018,11,13,CHECK_WITHDRAWAL,1000.0,M269923406
7138,409000493210',2018-11-13,Indiaforensic NFS SETT 10-11-201,500.0,0.0,2723282.120000004,2018,11,13,CASH_OUT,500.0,M954764819
7139,409000493210',2018-11-13,Indiaforensic NFS SETT 10-11-201,8000.0,0.0,2715282.120000004,2018,11,13,CHECK_WITHDRAWAL,8000.0,M535002407
7140,409000493210',2018-11-13,Indiaforensic NFS SETT 10-11-201,100.0,0.0,2715182.120000004,2018,11,13,CHECK_WITHDRAWAL,100.0,M1811698326
7141,409000493210',2018-11-13,Indiaforensic NFS SETT 10-11-201,10000.0,0.0,2705182.120000004,2018,11,13,DEBIT,10000.0,M1165836116
7142,409000493210',2018-11-13,Indiaforensic NFS SETT 10-11-201,5000.0,0.0,2700182.120000004,2018,11,13,PAYEMENT,5000.0,M497424937
7143,409000493210',2018-11-13,Indiaforensic NFS SETT 10-11-201,1000.0,0.0,2699182.120000004,2018,11,13,CHECK_WITHDRAWAL,1000.0,M1801753119
7144,409000493210',2018-11-13,Indiaforensic NFS SETT 10-11-201,1500.0,0.0,2697682.120000004,2018,11,13,PAYEMENT,1500.0,M1850169748
7145,409000493210',2018-11-13,Indiaforensic NFS SETT 10-11-201,5000.0,0.0,2692682.120000004,2018,11,13,CASH_OUT,5000.0,M446264394
7146,409000493210',2018-11-13,Indiaforensic NFS SETT 10-11-201,2000.0,0.0,2690682.120000004,2018,11,13,CASH_OUT,2000.0,M1725382189
7147,409000493210',2018-11-13,Indiaforensic NFS SETT 10-11-201,5000.0,0.0,2685682.120000004,2018,11,13,DEBIT,5000.0,M1977202492
7148,409000493210',2018-11-13,Indiaforensic NFS SETT 10-11-201,4000.0,0.0,2681682.120000004,2018,11,13,CASH_OUT,4000.0,C1047634424
7149,409000493210',2018-11-13,Indiaforensic NFS SETT 10-11-201,1000.0,0.0,2680682.120000004,2018,11,13,DEBIT,1000.0,M1675886984
7150,409000493210',2018-11-13,Indiaforensic NFS SETT 10-11-201,10000.0,0.0,2670682.120000004,2018,11,13,CASH_OUT,10000.0,M1398492607
7151,409000493210',2018-11-13,Indiaforensic NFS SETT 10-11-201,3000.0,0.0,2667682.120000004,2018,11,13,CASH_OUT,3000.0,M209501229
7152,409000493210',2018-11-13,Indiaforensic NFS SETT 10-11-201,5000.0,0.0,2662682.120000004,2018,11,13,DEBIT,5000.0,M1066504752
7153,409000493210',2018-11-13,Indiaforensic NFS SETT 10-11-201,4000.0,0.0,2658682.120000004,2018,11,13,CHECK_WITHDRAWAL,4000.0,M556080707
7154,409000493210',2018-11-13,Indiaforensic NFS SETT 10-11-201,400.0,0.0,2658282.120000004,2018,11,13,CASH_OUT,400.0,C12793273
7155,409000493210',2018-11-13,Indiaforensic NFS SETT 10-11-201,5500.0,0.0,2652782.120000004,2018,11,13,PAYEMENT,5500.0,C1438594533
7156,409000493210',2018-11-13,Indiaforensic NFS SETT 11-11-201,10000.0,0.0,2642782.120000004,2018,11,13,CASH_OUT,10000.0,M528042460
7157,409000493210',2018-11-13,Indiaforensic NFS SETT 11-11-201,100.0,0.0,2642682.120000004,2018,11,13,CASH_OUT,100.0,M882371818
7158,409000493210',2018-11-13,Indiaforensic NFS SETT 11-11-201,5000.0,0.0,2637682.120000004,2018,11,13,PAYEMENT,5000.0,M1261105387
7159,409000493210',2018-11-13,Indiaforensic NFS SETT 11-11-201,1000.0,0.0,2636682.120000004,2018,11,13,DEBIT,1000.0,C1651945012
7160,409000493210',2018-11-13,Indiaforensic NFS SETT 11-11-201,3000.0,0.0,2633682.120000004,2018,11,13,DEBIT,3000.0,M809960622
7161,409000493210',2018-11-13,Indiaforensic NFS SETT 11-11-201,10000.0,0.0,2623682.120000004,2018,11,13,DEBIT,10000.0,C1428469551
7162,409000493210',2018-11-13,Indiaforensic NFS SETT 11-11-201,5000.0,0.0,2618682.120000004,2018,11,13,CASH_OUT,5000.0,M2111326114
7163,409000493210',2018-11-13,Indiaforensic NFS SETT 11-11-201,5000.0,0.0,2613682.120000004,2018,11,13,DEBIT,5000.0,M1776760511
7164,409000493210',2018-11-13,Indiaforensic NFS SETT 11-11-201,6000.0,0.0,2607682.120000004,2018,11,13,PAYEMENT,6000.0,M1413117445
7165,409000493210',2018-11-13,Indiaforensic NFS SETT 11-11-201,9000.0,0.0,2598682.120000004,2018,11,13,CHECK_WITHDRAWAL,9000.0,M1671164933
7166,409000493210',2018-11-13,Indiaforensic NFS SETT 11-11-201,8000.0,0.0,2590682.120000004,2018,11,13,PAYEMENT,8000.0,C271588719
7167,409000493210',2018-11-13,Indiaforensic NFS SETT 11-11-201,10000.0,0.0,2580682.120000004,2018,11,13,CHECK_WITHDRAWAL,10000.0,C1213485528
7168,409000493210',2018-11-13,Indiaforensic NFS SETT 11-11-201,900.0,0.0,2579782.120000004,2018,11,13,CASH_OUT,900.0,M1304522697
7169,409000493210',2018-11-13,Indiaforensic NFS SETT 11-11-201,5000.0,0.0,2574782.120000004,2018,11,13,DEBIT,5000.0,M612958241
7170,409000493210',2018-11-13,Indiaforensic NFS SETT 11-11-201,7500.0,0.0,2567282.120000004,2018,11,13,CASH_OUT,7500.0,M658645383
7171,409000493210',2018-11-13,Indiaforensic NFS SETT 11-11-201,2000.0,0.0,2565282.120000004,2018,11,13,CHECK_WITHDRAWAL,2000.0,M518072030
7172,409000493210',2018-11-13,Indiaforensic NFS SETT 11-11-201,5000.0,0.0,2560282.120000004,2018,11,13,CASH_OUT,5000.0,M347386462
7173,409000493210',2018-11-13,Indiaforensic NFS SETT 11-11-201,8000.0,0.0,2552282.120000004,2018,11,13,CASH_OUT,8000.0,C400720732
7174,409000493210',2018-11-13,Indiaforensic  RUPAY SETT 131118,5367.96,0.0,2546914.160000004,2018,11,13,DEBIT,5367.96,M435030575
7175,409000493210',2018-11-13,Indiaforensic RUPAY STL INTC1311,61.31,0.0,2546852.8500000043,2018,11,13,DEBIT,61.31,C2072865894
7176,409000493210',2018-11-13,Indiaforensic  RUPAY SETT 131118,0.0,61.31,2546914.160000004,2018,11,13,CASH_IN,61.31,M1072499716
7177,409000493210',2018-11-14,Indiaforensic RUPAY SETT 141118,12707.77,0.0,2534206.390000004,2018,11,14,PAYEMENT,12707.77,M894025840
7178,409000493210',2018-11-14,Indiaforensic RUPAY SETT 141118,0.0,132.66,2534339.0500000035,2018,11,14,CASH_IN,132.66,M1946618260
7179,409000493210',2018-11-14,Indiaforensic RUPAY STL INTC1411,109.11,0.0,2534229.940000004,2018,11,14,CASH_OUT,109.11,M120617702
7180,409000493210',2018-11-14,Indiaforensic RUPAY STL INTC1411,0.0,0.18,2534230.120000004,2018,11,14,CHECK_CASHING,0.18,C675203915
7181,409000493210',2018-11-14,FDRL/INTERNAL FUND TRANSFE,0.0,50000.0,2584230.120000004,2018,11,14,CHECK_CASHING,50000.0,M1917717111
7182,409000493210',2018-11-14,FDRL/INTERNAL FUND TRANSFE,0.0,50000.0,2634230.120000004,2018,11,14,CHECK_CASHING,50000.0,C863811613
7183,409000493210',2018-11-14,FDRL/INTERNAL FUND TRANSFE,0.0,50000.0,2684230.120000004,2018,11,14,TRANSFER,50000.0,M92350773
7184,409000493210',2018-11-14,FDRL/INTERNAL FUND TRANSFE,0.0,50000.0,2734230.120000004,2018,11,14,TRANSFER,50000.0,C347725669
7185,409000493210',2018-11-14,FDRL/INTERNAL FUND TRANSFE,0.0,50000.0,2784230.120000004,2018,11,14,CASH_IN,50000.0,M628502276
7186,409000493210',2018-11-14,FDRL/INTERNAL FUND TRANSFE,0.0,50000.0,2834230.120000004,2018,11,14,CHECK_CASHING,50000.0,M1517112814
7187,409000493210',2018-11-14,Indiaforensic NFS SETT 12-11-201,2100.0,0.0,2832130.120000004,2018,11,14,CHECK_WITHDRAWAL,2100.0,M1885192614
7188,409000493210',2018-11-14,Indiaforensic NFS SETT 12-11-201,1000.0,0.0,2831130.120000004,2018,11,14,CHECK_WITHDRAWAL,1000.0,M2063059370
7189,409000493210',2018-11-14,Indiaforensic NFS SETT 12-11-201,3500.0,0.0,2827630.120000004,2018,11,14,PAYEMENT,3500.0,C1095575585
7190,409000493210',2018-11-14,Indiaforensic NFS SETT 12-11-201,10000.0,0.0,2817630.120000004,2018,11,14,PAYEMENT,10000.0,C801142660
7191,409000493210',2018-11-14,Indiaforensic NFS SETT 12-11-201,3500.0,0.0,2814130.120000004,2018,11,14,CHECK_WITHDRAWAL,3500.0,M534955437
7192,409000493210',2018-11-14,Indiaforensic NFS SETT 12-11-201,8000.0,0.0,2806130.120000004,2018,11,14,CASH_OUT,8000.0,C237988421
7193,409000493210',2018-11-14,Indiaforensic NFS SETT 12-11-201,1000.0,0.0,2805130.120000004,2018,11,14,CASH_OUT,1000.0,C1870436181
7194,409000493210',2018-11-14,Indiaforensic NFS SETT 12-11-201,6000.0,0.0,2799130.120000004,2018,11,14,PAYEMENT,6000.0,M1105475717
7195,409000493210',2018-11-14,Indiaforensic NFS SETT 12-11-201,3000.0,0.0,2796130.120000004,2018,11,14,DEBIT,3000.0,M423377692
7196,409000493210',2018-11-14,Indiaforensic NFS SETT 12-11-201,100.0,0.0,2796030.120000004,2018,11,14,DEBIT,100.0,M588801311
7197,409000493210',2018-11-14,Indiaforensic NFS SETT 12-11-201,300.0,0.0,2795730.120000004,2018,11,14,PAYEMENT,300.0,M1192809248
7198,409000493210',2018-11-14,Indiaforensic NFS SETT 12-11-201,3500.0,0.0,2792230.120000004,2018,11,14,CHECK_WITHDRAWAL,3500.0,C83980058
7199,409000493210',2018-11-14,Indiaforensic NFS SETT 12-11-201,4000.0,0.0,2788230.120000004,2018,11,14,CASH_OUT,4000.0,C1457383927
7200,409000493210',2018-11-14,Indiaforensic NFS SETT 12-11-201,200.0,0.0,2788030.120000004,2018,11,14,CHECK_WITHDRAWAL,200.0,C1477979030
7201,409000493210',2018-11-14,Indiaforensic NFS SETT 12-11-201,3000.0,0.0,2785030.120000004,2018,11,14,DEBIT,3000.0,C1262822392
7202,409000493210',2018-11-14,Indiaforensic NFS SETT 12-11-201,10000.0,0.0,2775030.120000004,2018,11,14,PAYEMENT,10000.0,C1335946878
7203,409000493210',2018-11-14,Indiaforensic  RUPAY SETT 141118,14512.52,0.0,2760517.6000000043,2018,11,14,PAYEMENT,14512.52,C40075281
7204,409000493210',2018-11-14,Indiaforensic  RUPAY SETT 141118,0.0,325.66,2760843.260000004,2018,11,14,TRANSFER,325.66,C9108707
7205,409000493210',2018-11-14,Indiaforensic RUPAY STL INTC1411,133.88,0.0,2760709.380000004,2018,11,14,CASH_OUT,133.88,C1733439693
7206,409000493210',2018-11-14,Indiaforensic RUPAY STL INTC1411,0.0,1.44,2760710.820000004,2018,11,14,CASH_IN,1.44,C2110335494
7207,409000493210',2018-11-14,Indiaforensic NFS SETT 13-11-201,1000.0,0.0,2759710.820000004,2018,11,14,DEBIT,1000.0,M877809987
7208,409000493210',2018-11-14,Indiaforensic NFS SETT 13-11-201,1000.0,0.0,2758710.820000004,2018,11,14,DEBIT,1000.0,C861958315
7209,409000493210',2018-11-14,Indiaforensic NFS SETT 13-11-201,2000.0,0.0,2756710.820000004,2018,11,14,PAYEMENT,2000.0,M438448733
7210,409000493210',2018-11-14,Indiaforensic NFS SETT 13-11-201,700.0,0.0,2756010.820000004,2018,11,14,DEBIT,700.0,M1600734767
7211,409000493210',2018-11-14,Indiaforensic NFS SETT 13-11-201,10000.0,0.0,2746010.820000004,2018,11,14,DEBIT,10000.0,M252297858
7212,409000493210',2018-11-14,Indiaforensic NFS SETT 13-11-201,8000.0,0.0,2738010.820000004,2018,11,14,CHECK_WITHDRAWAL,8000.0,M1128352648
7213,409000493210',2018-11-14,Indiaforensic NFS SETT 13-11-201,300.0,0.0,2737710.820000004,2018,11,14,CASH_OUT,300.0,M335204551
7214,409000493210',2018-11-14,Indiaforensic NFS SETT 13-11-201,500.0,0.0,2737210.820000004,2018,11,14,DEBIT,500.0,M1831833867
7215,409000493210',2018-11-14,Indiaforensic NFS SETT 13-11-201,300.0,0.0,2736910.820000004,2018,11,14,CHECK_WITHDRAWAL,300.0,M1249676471
7216,409000493210',2018-11-14,Indiaforensic NFS SETT 13-11-201,5700.0,0.0,2731210.820000004,2018,11,14,CASH_OUT,5700.0,M592520538
7217,409000493210',2018-11-14,Indiaforensic NFS SETT 13-11-201,10000.0,0.0,2721210.820000004,2018,11,14,CASH_OUT,10000.0,M709827525
7218,409000493210',2018-11-14,Indiaforensic NFS SETT 13-11-201,3000.0,0.0,2718210.820000004,2018,11,14,CHECK_WITHDRAWAL,3000.0,M144699459
7219,409000493210',2018-11-14,Indiaforensic NFS SETT 13-11-201,500.0,0.0,2717710.820000004,2018,11,14,CHECK_WITHDRAWAL,500.0,M525859363
7220,409000493210',2018-11-14,Indiaforensic NFS SETT 13-11-201,5000.0,0.0,2712710.820000004,2018,11,14,CHECK_WITHDRAWAL,5000.0,C911998047
7221,409000493210',2018-11-14,Indiaforensic NFS SETT 13-11-201,1000.0,0.0,2711710.820000004,2018,11,14,CHECK_WITHDRAWAL,1000.0,M1451732454
7222,409000493210',2018-11-14,Indiaforensic NFS SETT 13-11-201,300.0,0.0,2711410.820000004,2018,11,14,CASH_OUT,300.0,C1027296777
7223,409000493210',2018-11-14,Indiaforensic NFS SETT 13-11-201,2000.0,0.0,2709410.820000004,2018,11,14,DEBIT,2000.0,C715819458
7224,409000493210',2018-11-14,Indiaforensic NFS SETT 13-11-201,10000.0,0.0,2699410.820000004,2018,11,14,PAYEMENT,10000.0,C183354406
7225,409000493210',2018-11-14,Indiaforensic NFS SETT 13-11-201,2000.0,0.0,2697410.820000004,2018,11,14,CASH_OUT,2000.0,C214774813
7226,409000493210',2018-11-15,Indiaforensic  RUPAY SETT 151118,13144.15,0.0,2684266.670000004,2018,11,15,CHECK_WITHDRAWAL,13144.15,C803116137
7227,409000493210',2018-11-15,Indiaforensic  RUPAY SETT 151118,0.0,129.87,2684396.540000004,2018,11,15,CHECK_CASHING,129.87,C1299829127
7228,409000493210',2018-11-15,Indiaforensic RUPAY STL INTC1511,127.58,0.0,2684268.960000004,2018,11,15,PAYEMENT,127.58,C1022023283
7229,409000493210',2018-11-15,Indiaforensic RUPAY STL INTC1511,0.0,0.01,2684268.970000004,2018,11,15,CASH_IN,0.01,C1870367457
7230,409000493210',2018-11-15,Indiaforensic NFS SETT 14-11-201,500.0,0.0,2683768.970000004,2018,11,15,DEBIT,500.0,C237988421
7231,409000493210',2018-11-15,Indiaforensic NFS SETT 14-11-201,5000.0,0.0,2678768.970000004,2018,11,15,DEBIT,5000.0,C1281580764
7232,409000493210',2018-11-15,Indiaforensic NFS SETT 14-11-201,100.0,0.0,2678668.970000004,2018,11,15,PAYEMENT,100.0,C1674899618
7233,409000493210',2018-11-15,Indiaforensic NFS SETT 14-11-201,2500.0,0.0,2676168.970000004,2018,11,15,DEBIT,2500.0,C1706891711
7234,409000493210',2018-11-15,Indiaforensic NFS SETT 14-11-201,400.0,0.0,2675768.970000004,2018,11,15,DEBIT,400.0,C1852606548
7235,409000493210',2018-11-15,Indiaforensic NFS SETT 14-11-201,3000.0,0.0,2672768.970000004,2018,11,15,CASH_OUT,3000.0,C1346667529
7236,409000493210',2018-11-15,Indiaforensic NFS SETT 14-11-201,5000.0,0.0,2667768.970000004,2018,11,15,CHECK_WITHDRAWAL,5000.0,C2046611860
7237,409000493210',2018-11-15,Indiaforensic NFS SETT 14-11-201,9500.0,0.0,2658268.970000004,2018,11,15,CASH_OUT,9500.0,C1339257929
7238,409000493210',2018-11-15,Indiaforensic NFS SETT 14-11-201,10000.0,0.0,2648268.970000004,2018,11,15,CASH_OUT,10000.0,C1211317010
7239,409000493210',2018-11-15,Indiaforensic NFS SETT 14-11-201,8500.0,0.0,2639768.970000004,2018,11,15,DEBIT,8500.0,C271588719
7240,409000493210',2018-11-15,Indiaforensic NFS SETT 14-11-201,2000.0,0.0,2637768.970000004,2018,11,15,PAYEMENT,2000.0,C1467806809
7241,409000493210',2018-11-15,Indiaforensic NFS SETT 14-11-201,100.0,0.0,2637668.970000004,2018,11,15,CHECK_WITHDRAWAL,100.0,C798678484
7242,409000493210',2018-11-15,Indiaforensic NFS SETT 14-11-201,4000.0,0.0,2633668.970000004,2018,11,15,DEBIT,4000.0,C560041895
7243,409000493210',2018-11-15,Indiaforensic NFS SETT 14-11-201,2500.0,0.0,2631168.970000004,2018,11,15,CASH_OUT,2500.0,C1380361139
7244,409000493210',2018-11-15,Indiaforensic NFS SETT 14-11-201,2000.0,0.0,2629168.970000004,2018,11,15,CHECK_WITHDRAWAL,2000.0,C170899621
7245,409000493210',2018-11-15,Indiaforensic NFS SETT 14-11-201,200.0,0.0,2628968.970000004,2018,11,15,PAYEMENT,200.0,C2101977504
7246,409000493210',2018-11-15,Indiaforensic NFS SETT 14-11-201,10000.0,0.0,2618968.970000004,2018,11,15,DEBIT,10000.0,C728885526
7247,409000493210',2018-11-15,Indiaforensic  RUPAY SETT 151118,237.79,0.0,2618731.180000004,2018,11,15,CHECK_WITHDRAWAL,237.79,C71555810
7248,409000493210',2018-11-15,Indiaforensic  RUPAY SETT 151118,0.0,56.71,2618787.890000004,2018,11,15,TRANSFER,56.71,C1816757085
7249,409000493210',2018-11-15,Indiaforensic RUPAY STL INTC1511,1.66,0.0,2618786.230000004,2018,11,15,PAYEMENT,1.66,C170899621
7250,409000493210',2018-11-15,Indiaforensic RUPAY STL INTC1511,0.0,0.41,2618786.640000004,2018,11,15,TRANSFER,0.41,C214774813
7251,409000493210',2018-11-16,Indiaforensic  RUPAY SETT 161118,17115.89,0.0,2601670.750000004,2018,11,16,CASH_OUT,17115.89,C803116137
7252,409000493210',2018-11-16,Indiaforensic  RUPAY SETT 161118,0.0,431.9,2602102.650000004,2018,11,16,CHECK_CASHING,431.9,C1423992712
7253,409000493210',2018-11-16,Indiaforensic RUPAY STL INTC1611,179.9,0.0,2601922.750000004,2018,11,16,DEBIT,179.9,C1922859107
7254,409000493210',2018-11-16,Indiaforensic RUPAY STL INTC1611,0.0,1.89,2601924.640000004,2018,11,16,CHECK_CASHING,1.89,C1255024717
7255,409000493210',2018-11-16,Indiaforensic RUPAY SETT 161118-,17712.91,0.0,2584211.730000004,2018,11,16,CHECK_WITHDRAWAL,17712.91,C194746285
7256,409000493210',2018-11-16,Indiaforensic RUPAY SETT 161118-,0.0,51.11,2584262.840000004,2018,11,16,TRANSFER,51.11,C1587143371
7257,409000493210',2018-11-16,Indiaforensic RUPAY STL INTC1611,51.11,0.0,2584211.730000004,2018,11,16,CHECK_WITHDRAWAL,51.11,C1880332929
7258,409000493210',2018-11-16,Indiaforensic NFS SETT 15-11-201,100.0,0.0,2584111.730000004,2018,11,16,PAYEMENT,100.0,C1141137903
7259,409000493210',2018-11-16,Indiaforensic NFS SETT 15-11-201,7000.0,0.0,2577111.730000004,2018,11,16,DEBIT,7000.0,C1237401293
7260,409000493210',2018-11-16,Indiaforensic NFS SETT 15-11-201,500.0,0.0,2576611.730000004,2018,11,16,DEBIT,500.0,C214774813
7261,409000493210',2018-11-16,Indiaforensic NFS SETT 15-11-201,200.0,0.0,2576411.730000004,2018,11,16,DEBIT,200.0,C1335946878
7262,409000493210',2018-11-16,Indiaforensic NFS SETT 15-11-201,200.0,0.0,2576211.730000004,2018,11,16,CHECK_WITHDRAWAL,200.0,C54617902
7263,409000493210',2018-11-16,Indiaforensic NFS SETT 15-11-201,10000.0,0.0,2566211.730000004,2018,11,16,CHECK_WITHDRAWAL,10000.0,C1334973394
7264,409000493210',2018-11-16,Indiaforensic NFS SETT 15-11-201,100.0,0.0,2566111.730000004,2018,11,16,PAYEMENT,100.0,C1494895909
7265,409000493210',2018-11-16,Indiaforensic NFS SETT 15-11-201,100.0,0.0,2566011.730000004,2018,11,16,CASH_OUT,100.0,C1317731757
7266,409000493210',2018-11-16,Indiaforensic NFS SETT 15-11-201,5000.0,0.0,2561011.730000004,2018,11,16,CHECK_WITHDRAWAL,5000.0,C458582664
7267,409000493210',2018-11-16,Indiaforensic NFS SETT 15-11-201,5000.0,0.0,2556011.730000004,2018,11,16,DEBIT,5000.0,M578555127
7268,409000493210',2018-11-16,Indiaforensic NFS SETT 15-11-201,500.0,0.0,2555511.730000004,2018,11,16,DEBIT,500.0,M1430674428
7269,409000493210',2018-11-16,Indiaforensic NFS SETT 15-11-201,4000.0,0.0,2551511.730000004,2018,11,16,PAYEMENT,4000.0,M1203500109
7270,409000493210',2018-11-16,Indiaforensic NFS SETT 15-11-201,7000.0,0.0,2544511.730000004,2018,11,16,CASH_OUT,7000.0,M1387774425
7271,409000493210',2018-11-16,Indiaforensic NFS SETT 15-11-201,7000.0,0.0,2537511.730000004,2018,11,16,CHECK_WITHDRAWAL,7000.0,M1562292756
7272,409000493210',2018-11-16,Indiaforensic NFS SETT 15-11-201,5000.0,0.0,2532511.730000004,2018,11,16,DEBIT,5000.0,C769342184
7273,409000493210',2018-11-16,Indiaforensic NFS SETT 15-11-201,400.0,0.0,2532111.730000004,2018,11,16,DEBIT,400.0,C560041895
7274,409000493210',2018-11-16,Indiaforensic NFS SETT 15-11-201,2000.0,0.0,2530111.730000004,2018,11,16,DEBIT,2000.0,C878506901
7275,409000493210',2018-11-16,Indiaforensic NFS SETT 15-11-201,10000.0,0.0,2520111.730000004,2018,11,16,CASH_OUT,10000.0,C1674899618
7276,409000493210',2018-11-17,Indiaforensic  RUPAY SETT 171118,23930.64,0.0,2496181.090000004,2018,11,17,CHECK_WITHDRAWAL,23930.64,C481402298
7277,409000493210',2018-11-17,Indiaforensic  RUPAY SETT 171118,0.0,230.66,2496411.750000004,2018,11,17,CHECK_CASHING,230.66,C1245442940
7278,409000493210',2018-11-17,Indiaforensic RUPAY STL INTC1711,230.66,0.0,2496181.090000004,2018,11,17,DEBIT,230.66,C1335946878
7279,409000493210',2018-11-17,Indiaforensic  RUPAY SETT 171118,0.01,0.0,2496181.0800000043,2018,11,17,DEBIT,0.01,C296121376
7280,409000493210',2018-11-17,Indiaforensic  RUPAY SETT 171118,0.0,1.5,2496182.5800000043,2018,11,17,CHECK_CASHING,1.5,C1850180796
7281,409000493210',2018-11-17,Indiaforensic RUPAY STL INTC1711,0.0,0.01,2496182.590000004,2018,11,17,CASH_IN,0.01,M778097908
7282,409000493210',2018-11-17,Indiaforensic NFS SETT 16-11-201,2000.0,0.0,2494182.590000004,2018,11,17,DEBIT,2000.0,M1173151026
7283,409000493210',2018-11-17,Indiaforensic NFS SETT 16-11-201,1500.0,0.0,2492682.590000004,2018,11,17,DEBIT,1500.0,M1759914811
7284,409000493210',2018-11-17,Indiaforensic NFS SETT 16-11-201,3000.0,0.0,2489682.590000004,2018,11,17,PAYEMENT,3000.0,M400867034
7285,409000493210',2018-11-17,Indiaforensic NFS SETT 16-11-201,300.0,0.0,2489382.590000004,2018,11,17,DEBIT,300.0,M1107476456
7286,409000493210',2018-11-17,Indiaforensic NFS SETT 16-11-201,3000.0,0.0,2486382.590000004,2018,11,17,CHECK_WITHDRAWAL,3000.0,M1405230085
7287,409000493210',2018-11-17,Indiaforensic NFS SETT 16-11-201,10000.0,0.0,2476382.590000004,2018,11,17,DEBIT,10000.0,M942829525
7288,409000493210',2018-11-17,Indiaforensic NFS SETT 16-11-201,9000.0,0.0,2467382.590000004,2018,11,17,CASH_OUT,9000.0,M153580963
7289,409000493210',2018-11-17,Indiaforensic NFS SETT 16-11-201,2000.0,0.0,2465382.590000004,2018,11,17,DEBIT,2000.0,M250977006
7290,409000493210',2018-11-19,Indiaforensic RUPAY SETT 181118,1213.14,0.0,2464169.450000004,2018,11,19,CASH_OUT,1213.14,C107095723
7291,409000493210',2018-11-19,Indiaforensic RUPAY STL INTC1811,9.22,0.0,2464160.2300000032,2018,11,19,PAYEMENT,9.22,M1890131314
7292,409000493210',2018-11-19,Indiaforensic RUPAY SETT 191118,55773.13,0.0,2408387.1000000043,2018,11,19,CHECK_WITHDRAWAL,55773.13,M1076721351
7293,409000493210',2018-11-19,Indiaforensic RUPAY SETT 181118,0.0,13.72,2408400.820000004,2018,11,19,TRANSFER,13.72,M534213125
7294,409000493210',2018-11-19,Indiaforensic RUPAY STL INTC1811,0.0,0.02,2408400.840000004,2018,11,19,TRANSFER,0.02,M680072609
7295,409000493210',2018-11-19,Indiaforensic RUPAY SETT 191118,0.0,391.2,2408792.040000004,2018,11,19,CHECK_CASHING,391.2,M1178969461
7296,409000493210',2018-11-19,Indiaforensic RUPAY STL INTC1911,391.2,0.0,2408400.840000004,2018,11,19,DEBIT,391.2,C176203926
7297,409000493210',2018-11-19,Indiaforensic NFS SETT 17-11-201,1000.0,0.0,2407400.840000004,2018,11,19,DEBIT,1000.0,C1096283470
7298,409000493210',2018-11-19,Indiaforensic NFS SETT 17-11-201,5000.0,0.0,2402400.840000004,2018,11,19,DEBIT,5000.0,C1883840933
7299,409000493210',2018-11-19,Indiaforensic NFS SETT 17-11-201,3000.0,0.0,2399400.840000004,2018,11,19,CASH_OUT,3000.0,M1173819240
7300,409000493210',2018-11-19,Indiaforensic NFS SETT 18-11-201,4000.0,0.0,2395400.840000004,2018,11,19,DEBIT,4000.0,C1850180796
7301,409000493210',2018-11-19,Indiaforensic NFS SETT 18-11-201,8000.0,0.0,2387400.840000004,2018,11,19,PAYEMENT,8000.0,M1442935412
7302,409000493210',2018-11-19,Indiaforensic NFS SETT 18-11-201,1000.0,0.0,2386400.840000004,2018,11,19,CHECK_WITHDRAWAL,1000.0,C296121376
7303,409000493210',2018-11-19,Indiaforensic NFS SETT 18-11-201,8000.0,0.0,2378400.840000004,2018,11,19,CHECK_WITHDRAWAL,8000.0,C1794607688
7304,409000493210',2018-11-19,Indiaforensic NFS SETT 18-11-201,10000.0,0.0,2368400.840000004,2018,11,19,CHECK_WITHDRAWAL,10000.0,M1277160809
7305,409000493210',2018-11-19,Indiaforensic NFS SETT 18-11-201,10000.0,0.0,2358400.840000004,2018,11,19,CHECK_WITHDRAWAL,10000.0,M747984007
7306,409000493210',2018-11-19,Indiaforensic NFS SETT 18-11-201,750.0,0.0,2357650.840000004,2018,11,19,DEBIT,750.0,C339099861
7307,409000493210',2018-11-19,Indiaforensic NFS SETT 18-11-201,10000.0,0.0,2347650.840000004,2018,11,19,CASH_OUT,10000.0,M103010850
7308,409000493210',2018-11-19,Indiaforensic NFS SETT 18-11-201,1000.0,0.0,2346650.840000004,2018,11,19,PAYEMENT,1000.0,M1262399289
7309,409000493210',2018-11-19,Indiaforensic NFS SETT 18-11-201,10000.0,0.0,2336650.840000004,2018,11,19,CHECK_WITHDRAWAL,10000.0,M356649202
7310,409000493210',2018-11-19,Indiaforensic NFS SETT 18-11-201,5000.0,0.0,2331650.840000004,2018,11,19,CASH_OUT,5000.0,M259237839
7311,409000493210',2018-11-19,Indiaforensic NFS SETT 18-11-201,10000.0,0.0,2321650.840000004,2018,11,19,CASH_OUT,10000.0,C347696158
7312,409000493210',2018-11-19,Indiaforensic NFS SETT 18-11-201,5000.0,0.0,2316650.840000004,2018,11,19,CHECK_WITHDRAWAL,5000.0,M570038756
7313,409000493210',2018-11-19,Indiaforensic NFS SETT 18-11-201,9000.0,0.0,2307650.840000004,2018,11,19,CHECK_WITHDRAWAL,9000.0,M917040074
7314,409000493210',2018-11-19,Indiaforensic  RUPAY SETT 191118,29703.67,0.0,2277947.170000004,2018,11,19,PAYEMENT,29703.67,M1128952562
7315,409000493210',2018-11-19,Indiaforensic  RUPAY SETT 191118,0.0,383.3,2278330.470000004,2018,11,19,TRANSFER,383.3,M755576935
7316,409000493210',2018-11-19,Indiaforensic RUPAY STL INTC1911,309.9,0.0,2278020.570000004,2018,11,19,CASH_OUT,309.9,M2093499056
7317,409000493210',2018-11-19,Indiaforensic RUPAY STL INTC1911,0.0,0.53,2278021.1000000043,2018,11,19,CASH_IN,0.53,M926134772
7318,409000493210',2018-11-20,TRF FROM  Indiaforensic SERVICES,0.0,366788.0,2644809.1000000043,2018,11,20,CHECK_CASHING,366788.0,C122086708
7319,409000493210',2018-11-20,FDRL/INTERNAL FUND TRANSFE,0.0,50000.0,2694809.1000000043,2018,11,20,TRANSFER,50000.0,C71555810
7320,409000493210',2018-11-20,FDRL/INTERNAL FUND TRANSFE,0.0,50000.0,2744809.1000000043,2018,11,20,CHECK_CASHING,50000.0,C486371171
7321,409000493210',2018-11-20,FDRL/INTERNAL FUND TRANSFE,0.0,50000.0,2794809.1000000043,2018,11,20,CHECK_CASHING,50000.0,M682713491
7322,409000493210',2018-11-20,FDRL/INTERNAL FUND TRANSFE,0.0,50000.0,2844809.100000004,2018,11,20,CHECK_CASHING,50000.0,C1242584406
7323,409000493210',2018-11-20,Indiaforensic  RUPAY SETT 201118,5100.71,0.0,2839708.390000004,2018,11,20,DEBIT,5100.71,C1271835801
7324,409000493210',2018-11-20,Indiaforensic RUPAY STL INTC2011,56.1,0.0,2839652.2900000038,2018,11,20,PAYEMENT,56.1,C1121686878
7325,409000493210',2018-11-20,Indiaforensic  RUPAY SETT 201118,0.0,56.1,2839708.390000004,2018,11,20,TRANSFER,56.1,M650835126
7326,409000493210',2018-11-20,Indiaforensic  RUPAY SETT 201118,3817.37,0.0,2835891.0200000037,2018,11,20,CASH_OUT,3817.37,M745868137
7327,409000493210',2018-11-20,Indiaforensic  RUPAY SETT 201118,0.0,28.63,2835919.650000003,2018,11,20,TRANSFER,28.63,C794358930
7328,409000493210',2018-11-20,Indiaforensic RUPAY STL INTC2011,28.63,0.0,2835891.0200000037,2018,11,20,CHECK_WITHDRAWAL,28.63,C840027268
7329,409000493210',2018-11-20,Indiaforensic NFS SETT 19-11-201,200.0,0.0,2835691.0200000037,2018,11,20,PAYEMENT,200.0,M703665376
7330,409000493210',2018-11-20,Indiaforensic NFS SETT 19-11-201,9000.0,0.0,2826691.0200000037,2018,11,20,CHECK_WITHDRAWAL,9000.0,C1167066016
7331,409000493210',2018-11-20,Indiaforensic NFS SETT 19-11-201,5000.0,0.0,2821691.0200000037,2018,11,20,CASH_OUT,5000.0,M1600888965
7332,409000493210',2018-11-20,Indiaforensic NFS SETT 19-11-201,1000.0,0.0,2820691.0200000037,2018,11,20,CASH_OUT,1000.0,M653766932
7333,409000493210',2018-11-20,Indiaforensic NFS SETT 19-11-201,6200.0,0.0,2814491.020000004,2018,11,20,PAYEMENT,6200.0,M586212137
7334,409000493210',2018-11-20,Indiaforensic NFS SETT 19-11-201,500.0,0.0,2813991.020000004,2018,11,20,DEBIT,500.0,C214774813
7335,409000493210',2018-11-20,Indiaforensic NFS SETT 19-11-201,10000.0,0.0,2803991.020000004,2018,11,20,CHECK_WITHDRAWAL,10000.0,C1495761010
7336,409000493210',2018-11-20,Indiaforensic NFS SETT 19-11-201,10000.0,0.0,2793991.020000004,2018,11,20,CASH_OUT,10000.0,M1304803463
7337,409000493210',2018-11-20,Indiaforensic NFS SETT 19-11-201,5000.0,0.0,2788991.020000004,2018,11,20,CASH_OUT,5000.0,C1880332929
7338,409000493210',2018-11-20,Indiaforensic NFS SETT 19-11-201,5000.0,0.0,2783991.020000004,2018,11,20,CHECK_WITHDRAWAL,5000.0,C1674899618
7339,409000493210',2018-11-20,Indiaforensic NFS SETT 19-11-201,5000.0,0.0,2778991.020000004,2018,11,20,DEBIT,5000.0,C11003494
7340,409000493210',2018-11-20,Indiaforensic NFS SETT 19-11-201,10000.0,0.0,2768991.020000004,2018,11,20,CASH_OUT,10000.0,C410033330
7341,409000493210',2018-11-20,Indiaforensic NFS SETT 05-11-201,10000.0,0.0,2758991.020000004,2018,11,20,DEBIT,10000.0,C7313260
7342,409000493210',2018-11-20,Indiaforensic NFS SETT 05-11-201,5000.0,0.0,2753991.020000004,2018,11,20,CASH_OUT,5000.0,C392292416
7343,409000493210',2018-11-20,Indiaforensic NFS SETT 05-11-201,400.0,0.0,2753591.020000004,2018,11,20,CHECK_WITHDRAWAL,400.0,C97730845
7344,409000493210',2018-11-20,Indiaforensic NFS SETT 05-11-201,3500.0,0.0,2750091.020000004,2018,11,20,DEBIT,3500.0,C1816757085
7345,409000493210',2018-11-20,Indiaforensic NFS SETT 05-11-201,500.0,0.0,2749591.020000004,2018,11,20,CASH_OUT,500.0,C1060041730
7346,409000493210',2018-11-20,Indiaforensic NFS SETT 05-11-201,400.0,0.0,2749191.020000004,2018,11,20,CHECK_WITHDRAWAL,400.0,C1354952534
7347,409000493210',2018-11-20,Indiaforensic NFS SETT 05-11-201,500.0,0.0,2748691.020000004,2018,11,20,DEBIT,500.0,C931482420
7348,409000493210',2018-11-20,Indiaforensic NFS SETT 05-11-201,4500.0,0.0,2744191.020000004,2018,11,20,DEBIT,4500.0,C1191924243
7349,409000493210',2018-11-20,Indiaforensic NFS SETT 05-11-201,2000.0,0.0,2742191.020000004,2018,11,20,PAYEMENT,2000.0,C977993101
7350,409000493210',2018-11-20,Indiaforensic NFS SETT 05-11-201,5500.0,0.0,2736691.020000004,2018,11,20,CHECK_WITHDRAWAL,5500.0,C728885526
7351,409000493210',2018-11-20,Indiaforensic NFS SETT 05-11-201,5000.0,0.0,2731691.020000004,2018,11,20,CHECK_WITHDRAWAL,5000.0,C1345063038
7352,409000493210',2018-11-20,Indiaforensic NFS SETT 05-11-201,500.0,0.0,2731191.020000004,2018,11,20,CASH_OUT,500.0,C1782113663
7353,409000493210',2018-11-20,Indiaforensic NFS SETT 05-11-201,5100.0,0.0,2726091.020000004,2018,11,20,DEBIT,5100.0,C2011996123
7354,409000493210',2018-11-20,Indiaforensic NFS SETT 05-11-201,3000.0,0.0,2723091.020000004,2018,11,20,CASH_OUT,3000.0,M817012565
7355,409000493210',2018-11-20,Indiaforensic NFS SETT 05-11-201,5000.0,0.0,2718091.020000004,2018,11,20,CASH_OUT,5000.0,C481402298
7356,409000493210',2018-11-20,Indiaforensic NFS SETT 05-11-201,9000.0,0.0,2709091.020000004,2018,11,20,CHECK_WITHDRAWAL,9000.0,C251155815
7357,409000493210',2018-11-20,Indiaforensic NFS SETT 05-11-201,5000.0,0.0,2704091.020000004,2018,11,20,CASH_OUT,5000.0,M1483742860
7358,409000493210',2018-11-20,Indiaforensic NFS SETT 05-11-201,7500.0,0.0,2696591.020000004,2018,11,20,CHECK_WITHDRAWAL,7500.0,M789475336
7359,409000493210',2018-11-20,Indiaforensic NFS SETT 05-11-201,500.0,0.0,2696091.020000004,2018,11,20,PAYEMENT,500.0,M1747087615
7360,409000493210',2018-11-20,Indiaforensic NFS SETT 05-11-201,9000.0,0.0,2687091.020000004,2018,11,20,PAYEMENT,9000.0,M932325687
7361,409000493210',2018-11-20,Indiaforensic NFS SETT 05-11-201,10000.0,0.0,2677091.020000004,2018,11,20,DEBIT,10000.0,M144055893
7362,409000493210',2018-11-20,Indiaforensic NFS SETT 05-11-201,5000.0,0.0,2672091.020000004,2018,11,20,CHECK_WITHDRAWAL,5000.0,M1100474457
7363,409000493210',2018-11-20,Indiaforensic NFS SETT 05-11-201,10000.0,0.0,2662091.020000004,2018,11,20,PAYEMENT,10000.0,M1272708038
7364,409000493210',2018-11-20,Indiaforensic NFS SETT 05-11-201,7000.0,0.0,2655091.020000004,2018,11,20,DEBIT,7000.0,M123251782
7365,409000493210',2018-11-21,Indiaforensic  RUPAY SETT 211118,1975.36,0.0,2653115.660000004,2018,11,21,CASH_OUT,1975.36,M1497258319
7366,409000493210',2018-11-21,Indiaforensic  RUPAY SETT 211118,0.0,243.48,2653359.140000004,2018,11,21,CASH_IN,243.48,M2020015678
7367,409000493210',2018-11-21,Indiaforensic RUPAY STL INTC2111,13.6,0.0,2653345.540000004,2018,11,21,PAYEMENT,13.6,M1649464124
7368,409000493210',2018-11-21,Indiaforensic RUPAY STL INTC2111,0.0,1.71,2653347.250000004,2018,11,21,CHECK_CASHING,1.71,M1705236425
7369,409000493210',2018-11-21,Indiaforensic  RUPAY SETT 211118,10054.12,0.0,2643293.130000003,2018,11,21,DEBIT,10054.12,M818628762
7370,409000493210',2018-11-21,Indiaforensic  RUPAY SETT 211118,0.0,78.31,2643371.440000003,2018,11,21,TRANSFER,78.31,M997919131
7371,409000493210',2018-11-21,Indiaforensic RUPAY STL INTC2111,78.31,0.0,2643293.130000003,2018,11,21,CHECK_WITHDRAWAL,78.31,M819545304
7372,409000493210',2018-11-22,Indiaforensic  RUPAY SETT 221118,13777.32,0.0,2629515.8100000042,2018,11,22,CASH_OUT,13777.32,M2141341498
7373,409000493210',2018-11-22,Indiaforensic  RUPAY SETT 221118,0.0,144.79,2629660.6000000043,2018,11,22,CHECK_CASHING,144.79,M1030218707
7374,409000493210',2018-11-22,Indiaforensic RUPAY STL INTC2211,144.79,0.0,2629515.8100000042,2018,11,22,PAYEMENT,144.79,M2035894779
7375,409000493210',2018-11-22,Indiaforensic  RUPAY SETT 221118,762.83,0.0,2628752.9800000032,2018,11,22,CHECK_WITHDRAWAL,762.83,C560041895
7376,409000493210',2018-11-22,Indiaforensic  RUPAY SETT 221118,0.0,8.37,2628761.3500000043,2018,11,22,CASH_IN,8.37,M1190097728
7377,409000493210',2018-11-22,Indiaforensic RUPAY STL INTC2211,8.37,0.0,2628752.9800000032,2018,11,22,CASH_OUT,8.37,M103483282
7378,409000493210',2018-11-22,Indiaforensic NFS SETT 20-11-201,2000.0,0.0,2626752.9800000032,2018,11,22,DEBIT,2000.0,M303831560
7379,409000493210',2018-11-22,Indiaforensic NFS SETT 20-11-201,10000.0,0.0,2616752.9800000032,2018,11,22,DEBIT,10000.0,C932583850
7380,409000493210',2018-11-22,Indiaforensic NFS SETT 20-11-201,4000.0,0.0,2612752.9800000032,2018,11,22,DEBIT,4000.0,C1538745405
7381,409000493210',2018-11-22,Indiaforensic NFS SETT 20-11-201,100.0,0.0,2612652.9800000032,2018,11,22,PAYEMENT,100.0,C1570256460
7382,409000493210',2018-11-22,Indiaforensic NFS SETT 20-11-201,10000.0,0.0,2602652.9800000032,2018,11,22,CASH_OUT,10000.0,C1419794148
7383,409000493210',2018-11-22,Indiaforensic NFS SETT 20-11-201,1000.0,0.0,2601652.9800000032,2018,11,22,DEBIT,1000.0,C202149782
7384,409000493210',2018-11-22,Indiaforensic NFS SETT 20-11-201,2000.0,0.0,2599652.9800000032,2018,11,22,DEBIT,2000.0,C1559037239
7385,409000493210',2018-11-22,Indiaforensic NFS SETT 20-11-201,10000.0,0.0,2589652.9800000032,2018,11,22,CHECK_WITHDRAWAL,10000.0,C801142660
7386,409000493210',2018-11-22,Indiaforensic NFS SETT 20-11-201,4000.0,0.0,2585652.9800000032,2018,11,22,DEBIT,4000.0,C295372946
7387,409000493210',2018-11-22,Indiaforensic NFS SETT 20-11-201,500.0,0.0,2585152.9800000032,2018,11,22,CHECK_WITHDRAWAL,500.0,C83980058
7388,409000493210',2018-11-22,Indiaforensic NFS SETT 21-11-201,200.0,0.0,2584952.9800000032,2018,11,22,PAYEMENT,200.0,C766681183
7389,409000493210',2018-11-22,Indiaforensic NFS SETT 21-11-201,200.0,0.0,2584752.9800000032,2018,11,22,CHECK_WITHDRAWAL,200.0,C1464835638
7390,409000493210',2018-11-22,Indiaforensic NFS SETT 21-11-201,5000.0,0.0,2579752.9800000032,2018,11,22,CHECK_WITHDRAWAL,5000.0,C1896545607
7391,409000493210',2018-11-22,Indiaforensic NFS SETT 21-11-201,2000.0,0.0,2577752.9800000032,2018,11,22,CASH_OUT,2000.0,C932583850
7392,409000493210',2018-11-22,Indiaforensic NFS SETT 21-11-201,10000.0,0.0,2567752.9800000032,2018,11,22,PAYEMENT,10000.0,C1067155425
7393,409000493210',2018-11-23,Indiaforensic  RUPAY SETT 231118,15913.56,0.0,2551839.420000003,2018,11,23,CHECK_WITHDRAWAL,15913.56,C1875310223
7394,409000493210',2018-11-23,Indiaforensic  RUPAY SETT 231118,0.0,233.41,2552072.8300000043,2018,11,23,CASH_IN,233.41,C2113748097
7395,409000493210',2018-11-23,Indiaforensic RUPAY STL INTC2111,164.24,0.0,2551908.590000003,2018,11,23,DEBIT,164.24,C1360767589
7396,409000493210',2018-11-23,Indiaforensic RUPAY STL INTC2111,0.0,0.52,2551909.110000003,2018,11,23,CHECK_CASHING,0.52,C1982828534
7397,409000493210',2018-11-23,Indiaforensic  RUPAY SETT 231118,18073.05,0.0,2533836.0600000042,2018,11,23,PAYEMENT,18073.05,C1471633238
7398,409000493210',2018-11-23,Indiaforensic  RUPAY SETT 231118,0.0,186.78,2534022.840000003,2018,11,23,CASH_IN,186.78,C507538622
7399,409000493210',2018-11-23,Indiaforensic RUPAY STL INTC2311,186.78,0.0,2533836.0600000042,2018,11,23,CASH_OUT,186.78,C644345897
7400,409000493210',2018-11-26,Indiaforensic  RUPAY SETT 261118,1999.25,0.0,2531836.8100000042,2018,11,26,CHECK_WITHDRAWAL,1999.25,C1446521801
7401,409000493210',2018-11-26,Indiaforensic  RUPAY SETT 261118,0.0,24.81,2531861.620000004,2018,11,26,CASH_IN,24.81,M1231029475
7402,409000493210',2018-11-26,Indiaforensic RUPAY STL INTC2611,24.81,0.0,2531836.8100000042,2018,11,26,DEBIT,24.81,C1778300121
7403,409000493210',2018-11-26,Indiaforensic  RUPAY SETT 261118,13363.57,0.0,2518473.240000004,2018,11,26,CHECK_WITHDRAWAL,13363.57,M254917009
7404,409000493210',2018-11-26,Indiaforensic  RUPAY SETT 261118,0.0,109.27,2518582.510000004,2018,11,26,CHECK_CASHING,109.27,M1367544605
7405,409000493210',2018-11-26,Indiaforensic RUPAY STL INTC2611,102.22,0.0,2518480.290000004,2018,11,26,DEBIT,102.22,M1774347256
7406,409000493210',2018-11-26,Indiaforensic RUPAY STL INTC2611,0.0,0.04,2518480.3300000043,2018,11,26,CHECK_CASHING,0.04,M428475414
7407,409000493210',2018-11-26,Indiaforensic SERVICES INDIA PVT,31330.06,0.0,2487150.270000004,2018,11,26,CHECK_WITHDRAWAL,31330.06,M1703353597
7408,409000493210',2018-11-26,Indiaforensic  RUPAY SETT 251118,0.0,269.36,2487419.630000003,2018,11,26,CASH_IN,269.36,M1004308853
7409,409000493210',2018-11-26,Indiaforensic RUPAY STL INTC2511,251.49,0.0,2487168.140000003,2018,11,26,PAYEMENT,251.49,M2052572633
7410,409000493210',2018-11-26,Indiaforensic RUPAY STL INTC2511,0.0,0.09,2487168.2300000032,2018,11,26,CHECK_CASHING,0.09,M736233691
7411,409000493210',2018-11-26,Indiaforensic  RUPAY SETT 241118,6670.41,0.0,2480497.8200000026,2018,11,26,CHECK_WITHDRAWAL,6670.41,M451480761
7412,409000493210',2018-11-26,Indiaforensic  RUPAY SETT 241118,0.0,62.48,2480560.3000000026,2018,11,26,CASH_IN,62.48,M8238713
7413,409000493210',2018-11-26,Indiaforensic RUPAY STL INTC2411,54.98,0.0,2480505.3200000026,2018,11,26,CHECK_WITHDRAWAL,54.98,M798483422
7414,409000493210',2018-11-26,Indiaforensic RUPAY STL INTC2411,0.0,0.04,2480505.3600000027,2018,11,26,CHECK_CASHING,0.04,M1867721054
7415,409000493210',2018-11-27,Indiaforensic  RUPAY SETT 271118,8164.28,0.0,2472341.0800000043,2018,11,27,PAYEMENT,8164.28,M1335077110
7416,409000493210',2018-11-27,Indiaforensic  RUPAY SETT 271118,0.0,127.59,2472468.6700000027,2018,11,27,CHECK_CASHING,127.59,M1069736192
7417,409000493210',2018-11-27,Indiaforensic RUPAY STL INTC2711,62.58,0.0,2472406.0900000026,2018,11,27,CHECK_WITHDRAWAL,62.58,M1670283668
7418,409000493210',2018-11-27,Indiaforensic RUPAY STL INTC2711,0.0,0.46,2472406.5500000026,2018,11,27,TRANSFER,0.46,M1797553910
7419,409000493210',2018-11-27,Indiaforensic NFS SETT 22-11-201,10000.0,0.0,2462406.5500000026,2018,11,27,PAYEMENT,10000.0,M252744319
7420,409000493210',2018-11-27,Indiaforensic NFS SETT 22-11-201,5000.0,0.0,2457406.5500000026,2018,11,27,CHECK_WITHDRAWAL,5000.0,M911673654
7421,409000493210',2018-11-27,Indiaforensic NFS SETT 22-11-201,1500.0,0.0,2455906.5500000026,2018,11,27,PAYEMENT,1500.0,M209524543
7422,409000493210',2018-11-27,Indiaforensic NFS SETT 22-11-201,10000.0,0.0,2445906.5500000026,2018,11,27,DEBIT,10000.0,M476152469
7423,409000493210',2018-11-27,Indiaforensic NFS SETT 23-11-201,5000.0,0.0,2440906.5500000026,2018,11,27,CHECK_WITHDRAWAL,5000.0,M1357570394
7424,409000493210',2018-11-27,Indiaforensic NFS SETT 23-11-201,10000.0,0.0,2430906.5500000026,2018,11,27,CASH_OUT,10000.0,M1532977612
7425,409000493210',2018-11-27,Indiaforensic NFS SETT 23-11-201,1000.0,0.0,2429906.5500000026,2018,11,27,CASH_OUT,1000.0,M1055932985
7426,409000493210',2018-11-27,Indiaforensic NFS SETT 23-11-201,500.0,0.0,2429406.5500000026,2018,11,27,CHECK_WITHDRAWAL,500.0,M77173924
7427,409000493210',2018-11-27,Indiaforensic NFS SETT 23-11-201,100.0,0.0,2429306.5500000026,2018,11,27,CHECK_WITHDRAWAL,100.0,C1933965693
7428,409000493210',2018-11-27,Indiaforensic NFS SETT 23-11-201,300.0,0.0,2429006.5500000026,2018,11,27,DEBIT,300.0,M1610143599
7429,409000493210',2018-11-27,Indiaforensic NFS SETT 24-11-201,10000.0,0.0,2419006.5500000026,2018,11,27,DEBIT,10000.0,M1464230046
7430,409000493210',2018-11-27,Indiaforensic NFS SETT 24-11-201,10000.0,0.0,2409006.5500000026,2018,11,27,PAYEMENT,10000.0,M1501618847
7431,409000493210',2018-11-27,Indiaforensic NFS SETT 24-11-201,200.0,0.0,2408806.5500000026,2018,11,27,CASH_OUT,200.0,C1816757085
7432,409000493210',2018-11-27,Indiaforensic NFS SETT 24-11-201,7000.0,0.0,2401806.5500000026,2018,11,27,CASH_OUT,7000.0,C634210724
7433,409000493210',2018-11-27,Indiaforensic NFS SETT 25-11-201,10000.0,0.0,2391806.5500000026,2018,11,27,PAYEMENT,10000.0,M105451526
7434,409000493210',2018-11-27,Indiaforensic NFS SETT 25-11-201,2000.0,0.0,2389806.5500000026,2018,11,27,PAYEMENT,2000.0,M1417768314
7435,409000493210',2018-11-27,Indiaforensic NFS SETT 25-11-201,8000.0,0.0,2381806.5500000026,2018,11,27,PAYEMENT,8000.0,M1592602335
7436,409000493210',2018-11-27,Indiaforensic NFS SETT 25-11-201,2000.0,0.0,2379806.5500000026,2018,11,27,PAYEMENT,2000.0,C542220524
7437,409000493210',2018-11-27,Indiaforensic NFS SETT 25-11-201,200.0,0.0,2379606.5500000026,2018,11,27,PAYEMENT,200.0,C716083600
7438,409000493210',2018-11-27,Indiaforensic NFS SETT 25-11-201,500.0,0.0,2379106.5500000026,2018,11,27,CHECK_WITHDRAWAL,500.0,M1808324797
7439,409000493210',2018-11-27,Indiaforensic  RUPAY SETT 271118,6049.73,0.0,2373056.8200000026,2018,11,27,DEBIT,6049.73,C1615804266
7440,409000493210',2018-11-27,Indiaforensic  RUPAY SETT 271118,0.0,127.53,2373184.3500000024,2018,11,27,CHECK_CASHING,127.53,C465499079
7441,409000493210',2018-11-27,Indiaforensic RUPAY STL INTC2711,45.73,0.0,2373138.6200000024,2018,11,27,PAYEMENT,45.73,C267527788
7442,409000493210',2018-11-27,Indiaforensic RUPAY STL INTC2711,0.0,0.61,2373139.2300000023,2018,11,27,CASH_IN,0.61,M330652043
7443,409000493210',2018-11-28,Indiaforensic  RUPAY SETT 281118,13861.03,0.0,2359278.2000000025,2018,11,28,CHECK_WITHDRAWAL,13861.03,M26179918
7444,409000493210',2018-11-28,Indiaforensic  RUPAY SETT 281118,0.0,137.86,2359416.0600000024,2018,11,28,CHECK_CASHING,137.86,M22737007
7445,409000493210',2018-11-28,Indiaforensic RUPAY STL INTC2811,114.93,0.0,2359301.1300000018,2018,11,28,CHECK_WITHDRAWAL,114.93,M205010614
7446,409000493210',2018-11-28,Indiaforensic RUPAY STL INTC2811,0.0,0.17,2359301.3000000017,2018,11,28,TRANSFER,0.17,M910041097
7447,409000493210',2018-11-28,Indiaforensic NFS SETT 26-11-201,1000.0,0.0,2358301.3000000017,2018,11,28,CASH_OUT,1000.0,M907409625
7448,409000493210',2018-11-28,Indiaforensic NFS SETT 26-11-201,300.0,0.0,2358001.3000000017,2018,11,28,CHECK_WITHDRAWAL,300.0,M442060811
7449,409000493210',2018-11-28,Indiaforensic NFS SETT 26-11-201,1000.0,0.0,2357001.3000000017,2018,11,28,DEBIT,1000.0,M1475804169
7450,409000493210',2018-11-28,Indiaforensic NFS SETT 26-11-201,2500.0,0.0,2354501.3000000017,2018,11,28,CHECK_WITHDRAWAL,2500.0,M1525421339
7451,409000493210',2018-11-28,Indiaforensic NFS SETT 26-11-201,100.0,0.0,2354401.3000000017,2018,11,28,CASH_OUT,100.0,M347701627
7452,409000493210',2018-11-28,Indiaforensic NFS SETT 26-11-201,700.0,0.0,2353701.3000000017,2018,11,28,PAYEMENT,700.0,M170698369
7453,409000493210',2018-11-28,Indiaforensic NFS SETT 26-11-201,400.0,0.0,2353301.3000000017,2018,11,28,PAYEMENT,400.0,M1609448604
7454,409000493210',2018-11-28,Indiaforensic NFS SETT 26-11-201,1000.0,0.0,2352301.3000000017,2018,11,28,PAYEMENT,1000.0,M295749384
7455,409000493210',2018-11-28,Indiaforensic NFS SETT 26-11-201,2000.0,0.0,2350301.3000000017,2018,11,28,CASH_OUT,2000.0,M513477778
7456,409000493210',2018-11-28,Indiaforensic NFS SETT 26-11-201,1500.0,0.0,2348801.3000000017,2018,11,28,PAYEMENT,1500.0,M1290911050
7457,409000493210',2018-11-28,Indiaforensic NFS SETT 26-11-201,1500.0,0.0,2347301.3000000017,2018,11,28,CASH_OUT,1500.0,M1147103911
7458,409000493210',2018-11-28,Indiaforensic NFS SETT 26-11-201,1500.0,0.0,2345801.3000000017,2018,11,28,CHECK_WITHDRAWAL,1500.0,M731431696
7459,409000493210',2018-11-28,Indiaforensic NFS SETT 26-11-201,500.0,0.0,2345301.3000000017,2018,11,28,DEBIT,500.0,M641078642
7460,409000493210',2018-11-28,Indiaforensic NFS SETT 26-11-201,3000.0,0.0,2342301.3000000017,2018,11,28,CASH_OUT,3000.0,M807771233
7461,409000493210',2018-11-28,Indiaforensic NFS SETT 26-11-201,400.0,0.0,2341901.3000000017,2018,11,28,CHECK_WITHDRAWAL,400.0,M626754729
7462,409000493210',2018-11-28,Indiaforensic NFS SETT 26-11-201,300.0,0.0,2341601.3000000017,2018,11,28,CHECK_WITHDRAWAL,300.0,M645018917
7463,409000493210',2018-11-28,Indiaforensic NFS SETT 26-11-201,300.0,0.0,2341301.3000000017,2018,11,28,CHECK_WITHDRAWAL,300.0,M1757653560
7464,409000493210',2018-11-28,Indiaforensic NFS SETT 26-11-201,1000.0,0.0,2340301.3000000017,2018,11,28,CASH_OUT,1000.0,C440737101
7465,409000493210',2018-11-28,Indiaforensic NFS SETT 26-11-201,1000.0,0.0,2339301.3000000017,2018,11,28,CASH_OUT,1000.0,C1286084959
7466,409000493210',2018-11-28,Indiaforensic NFS SETT 26-11-201,1000.0,0.0,2338301.3000000017,2018,11,28,CHECK_WITHDRAWAL,1000.0,C1531333864
7467,409000493210',2018-11-28,Indiaforensic NFS SETT 26-11-201,2600.0,0.0,2335701.3000000017,2018,11,28,CASH_OUT,2600.0,C1398530689
7468,409000493210',2018-11-28,Indiaforensic NFS SETT 26-11-201,1000.0,0.0,2334701.3000000017,2018,11,28,PAYEMENT,1000.0,M858132653
7469,409000493210',2018-11-28,Indiaforensic NFS SETT 26-11-201,3000.0,0.0,2331701.3000000017,2018,11,28,DEBIT,3000.0,M2036240117
7470,409000493210',2018-11-28,Indiaforensic NFS SETT 27-11-201,1000.0,0.0,2330701.3000000017,2018,11,28,CHECK_WITHDRAWAL,1000.0,M280475120
7471,409000493210',2018-11-28,Indiaforensic NFS SETT 27-11-201,1000.0,0.0,2329701.3000000017,2018,11,28,PAYEMENT,1000.0,M95387183
7472,409000493210',2018-11-28,Indiaforensic NFS SETT 27-11-201,2000.0,0.0,2327701.3000000017,2018,11,28,CASH_OUT,2000.0,C803116137
7473,409000493210',2018-11-28,Indiaforensic NFS SETT 27-11-201,5000.0,0.0,2322701.3000000017,2018,11,28,CASH_OUT,5000.0,M1394111263
7474,409000493210',2018-11-28,Indiaforensic NFS SETT 27-11-201,9500.0,0.0,2313201.3000000017,2018,11,28,DEBIT,9500.0,M311245180
7475,409000493210',2018-11-28,Indiaforensic NFS SETT 27-11-201,1000.0,0.0,2312201.3000000017,2018,11,28,CHECK_WITHDRAWAL,1000.0,M962248325
7476,409000493210',2018-11-28,Indiaforensic NFS SETT 27-11-201,200.0,0.0,2312001.3000000017,2018,11,28,CASH_OUT,200.0,M783882087
7477,409000493210',2018-11-28,Indiaforensic NFS SETT 27-11-201,100.0,0.0,2311901.3000000017,2018,11,28,CASH_OUT,100.0,M1053596586
7478,409000493210',2018-11-28,Indiaforensic NFS SETT 27-11-201,100.0,0.0,2311801.3000000017,2018,11,28,CASH_OUT,100.0,C651445737
7479,409000493210',2018-11-28,Indiaforensic NFS SETT 27-11-201,500.0,0.0,2311301.3000000017,2018,11,28,DEBIT,500.0,M237502470
7480,409000493210',2018-11-28,Indiaforensic NFS SETT 27-11-201,1000.0,0.0,2310301.3000000017,2018,11,28,CASH_OUT,1000.0,C1816986148
7481,409000493210',2018-11-28,Indiaforensic NFS SETT 27-11-201,1000.0,0.0,2309301.3000000017,2018,11,28,CASH_OUT,1000.0,M333825340
7482,409000493210',2018-11-28,Indiaforensic NFS SETT 27-11-201,10000.0,0.0,2299301.3000000017,2018,11,28,CASH_OUT,10000.0,C878506901
7483,409000493210',2018-11-28,Indiaforensic NFS SETT 27-11-201,1900.0,0.0,2297401.3000000017,2018,11,28,DEBIT,1900.0,C1477979030
7484,409000493210',2018-11-28,Indiaforensic NFS SETT 27-11-201,300.0,0.0,2297101.3000000017,2018,11,28,CASH_OUT,300.0,M814945818
7485,409000493210',2018-11-28,Indiaforensic NFS SETT 27-11-201,100.0,0.0,2297001.3000000017,2018,11,28,CHECK_WITHDRAWAL,100.0,C1191924243
7486,409000493210',2018-11-28,Indiaforensic NFS SETT 27-11-201,600.0,0.0,2296401.3000000017,2018,11,28,DEBIT,600.0,M1140174868
7487,409000493210',2018-11-28,Indiaforensic  RUPAY SETT 281118,9367.06,0.0,2287034.240000002,2018,11,28,CHECK_WITHDRAWAL,9367.06,M1549393863
7488,409000493210',2018-11-28,Indiaforensic  RUPAY SETT 281118,0.0,72.37,2287106.6100000017,2018,11,28,TRANSFER,72.37,M787889005
7489,409000493210',2018-11-28,Indiaforensic RUPAY STL INTC2811,72.37,0.0,2287034.240000002,2018,11,28,CASH_OUT,72.37,M633964087
7490,409000493210',2018-11-29,Indiaforensic  RUPAY SETT 291118,5287.08,0.0,2281747.160000002,2018,11,29,CHECK_WITHDRAWAL,5287.08,M277861845
7491,409000493210',2018-11-29,Indiaforensic  RUPAY SETT 291118,0.0,50.52,2281797.680000002,2018,11,29,CHECK_CASHING,50.52,M682914321
7492,409000493210',2018-11-29,Indiaforensic RUPAY STL INTC2911,50.52,0.0,2281747.160000002,2018,11,29,DEBIT,50.52,M611587518
7493,409000493210',2018-11-29,TRF FROM  Indiaforensic SERVICES,0.0,15000.0,2296747.160000002,2018,11,29,CHECK_CASHING,15000.0,C1284149862
7494,409000493210',2018-11-29,TRF FROM  Indiaforensic SERVICES,0.0,95431.0,2392178.160000002,2018,11,29,CASH_IN,95431.0,M1398450119
7495,409000493210',2018-11-29,Indiaforensic  RUPAY SETT 291118,2564.39,0.0,2389613.770000002,2018,11,29,CHECK_WITHDRAWAL,2564.39,C2046578329
7496,409000493210',2018-11-29,Indiaforensic  RUPAY SETT 291118,0.0,30.65,2389644.420000002,2018,11,29,TRANSFER,30.65,C1531812826
7497,409000493210',2018-11-29,Indiaforensic RUPAY STL INTC2911,26.74,0.0,2389617.6800000016,2018,11,29,PAYEMENT,26.74,M612412611
7498,409000493210',2018-11-29,Indiaforensic RUPAY STL INTC2911,0.0,0.02,2389617.7000000016,2018,11,29,CASH_IN,0.02,C2117043942
7499,409000493210',2018-11-30,Indiaforensic  RUPAY SETT 301118,33936.66,0.0,2355681.0400000014,2018,11,30,CHECK_WITHDRAWAL,33936.66,M1755838330
7500,409000493210',2018-11-30,Indiaforensic  RUPAY SETT 301118,0.0,235.67,2355916.7100000014,2018,11,30,CASH_IN,235.67,M513310553
7501,409000493210',2018-11-30,Indiaforensic RUPAY STL INTC3011,235.67,0.0,2355681.0400000014,2018,11,30,CASH_OUT,235.67,C800523009
7502,409000493210',2018-11-30,Indiaforensic  RUPAY SETT 301118,7105.03,0.0,2348576.0100000016,2018,11,30,CASH_OUT,7105.03,M42801967
7503,409000493210',2018-11-30,Indiaforensic  RUPAY SETT 301118,0.0,143.7,2348719.710000002,2018,11,30,CHECK_CASHING,143.7,M293687918
7504,409000493210',2018-11-30,Indiaforensic RUPAY STL INTC3011,0.0,0.49,2348720.200000002,2018,11,30,TRANSFER,0.49,M998935228
7505,409000493210',2018-11-30,Indiaforensic RUPAY STL INTC3011,77.7,0.0,2348642.500000002,2018,11,30,CASH_OUT,77.7,M1762409247
7506,409000493210',2018-11-30,TRF FROM  Indiaforensic SERVICES,0.0,220000.0,2568642.500000002,2018,11,30,CASH_IN,220000.0,M1925356935
7507,409000493210',2018-11-30,Indiaforensic NFS SETT 28-11-201,2000.0,0.0,2566642.500000002,2018,11,30,DEBIT,2000.0,M552186123
7508,409000493210',2018-11-30,Indiaforensic NFS SETT 28-11-201,500.0,0.0,2566142.500000002,2018,11,30,DEBIT,500.0,M1241568657
7509,409000493210',2018-11-30,Indiaforensic NFS SETT 28-11-201,1000.0,0.0,2565142.500000002,2018,11,30,CHECK_WITHDRAWAL,1000.0,M572706092
7510,409000493210',2018-11-30,Indiaforensic NFS SETT 28-11-201,1000.0,0.0,2564142.500000002,2018,11,30,DEBIT,1000.0,M4008846
7511,409000493210',2018-11-30,Indiaforensic NFS SETT 28-11-201,1000.0,0.0,2563142.500000002,2018,11,30,CHECK_WITHDRAWAL,1000.0,C667346055
7512,409000493210',2018-11-30,Indiaforensic NFS SETT 28-11-201,5000.0,0.0,2558142.500000002,2018,11,30,PAYEMENT,5000.0,M735140074
7513,409000493210',2018-11-30,Indiaforensic NFS SETT 28-11-201,5000.0,0.0,2553142.500000002,2018,11,30,PAYEMENT,5000.0,M80867688
7514,409000493210',2018-11-30,Indiaforensic NFS SETT 28-11-201,200.0,0.0,2552942.500000002,2018,11,30,PAYEMENT,200.0,C1382394077
7515,409000493210',2018-11-30,Indiaforensic NFS SETT 28-11-201,1000.0,0.0,2551942.500000002,2018,11,30,PAYEMENT,1000.0,C1825992554
7516,409000493210',2018-11-30,Indiaforensic NFS SETT 28-11-201,500.0,0.0,2551442.500000002,2018,11,30,CHECK_WITHDRAWAL,500.0,C803116137
7517,409000493210',2018-11-30,Indiaforensic NFS SETT 28-11-201,5000.0,0.0,2546442.500000002,2018,11,30,CHECK_WITHDRAWAL,5000.0,M39846973
7518,409000493210',2018-11-30,Indiaforensic NFS SETT 28-11-201,5000.0,0.0,2541442.500000002,2018,11,30,CHECK_WITHDRAWAL,5000.0,M1579030959
7519,409000493210',2018-11-30,Indiaforensic NFS SETT 28-11-201,1000.0,0.0,2540442.500000002,2018,11,30,CHECK_WITHDRAWAL,1000.0,C1198167820
7520,409000493210',2018-11-30,Indiaforensic NFS SETT 28-11-201,1000.0,0.0,2539442.500000002,2018,11,30,PAYEMENT,1000.0,M1082705382
7521,409000493210',2018-11-30,Indiaforensic NFS SETT 29-11-201,1000.0,0.0,2538442.500000002,2018,11,30,CHECK_WITHDRAWAL,1000.0,M1311844369
7522,409000493210',2018-11-30,Indiaforensic NFS SETT 29-11-201,5000.0,0.0,2533442.500000002,2018,11,30,CASH_OUT,5000.0,M2001804956
7523,409000493210',2018-11-30,Indiaforensic NFS SETT 29-11-201,3000.0,0.0,2530442.500000002,2018,11,30,CHECK_WITHDRAWAL,3000.0,C453211571
7524,409000493210',2018-11-30,Indiaforensic NFS SETT 29-11-201,500.0,0.0,2529942.500000002,2018,11,30,PAYEMENT,500.0,M112774596
7525,409000493210',2018-11-30,Indiaforensic NFS SETT 29-11-201,10000.0,0.0,2519942.500000002,2018,11,30,DEBIT,10000.0,M181806430
7526,409000493210',2018-11-30,Indiaforensic NFS SETT 29-11-201,8000.0,0.0,2511942.500000002,2018,11,30,PAYEMENT,8000.0,M1217162392
7527,409000493210',2018-12-01,Indiaforensic  RUPAY SETT 011218,8996.16,0.0,2502946.3400000017,2018,12,1,CHECK_WITHDRAWAL,8996.16,M511154139
7528,409000493210',2018-12-01,Indiaforensic  RUPAY SETT 011218,0.0,120.49,2503066.830000002,2018,12,1,CASH_IN,120.49,M1874960853
7529,409000493210',2018-12-01,Indiaforensic RUPAY STL INTC0112,120.49,0.0,2502946.3400000017,2018,12,1,PAYEMENT,120.49,M1835916981
7530,409000493210',2018-12-01,Indiaforensic NFS SETT 30-11-201,9000.0,0.0,2493946.3400000017,2018,12,1,CHECK_WITHDRAWAL,9000.0,M1559928458
7531,409000493210',2018-12-01,Indiaforensic NFS SETT 30-11-201,8200.0,0.0,2485746.3400000017,2018,12,1,PAYEMENT,8200.0,C183354406
7532,409000493210',2018-12-01,Indiaforensic NFS SETT 30-11-201,5000.0,0.0,2480746.3400000017,2018,12,1,PAYEMENT,5000.0,M649838238
7533,409000493210',2018-12-01,Indiaforensic NFS SETT 30-11-201,3000.0,0.0,2477746.3400000017,2018,12,1,DEBIT,3000.0,M1900903547
7534,409000493210',2018-12-01,Indiaforensic NFS SETT 30-11-201,10000.0,0.0,2467746.3400000017,2018,12,1,CHECK_WITHDRAWAL,10000.0,C1495761010
7535,409000493210',2018-12-01,Indiaforensic NFS SETT 30-11-201,3500.0,0.0,2464246.3400000017,2018,12,1,CHECK_WITHDRAWAL,3500.0,C1789550256
7536,409000493210',2018-12-01,Indiaforensic NFS SETT 30-11-201,500.0,0.0,2463746.3400000017,2018,12,1,DEBIT,500.0,C403147759
7537,409000493210',2018-12-01,Indiaforensic  RUPAY SETT 011218,3373.04,0.0,2460373.3000000017,2018,12,1,DEBIT,3373.04,C296121376
7538,409000493210',2018-12-01,Indiaforensic  RUPAY SETT 011218,0.0,20.69,2460393.9900000016,2018,12,1,TRANSFER,20.69,C1334973394
7539,409000493210',2018-12-01,Indiaforensic RUPAY STL INTC0112,20.69,0.0,2460373.3000000017,2018,12,1,DEBIT,20.69,C793315160
7540,409000493210',2018-12-03,Indiaforensic RUPAY SETT 021218,7611.25,0.0,2452762.0500000017,2018,12,3,DEBIT,7611.25,C2011996123
7541,409000493210',2018-12-03,Indiaforensic RUPAY SETT 021218,0.0,85.31,2452847.3600000017,2018,12,3,CASH_IN,85.31,C769342184
7542,409000493210',2018-12-03,Indiaforensic RUPAY STL INTC0212,63.76,0.0,2452783.600000002,2018,12,3,CHECK_WITHDRAWAL,63.76,C421163163
7543,409000493210',2018-12-03,Indiaforensic RUPAY STL INTC0212,0.0,0.15,2452783.750000002,2018,12,3,CASH_IN,0.15,C728526866
7544,409000493210',2018-12-03,Indiaforensic RUPAY SETT 031218,40357.07,0.0,2412426.680000002,2018,12,3,CHECK_WITHDRAWAL,40357.07,C560041895
7545,409000493210',2018-12-03,Indiaforensic RUPAY STL INTC0312,300.86,0.0,2412125.8200000017,2018,12,3,CHECK_WITHDRAWAL,300.86,C1897050650
7546,409000493210',2018-12-03,Indiaforensic RUPAY SETT 031218,0.0,300.86,2412426.680000002,2018,12,3,TRANSFER,300.86,C1529639302
7547,409000493210',2018-12-03,Indiaforensic  RUPAY SETT 031218,6929.66,0.0,2405497.020000002,2018,12,3,CASH_OUT,6929.66,C1446521801
7548,409000493210',2018-12-03,Indiaforensic  RUPAY SETT 031218,0.0,51.48,2405548.500000002,2018,12,3,CHECK_CASHING,51.48,C248609774
7549,409000493210',2018-12-03,Indiaforensic RUPAY STL INTC0312,51.48,0.0,2405497.020000002,2018,12,3,CHECK_WITHDRAWAL,51.48,C343534938
7550,409000493210',2018-12-03,Indiaforensic NFS SETT 01-12-201,10000.0,0.0,2395497.020000002,2018,12,3,CHECK_WITHDRAWAL,10000.0,C1730752455
7551,409000493210',2018-12-03,Indiaforensic NFS SETT 01-12-201,300.0,0.0,2395197.020000002,2018,12,3,DEBIT,300.0,C1816757085
7552,409000493210',2018-12-03,Indiaforensic NFS SETT 01-12-201,10000.0,0.0,2385197.020000002,2018,12,3,CASH_OUT,10000.0,M663139908
7553,409000493210',2018-12-03,Indiaforensic NFS SETT 01-12-201,10000.0,0.0,2375197.020000002,2018,12,3,DEBIT,10000.0,M400048100
7554,409000493210',2018-12-03,Indiaforensic NFS SETT 01-12-201,500.0,0.0,2374697.020000002,2018,12,3,PAYEMENT,500.0,M1875933782
7555,409000493210',2018-12-03,Indiaforensic NFS SETT 02-12-201,6500.0,0.0,2368197.020000002,2018,12,3,CASH_OUT,6500.0,M1164219495
7556,409000493210',2018-12-03,Indiaforensic NFS SETT 02-12-201,500.0,0.0,2367697.020000002,2018,12,3,CHECK_WITHDRAWAL,500.0,M1645088054
7557,409000493210',2018-12-03,Indiaforensic NFS SETT 02-12-201,600.0,0.0,2367097.020000002,2018,12,3,PAYEMENT,600.0,M1039453590
7558,409000493210',2018-12-03,Indiaforensic NFS SETT 02-12-201,4000.0,0.0,2363097.020000002,2018,12,3,CASH_OUT,4000.0,C448070390
7559,409000493210',2018-12-03,Indiaforensic NFS SETT 02-12-201,4000.0,0.0,2359097.020000002,2018,12,3,DEBIT,4000.0,M1858051117
7560,409000493210',2018-12-03,Indiaforensic NFS SETT 02-12-201,900.0,0.0,2358197.020000002,2018,12,3,CASH_OUT,900.0,M1000347057
7561,409000493210',2018-12-03,Indiaforensic NFS SETT 02-12-201,5000.0,0.0,2353197.020000002,2018,12,3,DEBIT,5000.0,M1532556857
7562,409000493210',2018-12-03,Indiaforensic NFS SETT 02-12-201,5000.0,0.0,2348197.020000002,2018,12,3,CASH_OUT,5000.0,M1986270265
7563,409000493210',2018-12-03,Indiaforensic NFS SETT 02-12-201,5000.0,0.0,2343197.020000002,2018,12,3,PAYEMENT,5000.0,M29401411
7564,409000493210',2018-12-03,Indiaforensic NFS SETT 02-12-201,2900.0,0.0,2340297.020000002,2018,12,3,DEBIT,2900.0,C2046578329
7565,409000493210',2018-12-03,Indiaforensic NFS SETT 02-12-201,500.0,0.0,2339797.020000002,2018,12,3,CHECK_WITHDRAWAL,500.0,M949557121
7566,409000493210',2018-12-03,Indiaforensic NFS SETT 02-12-201,500.0,0.0,2339297.020000002,2018,12,3,DEBIT,500.0,M1472719920
7567,409000493210',2018-12-04,Indiaforensic  RUPAY SETT 041218,17010.05,0.0,2322286.970000002,2018,12,4,PAYEMENT,17010.05,M46711852
7568,409000493210',2018-12-04,Indiaforensic  RUPAY SETT 041218,0.0,166.36,2322453.330000002,2018,12,4,CASH_IN,166.36,M1833824722
7569,409000493210',2018-12-04,Indiaforensic RUPAY STL INTC0412,152.78,0.0,2322300.5500000017,2018,12,4,PAYEMENT,152.78,M887606755
7570,409000493210',2018-12-04,Indiaforensic RUPAY STL INTC0412,0.0,0.07,2322300.620000002,2018,12,4,CHECK_CASHING,0.07,M719355325
7571,409000493210',2018-12-04,FDRL/INTERNAL FUND TRANSFE,0.0,50000.0,2372300.620000002,2018,12,4,TRANSFER,50000.0,C991505714
7572,409000493210',2018-12-04,FDRL/INTERNAL FUND TRANSFE,0.0,50000.0,2422300.620000002,2018,12,4,TRANSFER,50000.0,M581494907
7573,409000493210',2018-12-04,Indiaforensic  RUPAY SETT 041218,852.42,0.0,2421448.200000002,2018,12,4,DEBIT,852.42,M1810711373
7574,409000493210',2018-12-04,Indiaforensic  RUPAY SETT 041218,0.0,7.98,2421456.180000002,2018,12,4,CHECK_CASHING,7.98,M1996476498
7575,409000493210',2018-12-04,Indiaforensic RUPAY STL INTC0412,7.23,0.0,2421448.950000002,2018,12,4,CASH_OUT,7.23,C2081595126
7576,409000493210',2018-12-05,Indiaforensic  RUPAY SETT 051218,3971.82,0.0,2417477.1300000018,2018,12,5,DEBIT,3971.82,M74211793
7577,409000493210',2018-12-05,Indiaforensic  RUPAY SETT 051218,0.0,36.85,2417513.9800000023,2018,12,5,CHECK_CASHING,36.85,C1060041730
7578,409000493210',2018-12-05,Indiaforensic RUPAY STL INTC0512,31.13,0.0,2417482.8500000024,2018,12,5,PAYEMENT,31.13,M1000671313
7579,409000493210',2018-12-05,Indiaforensic RUPAY STL INTC0512,0.0,0.03,2417482.8800000018,2018,12,5,CASH_IN,0.03,M438163691
7580,409000493210',2018-12-05,Indiaforensic  RUPAY SETT 051218,2638.83,0.0,2414844.0500000017,2018,12,5,PAYEMENT,2638.83,M1578892902
7581,409000493210',2018-12-05,Indiaforensic  RUPAY SETT 051218,0.0,19.33,2414863.3800000018,2018,12,5,CHECK_CASHING,19.33,M1919800167
7582,409000493210',2018-12-05,Indiaforensic RUPAY STL INTC0512,19.33,0.0,2414844.0500000017,2018,12,5,PAYEMENT,19.33,C1183266411
7583,409000493210',2018-12-05,Indiaforensic NFS SETT 03-12-201,1700.0,0.0,2413144.0500000017,2018,12,5,PAYEMENT,1700.0,C150309335
7584,409000493210',2018-12-05,Indiaforensic NFS SETT 03-12-201,500.0,0.0,2412644.0500000017,2018,12,5,CHECK_WITHDRAWAL,500.0,M1151821341
7585,409000493210',2018-12-05,Indiaforensic NFS SETT 03-12-201,8000.0,0.0,2404644.0500000017,2018,12,5,CASH_OUT,8000.0,M217103506
7586,409000493210',2018-12-05,Indiaforensic NFS SETT 04-12-201,7000.0,0.0,2397644.0500000017,2018,12,5,CASH_OUT,7000.0,C1313534832
7587,409000493210',2018-12-05,Indiaforensic NFS SETT 04-12-201,10000.0,0.0,2387644.0500000017,2018,12,5,PAYEMENT,10000.0,M87865777
7588,409000493210',2018-12-05,Indiaforensic NFS SETT 04-12-201,5000.0,0.0,2382644.0500000017,2018,12,5,PAYEMENT,5000.0,M1642286060
7589,409000493210',2018-12-05,Indiaforensic NFS SETT 04-12-201,10000.0,0.0,2372644.0500000017,2018,12,5,CASH_OUT,10000.0,M1402232732
7590,409000493210',2018-12-05,Indiaforensic NFS SETT 04-12-201,1400.0,0.0,2371244.0500000017,2018,12,5,DEBIT,1400.0,M687842599
7591,409000493210',2018-12-06,Indiaforensic  RUPAY SETT 061218,13076.18,0.0,2358167.870000002,2018,12,6,DEBIT,13076.18,M1178027755
7592,409000493210',2018-12-06,Indiaforensic  RUPAY SETT 061218,0.0,111.74,2358279.6100000017,2018,12,6,TRANSFER,111.74,M22733595
7593,409000493210',2018-12-06,Indiaforensic RUPAY STL INTC0612,106.49,0.0,2358173.120000002,2018,12,6,CASH_OUT,106.49,C2011996123
7594,409000493210',2018-12-06,Indiaforensic RUPAY STL INTC0612,0.0,0.02,2358173.140000002,2018,12,6,TRANSFER,0.02,C1251686742
7595,409000493210',2018-12-06,Indiaforensic  RUPAY SETT 061218,3569.82,0.0,2354603.3200000017,2018,12,6,CHECK_WITHDRAWAL,3569.82,M1899482388
7596,409000493210',2018-12-06,Indiaforensic  RUPAY SETT 061218,0.0,25.9,2354629.220000002,2018,12,6,CHECK_CASHING,25.9,M1843541066
7597,409000493210',2018-12-06,Indiaforensic RUPAY STL INTC0612,25.9,0.0,2354603.3200000017,2018,12,6,DEBIT,25.9,M418223232
7598,409000493210',2018-12-06,TRF FROM  Indiaforensic SERVICES,0.0,50000.0,2404603.3200000017,2018,12,6,TRANSFER,50000.0,M596403167
7599,409000493210',2018-12-07,Indiaforensic  RUPAY SETT 071218,6093.97,0.0,2398509.350000002,2018,12,7,DEBIT,6093.97,C769342184
7600,409000493210',2018-12-07,Indiaforensic  RUPAY SETT 071218,0.0,43.32,2398552.670000002,2018,12,7,TRANSFER,43.32,M815497540
7601,409000493210',2018-12-07,Indiaforensic RUPAY STL INTC0712,43.32,0.0,2398509.350000002,2018,12,7,CHECK_WITHDRAWAL,43.32,M840259832
7602,409000493210',2018-12-07,Indiaforensic NFS SETT 06-12-201,10000.0,0.0,2388509.350000002,2018,12,7,CASH_OUT,10000.0,M107131289
7603,409000493210',2018-12-07,Indiaforensic  RUPAY SETT 071218,26528.57,0.0,2361980.7800000017,2018,12,7,CHECK_WITHDRAWAL,26528.57,M573424492
7604,409000493210',2018-12-07,Indiaforensic  RUPAY SETT 071218,0.0,121.48,2362102.260000002,2018,12,7,CHECK_CASHING,121.48,M666389658
7605,409000493210',2018-12-07,Indiaforensic RUPAY STL INTC0712,110.43,0.0,2361991.830000002,2018,12,7,PAYEMENT,110.43,M1834041945
7606,409000493210',2018-12-07,Indiaforensic RUPAY STL INTC0712,0.0,0.06,2361991.890000002,2018,12,7,CHECK_CASHING,0.06,M316204726
7607,409000493210',2018-12-10,FDRL/INTERNAL FUND TRANSFE,0.0,50000.0,2411991.890000002,2018,12,10,CASH_IN,50000.0,M179690980
7608,409000493210',2018-12-10,FDRL/INTERNAL FUND TRANSFE,0.0,50000.0,2461991.890000002,2018,12,10,CHECK_CASHING,50000.0,M626295499
7609,409000493210',2018-12-10,FDRL/INTERNAL FUND TRANSFE,0.0,50000.0,2511991.890000002,2018,12,10,CASH_IN,50000.0,M1678923217
7610,409000493210',2018-12-10,FDRL/INTERNAL FUND TRANSFE,0.0,50000.0,2561991.890000002,2018,12,10,CHECK_CASHING,50000.0,M1947573705
7611,409000493210',2018-12-10,FDRL/INTERNAL FUND TRANSFE,0.0,50000.0,2611991.890000002,2018,12,10,CHECK_CASHING,50000.0,M625086641
7612,409000493210',2018-12-10,FDRL/INTERNAL FUND TRANSFE,0.0,50000.0,2661991.890000002,2018,12,10,CASH_IN,50000.0,M942223469
7613,409000493210',2018-12-10,TRF FROM  Indiaforensic SERVICES,0.0,373047.0,3035038.890000002,2018,12,10,TRANSFER,373047.0,M488480779
7614,409000493210',2018-12-10,Indiaforensic RUPAY SETT 081218,22995.99,0.0,3012042.900000002,2018,12,10,CASH_OUT,22995.99,M1559191497
7615,409000493210',2018-12-10,Indiaforensic RUPAY SETT 081218,0.0,257.18,3012300.080000002,2018,12,10,CASH_IN,257.18,M2070645994
7616,409000493210',2018-12-10,Indiaforensic RUPAY STL INTC0812,253.79,0.0,3012046.290000002,2018,12,10,CHECK_WITHDRAWAL,253.79,M1436718473
7617,409000493210',2018-12-10,Indiaforensic RUPAY STL INTC0812,0.0,0.01,3012046.3000000017,2018,12,10,CASH_IN,0.01,M1249126393
7618,409000493210',2018-12-10,Indiaforensic RUPAY SETT 091218,48735.81,0.0,2963310.490000002,2018,12,10,CHECK_WITHDRAWAL,48735.81,M1410901593
7619,409000493210',2018-12-10,Indiaforensic RUPAY SETT 091218,0.0,3454.72,2966765.210000002,2018,12,10,CASH_IN,3454.72,M757515938
7620,409000493210',2018-12-10,Indiaforensic RUPAY STL INTC0912,450.97,0.0,2966314.240000002,2018,12,10,PAYEMENT,450.97,M307868325
7621,409000493210',2018-12-10,Indiaforensic RUPAY STL INTC0912,0.0,48.02,2966362.260000002,2018,12,10,CASH_IN,48.02,C2078250226
7622,409000493210',2018-12-10,Indiaforensic RUPAY SETT 101218,12647.2,0.0,2953715.0600000015,2018,12,10,CASH_OUT,12647.2,C1838584624
7623,409000493210',2018-12-10,Indiaforensic RUPAY SETT 101218,0.0,108.6,2953823.660000001,2018,12,10,CHECK_CASHING,108.6,C968448640
7624,409000493210',2018-12-10,Indiaforensic RUPAY STL INTC1012,100.73,0.0,2953722.930000002,2018,12,10,DEBIT,100.73,C146305349
7625,409000493210',2018-12-10,Indiaforensic RUPAY STL INTC1012,0.0,0.03,2953722.9600000014,2018,12,10,TRANSFER,0.03,C1883840933
7626,409000493210',2018-12-10,Indiaforensic RUPAY SETT 101218-,12378.71,0.0,2941344.2500000014,2018,12,10,PAYEMENT,12378.71,C1587143371
7627,409000493210',2018-12-10,Indiaforensic RUPAY SETT 101218-,0.0,41.67,2941385.9200000013,2018,12,10,CHECK_CASHING,41.67,C481402298
7628,409000493210',2018-12-10,Indiaforensic RUPAY STL INTC1012,41.67,0.0,2941344.2500000014,2018,12,10,CHECK_WITHDRAWAL,41.67,C667346055
7629,409000493210',2018-12-10,Indiaforensic NFS SETT 06-12-201,10000.0,0.0,2931344.2500000014,2018,12,10,DEBIT,10000.0,C836514715
7630,409000493210',2018-12-10,Indiaforensic NFS SETT 06-12-201,8000.0,0.0,2923344.2500000014,2018,12,10,CHECK_WITHDRAWAL,8000.0,C1047634424
7631,409000493210',2018-12-10,Indiaforensic NFS SETT 06-12-201,10000.0,0.0,2913344.2500000014,2018,12,10,CASH_OUT,10000.0,C400720732
7632,409000493210',2018-12-10,Indiaforensic NFS SETT 06-12-201,8000.0,0.0,2905344.2500000014,2018,12,10,DEBIT,8000.0,C932583850
7633,409000493210',2018-12-10,Indiaforensic NFS SETT 06-12-201,8000.0,0.0,2897344.2500000014,2018,12,10,DEBIT,8000.0,C1805683209
7634,409000493210',2018-12-10,Indiaforensic NFS SETT 06-12-201,9000.0,0.0,2888344.2500000014,2018,12,10,CASH_OUT,9000.0,C804836251
7635,409000493210',2018-12-10,Indiaforensic NFS SETT 06-12-201,10000.0,0.0,2878344.2500000014,2018,12,10,DEBIT,10000.0,C177368500
7636,409000493210',2018-12-10,Indiaforensic NFS SETT 06-12-201,2000.0,0.0,2876344.2500000014,2018,12,10,DEBIT,2000.0,C2052185144
7637,409000493210',2018-12-10,Indiaforensic NFS SETT 06-12-201,10000.0,0.0,2866344.2500000014,2018,12,10,CHECK_WITHDRAWAL,10000.0,C1339257929
7638,409000493210',2018-12-11,Indiaforensic  RUPAY SETT 111218,4730.26,0.0,2861613.990000002,2018,12,11,PAYEMENT,4730.26,C392292416
7639,409000493210',2018-12-11,Indiaforensic  RUPAY SETT 111218,0.0,62.19,2861676.180000002,2018,12,11,TRANSFER,62.19,C1206868531
7640,409000493210',2018-12-11,Indiaforensic RUPAY STL INTC1112,25.36,0.0,2861650.8200000017,2018,12,11,CASH_OUT,25.36,C500058139
7641,409000493210',2018-12-11,Indiaforensic RUPAY STL INTC1112,0.0,0.23,2861651.0500000017,2018,12,11,CASH_IN,0.23,C297785169
7642,409000493210',2018-12-11,Indiaforensic  RUPAY SETT 111218,3859.73,0.0,2857791.3200000017,2018,12,11,CASH_OUT,3859.73,M461634243
7643,409000493210',2018-12-11,Indiaforensic  RUPAY SETT 111218,0.0,31.18,2857822.500000002,2018,12,11,TRANSFER,31.18,M1973179365
7644,409000493210',2018-12-11,Indiaforensic RUPAY STL INTC1112,28.76,0.0,2857793.740000002,2018,12,11,PAYEMENT,28.76,C1234059684
7645,409000493210',2018-12-11,Indiaforensic RUPAY STL INTC1112,0.0,0.01,2857793.750000002,2018,12,11,CASH_IN,0.01,M1048559742
7646,409000493210',2018-12-11,Indiaforensic NFS SETT 07-12-201,6000.0,0.0,2851793.750000002,2018,12,11,CHECK_WITHDRAWAL,6000.0,C149474995
7647,409000493210',2018-12-11,Indiaforensic NFS SETT 07-12-201,8500.0,0.0,2843293.750000002,2018,12,11,CHECK_WITHDRAWAL,8500.0,C301749835
7648,409000493210',2018-12-11,Indiaforensic NFS SETT 07-12-201,3000.0,0.0,2840293.750000002,2018,12,11,CHECK_WITHDRAWAL,3000.0,M1621023573
7649,409000493210',2018-12-11,Indiaforensic NFS SETT 07-12-201,500.0,0.0,2839793.750000002,2018,12,11,CHECK_WITHDRAWAL,500.0,C1554565380
7650,409000493210',2018-12-11,Indiaforensic NFS SETT 07-12-201,5000.0,0.0,2834793.750000002,2018,12,11,PAYEMENT,5000.0,M892589968
7651,409000493210',2018-12-11,Indiaforensic NFS SETT 07-12-201,500.0,0.0,2834293.750000002,2018,12,11,CHECK_WITHDRAWAL,500.0,C1750905143
7652,409000493210',2018-12-11,Indiaforensic NFS SETT 07-12-201,200.0,0.0,2834093.750000002,2018,12,11,CHECK_WITHDRAWAL,200.0,M440033814
7653,409000493210',2018-12-11,Indiaforensic NFS SETT 07-12-201,200.0,0.0,2833893.750000002,2018,12,11,DEBIT,200.0,C914293025
7654,409000493210',2018-12-11,Indiaforensic NFS SETT 07-12-201,9000.0,0.0,2824893.750000002,2018,12,11,CHECK_WITHDRAWAL,9000.0,M230836018
7655,409000493210',2018-12-11,Indiaforensic NFS SETT 07-12-201,8000.0,0.0,2816893.750000002,2018,12,11,PAYEMENT,8000.0,C2100440237
7656,409000493210',2018-12-11,Indiaforensic NFS SETT 07-12-201,8500.0,0.0,2808393.750000002,2018,12,11,PAYEMENT,8500.0,M26462224
7657,409000493210',2018-12-11,Indiaforensic NFS SETT 07-12-201,10000.0,0.0,2798393.750000002,2018,12,11,DEBIT,10000.0,M1475213961
7658,409000493210',2018-12-11,Indiaforensic NFS SETT 07-12-201,1000.0,0.0,2797393.750000002,2018,12,11,CHECK_WITHDRAWAL,1000.0,C257999182
7659,409000493210',2018-12-11,Indiaforensic NFS SETT 07-12-201,10000.0,0.0,2787393.750000002,2018,12,11,PAYEMENT,10000.0,M1387756894
7660,409000493210',2018-12-11,Indiaforensic NFS SETT 07-12-201,10000.0,0.0,2777393.750000002,2018,12,11,CASH_OUT,10000.0,M1497982409
7661,409000493210',2018-12-11,Indiaforensic NFS SETT 07-12-201,400.0,0.0,2776993.750000002,2018,12,11,CHECK_WITHDRAWAL,400.0,C1255024717
7662,409000493210',2018-12-11,Indiaforensic NFS SETT 07-12-201,300.0,0.0,2776693.750000002,2018,12,11,PAYEMENT,300.0,C2059996587
7663,409000493210',2018-12-11,Indiaforensic NFS SETT 07-12-201,8000.0,0.0,2768693.750000002,2018,12,11,CHECK_WITHDRAWAL,8000.0,M939294268
7664,409000493210',2018-12-11,Indiaforensic NFS SETT 07-12-201,10000.0,0.0,2758693.750000002,2018,12,11,PAYEMENT,10000.0,C1859965144
7665,409000493210',2018-12-11,Indiaforensic NFS SETT 07-12-201,5000.0,0.0,2753693.750000002,2018,12,11,DEBIT,5000.0,C1299829127
7666,409000493210',2018-12-11,Indiaforensic NFS SETT 07-12-201,5000.0,0.0,2748693.750000002,2018,12,11,PAYEMENT,5000.0,M1076879089
7667,409000493210',2018-12-11,Indiaforensic NFS SETT 07-12-201,10000.0,0.0,2738693.750000002,2018,12,11,CHECK_WITHDRAWAL,10000.0,M269724308
7668,409000493210',2018-12-11,Indiaforensic NFS SETT 07-12-201,1000.0,0.0,2737693.750000002,2018,12,11,DEBIT,1000.0,M140222364
7669,409000493210',2018-12-11,Indiaforensic NFS SETT 07-12-201,400.0,0.0,2737293.750000002,2018,12,11,CHECK_WITHDRAWAL,400.0,M728386983
7670,409000493210',2018-12-11,Indiaforensic NFS SETT 07-12-201,9600.0,0.0,2727693.750000002,2018,12,11,CASH_OUT,9600.0,M558201620
7671,409000493210',2018-12-11,Indiaforensic NFS SETT 07-12-201,7000.0,0.0,2720693.750000002,2018,12,11,DEBIT,7000.0,M2115692179
7672,409000493210',2018-12-11,Indiaforensic NFS SETT 07-12-201,500.0,0.0,2720193.750000002,2018,12,11,CASH_OUT,500.0,M873546155
7673,409000493210',2018-12-11,Indiaforensic NFS SETT 07-12-201,8000.0,0.0,2712193.750000002,2018,12,11,CASH_OUT,8000.0,M1056221435
7674,409000493210',2018-12-11,Indiaforensic NFS SETT 07-12-201,5000.0,0.0,2707193.750000002,2018,12,11,CHECK_WITHDRAWAL,5000.0,M249270028
7675,409000493210',2018-12-11,Indiaforensic NFS SETT 07-12-201,10000.0,0.0,2697193.750000002,2018,12,11,CHECK_WITHDRAWAL,10000.0,M492815168
7676,409000493210',2018-12-11,Indiaforensic NFS SETT 07-12-201,3600.0,0.0,2693593.750000002,2018,12,11,CASH_OUT,3600.0,M869140506
7677,409000493210',2018-12-11,Indiaforensic NFS SETT 07-12-201,8800.0,0.0,2684793.750000002,2018,12,11,CASH_OUT,8800.0,C798678484
7678,409000493210',2018-12-11,Indiaforensic NFS SETT 07-12-201,10000.0,0.0,2674793.750000002,2018,12,11,DEBIT,10000.0,M1975716431
7679,409000493210',2018-12-11,Indiaforensic NFS SETT 07-12-201,8900.0,0.0,2665893.750000002,2018,12,11,PAYEMENT,8900.0,M28376203
7680,409000493210',2018-12-11,Indiaforensic NFS SETT 07-12-201,4000.0,0.0,2661893.750000002,2018,12,11,CHECK_WITHDRAWAL,4000.0,M213560315
7681,409000493210',2018-12-11,Indiaforensic NFS SETT 07-12-201,8800.0,0.0,2653093.750000002,2018,12,11,CHECK_WITHDRAWAL,8800.0,M1320400528
7682,409000493210',2018-12-11,Indiaforensic NFS SETT 07-12-201,2000.0,0.0,2651093.750000002,2018,12,11,DEBIT,2000.0,M1153269540
7683,409000493210',2018-12-11,Indiaforensic NFS SETT 07-12-201,5000.0,0.0,2646093.750000002,2018,12,11,DEBIT,5000.0,M1438092717
7684,409000493210',2018-12-11,Indiaforensic NFS SETT 07-12-201,7700.0,0.0,2638393.750000002,2018,12,11,PAYEMENT,7700.0,M1755303688
7685,409000493210',2018-12-11,Indiaforensic NFS SETT 07-12-201,4500.0,0.0,2633893.750000002,2018,12,11,CHECK_WITHDRAWAL,4500.0,M439513824
7686,409000493210',2018-12-11,Indiaforensic NFS SETT 07-12-201,2000.0,0.0,2631893.750000002,2018,12,11,DEBIT,2000.0,M1840423520
7687,409000493210',2018-12-11,Indiaforensic NFS SETT 07-12-201,9600.0,0.0,2622293.750000002,2018,12,11,PAYEMENT,9600.0,M502851205
7688,409000493210',2018-12-11,Indiaforensic NFS SETT 07-12-201,5000.0,0.0,2617293.750000002,2018,12,11,CHECK_WITHDRAWAL,5000.0,M11221844
7689,409000493210',2018-12-11,Indiaforensic NFS SETT 07-12-201,7500.0,0.0,2609793.750000002,2018,12,11,DEBIT,7500.0,M1874869494
7690,409000493210',2018-12-11,Indiaforensic NFS SETT 07-12-201,8900.0,0.0,2600893.750000002,2018,12,11,CASH_OUT,8900.0,M1607463538
7691,409000493210',2018-12-11,Indiaforensic NFS SETT 07-12-201,6900.0,0.0,2593993.750000002,2018,12,11,PAYEMENT,6900.0,M890560397
7692,409000493210',2018-12-11,Indiaforensic NFS SETT 07-12-201,5000.0,0.0,2588993.750000002,2018,12,11,DEBIT,5000.0,M737301055
7693,409000493210',2018-12-11,Indiaforensic NFS SETT 07-12-201,8500.0,0.0,2580493.750000002,2018,12,11,DEBIT,8500.0,C36437323
7694,409000493210',2018-12-11,Indiaforensic NFS SETT 07-12-201,8000.0,0.0,2572493.750000002,2018,12,11,CHECK_WITHDRAWAL,8000.0,M1879362884
7695,409000493210',2018-12-11,Indiaforensic NFS SETT 07-12-201,8700.0,0.0,2563793.750000002,2018,12,11,CASH_OUT,8700.0,M1299436497
7696,409000493210',2018-12-11,Indiaforensic NFS SETT 07-12-201,2000.0,0.0,2561793.750000002,2018,12,11,DEBIT,2000.0,C1262822392
7697,409000493210',2018-12-11,Indiaforensic NFS SETT 07-12-201,8700.0,0.0,2553093.750000002,2018,12,11,PAYEMENT,8700.0,M1862757459
7698,409000493210',2018-12-11,Indiaforensic NFS SETT 07-12-201,300.0,0.0,2552793.750000002,2018,12,11,PAYEMENT,300.0,C11003494
7699,409000493210',2018-12-11,Indiaforensic NFS SETT 07-12-201,500.0,0.0,2552293.750000002,2018,12,11,PAYEMENT,500.0,C1880332929
7700,409000493210',2018-12-11,Indiaforensic NFS SETT 07-12-201,2000.0,0.0,2550293.750000002,2018,12,11,DEBIT,2000.0,C2083562754
7701,409000493210',2018-12-11,Indiaforensic NFS SETT 07-12-201,10000.0,0.0,2540293.750000002,2018,12,11,PAYEMENT,10000.0,C183354406
7702,409000493210',2018-12-11,Indiaforensic NFS SETT 07-12-201,1000.0,0.0,2539293.750000002,2018,12,11,PAYEMENT,1000.0,C1674899618
7703,409000493210',2018-12-11,Indiaforensic NFS SETT 07-12-201,6000.0,0.0,2533293.750000002,2018,12,11,PAYEMENT,6000.0,C248609774
7704,409000493210',2018-12-11,Indiaforensic NFS SETT 07-12-201,9500.0,0.0,2523793.750000002,2018,12,11,CHECK_WITHDRAWAL,9500.0,C1730752455
7705,409000493210',2018-12-11,Indiaforensic NFS SETT 07-12-201,9500.0,0.0,2514293.750000002,2018,12,11,PAYEMENT,9500.0,C1883840933
7706,409000493210',2018-12-11,Indiaforensic NFS SETT 07-12-201,9500.0,0.0,2504793.750000002,2018,12,11,CHECK_WITHDRAWAL,9500.0,M152834486
7707,409000493210',2018-12-11,Indiaforensic NFS SETT 07-12-201,9300.0,0.0,2495493.750000002,2018,12,11,DEBIT,9300.0,M503144483
7708,409000493210',2018-12-11,Indiaforensic NFS SETT 07-12-201,6000.0,0.0,2489493.750000002,2018,12,11,CASH_OUT,6000.0,C854671988
7709,409000493210',2018-12-11,Indiaforensic NFS SETT 07-12-201,10000.0,0.0,2479493.750000002,2018,12,11,CASH_OUT,10000.0,M934117774
7710,409000493210',2018-12-11,Indiaforensic NFS SETT 07-12-201,3000.0,0.0,2476493.750000002,2018,12,11,CASH_OUT,3000.0,M975733206
7711,409000493210',2018-12-11,Indiaforensic NFS SETT 07-12-201,10000.0,0.0,2466493.750000002,2018,12,11,CASH_OUT,10000.0,C769342184
7712,409000493210',2018-12-11,Indiaforensic NFS SETT 07-12-201,7300.0,0.0,2459193.750000002,2018,12,11,DEBIT,7300.0,C1805683209
7713,409000493210',2018-12-11,Indiaforensic NFS SETT 08-12-201,5000.0,0.0,2454193.750000002,2018,12,11,CASH_OUT,5000.0,C991505714
7714,409000493210',2018-12-11,Indiaforensic NFS SETT 08-12-201,100.0,0.0,2454093.750000002,2018,12,11,CHECK_WITHDRAWAL,100.0,C803116137
7715,409000493210',2018-12-11,Indiaforensic NFS SETT 08-12-201,10000.0,0.0,2444093.750000002,2018,12,11,PAYEMENT,10000.0,C1554540309
7716,409000493210',2018-12-11,Indiaforensic NFS SETT 08-12-201,10000.0,0.0,2434093.750000002,2018,12,11,DEBIT,10000.0,C481402298
7717,409000493210',2018-12-11,Indiaforensic NFS SETT 08-12-201,1000.0,0.0,2433093.750000002,2018,12,11,CHECK_WITHDRAWAL,1000.0,C1286084959
7718,409000493210',2018-12-11,Indiaforensic NFS SETT 08-12-201,4500.0,0.0,2428593.750000002,2018,12,11,DEBIT,4500.0,C1477979030
7719,409000493210',2018-12-11,Indiaforensic NFS SETT 08-12-201,300.0,0.0,2428293.750000002,2018,12,11,PAYEMENT,300.0,C309167705
7720,409000493210',2018-12-11,Indiaforensic NFS SETT 08-12-201,8500.0,0.0,2419793.750000002,2018,12,11,PAYEMENT,8500.0,C1730752455
7721,409000493210',2018-12-11,Indiaforensic NFS SETT 08-12-201,10000.0,0.0,2409793.750000002,2018,12,11,PAYEMENT,10000.0,C242131142
7722,409000493210',2018-12-11,Indiaforensic NFS SETT 08-12-201,6000.0,0.0,2403793.750000002,2018,12,11,DEBIT,6000.0,M353825943
7723,409000493210',2018-12-11,Indiaforensic NFS SETT 08-12-201,9500.0,0.0,2394293.750000002,2018,12,11,CASH_OUT,9500.0,M1293962032
7724,409000493210',2018-12-11,Indiaforensic NFS SETT 08-12-201,10000.0,0.0,2384293.750000002,2018,12,11,CASH_OUT,10000.0,C529351377
7725,409000493210',2018-12-11,Indiaforensic NFS SETT 08-12-201,8300.0,0.0,2375993.750000002,2018,12,11,DEBIT,8300.0,M1134231960
7726,409000493210',2018-12-11,Indiaforensic NFS SETT 08-12-201,8000.0,0.0,2367993.750000002,2018,12,11,PAYEMENT,8000.0,M1817055696
7727,409000493210',2018-12-11,Indiaforensic NFS SETT 08-12-201,8500.0,0.0,2359493.750000002,2018,12,11,PAYEMENT,8500.0,M847568453
7728,409000493210',2018-12-11,Indiaforensic NFS SETT 08-12-201,10000.0,0.0,2349493.750000002,2018,12,11,PAYEMENT,10000.0,M1338826013
7729,409000493210',2018-12-11,Indiaforensic NFS SETT 08-12-201,200.0,0.0,2349293.750000002,2018,12,11,CHECK_WITHDRAWAL,200.0,M916608087
7730,409000493210',2018-12-11,Indiaforensic NFS SETT 08-12-201,3000.0,0.0,2346293.750000002,2018,12,11,PAYEMENT,3000.0,M1213794377
7731,409000493210',2018-12-11,Indiaforensic NFS SETT 08-12-201,7000.0,0.0,2339293.750000002,2018,12,11,CASH_OUT,7000.0,C97730845
7732,409000493210',2018-12-11,Indiaforensic NFS SETT 08-12-201,2000.0,0.0,2337293.750000002,2018,12,11,DEBIT,2000.0,M153337703
7733,409000493210',2018-12-11,Indiaforensic NFS SETT 08-12-201,3000.0,0.0,2334293.750000002,2018,12,11,CHECK_WITHDRAWAL,3000.0,M571309751
7734,409000493210',2018-12-11,Indiaforensic NFS SETT 08-12-201,6000.0,0.0,2328293.750000002,2018,12,11,DEBIT,6000.0,M517608115
7735,409000493210',2018-12-11,Indiaforensic NFS SETT 08-12-201,7600.0,0.0,2320693.750000002,2018,12,11,DEBIT,7600.0,C1028574311
7736,409000493210',2018-12-11,Indiaforensic NFS SETT 08-12-201,100.0,0.0,2320593.750000002,2018,12,11,DEBIT,100.0,M570008325
7737,409000493210',2018-12-11,Indiaforensic NFS SETT 08-12-201,100.0,0.0,2320493.750000002,2018,12,11,PAYEMENT,100.0,M179258229
7738,409000493210',2018-12-11,Indiaforensic NFS SETT 08-12-201,100.0,0.0,2320393.750000002,2018,12,11,PAYEMENT,100.0,M1135030031
7739,409000493210',2018-12-11,Indiaforensic NFS SETT 08-12-201,2000.0,0.0,2318393.750000002,2018,12,11,DEBIT,2000.0,M531068784
7740,409000493210',2018-12-11,Indiaforensic NFS SETT 08-12-201,8500.0,0.0,2309893.750000002,2018,12,11,PAYEMENT,8500.0,M416692630
7741,409000493210',2018-12-11,Indiaforensic NFS SETT 09-12-201,8000.0,0.0,2301893.750000002,2018,12,11,CHECK_WITHDRAWAL,8000.0,M1246962289
7742,409000493210',2018-12-11,Indiaforensic NFS SETT 09-12-201,400.0,0.0,2301493.750000002,2018,12,11,DEBIT,400.0,M469765167
7743,409000493210',2018-12-11,Indiaforensic NFS SETT 09-12-201,8500.0,0.0,2292993.750000002,2018,12,11,CASH_OUT,8500.0,M2137601740
7744,409000493210',2018-12-11,Indiaforensic NFS SETT 09-12-201,5000.0,0.0,2287993.750000002,2018,12,11,DEBIT,5000.0,M1254252690
7745,409000493210',2018-12-11,Indiaforensic NFS SETT 09-12-201,1000.0,0.0,2286993.750000002,2018,12,11,PAYEMENT,1000.0,M115857872
7746,409000493210',2018-12-11,Indiaforensic NFS SETT 09-12-201,2000.0,0.0,2284993.750000002,2018,12,11,PAYEMENT,2000.0,M1913827982
7747,409000493210',2018-12-11,Indiaforensic NFS SETT 09-12-201,8000.0,0.0,2276993.750000002,2018,12,11,CASH_OUT,8000.0,C343534938
7748,409000493210',2018-12-11,Indiaforensic NFS SETT 09-12-201,400.0,0.0,2276593.750000002,2018,12,11,DEBIT,400.0,C465499079
7749,409000493210',2018-12-11,Indiaforensic NFS SETT 09-12-201,1000.0,0.0,2275593.750000002,2018,12,11,PAYEMENT,1000.0,C339099861
7750,409000493210',2018-12-11,Indiaforensic NFS SETT 09-12-201,1200.0,0.0,2274393.750000002,2018,12,11,CASH_OUT,1200.0,C1487669283
7751,409000493210',2018-12-11,Indiaforensic NFS SETT 09-12-201,5000.0,0.0,2269393.750000002,2018,12,11,DEBIT,5000.0,C1931283804
7752,409000493210',2018-12-11,Indiaforensic NFS SETT 09-12-201,500.0,0.0,2268893.750000002,2018,12,11,DEBIT,500.0,C1313534832
7753,409000493210',2018-12-11,Indiaforensic NFS SETT 09-12-201,500.0,0.0,2268393.750000002,2018,12,11,PAYEMENT,500.0,C766681183
7754,409000493210',2018-12-11,Indiaforensic NFS SETT 09-12-201,500.0,0.0,2267893.750000002,2018,12,11,CHECK_WITHDRAWAL,500.0,C465499079
7755,409000493210',2018-12-11,Indiaforensic NFS SETT 09-12-201,500.0,0.0,2267393.750000002,2018,12,11,DEBIT,500.0,C506903242
7756,409000493210',2018-12-11,Indiaforensic NFS SETT 09-12-201,500.0,0.0,2266893.750000002,2018,12,11,DEBIT,500.0,C7881234
7757,409000493210',2018-12-11,Indiaforensic NFS SETT 09-12-201,500.0,0.0,2266393.750000002,2018,12,11,CASH_OUT,500.0,C1120229752
7758,409000493210',2018-12-11,Indiaforensic NFS SETT 09-12-201,2500.0,0.0,2263893.750000002,2018,12,11,CASH_OUT,2500.0,C1933965693
7759,409000493210',2018-12-11,Indiaforensic NFS SETT 09-12-201,5000.0,0.0,2258893.750000002,2018,12,11,CASH_OUT,5000.0,C656977363
7760,409000493210',2018-12-11,Indiaforensic NFS SETT 09-12-201,8300.0,0.0,2250593.750000002,2018,12,11,CHECK_WITHDRAWAL,8300.0,C1750563752
7761,409000493210',2018-12-11,Indiaforensic NFS SETT 09-12-201,100.0,0.0,2250493.750000002,2018,12,11,CHECK_WITHDRAWAL,100.0,C1337563431
7762,409000493210',2018-12-11,Indiaforensic NFS SETT 09-12-201,600.0,0.0,2249893.750000002,2018,12,11,PAYEMENT,600.0,C392292416
7763,409000493210',2018-12-11,Indiaforensic NFS SETT 09-12-201,200.0,0.0,2249693.750000002,2018,12,11,DEBIT,200.0,C1850042097
7764,409000493210',2018-12-11,Indiaforensic NFS SETT 09-12-201,500.0,0.0,2249193.750000002,2018,12,11,PAYEMENT,500.0,C1531333864
7765,409000493210',2018-12-11,Indiaforensic NFS SETT 09-12-201,7400.0,0.0,2241793.750000002,2018,12,11,DEBIT,7400.0,C173783788
7766,409000493210',2018-12-11,Indiaforensic NFS SETT 09-12-201,5000.0,0.0,2236793.750000002,2018,12,11,CASH_OUT,5000.0,C1453795463
7767,409000493210',2018-12-11,Indiaforensic NFS SETT 09-12-201,500.0,0.0,2236293.750000002,2018,12,11,PAYEMENT,500.0,C1899073220
7768,409000493210',2018-12-11,Indiaforensic NFS SETT 09-12-201,400.0,0.0,2235893.750000002,2018,12,11,CHECK_WITHDRAWAL,400.0,C1095575585
7769,409000493210',2018-12-11,Indiaforensic NFS SETT 09-12-201,10000.0,0.0,2225893.750000002,2018,12,11,DEBIT,10000.0,C1334973394
7770,409000493210',2018-12-11,Indiaforensic NFS SETT 09-12-201,4000.0,0.0,2221893.750000002,2018,12,11,PAYEMENT,4000.0,C1515704208
7771,409000493210',2018-12-11,Indiaforensic NFS SETT 09-12-201,4000.0,0.0,2217893.750000002,2018,12,11,CHECK_WITHDRAWAL,4000.0,C1926673338
7772,409000493210',2018-12-12,Indiaforensic RUPAY SETT 121218,3808.64,0.0,2214085.1100000017,2018,12,12,DEBIT,3808.64,C1251686742
7773,409000493210',2018-12-12,Indiaforensic RUPAY SETT 121218,0.0,43.15,2214128.2600000016,2018,12,12,TRANSFER,43.15,C465257140
7774,409000493210',2018-12-12,Indiaforensic RUPAY STL INTC1212,36.77,0.0,2214091.4900000016,2018,12,12,DEBIT,36.77,C1337741679
7775,409000493210',2018-12-12,Indiaforensic RUPAY STL INTC1212,0.0,0.03,2214091.5200000014,2018,12,12,CASH_IN,0.03,C1850180796
7776,409000493210',2018-12-12,Indiaforensic RUPAY SETT 121218-,18014.42,0.0,2196077.100000001,2018,12,12,DEBIT,18014.42,C836514715
7777,409000493210',2018-12-12,Indiaforensic RUPAY SETT 121218-,0.0,192.47,2196269.5700000017,2018,12,12,TRANSFER,192.47,C2072865894
7778,409000493210',2018-12-12,Indiaforensic RUPAY STL INTC1212,192.47,0.0,2196077.100000001,2018,12,12,CASH_OUT,192.47,C295372946
7779,409000493210',2018-12-12,TRF FROM  Indiaforensic SERVICES,0.0,115000.0,2311077.100000001,2018,12,12,CASH_IN,115000.0,C745740822
7780,409000493210',2018-12-13,Indiaforensic  RUPAY SETT 131218,5739.69,0.0,2305337.410000001,2018,12,13,PAYEMENT,5739.69,C665576141
7781,409000493210',2018-12-13,Indiaforensic  RUPAY SETT 131218,0.0,43.99,2305381.400000002,2018,12,13,CHECK_CASHING,43.99,C1951379728
7782,409000493210',2018-12-13,Indiaforensic RUPAY STL INTC1312,42.11,0.0,2305339.290000002,2018,12,13,PAYEMENT,42.11,C1782113663
7783,409000493210',2018-12-13,Indiaforensic RUPAY STL INTC1312,0.0,0.01,2305339.3000000017,2018,12,13,CHECK_CASHING,0.01,C1339257929
7784,409000493210',2018-12-13,Indiaforensic  RUPAY SETT 131218,885.91,0.0,2304453.390000001,2018,12,13,PAYEMENT,885.91,C619120762
7785,409000493210',2018-12-13,Indiaforensic  RUPAY SETT 131218,0.0,12.0,2304465.390000001,2018,12,13,TRANSFER,12.0,C2140846441
7786,409000493210',2018-12-13,Indiaforensic RUPAY STL INTC1312,9.75,0.0,2304455.640000001,2018,12,13,CHECK_WITHDRAWAL,9.75,C1167066016
7787,409000493210',2018-12-13,Indiaforensic RUPAY STL INTC1312,0.0,0.01,2304455.6500000013,2018,12,13,CASH_IN,0.01,C1922859107
7788,409000493210',2018-12-13,Indiaforensic NFS SETT 11-12-201,2500.0,0.0,2301955.6500000013,2018,12,13,DEBIT,2500.0,C517653428
7789,409000493210',2018-12-13,Indiaforensic NFS SETT 11-12-201,2500.0,0.0,2299455.6500000013,2018,12,13,CASH_OUT,2500.0,C1674899618
7790,409000493210',2018-12-13,Indiaforensic NFS SETT 11-12-201,6700.0,0.0,2292755.6500000013,2018,12,13,CHECK_WITHDRAWAL,6700.0,C1379031360
7791,409000493210',2018-12-13,Indiaforensic NFS SETT 11-12-201,1000.0,0.0,2291755.6500000013,2018,12,13,PAYEMENT,1000.0,C1060041730
7792,409000493210',2018-12-13,Indiaforensic NFS SETT 11-12-201,10000.0,0.0,2281755.6500000013,2018,12,13,CHECK_WITHDRAWAL,10000.0,C2034460325
7793,409000493210',2018-12-13,Indiaforensic NFS SETT 11-12-201,9500.0,0.0,2272255.6500000013,2018,12,13,DEBIT,9500.0,C1354725727
7794,409000493210',2018-12-13,Indiaforensic NFS SETT 11-12-201,8000.0,0.0,2264255.6500000013,2018,12,13,CASH_OUT,8000.0,M1625676573
7795,409000493210',2018-12-13,Indiaforensic NFS SETT 11-12-201,8000.0,0.0,2256255.6500000013,2018,12,13,CHECK_WITHDRAWAL,8000.0,M854246299
7796,409000493210',2018-12-13,Indiaforensic NFS SETT 11-12-201,2000.0,0.0,2254255.6500000013,2018,12,13,DEBIT,2000.0,M8633259
7797,409000493210',2018-12-13,Indiaforensic NFS SETT 11-12-201,7000.0,0.0,2247255.6500000013,2018,12,13,CHECK_WITHDRAWAL,7000.0,M52439501
7798,409000493210',2018-12-13,Indiaforensic NFS SETT 11-12-201,5000.0,0.0,2242255.6500000013,2018,12,13,PAYEMENT,5000.0,M1438317505
7799,409000493210',2018-12-13,Indiaforensic NFS SETT 11-12-201,8000.0,0.0,2234255.6500000013,2018,12,13,PAYEMENT,8000.0,M651177414
7800,409000493210',2018-12-13,Indiaforensic NFS SETT 11-12-201,500.0,0.0,2233755.6500000013,2018,12,13,CHECK_WITHDRAWAL,500.0,M649154765
7801,409000493210',2018-12-13,Indiaforensic NFS SETT 11-12-201,500.0,0.0,2233255.6500000013,2018,12,13,PAYEMENT,500.0,M1172737964
7802,409000493210',2018-12-13,Indiaforensic NFS SETT 11-12-201,200.0,0.0,2233055.6500000013,2018,12,13,CASH_OUT,200.0,M1932244125
7803,409000493210',2018-12-13,Indiaforensic NFS SETT 11-12-201,10000.0,0.0,2223055.6500000013,2018,12,13,PAYEMENT,10000.0,M430231018
7804,409000493210',2018-12-13,Indiaforensic NFS SETT 11-12-201,6000.0,0.0,2217055.6500000013,2018,12,13,PAYEMENT,6000.0,M1844179384
7805,409000493210',2018-12-13,Indiaforensic NFS SETT 11-12-201,500.0,0.0,2216555.6500000013,2018,12,13,CASH_OUT,500.0,C1494895909
7806,409000493210',2018-12-13,Indiaforensic NFS SETT 11-12-201,1000.0,0.0,2215555.6500000013,2018,12,13,CASH_OUT,1000.0,C317071334
7807,409000493210',2018-12-13,Indiaforensic NFS SETT 11-12-201,8200.0,0.0,2207355.6500000013,2018,12,13,CASH_OUT,8200.0,C313124964
7808,409000493210',2018-12-13,Indiaforensic NFS SETT 11-12-201,10000.0,0.0,2197355.6500000013,2018,12,13,PAYEMENT,10000.0,C292665982
7809,409000493210',2018-12-13,Indiaforensic NFS SETT 11-12-201,2500.0,0.0,2194855.6500000013,2018,12,13,PAYEMENT,2500.0,C214774813
7810,409000493210',2018-12-13,Indiaforensic NFS SETT 10-12-201,6000.0,0.0,2188855.6500000013,2018,12,13,DEBIT,6000.0,C1083142315
7811,409000493210',2018-12-13,Indiaforensic NFS SETT 10-12-201,1000.0,0.0,2187855.6500000013,2018,12,13,CHECK_WITHDRAWAL,1000.0,C1827910615
7812,409000493210',2018-12-13,Indiaforensic NFS SETT 10-12-201,1500.0,0.0,2186355.6500000013,2018,12,13,DEBIT,1500.0,C1438780049
7813,409000493210',2018-12-13,Indiaforensic NFS SETT 10-12-201,5000.0,0.0,2181355.6500000013,2018,12,13,CASH_OUT,5000.0,C1191924243
7814,409000493210',2018-12-13,Indiaforensic NFS SETT 10-12-201,2000.0,0.0,2179355.6500000013,2018,12,13,CHECK_WITHDRAWAL,2000.0,C301749835
7815,409000493210',2018-12-13,Indiaforensic NFS SETT 10-12-201,7000.0,0.0,2172355.6500000013,2018,12,13,PAYEMENT,7000.0,C305646302
7816,409000493210',2018-12-13,Indiaforensic NFS SETT 10-12-201,3000.0,0.0,2169355.6500000013,2018,12,13,CASH_OUT,3000.0,M1226784688
7817,409000493210',2018-12-13,Indiaforensic NFS SETT 10-12-201,10000.0,0.0,2159355.6500000013,2018,12,13,CASH_OUT,10000.0,C1303868418
7818,409000493210',2018-12-13,Indiaforensic NFS SETT 10-12-201,6000.0,0.0,2153355.6500000013,2018,12,13,DEBIT,6000.0,M727095384
7819,409000493210',2018-12-13,Indiaforensic NFS SETT 10-12-201,4000.0,0.0,2149355.6500000013,2018,12,13,DEBIT,4000.0,M1104718965
7820,409000493210',2018-12-13,Indiaforensic NFS SETT 10-12-201,9800.0,0.0,2139555.6500000013,2018,12,13,PAYEMENT,9800.0,C1805683209
7821,409000493210',2018-12-13,Indiaforensic NFS SETT 10-12-201,10000.0,0.0,2129555.6500000013,2018,12,13,CHECK_WITHDRAWAL,10000.0,M1009677262
7822,409000493210',2018-12-13,Indiaforensic NFS SETT 10-12-201,1900.0,0.0,2127655.6500000013,2018,12,13,CASH_OUT,1900.0,M1249347907
7823,409000493210',2018-12-14,Indiaforensic  RUPAY SETT 141218,810.89,0.0,2126844.7600000007,2018,12,14,PAYEMENT,810.89,M911887259
7824,409000493210',2018-12-14,Indiaforensic RUPAY STL INTC1412,8.1,0.0,2126836.660000001,2018,12,14,PAYEMENT,8.1,C773898763
7825,409000493210',2018-12-14,Indiaforensic  RUPAY SETT 141218,0.0,14.0,2126850.660000001,2018,12,14,TRANSFER,14.0,C1529639302
7826,409000493210',2018-12-14,Indiaforensic RUPAY STL INTC1412,0.0,0.02,2126850.680000001,2018,12,14,CASH_IN,0.02,C1167066016
7827,409000493210',2018-12-14,TRF FROM  Indiaforensic SERVICES,0.0,200000.0,2326850.680000001,2018,12,14,CASH_IN,200000.0,C2057394816
7828,409000493210',2018-12-14,Indiaforensic  RUPAY SETT 141218,7277.25,0.0,2319573.430000001,2018,12,14,CASH_OUT,7277.25,M1875112359
7829,409000493210',2018-12-14,Indiaforensic  RUPAY SETT 141218,0.0,58.56,2319631.990000001,2018,12,14,TRANSFER,58.56,M525953416
7830,409000493210',2018-12-14,Indiaforensic RUPAY STL INTC1412,58.56,0.0,2319573.430000001,2018,12,14,CASH_OUT,58.56,M466473730
7831,409000493210',2018-12-14,Indiaforensic NFS SETT 12-12-201,6000.0,0.0,2313573.430000001,2018,12,14,DEBIT,6000.0,C7881234
7832,409000493210',2018-12-14,Indiaforensic NFS SETT 12-12-201,4400.0,0.0,2309173.430000001,2018,12,14,CASH_OUT,4400.0,C991363637
7833,409000493210',2018-12-14,Indiaforensic NFS SETT 12-12-201,5000.0,0.0,2304173.430000001,2018,12,14,PAYEMENT,5000.0,M883196624
7834,409000493210',2018-12-14,Indiaforensic NFS SETT 12-12-201,1000.0,0.0,2303173.430000001,2018,12,14,PAYEMENT,1000.0,M1765405066
7835,409000493210',2018-12-14,Indiaforensic NFS SETT 12-12-201,500.0,0.0,2302673.430000001,2018,12,14,CASH_OUT,500.0,M413088973
7836,409000493210',2018-12-14,Indiaforensic NFS SETT 12-12-201,8500.0,0.0,2294173.430000001,2018,12,14,CASH_OUT,8500.0,M136544977
7837,409000493210',2018-12-14,Indiaforensic NFS SETT 12-12-201,2000.0,0.0,2292173.430000001,2018,12,14,CASH_OUT,2000.0,M227158811
7838,409000493210',2018-12-14,Indiaforensic NFS SETT 12-12-201,10000.0,0.0,2282173.430000001,2018,12,14,CHECK_WITHDRAWAL,10000.0,C875917495
7839,409000493210',2018-12-14,Indiaforensic NFS SETT 12-12-201,5000.0,0.0,2277173.430000001,2018,12,14,CASH_OUT,5000.0,M1335794721
7840,409000493210',2018-12-14,Indiaforensic NFS SETT 12-12-201,2000.0,0.0,2275173.430000001,2018,12,14,PAYEMENT,2000.0,C1339257929
7841,409000493210',2018-12-14,Indiaforensic NFS SETT 12-12-201,2000.0,0.0,2273173.430000001,2018,12,14,PAYEMENT,2000.0,M242596583
7842,409000493210',2018-12-14,Indiaforensic NFS SETT 12-12-201,3000.0,0.0,2270173.430000001,2018,12,14,CASH_OUT,3000.0,C1046160944
7843,409000493210',2018-12-14,Indiaforensic NFS SETT 12-12-201,4000.0,0.0,2266173.430000001,2018,12,14,PAYEMENT,4000.0,M1328224815
7844,409000493210',2018-12-14,Indiaforensic NFS SETT 12-12-201,9000.0,0.0,2257173.430000001,2018,12,14,DEBIT,9000.0,M1394617094
7845,409000493210',2018-12-14,Indiaforensic NFS SETT 12-12-201,5000.0,0.0,2252173.430000001,2018,12,14,DEBIT,5000.0,C124540047
7846,409000493210',2018-12-14,Indiaforensic NFS SETT 12-12-201,5500.0,0.0,2246673.430000001,2018,12,14,CASH_OUT,5500.0,M1851652465
7847,409000493210',2018-12-14,Indiaforensic NFS SETT 12-12-201,4500.0,0.0,2242173.430000001,2018,12,14,CASH_OUT,4500.0,M748971195
7848,409000493210',2018-12-14,Indiaforensic NFS SETT 12-12-201,500.0,0.0,2241673.430000001,2018,12,14,CHECK_WITHDRAWAL,500.0,M1190150603
7849,409000493210',2018-12-14,Indiaforensic NFS SETT 12-12-201,10000.0,0.0,2231673.430000001,2018,12,14,PAYEMENT,10000.0,M1228179933
7850,409000493210',2018-12-14,Indiaforensic NFS SETT 12-12-201,1000.0,0.0,2230673.430000001,2018,12,14,PAYEMENT,1000.0,C1825992554
7851,409000493210',2018-12-14,Indiaforensic NFS SETT 12-12-201,7000.0,0.0,2223673.430000001,2018,12,14,CHECK_WITHDRAWAL,7000.0,M1680568790
7852,409000493210',2018-12-14,Indiaforensic NFS SETT 12-12-201,10000.0,0.0,2213673.430000001,2018,12,14,CASH_OUT,10000.0,M2123460034
7853,409000493210',2018-12-14,Indiaforensic NFS SETT 12-12-201,2000.0,0.0,2211673.430000001,2018,12,14,CHECK_WITHDRAWAL,2000.0,M629314014
7854,409000493210',2018-12-14,Indiaforensic NFS SETT 12-12-201,500.0,0.0,2211173.430000001,2018,12,14,CHECK_WITHDRAWAL,500.0,C374625527
7855,409000493210',2018-12-15,Indiaforensic  RUPAY SETT 151218,4360.76,0.0,2206812.6700000013,2018,12,15,DEBIT,4360.76,M1738049197
7856,409000493210',2018-12-15,Indiaforensic  RUPAY SETT 151218,0.0,3039.03,2209851.700000001,2018,12,15,CHECK_CASHING,3039.03,C195600860
7857,409000493210',2018-12-15,Indiaforensic RUPAY STL INTC1512,37.53,0.0,2209814.1700000013,2018,12,15,PAYEMENT,37.53,M2010394327
7858,409000493210',2018-12-15,Indiaforensic RUPAY STL INTC1512,0.0,21.01,2209835.180000001,2018,12,15,TRANSFER,21.01,C1722351469
7859,409000493210',2018-12-15,Indiaforensic  RUPAY SETT 151218,8950.36,0.0,2200884.8200000008,2018,12,15,DEBIT,8950.36,M590380140
7860,409000493210',2018-12-15,Indiaforensic  RUPAY SETT 151218,0.0,92.46,2200977.2800000007,2018,12,15,TRANSFER,92.46,M1912733854
7861,409000493210',2018-12-15,Indiaforensic RUPAY STL INTC1512,91.71,0.0,2200885.5700000008,2018,12,15,DEBIT,91.71,C1479553213
7862,409000493210',2018-12-15,Indiaforensic NFS SETT 13-12-201,4000.0,0.0,2196885.5700000008,2018,12,15,CASH_OUT,4000.0,M1681911120
7863,409000493210',2018-12-15,Indiaforensic NFS SETT 13-12-201,2000.0,0.0,2194885.5700000008,2018,12,15,DEBIT,2000.0,C891020651
7864,409000493210',2018-12-15,Indiaforensic NFS SETT 13-12-201,6000.0,0.0,2188885.5700000008,2018,12,15,PAYEMENT,6000.0,C1360767589
7865,409000493210',2018-12-15,Indiaforensic NFS SETT 13-12-201,4000.0,0.0,2184885.5700000008,2018,12,15,CASH_OUT,4000.0,M590399893
7866,409000493210',2018-12-17,Indiaforensic RUPAY SETT 161218,20842.31,0.0,2164043.2600000007,2018,12,17,PAYEMENT,20842.31,M1947403350
7867,409000493210',2018-12-17,Indiaforensic RUPAY STL INTC1612,188.61,0.0,2163854.6500000013,2018,12,17,CHECK_WITHDRAWAL,188.61,M516818219
7868,409000493210',2018-12-17,Indiaforensic RUPAY SETT 171218,25725.66,0.0,2138128.990000001,2018,12,17,CHECK_WITHDRAWAL,25725.66,M1283581890
7869,409000493210',2018-12-17,Indiaforensic RUPAY SETT 161218,0.0,235.73,2138364.720000001,2018,12,17,TRANSFER,235.73,C35126588
7870,409000493210',2018-12-17,Indiaforensic RUPAY STL INTC1612,0.0,0.35,2138365.0700000008,2018,12,17,CHECK_CASHING,0.35,M1657767738
7871,409000493210',2018-12-17,Indiaforensic RUPAY SETT 171218,0.0,460.7,2138825.7700000014,2018,12,17,CHECK_CASHING,460.7,C1083142315
7872,409000493210',2018-12-17,Indiaforensic RUPAY STL INTC1712,240.08,0.0,2138585.6900000013,2018,12,17,DEBIT,240.08,M42314793
7873,409000493210',2018-12-17,Indiaforensic RUPAY STL INTC1712,0.0,3.53,2138589.220000001,2018,12,17,CASH_IN,3.53,C766681183
7874,409000493210',2018-12-17,Indiaforensic  RUPAY SETT 171218,7520.0,0.0,2131069.220000001,2018,12,17,CHECK_WITHDRAWAL,7520.0,C347725669
7875,409000493210',2018-12-17,Indiaforensic RUPAY STL INTC1712,85.58,0.0,2130983.640000001,2018,12,17,PAYEMENT,85.58,M2099834837
7876,409000493210',2018-12-17,Indiaforensic  RUPAY SETT 171218,0.0,85.58,2131069.220000001,2018,12,17,CASH_IN,85.58,C885951223
7877,409000493210',2018-12-18,Indiaforensic NFS SETT 14-12-201,10000.0,0.0,2121069.220000001,2018,12,18,DEBIT,10000.0,M1039835620
7878,409000493210',2018-12-18,Indiaforensic NFS SETT 14-12-201,8500.0,0.0,2112569.220000001,2018,12,18,CHECK_WITHDRAWAL,8500.0,M1154136178
7879,409000493210',2018-12-18,Indiaforensic NFS SETT 14-12-201,10000.0,0.0,2102569.220000001,2018,12,18,CASH_OUT,10000.0,M766991922
7880,409000493210',2018-12-18,Indiaforensic NFS SETT 14-12-201,9500.0,0.0,2093069.220000001,2018,12,18,DEBIT,9500.0,M238370333
7881,409000493210',2018-12-18,Indiaforensic NFS SETT 14-12-201,10000.0,0.0,2083069.220000001,2018,12,18,DEBIT,10000.0,M223198004
7882,409000493210',2018-12-18,Indiaforensic NFS SETT 14-12-201,9500.0,0.0,2073569.220000001,2018,12,18,DEBIT,9500.0,C1560607671
7883,409000493210',2018-12-18,Indiaforensic NFS SETT 14-12-201,1600.0,0.0,2071969.220000001,2018,12,18,CASH_OUT,1600.0,C860798122
7884,409000493210',2018-12-18,Indiaforensic NFS SETT 14-12-201,4000.0,0.0,2067969.220000001,2018,12,18,CHECK_WITHDRAWAL,4000.0,C991363637
7885,409000493210',2018-12-18,Indiaforensic NFS SETT 14-12-201,500.0,0.0,2067469.220000001,2018,12,18,DEBIT,500.0,C854671988
7886,409000493210',2018-12-18,Indiaforensic NFS SETT 14-12-201,10000.0,0.0,2057469.220000001,2018,12,18,PAYEMENT,10000.0,C1496102000
7887,409000493210',2018-12-18,Indiaforensic NFS SETT 14-12-201,5000.0,0.0,2052469.220000001,2018,12,18,CASH_OUT,5000.0,C1297685781
7888,409000493210',2018-12-18,Indiaforensic NFS SETT 14-12-201,900.0,0.0,2051569.220000001,2018,12,18,PAYEMENT,900.0,C1782113663
7889,409000493210',2018-12-18,Indiaforensic NFS SETT 14-12-201,1000.0,0.0,2050569.220000001,2018,12,18,DEBIT,1000.0,C1782113663
7890,409000493210',2018-12-18,Indiaforensic NFS SETT 14-12-201,200.0,0.0,2050369.220000001,2018,12,18,CHECK_WITHDRAWAL,200.0,C1922859107
7891,409000493210',2018-12-18,Indiaforensic NFS SETT 14-12-201,1500.0,0.0,2048869.220000001,2018,12,18,CASH_OUT,1500.0,C1750350389
7892,409000493210',2018-12-18,Indiaforensic NFS SETT 14-12-201,3000.0,0.0,2045869.220000001,2018,12,18,CHECK_WITHDRAWAL,3000.0,C863811613
7893,409000493210',2018-12-18,Indiaforensic NFS SETT 15-12-201,500.0,0.0,2045369.220000001,2018,12,18,CASH_OUT,500.0,C621014131
7894,409000493210',2018-12-18,Indiaforensic NFS SETT 15-12-201,10000.0,0.0,2035369.220000001,2018,12,18,DEBIT,10000.0,C1670989986
7895,409000493210',2018-12-18,Indiaforensic NFS SETT 15-12-201,5000.0,0.0,2030369.220000001,2018,12,18,CHECK_WITHDRAWAL,5000.0,C1213257323
7896,409000493210',2018-12-18,Indiaforensic NFS SETT 15-12-201,5000.0,0.0,2025369.220000001,2018,12,18,CHECK_WITHDRAWAL,5000.0,C1636786811
7897,409000493210',2018-12-18,Indiaforensic NFS SETT 15-12-201,100.0,0.0,2025269.220000001,2018,12,18,PAYEMENT,100.0,C486371171
7898,409000493210',2018-12-18,Indiaforensic NFS SETT 15-12-201,500.0,0.0,2024769.220000001,2018,12,18,DEBIT,500.0,C1896545607
7899,409000493210',2018-12-18,Indiaforensic NFS SETT 15-12-201,300.0,0.0,2024469.220000001,2018,12,18,PAYEMENT,300.0,C660143728
7900,409000493210',2018-12-18,Indiaforensic NFS SETT 15-12-201,5000.0,0.0,2019469.220000001,2018,12,18,PAYEMENT,5000.0,C705487682
7901,409000493210',2018-12-18,Indiaforensic NFS SETT 15-12-201,5000.0,0.0,2014469.220000001,2018,12,18,PAYEMENT,5000.0,C1167066016
7902,409000493210',2018-12-18,Indiaforensic NFS SETT 15-12-201,300.0,0.0,2014169.220000001,2018,12,18,CASH_OUT,300.0,C1634190383
7903,409000493210',2018-12-18,Indiaforensic NFS SETT 15-12-201,1500.0,0.0,2012669.220000001,2018,12,18,PAYEMENT,1500.0,C553264065
7904,409000493210',2018-12-18,Indiaforensic NFS SETT 15-12-201,2000.0,0.0,2010669.220000001,2018,12,18,CASH_OUT,2000.0,C1019670582
7905,409000493210',2018-12-18,Indiaforensic NFS SETT 15-12-201,1900.0,0.0,2008769.220000001,2018,12,18,CHECK_WITHDRAWAL,1900.0,C655381473
7906,409000493210',2018-12-18,Indiaforensic NFS SETT 15-12-201,500.0,0.0,2008269.220000001,2018,12,18,CHECK_WITHDRAWAL,500.0,C746359178
7907,409000493210',2018-12-18,Indiaforensic NFS SETT 15-12-201,8000.0,0.0,2000269.220000001,2018,12,18,CASH_OUT,8000.0,C403147759
7908,409000493210',2018-12-18,Indiaforensic NFS SETT 15-12-201,8000.0,0.0,1992269.220000001,2018,12,18,CASH_OUT,8000.0,C773898763
7909,409000493210',2018-12-18,Indiaforensic NFS SETT 15-12-201,3000.0,0.0,1989269.220000001,2018,12,18,CHECK_WITHDRAWAL,3000.0,C766681183
7910,409000493210',2018-12-18,Indiaforensic NFS SETT 15-12-201,200.0,0.0,1989069.220000001,2018,12,18,CHECK_WITHDRAWAL,200.0,C1457383927
7911,409000493210',2018-12-18,Indiaforensic NFS SETT 15-12-201,100.0,0.0,1988969.220000001,2018,12,18,CHECK_WITHDRAWAL,100.0,C410033330
7912,409000493210',2018-12-18,Indiaforensic NFS SETT 15-12-201,100.0,0.0,1988869.220000001,2018,12,18,PAYEMENT,100.0,C542766981
7913,409000493210',2018-12-18,Indiaforensic NFS SETT 16-12-201,10000.0,0.0,1978869.220000001,2018,12,18,CHECK_WITHDRAWAL,10000.0,C675203915
7914,409000493210',2018-12-18,Indiaforensic NFS SETT 16-12-201,5000.0,0.0,1973869.220000001,2018,12,18,PAYEMENT,5000.0,C1654056127
7915,409000493210',2018-12-18,Indiaforensic NFS SETT 16-12-201,8000.0,0.0,1965869.220000001,2018,12,18,DEBIT,8000.0,C957388291
7916,409000493210',2018-12-18,Indiaforensic NFS SETT 16-12-201,10000.0,0.0,1955869.220000001,2018,12,18,PAYEMENT,10000.0,C417277601
7917,409000493210',2018-12-18,Indiaforensic NFS SETT 16-12-201,10000.0,0.0,1945869.220000001,2018,12,18,CHECK_WITHDRAWAL,10000.0,C1641587857
7918,409000493210',2018-12-18,Indiaforensic NFS SETT 16-12-201,2000.0,0.0,1943869.220000001,2018,12,18,PAYEMENT,2000.0,C1286084959
7919,409000493210',2018-12-18,Indiaforensic NFS SETT 16-12-201,500.0,0.0,1943369.220000001,2018,12,18,CHECK_WITHDRAWAL,500.0,C1457383927
7920,409000493210',2018-12-18,Indiaforensic NFS SETT 16-12-201,200.0,0.0,1943169.220000001,2018,12,18,DEBIT,200.0,C1427067435
7921,409000493210',2018-12-18,Indiaforensic RUPAY SETT 181218,4755.08,0.0,1938414.1400000008,2018,12,18,CHECK_WITHDRAWAL,4755.08,C1786758337
7922,409000493210',2018-12-18,Indiaforensic RUPAY SETT 181218,0.0,46.29,1938460.4300000009,2018,12,18,CHECK_CASHING,46.29,C418964192
7923,409000493210',2018-12-18,Indiaforensic RUPAY STL INTC1812,46.29,0.0,1938414.1400000008,2018,12,18,CHECK_WITHDRAWAL,46.29,C1211317010
7924,409000493210',2018-12-18,Indiaforensic RUPAY SETT 181218-,31003.58,0.0,1907410.560000001,2018,12,18,DEBIT,31003.58,C716083600
7925,409000493210',2018-12-18,Indiaforensic RUPAY SETT 181218-,0.0,329.4,1907739.960000001,2018,12,18,CASH_IN,329.4,C1529639302
7926,409000493210',2018-12-18,Indiaforensic RUPAY STL INTC1812,329.4,0.0,1907410.560000001,2018,12,18,CASH_OUT,329.4,C296121376
7927,409000493210',2018-12-19,Indiaforensic  RUPAY SETT 191218,4705.07,0.0,1902705.490000001,2018,12,19,CASH_OUT,4705.07,C1286084959
7928,409000493210',2018-12-19,Indiaforensic  RUPAY SETT 191218,0.0,69.87,1902775.360000001,2018,12,19,CASH_IN,69.87,C1234776885
7929,409000493210',2018-12-19,Indiaforensic RUPAY STL INTC1912,38.59,0.0,1902736.770000001,2018,12,19,CHECK_WITHDRAWAL,38.59,C1746150957
7930,409000493210',2018-12-19,Indiaforensic RUPAY STL INTC1912,0.0,0.23,1902737.000000001,2018,12,19,TRANSFER,0.23,C43924520
7931,409000493210',2018-12-19,Indiaforensic  RUPAY SETT 191218,7810.7,0.0,1894926.300000001,2018,12,19,CASH_OUT,7810.7,C1286084959
7932,409000493210',2018-12-19,Indiaforensic  RUPAY SETT 191218,0.0,61.95,1894988.250000001,2018,12,19,CHECK_CASHING,61.95,C1120735174
7933,409000493210',2018-12-19,Indiaforensic RUPAY STL INTC1912,61.95,0.0,1894926.300000001,2018,12,19,CASH_OUT,61.95,C1339257929
7934,409000493210',2018-12-20,Indiaforensic  RUPAY SETT 201218,5111.36,0.0,1889814.9400000009,2018,12,20,DEBIT,5111.36,C716083600
7935,409000493210',2018-12-20,Indiaforensic  RUPAY SETT 201218,0.0,61.74,1889876.6800000009,2018,12,20,CHECK_CASHING,61.74,C986473968
7936,409000493210',2018-12-20,Indiaforensic RUPAY STL INTC2012,61.74,0.0,1889814.9400000009,2018,12,20,PAYEMENT,61.74,C408553489
7937,409000493210',2018-12-20,Indiaforensic  RUPAY SETT 201218,10424.12,0.0,1879390.820000001,2018,12,20,DEBIT,10424.12,C1331052438
7938,409000493210',2018-12-20,Indiaforensic  RUPAY SETT 201218,0.0,133.11,1879523.9300000009,2018,12,20,CHECK_CASHING,133.11,C1213485528
7939,409000493210',2018-12-20,Indiaforensic RUPAY STL INTC2012,112.4,0.0,1879411.530000001,2018,12,20,CHECK_WITHDRAWAL,112.4,C667346055
7940,409000493210',2018-12-20,Indiaforensic RUPAY STL INTC2012,0.0,0.16,1879411.6900000009,2018,12,20,CASH_IN,0.16,C1049228732
7941,409000493210',2018-12-20,Indiaforensic NFS SETT 17-12-201,800.0,0.0,1878611.6900000009,2018,12,20,CHECK_WITHDRAWAL,800.0,C1651945012
7942,409000493210',2018-12-20,Indiaforensic NFS SETT 17-12-201,8500.0,0.0,1870111.6900000009,2018,12,20,DEBIT,8500.0,C909295153
7943,409000493210',2018-12-20,Indiaforensic NFS SETT 17-12-201,9000.0,0.0,1861111.6900000009,2018,12,20,CHECK_WITHDRAWAL,9000.0,C458582664
7944,409000493210',2018-12-20,Indiaforensic NFS SETT 17-12-201,8000.0,0.0,1853111.6900000009,2018,12,20,CHECK_WITHDRAWAL,8000.0,C875917495
7945,409000493210',2018-12-20,Indiaforensic NFS SETT 17-12-201,8000.0,0.0,1845111.6900000009,2018,12,20,CHECK_WITHDRAWAL,8000.0,C1281580764
7946,409000493210',2018-12-20,Indiaforensic NFS SETT 17-12-201,5000.0,0.0,1840111.6900000009,2018,12,20,PAYEMENT,5000.0,C1846735756
7947,409000493210',2018-12-20,Indiaforensic NFS SETT 17-12-201,400.0,0.0,1839711.6900000009,2018,12,20,CASH_OUT,400.0,C296121376
7948,409000493210',2018-12-20,Indiaforensic NFS SETT 17-12-201,7000.0,0.0,1832711.6900000009,2018,12,20,CHECK_WITHDRAWAL,7000.0,C991363637
7949,409000493210',2018-12-20,Indiaforensic NFS SETT 17-12-201,9800.0,0.0,1822911.6900000009,2018,12,20,CASH_OUT,9800.0,C1634190383
7950,409000493210',2018-12-20,Indiaforensic NFS SETT 17-12-201,300.0,0.0,1822611.6900000009,2018,12,20,CASH_OUT,300.0,M1380654657
7951,409000493210',2018-12-20,Indiaforensic NFS SETT 17-12-201,200.0,0.0,1822411.6900000009,2018,12,20,CHECK_WITHDRAWAL,200.0,M226653811
7952,409000493210',2018-12-20,Indiaforensic NFS SETT 17-12-201,5500.0,0.0,1816911.6900000009,2018,12,20,CHECK_WITHDRAWAL,5500.0,C1359953204
7953,409000493210',2018-12-20,Indiaforensic NFS SETT 17-12-201,10000.0,0.0,1806911.6900000009,2018,12,20,PAYEMENT,10000.0,M1844762865
7954,409000493210',2018-12-20,Indiaforensic NFS SETT 17-12-201,500.0,0.0,1806411.6900000009,2018,12,20,DEBIT,500.0,C11003494
7955,409000493210',2018-12-20,Indiaforensic NFS SETT 17-12-201,9500.0,0.0,1796911.6900000009,2018,12,20,CASH_OUT,9500.0,C503195940
7956,409000493210',2018-12-20,Indiaforensic NFS SETT 17-12-201,8500.0,0.0,1788411.6900000009,2018,12,20,CASH_OUT,8500.0,M795924364
7957,409000493210',2018-12-20,Indiaforensic NFS SETT 17-12-201,6000.0,0.0,1782411.6900000009,2018,12,20,CHECK_WITHDRAWAL,6000.0,M2031507085
7958,409000493210',2018-12-20,Indiaforensic NFS SETT 17-12-201,8000.0,0.0,1774411.6900000009,2018,12,20,CHECK_WITHDRAWAL,8000.0,C1951379728
7959,409000493210',2018-12-20,Indiaforensic NFS SETT 17-12-201,5000.0,0.0,1769411.6900000009,2018,12,20,PAYEMENT,5000.0,M1137887459
7960,409000493210',2018-12-20,Indiaforensic NFS SETT 17-12-201,8500.0,0.0,1760911.6900000009,2018,12,20,PAYEMENT,8500.0,C49477935
7961,409000493210',2018-12-20,Indiaforensic NFS SETT 17-12-201,8000.0,0.0,1752911.6900000009,2018,12,20,CASH_OUT,8000.0,M173930892
7962,409000493210',2018-12-20,Indiaforensic NFS SETT 17-12-201,6000.0,0.0,1746911.6900000009,2018,12,20,DEBIT,6000.0,C36856762
7963,409000493210',2018-12-20,Indiaforensic NFS SETT 17-12-201,8000.0,0.0,1738911.6900000009,2018,12,20,DEBIT,8000.0,M1172289188
7964,409000493210',2018-12-20,Indiaforensic NFS SETT 17-12-201,5000.0,0.0,1733911.6900000009,2018,12,20,DEBIT,5000.0,M317443574
7965,409000493210',2018-12-20,Indiaforensic NFS SETT 17-12-201,3500.0,0.0,1730411.6900000009,2018,12,20,PAYEMENT,3500.0,C1891834647
7966,409000493210',2018-12-20,Indiaforensic NFS SETT 17-12-201,5000.0,0.0,1725411.6900000009,2018,12,20,PAYEMENT,5000.0,C662736689
7967,409000493210',2018-12-20,Indiaforensic NFS SETT 17-12-201,10000.0,0.0,1715411.6900000009,2018,12,20,CHECK_WITHDRAWAL,10000.0,M966902272
7968,409000493210',2018-12-20,Indiaforensic NFS SETT 17-12-201,6500.0,0.0,1708911.6900000009,2018,12,20,CHECK_WITHDRAWAL,6500.0,M369977528
7969,409000493210',2018-12-20,Indiaforensic NFS SETT 18-12-201,100.0,0.0,1708811.6900000009,2018,12,20,CASH_OUT,100.0,C1545688642
7970,409000493210',2018-12-20,Indiaforensic NFS SETT 18-12-201,2000.0,0.0,1706811.6900000009,2018,12,20,DEBIT,2000.0,M744180625
7971,409000493210',2018-12-20,Indiaforensic NFS SETT 18-12-201,1500.0,0.0,1705311.6900000009,2018,12,20,CHECK_WITHDRAWAL,1500.0,M1992478722
7972,409000493210',2018-12-20,Indiaforensic NFS SETT 18-12-201,5000.0,0.0,1700311.6900000009,2018,12,20,CHECK_WITHDRAWAL,5000.0,M598294540
7973,409000493210',2018-12-20,Indiaforensic NFS SETT 18-12-201,2000.0,0.0,1698311.6900000009,2018,12,20,CHECK_WITHDRAWAL,2000.0,M1731311293
7974,409000493210',2018-12-20,Indiaforensic NFS SETT 18-12-201,100.0,0.0,1698211.6900000009,2018,12,20,CHECK_WITHDRAWAL,100.0,M525313125
7975,409000493210',2018-12-20,Indiaforensic NFS SETT 18-12-201,200.0,0.0,1698011.6900000009,2018,12,20,CHECK_WITHDRAWAL,200.0,M1804109458
7976,409000493210',2018-12-20,Indiaforensic NFS SETT 18-12-201,5000.0,0.0,1693011.6900000009,2018,12,20,CHECK_WITHDRAWAL,5000.0,M102373363
7977,409000493210',2018-12-20,Indiaforensic NFS SETT 18-12-201,8000.0,0.0,1685011.6900000009,2018,12,20,CASH_OUT,8000.0,M440306536
7978,409000493210',2018-12-20,Indiaforensic NFS SETT 18-12-201,7900.0,0.0,1677111.6900000009,2018,12,20,PAYEMENT,7900.0,M264686278
7979,409000493210',2018-12-20,Indiaforensic NFS SETT 18-12-201,300.0,0.0,1676811.6900000009,2018,12,20,CHECK_WITHDRAWAL,300.0,M1023842266
7980,409000493210',2018-12-20,Indiaforensic NFS SETT 18-12-201,100.0,0.0,1676711.6900000009,2018,12,20,CHECK_WITHDRAWAL,100.0,M1915781538
7981,409000493210',2018-12-20,Indiaforensic NFS SETT 18-12-201,6000.0,0.0,1670711.6900000009,2018,12,20,DEBIT,6000.0,M1101963025
7982,409000493210',2018-12-20,Indiaforensic NFS SETT 18-12-201,10000.0,0.0,1660711.6900000009,2018,12,20,CASH_OUT,10000.0,M871344084
7983,409000493210',2018-12-20,Indiaforensic NFS SETT 18-12-201,300.0,0.0,1660411.6900000009,2018,12,20,CASH_OUT,300.0,M896315952
7984,409000493210',2018-12-20,Indiaforensic NFS SETT 18-12-201,100.0,0.0,1660311.6900000009,2018,12,20,DEBIT,100.0,M505957776
7985,409000493210',2018-12-20,Indiaforensic NFS SETT 18-12-201,1000.0,0.0,1659311.6900000009,2018,12,20,CASH_OUT,1000.0,M837603331
7986,409000493210',2018-12-20,Indiaforensic NFS SETT 18-12-201,1500.0,0.0,1657811.6900000009,2018,12,20,CASH_OUT,1500.0,M27639992
7987,409000493210',2018-12-20,TRF FRM  Indiaforensic SERVICES,0.0,239515.0,1897326.6900000009,2018,12,20,CHECK_CASHING,239515.0,M1060104887
7988,409000493210',2018-12-21,Indiaforensic  RUPAY SETT 211218,1856.29,0.0,1895470.4000000008,2018,12,21,PAYEMENT,1856.29,M658022908
7989,409000493210',2018-12-21,Indiaforensic  RUPAY SETT 211218,0.0,3015.33,1898485.730000001,2018,12,21,CASH_IN,3015.33,M768027660
7990,409000493210',2018-12-21,Indiaforensic RUPAY STL INTC2112,13.51,0.0,1898472.220000001,2018,12,21,CHECK_WITHDRAWAL,13.51,M2140662115
7991,409000493210',2018-12-21,Indiaforensic RUPAY STL INTC2112,0.0,48.01,1898520.230000001,2018,12,21,TRANSFER,48.01,M1846942954
7992,409000493210',2018-12-21,Indiaforensic  RUPAY SETT 211218,23993.31,0.0,1874526.9200000009,2018,12,21,DEBIT,23993.31,M664944007
7993,409000493210',2018-12-21,Indiaforensic  RUPAY SETT 211218,0.0,208.04,1874734.960000001,2018,12,21,TRANSFER,208.04,M750444785
7994,409000493210',2018-12-21,Indiaforensic RUPAY STL INTC2112,156.67,0.0,1874578.290000001,2018,12,21,DEBIT,156.67,C365212068
7995,409000493210',2018-12-21,Indiaforensic RUPAY STL INTC2112,0.0,0.39,1874578.6800000009,2018,12,21,CASH_IN,0.39,C1909597726
7996,409000493210',2018-12-21,Indiaforensic NFS SETT 19-12-201,1000.0,0.0,1873578.6800000009,2018,12,21,CHECK_WITHDRAWAL,1000.0,C531076772
7997,409000493210',2018-12-21,Indiaforensic NFS SETT 19-12-201,500.0,0.0,1873078.6800000009,2018,12,21,DEBIT,500.0,C1554565380
7998,409000493210',2018-12-21,Indiaforensic NFS SETT 19-12-201,500.0,0.0,1872578.6800000009,2018,12,21,CASH_OUT,500.0,C1357984916
7999,409000493210',2018-12-21,Indiaforensic NFS SETT 19-12-201,6000.0,0.0,1866578.6800000009,2018,12,21,DEBIT,6000.0,C991505714
8000,409000493210',2018-12-21,Indiaforensic NFS SETT 19-12-201,1500.0,0.0,1865078.6800000009,2018,12,21,PAYEMENT,1500.0,C1354952534
8001,409000493210',2018-12-21,Indiaforensic NFS SETT 19-12-201,10000.0,0.0,1855078.6800000009,2018,12,21,PAYEMENT,10000.0,C1028574311
8002,409000493210',2018-12-21,Indiaforensic NFS SETT 19-12-201,400.0,0.0,1854678.6800000009,2018,12,21,DEBIT,400.0,M1961696565
8003,409000493210',2018-12-21,Indiaforensic NFS SETT 19-12-201,6000.0,0.0,1848678.6800000009,2018,12,21,PAYEMENT,6000.0,M1565583350
8004,409000493210',2018-12-21,Indiaforensic NFS SETT 19-12-201,200.0,0.0,1848478.6800000009,2018,12,21,PAYEMENT,200.0,M1222836602
8005,409000493210',2018-12-21,Indiaforensic NFS SETT 19-12-201,300.0,0.0,1848178.6800000009,2018,12,21,CHECK_WITHDRAWAL,300.0,M270945456
8006,409000493210',2018-12-24,Indiaforensic RUPAY SETT 221218,24958.45,0.0,1823220.230000001,2018,12,24,CHECK_WITHDRAWAL,24958.45,M1237278408
8007,409000493210',2018-12-24,Indiaforensic RUPAY STL INTC2212,192.06,0.0,1823028.1700000009,2018,12,24,CHECK_WITHDRAWAL,192.06,C1100767002
8008,409000493210',2018-12-24,Indiaforensic RUPAY SETT 231218,40633.96,0.0,1782394.210000001,2018,12,24,CHECK_WITHDRAWAL,40633.96,C1883840933
8009,409000493210',2018-12-24,Indiaforensic RUPAY STL INTC2312,389.15,0.0,1782005.060000001,2018,12,24,CASH_OUT,389.15,C1286084959
8010,409000493210',2018-12-24,Indiaforensic RUPAY SETT 241218,31205.37,0.0,1750799.6900000009,2018,12,24,PAYEMENT,31205.37,C1496102000
8011,409000493210',2018-12-24,Indiaforensic RUPAY SETT 221218,0.0,192.06,1750991.750000001,2018,12,24,TRANSFER,192.06,C503195940
8012,409000493210',2018-12-24,Indiaforensic RUPAY STL INTC2412,232.06,0.0,1750759.6900000009,2018,12,24,CASH_OUT,232.06,C662736689
8013,409000493210',2018-12-24,Indiaforensic RUPAY SETT 231218,0.0,411.68,1751171.370000001,2018,12,24,TRANSFER,411.68,C1019670582
8014,409000493210',2018-12-24,Indiaforensic RUPAY STL INTC2312,0.0,0.17,1751171.540000001,2018,12,24,TRANSFER,0.17,C1423992712
8015,409000493210',2018-12-24,Indiaforensic RUPAY SETT 241218,0.0,302.22,1751473.760000001,2018,12,24,TRANSFER,302.22,C662736689
8016,409000493210',2018-12-24,Indiaforensic RUPAY STL INTC2412,0.0,0.52,1751474.280000001,2018,12,24,CHECK_CASHING,0.52,C28783325
8017,409000493210',2018-12-24,Indiaforensic NFS SETT 20-12-201,10000.0,0.0,1741474.280000001,2018,12,24,DEBIT,10000.0,C1634190383
8018,409000493210',2018-12-24,Indiaforensic NFS SETT 20-12-201,100.0,0.0,1741374.280000001,2018,12,24,CASH_OUT,100.0,C191614132
8019,409000493210',2018-12-24,Indiaforensic NFS SETT 20-12-201,300.0,0.0,1741074.280000001,2018,12,24,CASH_OUT,300.0,C1151964959
8020,409000493210',2018-12-24,Indiaforensic NFS SETT 20-12-201,3100.0,0.0,1737974.280000001,2018,12,24,PAYEMENT,3100.0,C1394526584
8021,409000493210',2018-12-24,Indiaforensic NFS SETT 20-12-201,10000.0,0.0,1727974.280000001,2018,12,24,CHECK_WITHDRAWAL,10000.0,C1730752455
8022,409000493210',2018-12-24,Indiaforensic NFS SETT 20-12-201,200.0,0.0,1727774.280000001,2018,12,24,CHECK_WITHDRAWAL,200.0,C1916720513
8023,409000493210',2018-12-24,Indiaforensic NFS SETT 20-12-201,100.0,0.0,1727674.280000001,2018,12,24,PAYEMENT,100.0,C1423992712
8024,409000493210',2018-12-24,Indiaforensic NFS SETT 20-12-201,8000.0,0.0,1719674.280000001,2018,12,24,CASH_OUT,8000.0,C1816757085
8025,409000493210',2018-12-24,Indiaforensic NFS SETT 20-12-201,2100.0,0.0,1717574.280000001,2018,12,24,CHECK_WITHDRAWAL,2100.0,C503485607
8026,409000493210',2018-12-24,Indiaforensic NFS SETT 20-12-201,5000.0,0.0,1712574.280000001,2018,12,24,DEBIT,5000.0,C2029310301
8027,409000493210',2018-12-24,Indiaforensic NFS SETT 20-12-201,100.0,0.0,1712474.280000001,2018,12,24,CASH_OUT,100.0,C1262822392
8028,409000493210',2018-12-24,Indiaforensic NFS SETT 20-12-201,200.0,0.0,1712274.280000001,2018,12,24,CHECK_WITHDRAWAL,200.0,C803116137
8029,409000493210',2018-12-24,Indiaforensic NFS SETT 20-12-201,4000.0,0.0,1708274.280000001,2018,12,24,CHECK_WITHDRAWAL,4000.0,C1789550256
8030,409000493210',2018-12-24,Indiaforensic NFS SETT 20-12-201,200.0,0.0,1708074.280000001,2018,12,24,PAYEMENT,200.0,C1750563752
8031,409000493210',2018-12-24,Indiaforensic NFS SETT 20-12-201,200.0,0.0,1707874.280000001,2018,12,24,CHECK_WITHDRAWAL,200.0,C1870436181
8032,409000493210',2018-12-24,Indiaforensic NFS SETT 20-12-201,300.0,0.0,1707574.280000001,2018,12,24,DEBIT,300.0,C1085479446
8033,409000493210',2018-12-24,Indiaforensic  RUPAY SETT 241218,1043.65,0.0,1706530.630000001,2018,12,24,PAYEMENT,1043.65,C977993101
8034,409000493210',2018-12-24,Indiaforensic  RUPAY SETT 241218,0.0,8.47,1706539.100000001,2018,12,24,CASH_IN,8.47,C909295153
8035,409000493210',2018-12-24,Indiaforensic RUPAY STL INTC2412,8.47,0.0,1706530.630000001,2018,12,24,CASH_OUT,8.47,C7881234
8036,409000493210',2018-12-26,Indiaforensic NFS SETT 21-12-201,10000.0,0.0,1696530.630000001,2018,12,26,CASH_OUT,10000.0,C766681183
8037,409000493210',2018-12-26,Indiaforensic NFS SETT 21-12-201,8000.0,0.0,1688530.630000001,2018,12,26,DEBIT,8000.0,C1816986148
8038,409000493210',2018-12-26,Indiaforensic NFS SETT 21-12-201,500.0,0.0,1688030.630000001,2018,12,26,CHECK_WITHDRAWAL,500.0,C423583818
8039,409000493210',2018-12-26,Indiaforensic NFS SETT 22-12-201,7600.0,0.0,1680430.630000001,2018,12,26,DEBIT,7600.0,C97730845
8040,409000493210',2018-12-26,Indiaforensic NFS SETT 22-12-201,1500.0,0.0,1678930.630000001,2018,12,26,PAYEMENT,1500.0,C1459693562
8041,409000493210',2018-12-26,Indiaforensic NFS SETT 22-12-201,10000.0,0.0,1668930.630000001,2018,12,26,CASH_OUT,10000.0,C2072865894
8042,409000493210',2018-12-26,Indiaforensic NFS SETT 22-12-201,200.0,0.0,1668730.630000001,2018,12,26,CASH_OUT,200.0,C7313260
8043,409000493210',2018-12-26,Indiaforensic NFS SETT 22-12-201,10000.0,0.0,1658730.630000001,2018,12,26,CASH_OUT,10000.0,C1495761010
8044,409000493210',2018-12-26,Indiaforensic NFS SETT 22-12-201,500.0,0.0,1658230.630000001,2018,12,26,DEBIT,500.0,C1122805102
8045,409000493210',2018-12-26,Indiaforensic NFS SETT 22-12-201,2000.0,0.0,1656230.630000001,2018,12,26,DEBIT,2000.0,M1400979201
8046,409000493210',2018-12-26,Indiaforensic NFS SETT 22-12-201,200.0,0.0,1656030.630000001,2018,12,26,CHECK_WITHDRAWAL,200.0,M1823652167
8047,409000493210',2018-12-26,Indiaforensic NFS SETT 22-12-201,500.0,0.0,1655530.630000001,2018,12,26,CHECK_WITHDRAWAL,500.0,M441216628
8048,409000493210',2018-12-26,Indiaforensic NFS SETT 22-12-201,8000.0,0.0,1647530.630000001,2018,12,26,DEBIT,8000.0,M1373029421
8049,409000493210',2018-12-26,Indiaforensic NFS SETT 22-12-201,10000.0,0.0,1637530.630000001,2018,12,26,CHECK_WITHDRAWAL,10000.0,M285527866
8050,409000493210',2018-12-26,Indiaforensic NFS SETT 23-12-201,10000.0,0.0,1627530.630000001,2018,12,26,PAYEMENT,10000.0,M1729472218
8051,409000493210',2018-12-26,Indiaforensic NFS SETT 23-12-201,9500.0,0.0,1618030.630000001,2018,12,26,PAYEMENT,9500.0,M704144944
8052,409000493210',2018-12-26,Indiaforensic NFS SETT 23-12-201,8000.0,0.0,1610030.630000001,2018,12,26,DEBIT,8000.0,C1379589736
8053,409000493210',2018-12-26,Indiaforensic NFS SETT 23-12-201,2000.0,0.0,1608030.630000001,2018,12,26,PAYEMENT,2000.0,C2145942542
8054,409000493210',2018-12-26,Indiaforensic NFS SETT 23-12-201,400.0,0.0,1607630.630000001,2018,12,26,DEBIT,400.0,M678449488
8055,409000493210',2018-12-26,Indiaforensic NFS SETT 23-12-201,200.0,0.0,1607430.630000001,2018,12,26,DEBIT,200.0,M682788544
8056,409000493210',2018-12-26,Indiaforensic NFS SETT 23-12-201,5000.0,0.0,1602430.630000001,2018,12,26,CHECK_WITHDRAWAL,5000.0,M1532904892
8057,409000493210',2018-12-26,Indiaforensic NFS SETT 23-12-201,2000.0,0.0,1600430.630000001,2018,12,26,PAYEMENT,2000.0,C886517510
8058,409000493210',2018-12-26,Indiaforensic RUPAY SETT 251218,35777.46,0.0,1564653.1700000009,2018,12,26,PAYEMENT,35777.46,M779445238
8059,409000493210',2018-12-26,Indiaforensic RUPAY SETT 251218,0.0,373.38,1565026.550000001,2018,12,26,CHECK_CASHING,373.38,C836514715
8060,409000493210',2018-12-26,Indiaforensic RUPAY STL INTC2512,371.29,0.0,1564655.260000001,2018,12,26,DEBIT,371.29,C1145835418
8061,409000493210',2018-12-26,Indiaforensic RUPAY STL INTC2512,0.0,0.01,1564655.270000001,2018,12,26,CASH_IN,0.01,M2122731428
8062,409000493210',2018-12-26,Indiaforensic RUPAY SETT 261218,17010.0,0.0,1547645.270000001,2018,12,26,DEBIT,17010.0,M953949264
8063,409000493210',2018-12-26,Indiaforensic RUPAY SETT 261218,0.0,199.44,1547844.710000001,2018,12,26,CASH_IN,199.44,M1090073068
8064,409000493210',2018-12-26,Indiaforensic RUPAY STL INTC2612,165.07,0.0,1547679.6400000006,2018,12,26,PAYEMENT,165.07,M182999725
8065,409000493210',2018-12-26,Indiaforensic RUPAY STL INTC2612,0.0,0.26,1547679.9000000006,2018,12,26,TRANSFER,0.26,M2047200712
8066,409000493210',2018-12-26,Indiaforensic  RUPAY SETT 261218,3379.54,0.0,1544300.3600000006,2018,12,26,CHECK_WITHDRAWAL,3379.54,C195600860
8067,409000493210',2018-12-26,Indiaforensic  RUPAY SETT 261218,0.0,43.14,1544343.5000000002,2018,12,26,CASH_IN,43.14,M867485557
8068,409000493210',2018-12-26,Indiaforensic RUPAY STL INTC2612,27.57,0.0,1544315.9300000004,2018,12,26,CASH_OUT,27.57,C111210112
8069,409000493210',2018-12-26,Indiaforensic RUPAY STL INTC2612,0.0,0.07,1544316.0000000002,2018,12,26,TRANSFER,0.07,M121483686
8070,409000493210',2018-12-27,Indiaforensic NFS SETT 24-12-201,300.0,0.0,1544016.0000000002,2018,12,27,CASH_OUT,300.0,M740844878
8071,409000493210',2018-12-27,Indiaforensic NFS SETT 24-12-201,1100.0,0.0,1542916.0000000002,2018,12,27,PAYEMENT,1100.0,C2083117811
8072,409000493210',2018-12-27,Indiaforensic NFS SETT 24-12-201,1000.0,0.0,1541916.0000000002,2018,12,27,DEBIT,1000.0,M1873983858
8073,409000493210',2018-12-27,Indiaforensic NFS SETT 24-12-201,3000.0,0.0,1538916.0000000002,2018,12,27,DEBIT,3000.0,C1991252420
8074,409000493210',2018-12-27,Indiaforensic NFS SETT 24-12-201,2000.0,0.0,1536916.0000000002,2018,12,27,PAYEMENT,2000.0,M991572261
8075,409000493210',2018-12-27,Indiaforensic NFS SETT 24-12-201,400.0,0.0,1536516.0000000002,2018,12,27,DEBIT,400.0,C505973878
8076,409000493210',2018-12-27,Indiaforensic NFS SETT 24-12-201,300.0,0.0,1536216.0000000002,2018,12,27,PAYEMENT,300.0,M1020745918
8077,409000493210',2018-12-27,Indiaforensic NFS SETT 24-12-201,1000.0,0.0,1535216.0000000002,2018,12,27,CHECK_WITHDRAWAL,1000.0,M1552771166
8078,409000493210',2018-12-27,Indiaforensic NFS SETT 24-12-201,1000.0,0.0,1534216.0000000002,2018,12,27,DEBIT,1000.0,M1292788772
8079,409000493210',2018-12-27,Indiaforensic NFS SETT 24-12-201,400.0,0.0,1533816.0000000002,2018,12,27,DEBIT,400.0,M1515201771
8080,409000493210',2018-12-27,Indiaforensic NFS SETT 24-12-201,700.0,0.0,1533116.0000000002,2018,12,27,PAYEMENT,700.0,M2038211362
8081,409000493210',2018-12-27,Indiaforensic NFS SETT 24-12-201,500.0,0.0,1532616.0000000002,2018,12,27,DEBIT,500.0,M203607885
8082,409000493210',2018-12-27,Indiaforensic NFS SETT 24-12-201,3000.0,0.0,1529616.0000000002,2018,12,27,PAYEMENT,3000.0,M966446307
8083,409000493210',2018-12-27,Indiaforensic NFS SETT 24-12-201,6000.0,0.0,1523616.0000000002,2018,12,27,PAYEMENT,6000.0,M34004511
8084,409000493210',2018-12-27,Indiaforensic NFS SETT 25-12-201,100.0,0.0,1523516.0000000002,2018,12,27,DEBIT,100.0,M1354501053
8085,409000493210',2018-12-27,Indiaforensic NFS SETT 25-12-201,200.0,0.0,1523316.0000000002,2018,12,27,PAYEMENT,200.0,M1570030862
8086,409000493210',2018-12-27,Indiaforensic NFS SETT 25-12-201,2300.0,0.0,1521016.0000000002,2018,12,27,CASH_OUT,2300.0,C1100439041
8087,409000493210',2018-12-27,Indiaforensic NFS SETT 25-12-201,1000.0,0.0,1520016.0000000002,2018,12,27,CHECK_WITHDRAWAL,1000.0,M2051142823
8088,409000493210',2018-12-27,Indiaforensic NFS SETT 25-12-201,200.0,0.0,1519816.0000000002,2018,12,27,PAYEMENT,200.0,M1786936076
8089,409000493210',2018-12-27,Indiaforensic NFS SETT 25-12-201,1000.0,0.0,1518816.0000000002,2018,12,27,DEBIT,1000.0,M1291794687
8090,409000493210',2018-12-27,Indiaforensic NFS SETT 25-12-201,700.0,0.0,1518116.0000000002,2018,12,27,CASH_OUT,700.0,M67025210
8091,409000493210',2018-12-27,Indiaforensic NFS SETT 25-12-201,1000.0,0.0,1517116.0000000002,2018,12,27,PAYEMENT,1000.0,M2137638080
8092,409000493210',2018-12-27,Indiaforensic NFS SETT 25-12-201,500.0,0.0,1516616.0000000002,2018,12,27,DEBIT,500.0,M484124940
8093,409000493210',2018-12-27,Indiaforensic NFS SETT 25-12-201,300.0,0.0,1516316.0000000002,2018,12,27,PAYEMENT,300.0,M1174916066
8094,409000493210',2018-12-27,Indiaforensic NFS SETT 25-12-201,100.0,0.0,1516216.0000000002,2018,12,27,CHECK_WITHDRAWAL,100.0,M975361695
8095,409000493210',2018-12-27,Indiaforensic NFS SETT 25-12-201,8000.0,0.0,1508216.0000000002,2018,12,27,CHECK_WITHDRAWAL,8000.0,M2134297999
8096,409000493210',2018-12-27,Indiaforensic NFS SETT 25-12-201,10000.0,0.0,1498216.0000000002,2018,12,27,DEBIT,10000.0,M213819615
8097,409000493210',2018-12-27,Indiaforensic NFS SETT 25-12-201,300.0,0.0,1497916.0000000002,2018,12,27,CASH_OUT,300.0,C1721246982
8098,409000493210',2018-12-27,Indiaforensic  RUPAY SETT 271218,4770.03,0.0,1493145.9700000002,2018,12,27,CHECK_WITHDRAWAL,4770.03,M1880872680
8099,409000493210',2018-12-27,Indiaforensic  RUPAY SETT 271218,0.0,48.9,1493194.8700000003,2018,12,27,CASH_IN,48.9,M1227497998
8100,409000493210',2018-12-27,Indiaforensic RUPAY STL INTC2712,48.9,0.0,1493145.9700000002,2018,12,27,PAYEMENT,48.9,M1901953696
8101,409000493210',2018-12-27,Indiaforensic  RUPAY SETT 271218,14192.27,0.0,1478953.7000000004,2018,12,27,CASH_OUT,14192.27,C869665662
8102,409000493210',2018-12-27,Indiaforensic  RUPAY SETT 271218,0.0,119.15,1479072.8500000003,2018,12,27,TRANSFER,119.15,M333081545
8103,409000493210',2018-12-27,Indiaforensic RUPAY STL INTC2712,119.15,0.0,1478953.7000000004,2018,12,27,PAYEMENT,119.15,M1093793499
8104,409000493210',2018-12-27,FDRL/INTERNAL FUND TRANSFE,0.0,100000.0,1578953.7000000004,2018,12,27,CHECK_CASHING,100000.0,M1158234446
8105,409000493210',2018-12-27,FDRL/INTERNAL FUND TRANSFE,0.0,100000.0,1678953.7000000004,2018,12,27,TRANSFER,100000.0,M2023806564
8106,409000493210',2018-12-27,Indiaforensic NFS SETT 26-12-201,2800.0,0.0,1676153.7000000004,2018,12,27,CHECK_WITHDRAWAL,2800.0,M498833994
8107,409000493210',2018-12-27,Indiaforensic NFS SETT 26-12-201,500.0,0.0,1675653.7000000004,2018,12,27,PAYEMENT,500.0,C1373172466
8108,409000493210',2018-12-27,Indiaforensic NFS SETT 26-12-201,10000.0,0.0,1665653.7000000004,2018,12,27,PAYEMENT,10000.0,M834871206
8109,409000493210',2018-12-27,Indiaforensic NFS SETT 26-12-201,1000.0,0.0,1664653.7000000004,2018,12,27,CHECK_WITHDRAWAL,1000.0,M1029586776
8110,409000493210',2018-12-27,Indiaforensic NFS SETT 26-12-201,1000.0,0.0,1663653.7000000004,2018,12,27,CHECK_WITHDRAWAL,1000.0,M1221330445
8111,409000493210',2018-12-27,Indiaforensic NFS SETT 26-12-201,500.0,0.0,1663153.7000000004,2018,12,27,DEBIT,500.0,C1811787479
8112,409000493210',2018-12-27,Indiaforensic NFS SETT 26-12-201,500.0,0.0,1662653.7000000004,2018,12,27,CHECK_WITHDRAWAL,500.0,M277698998
8113,409000493210',2018-12-27,Indiaforensic NFS SETT 26-12-201,2000.0,0.0,1660653.7000000004,2018,12,27,DEBIT,2000.0,C451111351
8114,409000493210',2018-12-27,Indiaforensic NFS SETT 26-12-201,1500.0,0.0,1659153.7000000004,2018,12,27,CHECK_WITHDRAWAL,1500.0,C656977363
8115,409000493210',2018-12-28,Indiaforensic  RUPAY SETT 281218,3915.86,0.0,1655237.8400000003,2018,12,28,CHECK_WITHDRAWAL,3915.86,C787033725
8116,409000493210',2018-12-28,Indiaforensic  RUPAY SETT 281218,0.0,38.33,1655276.1700000004,2018,12,28,CHECK_CASHING,38.33,M979132425
8117,409000493210',2018-12-28,Indiaforensic RUPAY STL INTC2812,34.17,0.0,1655242.0000000002,2018,12,28,CASH_OUT,34.17,M654538846
8118,409000493210',2018-12-28,Indiaforensic RUPAY STL INTC2812,0.0,0.02,1655242.0200000003,2018,12,28,TRANSFER,0.02,M1512216535
8119,409000493210',2018-12-28,Indiaforensic  RUPAY SETT 281218,2311.29,0.0,1652930.7300000002,2018,12,28,CASH_OUT,2311.29,C1651945012
8120,409000493210',2018-12-28,Indiaforensic  RUPAY SETT 281218,0.0,106.1,1653036.8300000003,2018,12,28,TRANSFER,106.1,M89432819
8121,409000493210',2018-12-28,Indiaforensic RUPAY STL INTC2812,16.96,0.0,1653019.8700000006,2018,12,28,DEBIT,16.96,M1064991974
8122,409000493210',2018-12-28,Indiaforensic RUPAY STL INTC2812,0.0,0.65,1653020.5200000003,2018,12,28,TRANSFER,0.65,M1032131305
8123,409000493210',2018-12-29,Indiaforensic  RUPAY SETT 291218,7814.64,0.0,1645205.8800000006,2018,12,29,CASH_OUT,7814.64,C803116137
8124,409000493210',2018-12-29,Indiaforensic  RUPAY SETT 291218,0.0,67.69,1645273.5700000003,2018,12,29,CHECK_CASHING,67.69,M76046801
8125,409000493210',2018-12-29,Indiaforensic RUPAY STL INTC2912,67.69,0.0,1645205.8800000006,2018,12,29,PAYEMENT,67.69,M2075098668
8126,409000493210',2018-12-29,Indiaforensic  RUPAY SETT 291218,12400.65,0.0,1632805.230000001,2018,12,29,DEBIT,12400.65,C1213485528
8127,409000493210',2018-12-29,Indiaforensic  RUPAY SETT 291218,0.0,107.93,1632913.1600000006,2018,12,29,TRANSFER,107.93,C11003494
8128,409000493210',2018-12-29,Indiaforensic RUPAY STL INTC2912,105.31,0.0,1632807.8500000006,2018,12,29,CHECK_WITHDRAWAL,105.31,M1558198941
8129,409000493210',2018-12-29,Indiaforensic RUPAY STL INTC2912,0.0,0.01,1632807.8600000006,2018,12,29,CHECK_CASHING,0.01,C1419794148
8130,409000493210',2018-12-31,Indiaforensic NFS SETT 27-12-201,5000.0,0.0,1627807.8600000006,2018,12,31,DEBIT,5000.0,M1065327935
8131,409000493210',2018-12-31,Indiaforensic NFS SETT 27-12-201,1800.0,0.0,1626007.8600000006,2018,12,31,PAYEMENT,1800.0,C1200612373
8132,409000493210',2018-12-31,Indiaforensic NFS SETT 27-12-201,10000.0,0.0,1616007.8600000006,2018,12,31,CHECK_WITHDRAWAL,10000.0,M1762997532
8133,409000493210',2018-12-31,Indiaforensic NFS SETT 27-12-201,8000.0,0.0,1608007.8600000006,2018,12,31,DEBIT,8000.0,M2078517303
8134,409000493210',2018-12-31,Indiaforensic NFS SETT 27-12-201,10000.0,0.0,1598007.8600000006,2018,12,31,CHECK_WITHDRAWAL,10000.0,C1219273867
8135,409000493210',2018-12-31,Indiaforensic NFS SETT 27-12-201,9500.0,0.0,1588507.8600000006,2018,12,31,DEBIT,9500.0,M1219970301
8136,409000493210',2018-12-31,Indiaforensic NFS SETT 27-12-201,10000.0,0.0,1578507.8600000006,2018,12,31,DEBIT,10000.0,M1617253954
8137,409000493210',2018-12-31,Indiaforensic NFS SETT 27-12-201,200.0,0.0,1578307.8600000006,2018,12,31,CHECK_WITHDRAWAL,200.0,M1998948845
8138,409000493210',2018-12-31,Indiaforensic NFS SETT 27-12-201,1000.0,0.0,1577307.8600000006,2018,12,31,DEBIT,1000.0,M201591949
8139,409000493210',2018-12-31,Indiaforensic NFS SETT 27-12-201,2000.0,0.0,1575307.8600000006,2018,12,31,DEBIT,2000.0,C257999182
8140,409000493210',2018-12-31,Indiaforensic NFS SETT 27-12-201,300.0,0.0,1575007.8600000006,2018,12,31,PAYEMENT,300.0,C985934102
8141,409000493210',2018-12-31,Indiaforensic NFS SETT 28-12-201,10000.0,0.0,1565007.8600000006,2018,12,31,PAYEMENT,10000.0,C374625527
8142,409000493210',2018-12-31,Indiaforensic NFS SETT 28-12-201,1000.0,0.0,1564007.8600000006,2018,12,31,CHECK_WITHDRAWAL,1000.0,C1515704208
8143,409000493210',2018-12-31,Indiaforensic NFS SETT 28-12-201,2000.0,0.0,1562007.8600000006,2018,12,31,CASH_OUT,2000.0,M513633400
8144,409000493210',2018-12-31,Indiaforensic NFS SETT 28-12-201,1000.0,0.0,1561007.8600000006,2018,12,31,CASH_OUT,1000.0,M1390374159
8145,409000493210',2018-12-31,Indiaforensic NFS SETT 28-12-201,10000.0,0.0,1551007.8600000006,2018,12,31,PAYEMENT,10000.0,M1580883724
8146,409000493210',2018-12-31,Indiaforensic RUPAY SETT 301218,14309.5,0.0,1536698.3600000006,2018,12,31,DEBIT,14309.5,C451111351
8147,409000493210',2018-12-31,Indiaforensic RUPAY SETT 301218,0.0,113.21,1536811.5700000003,2018,12,31,TRANSFER,113.21,C1234059684
8148,409000493210',2018-12-31,Indiaforensic RUPAY STL INTC3012,113.21,0.0,1536698.3600000006,2018,12,31,PAYEMENT,113.21,C1234776885
8149,409000493210',2018-12-31,Indiaforensic RUPAY SETT 311218,25636.0,0.0,1511062.3600000006,2018,12,31,DEBIT,25636.0,C451111351
8150,409000493210',2018-12-31,Indiaforensic RUPAY SETT 311218,0.0,285.4,1511347.7600000002,2018,12,31,CASH_IN,285.4,C128870695
8151,409000493210',2018-12-31,Indiaforensic RUPAY STL INTC3112,233.84,0.0,1511113.9200000004,2018,12,31,CHECK_WITHDRAWAL,233.84,C1554540309
8152,409000493210',2018-12-31,Indiaforensic RUPAY STL INTC3112,0.0,0.36,1511114.2800000003,2018,12,31,CASH_IN,0.36,C803116137
8153,409000493210',2018-12-31,FDRL/INTERNAL FUND TRANSFE,0.0,32000.0,1543114.2800000003,2018,12,31,CHECK_CASHING,32000.0,C1060041730
8154,409000493210',2018-12-31,FDRL/INTERNAL FUND TRANSFE,0.0,528711.0,2071825.2800000003,2018,12,31,CHECK_CASHING,528711.0,C214774813
8155,409000493210',2018-12-31,Indiaforensic  RUPAY SETT 311218,10434.88,0.0,2061390.4000000008,2018,12,31,CHECK_WITHDRAWAL,10434.88,C257999182
8156,409000493210',2018-12-31,Indiaforensic  RUPAY SETT 311218,0.0,81.78,2061472.1800000009,2018,12,31,CASH_IN,81.78,C1234059684
8157,409000493210',2018-12-31,Indiaforensic RUPAY STL INTC3112,81.78,0.0,2061390.4000000008,2018,12,31,CASH_OUT,81.78,C1674899618
8158,409000438620',2018-01-01,AEPS Indiaforensic INCOME 301217,0.0,187027.63,580994.3499999852,2018,1,1,CASH_IN,187027.63,C1419794148
8159,409000438620',2018-01-01,AEPS Indiaforensic GST 301217,0.0,33664.97,614659.3199999853,2018,1,1,CHECK_CASHING,33664.97,C1778300121
8160,409000438620',2018-01-01,AEPS Indiaforensic INCOME 311217,0.0,133543.25,748202.5699999852,2018,1,1,TRANSFER,133543.25,C1931283804
8161,409000438620',2018-01-01,AEPS Indiaforensic GST 311217,0.0,24037.78,772240.3499999852,2018,1,1,CHECK_CASHING,24037.78,C184253187
8162,409000438620',2018-01-01,Indiaforensic AEPS NPCI WDL SET,0.0,42220056.0,42992296.34999999,2018,1,1,CASH_IN,42220056.0,C1531333864
8163,409000438620',2018-01-01,Indiaforensic AEPS NPCI WDL SET,0.0,28842441.0,71834737.35,2018,1,1,CASH_IN,28842441.0,C863811613
8164,409000438620',2018-01-01,Indiaforensic AEPS NPCI DEP SET,34748966.0,0.0,37085771.35,2018,1,1,CHECK_WITHDRAWAL,34748966.0,C836514715
8165,409000438620',2018-01-01,Indiaforensic AEPS NPCI DEP SET,24426693.0,0.0,12659078.349999996,2018,1,1,PAYEMENT,24426693.0,C1761291320
8166,409000438620',2018-01-01,TRF TO  Indiaforensic SERVICES I,2000000.0,0.0,10659078.349999994,2018,1,1,DEBIT,2000000.0,C2063763486
8167,409000438620',2018-01-01,TRF TO  Indiaforensic SERVICES I,10000000.0,0.0,659078.349999994,2018,1,1,DEBIT,10000000.0,C1427067435
8168,409000438620',2018-01-01,TRF TO  Indiaforensic SERVICES I,500000.0,0.0,159078.34999999404,2018,1,1,CHECK_WITHDRAWAL,500000.0,C662736689
8169,409000438620',2018-01-02,AEPS Indiaforensic INCOME 010118,0.0,119542.23,278620.57999999396,2018,1,2,CASH_IN,119542.23,C1777369261
8170,409000438620',2018-01-02,AEPS Indiaforensic GST 010118,0.0,21517.6,300138.179999994,2018,1,2,CHECK_CASHING,21517.6,C1701412896
8171,409000438620',2018-01-02,Indiaforensic AEPS NPCI WDL SET,0.0,26281758.0,26581896.17999999,2018,1,2,CHECK_CASHING,26281758.0,C932493233
8172,409000438620',2018-01-02,Indiaforensic AEPS NPCI DEP SET,21898671.0,0.0,4683225.179999992,2018,1,2,DEBIT,21898671.0,M1915885313
8173,409000438620',2018-01-02,TRF TO  Indiaforensic SERVICES I,4600000.0,0.0,83225.17999999225,2018,1,2,CHECK_WITHDRAWAL,4600000.0,M405039568
8174,409000438620',2018-01-03,AEPS Indiaforensic INCOME 020118,0.0,190555.73,273780.9099999923,2018,1,3,TRANSFER,190555.73,M13002046
8175,409000438620',2018-01-03,AEPS Indiaforensic GST 020118,0.0,34300.03,308080.93999999226,2018,1,3,TRANSFER,34300.03,C1303868418
8176,409000438620',2018-01-03,Indiaforensic AEPS NPCI WDL SET,0.0,45304997.0,45613077.93999999,2018,1,3,CHECK_CASHING,45304997.0,C1651945012
8177,409000438620',2018-01-03,AEPS ACQUIRING ADJ FEES 0,88.5,0.0,45612989.43999999,2018,1,3,CHECK_WITHDRAWAL,88.5,M1586219070
8178,409000438620',2018-01-03,AEPS ACQ REP ADJ FEES 020,0.0,59.0,45613048.43999999,2018,1,3,TRANSFER,59.0,M1765232168
8179,409000438620',2018-01-03,Indiaforensic AEPS NPCI DEP SET,32022619.0,0.0,13590429.43999999,2018,1,3,CASH_OUT,32022619.0,M956551113
8180,409000438620',2018-01-03,TRF TO  Indiaforensic SERVICES I,13500000.0,0.0,90429.43999999015,2018,1,3,CASH_OUT,13500000.0,M680415425
8181,409000438620',2018-01-04,Indiaforensic AEPS NPCI WDL SET,0.0,46421066.0,46511495.43999999,2018,1,4,TRANSFER,46421066.0,C571435580
8182,409000438620',2018-01-04,AEPS ACQUIRING ADJ FEES 0,17.7,0.0,46511477.73999999,2018,1,4,DEBIT,17.7,C1244869566
8183,409000438620',2018-01-04,AEPS Indiaforensic INCOME 030118,0.0,203728.77,46715206.50999999,2018,1,4,CHECK_CASHING,203728.77,C1838584624
8184,409000438620',2018-01-04,AEPS Indiaforensic GST 030118,0.0,36671.18,46751877.68999999,2018,1,4,CASH_IN,36671.18,M1491019876
8185,409000438620',2018-01-04,Indiaforensic AEPS NPCI DEP SET,37896427.0,0.0,8855450.68999999,2018,1,4,CASH_OUT,37896427.0,M1596390477
8186,409000438620',2018-01-04,TRF TO  Indiaforensic SERVICES I,8800000.0,0.0,55450.689999990165,2018,1,4,CHECK_WITHDRAWAL,8800000.0,M531855844
8187,409000438620',2018-01-05,Indiaforensic AEPS NPCI WDL SET,0.0,44256042.0,44311492.68999999,2018,1,5,TRANSFER,44256042.0,M1739703215
8188,409000438620',2018-01-05,Indiaforensic AEPS NPCI DEP SET,37693730.0,0.0,6617762.68999999,2018,1,5,DEBIT,37693730.0,C634210724
8189,409000438620',2018-01-05,AEPS ACQ REP ADJ FEES 040,0.0,88.5,6617851.18999999,2018,1,5,CHECK_CASHING,88.5,C465257140
8190,409000438620',2018-01-05,AEPS Indiaforensic INCOME 040118,0.0,199872.24,6817723.42999999,2018,1,5,CASH_IN,199872.24,M552806685
8191,409000438620',2018-01-05,AEPS Indiaforensic GST 040118,0.0,35977.0,6853700.42999999,2018,1,5,CASH_IN,35977.0,M1699593080
8192,409000438620',2018-01-05,TRF TO  Indiaforensic SERVICES I,3000000.0,0.0,3853700.4299999913,2018,1,5,CASH_OUT,3000000.0,C1436136891
8193,409000438620',2018-01-05,TRF TO  Indiaforensic SERVICES I,3000000.0,0.0,853700.4299999905,2018,1,5,CHECK_WITHDRAWAL,3000000.0,M113468028
8194,409000438620',2018-01-06,Indiaforensic AEPS NPCI WDL SET,0.0,44583319.0,45437019.42999999,2018,1,6,CASH_IN,44583319.0,M1074852402
8195,409000438620',2018-01-06,AEPS ACQUIRING ADJ FEES 0,56.05,0.0,45436963.38,2018,1,6,CHECK_WITHDRAWAL,56.05,M972236893
8196,409000438620',2018-01-06,Indiaforensic AEPS NPCI DEP SET,35784266.0,0.0,9652697.379999997,2018,1,6,CHECK_WITHDRAWAL,35784266.0,M485998677
8197,409000438620',2018-01-06,AEPS Indiaforensic INCOME 050118,0.0,198695.99,9851393.369999995,2018,1,6,CASH_IN,198695.99,C1577253667
8198,409000438620',2018-01-06,AEPS Indiaforensic GST 050118,0.0,35765.28,9887158.649999997,2018,1,6,TRANSFER,35765.28,M970909181
8199,409000438620',2018-01-06,TRF TO  Indiaforensic SERVICES I,3000000.0,0.0,6887158.649999995,2018,1,6,PAYEMENT,3000000.0,M784488689
8200,409000438620',2018-01-06,TRF TO  Indiaforensic SERVICES I,3000000.0,0.0,3887158.649999995,2018,1,6,DEBIT,3000000.0,M2118892964
8201,409000438620',2018-01-06,TRF TO  Indiaforensic SERVICES I,3000000.0,0.0,887158.6499999949,2018,1,6,PAYEMENT,3000000.0,M307536845
8202,409000438620',2018-01-08,Indiaforensic AEPS NPCI WDL SET,0.0,44107979.0,44995137.64999999,2018,1,8,CASH_IN,44107979.0,M588108658
8203,409000438620',2018-01-08,Indiaforensic AEPS NPCI WDL SET,0.0,31469794.0,76464931.64999999,2018,1,8,TRANSFER,31469794.0,M1371624712
8204,409000438620',2018-01-08,AEPS ACQUIRING ADJ FEES 0,302.07,0.0,76464629.58,2018,1,8,PAYEMENT,302.07,M1536653994
8205,409000438620',2018-01-08,AEPS Indiaforensic INCOME 060118,0.0,195467.89,76660097.47,2018,1,8,CASH_IN,195467.89,M14679281
8206,409000438620',2018-01-08,AEPS Indiaforensic GST 060118,0.0,35184.22,76695281.69,2018,1,8,TRANSFER,35184.22,M321421684
8207,409000438620',2018-01-08,AEPS Indiaforensic INCOME 070118,0.0,143628.09,76838909.78,2018,1,8,TRANSFER,143628.09,C1529115495
8208,409000438620',2018-01-08,AEPS Indiaforensic GST 070118,0.0,25853.06,76864762.84,2018,1,8,CASH_IN,25853.06,M2147158964
8209,409000438620',2018-01-08,Indiaforensic AEPS NPCI DEP SET,35299565.0,0.0,41565197.84,2018,1,8,CHECK_WITHDRAWAL,35299565.0,C1360767589
8210,409000438620',2018-01-08,Indiaforensic AEPS NPCI DEP SET,26341855.0,0.0,15223342.840000005,2018,1,8,PAYEMENT,26341855.0,M1842201464
8211,409000438620',2018-01-08,TRF TO  Indiaforensic SERVICES I,15000000.0,0.0,223342.8400000036,2018,1,8,DEBIT,15000000.0,M438506351
8212,409000438620',2018-01-08,CB734512443906/RMCPL16998/1,5000.0,0.0,218342.8400000036,2018,1,8,CASH_OUT,5000.0,M544361505
8213,409000438620',2018-01-08,CB734713491992/RMCPL12814/1,1000.0,0.0,217342.8400000036,2018,1,8,CASH_OUT,1000.0,M246836039
8214,409000438620',2018-01-08,CB731511349381/RMCPL15250/1,10000.0,0.0,207342.8400000036,2018,1,8,PAYEMENT,10000.0,M600185883
8215,409000438620',2018-01-08,CB734712444301/RMCPL21147/1,3000.0,0.0,204342.8400000036,2018,1,8,CHECK_WITHDRAWAL,3000.0,M2000471377
8216,409000438620',2018-01-08,CB734816594359/RMCPL15328/1,2000.0,0.0,202342.8400000036,2018,1,8,DEBIT,2000.0,M1326405365
8217,409000438620',2018-01-08,CB735515169681/RMCPL20273/2,7000.0,0.0,195342.8400000036,2018,1,8,CASH_OUT,7000.0,M2136756216
8218,409000438620',2018-01-08,CB733812559693/RMCPL18736/0,0.0,10000.0,205342.8400000036,2018,1,8,TRANSFER,10000.0,M1126139952
8219,409000438620',2018-01-08,CB733811498368/RMCPL13957/0,0.0,9500.0,214842.8400000036,2018,1,8,TRANSFER,9500.0,M1745174877
8220,409000438620',2018-01-08,CB734510328137/RMCPL21476/1,0.0,10000.0,224842.8400000036,2018,1,8,TRANSFER,10000.0,M932255242
8221,409000438620',2018-01-08,CB734512447515/RMCPL17988/1,0.0,2000.0,226842.8400000036,2018,1,8,CASH_IN,2000.0,C1725062057
8222,409000438620',2018-01-08,CB734512447618/RMCPL18192/1,0.0,10000.0,236842.8400000036,2018,1,8,TRANSFER,10000.0,M1436731998
8223,409000438620',2018-01-08,CB734512439567/RMCPL12832/1,0.0,10000.0,246842.8400000036,2018,1,8,CASH_IN,10000.0,M314280259
8224,409000438620',2018-01-08,CB734613512083/RMCPL16545/1,0.0,10000.0,256842.8400000036,2018,1,8,CASH_IN,10000.0,M105320614
8225,409000438620',2018-01-08,CB735313581670/RMCPL19124/1,0.0,8000.0,264842.8400000036,2018,1,8,CHECK_CASHING,8000.0,M1207334820
8226,409000438620',2018-01-08,CB735017271350/RMCPL14779/1,0.0,500.0,265342.8400000036,2018,1,8,TRANSFER,500.0,C1880332929
8227,409000438620',2018-01-08,CB735014140965/RMCPL19664/1,0.0,10000.0,275342.8400000036,2018,1,8,TRANSFER,10000.0,M1538546428
8228,409000438620',2018-01-08,CB735012055165/RMCPL19724/1,0.0,1200.0,276542.8400000036,2018,1,8,TRANSFER,1200.0,M504913926
8229,409000438620',2018-01-08,CB735012054759/RMCPL19068/1,0.0,3500.0,280042.8400000036,2018,1,8,CHECK_CASHING,3500.0,M251950704
8230,409000438620',2018-01-09,Indiaforensic AEPS NPCI WDL SET,0.0,52353572.0,52633614.84,2018,1,9,TRANSFER,52353572.0,M668222840
8231,409000438620',2018-01-09,AEPS ACQUIRING ADJ FEES 0,17.7,0.0,52633597.14,2018,1,9,PAYEMENT,17.7,M148704368
8232,409000438620',2018-01-09,AEPS ACQ CR ADJ FEES 0801,2507.66,0.0,52631089.48,2018,1,9,DEBIT,2507.66,M2144798813
8233,409000438620',2018-01-09,CR735512048508/RMCPL13859/2,500.0,0.0,52630589.48,2018,1,9,CASH_OUT,500.0,M152177845
8234,409000438620',2018-01-09,CR735515167533/RMCPL10817/2,6000.0,0.0,52624589.48,2018,1,9,DEBIT,6000.0,M1603529730
8235,409000438620',2018-01-09,CR735515168185/RMCPL22051/2,6000.0,0.0,52618589.48,2018,1,9,CHECK_WITHDRAWAL,6000.0,M1310907099
8236,409000438620',2018-01-09,CR735515169613/RMCPL17146/2,10000.0,0.0,52608589.48,2018,1,9,DEBIT,10000.0,M445735200
8237,409000438620',2018-01-09,CR735515169630/RMCPL20499/2,2500.0,0.0,52606089.48,2018,1,9,DEBIT,2500.0,M1969217453
8238,409000438620',2018-01-09,CR735512049052/RMCPL17470/2,166.0,0.0,52605923.48,2018,1,9,PAYEMENT,166.0,M764482683
8239,409000438620',2018-01-09,CR735515169785/RMCPL17511/2,3000.0,0.0,52602923.48,2018,1,9,CHECK_WITHDRAWAL,3000.0,M312082131
8240,409000438620',2018-01-09,CR735515167923/RMCPL15232/2,2000.0,0.0,52600923.48,2018,1,9,DEBIT,2000.0,M1287155721
8241,409000438620',2018-01-09,CR735512048035/RMCPL14700/2,5000.0,0.0,52595923.48,2018,1,9,CASH_OUT,5000.0,M266571038
8242,409000438620',2018-01-09,CR735512047074/RMCPL12509/2,500.0,0.0,52595423.48,2018,1,9,PAYEMENT,500.0,M359819227
8243,409000438620',2018-01-09,CR735514122362/RMCPL16880/2,1500.0,0.0,52593923.48,2018,1,9,PAYEMENT,1500.0,M1485974016
8244,409000438620',2018-01-09,CR735515168153/RMCPL16146/2,500.0,0.0,52593423.48,2018,1,9,DEBIT,500.0,M1862912920
8245,409000438620',2018-01-09,CR735515167953/RMCPL14609/2,1500.0,0.0,52591923.48,2018,1,9,CASH_OUT,1500.0,M993904466
8246,409000438620',2018-01-09,CR735511020377/RMCPL16880/2,1500.0,0.0,52590423.48,2018,1,9,PAYEMENT,1500.0,M1792339731
8247,409000438620',2018-01-09,CR735512048787/RMCPL19012/2,3000.0,0.0,52587423.48,2018,1,9,PAYEMENT,3000.0,M2088388998
8248,409000438620',2018-01-09,CR735515167389/RMCPL18492/2,5000.0,0.0,52582423.48,2018,1,9,PAYEMENT,5000.0,M2142397531
8249,409000438620',2018-01-09,CR735515167160/RMCPL20676/2,5000.0,0.0,52577423.48,2018,1,9,DEBIT,5000.0,M940459786
8250,409000438620',2018-01-09,CR735514122258/RMCPL21735/2,500.0,0.0,52576923.48,2018,1,9,DEBIT,500.0,M2068183023
8251,409000438620',2018-01-09,CR735515167934/RMCPL15094/2,2000.0,0.0,52574923.48,2018,1,9,CHECK_WITHDRAWAL,2000.0,M400045995
8252,409000438620',2018-01-09,CR735511019904/RMCPL11353/2,2000.0,0.0,52572923.48,2018,1,9,CHECK_WITHDRAWAL,2000.0,M442076720
8253,409000438620',2018-01-09,CR735512047077/RMCPL19329/2,4000.0,0.0,52568923.48,2018,1,9,PAYEMENT,4000.0,M836487773
8254,409000438620',2018-01-09,CR735512050179/RMCPL20493/2,2000.0,0.0,52566923.48,2018,1,9,CHECK_WITHDRAWAL,2000.0,C919978702
8255,409000438620',2018-01-09,CR735514122268/RMCPL15751/2,3000.0,0.0,52563923.48,2018,1,9,CASH_OUT,3000.0,M933099011
8256,409000438620',2018-01-09,CR735512048312/RMCPL16637/2,2500.0,0.0,52561423.48,2018,1,9,PAYEMENT,2500.0,M1372855191
8257,409000438620',2018-01-09,CR735512047092/RMCPL16824/2,100.0,0.0,52561323.48,2018,1,9,CASH_OUT,100.0,M656805788
8258,409000438620',2018-01-09,CR735514122265/RMCPL05271/2,2000.0,0.0,52559323.48,2018,1,9,PAYEMENT,2000.0,M1425711168
8259,409000438620',2018-01-09,CR735515169717/RMCPL19867/2,500.0,0.0,52558823.48,2018,1,9,PAYEMENT,500.0,M572087558
8260,409000438620',2018-01-09,CR735515169174/RMCPL09843/2,500.0,0.0,52558323.48,2018,1,9,CASH_OUT,500.0,M505434149
8261,409000438620',2018-01-09,CR735515167526/RMCPL19182/2,1500.0,0.0,52556823.48,2018,1,9,PAYEMENT,1500.0,M1678338625
8262,409000438620',2018-01-09,CR735511020818/RMCPL17616/2,1000.0,0.0,52555823.48,2018,1,9,PAYEMENT,1000.0,C365212068
8263,409000438620',2018-01-09,CR735515169650/RMCPL17775/2,10000.0,0.0,52545823.48,2018,1,9,CHECK_WITHDRAWAL,10000.0,C1345063038
8264,409000438620',2018-01-09,CR735514122261/RMCPL18740/2,10000.0,0.0,52535823.48,2018,1,9,PAYEMENT,10000.0,C853932876
8265,409000438620',2018-01-09,CR735511019923/RMCPL12312/2,1010.0,0.0,52534813.48,2018,1,9,CASH_OUT,1010.0,C1137422246
8266,409000438620',2018-01-09,CR735515167555/RMCPL09649/2,500.0,0.0,52534313.48,2018,1,9,CASH_OUT,500.0,C1297685781
8267,409000438620',2018-01-09,CR735511019929/RMCPL14190/2,1500.0,0.0,52532813.48,2018,1,9,DEBIT,1500.0,C662736689
8268,409000438620',2018-01-09,CR735511019932/RMCPL13301/2,1500.0,0.0,52531313.48,2018,1,9,PAYEMENT,1500.0,C2144647660
8269,409000438620',2018-01-09,CR735511020500/RMCPL00154/2,7000.0,0.0,52524313.48,2018,1,9,CHECK_WITHDRAWAL,7000.0,C1495761010
8270,409000438620',2018-01-09,CR735511022351/RMCPL17438/2,500.0,0.0,52523813.48,2018,1,9,DEBIT,500.0,M1599108857
8271,409000438620',2018-01-09,CR735512050144/RMCPL21490/2,5000.0,0.0,52518813.48,2018,1,9,CHECK_WITHDRAWAL,5000.0,M1867773348
8272,409000438620',2018-01-09,CR735511019933/RMCPL13893/2,5500.0,0.0,52513313.48,2018,1,9,CHECK_WITHDRAWAL,5500.0,M2102441156
8273,409000438620',2018-01-09,CR735515168060/RMCPL18414/2,10000.0,0.0,52503313.48,2018,1,9,CASH_OUT,10000.0,M141460585
8274,409000438620',2018-01-09,CR735515167156/RMCPL16323/2,10000.0,0.0,52493313.48,2018,1,9,CASH_OUT,10000.0,M238605909
8275,409000438620',2018-01-09,CR735515168072/RMCPL16092/2,500.0,0.0,52492813.48,2018,1,9,CASH_OUT,500.0,M261371975
8276,409000438620',2018-01-09,CR735515167985/RMCPL19308/2,1000.0,0.0,52491813.48,2018,1,9,DEBIT,1000.0,C40075281
8277,409000438620',2018-01-09,CR735515169783/RMCPL20016/2,1000.0,0.0,52490813.48,2018,1,9,DEBIT,1000.0,C1155337528
8278,409000438620',2018-01-09,CR735511019938/RMCPL18863/2,2000.0,0.0,52488813.48,2018,1,9,DEBIT,2000.0,M1959449975
8279,409000438620',2018-01-09,CR735512049381/RMCPL22099/2,2000.0,0.0,52486813.48,2018,1,9,DEBIT,2000.0,M733671868
8280,409000438620',2018-01-09,CR735515169185/RMCPL11624/2,10000.0,0.0,52476813.48,2018,1,9,DEBIT,10000.0,M1195781551
8281,409000438620',2018-01-09,CR735515169195/RMCPL20613/2,500.0,0.0,52476313.48,2018,1,9,DEBIT,500.0,M1060553105
8282,409000438620',2018-01-09,CR735511019903/RMCPL19562/2,500.0,0.0,52475813.48,2018,1,9,DEBIT,500.0,M88760063
8283,409000438620',2018-01-09,CR735915929758/RMCPL16571/2,2000.0,0.0,52473813.48,2018,1,9,CHECK_WITHDRAWAL,2000.0,M542263318
8284,409000438620',2018-01-09,CR735915929725/RMCPL21122/2,5000.0,0.0,52468813.48,2018,1,9,CASH_OUT,5000.0,M1033287931
8285,409000438620',2018-01-09,CR735611673122/RMCPL18968/2,1000.0,0.0,52467813.48,2018,1,9,CASH_OUT,1000.0,M788557535
8286,409000438620',2018-01-09,CR735611673152/RMCPL21551/2,500.0,0.0,52467313.48,2018,1,9,CHECK_WITHDRAWAL,500.0,C1337563431
8287,409000438620',2018-01-09,CR735611673062/RMCPL21507/2,500.0,0.0,52466813.48,2018,1,9,DEBIT,500.0,C705265015
8288,409000438620',2018-01-09,CR735611673131/RMCPL17642/2,10000.0,0.0,52456813.48,2018,1,9,DEBIT,10000.0,M495113052
8289,409000438620',2018-01-09,CR735611673141/RMCPL21565/2,4000.0,0.0,52452813.48,2018,1,9,PAYEMENT,4000.0,M1555450780
8290,409000438620',2018-01-09,CR735611672997/RMCPL17812/2,500.0,0.0,52452313.48,2018,1,9,DEBIT,500.0,M656689800
8291,409000438620',2018-01-09,CR736111067950/RMCPL13088/2,2000.0,0.0,52450313.48,2018,1,9,CASH_OUT,2000.0,M1780694323
8292,409000438620',2018-01-09,CR736212797872/RMCPL15594/2,5000.0,0.0,52445313.48,2018,1,9,DEBIT,5000.0,C894315519
8293,409000438620',2018-01-09,CR736212797977/RMCPL17307/2,3000.0,0.0,52442313.48,2018,1,9,CASH_OUT,3000.0,C1337563431
8294,409000438620',2018-01-09,CR736212797868/RMCPL17123/2,700.0,0.0,52441613.48,2018,1,9,CHECK_WITHDRAWAL,700.0,M881883721
8295,409000438620',2018-01-09,CR736212798028/RMCPL19235/2,500.0,0.0,52441113.48,2018,1,9,CASH_OUT,500.0,C289039926
8296,409000438620',2018-01-09,CR800216339006/RMCPL21647/0,1500.0,0.0,52439613.48,2018,1,9,CHECK_WITHDRAWAL,1500.0,M363717234
8297,409000438620',2018-01-09,CR800214256878/RMCPL08124/0,500.0,0.0,52439113.48,2018,1,9,DEBIT,500.0,M222457345
8298,409000438620',2018-01-09,CR800214256869/RMCPL17219/0,5000.0,0.0,52434113.48,2018,1,9,CASH_OUT,5000.0,M2123339741
8299,409000438620',2018-01-09,CR800213216785/RMCPL14739/0,5000.0,0.0,52429113.48,2018,1,9,PAYEMENT,5000.0,M110650017
8300,409000438620',2018-01-09,CR800214258657/RMCPL10984/0,2000.0,0.0,52427113.48,2018,1,9,CHECK_WITHDRAWAL,2000.0,M1516522869
8301,409000438620',2018-01-09,CR800213216828/RMCPL15612/0,10000.0,0.0,52417113.48,2018,1,9,DEBIT,10000.0,C2063763486
8302,409000438620',2018-01-09,CR800216339082/RMCPL22365/0,5000.0,0.0,52412113.48,2018,1,9,CASH_OUT,5000.0,M1182693267
8303,409000438620',2018-01-09,CR800214256798/RMCPL18141/0,500.0,0.0,52411613.48,2018,1,9,CASH_OUT,500.0,C1948471365
8304,409000438620',2018-01-09,CR800216339330/RMCPL20241/0,3000.0,0.0,52408613.48,2018,1,9,CASH_OUT,3000.0,M1008662534
8305,409000438620',2018-01-09,CR800216329019/RMCPL21235/0,500.0,0.0,52408113.48,2018,1,9,CASH_OUT,500.0,M2075922925
8306,409000438620',2018-01-09,CR800217384240/RMCPL22565/0,1000.0,0.0,52407113.48,2018,1,9,PAYEMENT,1000.0,M920722272
8307,409000438620',2018-01-09,CR800218401335/RMCPL18488/0,500.0,0.0,52406613.48,2018,1,9,CHECK_WITHDRAWAL,500.0,M1794125280
8308,409000438620',2018-01-09,CR800216339087/RMCPL10820/0,2000.0,0.0,52404613.48,2018,1,9,PAYEMENT,2000.0,C384887832
8309,409000438620',2018-01-09,CR800214256984/RMCPL16122/0,1000.0,0.0,52403613.48,2018,1,9,CHECK_WITHDRAWAL,1000.0,C1577826863
8310,409000438620',2018-01-09,CR800214258554/RMCPL21375/0,2000.0,0.0,52401613.48,2018,1,9,PAYEMENT,2000.0,M1343837945
8311,409000438620',2018-01-09,CR800214256823/RMCPL14536/0,5000.0,0.0,52396613.48,2018,1,9,PAYEMENT,5000.0,M1337906940
8312,409000438620',2018-01-09,CR800214256944/RMCPL09500/0,10000.0,0.0,52386613.48,2018,1,9,DEBIT,10000.0,M19509485
8313,409000438620',2018-01-09,CR800216339238/RMCPL20680/0,1000.0,0.0,52385613.48,2018,1,9,CASH_OUT,1000.0,M1979657069
8314,409000438620',2018-01-09,CR800216339297/RMCPL17843/0,5000.0,0.0,52380613.48,2018,1,9,PAYEMENT,5000.0,M1323829908
8315,409000438620',2018-01-09,CR800217384313/RMCPL18497/0,1000.0,0.0,52379613.48,2018,1,9,PAYEMENT,1000.0,M1993482475
8316,409000438620',2018-01-09,CR800214256887/RMCPL13036/0,500.0,0.0,52379113.48,2018,1,9,DEBIT,500.0,C1721246982
8317,409000438620',2018-01-09,CR800214258572/RMCPL18519/0,3000.0,0.0,52376113.48,2018,1,9,CASH_OUT,3000.0,M97394375
8318,409000438620',2018-01-09,CR800214259646/RMCPL17273/0,900.0,0.0,52375213.48,2018,1,9,PAYEMENT,900.0,M817720264
8319,409000438620',2018-01-09,CR800216329066/RMCPL17413/0,3030.0,0.0,52372183.48,2018,1,9,CHECK_WITHDRAWAL,3030.0,M151754389
8320,409000438620',2018-01-09,CR800216339309/RMCPL20451/0,2000.0,0.0,52370183.48,2018,1,9,DEBIT,2000.0,M1440183980
8321,409000438620',2018-01-09,CR800216339053/RMCPL18576/0,7000.0,0.0,52363183.48,2018,1,9,CHECK_WITHDRAWAL,7000.0,M1217159306
8322,409000438620',2018-01-09,CR800214256990/RMCPL15896/0,4000.0,0.0,52359183.48,2018,1,9,CASH_OUT,4000.0,M1440753249
8323,409000438620',2018-01-09,CR800217384486/RMCPL21493/0,1000.0,0.0,52358183.48,2018,1,9,CHECK_WITHDRAWAL,1000.0,M1419502343
8324,409000438620',2018-01-09,CR800217384350/RMCPL21219/0,1000.0,0.0,52357183.48,2018,1,9,DEBIT,1000.0,M1493446952
8325,409000438620',2018-01-09,CR800217384482/RMCPL16787/0,2500.0,0.0,52354683.48,2018,1,9,DEBIT,2500.0,M1865113742
8326,409000438620',2018-01-09,CR800214259635/RMCPL18607/0,2000.0,0.0,52352683.48,2018,1,9,PAYEMENT,2000.0,M69207690
8327,409000438620',2018-01-09,CR800213216786/RMCPL12897/0,500.0,0.0,52352183.48,2018,1,9,DEBIT,500.0,M1296250873
8328,409000438620',2018-01-09,CR800213216762/RMCPL19040/0,2500.0,0.0,52349683.48,2018,1,9,DEBIT,2500.0,M444542260
8329,409000438620',2018-01-09,CR800216339018/RMCPL16977/0,500.0,0.0,52349183.48,2018,1,9,DEBIT,500.0,M1997290658
8330,409000438620',2018-01-09,CR800213216794/RMCPL22266/0,310.0,0.0,52348873.48,2018,1,9,CHECK_WITHDRAWAL,310.0,M1897030087
8331,409000438620',2018-01-09,CR800216339124/RMCPL19895/0,500.0,0.0,52348373.48,2018,1,9,DEBIT,500.0,M1704289773
8332,409000438620',2018-01-09,CR800214258739/RMCPL20369/0,3000.0,0.0,52345373.48,2018,1,9,PAYEMENT,3000.0,M719383448
8333,409000438620',2018-01-09,CR800214258616/RMCPL16021/0,10000.0,0.0,52335373.48,2018,1,9,DEBIT,10000.0,M1118346479
8334,409000438620',2018-01-09,CR800214258668/RMCPL21061/0,10000.0,0.0,52325373.48,2018,1,9,PAYEMENT,10000.0,M1386362229
8335,409000438620',2018-01-09,CR800218401426/RMCPL15518/0,2000.0,0.0,52323373.48,2018,1,9,DEBIT,2000.0,M957251916
8336,409000438620',2018-01-09,CR800216339079/RMCPL09136/0,5000.0,0.0,52318373.48,2018,1,9,DEBIT,5000.0,M419233406
8337,409000438620',2018-01-09,CR800214258677/RMCPL21970/0,1500.0,0.0,52316873.48,2018,1,9,PAYEMENT,1500.0,M1394205948
8338,409000438620',2018-01-09,CR800214258621/RMCPL20329/0,1000.0,0.0,52315873.48,2018,1,9,DEBIT,1000.0,M1152917511
8339,409000438620',2018-01-09,CR800217384331/RMCPL11796/0,4000.0,0.0,52311873.48,2018,1,9,CASH_OUT,4000.0,M1178605557
8340,409000438620',2018-01-09,CR800214258650/RMCPL11707/0,10000.0,0.0,52301873.48,2018,1,9,PAYEMENT,10000.0,M964662898
8341,409000438620',2018-01-09,CR800213216735/RMCPL21258/0,5000.0,0.0,52296873.48,2018,1,9,CASH_OUT,5000.0,M886940084
8342,409000438620',2018-01-09,CR800213216969/RMCPL09099/0,1500.0,0.0,52295373.48,2018,1,9,CASH_OUT,1500.0,M1555348096
8343,409000438620',2018-01-09,CR800213216795/RMCPL18815/0,5960.0,0.0,52289413.48,2018,1,9,CASH_OUT,5960.0,M1349617601
8344,409000438620',2018-01-09,CR800214258605/RMCPL21685/0,500.0,0.0,52288913.48,2018,1,9,PAYEMENT,500.0,M1538853769
8345,409000438620',2018-01-09,CR800215262943/RMCPL14588/0,1500.0,0.0,52287413.48,2018,1,9,DEBIT,1500.0,M1277370210
8346,409000438620',2018-01-09,CR800215262908/RMCPL22133/0,1000.0,0.0,52286413.48,2018,1,9,PAYEMENT,1000.0,M2080300983
8347,409000438620',2018-01-09,CR800215262976/RMCPL22606/0,7500.0,0.0,52278913.48,2018,1,9,CHECK_WITHDRAWAL,7500.0,C1147977782
8348,409000438620',2018-01-09,CR800215263203/RMCPL10073/0,500.0,0.0,52278413.48,2018,1,9,DEBIT,500.0,M306013803
8349,409000438620',2018-01-09,CR800215263308/RMCPL17905/0,1000.0,0.0,52277413.48,2018,1,9,DEBIT,1000.0,M2118449545
8350,409000438620',2018-01-09,CR800215262938/RMCPL16095/0,4000.0,0.0,52273413.48,2018,1,9,CASH_OUT,4000.0,C621014131
8351,409000438620',2018-01-09,CR800215263041/RMCPL20628/0,4000.0,0.0,52269413.48,2018,1,9,CHECK_WITHDRAWAL,4000.0,M1402941420
8352,409000438620',2018-01-09,CR800215263313/RMCPL19453/0,500.0,0.0,52268913.48,2018,1,9,DEBIT,500.0,M2101767929
8353,409000438620',2018-01-09,CR800215263023/RMCPL19040/0,6000.0,0.0,52262913.48,2018,1,9,DEBIT,6000.0,M1612491156
8354,409000438620',2018-01-09,CR800211119242/RMCPL14751/0,2000.0,0.0,52260913.48,2018,1,9,CHECK_WITHDRAWAL,2000.0,M1412611602
8355,409000438620',2018-01-09,CR800215263325/RMCPL16216/0,1000.0,0.0,52259913.48,2018,1,9,PAYEMENT,1000.0,M724611679
8356,409000438620',2018-01-09,CR800215263136/RMCPL13526/0,500.0,0.0,52259413.48,2018,1,9,PAYEMENT,500.0,M425543552
8357,409000438620',2018-01-09,CR800215262948/RMCPL16925/0,2500.0,0.0,52256913.48,2018,1,9,CASH_OUT,2500.0,M918922423
8358,409000438620',2018-01-09,CR800215263100/RMCPL21378/0,2000.0,0.0,52254913.48,2018,1,9,CASH_OUT,2000.0,M1747047649
8359,409000438620',2018-01-09,CR800215263375/RMCPL19609/0,3000.0,0.0,52251913.48,2018,1,9,PAYEMENT,3000.0,M557613354
8360,409000438620',2018-01-09,CR800211119240/RMCPL14165/0,510.0,0.0,52251403.48,2018,1,9,CASH_OUT,510.0,C1254526270
8361,409000438620',2018-01-09,CR800215263052/RMCPL18313/0,1000.0,0.0,52250403.48,2018,1,9,CHECK_WITHDRAWAL,1000.0,M1114712230
8362,409000438620',2018-01-09,CR735412331067/RMCPL12330/2,500.0,0.0,52249903.48,2018,1,9,CASH_OUT,500.0,C929452805
8363,409000438620',2018-01-09,CR735412330940/RMCPL19959/2,500.0,0.0,52249403.48,2018,1,9,PAYEMENT,500.0,C1262822392
8364,409000438620',2018-01-09,CR735412331112/RMCPL12720/2,600.0,0.0,52248803.48,2018,1,9,CHECK_WITHDRAWAL,600.0,M672023440
8365,409000438620',2018-01-09,CR735412331117/RMCPL18921/2,2000.0,0.0,52246803.48,2018,1,9,PAYEMENT,2000.0,M1039655689
8366,409000438620',2018-01-09,CR735412331062/RMCPL13301/2,500.0,0.0,52246303.48,2018,1,9,CASH_OUT,500.0,C1805683209
8367,409000438620',2018-01-09,CR735412330931/RMCPL20395/2,2500.0,0.0,52243803.48,2018,1,9,PAYEMENT,2500.0,M534021387
8368,409000438620',2018-01-09,CR735412331027/RMCPL14615/2,7000.0,0.0,52236803.48,2018,1,9,PAYEMENT,7000.0,M1868532012
8369,409000438620',2018-01-09,CR735412330836/RMCPL15577/2,3000.0,0.0,52233803.48,2018,1,9,PAYEMENT,3000.0,M980801953
8370,409000438620',2018-01-09,CR735412330858/RMCPL15030/2,10000.0,0.0,52223803.48,2018,1,9,CHECK_WITHDRAWAL,10000.0,M2047368450
8371,409000438620',2018-01-09,CR735412331024/RMCPL20528/2,3000.0,0.0,52220803.48,2018,1,9,CHECK_WITHDRAWAL,3000.0,M2017601039
8372,409000438620',2018-01-09,CR735412330872/RMCPL14215/2,10000.0,0.0,52210803.48,2018,1,9,PAYEMENT,10000.0,C1672788422
8373,409000438620',2018-01-09,CR735412331079/RMCPL21904/2,2000.0,0.0,52208803.48,2018,1,9,CHECK_WITHDRAWAL,2000.0,M1510692106
8374,409000438620',2018-01-09,CR735412331011/RMCPL20318/2,1000.0,0.0,52207803.48,2018,1,9,CASH_OUT,1000.0,M1775883042
8375,409000438620',2018-01-09,CR735412330832/RMCPL12288/2,1500.0,0.0,52206303.48,2018,1,9,CHECK_WITHDRAWAL,1500.0,M1308652091
8376,409000438620',2018-01-09,CR735412330868/RMCPL16572/2,500.0,0.0,52205803.48,2018,1,9,PAYEMENT,500.0,M1507317108
8377,409000438620',2018-01-09,CR735412331113/RMCPL14954/2,500.0,0.0,52205303.48,2018,1,9,DEBIT,500.0,M1142388059
8378,409000438620',2018-01-09,CR735412331111/RMCPL17350/2,5000.0,0.0,52200303.48,2018,1,9,CHECK_WITHDRAWAL,5000.0,C2066777507
8379,409000438620',2018-01-09,CR736111068862/RMCPL20908/2,500.0,0.0,52199803.48,2018,1,9,CASH_OUT,500.0,C1577253667
8380,409000438620',2018-01-09,CR800216330156/RMCPL18302/0,3000.0,0.0,52196803.48,2018,1,9,CHECK_WITHDRAWAL,3000.0,C1916720513
8381,409000438620',2018-01-09,CR800216330192/RMCPL17428/0,2000.0,0.0,52194803.48,2018,1,9,DEBIT,2000.0,C1721246982
8382,409000438620',2018-01-09,CR800214260985/RMCPL16629/0,2000.0,0.0,52192803.48,2018,1,9,CASH_OUT,2000.0,C967425740
8383,409000438620',2018-01-09,CR800216330061/RMCPL17562/0,500.0,0.0,52192303.48,2018,1,9,PAYEMENT,500.0,C1899073220
8384,409000438620',2018-01-09,CR800216330049/RMCPL13710/0,500.0,0.0,52191803.48,2018,1,9,CASH_OUT,500.0,C486371171
8385,409000438620',2018-01-09,CR800216330198/RMCPL17405/0,2000.0,0.0,52189803.48,2018,1,9,PAYEMENT,2000.0,C242131142
8386,409000438620',2018-01-09,CR800218395346/RMCPL09181/0,500.0,0.0,52189303.48,2018,1,9,PAYEMENT,500.0,C1060041730
8387,409000438620',2018-01-09,CR800216330132/RMCPL00152/0,1000.0,0.0,52188303.48,2018,1,9,DEBIT,1000.0,C1289462509
8388,409000438620',2018-01-09,CR800214261045/RMCPL16467/0,2000.0,0.0,52186303.48,2018,1,9,CHECK_WITHDRAWAL,2000.0,C705265015
8389,409000438620',2018-01-09,CR800214261173/RMCPL17273/0,2500.0,0.0,52183803.48,2018,1,9,PAYEMENT,2500.0,C1360767589
8390,409000438620',2018-01-09,CR800214261203/RMCPL16571/0,1000.0,0.0,52182803.48,2018,1,9,DEBIT,1000.0,C1191924243
8391,409000438620',2018-01-09,CR800218395279/RMCPL18271/0,2500.0,0.0,52180303.48,2018,1,9,CASH_OUT,2500.0,C392292416
8392,409000438620',2018-01-09,CR800218395378/RMCPL17285/0,1500.0,0.0,52178803.48,2018,1,9,PAYEMENT,1500.0,C726762476
8393,409000438620',2018-01-09,CR800216330140/RMCPL17259/0,1000.0,0.0,52177803.48,2018,1,9,CASH_OUT,1000.0,C1335946878
8394,409000438620',2018-01-09,CR800218395561/RMCPL22397/0,2000.0,0.0,52175803.48,2018,1,9,CASH_OUT,2000.0,C878506901
8395,409000438620',2018-01-09,CR800216330330/RMCPL22497/0,10000.0,0.0,52165803.48,2018,1,9,CHECK_WITHDRAWAL,10000.0,C1303868418
8396,409000438620',2018-01-09,CR800214261167/RMCPL21320/0,500.0,0.0,52165303.48,2018,1,9,DEBIT,500.0,C1427067435
8397,409000438620',2018-01-09,CR800214261146/RMCPL16185/0,1000.0,0.0,52164303.48,2018,1,9,PAYEMENT,1000.0,C1529115495
8398,409000438620',2018-01-09,CR800218395516/RMCPL16162/0,5000.0,0.0,52159303.48,2018,1,9,CHECK_WITHDRAWAL,5000.0,C761069599
8399,409000438620',2018-01-09,CR800218395543/RMCPL16643/0,1000.0,0.0,52158303.48,2018,1,9,CHECK_WITHDRAWAL,1000.0,C1337741679
8400,409000438620',2018-01-09,CR800214261153/RMCPL17019/0,10000.0,0.0,52148303.48,2018,1,9,PAYEMENT,10000.0,C22805895
8401,409000438620',2018-01-09,CR800214261102/RMCPL19138/0,1000.0,0.0,52147303.48,2018,1,9,CHECK_WITHDRAWAL,1000.0,C1712003741
8402,409000438620',2018-01-09,CR800214261087/RMCPL13173/0,1000.0,0.0,52146303.48,2018,1,9,CASH_OUT,1000.0,C769342184
8403,409000438620',2018-01-09,CR800214261169/RMCPL14982/0,1000.0,0.0,52145303.48,2018,1,9,CHECK_WITHDRAWAL,1000.0,C410033330
8404,409000438620',2018-01-09,CR800216330250/RMCPL19890/0,500.0,0.0,52144803.48,2018,1,9,PAYEMENT,500.0,C634210724
8405,409000438620',2018-01-09,CR800214261130/RMCPL16004/0,1000.0,0.0,52143803.48,2018,1,9,PAYEMENT,1000.0,C2117043942
8406,409000438620',2018-01-09,CR800214261077/RMCPL20548/0,5000.0,0.0,52138803.48,2018,1,9,DEBIT,5000.0,C1234059684
8407,409000438620',2018-01-09,CR800214261099/RMCPL16210/0,10000.0,0.0,52128803.48,2018,1,9,PAYEMENT,10000.0,C473344802
8408,409000438620',2018-01-09,CR800214261061/RMCPL15781/0,5000.0,0.0,52123803.48,2018,1,9,CHECK_WITHDRAWAL,5000.0,C1182908789
8409,409000438620',2018-01-09,CR800214228242/RMCPL20472/0,500.0,0.0,52123303.48,2018,1,9,CASH_OUT,500.0,C2083424441
8410,409000438620',2018-01-09,CR800218395333/RMCPL16230/0,4000.0,0.0,52119303.48,2018,1,9,DEBIT,4000.0,C836514715
8411,409000438620',2018-01-09,CR800218395361/RMCPL15518/0,1000.0,0.0,52118303.48,2018,1,9,CHECK_WITHDRAWAL,1000.0,C621014131
8412,409000438620',2018-01-09,CR800214261188/RMCPL17219/0,10000.0,0.0,52108303.48,2018,1,9,CASH_OUT,10000.0,C188246551
8413,409000438620',2018-01-09,CR800214261084/RMCPL17664/0,3000.0,0.0,52105303.48,2018,1,9,CASH_OUT,3000.0,C1636786811
8414,409000438620',2018-01-09,CR800214261043/RMCPL19682/0,610.0,0.0,52104693.48,2018,1,9,CHECK_WITHDRAWAL,610.0,C392292416
8415,409000438620',2018-01-09,CR800216330333/RMCPL18884/0,500.0,0.0,52104193.48,2018,1,9,PAYEMENT,500.0,C1339257929
8416,409000438620',2018-01-09,CR800214261009/RMCPL20138/0,2500.0,0.0,52101693.48,2018,1,9,CASH_OUT,2500.0,C932493233
8417,409000438620',2018-01-09,CR800312854269/RMCPL21530/0,500.0,0.0,52101193.48,2018,1,9,CHECK_WITHDRAWAL,500.0,C716083600
8418,409000438620',2018-01-09,CR800312836797/RMCPL18349/0,2000.0,0.0,52099193.48,2018,1,9,PAYEMENT,2000.0,C1191924243
8419,409000438620',2018-01-09,CR800313866951/RMCPL16821/0,5500.0,0.0,52093693.48,2018,1,9,PAYEMENT,5500.0,C1213485528
8420,409000438620',2018-01-09,CR800312823879/RMCPL16092/0,5000.0,0.0,52088693.48,2018,1,9,DEBIT,5000.0,C1482979717
8421,409000438620',2018-01-09,CR800312854215/RMCPL21514/0,1500.0,0.0,52087193.48,2018,1,9,PAYEMENT,1500.0,C257999182
8422,409000438620',2018-01-09,CR800312836586/RMCPL22265/0,10000.0,0.0,52077193.48,2018,1,9,CASH_OUT,10000.0,C517653428
8423,409000438620',2018-01-09,CR800312836656/RMCPL14406/0,5000.0,0.0,52072193.48,2018,1,9,CHECK_WITHDRAWAL,5000.0,C1213257323
8424,409000438620',2018-01-09,CR800312854254/RMCPL17616/0,1000.0,0.0,52071193.48,2018,1,9,PAYEMENT,1000.0,C1058634310
8425,409000438620',2018-01-09,CR800312836845/RMCPL18465/0,1000.0,0.0,52070193.48,2018,1,9,PAYEMENT,1000.0,C339099861
8426,409000438620',2018-01-09,CR800317024766/RMCPL14809/0,500.0,0.0,52069693.48,2018,1,9,CASH_OUT,500.0,C967425740
8427,409000438620',2018-01-09,CR800313866920/RMCPL20706/0,2000.0,0.0,52067693.48,2018,1,9,CHECK_WITHDRAWAL,2000.0,C40075281
8428,409000438620',2018-01-09,CR800312826020/RMCPL17511/0,500.0,0.0,52067193.48,2018,1,9,CASH_OUT,500.0,M1144757947
8429,409000438620',2018-01-09,CR800312836517/RMCPL16092/0,1000.0,0.0,52066193.48,2018,1,9,DEBIT,1000.0,M228118035
8430,409000438620',2018-01-09,CR800312836319/RMCPL15334/0,8000.0,0.0,52058193.48,2018,1,9,PAYEMENT,8000.0,M105916924
8431,409000438620',2018-01-09,CR800312854392/RMCPL19796/0,5000.0,0.0,52053193.48,2018,1,9,DEBIT,5000.0,M63366151
8432,409000438620',2018-01-09,CR800313867033/RMCPL07629/0,3000.0,0.0,52050193.48,2018,1,9,PAYEMENT,3000.0,M795151790
8433,409000438620',2018-01-09,CR800312854307/RMCPL11811/0,1000.0,0.0,52049193.48,2018,1,9,CHECK_WITHDRAWAL,1000.0,M2041210715
8434,409000438620',2018-01-09,CR800313867071/RMCPL14662/0,1000.0,0.0,52048193.48,2018,1,9,CHECK_WITHDRAWAL,1000.0,M954924459
8435,409000438620',2018-01-09,CR800312836755/RMCPL19859/0,800.0,0.0,52047393.48,2018,1,9,DEBIT,800.0,C1438594533
8436,409000438620',2018-01-09,CR800312830054/RMCPL16390/0,7000.0,0.0,52040393.48,2018,1,9,PAYEMENT,7000.0,M235668413
8437,409000438620',2018-01-09,CR800317024620/RMCPL11811/0,2020.0,0.0,52038373.48,2018,1,9,PAYEMENT,2020.0,C773898763
8438,409000438620',2018-01-09,CR800317024798/RMCPL20430/0,3000.0,0.0,52035373.48,2018,1,9,PAYEMENT,3000.0,C220766773
8439,409000438620',2018-01-09,CR800312854378/RMCPL19763/0,3000.0,0.0,52032373.48,2018,1,9,CASH_OUT,3000.0,M1947336745
8440,409000438620',2018-01-09,CR800312836582/RMCPL13851/0,1000.0,0.0,52031373.48,2018,1,9,CASH_OUT,1000.0,C791512944
8441,409000438620',2018-01-09,CR800312854240/RMCPL16355/0,500.0,0.0,52030873.48,2018,1,9,CASH_OUT,500.0,C753282599
8442,409000438620',2018-01-09,CR800312854265/RMCPL14780/0,3500.0,0.0,52027373.48,2018,1,9,PAYEMENT,3500.0,C1822045793
8443,409000438620',2018-01-09,CR800313866896/RMCPL11227/0,1000.0,0.0,52026373.48,2018,1,9,DEBIT,1000.0,C1728766751
8444,409000438620',2018-01-09,CR800312836513/RMCPL21946/0,3000.0,0.0,52023373.48,2018,1,9,DEBIT,3000.0,M5308857
8445,409000438620',2018-01-09,CR800312836675/RMCPL20319/0,1000.0,0.0,52022373.48,2018,1,9,PAYEMENT,1000.0,M1589795681
8446,409000438620',2018-01-09,CR800317024771/RMCPL15468/0,2000.0,0.0,52020373.48,2018,1,9,CASH_OUT,2000.0,M1970307376
8447,409000438620',2018-01-09,CR800317024712/RMCPL18343/0,1000.0,0.0,52019373.48,2018,1,9,CHECK_WITHDRAWAL,1000.0,C470217116
8448,409000438620',2018-01-09,CR800317024681/RMCPL09117/0,1000.0,0.0,52018373.48,2018,1,9,CHECK_WITHDRAWAL,1000.0,M487981409
8449,409000438620',2018-01-09,CR800312836710/RMCPL20507/0,6000.0,0.0,52012373.48,2018,1,9,CHECK_WITHDRAWAL,6000.0,C1850180796
8450,409000438620',2018-01-09,CR800312836814/RMCPL17423/0,2000.0,0.0,52010373.48,2018,1,9,PAYEMENT,2000.0,C1303868418
8451,409000438620',2018-01-09,CR800313867132/RMCPL17747/0,1000.0,0.0,52009373.48,2018,1,9,PAYEMENT,1000.0,M658528347
8452,409000438620',2018-01-09,CR800313867029/RMCPL12634/0,1000.0,0.0,52008373.48,2018,1,9,PAYEMENT,1000.0,C1139794020
8453,409000438620',2018-01-09,CR800317024612/RMCPL15015/0,1000.0,0.0,52007373.48,2018,1,9,DEBIT,1000.0,M628990485
8454,409000438620',2018-01-09,CR800317024893/RMCPL11759/0,500.0,0.0,52006873.48,2018,1,9,CASH_OUT,500.0,M255748214
8455,409000438620',2018-01-09,CR800312836502/RMCPL16185/0,6000.0,0.0,52000873.48,2018,1,9,CHECK_WITHDRAWAL,6000.0,M443006127
8456,409000438620',2018-01-09,CR800312854148/RMCPL12064/0,1500.0,0.0,51999373.48,2018,1,9,PAYEMENT,1500.0,M860538473
8457,409000438620',2018-01-09,CR800312854176/RMCPL22000/0,2500.0,0.0,51996873.48,2018,1,9,DEBIT,2500.0,M1348883706
8458,409000438620',2018-01-09,CR800317024606/RMCPL17115/0,1000.0,0.0,51995873.48,2018,1,9,CASH_OUT,1000.0,M569647544
8459,409000438620',2018-01-09,CR800313866960/RMCPL21498/0,1000.0,0.0,51994873.48,2018,1,9,DEBIT,1000.0,M748199298
8460,409000438620',2018-01-09,CR800312836576/RMCPL11827/0,1000.0,0.0,51993873.48,2018,1,9,CASH_OUT,1000.0,M779998468
8461,409000438620',2018-01-09,CR800317024967/RMCPL15954/0,3000.0,0.0,51990873.48,2018,1,9,CHECK_WITHDRAWAL,3000.0,M1447232813
8462,409000438620',2018-01-09,CR800312836796/RMCPL14498/0,2000.0,0.0,51988873.48,2018,1,9,DEBIT,2000.0,C1807896178
8463,409000438620',2018-01-09,CR800312836563/RMCPL17234/0,500.0,0.0,51988373.48,2018,1,9,PAYEMENT,500.0,M1608512753
8464,409000438620',2018-01-09,CR800317024793/RMCPL12522/0,1300.0,0.0,51987073.48,2018,1,9,PAYEMENT,1300.0,M336569474
8465,409000438620',2018-01-09,CR800312836679/RMCPL17115/0,1000.0,0.0,51986073.48,2018,1,9,CASH_OUT,1000.0,M1485182201
8466,409000438620',2018-01-09,CR800312854284/RMCPL19939/0,1000.0,0.0,51985073.48,2018,1,9,PAYEMENT,1000.0,M2142442467
8467,409000438620',2018-01-09,CR800312854380/RMCPL15397/0,2000.0,0.0,51983073.48,2018,1,9,PAYEMENT,2000.0,M534199755
8468,409000438620',2018-01-09,CR800312836632/RMCPL13879/0,6000.0,0.0,51977073.48,2018,1,9,DEBIT,6000.0,M1644650045
8469,409000438620',2018-01-09,CR800312836531/RMCPL17352/0,10000.0,0.0,51967073.48,2018,1,9,DEBIT,10000.0,M1165449749
8470,409000438620',2018-01-09,AEPS Indiaforensic INCOME 080118,0.0,219212.8,52186286.28,2018,1,9,CHECK_CASHING,219212.8,M2075691191
8471,409000438620',2018-01-09,AEPS Indiaforensic GST 080118,0.0,39458.3,52225744.58,2018,1,9,TRANSFER,39458.3,M662560207
8472,409000438620',2018-01-09,Indiaforensic AEPS NPCI DEP SET,36658289.0,0.0,15567455.579999998,2018,1,9,CASH_OUT,36658289.0,M224315910
8473,409000438620',2018-01-09,TRF TO  Indiaforensic SERVICES I,15000000.0,0.0,567455.5799999982,2018,1,9,DEBIT,15000000.0,C2144647660
8474,409000438620',2018-01-09,TRF TO  Indiaforensic SERVICES I,500000.0,0.0,67455.57999999821,2018,1,9,CASH_OUT,500000.0,C1163619825
8475,409000438620',2018-01-10,AEPS ACQ REP ADJ FEES 090,0.0,100.3,67555.87999999821,2018,1,10,CASH_IN,100.3,M435765325
8476,409000438620',2018-01-10,AEPS Indiaforensic INCOME 090118,0.0,225615.53,293171.4099999982,2018,1,10,CASH_IN,225615.53,M24228051
8477,409000438620',2018-01-10,AEPS Indiaforensic GST 090118,0.0,40610.8,333782.2099999982,2018,1,10,TRANSFER,40610.8,M1427476487
8478,409000438620',2018-01-10,Indiaforensic AEPS NPCI WDL SET,0.0,52483897.0,52817679.21,2018,1,10,CASH_IN,52483897.0,M44341075
8479,409000438620',2018-01-10,Indiaforensic AEPS NPCI DEP SET,39897123.0,0.0,12920556.21,2018,1,10,CASH_OUT,39897123.0,M394591403
8480,409000438620',2018-01-10,TRF TO  Indiaforensic SERVICES I,12900000.0,0.0,20556.21000000089,2018,1,10,DEBIT,12900000.0,M1163704025
8481,409000438620',2018-01-11,Indiaforensic AEPS NPCI WDL SET,0.0,51467187.0,51487743.21,2018,1,11,TRANSFER,51467187.0,M1563163807
8482,409000438620',2018-01-11,Indiaforensic AEPS NPCI DEP SET,41208746.0,0.0,10278997.21,2018,1,11,PAYEMENT,41208746.0,M1000093805
8483,409000438620',2018-01-11,AEPS Indiaforensic INCOME 100118,0.0,226040.01,10505037.22,2018,1,11,CASH_IN,226040.01,M87487369
8484,409000438620',2018-01-11,AEPS Indiaforensic GST 100118,0.0,40687.2,10545724.42,2018,1,11,CHECK_CASHING,40687.2,M1907813883
8485,409000438620',2018-01-11,TRF TO  Indiaforensic SERVICES I,10500000.0,0.0,45724.41999999993,2018,1,11,DEBIT,10500000.0,M499911608
8486,409000438620',2018-01-11,Indiaforensic AEPS NPCI DEP SET,3000.0,0.0,42724.419999999925,2018,1,11,PAYEMENT,3000.0,M1869191350
8487,409000438620',2018-01-12,Indiaforensic AEPS NPCI WDL SET,0.0,49056114.0,49098838.42,2018,1,12,CASH_IN,49056114.0,M497378142
8488,409000438620',2018-01-12,AEPS ACQUIRING ADJ FEES 1,94.98,0.0,49098743.44000001,2018,1,12,CASH_OUT,94.98,M617400603
8489,409000438620',2018-01-12,Indiaforensic AEPS NPCI DEP SET,36529439.0,0.0,12569304.440000005,2018,1,12,CASH_OUT,36529439.0,M999036382
8490,409000438620',2018-01-12,AEPS Indiaforensic INCOME 110118,0.0,207173.05,12776477.490000006,2018,1,12,CASH_IN,207173.05,M1694437034
8491,409000438620',2018-01-12,AEPS Indiaforensic GST 110118,0.0,37291.15,12813768.640000004,2018,1,12,CHECK_CASHING,37291.15,M459451678
8492,409000438620',2018-01-12,TRF TO  Indiaforensic SERVICES I,12500000.0,0.0,313768.6400000062,2018,1,12,CHECK_WITHDRAWAL,12500000.0,M1843167615
8493,409000438620',2018-01-15,Indiaforensic AEPS NPCI WDL SET,0.0,51879422.0,52193190.64000001,2018,1,15,TRANSFER,51879422.0,M2026446122
8494,409000438620',2018-01-15,Indiaforensic AEPS NPCI WDL SET,0.0,56096135.0,108289325.64000002,2018,1,15,CASH_IN,56096135.0,M1386474403
8495,409000438620',2018-01-15,Indiaforensic AEPS NPCI WDL SET,0.0,31238902.0,139528227.64000002,2018,1,15,CHECK_CASHING,31238902.0,C501170909
8496,409000438620',2018-01-15,Indiaforensic AEPS NPCI DEP SET,37794896.0,0.0,101733331.64000002,2018,1,15,CASH_OUT,37794896.0,M1333633954
8497,409000438620',2018-01-15,Indiaforensic AEPS NPCI DEP SET,41386936.0,0.0,60346395.64000002,2018,1,15,CASH_OUT,41386936.0,M1980062978
8498,409000438620',2018-01-15,Indiaforensic AEPS NPCI DEP SET,29918078.0,0.0,30428317.64000001,2018,1,15,CHECK_WITHDRAWAL,29918078.0,M319477133
8499,409000438620',2018-01-15,AEPS ACQ REP ADJ FEES 120,0.0,41.3,30428358.940000016,2018,1,15,TRANSFER,41.3,M943346272
8500,409000438620',2018-01-15,TRF TO  Indiaforensic SERVICES I,15000000.0,0.0,15428358.940000014,2018,1,15,DEBIT,15000000.0,C1870252780
8501,409000438620',2018-01-15,TRF TO  Indiaforensic SERVICES I,15000000.0,0.0,428358.9400000162,2018,1,15,PAYEMENT,15000000.0,C470217116
8502,409000438620',2018-01-15,GF735017271350/RMCPL14779/1,500.0,0.0,427858.9400000162,2018,1,15,CASH_OUT,500.0,M1575169536
8503,409000438620',2018-01-15,AEPS ACQ GF REP ADJ FEES1,0.0,2.95,427861.89000001625,2018,1,15,CASH_IN,2.95,M13484189
8504,409000438620',2018-01-15,AEPS Indiaforensic INCOME 120118,0.0,221438.09,649299.9800000163,2018,1,15,TRANSFER,221438.09,M1964320423
8505,409000438620',2018-01-15,AEPS Indiaforensic GST 120118,0.0,39858.86,689158.8400000164,2018,1,15,TRANSFER,39858.86,M1281233469
8506,409000438620',2018-01-15,AEPS Indiaforensic INCOME 120118,0.0,239776.39,928935.2300000164,2018,1,15,CHECK_CASHING,239776.39,M900207233
8507,409000438620',2018-01-15,AEPS Indiaforensic GST 120118,0.0,43159.75,972094.9800000164,2018,1,15,TRANSFER,43159.75,C1408538096
8508,409000438620',2018-01-15,AEPS Indiaforensic INCOME 140118,0.0,153339.28,1125434.2600000163,2018,1,15,CHECK_CASHING,153339.28,C2006081398
8509,409000438620',2018-01-15,AEPS Indiaforensic GST 140118,0.0,27601.07,1153035.3300000164,2018,1,15,CHECK_CASHING,27601.07,M1504469201
8510,409000438620',2018-01-16,Indiaforensic AEPS NPCI WDL SET,0.0,45552955.0,46705990.33000001,2018,1,16,CASH_IN,45552955.0,C705265015
8511,409000438620',2018-01-16,AEPS ACQUIRING ADJ FEES 1,95.88,0.0,46705894.45000001,2018,1,16,PAYEMENT,95.88,M2062646577
8512,409000438620',2018-01-16,Indiaforensic AEPS NPCI DEP SET,35657151.0,0.0,11048743.45000001,2018,1,16,DEBIT,35657151.0,M1246350906
8513,409000438620',2018-01-16,AEPS Indiaforensic INCOME 150118,0.0,200116.64,11248860.090000013,2018,1,16,CHECK_CASHING,200116.64,M552025665
8514,409000438620',2018-01-16,AEPS Indiaforensic GST 150118,0.0,36021.0,11284881.090000013,2018,1,16,CASH_IN,36021.0,M1836184214
8515,409000438620',2018-01-16,TRF TO  Indiaforensic SERVICES I,11000000.0,0.0,284881.090000011,2018,1,16,CASH_OUT,11000000.0,M1394208704
8516,409000438620',2018-01-17,Indiaforensic AEPS NPCI WDL SET,0.0,54673592.0,54958473.09000001,2018,1,17,TRANSFER,54673592.0,M907561070
8517,409000438620',2018-01-17,Indiaforensic AEPS NPCI DEP SET,43914275.0,0.0,11044198.090000013,2018,1,17,DEBIT,43914275.0,C751413576
8518,409000438620',2018-01-17,AEPS ACQUIRING ADJ FEES 1,67.85,0.0,11044130.240000013,2018,1,17,CHECK_WITHDRAWAL,67.85,M1704990977
8519,409000438620',2018-01-17,AEPS Indiaforensic INCOME 160118,0.0,240672.3,11284802.540000012,2018,1,17,TRANSFER,240672.3,M2011580998
8520,409000438620',2018-01-17,AEPS Indiaforensic GST 160118,0.0,43321.01,11328123.550000012,2018,1,17,TRANSFER,43321.01,M875191127
8521,409000438620',2018-01-17,TRF TO  Indiaforensic SERVICES I,10000000.0,0.0,1328123.550000012,2018,1,17,CHECK_WITHDRAWAL,10000000.0,M462020284
8522,409000438620',2018-01-17,TRF TO  Indiaforensic SERVICES I,1000000.0,0.0,328123.5500000119,2018,1,17,DEBIT,1000000.0,C1495761010
8523,409000438620',2018-01-18,Indiaforensic AEPS NPCI WDL SET,0.0,50683424.0,51011547.55000001,2018,1,18,CHECK_CASHING,50683424.0,M196069204
8524,409000438620',2018-01-18,Indiaforensic AEPS NPCI DEP SET,42215613.0,0.0,8795934.550000012,2018,1,18,DEBIT,42215613.0,M93367172
8525,409000438620',2018-01-18,AEPS ACQUIRING ADJ FEES 1,115.11,0.0,8795819.440000013,2018,1,18,DEBIT,115.11,M2101881246
8526,409000438620',2018-01-18,AEPS ACQ CR ADJ FEES 1701,1467.1,0.0,8794352.340000013,2018,1,18,CASH_OUT,1467.1,M390946039
8527,409000438620',2018-01-18,AEPS Indiaforensic INCOME 170118,0.0,226338.38,9020690.720000014,2018,1,18,CASH_IN,226338.38,C977993101
8528,409000438620',2018-01-18,AEPS Indiaforensic GST 170118,0.0,40740.91,9061431.630000014,2018,1,18,CASH_IN,40740.91,C1494895909
8529,409000438620',2018-01-18,CR800917586889/RMCPL17872/0,2500.0,0.0,9058931.630000014,2018,1,18,DEBIT,2500.0,C766681183
8530,409000438620',2018-01-18,CR800917587230/RMCPL21498/0,2000.0,0.0,9056931.630000014,2018,1,18,CASH_OUT,2000.0,C1721246982
8531,409000438620',2018-01-18,CR800917578140/RMCPL21243/0,3000.0,0.0,9053931.630000014,2018,1,18,DEBIT,3000.0,C1816986148
8532,409000438620',2018-01-18,CR800917587212/RMCPL13807/0,300.0,0.0,9053631.630000014,2018,1,18,CHECK_WITHDRAWAL,300.0,C214774813
8533,409000438620',2018-01-18,CR800917586568/RMCPL03048/0,3050.0,0.0,9050581.630000014,2018,1,18,PAYEMENT,3050.0,C194746285
8534,409000438620',2018-01-18,CR800917586562/RMCPL20319/0,1000.0,0.0,9049581.630000014,2018,1,18,DEBIT,1000.0,C465257140
8535,409000438620',2018-01-18,CR800917586621/RMCPL19756/0,6000.0,0.0,9043581.630000014,2018,1,18,CASH_OUT,6000.0,C631424220
8536,409000438620',2018-01-18,CR800917586435/RMCPL11898/0,500.0,0.0,9043081.630000014,2018,1,18,DEBIT,500.0,C416519915
8537,409000438620',2018-01-18,CR800917587297/RMCPL10937/0,500.0,0.0,9042581.630000014,2018,1,18,DEBIT,500.0,M1373719734
8538,409000438620',2018-01-18,CR800917587275/RMCPL19554/0,1000.0,0.0,9041581.630000014,2018,1,18,CHECK_WITHDRAWAL,1000.0,M1327733366
8539,409000438620',2018-01-18,CR800917587205/RMCPL12824/0,2000.0,0.0,9039581.630000014,2018,1,18,CASH_OUT,2000.0,M1100771574
8540,409000438620',2018-01-18,CR800917587312/RMCPL21765/0,1000.0,0.0,9038581.630000014,2018,1,18,CHECK_WITHDRAWAL,1000.0,C405881980
8541,409000438620',2018-01-18,CR800415517797/RMCPL15703/0,2000.0,0.0,9036581.630000014,2018,1,18,CHECK_WITHDRAWAL,2000.0,M1219605609
8542,409000438620',2018-01-18,CR800415517674/RMCPL18649/0,8000.0,0.0,9028581.630000014,2018,1,18,CASH_OUT,8000.0,M367478965
8543,409000438620',2018-01-18,CR800415517874/RMCPL19899/0,1000.0,0.0,9027581.630000014,2018,1,18,CHECK_WITHDRAWAL,1000.0,C1477979030
8544,409000438620',2018-01-18,CR800415517577/RMCPL19112/0,3500.0,0.0,9024081.630000014,2018,1,18,PAYEMENT,3500.0,C1850180796
8545,409000438620',2018-01-18,CR800415517574/RMCPL13310/0,500.0,0.0,9023581.630000014,2018,1,18,CASH_OUT,500.0,M1684281752
8546,409000438620',2018-01-18,CR800415517948/RMCPL22050/0,4000.0,0.0,9019581.630000014,2018,1,18,PAYEMENT,4000.0,M513474126
8547,409000438620',2018-01-18,CR800415517694/RMCPL19235/0,1000.0,0.0,9018581.630000014,2018,1,18,PAYEMENT,1000.0,M1535877586
8548,409000438620',2018-01-18,CR800415517767/RMCPL17018/0,5000.0,0.0,9013581.630000014,2018,1,18,PAYEMENT,5000.0,M517637439
8549,409000438620',2018-01-18,CR800415517798/RMCPL21136/0,7000.0,0.0,9006581.630000014,2018,1,18,CASH_OUT,7000.0,M965010099
8550,409000438620',2018-01-18,CR800415517571/RMCPL14833/0,500.0,0.0,9006081.630000014,2018,1,18,CASH_OUT,500.0,M2139268895
8551,409000438620',2018-01-18,CR800415517865/RMCPL18868/0,10000.0,0.0,8996081.630000014,2018,1,18,CASH_OUT,10000.0,C979778117
8552,409000438620',2018-01-18,CR800415517756/RMCPL16717/0,3000.0,0.0,8993081.630000014,2018,1,18,CASH_OUT,3000.0,M145371155
8553,409000438620',2018-01-18,CR800415517912/RMCPL18240/0,1000.0,0.0,8992081.630000014,2018,1,18,DEBIT,1000.0,M2013186564
8554,409000438620',2018-01-18,CR800815905636/RMCPL00112/0,2000.0,0.0,8990081.630000014,2018,1,18,PAYEMENT,2000.0,M1522752279
8555,409000438620',2018-01-18,CR800816963225/RMCPL16793/0,3000.0,0.0,8987081.630000014,2018,1,18,DEBIT,3000.0,M1870673366
8556,409000438620',2018-01-18,CR800816963223/RMCPL18493/0,2500.0,0.0,8984581.630000014,2018,1,18,PAYEMENT,2500.0,M706783822
8557,409000438620',2018-01-18,CR800815905596/RMCPL14181/0,5000.0,0.0,8979581.630000014,2018,1,18,DEBIT,5000.0,M1363009375
8558,409000438620',2018-01-18,CR800815905475/RMCPL10452/0,2500.0,0.0,8977081.630000014,2018,1,18,DEBIT,2500.0,C1626759869
8559,409000438620',2018-01-18,CR800815905564/RMCPL16100/0,2500.0,0.0,8974581.630000014,2018,1,18,PAYEMENT,2500.0,M451019405
8560,409000438620',2018-01-18,CR800815905585/RMCPL11952/0,10000.0,0.0,8964581.630000014,2018,1,18,CASH_OUT,10000.0,C1983025922
8561,409000438620',2018-01-18,CR800815905549/RMCPL14471/0,5000.0,0.0,8959581.630000014,2018,1,18,CHECK_WITHDRAWAL,5000.0,C863811613
8562,409000438620',2018-01-18,CR800913418046/RMCPL20594/0,600.0,0.0,8958981.630000014,2018,1,18,CASH_OUT,600.0,C416519915
8563,409000438620',2018-01-18,CR800918624761/RMCPL16100/0,2000.0,0.0,8956981.630000014,2018,1,18,PAYEMENT,2000.0,C1337563431
8564,409000438620',2018-01-18,CR800918647966/RMCPL21498/0,5000.0,0.0,8951981.630000014,2018,1,18,PAYEMENT,5000.0,C257999182
8565,409000438620',2018-01-18,CR800917577295/RMCPL09588/0,3000.0,0.0,8948981.630000014,2018,1,18,PAYEMENT,3000.0,C2083562754
8566,409000438620',2018-01-18,CR800917577270/RMCPL10735/0,2000.0,0.0,8946981.630000014,2018,1,18,DEBIT,2000.0,C1303868418
8567,409000438620',2018-01-18,CR800913418017/RMCPL13573/0,3000.0,0.0,8943981.630000014,2018,1,18,CHECK_WITHDRAWAL,3000.0,C706289539
8568,409000438620',2018-01-18,CR800917587578/RMCPL18560/0,2000.0,0.0,8941981.630000014,2018,1,18,PAYEMENT,2000.0,C1100439041
8569,409000438620',2018-01-18,CR800918655088/RMCPL22818/0,3000.0,0.0,8938981.630000014,2018,1,18,DEBIT,3000.0,C440737101
8570,409000438620',2018-01-18,CR800918624132/RMCPL22507/0,4000.0,0.0,8934981.630000014,2018,1,18,CASH_OUT,4000.0,C1007717381
8571,409000438620',2018-01-18,CR800918624678/RMCPL18298/0,500.0,0.0,8934481.630000014,2018,1,18,CHECK_WITHDRAWAL,500.0,C1554540309
8572,409000438620',2018-01-18,CR800917587575/RMCPL14640/0,2500.0,0.0,8931981.630000014,2018,1,18,CASH_OUT,2500.0,C1814361629
8573,409000438620',2018-01-18,CR800918646925/RMCPL11511/0,1000.0,0.0,8930981.630000014,2018,1,18,PAYEMENT,1000.0,C503195940
8574,409000438620',2018-01-18,CR800918655110/RMCPL15583/0,500.0,0.0,8930481.630000014,2018,1,18,PAYEMENT,500.0,C16344660
8575,409000438620',2018-01-18,CR800918655143/RMCPL10922/0,1500.0,0.0,8928981.630000014,2018,1,18,PAYEMENT,1500.0,C838411509
8576,409000438620',2018-01-18,CR800918624622/RMCPL19429/0,1000.0,0.0,8927981.630000014,2018,1,18,CASH_OUT,1000.0,C2072865894
8577,409000438620',2018-01-18,CR800918623849/RMCPL10752/0,1000.0,0.0,8926981.630000014,2018,1,18,DEBIT,1000.0,C1991252420
8578,409000438620',2018-01-18,CR800917587574/RMCPL09664/0,3000.0,0.0,8923981.630000014,2018,1,18,CHECK_WITHDRAWAL,3000.0,C1284149862
8579,409000438620',2018-01-18,CR800918624437/RMCPL19570/0,2500.0,0.0,8921481.630000014,2018,1,18,CASH_OUT,2500.0,C1850042097
8580,409000438620',2018-01-18,CR800918624071/RMCPL19904/0,3220.0,0.0,8918261.630000014,2018,1,18,PAYEMENT,3220.0,C2134357721
8581,409000438620',2018-01-18,CR800918655134/RMCPL17812/0,500.0,0.0,8917761.630000014,2018,1,18,PAYEMENT,500.0,C2057394816
8582,409000438620',2018-01-18,CR800918655022/RMCPL22747/0,3000.0,0.0,8914761.630000014,2018,1,18,DEBIT,3000.0,C248609774
8583,409000438620',2018-01-18,CR800917577247/RMCPL17881/0,3000.0,0.0,8911761.630000014,2018,1,18,DEBIT,3000.0,C811597470
8584,409000438620',2018-01-18,CR800918624647/RMCPL16887/0,200.0,0.0,8911561.630000014,2018,1,18,CASH_OUT,200.0,C1706891711
8585,409000438620',2018-01-18,CR800918624491/RMCPL15232/0,5000.0,0.0,8906561.630000014,2018,1,18,CHECK_WITHDRAWAL,5000.0,C1651945012
8586,409000438620',2018-01-18,CR800918655059/RMCPL02803/0,2000.0,0.0,8904561.630000014,2018,1,18,CHECK_WITHDRAWAL,2000.0,C451111351
8587,409000438620',2018-01-18,CR800917587601/RMCPL16750/0,10000.0,0.0,8894561.630000014,2018,1,18,PAYEMENT,10000.0,C1721246982
8588,409000438620',2018-01-18,CR800917587335/RMCPL19583/0,3000.0,0.0,8891561.630000014,2018,1,18,DEBIT,3000.0,C382431057
8589,409000438620',2018-01-18,CR800410330261/RMCPL18600/0,1000.0,0.0,8890561.630000014,2018,1,18,PAYEMENT,1000.0,C886517510
8590,409000438620',2018-01-18,CR800411378080/RMCPL17645/0,500.0,0.0,8890061.630000014,2018,1,18,CHECK_WITHDRAWAL,500.0,C1022680775
8591,409000438620',2018-01-18,CR800411378137/RMCPL16353/0,3000.0,0.0,8887061.630000014,2018,1,18,DEBIT,3000.0,C1200417755
8592,409000438620',2018-01-18,CR800411378215/RMCPL21284/0,5000.0,0.0,8882061.630000014,2018,1,18,DEBIT,5000.0,C384887832
8593,409000438620',2018-01-18,CR800410330282/RMCPL09640/0,10000.0,0.0,8872061.630000014,2018,1,18,PAYEMENT,10000.0,C1428469551
8594,409000438620',2018-01-18,CR800411378205/RMCPL18992/0,3000.0,0.0,8869061.630000014,2018,1,18,PAYEMENT,3000.0,C1963862935
8595,409000438620',2018-01-18,CR800411378271/RMCPL10084/0,1000.0,0.0,8868061.630000014,2018,1,18,CASH_OUT,1000.0,C878506901
8596,409000438620',2018-01-18,CR800411378282/RMCPL14949/0,1000.0,0.0,8867061.630000014,2018,1,18,DEBIT,1000.0,C590842329
8597,409000438620',2018-01-18,CR800411378136/RMCPL18804/0,3000.0,0.0,8864061.630000014,2018,1,18,CASH_OUT,3000.0,C1951379728
8598,409000438620',2018-01-18,CR800411378284/RMCPL16858/0,500.0,0.0,8863561.630000014,2018,1,18,CASH_OUT,500.0,C7881234
8599,409000438620',2018-01-18,CR800410330375/RMCPL21687/0,1000.0,0.0,8862561.630000014,2018,1,18,DEBIT,1000.0,C75457651
8600,409000438620',2018-01-18,CR800411378244/RMCPL00226/0,10000.0,0.0,8852561.630000014,2018,1,18,PAYEMENT,10000.0,C1883840933
8601,409000438620',2018-01-18,CR800410330300/RMCPL17289/0,10000.0,0.0,8842561.630000014,2018,1,18,CASH_OUT,10000.0,C1626759869
8602,409000438620',2018-01-18,CR800410330374/RMCPL15524/0,500.0,0.0,8842061.630000014,2018,1,18,DEBIT,500.0,C1519216494
8603,409000438620',2018-01-18,CR800410330361/RMCPL19895/0,1500.0,0.0,8840561.630000014,2018,1,18,DEBIT,1500.0,C1255024717
8604,409000438620',2018-01-18,CR800816949747/RMCPL00543/0,500.0,0.0,8840061.630000014,2018,1,18,CHECK_WITHDRAWAL,500.0,C1373172466
8605,409000438620',2018-01-18,CR800818027340/RMCPL09506/0,1000.0,0.0,8839061.630000014,2018,1,18,CASH_OUT,1000.0,C2145942542
8606,409000438620',2018-01-18,CR800818027440/RMCPL10418/0,5000.0,0.0,8834061.630000014,2018,1,18,DEBIT,5000.0,C949483950
8607,409000438620',2018-01-18,CR800813863527/RMCPL15874/0,210.0,0.0,8833851.630000014,2018,1,18,DEBIT,210.0,C843467284
8608,409000438620',2018-01-18,CR800816949614/RMCPL18123/0,3000.0,0.0,8830851.630000014,2018,1,18,CASH_OUT,3000.0,C312362475
8609,409000438620',2018-01-18,CR800813863626/RMCPL20622/0,3000.0,0.0,8827851.630000014,2018,1,18,PAYEMENT,3000.0,C716083600
8610,409000438620',2018-01-18,CR800816949701/RMCPL11120/0,1500.0,0.0,8826351.630000014,2018,1,18,CASH_OUT,1500.0,C1022680775
8611,409000438620',2018-01-18,CR800816949521/RMCPL18950/0,3000.0,0.0,8823351.630000014,2018,1,18,CHECK_WITHDRAWAL,3000.0,C414386513
8612,409000438620',2018-01-18,CR800816949630/RMCPL21584/0,500.0,0.0,8822851.630000014,2018,1,18,PAYEMENT,500.0,C305646302
8613,409000438620',2018-01-18,CR800813863511/RMCPL14780/0,4000.0,0.0,8818851.630000014,2018,1,18,CHECK_WITHDRAWAL,4000.0,C660143728
8614,409000438620',2018-01-18,CR800813863500/RMCPL16197/0,10000.0,0.0,8808851.630000014,2018,1,18,DEBIT,10000.0,C931482420
8615,409000438620',2018-01-18,CR800812794934/RMCPL18725/0,100.0,0.0,8808751.630000014,2018,1,18,PAYEMENT,100.0,C2011996123
8616,409000438620',2018-01-18,CR800816949733/RMCPL18092/0,1000.0,0.0,8807751.630000014,2018,1,18,CHECK_WITHDRAWAL,1000.0,C1255024717
8617,409000438620',2018-01-18,CR800818027539/RMCPL12720/0,10000.0,0.0,8797751.630000014,2018,1,18,CASH_OUT,10000.0,C1147977782
8618,409000438620',2018-01-18,CR800818027297/RMCPL09664/0,5000.0,0.0,8792751.630000014,2018,1,18,CASH_OUT,5000.0,C2072865894
8619,409000438620',2018-01-18,CR800813863432/RMCPL19235/0,1000.0,0.0,8791751.630000014,2018,1,18,CASH_OUT,1000.0,C1334973394
8620,409000438620',2018-01-18,CR800818027331/RMCPL14614/0,1500.0,0.0,8790251.630000014,2018,1,18,CASH_OUT,1500.0,C1023714065
8621,409000438620',2018-01-18,CR800813863585/RMCPL19075/0,4000.0,0.0,8786251.630000014,2018,1,18,CHECK_WITHDRAWAL,4000.0,C1626759869
8622,409000438620',2018-01-18,CR800812794918/RMCPL17914/0,500.0,0.0,8785751.630000014,2018,1,18,CHECK_WITHDRAWAL,500.0,C1167066016
8623,409000438620',2018-01-18,CR800818027452/RMCPL11945/0,1000.0,0.0,8784751.630000014,2018,1,18,CHECK_WITHDRAWAL,1000.0,C1728766751
8624,409000438620',2018-01-18,CR800818027464/RMCPL17589/0,3000.0,0.0,8781751.630000014,2018,1,18,DEBIT,3000.0,C935808590
8625,409000438620',2018-01-18,CR800813863353/RMCPL14458/0,5000.0,0.0,8776751.630000014,2018,1,18,CHECK_WITHDRAWAL,5000.0,C979778117
8626,409000438620',2018-01-18,CR800818027303/RMCPL21709/0,3000.0,0.0,8773751.630000014,2018,1,18,PAYEMENT,3000.0,C657736958
8627,409000438620',2018-01-18,CR800816949736/RMCPL18313/0,2000.0,0.0,8771751.630000014,2018,1,18,DEBIT,2000.0,M1526263649
8628,409000438620',2018-01-18,CR800813863232/RMCPL20360/0,6000.0,0.0,8765751.630000014,2018,1,18,DEBIT,6000.0,M694690372
8629,409000438620',2018-01-18,CR800813863369/RMCPL21470/0,500.0,0.0,8765251.630000014,2018,1,18,DEBIT,500.0,M779529705
8630,409000438620',2018-01-18,CR800816949553/RMCPL13846/0,500.0,0.0,8764751.630000014,2018,1,18,DEBIT,500.0,C81639848
8631,409000438620',2018-01-18,CR800813863298/RMCPL09987/0,10000.0,0.0,8754751.630000014,2018,1,18,CASH_OUT,10000.0,C466505482
8632,409000438620',2018-01-18,CR800813863510/RMCPL13062/0,2010.0,0.0,8752741.630000014,2018,1,18,PAYEMENT,2010.0,M2094001478
8633,409000438620',2018-01-18,CR800818027366/RMCPL19812/0,1000.0,0.0,8751741.630000014,2018,1,18,CASH_OUT,1000.0,C728526866
8634,409000438620',2018-01-18,CR800813863461/RMCPL18011/0,500.0,0.0,8751241.630000014,2018,1,18,CHECK_WITHDRAWAL,500.0,M137463816
8635,409000438620',2018-01-18,CR800816949577/RMCPL12312/0,2220.0,0.0,8749021.630000014,2018,1,18,DEBIT,2220.0,M1082896755
8636,409000438620',2018-01-18,CR800812794953/RMCPL22314/0,500.0,0.0,8748521.630000014,2018,1,18,PAYEMENT,500.0,M855155579
8637,409000438620',2018-01-18,CR800816949711/RMCPL13751/0,2000.0,0.0,8746521.630000014,2018,1,18,CASH_OUT,2000.0,M457891448
8638,409000438620',2018-01-18,CR800816949811/RMCPL16974/0,2500.0,0.0,8744021.630000014,2018,1,18,CHECK_WITHDRAWAL,2500.0,M854519560
8639,409000438620',2018-01-18,CR800917577035/RMCPL19907/0,2500.0,0.0,8741521.630000014,2018,1,18,CASH_OUT,2500.0,M1187741707
8640,409000438620',2018-01-18,CR800912368151/RMCPL19054/0,1500.0,0.0,8740021.630000014,2018,1,18,CASH_OUT,1500.0,M352938766
8641,409000438620',2018-01-18,CR800913417921/RMCPL06680/0,500.0,0.0,8739521.630000014,2018,1,18,DEBIT,500.0,M2108006254
8642,409000438620',2018-01-18,CR800913417833/RMCPL22663/0,1500.0,0.0,8738021.630000014,2018,1,18,CASH_OUT,1500.0,C146305349
8643,409000438620',2018-01-18,CR800912368273/RMCPL13573/0,2000.0,0.0,8736021.630000014,2018,1,18,DEBIT,2000.0,C1457383927
8644,409000438620',2018-01-18,CR800913417957/RMCPL20432/0,3000.0,0.0,8733021.630000014,2018,1,18,CASH_OUT,3000.0,M856511870
8645,409000438620',2018-01-18,CR800917577092/RMCPL19531/0,2000.0,0.0,8731021.630000014,2018,1,18,DEBIT,2000.0,M386480126
8646,409000438620',2018-01-18,CR800913417992/RMCPL14561/0,2000.0,0.0,8729021.630000014,2018,1,18,PAYEMENT,2000.0,M994372924
8647,409000438620',2018-01-18,CR800912368252/RMCPL20141/0,3000.0,0.0,8726021.630000014,2018,1,18,CHECK_WITHDRAWAL,3000.0,C1761291320
8648,409000438620',2018-01-18,CR800918624004/RMCPL13504/0,520.0,0.0,8725501.630000014,2018,1,18,CHECK_WITHDRAWAL,520.0,M2114163679
8649,409000438620',2018-01-18,CR800913417844/RMCPL18011/0,6000.0,0.0,8719501.630000014,2018,1,18,PAYEMENT,6000.0,M1044221548
8650,409000438620',2018-01-18,CR800917577044/RMCPL16831/0,2500.0,0.0,8717001.630000014,2018,1,18,DEBIT,2500.0,M489480245
8651,409000438620',2018-01-18,CR800917577163/RMCPL15068/0,500.0,0.0,8716501.630000014,2018,1,18,PAYEMENT,500.0,M949277105
8652,409000438620',2018-01-18,CR800917577126/RMCPL00886/0,4750.0,0.0,8711751.630000014,2018,1,18,PAYEMENT,4750.0,C1071364078
8653,409000438620',2018-01-18,CR800918623885/RMCPL16831/0,5000.0,0.0,8706751.630000014,2018,1,18,CASH_OUT,5000.0,M218002096
8654,409000438620',2018-01-18,CR800912368114/RMCPL16915/0,1500.0,0.0,8705251.630000014,2018,1,18,CHECK_WITHDRAWAL,1500.0,M359494998
8655,409000438620',2018-01-18,TRF TO  Indiaforensic SERVICES I,5000000.0,0.0,3705251.630000014,2018,1,18,DEBIT,5000000.0,C1297685781
8656,409000438620',2018-01-18,TRF TO  Indiaforensic SERVICES I,3000000.0,0.0,705251.6300000139,2018,1,18,DEBIT,3000000.0,M1999836215
8657,409000438620',2018-01-18,TRF TO  Indiaforensic SERVICES I,500000.0,0.0,205251.63000001386,2018,1,18,CASH_OUT,500000.0,M91182750
8658,409000438620',2018-01-19,Indiaforensic AEPS NPCI WDL SET,0.0,52569402.0,52774653.63000001,2018,1,19,CASH_IN,52569402.0,C2052185144
8659,409000438620',2018-01-19,Indiaforensic AEPS NPCI DEP SET,42847886.0,0.0,9926767.63000001,2018,1,19,PAYEMENT,42847886.0,M1689316426
8660,409000438620',2018-01-19,AEPS ACQUIRING ADJ FEES 1,14.75,0.0,9926752.88000001,2018,1,19,DEBIT,14.75,M696321613
8661,409000438620',2018-01-19,GF735313581670/RMCPL19124/1,8000.0,0.0,9918752.88000001,2018,1,19,CHECK_WITHDRAWAL,8000.0,M2130217373
8662,409000438620',2018-01-19,AEPS ACQ REP ADJ FEES 180,0.0,20.65,9918773.53000001,2018,1,19,TRANSFER,20.65,M1622054159
8663,409000438620',2018-01-19,AEPS ACQ GFREP ADJ FEES 1,0.0,17.7,9918791.23000001,2018,1,19,CASH_IN,17.7,C1870252780
8664,409000438620',2018-01-19,AEPS Indiaforensic INCOME 180118,0.0,233288.65,10152079.88000001,2018,1,19,CASH_IN,233288.65,C909295153
8665,409000438620',2018-01-19,AEPS Indiaforensic GST 180118,0.0,41991.96,10194071.840000013,2018,1,19,CASH_IN,41991.96,C1411863742
8666,409000438620',2018-01-19,TRF TO  Indiaforensic SERVICES I,10000000.0,0.0,194071.84000001106,2018,1,19,CHECK_WITHDRAWAL,10000000.0,M356280764
8667,409000438620',2018-01-19,AEPS Indiaforensic INCOME 080118,0.0,13.0,194084.84000001106,2018,1,19,TRANSFER,13.0,C2063763486
8668,409000438620',2018-01-19,AEPS Indiaforensic GST 080118,0.0,2.34,194087.18000001105,2018,1,19,CHECK_CASHING,2.34,M1881845799
8669,409000438620',2018-01-20,Indiaforensic AEPS NPCI WDL SET,0.0,50722252.0,50916339.18000002,2018,1,20,TRANSFER,50722252.0,M143824997
8670,409000438620',2018-01-20,Indiaforensic AEPS NPCI DEP SET,41772514.0,0.0,9143825.180000016,2018,1,20,DEBIT,41772514.0,M1838654295
8671,409000438620',2018-01-20,AEPS ACQUIRING ADJ FEES 1,64.9,0.0,9143760.280000014,2018,1,20,DEBIT,64.9,M497757429
8672,409000438620',2018-01-20,AEPS ACQ REP ADJ FEES 190,0.0,70.86,9143831.140000014,2018,1,20,TRANSFER,70.86,M1227140361
8673,409000438620',2018-01-20,AEPS Indiaforensic INCOME 190118,0.0,226773.47,9370604.610000014,2018,1,20,CHECK_CASHING,226773.47,M974471358
8674,409000438620',2018-01-20,AEPS Indiaforensic GST 190118,0.0,40819.22,9411423.830000017,2018,1,20,TRANSFER,40819.22,C515132998
8675,409000438620',2018-01-20,TRF TO  Indiaforensic SERVICES I,2000000.0,0.0,7411423.830000015,2018,1,20,CHECK_WITHDRAWAL,2000000.0,M275543021
8676,409000438620',2018-01-20,TRF TO  Indiaforensic SERVICES I,5000000.0,0.0,2411423.830000015,2018,1,20,CASH_OUT,5000000.0,M304767096
8677,409000438620',2018-01-20,TRF TO  Indiaforensic SERVICES I,2000000.0,0.0,411423.830000015,2018,1,20,PAYEMENT,2000000.0,M436211711
8678,409000438620',2018-01-22,Indiaforensic AEPS NPCI WDL SET,0.0,48774494.0,49185917.83000001,2018,1,22,TRANSFER,48774494.0,C1354725727
8679,409000438620',2018-01-22,Indiaforensic AEPS NPCI WDL SET,0.0,34183203.0,83369120.83000001,2018,1,22,CASH_IN,34183203.0,M1397931022
8680,409000438620',2018-01-22,Indiaforensic AEPS NPCI DEP SET,40836701.0,0.0,42532419.83000001,2018,1,22,PAYEMENT,40836701.0,M521374580
8681,409000438620',2018-01-22,Indiaforensic AEPS NPCI DEP SET,29511122.0,0.0,13021297.830000013,2018,1,22,CHECK_WITHDRAWAL,29511122.0,C1303868418
8682,409000438620',2018-01-22,AEPS ACQUIRING ADJ FEES 2,17.7,0.0,13021280.130000016,2018,1,22,CHECK_WITHDRAWAL,17.7,C2011996123
8683,409000438620',2018-01-22,AEPS Indiaforensic INCOME 200118,0.0,220405.82,13241685.950000014,2018,1,22,CASH_IN,220405.82,C214774813
8684,409000438620',2018-01-22,AEPS Indiaforensic GST 200118,0.0,39673.05,13281359.000000015,2018,1,22,CHECK_CASHING,39673.05,C1590550415
8685,409000438620',2018-01-22,AEPS Indiaforensic INCOME 210118,0.0,162151.51,13443510.510000015,2018,1,22,CASH_IN,162151.51,C1303868418
8686,409000438620',2018-01-22,AEPS Indiaforensic GST 210118,0.0,29187.27,13472697.780000014,2018,1,22,CHECK_CASHING,29187.27,C1554540309
8687,409000438620',2018-01-22,TRF TO  Indiaforensic SERVICES I,13000000.0,0.0,472697.78000001423,2018,1,22,PAYEMENT,13000000.0,C909295153
8688,409000438620',2018-01-23,Indiaforensic AEPS NPCI WDL SET,0.0,43031762.0,43504459.780000016,2018,1,23,CHECK_CASHING,43031762.0,C486371171
8689,409000438620',2018-01-23,AEPS ACQ REP ADJ FEES 220,0.0,17.7,43504477.48000002,2018,1,23,CASH_IN,17.7,C75483598
8690,409000438620',2018-01-23,AEPS Indiaforensic INCOME 220118,0.0,197800.45,43702277.93000002,2018,1,23,TRANSFER,197800.45,C1882860489
8691,409000438620',2018-01-23,AEPS Indiaforensic GST 220118,0.0,35604.08,43737882.01000002,2018,1,23,CASH_IN,35604.08,C798678484
8692,409000438620',2018-01-23,Indiaforensic AEPS NPCI DEP SET,36287349.0,0.0,7450533.01000002,2018,1,23,PAYEMENT,36287349.0,C16344660
8693,409000438620',2018-01-23,TRF TO  Indiaforensic SERVICES I,7400000.0,0.0,50533.010000020266,2018,1,23,PAYEMENT,7400000.0,C1778801068
8694,409000438620',2018-01-24,Indiaforensic AEPS NPCI WDL SET,0.0,47422584.0,47473117.01000002,2018,1,24,CHECK_CASHING,47422584.0,C1234776885
8695,409000438620',2018-01-24,CB800213216840/RMCPL17770/0,1000.0,0.0,47472117.01000002,2018,1,24,CHECK_WITHDRAWAL,1000.0,C1899073220
8696,409000438620',2018-01-24,CB800214256881/RMCPL11061/0,700.0,0.0,47471417.01000002,2018,1,24,PAYEMENT,700.0,M1489640621
8697,409000438620',2018-01-24,CB800214256883/RMCPL17350/0,2000.0,0.0,47469417.01000002,2018,1,24,CASH_OUT,2000.0,C63387985
8698,409000438620',2018-01-24,CB800214256911/RMCPL17121/0,10000.0,0.0,47459417.01000002,2018,1,24,PAYEMENT,10000.0,C515132998
8699,409000438620',2018-01-24,CB800214256933/RMCPL19308/0,1000.0,0.0,47458417.01000002,2018,1,24,CHECK_WITHDRAWAL,1000.0,C508000580
8700,409000438620',2018-01-24,CB800214256960/RMCPL18042/0,10000.0,0.0,47448417.01000002,2018,1,24,CASH_OUT,10000.0,C1909597726
8701,409000438620',2018-01-24,CB800214256961/RMCPL02803/0,500.0,0.0,47447917.01000002,2018,1,24,CASH_OUT,500.0,C374625527
8702,409000438620',2018-01-24,CB800214257010/RMCPL15491/0,3000.0,0.0,47444917.01000002,2018,1,24,CASH_OUT,3000.0,C451111351
8703,409000438620',2018-01-24,CB800214258780/RMCPL16185/0,3000.0,0.0,47441917.01000002,2018,1,24,DEBIT,3000.0,C295372946
8704,409000438620',2018-01-24,CB800214259674/RMCPL20654/0,10000.0,0.0,47431917.01000002,2018,1,24,CASH_OUT,10000.0,C634440506
8705,409000438620',2018-01-24,CB800214259715/RMCPL18878/0,1500.0,0.0,47430417.01000002,2018,1,24,CHECK_WITHDRAWAL,1500.0,C2006206648
8706,409000438620',2018-01-24,CB800215262979/RMCPL18637/0,10000.0,0.0,47420417.01000002,2018,1,24,DEBIT,10000.0,C16344660
8707,409000438620',2018-01-24,CB800215263134/RMCPL18377/0,1000.0,0.0,47419417.01000002,2018,1,24,PAYEMENT,1000.0,C715819458
8708,409000438620',2018-01-24,CB800215263238/RMCPL15322/0,1000.0,0.0,47418417.01000002,2018,1,24,CASH_OUT,1000.0,C1674899618
8709,409000438620',2018-01-24,CB800215263328/RMCPL15323/0,6500.0,0.0,47411917.01000002,2018,1,24,CHECK_WITHDRAWAL,6500.0,C1245442940
8710,409000438620',2018-01-24,CB800216329069/RMCPL14673/0,3000.0,0.0,47408917.01000002,2018,1,24,CHECK_WITHDRAWAL,3000.0,C1245442940
8711,409000438620',2018-01-24,CB800312835195/RMCPL18014/0,500.0,0.0,47408417.01000002,2018,1,24,DEBIT,500.0,C1303868418
8712,409000438620',2018-01-24,CB800312836743/RMCPL22215/0,1000.0,0.0,47407417.01000002,2018,1,24,CASH_OUT,1000.0,C1609562230
8713,409000438620',2018-01-24,CB800312836810/RMCPL16122/0,500.0,0.0,47406917.01000002,2018,1,24,PAYEMENT,500.0,C1554565380
8714,409000438620',2018-01-24,CB800213216688/RMCPL17806/0,1000.0,0.0,47405917.01000002,2018,1,24,CASH_OUT,1000.0,C1641587857
8715,409000438620',2018-01-24,CB800214258728/RMCPL22133/0,5000.0,0.0,47400917.01000002,2018,1,24,DEBIT,5000.0,C1651945012
8716,409000438620',2018-01-24,CB800216339331/RMCPL22247/0,1000.0,0.0,47399917.01000002,2018,1,24,PAYEMENT,1000.0,C1615804266
8717,409000438620',2018-01-24,CB800216339055/RMCPL15468/0,4000.0,0.0,47395917.01000002,2018,1,24,CHECK_WITHDRAWAL,4000.0,C1071364078
8718,409000438620',2018-01-24,CB800216339102/RMCPL21341/0,1000.0,0.0,47394917.01000002,2018,1,24,CASH_OUT,1000.0,C1060041730
8719,409000438620',2018-01-24,CB800214258602/RMCPL13088/0,9500.0,0.0,47385417.01000002,2018,1,24,CHECK_WITHDRAWAL,9500.0,C1899073220
8720,409000438620',2018-01-24,CB800415517939/RMCPL18956/0,1000.0,0.0,47384417.01000002,2018,1,24,CASH_OUT,1000.0,C1778801068
8721,409000438620',2018-01-24,CB800917586577/RMCPL20275/0,4000.0,0.0,47380417.01000002,2018,1,24,DEBIT,4000.0,C542220524
8722,409000438620',2018-01-24,CB800917586796/RMCPL07077/0,600.0,0.0,47379817.01000002,2018,1,24,DEBIT,600.0,C481402298
8723,409000438620',2018-01-24,CB800917587120/RMCPL11063/0,1000.0,0.0,47378817.01000002,2018,1,24,PAYEMENT,1000.0,C1013700132
8724,409000438620',2018-01-24,CB800917587355/RMCPL15258/0,2000.0,0.0,47376817.01000002,2018,1,24,CASH_OUT,2000.0,C1899073220
8725,409000438620',2018-01-24,CB800917587389/RMCPL22241/0,500.0,0.0,47376317.01000002,2018,1,24,CHECK_WITHDRAWAL,500.0,C1339257929
8726,409000438620',2018-01-24,CB800917587544/RMCPL17567/0,1000.0,0.0,47375317.01000002,2018,1,24,DEBIT,1000.0,C675203915
8727,409000438620',2018-01-24,CB800912367639/RMCPL13006/0,1000.0,0.0,47374317.01000002,2018,1,24,CASH_OUT,1000.0,C1805683209
8728,409000438620',2018-01-24,CB801113655921/RMCPL22792/1,3000.0,0.0,47371317.01000002,2018,1,24,PAYEMENT,3000.0,C257999182
8729,409000438620',2018-01-24,CB801113644203/RMCPL09843/1,3000.0,0.0,47368317.01000002,2018,1,24,CASH_OUT,3000.0,C71555810
8730,409000438620',2018-01-24,CB801113644265/RMCPL18177/1,3000.0,0.0,47365317.01000002,2018,1,24,CHECK_WITHDRAWAL,3000.0,C914293025
8731,409000438620',2018-01-24,CB801113644267/RMCPL12008/1,500.0,0.0,47364817.01000002,2018,1,24,DEBIT,500.0,C400720732
8732,409000438620',2018-01-24,CB801113644887/RMCPL20608/1,500.0,0.0,47364317.01000002,2018,1,24,DEBIT,500.0,C991363637
8733,409000438620',2018-01-24,CB801113645943/RMCPL10937/1,2000.0,0.0,47362317.01000002,2018,1,24,CHECK_WITHDRAWAL,2000.0,C111210112
8734,409000438620',2018-01-24,CB801113645946/RMCPL17459/1,1250.0,0.0,47361067.01000002,2018,1,24,PAYEMENT,1250.0,C237988421
8735,409000438620',2018-01-24,CB801110513587/RMCPL12036/1,2000.0,0.0,47359067.01000002,2018,1,24,DEBIT,2000.0,C486371171
8736,409000438620',2018-01-24,CB800813863439/RMCPL13059/0,2000.0,0.0,47357067.01000002,2018,1,24,DEBIT,2000.0,C804836251
8737,409000438620',2018-01-24,CB801008851314/RMCPL20927/1,10000.0,0.0,47347067.01000002,2018,1,24,CHECK_WITHDRAWAL,10000.0,C323761934
8738,409000438620',2018-01-24,CB800813863512/RMCPL20970/0,10000.0,0.0,47337067.01000002,2018,1,24,PAYEMENT,10000.0,C1584119395
8739,409000438620',2018-01-24,CB801016147863/RMCPL20131/1,7500.0,0.0,47329567.01000002,2018,1,24,PAYEMENT,7500.0,C40075281
8740,409000438620',2018-01-24,CB801110513616/RMCPL00150/1,2000.0,0.0,47327567.01000002,2018,1,24,DEBIT,2000.0,C507538622
8741,409000438620',2018-01-24,CB801113649121/RMCPL15427/1,2000.0,0.0,47325567.01000002,2018,1,24,DEBIT,2000.0,C508000580
8742,409000438620',2018-01-24,CB801512835743/RMCPL18667/1,9000.0,0.0,47316567.01000002,2018,1,24,PAYEMENT,9000.0,C1899073220
8743,409000438620',2018-01-24,Indiaforensic AEPS NPCI DEP SET,39930474.0,0.0,7386093.01000002,2018,1,24,CASH_OUT,39930474.0,C715819458
8744,409000438620',2018-01-24,AEPS ACQUIRING ADJ FEES 2,35.4,0.0,7386057.61000002,2018,1,24,DEBIT,35.4,C1720078459
8745,409000438620',2018-01-24,AEPS Indiaforensic INCOME 230118,0.0,216245.13,7602302.74000002,2018,1,24,CHECK_CASHING,216245.13,C2006081398
8746,409000438620',2018-01-24,AEPS Indiaforensic GST 230118,0.0,38924.12,7641226.86000002,2018,1,24,TRANSFER,38924.12,C384887832
8747,409000438620',2018-01-24,TRF TO  Indiaforensic SERVICES I,7400000.0,0.0,241226.8600000199,2018,1,24,DEBIT,7400000.0,C306206744
8748,409000438620',2018-01-25,Indiaforensic AEPS NPCI WDL SET,0.0,46775650.0,47016876.86000002,2018,1,25,TRANSFER,46775650.0,C2034460325
8749,409000438620',2018-01-25,Indiaforensic AEPS NPCI DEP SET,38869017.0,0.0,8147859.860000023,2018,1,25,PAYEMENT,38869017.0,C127252077
8750,409000438620',2018-01-25,AEPS INCOME REV 010417-25,1269094.36,0.0,6878765.500000021,2018,1,25,CASH_OUT,1269094.36,C125722707
8751,409000438620',2018-01-25,AEPS ACQUIRING ADJ FEES 2,11.8,0.0,6878753.700000023,2018,1,25,DEBIT,11.8,C1234776885
8752,409000438620',2018-01-25,AEPS Indiaforensic INCOME 240118,0.0,211453.27,7090206.970000021,2018,1,25,CHECK_CASHING,211453.27,C985934102
8753,409000438620',2018-01-25,AEPS Indiaforensic GST 240118,0.0,38061.59,7128268.560000021,2018,1,25,TRANSFER,38061.59,C72565662
8754,409000438620',2018-01-25,TRF TO  Indiaforensic SERVICES I,5000000.0,0.0,2128268.560000021,2018,1,25,PAYEMENT,5000000.0,C2083562754
8755,409000438620',2018-01-25,TRF TO  Indiaforensic SERVICES I,2000000.0,0.0,128268.560000021,2018,1,25,DEBIT,2000000.0,C1554565380
8756,409000438620',2018-01-29,Indiaforensic AEPS NPCI WDL SET,0.0,50378654.0,50506922.56000002,2018,1,29,CASH_IN,50378654.0,C128870695
8757,409000438620',2018-01-29,Indiaforensic AEPS NPCI WDL SET,0.0,30452545.0,80959467.56000002,2018,1,29,TRANSFER,30452545.0,C125722707
8758,409000438620',2018-01-29,Indiaforensic AEPS NPCI DEP SET,41299200.0,0.0,39660267.56000002,2018,1,29,DEBIT,41299200.0,C1286084959
8759,409000438620',2018-01-29,Indiaforensic AEPS NPCI DEP SET,26648563.0,0.0,13011704.560000015,2018,1,29,CHECK_WITHDRAWAL,26648563.0,C553790651
8760,409000438620',2018-01-29,Indiaforensic AEPS NPCI WDL SET,0.0,37976662.0,50988366.56000002,2018,1,29,CASH_IN,37976662.0,C162400148
8761,409000438620',2018-01-29,Indiaforensic AEPS NPCI WDL SET,0.0,23114189.0,74102555.56000002,2018,1,29,CASH_IN,23114189.0,M445226957
8762,409000438620',2018-01-29,Indiaforensic AEPS NPCI DEP SET,30889112.0,0.0,43213443.56000002,2018,1,29,DEBIT,30889112.0,C1790598448
8763,409000438620',2018-01-29,Indiaforensic AEPS NPCI DEP SET,24328046.0,0.0,18885397.560000014,2018,1,29,DEBIT,24328046.0,M1989317222
8764,409000438620',2018-01-29,AEPS ACQ REP ADJ FEES 250,0.0,35.4,18885432.960000016,2018,1,29,CHECK_CASHING,35.4,M437499329
8765,409000438620',2018-01-29,AEPS Indiaforensic INCOME 250118,0.0,225909.03,19111341.990000013,2018,1,29,CHECK_CASHING,225909.03,M2039317063
8766,409000438620',2018-01-29,AEPS Indiaforensic GST 250118,0.0,40663.63,19152005.620000016,2018,1,29,CASH_IN,40663.63,M1188576964
8767,409000438620',2018-01-29,AEPS Indiaforensic INCOME 260118,0.0,143806.38,19295812.00000001,2018,1,29,TRANSFER,143806.38,M960609751
8768,409000438620',2018-01-29,AEPS Indiaforensic GST 260118,0.0,25885.15,19321697.150000013,2018,1,29,CHECK_CASHING,25885.15,M1852753695
8769,409000438620',2018-01-29,AEPS Indiaforensic INCOME 270118,0.0,171645.23,19493342.380000014,2018,1,29,TRANSFER,171645.23,M706986081
8770,409000438620',2018-01-29,AEPS Indiaforensic GST 270118,0.0,30896.14,19524238.52000001,2018,1,29,CASH_IN,30896.14,C2113748097
8771,409000438620',2018-01-29,AEPS Indiaforensic INCOME 280118,0.0,117507.06,19641745.580000013,2018,1,29,CASH_IN,117507.06,M965023582
8772,409000438620',2018-01-29,AEPS Indiaforensic GST 280118,0.0,21151.27,19662896.850000013,2018,1,29,TRANSFER,21151.27,M1536992552
8773,409000438620',2018-01-29,TRF TO  Indiaforensic SERVICES I,5800000.0,0.0,13862896.850000013,2018,1,29,CHECK_WITHDRAWAL,5800000.0,C1615804266
8774,409000438620',2018-01-29,TRF TO  Indiaforensic SERVICES I,13000000.0,0.0,862896.8500000127,2018,1,29,PAYEMENT,13000000.0,M1970983463
8775,409000438620',2018-01-30,Indiaforensic AEPS NPCI WDL SET,0.0,50599453.0,51462349.85000001,2018,1,30,TRANSFER,50599453.0,C507046070
8776,409000438620',2018-01-30,Indiaforensic AEPS NPCI DEP SET,41083035.0,0.0,10379314.850000007,2018,1,30,CHECK_WITHDRAWAL,41083035.0,C1046160944
8777,409000438620',2018-01-30,AEPS ACQUIRING ADJ FEES 2,17.7,0.0,10379297.15000001,2018,1,30,CHECK_WITHDRAWAL,17.7,C1313534832
8778,409000438620',2018-01-30,AEPS ACQ REP ADJ FEES 290,0.0,11.8,10379308.95000001,2018,1,30,CHECK_CASHING,11.8,M1208464055
8779,409000438620',2018-01-30,AEPS Indiaforensic INCOME 290118,0.0,225286.26,10604595.21000001,2018,1,30,CASH_IN,225286.26,M92712774
8780,409000438620',2018-01-30,AEPS Indiaforensic GST 290118,0.0,40551.53,10645146.74000001,2018,1,30,CHECK_CASHING,40551.53,M1728067407
8781,409000438620',2018-01-30,TRF TO  Indiaforensic SERVICES I,10500000.0,0.0,145146.74000000954,2018,1,30,CHECK_WITHDRAWAL,10500000.0,C1360393616
8782,409000438620',2018-01-31,Indiaforensic AEPS NPCI WDL SET,0.0,55267077.0,55412223.74000001,2018,1,31,TRANSFER,55267077.0,M2095807072
8783,409000438620',2018-01-31,Indiaforensic AEPS NPCI DEP SET,44806906.0,0.0,10605317.74000001,2018,1,31,CHECK_WITHDRAWAL,44806906.0,M1803977656
8784,409000438620',2018-01-31,AEPS ACQUIRING ADJ FEES 3,53.1,0.0,10605264.64000001,2018,1,31,PAYEMENT,53.1,M1850393589
8785,409000438620',2018-01-31,AEPS ACQ CR ADJ FEES 3001,1811.46,0.0,10603453.180000007,2018,1,31,DEBIT,1811.46,M395888457
8786,409000438620',2018-01-31,CR801912100937/RMCPL21437/1,5000.0,0.0,10598453.180000007,2018,1,31,CASH_OUT,5000.0,M1250154012
8787,409000438620',2018-01-31,CR801915228935/RMCPL12219/1,1000.0,0.0,10597453.180000007,2018,1,31,CHECK_WITHDRAWAL,1000.0,M858872101
8788,409000438620',2018-01-31,CR801915228817/RMCPL13552/1,3000.0,0.0,10594453.180000007,2018,1,31,DEBIT,3000.0,M1653316341
8789,409000438620',2018-01-31,CR801712002062/RMCPL18168/1,1000.0,0.0,10593453.180000007,2018,1,31,DEBIT,1000.0,M708590084
8790,409000438620',2018-01-31,CR801712002275/RMCPL17681/1,7000.0,0.0,10586453.180000007,2018,1,31,CASH_OUT,7000.0,M1177088902
8791,409000438620',2018-01-31,CR801712002278/RMCPL21219/1,500.0,0.0,10585953.180000007,2018,1,31,CHECK_WITHDRAWAL,500.0,M1938138927
8792,409000438620',2018-01-31,CR801712002435/RMCPL19869/1,1000.0,0.0,10584953.180000007,2018,1,31,CASH_OUT,1000.0,M1581539326
8793,409000438620',2018-01-31,CR801712001934/RMCPL18480/1,2000.0,0.0,10582953.180000007,2018,1,31,PAYEMENT,2000.0,M715117698
8794,409000438620',2018-01-31,CR801712001848/RMCPL20329/1,500.0,0.0,10582453.180000007,2018,1,31,CHECK_WITHDRAWAL,500.0,M6634074
8795,409000438620',2018-01-31,CR801712002110/RMCPL21432/1,500.0,0.0,10581953.180000007,2018,1,31,CHECK_WITHDRAWAL,500.0,M1294054661
8796,409000438620',2018-01-31,CR801712002277/RMCPL12527/1,1000.0,0.0,10580953.180000007,2018,1,31,DEBIT,1000.0,M167514715
8797,409000438620',2018-01-31,CR801712002911/RMCPL12225/1,10000.0,0.0,10570953.180000007,2018,1,31,CHECK_WITHDRAWAL,10000.0,M584816461
8798,409000438620',2018-01-31,CR801712002994/RMCPL21953/1,1000.0,0.0,10569953.180000007,2018,1,31,CASH_OUT,1000.0,M2043935641
8799,409000438620',2018-01-31,CR801712002844/RMCPL16950/1,5000.0,0.0,10564953.180000007,2018,1,31,PAYEMENT,5000.0,M1901371976
8800,409000438620',2018-01-31,CR801712001331/RMCPL14560/1,1000.0,0.0,10563953.180000007,2018,1,31,DEBIT,1000.0,M624130540
8801,409000438620',2018-01-31,CR801712001652/RMCPL21953/1,1000.0,0.0,10562953.180000007,2018,1,31,DEBIT,1000.0,M668225854
8802,409000438620',2018-01-31,CR801712001315/RMCPL16538/1,1500.0,0.0,10561453.180000007,2018,1,31,PAYEMENT,1500.0,M137670903
8803,409000438620',2018-01-31,CR801712002695/RMCPL22193/1,2500.0,0.0,10558953.180000007,2018,1,31,CHECK_WITHDRAWAL,2500.0,M1227966084
8804,409000438620',2018-01-31,CR801712002282/RMCPL17200/1,1000.0,0.0,10557953.180000007,2018,1,31,PAYEMENT,1000.0,M1623406089
8805,409000438620',2018-01-31,CR801712002120/RMCPL20482/1,3000.0,0.0,10554953.180000007,2018,1,31,PAYEMENT,3000.0,M586261312
8806,409000438620',2018-01-31,CR801712002760/RMCPL14662/1,1000.0,0.0,10553953.180000007,2018,1,31,PAYEMENT,1000.0,C927008541
8807,409000438620',2018-01-31,CR801712001777/RMCPL19605/1,3000.0,0.0,10550953.180000007,2018,1,31,CASH_OUT,3000.0,C1730752455
8808,409000438620',2018-01-31,CR801712002656/RMCPL17049/1,1000.0,0.0,10549953.180000007,2018,1,31,PAYEMENT,1000.0,C1060041730
8809,409000438620',2018-01-31,CR801712000928/RMCPL13609/1,1000.0,0.0,10548953.180000007,2018,1,31,DEBIT,1000.0,C2072865894
8810,409000438620',2018-01-31,CR801712001677/RMCPL18408/1,1000.0,0.0,10547953.180000007,2018,1,31,CHECK_WITHDRAWAL,1000.0,C1286084959
8811,409000438620',2018-01-31,CR801509739690/RMCPL12371/1,500.0,0.0,10547453.180000007,2018,1,31,DEBIT,500.0,C2006081398
8812,409000438620',2018-01-31,CR801509739087/RMCPL11776/1,500.0,0.0,10546953.180000007,2018,1,31,CHECK_WITHDRAWAL,500.0,C1651945012
8813,409000438620',2018-01-31,CR801509738859/RMCPL19438/1,3000.0,0.0,10543953.180000007,2018,1,31,PAYEMENT,3000.0,C1931283804
8814,409000438620',2018-01-31,CR801316974180/RMCPL11592/1,1500.0,0.0,10542453.180000007,2018,1,31,DEBIT,1500.0,C2099343080
8815,409000438620',2018-01-31,CR801316974172/RMCPL15869/1,1500.0,0.0,10540953.180000007,2018,1,31,PAYEMENT,1500.0,C728526866
8816,409000438620',2018-01-31,CR801213256766/RMCPL21691/1,2040.0,0.0,10538913.180000007,2018,1,31,PAYEMENT,2040.0,C1495761010
8817,409000438620',2018-01-31,CR801213257044/RMCPL10426/1,1000.0,0.0,10537913.180000007,2018,1,31,DEBIT,1000.0,C853932876
8818,409000438620',2018-01-31,CR801213256854/RMCPL19298/1,1000.0,0.0,10536913.180000007,2018,1,31,DEBIT,1000.0,C169904524
8819,409000438620',2018-01-31,CR801213256778/RMCPL16467/1,1000.0,0.0,10535913.180000007,2018,1,31,CHECK_WITHDRAWAL,1000.0,C184253187
8820,409000438620',2018-01-31,CR801213251539/RMCPL21229/1,3000.0,0.0,10532913.180000007,2018,1,31,PAYEMENT,3000.0,C672137778
8821,409000438620',2018-01-31,CR801211170302/RMCPL13751/1,3000.0,0.0,10529913.180000007,2018,1,31,DEBIT,3000.0,C128870695
8822,409000438620',2018-01-31,CR801211170298/RMCPL17758/1,3000.0,0.0,10526913.180000007,2018,1,31,PAYEMENT,3000.0,C977993101
8823,409000438620',2018-01-31,CR801213257033/RMCPL21016/1,1000.0,0.0,10525913.180000007,2018,1,31,DEBIT,1000.0,C339099861
8824,409000438620',2018-01-31,CR801213257036/RMCPL22931/1,4000.0,0.0,10521913.180000007,2018,1,31,DEBIT,4000.0,C1721246982
8825,409000438620',2018-01-31,CR801213256727/RMCPL22510/1,3000.0,0.0,10518913.180000007,2018,1,31,PAYEMENT,3000.0,C2145041211
8826,409000438620',2018-01-31,CR801213256898/RMCPL13062/1,2000.0,0.0,10516913.180000007,2018,1,31,CHECK_WITHDRAWAL,2000.0,C461905695
8827,409000438620',2018-01-31,CR801213256973/RMCPL21242/1,138.0,0.0,10516775.180000007,2018,1,31,CASH_OUT,138.0,C1931283804
8828,409000438620',2018-01-31,CR801212236140/RMCPL15880/1,2000.0,0.0,10514775.180000007,2018,1,31,CASH_OUT,2000.0,C1060041730
8829,409000438620',2018-01-31,CR801213256845/RMCPL15549/1,1500.0,0.0,10513275.180000007,2018,1,31,PAYEMENT,1500.0,C1505755152
8830,409000438620',2018-01-31,CR801213257115/RMCPL22386/1,500.0,0.0,10512775.180000007,2018,1,31,CHECK_WITHDRAWAL,500.0,C1816986148
8831,409000438620',2018-01-31,CR801213256702/RMCPL19942/1,1000.0,0.0,10511775.180000007,2018,1,31,PAYEMENT,1000.0,C1832532108
8832,409000438620',2018-01-31,CR801210137032/RMCPL14707/1,2500.0,0.0,10509275.180000007,2018,1,31,CHECK_WITHDRAWAL,2500.0,C1303868418
8833,409000438620',2018-01-31,CR801110509721/RMCPL22129/1,4000.0,0.0,10505275.180000007,2018,1,31,DEBIT,4000.0,C271588719
8834,409000438620',2018-01-31,CR801113641078/RMCPL19840/1,500.0,0.0,10504775.180000007,2018,1,31,CASH_OUT,500.0,C794358930
8835,409000438620',2018-01-31,CR801112604850/RMCPL09188/1,7000.0,0.0,10497775.180000007,2018,1,31,CHECK_WITHDRAWAL,7000.0,C1234059684
8836,409000438620',2018-01-31,CR801110513591/RMCPL18521/1,500.0,0.0,10497275.180000007,2018,1,31,PAYEMENT,500.0,C1554565380
8837,409000438620',2018-01-31,CR801110509748/RMCPL17432/1,1000.0,0.0,10496275.180000007,2018,1,31,CHECK_WITHDRAWAL,1000.0,C1145835418
8838,409000438620',2018-01-31,CR801110518183/RMCPL19137/1,3000.0,0.0,10493275.180000007,2018,1,31,DEBIT,3000.0,C553790651
8839,409000438620',2018-01-31,CR801112604712/RMCPL16117/1,1000.0,0.0,10492275.180000007,2018,1,31,PAYEMENT,1000.0,C2113748097
8840,409000438620',2018-01-31,CR801113640793/RMCPL13499/1,2500.0,0.0,10489775.180000007,2018,1,31,PAYEMENT,2500.0,C1440282299
8841,409000438620',2018-01-31,CR801112607766/RMCPL22314/1,10000.0,0.0,10479775.180000007,2018,1,31,DEBIT,10000.0,C1778300121
8842,409000438620',2018-01-31,CR801110509685/RMCPL18422/1,500.0,0.0,10479275.180000007,2018,1,31,PAYEMENT,500.0,C1588476205
8843,409000438620',2018-01-31,CR801110518036/RMCPL22068/1,2000.0,0.0,10477275.180000007,2018,1,31,CASH_OUT,2000.0,C289039926
8844,409000438620',2018-01-31,CR801110513475/RMCPL13088/1,1000.0,0.0,10476275.180000007,2018,1,31,DEBIT,1000.0,C97730845
8845,409000438620',2018-01-31,CR801110518120/RMCPL14211/1,1500.0,0.0,10474775.180000007,2018,1,31,PAYEMENT,1500.0,C1329589315
8846,409000438620',2018-01-31,CR801113644788/RMCPL18637/1,1000.0,0.0,10473775.180000007,2018,1,31,CASH_OUT,1000.0,C1313534832
8847,409000438620',2018-01-31,CR801112604881/RMCPL12818/1,2000.0,0.0,10471775.180000007,2018,1,31,DEBIT,2000.0,C1297685781
8848,409000438620',2018-01-31,CR801110509677/RMCPL16865/1,500.0,0.0,10471275.180000007,2018,1,31,DEBIT,500.0,C187019413
8849,409000438620',2018-01-31,CR801114716330/RMCPL17808/1,500.0,0.0,10470775.180000007,2018,1,31,CHECK_WITHDRAWAL,500.0,C1085479446
8850,409000438620',2018-01-31,CR801110509746/RMCPL21709/1,3000.0,0.0,10467775.180000007,2018,1,31,DEBIT,3000.0,C634440506
8851,409000438620',2018-01-31,CR801110509831/RMCPL18656/1,3000.0,0.0,10464775.180000007,2018,1,31,CASH_OUT,3000.0,C114618982
8852,409000438620',2018-01-31,CR801113643401/RMCPL19218/1,1000.0,0.0,10463775.180000007,2018,1,31,DEBIT,1000.0,C377207092
8853,409000438620',2018-01-31,CR801113640747/RMCPL22092/1,500.0,0.0,10463275.180000007,2018,1,31,CASH_OUT,500.0,M2010785921
8854,409000438620',2018-01-31,CR801112607814/RMCPL17641/1,510.0,0.0,10462765.180000007,2018,1,31,CASH_OUT,510.0,M6518397
8855,409000438620',2018-01-31,CR801110513406/RMCPL21030/1,500.0,0.0,10462265.180000007,2018,1,31,DEBIT,500.0,C2117043942
8856,409000438620',2018-01-31,CR801112604733/RMCPL18443/1,5000.0,0.0,10457265.180000007,2018,1,31,CHECK_WITHDRAWAL,5000.0,M504687961
8857,409000438620',2018-01-31,CR801110517914/RMCPL13091/1,1540.0,0.0,10455725.180000007,2018,1,31,CASH_OUT,1540.0,M757190955
8858,409000438620',2018-01-31,CR801110518105/RMCPL21653/1,500.0,0.0,10455225.180000007,2018,1,31,DEBIT,500.0,M1608304191
8859,409000438620',2018-01-31,CR801110513615/RMCPL15079/1,10000.0,0.0,10445225.180000007,2018,1,31,DEBIT,10000.0,M74695825
8860,409000438620',2018-01-31,CR801110517974/RMCPL14977/1,2000.0,0.0,10443225.180000007,2018,1,31,CHECK_WITHDRAWAL,2000.0,M118130260
8861,409000438620',2018-01-31,CR801110513409/RMCPL19979/1,5000.0,0.0,10438225.180000007,2018,1,31,CASH_OUT,5000.0,M2102490838
8862,409000438620',2018-01-31,CR801113644517/RMCPL22007/1,1000.0,0.0,10437225.180000007,2018,1,31,CASH_OUT,1000.0,C1554540309
8863,409000438620',2018-01-31,CR801110509794/RMCPL13639/1,2500.0,0.0,10434725.180000007,2018,1,31,DEBIT,2500.0,C126778243
8864,409000438620',2018-01-31,CR801113645990/RMCPL13859/1,1000.0,0.0,10433725.180000007,2018,1,31,CHECK_WITHDRAWAL,1000.0,M272243411
8865,409000438620',2018-01-31,CR801113650931/RMCPL22042/1,500.0,0.0,10433225.180000007,2018,1,31,CHECK_WITHDRAWAL,500.0,M454621817
8866,409000438620',2018-01-31,CR801110509650/RMCPL15049/1,10000.0,0.0,10423225.180000007,2018,1,31,CASH_OUT,10000.0,C1286084959
8867,409000438620',2018-01-31,CR801110518050/RMCPL18702/1,2000.0,0.0,10421225.180000007,2018,1,31,DEBIT,2000.0,M261691810
8868,409000438620',2018-01-31,CR801110518248/RMCPL17250/1,10000.0,0.0,10411225.180000007,2018,1,31,DEBIT,10000.0,M1422989013
8869,409000438620',2018-01-31,CR801110513745/RMCPL15468/1,3000.0,0.0,10408225.180000007,2018,1,31,PAYEMENT,3000.0,M935631445
8870,409000438620',2018-01-31,CR801112604861/RMCPL19413/1,10000.0,0.0,10398225.180000007,2018,1,31,DEBIT,10000.0,M1331523729
8871,409000438620',2018-01-31,CR801112604895/RMCPL20318/1,1000.0,0.0,10397225.180000007,2018,1,31,CHECK_WITHDRAWAL,1000.0,M311344289
8872,409000438620',2018-01-31,CR801110518042/RMCPL18708/1,1000.0,0.0,10396225.180000007,2018,1,31,PAYEMENT,1000.0,C886517510
8873,409000438620',2018-01-31,CR801112604590/RMCPL12734/1,2500.0,0.0,10393725.180000007,2018,1,31,CHECK_WITHDRAWAL,2500.0,M1308514012
8874,409000438620',2018-01-31,CR801113640734/RMCPL14040/1,8000.0,0.0,10385725.180000007,2018,1,31,DEBIT,8000.0,C184253187
8875,409000438620',2018-01-31,CR801110509608/RMCPL10425/1,2000.0,0.0,10383725.180000007,2018,1,31,PAYEMENT,2000.0,M1744677371
8876,409000438620',2018-01-31,CR801110518014/RMCPL15464/1,1000.0,0.0,10382725.180000007,2018,1,31,PAYEMENT,1000.0,M1715798313
8877,409000438620',2018-01-31,CR801112607896/RMCPL15580/1,1500.0,0.0,10381225.180000007,2018,1,31,PAYEMENT,1500.0,C909295153
8878,409000438620',2018-01-31,CR801114716334/RMCPL15740/1,500.0,0.0,10380725.180000007,2018,1,31,DEBIT,500.0,M345144532
8879,409000438620',2018-01-31,CR801113646044/RMCPL22950/1,2000.0,0.0,10378725.180000007,2018,1,31,PAYEMENT,2000.0,M1146980236
8880,409000438620',2018-01-31,CR801110513742/RMCPL21300/1,1500.0,0.0,10377225.180000007,2018,1,31,DEBIT,1500.0,M295633759
8881,409000438620',2018-01-31,CR801112604718/RMCPL14828/1,1000.0,0.0,10376225.180000007,2018,1,31,CHECK_WITHDRAWAL,1000.0,C870563118
8882,409000438620',2018-01-31,CR801112604837/RMCPL09797/1,1000.0,0.0,10375225.180000007,2018,1,31,CASH_OUT,1000.0,C265108079
8883,409000438620',2018-01-31,CR801112604595/RMCPL20564/1,2000.0,0.0,10373225.180000007,2018,1,31,CHECK_WITHDRAWAL,2000.0,C1475909248
8884,409000438620',2018-01-31,CR801110509651/RMCPL13491/1,1000.0,0.0,10372225.180000007,2018,1,31,CHECK_WITHDRAWAL,1000.0,M1247720979
8885,409000438620',2018-01-31,CR801110509626/RMCPL21030/1,500.0,0.0,10371725.180000007,2018,1,31,DEBIT,500.0,M600820203
8886,409000438620',2018-01-31,CR801110513606/RMCPL11504/1,3000.0,0.0,10368725.180000007,2018,1,31,CASH_OUT,3000.0,M738086393
8887,409000438620',2018-01-31,CR801110518090/RMCPL14967/1,1000.0,0.0,10367725.180000007,2018,1,31,DEBIT,1000.0,M303790741
8888,409000438620',2018-01-31,CR801110513610/RMCPL10689/1,10000.0,0.0,10357725.180000007,2018,1,31,PAYEMENT,10000.0,M602812856
8889,409000438620',2018-01-31,CR801110513512/RMCPL21933/1,500.0,0.0,10357225.180000007,2018,1,31,CASH_OUT,500.0,M373436199
8890,409000438620',2018-01-31,CR801113640995/RMCPL22243/1,510.0,0.0,10356715.180000007,2018,1,31,PAYEMENT,510.0,M256568355
8891,409000438620',2018-01-31,CR801113644901/RMCPL14928/1,400.0,0.0,10356315.180000007,2018,1,31,DEBIT,400.0,C1778801068
8892,409000438620',2018-01-31,CR801110509575/RMCPL11999/1,500.0,0.0,10355815.180000007,2018,1,31,DEBIT,500.0,C2083117811
8893,409000438620',2018-01-31,CR801110518001/RMCPL20261/1,500.0,0.0,10355315.180000007,2018,1,31,PAYEMENT,500.0,C1615804266
8894,409000438620',2018-01-31,CR801113641104/RMCPL09962/1,4000.0,0.0,10351315.180000007,2018,1,31,DEBIT,4000.0,C954225330
8895,409000438620',2018-01-31,CR801008834545/RMCPL14810/1,500.0,0.0,10350815.180000007,2018,1,31,PAYEMENT,500.0,C111210112
8896,409000438620',2018-01-31,CR801017190568/RMCPL17123/1,700.0,0.0,10350115.180000007,2018,1,31,CASH_OUT,700.0,C1286084959
8897,409000438620',2018-01-31,CR801008851402/RMCPL17289/1,10000.0,0.0,10340115.180000007,2018,1,31,PAYEMENT,10000.0,C1266035080
8898,409000438620',2018-01-31,CR801008840745/RMCPL15629/1,1000.0,0.0,10339115.180000007,2018,1,31,CASH_OUT,1000.0,C1477979030
8899,409000438620',2018-01-31,CR801008851437/RMCPL20062/1,5000.0,0.0,10334115.180000007,2018,1,31,PAYEMENT,5000.0,C1651945012
8900,409000438620',2018-01-31,CR801016144401/RMCPL13536/1,2000.0,0.0,10332115.180000007,2018,1,31,CHECK_WITHDRAWAL,2000.0,C1730752455
8901,409000438620',2018-01-31,CR801011967300/RMCPL00704/1,210.0,0.0,10331905.180000007,2018,1,31,PAYEMENT,210.0,C985934102
8902,409000438620',2018-01-31,CR801008851466/RMCPL16871/1,2000.0,0.0,10329905.180000007,2018,1,31,PAYEMENT,2000.0,C1266035080
8903,409000438620',2018-01-31,CR801008851558/RMCPL20874/1,2500.0,0.0,10327405.180000007,2018,1,31,DEBIT,2500.0,C716083600
8904,409000438620',2018-01-31,CR801008844804/RMCPL03589/1,4500.0,0.0,10322905.180000007,2018,1,31,DEBIT,4500.0,M244926383
8905,409000438620',2018-01-31,CR801017190576/RMCPL21281/1,10000.0,0.0,10312905.180000007,2018,1,31,CASH_OUT,10000.0,C871895680
8906,409000438620',2018-01-31,CR801017213540/RMCPL17368/1,4000.0,0.0,10308905.180000007,2018,1,31,PAYEMENT,4000.0,M299194277
8907,409000438620',2018-01-31,CR801016147520/RMCPL13592/1,1000.0,0.0,10307905.180000007,2018,1,31,DEBIT,1000.0,M1694924087
8908,409000438620',2018-01-31,CR801016144230/RMCPL09925/1,2000.0,0.0,10305905.180000007,2018,1,31,DEBIT,2000.0,M1328154889
8909,409000438620',2018-01-31,CR801008844867/RMCPL18993/1,1500.0,0.0,10304405.180000007,2018,1,31,CASH_OUT,1500.0,M1655529269
8910,409000438620',2018-01-31,CR801008844831/RMCPL17274/1,2000.0,0.0,10302405.180000007,2018,1,31,PAYEMENT,2000.0,C787033725
8911,409000438620',2018-01-31,CR801018228056/RMCPL22472/1,2000.0,0.0,10300405.180000007,2018,1,31,CHECK_WITHDRAWAL,2000.0,M1452158309
8912,409000438620',2018-01-31,CR801008840576/RMCPL11402/1,5000.0,0.0,10295405.180000007,2018,1,31,CASH_OUT,5000.0,C1632648448
8913,409000438620',2018-01-31,CR801018228006/RMCPL21804/1,500.0,0.0,10294905.180000007,2018,1,31,CHECK_WITHDRAWAL,500.0,M673004775
8914,409000438620',2018-01-31,CR801008844768/RMCPL21872/1,1500.0,0.0,10293405.180000007,2018,1,31,DEBIT,1500.0,M1172610365
8915,409000438620',2018-01-31,CR801008851441/RMCPL18587/1,500.0,0.0,10292905.180000007,2018,1,31,DEBIT,500.0,M1175829504
8916,409000438620',2018-01-31,CR801008834564/RMCPL18487/1,1350.0,0.0,10291555.180000007,2018,1,31,CHECK_WITHDRAWAL,1350.0,M1453010953
8917,409000438620',2018-01-31,CR801016144359/RMCPL21219/1,2000.0,0.0,10289555.180000007,2018,1,31,CHECK_WITHDRAWAL,2000.0,M1221507960
8918,409000438620',2018-01-31,CR801008834438/RMCPL21473/1,6000.0,0.0,10283555.180000007,2018,1,31,DEBIT,6000.0,M1255505329
8919,409000438620',2018-01-31,CR801008851457/RMCPL09743/1,1000.0,0.0,10282555.180000007,2018,1,31,PAYEMENT,1000.0,M1404855442
8920,409000438620',2018-01-31,CR801016147810/RMCPL20407/1,3000.0,0.0,10279555.180000007,2018,1,31,CASH_OUT,3000.0,M2145027279
8921,409000438620',2018-01-31,CR801016155536/RMCPL16840/1,1010.0,0.0,10278545.180000007,2018,1,31,PAYEMENT,1010.0,M26362041
8922,409000438620',2018-01-31,CR801017191769/RMCPL21350/1,1000.0,0.0,10277545.180000007,2018,1,31,DEBIT,1000.0,M772801497
8923,409000438620',2018-01-31,CR801008844718/RMCPL09185/1,5500.0,0.0,10272045.180000007,2018,1,31,CASH_OUT,5500.0,C347725669
8924,409000438620',2018-01-31,CR801008844791/RMCPL20644/1,1500.0,0.0,10270545.180000007,2018,1,31,CASH_OUT,1500.0,M1618596377
8925,409000438620',2018-01-31,CR801016147683/RMCPL14166/1,2220.0,0.0,10268325.180000007,2018,1,31,CHECK_WITHDRAWAL,2220.0,M1751830047
8926,409000438620',2018-01-31,CR801016147500/RMCPL14949/1,100.0,0.0,10268225.180000007,2018,1,31,CASH_OUT,100.0,M1394529934
8927,409000438620',2018-01-31,CR801017191750/RMCPL12720/1,1000.0,0.0,10267225.180000007,2018,1,31,PAYEMENT,1000.0,M1807564872
8928,409000438620',2018-01-31,CR801008851579/RMCPL09194/1,1000.0,0.0,10266225.180000007,2018,1,31,PAYEMENT,1000.0,M2056144971
8929,409000438620',2018-01-31,CR801008851508/RMCPL14522/1,2000.0,0.0,10264225.180000007,2018,1,31,DEBIT,2000.0,M1694580081
8930,409000438620',2018-01-31,CR801008840606/RMCPL15602/1,10000.0,0.0,10254225.180000007,2018,1,31,PAYEMENT,10000.0,C317071334
8931,409000438620',2018-01-31,CR801008840657/RMCPL15451/1,2000.0,0.0,10252225.180000007,2018,1,31,DEBIT,2000.0,C443625234
8932,409000438620',2018-01-31,CR801017188845/RMCPL16457/1,1000.0,0.0,10251225.180000007,2018,1,31,DEBIT,1000.0,C1454226183
8933,409000438620',2018-01-31,CR801017191941/RMCPL17462/1,1000.0,0.0,10250225.180000007,2018,1,31,DEBIT,1000.0,M816903796
8934,409000438620',2018-01-31,CR801016144332/RMCPL19103/1,500.0,0.0,10249725.180000007,2018,1,31,CHECK_WITHDRAWAL,500.0,M972417956
8935,409000438620',2018-01-31,CR801008844770/RMCPL08013/1,5000.0,0.0,10244725.180000007,2018,1,31,CASH_OUT,5000.0,M196298876
8936,409000438620',2018-01-31,CR801017190634/RMCPL22549/1,3000.0,0.0,10241725.180000007,2018,1,31,CHECK_WITHDRAWAL,3000.0,M1933047934
8937,409000438620',2018-01-31,CR801018228113/RMCPL14487/1,3000.0,0.0,10238725.180000007,2018,1,31,CHECK_WITHDRAWAL,3000.0,M1719868180
8938,409000438620',2018-01-31,CR801017190589/RMCPL14710/1,500.0,0.0,10238225.180000007,2018,1,31,DEBIT,500.0,M61227510
8939,409000438620',2018-01-31,CR801016144360/RMCPL18791/1,2000.0,0.0,10236225.180000007,2018,1,31,PAYEMENT,2000.0,M418220917
8940,409000438620',2018-01-31,CR801017191947/RMCPL19474/1,1000.0,0.0,10235225.180000007,2018,1,31,DEBIT,1000.0,C1948471365
8941,409000438620',2018-01-31,CR801008851635/RMCPL22663/1,1000.0,0.0,10234225.180000007,2018,1,31,DEBIT,1000.0,M916936815
8942,409000438620',2018-01-31,CR801018228170/RMCPL21300/1,2000.0,0.0,10232225.180000007,2018,1,31,CASH_OUT,2000.0,M816895399
8943,409000438620',2018-01-31,CR801016155526/RMCPL20762/1,3000.0,0.0,10229225.180000007,2018,1,31,DEBIT,3000.0,C976133979
8944,409000438620',2018-01-31,CR801008844849/RMCPL10335/1,7000.0,0.0,10222225.180000007,2018,1,31,DEBIT,7000.0,C1520366382
8945,409000438620',2018-01-31,CR801008840482/RMCPL19068/1,5000.0,0.0,10217225.180000007,2018,1,31,CASH_OUT,5000.0,M1736021405
8946,409000438620',2018-01-31,CR801008844885/RMCPL11796/1,1000.0,0.0,10216225.180000007,2018,1,31,CASH_OUT,1000.0,M692860601
8947,409000438620',2018-01-31,CR801008840788/RMCPL14572/1,2000.0,0.0,10214225.180000007,2018,1,31,DEBIT,2000.0,M1088236798
8948,409000438620',2018-01-31,CR801016147848/RMCPL17782/1,5000.0,0.0,10209225.180000007,2018,1,31,CHECK_WITHDRAWAL,5000.0,C1554565380
8949,409000438620',2018-01-31,CR801016144189/RMCPL20680/1,500.0,0.0,10208725.180000007,2018,1,31,CASH_OUT,500.0,C370034120
8950,409000438620',2018-01-31,CR801008851517/RMCPL22371/1,500.0,0.0,10208225.180000007,2018,1,31,DEBIT,500.0,C1463758439
8951,409000438620',2018-01-31,CR801016155504/RMCPL15491/1,3000.0,0.0,10205225.180000007,2018,1,31,CASH_OUT,3000.0,M1291085172
8952,409000438620',2018-01-31,CR801018228190/RMCPL11402/1,1000.0,0.0,10204225.180000007,2018,1,31,DEBIT,1000.0,C158424358
8953,409000438620',2018-01-31,CR801008851493/RMCPL11752/1,800.0,0.0,10203425.180000007,2018,1,31,CHECK_WITHDRAWAL,800.0,C1069568462
8954,409000438620',2018-01-31,CR801016144375/RMCPL17155/1,1000.0,0.0,10202425.180000007,2018,1,31,CASH_OUT,1000.0,M706930658
8955,409000438620',2018-01-31,CR801016148645/RMCPL11265/1,500.0,0.0,10201925.180000007,2018,1,31,DEBIT,500.0,M1469692066
8956,409000438620',2018-01-31,CR801016147719/RMCPL17141/1,5000.0,0.0,10196925.180000007,2018,1,31,PAYEMENT,5000.0,M945195126
8957,409000438620',2018-01-31,AEPS ACQ REP ADJ FEES 300,0.0,17.7,10196942.880000008,2018,1,31,TRANSFER,17.7,M1816933119
8958,409000438620',2018-01-31,CR801008851550/RMCPL11241/1,6000.0,0.0,10190942.880000008,2018,1,31,DEBIT,6000.0,M1443062572
8959,409000438620',2018-01-31,CR801008840811/RMCPL21797/1,3500.0,0.0,10187442.880000008,2018,1,31,CHECK_WITHDRAWAL,3500.0,C451111351
8960,409000438620',2018-01-31,CR801008840701/RMCPL09932/1,3000.0,0.0,10184442.880000008,2018,1,31,DEBIT,3000.0,M1929749571
8961,409000438620',2018-01-31,CR801017191789/RMCPL09788/1,10000.0,0.0,10174442.880000008,2018,1,31,DEBIT,10000.0,M182174652
8962,409000438620',2018-01-31,CR801008840776/RMCPL15649/1,2000.0,0.0,10172442.880000008,2018,1,31,CHECK_WITHDRAWAL,2000.0,M1564432445
8963,409000438620',2018-01-31,CR801018228093/RMCPL21079/1,3000.0,0.0,10169442.880000008,2018,1,31,DEBIT,3000.0,M583835905
8964,409000438620',2018-01-31,CR801018228003/RMCPL10418/1,1000.0,0.0,10168442.880000008,2018,1,31,CASH_OUT,1000.0,C1778289781
8965,409000438620',2018-01-31,CR801008844793/RMCPL18020/1,500.0,0.0,10167942.880000008,2018,1,31,PAYEMENT,500.0,M888391968
8966,409000438620',2018-01-31,AEPS Indiaforensic INCOME 300118,0.0,245798.93,10413741.810000008,2018,1,31,CHECK_CASHING,245798.93,M1941771372
8967,409000438620',2018-01-31,AEPS Indiaforensic GST 300118,0.0,44243.81,10457985.620000007,2018,1,31,CHECK_CASHING,44243.81,M876084303
8968,409000438620',2018-01-31,TRF TO  Indiaforensic SERVICES I,10000000.0,0.0,457985.6200000085,2018,1,31,CHECK_WITHDRAWAL,10000000.0,M1495591569
8969,409000438620',2018-02-01,Indiaforensic AEPS NPCI WDL SET,0.0,50398191.0,50856176.62000001,2018,2,1,CHECK_CASHING,50398191.0,M1889298280
8970,409000438620',2018-02-01,Indiaforensic AEPS NPCI DEP SET,44036228.0,0.0,6819948.620000005,2018,2,1,PAYEMENT,44036228.0,M1077640163
8971,409000438620',2018-02-01,AEPS ACQUIRING ADJ FEES 3,17.7,0.0,6819930.920000005,2018,2,1,PAYEMENT,17.7,C1641169735
8972,409000438620',2018-02-01,AEPS ACQ REP ADJ FEES 300,0.0,53.1,6819984.020000004,2018,2,1,TRANSFER,53.1,C265845794
8973,409000438620',2018-02-01,AEPS Indiaforensic INCOME 310118,0.0,230421.05,7050405.070000004,2018,2,1,TRANSFER,230421.05,M926946280
8974,409000438620',2018-02-01,AEPS Indiaforensic GST 310118,0.0,41475.79,7091880.860000004,2018,2,1,CASH_IN,41475.79,M7025284
8975,409000438620',2018-02-01,TRF TO  Indiaforensic SERVICES I,5000000.0,0.0,2091880.860000004,2018,2,1,PAYEMENT,5000000.0,C985934102
8976,409000438620',2018-02-01,TRF TO  Indiaforensic SERVICES I,2000000.0,0.0,91880.86000000406,2018,2,1,DEBIT,2000000.0,C466505482
8977,409000438620',2018-02-02,Indiaforensic AEPS NPCI WDL SET,0.0,52178089.0,52269969.86000001,2018,2,2,CHECK_CASHING,52178089.0,C1245442940
8978,409000438620',2018-02-02,Indiaforensic AEPS NPCI DEP SET,30060846.0,0.0,22209123.860000007,2018,2,2,CASH_OUT,30060846.0,M774515463
8979,409000438620',2018-02-02,AEPS ACQUIRING ADJ FEES 0,17.7,0.0,22209106.160000008,2018,2,2,CASH_OUT,17.7,C296121376
8980,409000438620',2018-02-02,AEPS ACQ REP ADJ FEES 010,0.0,17.7,22209123.860000007,2018,2,2,TRANSFER,17.7,M1006688804
8981,409000438620',2018-02-02,TRF TO  Indiaforensic SERVICES I,15000000.0,0.0,7209123.860000008,2018,2,2,PAYEMENT,15000000.0,C1457383927
8982,409000438620',2018-02-02,TRF TO  Indiaforensic SERVICES I,7200000.0,0.0,9123.860000006856,2018,2,2,PAYEMENT,7200000.0,C555334025
8983,409000438620',2018-02-03,Indiaforensic AEPS NPCI WDL SET,0.0,57623175.0,57632298.86000001,2018,2,3,CASH_IN,57623175.0,C909295153
8984,409000438620',2018-02-03,Indiaforensic AEPS NPCI DEP SET,36407158.0,0.0,21225140.860000007,2018,2,3,PAYEMENT,36407158.0,C1234776885
8985,409000438620',2018-02-03,AEPS ACQUIRING ADJ FEES 0,66.08,0.0,21225074.78000001,2018,2,3,DEBIT,66.08,C1095666481
8986,409000438620',2018-02-03,AEPS ACQ REP ADJ FEES 020,0.0,17.7,21225092.480000008,2018,2,3,CASH_IN,17.7,M1452287711
8987,409000438620',2018-02-03,TRF TO  Indiaforensic SERVICES I,15000000.0,0.0,6225092.480000008,2018,2,3,CHECK_WITHDRAWAL,15000000.0,M1313152922
8988,409000438620',2018-02-03,TRF TO  Indiaforensic SERVICES I,3000000.0,0.0,3225092.480000008,2018,2,3,CHECK_WITHDRAWAL,3000000.0,C1450133081
8989,409000438620',2018-02-03,TRF TO  Indiaforensic SERVICES I,3000000.0,0.0,225092.4800000079,2018,2,3,DEBIT,3000000.0,M1623964247
8990,409000438620',2018-02-05,Indiaforensic AEPS NPCI WDL SET,0.0,49350092.0,49575184.48,2018,2,5,TRANSFER,49350092.0,C914293025
8991,409000438620',2018-02-05,Indiaforensic AEPS NPCI WDL SET,0.0,31255805.0,80830989.48,2018,2,5,CASH_IN,31255805.0,M1518422518
8992,409000438620',2018-02-05,AEPS ACQUIRING ADJ FEES 0,23.6,0.0,80830965.88000001,2018,2,5,PAYEMENT,23.6,C963383848
8993,409000438620',2018-02-05,Indiaforensic AEPS NPCI DEP SET,39459689.0,0.0,41371276.88000001,2018,2,5,DEBIT,39459689.0,C985934102
8994,409000438620',2018-02-05,Indiaforensic AEPS NPCI DEP SET,27163524.0,0.0,14207752.88000001,2018,2,5,DEBIT,27163524.0,M1002126468
8995,409000438620',2018-02-05,TRF TO  Indiaforensic SERVICES I,14200000.0,0.0,7752.880000010133,2018,2,5,CASH_OUT,14200000.0,C814473635
8996,409000438620',2018-02-06,Indiaforensic AEPS NPCI WDL SET,0.0,50733603.0,50741355.88000001,2018,2,6,CHECK_CASHING,50733603.0,M2094908687
8997,409000438620',2018-02-06,AEPS ACQ REP ADJ FEES 050,0.0,66.08,50741421.96000001,2018,2,6,TRANSFER,66.08,M208144409
8998,409000438620',2018-02-06,Indiaforensic AEPS NPCI DEP SET,36962313.0,0.0,13779108.960000008,2018,2,6,CHECK_WITHDRAWAL,36962313.0,M1084946006
8999,409000438620',2018-02-06,AEPS Indiaforensic INCOME 010218,0.0,205553.64,13984662.600000007,2018,2,6,CASH_IN,205553.64,C1636786811
9000,409000438620',2018-02-06,AEPS Indiaforensic GST 010218,0.0,36999.66,14021662.26000001,2018,2,6,CHECK_CASHING,36999.66,M690715138
9001,409000438620',2018-02-06,AEPS Indiaforensic INCOME 020218,0.0,231227.78,14252890.040000008,2018,2,6,CASH_IN,231227.78,M635096154
9002,409000438620',2018-02-06,AEPS Indiaforensic GST 020218,0.0,41621.0,14294511.040000008,2018,2,6,TRANSFER,41621.0,M658399791
9003,409000438620',2018-02-06,AEPS Indiaforensic INCOME 030218,0.0,216853.19,14511364.230000008,2018,2,6,CHECK_CASHING,216853.19,M1262973217
9004,409000438620',2018-02-06,AEPS Indiaforensic GST 030218,0.0,39033.57,14550397.800000008,2018,2,6,CASH_IN,39033.57,M1965969606
9005,409000438620',2018-02-06,AEPS Indiaforensic INCOME 040218,0.0,149285.73,14699683.530000007,2018,2,6,CHECK_CASHING,149285.73,M1540460994
9006,409000438620',2018-02-06,AEPS Indiaforensic GST 040218,0.0,26871.43,14726554.960000008,2018,2,6,CHECK_CASHING,26871.43,M1454357198
9007,409000438620',2018-02-06,AEPS Indiaforensic INCOME 050218,0.0,219162.61,14945717.570000008,2018,2,6,CHECK_CASHING,219162.61,M1401226549
9008,409000438620',2018-02-06,AEPS Indiaforensic GST 050218,0.0,39449.27,14985166.840000007,2018,2,6,TRANSFER,39449.27,M717735555
9009,409000438620',2018-02-06,TRF TO  Indiaforensic SERVICES I,14900000.0,0.0,85166.8400000073,2018,2,6,CASH_OUT,14900000.0,M1000930248
9010,409000438620',2018-02-07,Indiaforensic AEPS NPCI WDL SET,0.0,51793950.0,51879116.84,2018,2,7,CASH_IN,51793950.0,M90023615
9011,409000438620',2018-02-07,Indiaforensic AEPS NPCI DEP SET,40420893.0,0.0,11458223.840000005,2018,2,7,CASH_OUT,40420893.0,M1174772595
9012,409000438620',2018-02-07,AEPS ACQUIRING ADJ FEES 0,2.95,0.0,11458220.890000004,2018,2,7,DEBIT,2.95,M1806983232
9013,409000438620',2018-02-07,AEPS ACQ REP ADJ FEES 060,0.0,23.6,11458244.490000006,2018,2,7,TRANSFER,23.6,M1103456560
9014,409000438620',2018-02-07,AEPS Indiaforensic INCOME 060218,0.0,227128.53,11685373.020000005,2018,2,7,TRANSFER,227128.53,C2052185144
9015,409000438620',2018-02-07,AEPS Indiaforensic GST 060218,0.0,40883.14,11726256.160000006,2018,2,7,TRANSFER,40883.14,M247888865
9016,409000438620',2018-02-07,TRF TO  Indiaforensic SERVICES I,11400000.0,0.0,326256.16000000393,2018,2,7,DEBIT,11400000.0,C1360767589
9017,409000438620',2018-02-08,Indiaforensic AEPS NPCI WDL SET,0.0,49461865.0,49788121.16,2018,2,8,CASH_IN,49461865.0,M1521553533
9018,409000438620',2018-02-08,Indiaforensic AEPS NPCI DEP SET,38415053.0,0.0,11373068.160000006,2018,2,8,PAYEMENT,38415053.0,C705265015
9019,409000438620',2018-02-08,AEPS ACQ CR ADJ FEES 0702,82.6,0.0,11372985.560000004,2018,2,8,CASH_OUT,82.6,M1339490584
9020,409000438620',2018-02-08,CR802511191966/RMCPL15907/2,500.0,0.0,11372485.560000004,2018,2,8,CASH_OUT,500.0,M1365471425
9021,409000438620',2018-02-08,CR802511192845/RMCPL21121/2,6000.0,0.0,11366485.560000004,2018,2,8,CASH_OUT,6000.0,M1350450807
9022,409000438620',2018-02-08,CR802511191904/RMCPL22967/2,3340.0,0.0,11363145.560000004,2018,2,8,CASH_OUT,3340.0,C1326243087
9023,409000438620',2018-02-08,CR802512203184/RMCPL17588/2,1000.0,0.0,11362145.560000004,2018,2,8,PAYEMENT,1000.0,C1028574311
9024,409000438620',2018-02-08,CR802512204057/RMCPL20688/2,3000.0,0.0,11359145.560000004,2018,2,8,DEBIT,3000.0,C1457383927
9025,409000438620',2018-02-08,CR802512202081/RMCPL18268/2,2000.0,0.0,11357145.560000004,2018,2,8,CHECK_WITHDRAWAL,2000.0,C1085479446
9026,409000438620',2018-02-08,CR802912049255/RMCPL12731/2,500.0,0.0,11356645.560000004,2018,2,8,DEBIT,500.0,C1419794148
9027,409000438620',2018-02-08,CR802210587273/RMCPL14560/2,1000.0,0.0,11355645.560000004,2018,2,8,CASH_OUT,1000.0,C2006081398
9028,409000438620',2018-02-08,AEPS Indiaforensic INCOME 070218,0.0,216731.0,11572376.560000004,2018,2,8,CASH_IN,216731.0,C1850180796
9029,409000438620',2018-02-08,AEPS Indiaforensic GST 070218,0.0,39011.58,11611388.140000004,2018,2,8,CASH_IN,39011.58,C517653428
9030,409000438620',2018-02-08,TRF TO  Indiaforensic SERVICES I,11300000.0,0.0,311388.1400000043,2018,2,8,CHECK_WITHDRAWAL,11300000.0,C505973878
9031,409000438620',2018-02-09,Indiaforensic AEPS NPCI WDL SET,0.0,44810047.0,45121435.14,2018,2,9,CASH_IN,44810047.0,C1825992554
9032,409000438620',2018-02-09,AEPS ACQUIRING ADJ FEES 0,17.7,0.0,45121417.44,2018,2,9,CASH_OUT,17.7,C2052185144
9033,409000438620',2018-02-09,GF734512447618/RMCPL18192/1,10000.0,0.0,45111417.44,2018,2,9,PAYEMENT,10000.0,C158424358
9034,409000438620',2018-02-09,AEPS ACQ GFREP ADJ FEES 0,0.0,17.7,45111435.14,2018,2,9,CASH_IN,17.7,C1590550415
9035,409000438620',2018-02-09,AEPS Indiaforensic INCOME 080218,0.0,190853.81,45302288.95,2018,2,9,CHECK_CASHING,190853.81,C265108079
9036,409000438620',2018-02-09,AEPS Indiaforensic GST 080218,0.0,34353.69,45336642.64,2018,2,9,TRANSFER,34353.69,M1879414521
9037,409000438620',2018-02-09,Indiaforensic AEPS NPCI DEP SET,34038855.0,0.0,11297787.64,2018,2,9,CHECK_WITHDRAWAL,34038855.0,M858340148
9038,409000438620',2018-02-09,TRF TO  Indiaforensic SERVICES I,11200000.0,0.0,97787.64000000061,2018,2,9,PAYEMENT,11200000.0,M877611650
9039,409000438620',2018-02-12,Indiaforensic AEPS NPCI WDL SET,0.0,48920526.0,49018313.64,2018,2,12,CHECK_CASHING,48920526.0,M1682034673
9040,409000438620',2018-02-12,Indiaforensic AEPS NPCI WDL SET,0.0,43275348.0,92293661.64,2018,2,12,TRANSFER,43275348.0,M1326045592
9041,409000438620',2018-02-12,Indiaforensic AEPS NPCI WDL SET,0.0,32702156.0,124995817.64,2018,2,12,TRANSFER,32702156.0,M1718173776
9042,409000438620',2018-02-12,Indiaforensic AEPS NPCI DEP SET,35776353.0,0.0,89219464.64,2018,2,12,CHECK_WITHDRAWAL,35776353.0,M47701845
9043,409000438620',2018-02-12,Indiaforensic AEPS NPCI DEP SET,30073423.0,0.0,59146041.64,2018,2,12,DEBIT,30073423.0,M1267443383
9044,409000438620',2018-02-12,Indiaforensic AEPS NPCI DEP SET,26933315.0,0.0,32212726.64,2018,2,12,PAYEMENT,26933315.0,M1821332066
9045,409000438620',2018-02-12,TRF TO  Indiaforensic SERVICES I,15000000.0,0.0,17212726.64,2018,2,12,DEBIT,15000000.0,M2112012700
9046,409000438620',2018-02-12,TRF TO  Indiaforensic SERVICES I,15000000.0,0.0,2212726.640000001,2018,2,12,CASH_OUT,15000000.0,M1271176560
9047,409000438620',2018-02-12,AEPS ACQUIRING ADJ FEES 0,17.7,0.0,2212708.9400000004,2018,2,12,PAYEMENT,17.7,M408023455
9048,409000438620',2018-02-12,REP ADJ FEES 090218,0.0,20.65,2212729.5900000003,2018,2,12,CHECK_CASHING,20.65,M1555288047
9049,409000438620',2018-02-12,AEPS Indiaforensic INCOME 090218,0.0,207166.77,2419896.3600000003,2018,2,12,CASH_IN,207166.77,M427665153
9050,409000438620',2018-02-12,AEPS Indiaforensic GST 090218,0.0,37290.02,2457186.3800000004,2018,2,12,TRANSFER,37290.02,M2004057662
9051,409000438620',2018-02-12,AEPS Indiaforensic INCOME 100218,0.0,182542.68,2639729.0600000005,2018,2,12,CASH_IN,182542.68,M911400217
9052,409000438620',2018-02-12,AEPS Indiaforensic GST 100218,0.0,32857.68,2672586.740000001,2018,2,12,CHECK_CASHING,32857.68,M117629468
9053,409000438620',2018-02-12,AEPS Indiaforensic INCOME 110218,0.0,151589.24,2824175.9800000004,2018,2,12,CASH_IN,151589.24,M2086649316
9054,409000438620',2018-02-12,AEPS Indiaforensic GST 110218,0.0,27286.06,2851462.0400000005,2018,2,12,TRANSFER,27286.06,M1612952911
9055,409000438620',2018-02-12,TRF TO  Indiaforensic SERVICES I,2800000.0,0.0,51462.040000000496,2018,2,12,DEBIT,2800000.0,M367559104
9056,409000438620',2018-02-14,Indiaforensic AEPS NPCI WDL SET,0.0,53385122.0,53436584.04,2018,2,14,TRANSFER,53385122.0,M362427044
9057,409000438620',2018-02-14,Indiaforensic AEPS NPCI WDL SET,0.0,50798694.0,104235278.04,2018,2,14,CASH_IN,50798694.0,M500979799
9058,409000438620',2018-02-14,Indiaforensic AEPS NPCI DEP SET,37658561.0,0.0,66576717.03999999,2018,2,14,DEBIT,37658561.0,M1119605276
9059,409000438620',2018-02-14,Indiaforensic AEPS NPCI DEP SET,37978669.0,0.0,28598048.03999999,2018,2,14,DEBIT,37978669.0,M680533991
9060,409000438620',2018-02-14,TRF TO  Indiaforensic SERVICES I,13500000.0,0.0,15098048.039999992,2018,2,14,CASH_OUT,13500000.0,M883716803
9061,409000438620',2018-02-14,TRF TO  Indiaforensic SERVICES I,15000000.0,0.0,98048.03999999166,2018,2,14,CHECK_WITHDRAWAL,15000000.0,M1151309352
9062,409000438620',2018-02-14,AEPS ACQUIRING ADJ FEES 1,168.15,0.0,97879.88999999166,2018,2,14,CHECK_WITHDRAWAL,168.15,M1617767058
9063,409000438620',2018-02-14,AEPS Indiaforensic INCOME 120218,0.0,227079.18,324959.06999999174,2018,2,14,CASH_IN,227079.18,M1922191129
9064,409000438620',2018-02-14,AEPS Indiaforensic GST 120218,0.0,40874.25,365833.31999999174,2018,2,14,CASH_IN,40874.25,M1341130820
9065,409000438620',2018-02-14,AEPS Indiaforensic INCOME 130218,0.0,218199.08,584032.3999999915,2018,2,14,CHECK_CASHING,218199.08,M1088692104
9066,409000438620',2018-02-14,AEPS Indiaforensic GST 130218,0.0,39275.83,623308.2299999916,2018,2,14,TRANSFER,39275.83,M1300689712
9067,409000438620',2018-02-15,Indiaforensic AEPS NPCI WDL SET,0.0,43524087.0,44147395.22999999,2018,2,15,CHECK_CASHING,43524087.0,M2129874611
9068,409000438620',2018-02-15,Indiaforensic AEPS NPCI DEP SET,33990380.0,0.0,10157015.22999999,2018,2,15,DEBIT,33990380.0,M1576827711
9069,409000438620',2018-02-15,AEPS ACQUIRING ADJ FEES 1,23.6,0.0,10156991.62999999,2018,2,15,PAYEMENT,23.6,M2131124126
9070,409000438620',2018-02-15,AEPS ACQ REP ADJ FEES 140,0.0,17.7,10157009.329999987,2018,2,15,TRANSFER,17.7,M779586235
9071,409000438620',2018-02-15,AEPS Indiaforensic INCOME 140218,0.0,191360.96,10348370.28999999,2018,2,15,TRANSFER,191360.96,M1492905182
9072,409000438620',2018-02-15,AEPS Indiaforensic GST 140218,0.0,34444.97,10382815.25999999,2018,2,15,CASH_IN,34444.97,M1000763518
9073,409000438620',2018-02-15,TRF TO  Indiaforensic SERVICES I,10000000.0,0.0,382815.25999999046,2018,2,15,CASH_OUT,10000000.0,M1281024621
9074,409000438620',2018-02-16,Indiaforensic AEPS NPCI WDL SET,0.0,57349007.0,57731822.25999999,2018,2,16,TRANSFER,57349007.0,M1574257199
9075,409000438620',2018-02-16,Indiaforensic AEPS NPCI DEP SET,42797380.0,0.0,14934442.25999999,2018,2,16,CASH_OUT,42797380.0,M240733254
9076,409000438620',2018-02-16,TRF TO  Indiaforensic SERVICES I,14700000.0,0.0,234442.25999999052,2018,2,16,CHECK_WITHDRAWAL,14700000.0,M1802219104
9077,409000438620',2018-02-16,AEPS ACQ REP ADJ FEES 150,0.0,191.75,234634.00999999052,2018,2,16,TRANSFER,191.75,M1723731570
9078,409000438620',2018-02-16,AEPS Indiaforensic INCOME 150218,0.0,245906.06,480540.06999999046,2018,2,16,TRANSFER,245906.06,M235521954
9079,409000438620',2018-02-16,AEPS Indiaforensic GST 150218,0.0,44263.09,524803.1599999905,2018,2,16,TRANSFER,44263.09,M819197315
9080,409000438620',2018-02-17,Indiaforensic AEPS NPCI WDL SET,0.0,61261248.0,61786051.15999999,2018,2,17,CASH_IN,61261248.0,M1940927690
9081,409000438620',2018-02-17,Indiaforensic AEPS NPCI DEP SET,40840714.0,0.0,20945337.15999999,2018,2,17,DEBIT,40840714.0,M1067377959
9082,409000438620',2018-02-17,AEPS Indiaforensic INCOME 160218,0.0,250378.4,21195715.559999987,2018,2,17,CASH_IN,250378.4,M1487255196
9083,409000438620',2018-02-17,AEPS Indiaforensic GST 160218,0.0,45068.11,21240783.669999987,2018,2,17,TRANSFER,45068.11,M1935524147
9084,409000438620',2018-02-17,TRF TO  Indiaforensic SERVICES I,5000000.0,0.0,16240783.669999987,2018,2,17,CHECK_WITHDRAWAL,5000000.0,M576149775
9085,409000438620',2018-02-17,TRF TO  Indiaforensic SERVICES I,5000000.0,0.0,11240783.669999987,2018,2,17,CHECK_WITHDRAWAL,5000000.0,M301421265
9086,409000438620',2018-02-17,TRF TO  Indiaforensic SERVICES I,5000000.0,0.0,6240783.669999988,2018,2,17,CHECK_WITHDRAWAL,5000000.0,M1177414443
9087,409000438620',2018-02-17,TRF TO  Indiaforensic SERVICES I,5000000.0,0.0,1240783.6699999871,2018,2,17,CASH_OUT,5000000.0,M324419172
9088,409000438620',2018-02-19,TRF TO  Indiaforensic SERVICES I,1200000.0,0.0,40783.66999998689,2018,2,19,PAYEMENT,1200000.0,M920386152
9089,409000438620',2018-02-20,Indiaforensic AEPS NPCI WDL SET,0.0,49158374.0,49199157.66999999,2018,2,20,CASH_IN,49158374.0,M1208989446
9090,409000438620',2018-02-20,Indiaforensic AEPS NPCI DEP SET,33037846.0,0.0,16161311.669999987,2018,2,20,CHECK_WITHDRAWAL,33037846.0,M255248561
9091,409000438620',2018-02-20,TRF TO  Indiaforensic SERVICES I,15000000.0,0.0,1161311.6699999871,2018,2,20,DEBIT,15000000.0,M278894001
9092,409000438620',2018-02-20,Indiaforensic AEPS NPCI WDL SET,0.0,33452643.0,34613954.66999999,2018,2,20,CASH_IN,33452643.0,M1961550304
9093,409000438620',2018-02-20,Indiaforensic AEPS NPCI DEP SET,27186578.0,0.0,7427376.669999988,2018,2,20,CHECK_WITHDRAWAL,27186578.0,M1349353453
9094,409000438620',2018-02-20,TRF TO  Indiaforensic SERVICES I,7400000.0,0.0,27376.66999998689,2018,2,20,DEBIT,7400000.0,M941456460
9095,409000438620',2018-02-20,AEPS ACQUIRING ADJ FEES 1,133.05,0.0,27243.61999998689,2018,2,20,DEBIT,133.05,M631181275
9096,409000438620',2018-02-20,Indiaforensic AEPS NPCI WDL SET,0.0,50181992.0,50209235.61999999,2018,2,20,TRANSFER,50181992.0,M921812350
9097,409000438620',2018-02-20,AEPS Indiaforensic INCOME 170218,0.0,199759.84,50408995.45999999,2018,2,20,CASH_IN,199759.84,M1092507262
9098,409000438620',2018-02-20,AEPS Indiaforensic GST 170218,0.0,35956.77,50444952.23,2018,2,20,TRANSFER,35956.77,M1979294554
9099,409000438620',2018-02-20,AEPS Indiaforensic INCOME 180218,0.0,149887.2,50594839.43,2018,2,20,TRANSFER,149887.2,M1238746961
9100,409000438620',2018-02-20,AEPS Indiaforensic GST 180218,0.0,26979.7,50621819.13,2018,2,20,CASH_IN,26979.7,M2024971776
9101,409000438620',2018-02-20,Indiaforensic AEPS NPCI DEP SET,37121166.0,0.0,13500653.130000005,2018,2,20,CHECK_WITHDRAWAL,37121166.0,M994782211
9102,409000438620',2018-02-21,TRF TO  Indiaforensic SERVICES I,5000000.0,0.0,8500653.130000003,2018,2,21,CASH_OUT,5000000.0,M1605734165
9103,409000438620',2018-02-21,TRF TO  Indiaforensic SERVICES I,5000000.0,0.0,3500653.1300000027,2018,2,21,CHECK_WITHDRAWAL,5000000.0,M2101594271
9104,409000438620',2018-02-21,TRF TO  Indiaforensic SERVICES I,3000000.0,0.0,500653.13000000274,2018,2,21,CASH_OUT,3000000.0,M1730158315
9105,409000438620',2018-02-21,Indiaforensic AEPS NPCI WDL SET,0.0,48056598.0,48557251.13,2018,2,21,CHECK_CASHING,48056598.0,C1348937989
9106,409000438620',2018-02-21,Indiaforensic AEPS NPCI DEP SET,37828009.0,0.0,10729242.130000005,2018,2,21,PAYEMENT,37828009.0,M787089269
9107,409000438620',2018-02-21,AEPS Indiaforensic INCOME 200218,0.0,211826.95,10941069.080000002,2018,2,21,CHECK_CASHING,211826.95,M1779044114
9108,409000438620',2018-02-21,AEPS Indiaforensic GST 200218,0.0,38128.85,10979197.930000003,2018,2,21,CASH_IN,38128.85,M1975555493
9109,409000438620',2018-02-21,AEPS Indiaforensic INCOME 190218,0.0,216469.19,11195667.12,2018,2,21,TRANSFER,216469.19,M1381438013
9110,409000438620',2018-02-21,AEPS Indiaforensic GST 190218,0.0,38964.45,11234631.57,2018,2,21,CASH_IN,38964.45,C875761527
9111,409000438620',2018-02-21,TRF TO  Indiaforensic SERVICES I,10700000.0,0.0,534631.5700000003,2018,2,21,CASH_OUT,10700000.0,M1084093309
9112,409000438620',2018-02-22,Indiaforensic AEPS NPCI WDL SET,0.0,46239397.0,46774028.57,2018,2,22,CHECK_CASHING,46239397.0,M1853981509
9113,409000438620',2018-02-22,AEPS ACQUIRING ADJ FEES 2,244.96,0.0,46773783.61,2018,2,22,PAYEMENT,244.96,M305492781
9114,409000438620',2018-02-22,AEPS ACQ REP ADJ FEES 210,0.0,133.05,46773916.66,2018,2,22,CASH_IN,133.05,M1415857264
9115,409000438620',2018-02-22,Indiaforensic AEPS NPCI DEP SET,37532448.0,0.0,9241468.659999996,2018,2,22,DEBIT,37532448.0,M872190678
9116,409000438620',2018-02-22,AEPS Indiaforensic INCOME 210218,0.0,206288.71,9447757.369999995,2018,2,22,CHECK_CASHING,206288.71,M413114271
9117,409000438620',2018-02-22,AEPS Indiaforensic GST 210218,0.0,37131.97,9484889.339999998,2018,2,22,CHECK_CASHING,37131.97,M204333035
9118,409000438620',2018-02-22,TR TO  Indiaforensic SERVICES IN,9200000.0,0.0,284889.339999998,2018,2,22,DEBIT,9200000.0,M1989482571
9119,409000438620',2018-02-23,Indiaforensic AEPS NPCI WDL SET,0.0,46491287.0,46776176.34,2018,2,23,CHECK_CASHING,46491287.0,M1267290459
9120,409000438620',2018-02-23,AEPS ACQUIRING ADJ FEES 2,150.44,0.0,46776025.9,2018,2,23,CHECK_WITHDRAWAL,150.44,M401024507
9121,409000438620',2018-02-23,Indiaforensic AEPS NPCI DEP SET,37090637.0,0.0,9685388.9,2018,2,23,DEBIT,37090637.0,M1999963010
9122,409000438620',2018-02-23,AEPS Indiaforensic INCOME 220218,0.0,205654.51,9891043.409999998,2018,2,23,CASH_IN,205654.51,M1633407627
9123,409000438620',2018-02-23,AEPS Indiaforensic GST 220218,0.0,37017.81,9928061.22,2018,2,23,CHECK_CASHING,37017.81,M1961643507
9124,409000438620',2018-02-23,TRF TO  Indiaforensic SERVICES I,9600000.0,0.0,328061.2199999988,2018,2,23,DEBIT,9600000.0,M1811082427
9125,409000438620',2018-02-23,Indiaforensic AEPS NPCI WDL SET,0.0,33600.0,361661.2199999988,2018,2,23,CHECK_CASHING,33600.0,M93672808
9126,409000438620',2018-02-23,AEPS Indiaforensic INCOME 190218,0.0,91.8,361753.0199999989,2018,2,23,TRANSFER,91.8,C1545688642
9127,409000438620',2018-02-23,AEPS Indiaforensic GST 190218,0.0,16.52,361769.5399999988,2018,2,23,CASH_IN,16.52,M725543262
9128,409000438620',2018-02-26,Indiaforensic AEPS NPCI WDL SET,0.0,51133300.0,51495069.54,2018,2,26,TRANSFER,51133300.0,M1035027959
9129,409000438620',2018-02-26,Indiaforensic AEPS NPCI DEP SET,37709947.0,0.0,13785122.54,2018,2,26,DEBIT,37709947.0,C2011996123
9130,409000438620',2018-02-26,Indiaforensic AEPS NPCI WDL SET,0.0,44314891.0,58100013.54,2018,2,26,CHECK_CASHING,44314891.0,C1560607671
9131,409000438620',2018-02-26,Indiaforensic AEPS NPCI WDL SET,0.0,28735201.0,86835214.53999999,2018,2,26,CASH_IN,28735201.0,C40075281
9132,409000438620',2018-02-26,Indiaforensic AEPS NPCI DEP SET,32333997.0,0.0,54501217.53999999,2018,2,26,CASH_OUT,32333997.0,C1584119395
9133,409000438620',2018-02-26,Indiaforensic AEPS NPCI DEP SET,25789661.0,0.0,28711556.53999999,2018,2,26,DEBIT,25789661.0,C36856762
9134,409000438620',2018-02-26,TRF TO  Indiaforensic SERVICES I,15000000.0,0.0,13711556.539999992,2018,2,26,CASH_OUT,15000000.0,C1641587857
9135,409000438620',2018-02-26,TRF TO  Indiaforensic SERVICES I,13600000.0,0.0,111556.53999999166,2018,2,26,CHECK_WITHDRAWAL,13600000.0,C875917495
9136,409000438620',2018-02-26,AEPS Indiaforensic INCOME 230218,0.0,218536.59,330093.1299999916,2018,2,26,CHECK_CASHING,218536.59,C1870367457
9137,409000438620',2018-02-26,AEPS Indiaforensic GST 230218,0.0,39336.59,369429.7199999916,2018,2,26,CHECK_CASHING,39336.59,C1346667529
9138,409000438620',2018-02-26,AEPS Indiaforensic INCOME 240218,0.0,188726.14,558155.8599999916,2018,2,26,CASH_IN,188726.14,C1262822392
9139,409000438620',2018-02-26,AEPS Indiaforensic GST 240218,0.0,33970.71,592126.5699999916,2018,2,26,CHECK_CASHING,33970.71,C1651945012
9140,409000438620',2018-02-26,AEPS Indiaforensic INCOME 250218,0.0,135083.64,727210.2099999916,2018,2,26,TRANSFER,135083.64,C205300866
9141,409000438620',2018-02-26,AEPS Indiaforensic GST 250218,0.0,24315.06,751525.2699999915,2018,2,26,CASH_IN,24315.06,C863811613
9142,409000438620',2018-02-27,Indiaforensic AEPS NPCI WDL SET,0.0,45133262.0,45884787.26999999,2018,2,27,TRANSFER,45133262.0,C1013700132
9143,409000438620',2018-02-27,Indiaforensic AEPS NPCI DEP SET,35109461.0,0.0,10775326.269999988,2018,2,27,CASH_OUT,35109461.0,C705265015
9144,409000438620',2018-02-27,AEPS ACQUIRING ADJ FEES 2,17.7,0.0,10775308.56999999,2018,2,27,PAYEMENT,17.7,C347725669
9145,409000438620',2018-02-27,AEPS ACQ GF ADJ FEES 2602,793.59,0.0,10774514.97999999,2018,2,27,CASH_OUT,793.59,C675203915
9146,409000438620',2018-02-27,CR803311033265/RMCPL19049/2,6000.0,0.0,10768514.97999999,2018,2,27,CASH_OUT,6000.0,C1479450980
9147,409000438620',2018-02-27,CR803417723858/RMCPL13808/3,1000.0,0.0,10767514.97999999,2018,2,27,CHECK_WITHDRAWAL,1000.0,M1824531116
9148,409000438620',2018-02-27,CR803417723851/RMCPL23196/3,3000.0,0.0,10764514.97999999,2018,2,27,PAYEMENT,3000.0,M1122694271
9149,409000438620',2018-02-27,CR803417723618/RMCPL13855/3,500.0,0.0,10764014.97999999,2018,2,27,PAYEMENT,500.0,M1553338212
9150,409000438620',2018-02-27,CR803417723889/RMCPL18884/3,500.0,0.0,10763514.97999999,2018,2,27,PAYEMENT,500.0,C1688019098
9151,409000438620',2018-02-27,CR803609301933/RMCPL18225/5,2000.0,0.0,10761514.97999999,2018,2,27,DEBIT,2000.0,M2138211677
9152,409000438620',2018-02-27,CR804309519361/RMCPL13088/1,2000.0,0.0,10759514.97999999,2018,2,27,CASH_OUT,2000.0,M1058118485
9153,409000438620',2018-02-27,CR804309518934/RMCPL16697/1,300.0,0.0,10759214.97999999,2018,2,27,PAYEMENT,300.0,C1609562230
9154,409000438620',2018-02-27,CR804509439811/RMCPL22767/1,5000.0,0.0,10754214.97999999,2018,2,27,CASH_OUT,5000.0,M114452799
9155,409000438620',2018-02-27,CR805013792557/RMCPL14126/1,4050.0,0.0,10750164.97999999,2018,2,27,DEBIT,4050.0,C1477979030
9156,409000438620',2018-02-27,CR805014807058/RMCPL12064/1,3000.0,0.0,10747164.97999999,2018,2,27,DEBIT,3000.0,C611621587
9157,409000438620',2018-02-27,CR805013788653/RMCPL13314/1,2000.0,0.0,10745164.97999999,2018,2,27,DEBIT,2000.0,M1378389093
9158,409000438620',2018-02-27,CR805013792220/RMCPL18732/1,10000.0,0.0,10735164.97999999,2018,2,27,CHECK_WITHDRAWAL,10000.0,M1830305819
9159,409000438620',2018-02-27,CR805014806531/RMCPL22469/1,1000.0,0.0,10734164.97999999,2018,2,27,DEBIT,1000.0,M148963559
9160,409000438620',2018-02-27,CR805013789150/RMCPL15896/1,5000.0,0.0,10729164.97999999,2018,2,27,CASH_OUT,5000.0,M1832539882
9161,409000438620',2018-02-27,CR805013786598/RMCPL23966/1,5000.0,0.0,10724164.97999999,2018,2,27,DEBIT,5000.0,M343845012
9162,409000438620',2018-02-27,CR805013793105/RMCPL22057/1,4000.0,0.0,10720164.97999999,2018,2,27,CASH_OUT,4000.0,M127681620
9163,409000438620',2018-02-27,CR805013788853/RMCPL19806/1,500.0,0.0,10719664.97999999,2018,2,27,CHECK_WITHDRAWAL,500.0,M833545945
9164,409000438620',2018-02-27,CR805013792257/RMCPL18313/1,500.0,0.0,10719164.97999999,2018,2,27,DEBIT,500.0,M441482912
9165,409000438620',2018-02-27,CR805013792201/RMCPL19859/1,1000.0,0.0,10718164.97999999,2018,2,27,DEBIT,1000.0,C1298147262
9166,409000438620',2018-02-27,CR805013789851/RMCPL24063/1,4000.0,0.0,10714164.97999999,2018,2,27,DEBIT,4000.0,M75867593
9167,409000438620',2018-02-27,CR805013788311/RMCPL15079/1,5000.0,0.0,10709164.97999999,2018,2,27,DEBIT,5000.0,M920581443
9168,409000438620',2018-02-27,CR805014807063/RMCPL17468/1,1000.0,0.0,10708164.97999999,2018,2,27,CHECK_WITHDRAWAL,1000.0,M126197703
9169,409000438620',2018-02-27,CR805013792177/RMCPL14485/1,5000.0,0.0,10703164.97999999,2018,2,27,CHECK_WITHDRAWAL,5000.0,C12793273
9170,409000438620',2018-02-27,CR805013789181/RMCPL16875/1,1500.0,0.0,10701664.97999999,2018,2,27,DEBIT,1500.0,M6137753
9171,409000438620',2018-02-27,CR805013788873/RMCPL16637/1,1000.0,0.0,10700664.97999999,2018,2,27,CHECK_WITHDRAWAL,1000.0,M169206721
9172,409000438620',2018-02-27,CR805014807094/RMCPL22042/1,2500.0,0.0,10698164.97999999,2018,2,27,CHECK_WITHDRAWAL,2500.0,M734341896
9173,409000438620',2018-02-27,CR805013792068/RMCPL22638/1,1000.0,0.0,10697164.97999999,2018,2,27,DEBIT,1000.0,M1316583993
9174,409000438620',2018-02-27,CR805013792116/RMCPL19414/1,2000.0,0.0,10695164.97999999,2018,2,27,CHECK_WITHDRAWAL,2000.0,M1128872093
9175,409000438620',2018-02-27,CR805013788132/RMCPL21400/1,5000.0,0.0,10690164.97999999,2018,2,27,CASH_OUT,5000.0,M299830215
9176,409000438620',2018-02-27,CR805013789339/RMCPL21567/1,500.0,0.0,10689664.97999999,2018,2,27,CHECK_WITHDRAWAL,500.0,M1825558106
9177,409000438620',2018-02-27,CR805013787292/RMCPL17633/1,5000.0,0.0,10684664.97999999,2018,2,27,CHECK_WITHDRAWAL,5000.0,M21955570
9178,409000438620',2018-02-27,CR805013793116/RMCPL13088/1,500.0,0.0,10684164.97999999,2018,2,27,DEBIT,500.0,M838139333
9179,409000438620',2018-02-27,CR805013792273/RMCPL17049/1,1510.0,0.0,10682654.97999999,2018,2,27,DEBIT,1510.0,M500129592
9180,409000438620',2018-02-27,CR805013792180/RMCPL22353/1,500.0,0.0,10682154.97999999,2018,2,27,DEBIT,500.0,M1924565494
9181,409000438620',2018-02-27,CR805014806527/RMCPL14363/1,5000.0,0.0,10677154.97999999,2018,2,27,CASH_OUT,5000.0,M1163358778
9182,409000438620',2018-02-27,CR805013789288/RMCPL09155/1,1000.0,0.0,10676154.97999999,2018,2,27,DEBIT,1000.0,M901189533
9183,409000438620',2018-02-27,CR805013795576/RMCPL09112/1,2010.0,0.0,10674144.97999999,2018,2,27,PAYEMENT,2010.0,M1600366322
9184,409000438620',2018-02-27,CR805013789117/RMCPL09595/1,10000.0,0.0,10664144.97999999,2018,2,27,DEBIT,10000.0,C1303868418
9185,409000438620',2018-02-27,CR805013786930/RMCPL18598/1,5000.0,0.0,10659144.97999999,2018,2,27,CHECK_WITHDRAWAL,5000.0,M411529129
9186,409000438620',2018-02-27,CR805013789030/RMCPL22563/1,500.0,0.0,10658644.97999999,2018,2,27,PAYEMENT,500.0,M188529678
9187,409000438620',2018-02-27,CR805013786685/RMCPL15549/1,700.0,0.0,10657944.97999999,2018,2,27,PAYEMENT,700.0,M1161542555
9188,409000438620',2018-02-27,CR805013788961/RMCPL15491/1,5000.0,0.0,10652944.97999999,2018,2,27,CASH_OUT,5000.0,M2033788292
9189,409000438620',2018-02-27,CR805013792575/RMCPL21961/1,1500.0,0.0,10651444.97999999,2018,2,27,CHECK_WITHDRAWAL,1500.0,M336050495
9190,409000438620',2018-02-27,CR805013787993/RMCPL19012/1,2000.0,0.0,10649444.97999999,2018,2,27,CHECK_WITHDRAWAL,2000.0,M1784322521
9191,409000438620',2018-02-27,CR805013788163/RMCPL13803/1,1000.0,0.0,10648444.97999999,2018,2,27,CHECK_WITHDRAWAL,1000.0,M250243497
9192,409000438620',2018-02-27,CR805014806813/RMCPL22266/1,1510.0,0.0,10646934.97999999,2018,2,27,DEBIT,1510.0,C2006081398
9193,409000438620',2018-02-27,CR805013788972/RMCPL23459/1,1000.0,0.0,10645934.97999999,2018,2,27,CASH_OUT,1000.0,C1286084959
9194,409000438620',2018-02-27,CR805013788687/RMCPL16467/1,10000.0,0.0,10635934.97999999,2018,2,27,CASH_OUT,10000.0,C1850180796
9195,409000438620',2018-02-27,CR803212579840/RMCPL22822/1,3000.0,0.0,10632934.97999999,2018,2,27,DEBIT,3000.0,C1899073220
9196,409000438620',2018-02-27,CR803212579791/RMCPL19800/1,710.0,0.0,10632224.97999999,2018,2,27,DEBIT,710.0,C2011996123
9197,409000438620',2018-02-27,CR803212579767/RMCPL14949/1,330.0,0.0,10631894.97999999,2018,2,27,CHECK_WITHDRAWAL,330.0,C1674899618
9198,409000438620',2018-02-27,CR803517123364/RMCPL18551/4,1415.0,0.0,10630479.97999999,2018,2,27,CHECK_WITHDRAWAL,1415.0,C991363637
9199,409000438620',2018-02-27,CR803517123365/RMCPL21201/4,500.0,0.0,10629979.97999999,2018,2,27,CHECK_WITHDRAWAL,500.0,C1254526270
9200,409000438620',2018-02-27,CR803410491893/RMCPL23233/3,4000.0,0.0,10625979.97999999,2018,2,27,DEBIT,4000.0,C1619402333
9201,409000438620',2018-02-27,CR803413589939/RMCPL22602/3,1500.0,0.0,10624479.97999999,2018,2,27,DEBIT,1500.0,C990398217
9202,409000438620',2018-02-27,CR803410491902/RMCPL19701/3,1000.0,0.0,10623479.97999999,2018,2,27,CHECK_WITHDRAWAL,1000.0,C1394526584
9203,409000438620',2018-02-27,CR803417723812/RMCPL17123/3,2000.0,0.0,10621479.97999999,2018,2,27,CHECK_WITHDRAWAL,2000.0,M1340648545
9204,409000438620',2018-02-27,CR803417723693/RMCPL18667/3,10000.0,0.0,10611479.97999999,2018,2,27,CASH_OUT,10000.0,C1069568462
9205,409000438620',2018-02-27,CR803417723816/RMCPL18116/3,500.0,0.0,10610979.97999999,2018,2,27,PAYEMENT,500.0,C1636786811
9206,409000438620',2018-02-27,CR803410491924/RMCPL21784/3,2000.0,0.0,10608979.97999999,2018,2,27,CHECK_WITHDRAWAL,2000.0,M1451851232
9207,409000438620',2018-02-27,CR803417723818/RMCPL14838/3,500.0,0.0,10608479.97999999,2018,2,27,CHECK_WITHDRAWAL,500.0,M734142173
9208,409000438620',2018-02-27,CR803417723731/RMCPL03220/3,500.0,0.0,10607979.97999999,2018,2,27,CHECK_WITHDRAWAL,500.0,M677558982
9209,409000438620',2018-02-27,CR803613441410/RMCPL14220/5,500.0,0.0,10607479.97999999,2018,2,27,CASH_OUT,500.0,M1768580358
9210,409000438620',2018-02-27,CR803613441400/RMCPL14710/5,4000.0,0.0,10603479.97999999,2018,2,27,CASH_OUT,4000.0,C1491676195
9211,409000438620',2018-02-27,CR803613441432/RMCPL23472/5,1000.0,0.0,10602479.97999999,2018,2,27,CASH_OUT,1000.0,C225852166
9212,409000438620',2018-02-27,CR803613441445/RMCPL22482/5,2000.0,0.0,10600479.97999999,2018,2,27,DEBIT,2000.0,M1773418151
9213,409000438620',2018-02-27,CR804416214273/RMCPL20863/1,500.0,0.0,10599979.97999999,2018,2,27,CHECK_WITHDRAWAL,500.0,M489334328
9214,409000438620',2018-02-27,CR804410995930/RMCPL13980/1,6000.0,0.0,10593979.97999999,2018,2,27,DEBIT,6000.0,M1740766363
9215,409000438620',2018-02-27,CR805012771691/RMCPL24063/1,4000.0,0.0,10589979.97999999,2018,2,27,CHECK_WITHDRAWAL,4000.0,M413481120
9216,409000438620',2018-02-27,CR805012771658/RMCPL21490/1,2000.0,0.0,10587979.97999999,2018,2,27,PAYEMENT,2000.0,M406742184
9217,409000438620',2018-02-27,CR805012771680/RMCPL17641/1,2020.0,0.0,10585959.97999999,2018,2,27,CASH_OUT,2020.0,M1266968258
9218,409000438620',2018-02-27,CR805012771575/RMCPL15709/1,2000.0,0.0,10583959.97999999,2018,2,27,DEBIT,2000.0,M1270140044
9219,409000438620',2018-02-27,CR805012771702/RMCPL19509/1,8000.0,0.0,10575959.97999999,2018,2,27,CHECK_WITHDRAWAL,8000.0,M1893760760
9220,409000438620',2018-02-27,CR805012771672/RMCPL16290/1,1000.0,0.0,10574959.97999999,2018,2,27,PAYEMENT,1000.0,M447105432
9221,409000438620',2018-02-27,AEPS ACQ REP ADJ FEES 260,0.0,79.65,10575039.62999999,2018,2,27,TRANSFER,79.65,M620750931
9222,409000438620',2018-02-27,AEPS Indiaforensic INCOME 260218,0.0,195171.68,10770211.30999999,2018,2,27,TRANSFER,195171.68,M584203303
9223,409000438620',2018-02-27,AEPS Indiaforensic GST 260218,0.0,35130.9,10805342.20999999,2018,2,27,CASH_IN,35130.9,M1962762160
9224,409000438620',2018-02-27,TRF TO  Indiaforensic SERVICES I,10700000.0,0.0,105342.20999998973,2018,2,27,PAYEMENT,10700000.0,M1335288964
9225,409000438620',2018-02-28,Indiaforensic AEPS NPCI WDL SET,0.0,50159903.0,50265245.20999999,2018,2,28,CHECK_CASHING,50159903.0,C490766432
9226,409000438620',2018-02-28,Indiaforensic AEPS NPCI DEP SET,36864001.0,0.0,13401244.209999992,2018,2,28,DEBIT,36864001.0,M1759937900
9227,409000438620',2018-02-28,CB805013792329/RMCPL22875/1,4000.0,0.0,13397244.209999992,2018,2,28,PAYEMENT,4000.0,M36420582
9228,409000438620',2018-02-28,CB805013792756/RMCPL20049/1,1500.0,0.0,13395744.209999992,2018,2,28,PAYEMENT,1500.0,M604791405
9229,409000438620',2018-02-28,CB805013792838/RMCPL18013/1,1000.0,0.0,13394744.209999992,2018,2,28,CASH_OUT,1000.0,M210575547
9230,409000438620',2018-02-28,CB805013792856/RMCPL22316/1,4000.0,0.0,13390744.209999992,2018,2,28,DEBIT,4000.0,M1509255314
9231,409000438620',2018-02-28,CB805013793071/RMCPL14536/1,1000.0,0.0,13389744.209999992,2018,2,28,PAYEMENT,1000.0,C1137350304
9232,409000438620',2018-02-28,CB805014806556/RMCPL16840/1,2020.0,0.0,13387724.209999992,2018,2,28,CASH_OUT,2020.0,M677077995
9233,409000438620',2018-02-28,CB805014806568/RMCPL18141/1,1000.0,0.0,13386724.209999992,2018,2,28,CASH_OUT,1000.0,M531145975
9234,409000438620',2018-02-28,CB805014806738/RMCPL13078/1,1000.0,0.0,13385724.209999992,2018,2,28,PAYEMENT,1000.0,M670491331
9235,409000438620',2018-02-28,CB805014806792/RMCPL23126/1,500.0,0.0,13385224.209999992,2018,2,28,CHECK_WITHDRAWAL,500.0,M1717336482
9236,409000438620',2018-02-28,CB805014806796/RMCPL12946/1,10000.0,0.0,13375224.209999992,2018,2,28,PAYEMENT,10000.0,M780753611
9237,409000438620',2018-02-28,CB805014806871/RMCPL18093/1,5000.0,0.0,13370224.209999992,2018,2,28,CHECK_WITHDRAWAL,5000.0,M1485432471
9238,409000438620',2018-02-28,CB805014807056/RMCPL14712/1,10000.0,0.0,13360224.209999992,2018,2,28,PAYEMENT,10000.0,M1208371802
9239,409000438620',2018-02-28,CB805014807178/RMCPL23380/1,3000.0,0.0,13357224.209999992,2018,2,28,CASH_OUT,3000.0,M1781227569
9240,409000438620',2018-02-28,CB805013786938/RMCPL22051/1,10000.0,0.0,13347224.209999992,2018,2,28,CASH_OUT,10000.0,M1416407514
9241,409000438620',2018-02-28,CB805013787091/RMCPL22560/1,8500.0,0.0,13338724.209999992,2018,2,28,CASH_OUT,8500.0,C373928166
9242,409000438620',2018-02-28,CB805013788040/RMCPL18488/1,1000.0,0.0,13337724.209999992,2018,2,28,CASH_OUT,1000.0,M697106057
9243,409000438620',2018-02-28,CB805013788140/RMCPL23986/1,1000.0,0.0,13336724.209999992,2018,2,28,PAYEMENT,1000.0,C1714823857
9244,409000438620',2018-02-28,CB805013788951/RMCPL21223/1,2500.0,0.0,13334224.209999992,2018,2,28,DEBIT,2500.0,M2002285602
9245,409000438620',2018-02-28,CB805013788992/RMCPL12832/1,2000.0,0.0,13332224.209999992,2018,2,28,CASH_OUT,2000.0,M1553257656
9246,409000438620',2018-02-28,CB805013789250/RMCPL20457/1,5000.0,0.0,13327224.209999992,2018,2,28,CASH_OUT,5000.0,M814583272
9247,409000438620',2018-02-28,CB805013784433/RMCPL17634/1,6000.0,0.0,13321224.209999992,2018,2,28,CASH_OUT,6000.0,M113474614
9248,409000438620',2018-02-28,CB805013784511/RMCPL15834/1,3000.0,0.0,13318224.209999992,2018,2,28,CASH_OUT,3000.0,C1721246982
9249,409000438620',2018-02-28,CB805013784513/RMCPL12946/1,3000.0,0.0,13315224.209999992,2018,2,28,CASH_OUT,3000.0,C1554540309
9250,409000438620',2018-02-28,CB805013784524/RMCPL13111/1,2000.0,0.0,13313224.209999992,2018,2,28,PAYEMENT,2000.0,C1554565380
9251,409000438620',2018-02-28,CB805013784525/RMCPL23967/1,1000.0,0.0,13312224.209999992,2018,2,28,DEBIT,1000.0,C1334973394
9252,409000438620',2018-02-28,TRF TO  Indiaforensic SERVICES I,13300000.0,0.0,12224.209999993445,2018,2,28,CASH_OUT,13300000.0,C1850180796
9253,409000438620',2018-02-28,AEPS Indiaforensic INCOME 270218,0.0,211209.92,223434.12999999343,2018,2,28,TRANSFER,211209.92,C1899073220
9254,409000438620',2018-02-28,AEPS Indiaforensic GST 270218,0.0,38017.79,261451.91999999344,2018,2,28,CHECK_CASHING,38017.79,C1495761010
9255,409000438620',2018-03-01,Indiaforensic AEPS NPCI WDL SET,0.0,55082193.0,55343644.92,2018,3,1,TRANSFER,55082193.0,C853932876
9256,409000438620',2018-03-01,Indiaforensic AEPS NPCI DEP SET,42051154.0,0.0,13292490.919999994,2018,3,1,CASH_OUT,42051154.0,C863811613
9257,409000438620',2018-03-01,TRF TO  Indiaforensic SERVICES I,13200000.0,0.0,92490.91999999434,2018,3,1,CHECK_WITHDRAWAL,13200000.0,C1789550256
9258,409000438620',2018-03-01,AEPS ACQUIRING ADJ FEES 2,91.45,0.0,92399.46999999434,2018,3,1,CHECK_WITHDRAWAL,91.45,C343534938
9259,409000438620',2018-03-01,AEPS ACQREP ADJ FEES 2802,0.0,17.7,92417.16999999434,2018,3,1,CASH_IN,17.7,C313142474
9260,409000438620',2018-03-01,AEPS Indiaforensic INCOME 280218,0.0,234235.7,326652.86999999435,2018,3,1,TRANSFER,234235.7,C465499079
9261,409000438620',2018-03-01,AEPS Indiaforensic GST 280218,0.0,42162.43,368815.2999999944,2018,3,1,CASH_IN,42162.43,C985934102
9262,409000438620',2018-03-03,Indiaforensic AEPS NPCI WDL SET,0.0,51740260.0,52109075.3,2018,3,3,TRANSFER,51740260.0,M1941584971
9263,409000438620',2018-03-03,Indiaforensic AEPS NPCI WDL SET,0.0,15529786.0,67638861.3,2018,3,3,TRANSFER,15529786.0,M2051119589
9264,409000438620',2018-03-03,Indiaforensic AEPS NPCI DEP SET,38188836.0,0.0,29450025.3,2018,3,3,DEBIT,38188836.0,M1293905436
9265,409000438620',2018-03-03,Indiaforensic AEPS NPCI DEP SET,19234605.0,0.0,10215420.299999997,2018,3,3,CHECK_WITHDRAWAL,19234605.0,M1120531149
9266,409000438620',2018-03-03,TRF TO  Indiaforensic SERVICES I,5000000.0,0.0,5215420.299999997,2018,3,3,CHECK_WITHDRAWAL,5000000.0,M835594012
9267,409000438620',2018-03-03,TRF TO  Indiaforensic SERVICES I,2000000.0,0.0,3215420.299999997,2018,3,3,PAYEMENT,2000000.0,M105885501
9268,409000438620',2018-03-03,TRF TO  Indiaforensic SERVICES I,3000000.0,0.0,215420.29999999702,2018,3,3,CHECK_WITHDRAWAL,3000000.0,M2145651615
9269,409000438620',2018-03-03,AEPS ACQUIRING ADJ FEES 0,17.7,0.0,215402.59999999686,2018,3,3,CHECK_WITHDRAWAL,17.7,M1686929611
9270,409000438620',2018-03-03,AEPS ACQ GF ADJ FEES 0103,17.7,0.0,215384.899999997,2018,3,3,PAYEMENT,17.7,C1832580921
9271,409000438620',2018-03-03,AEPS Indiaforensic INCOME 010318,0.0,218918.18,434303.07999999705,2018,3,3,CASH_IN,218918.18,M96061258
9272,409000438620',2018-03-03,AEPS Indiaforensic GST 010318,0.0,39405.27,473708.349999997,2018,3,3,CASH_IN,39405.27,M620415815
9273,409000438620',2018-03-03,AEPS Indiaforensic INCOME 020318,0.0,84161.57,557869.919999997,2018,3,3,CASH_IN,84161.57,M728286619
9274,409000438620',2018-03-03,AEPS Indiaforensic GST 020318,0.0,15149.08,573018.999999997,2018,3,3,TRANSFER,15149.08,M1077898244
9275,409000438620',2018-03-05,Indiaforensic AEPS NPCI WDL SET,0.0,34865811.0,35438830.0,2018,3,5,CHECK_CASHING,34865811.0,M1270529736
9276,409000438620',2018-03-05,Indiaforensic AEPS NPCI WDL SET,0.0,29068134.0,64506964.0,2018,3,5,CASH_IN,29068134.0,M724030931
9277,409000438620',2018-03-05,Indiaforensic AEPS NPCI DEP SET,31982928.0,0.0,32524036.0,2018,3,5,CASH_OUT,31982928.0,M214170716
9278,409000438620',2018-03-05,Indiaforensic AEPS NPCI DEP SET,24739883.0,0.0,7784153.0,2018,3,5,PAYEMENT,24739883.0,C1206868531
9279,409000438620',2018-03-05,TRF TO  Indiaforensic SERVICES I,7700000.0,0.0,84153.0,2018,3,5,CHECK_WITHDRAWAL,7700000.0,M266267666
9280,409000438620',2018-03-05,AEPS Indiaforensic INCOME 030318,0.0,161748.59,245901.59,2018,3,5,CASH_IN,161748.59,C1359484306
9281,409000438620',2018-03-05,AEPS Indiaforensic GST 030318,0.0,29114.75,275016.34,2018,3,5,CASH_IN,29114.75,M1873149031
9282,409000438620',2018-03-05,AEPS Indiaforensic INCOME 040318,0.0,134285.23,409301.57,2018,3,5,CHECK_CASHING,134285.23,M1844498480
9283,409000438620',2018-03-05,AEPS Indiaforensic GST 040318,0.0,24171.34,433472.91,2018,3,5,CASH_IN,24171.34,M1941379381
9284,409000438620',2018-03-06,Indiaforensic AEPS NPCI WDL SET,0.0,37731963.0,38165435.91,2018,3,6,CASH_IN,37731963.0,C612008977
9285,409000438620',2018-03-06,Indiaforensic AEPS NPCI DEP SET,29069155.0,0.0,9096280.909999996,2018,3,6,PAYEMENT,29069155.0,C380242442
9286,409000438620',2018-03-06,TRF TO  Indiaforensic SERVICES I,9000000.0,0.0,96280.90999999642,2018,3,6,CASH_OUT,9000000.0,M1653282104
9287,409000438620',2018-03-06,AEPS Indiaforensic INCOME 050318,0.0,160951.67,257232.57999999644,2018,3,6,CHECK_CASHING,160951.67,M1490885900
9288,409000438620',2018-03-06,AEPS Indiaforensic GST 050318,0.0,28971.3,286203.87999999645,2018,3,6,TRANSFER,28971.3,M1037612046
9289,409000438620',2018-03-07,Indiaforensic AEPS NPCI WDL SET,0.0,47868779.0,48154982.88,2018,3,7,CASH_IN,47868779.0,M1896132887
9290,409000438620',2018-03-07,Indiaforensic AEPS NPCI DEP SET,38500521.0,0.0,9654461.879999997,2018,3,7,DEBIT,38500521.0,M215600758
9291,409000438620',2018-03-07,TRF TO  Indiaforensic SERVICES I,9600000.0,0.0,54461.87999999523,2018,3,7,DEBIT,9600000.0,M373590055
9292,409000438620',2018-03-07,AEPS ACQREP ADJ FEES 0603,0.0,17.7,54479.57999999524,2018,3,7,CASH_IN,17.7,M1806382908
9293,409000438620',2018-03-07,AEPS Indiaforensic INCOME 060318,0.0,204621.76,259101.3399999952,2018,3,7,TRANSFER,204621.76,M2072605782
9294,409000438620',2018-03-07,AEPS Indiaforensic GST 060318,0.0,36831.92,295933.25999999524,2018,3,7,CASH_IN,36831.92,C1313534832
9295,409000438620',2018-03-08,Indiaforensic AEPS NPCI WDL SET,0.0,41676252.0,41972185.26,2018,3,8,CHECK_CASHING,41676252.0,C1207178960
9296,409000438620',2018-03-08,CB805703035238/RPT05230/2,10000.0,0.0,41962185.26,2018,3,8,PAYEMENT,10000.0,M1882274571
9297,409000438620',2018-03-08,CB805703035238/RPT05230/2,2500.0,0.0,41959685.26,2018,3,8,DEBIT,2500.0,M1145512119
9298,409000438620',2018-03-08,CB805703035238/RPT05230/2,5000.0,0.0,41954685.26,2018,3,8,CHECK_WITHDRAWAL,5000.0,M730815140
9299,409000438620',2018-03-08,CB805703035238/RPT05230/2,500.0,0.0,41954185.26,2018,3,8,CHECK_WITHDRAWAL,500.0,M3244883
9300,409000438620',2018-03-08,CB805703035238/RPT05230/2,1500.0,0.0,41952685.26,2018,3,8,CHECK_WITHDRAWAL,1500.0,C1019670582
9301,409000438620',2018-03-08,CB805703035238/RPT05230/2,500.0,0.0,41952185.26,2018,3,8,CASH_OUT,500.0,C419414024
9302,409000438620',2018-03-08,CB805703035238/RPT05230/2,500.0,0.0,41951685.26,2018,3,8,PAYEMENT,500.0,C40075281
9303,409000438620',2018-03-08,CB805703035238/RPT05230/2,2000.0,0.0,41949685.26,2018,3,8,PAYEMENT,2000.0,C631424220
9304,409000438620',2018-03-08,CB805703035238/RPT05230/2,500.0,0.0,41949185.26,2018,3,8,PAYEMENT,500.0,C787033725
9305,409000438620',2018-03-08,CB805703035238/RPT05230/2,500.0,0.0,41948685.26,2018,3,8,CASH_OUT,500.0,C122086708
9306,409000438620',2018-03-08,CB805703035238/RPT05230/2,1000.0,0.0,41947685.26,2018,3,8,CASH_OUT,1000.0,C508000580
9307,409000438620',2018-03-08,Indiaforensic AEPS NPCI DEP SET,36972568.0,0.0,4975117.259999998,2018,3,8,PAYEMENT,36972568.0,C2016282692
9308,409000438620',2018-03-08,TRF TO  Indiaforensic SERVICES I,4900000.0,0.0,75117.25999999791,2018,3,8,CHECK_WITHDRAWAL,4900000.0,C1816757085
9309,409000438620',2018-03-08,AEPS ACQUIRING ADJ FEES 0,35.4,0.0,75081.85999999793,2018,3,8,PAYEMENT,35.4,M1978865375
9310,409000438620',2018-03-08,AEPS Indiaforensic INCOME 070318,0.0,185323.02,260404.87999999788,2018,3,8,CHECK_CASHING,185323.02,C1671179293
9311,409000438620',2018-03-08,AEPS Indiaforensic GST 070318,0.0,33358.14,293763.01999999786,2018,3,8,TRANSFER,33358.14,M552085610
9312,409000438620',2018-03-09,Indiaforensic AEPS NPCI WDL SET,0.0,43617351.0,43911114.02,2018,3,9,CHECK_CASHING,43617351.0,M1793414776
9313,409000438620',2018-03-09,Indiaforensic AEPS NPCI DEP SET,37204424.0,0.0,6706690.019999996,2018,3,9,CASH_OUT,37204424.0,M705531384
9314,409000438620',2018-03-09,TRF TO  Indiaforensic SERVICES I,6700000.0,0.0,6690.019999995828,2018,3,9,CASH_OUT,6700000.0,M589863377
9315,409000438620',2018-03-09,AEPS ACQUIRING ADJ FEES 0,17.7,0.0,6672.319999995828,2018,3,9,CASH_OUT,17.7,M335938576
9316,409000438620',2018-03-09,AEPS ACQREP ADJ FEES 0803,0.0,35.4,6707.7199999958275,2018,3,9,TRANSFER,35.4,M1644322989
9317,409000438620',2018-03-09,AEPS Indiaforensic INCOME 080318,0.0,192106.94,198814.65999999587,2018,3,9,CASH_IN,192106.94,M91147932
9318,409000438620',2018-03-09,AEPS Indiaforensic GST 080318,0.0,34579.25,233393.9099999959,2018,3,9,CASH_IN,34579.25,C1440325059
9319,409000438620',2018-03-12,Indiaforensic AEPS NPCI WDL SET,0.0,45067199.0,45300592.91,2018,3,12,CHECK_CASHING,45067199.0,M794026109
9320,409000438620',2018-03-12,Indiaforensic AEPS NPCI DEP SET,37286440.0,0.0,8014152.909999996,2018,3,12,CASH_OUT,37286440.0,M341631013
9321,409000438620',2018-03-12,Indiaforensic AEPS NPCI WDL SET,0.0,40399392.0,48413544.91,2018,3,12,CHECK_CASHING,40399392.0,C1899073220
9322,409000438620',2018-03-12,Indiaforensic AEPS NPCI WDL SET,0.0,28450812.0,76864356.91,2018,3,12,TRANSFER,28450812.0,C1477979030
9323,409000438620',2018-03-12,Indiaforensic AEPS NPCI DEP SET,31029586.0,0.0,45834770.91,2018,3,12,PAYEMENT,31029586.0,C634440506
9324,409000438620',2018-03-12,Indiaforensic AEPS NPCI DEP SET,26658561.0,0.0,19176209.91,2018,3,12,CASH_OUT,26658561.0,C453211571
9325,409000438620',2018-03-12,TRF TO  Indiaforensic SERVICES I,15000000.0,0.0,4176209.909999997,2018,3,12,CHECK_WITHDRAWAL,15000000.0,C801142660
9326,409000438620',2018-03-12,TRF TO  Indiaforensic SERVICES I,4000000.0,0.0,176209.9099999964,2018,3,12,CASH_OUT,4000000.0,C1615804266
9327,409000438620',2018-03-12,AEPS Indiaforensic INCOME 090318,0.0,197281.76,373491.66999999643,2018,3,12,TRANSFER,197281.76,C1100439041
9328,409000438620',2018-03-12,AEPS Indiaforensic GST 090318,0.0,35510.72,409002.3899999964,2018,3,12,TRANSFER,35510.72,C125722707
9329,409000438620',2018-03-13,Indiaforensic AEPS NPCI WDL SET,0.0,43179311.0,43588313.38999999,2018,3,13,TRANSFER,43179311.0,C1822045793
9330,409000438620',2018-03-13,Indiaforensic AEPS NPCI DEP SET,32297603.0,0.0,11290710.389999993,2018,3,13,CHECK_WITHDRAWAL,32297603.0,C408553489
9331,409000438620',2018-03-13,TRF TO  Indiaforensic SERVICES I,11200000.0,0.0,90710.38999999316,2018,3,13,DEBIT,11200000.0,C517653428
9332,409000438620',2018-03-13,AEPS ACQ REP ADJ FEES 120,0.0,17.7,90728.08999999314,2018,3,13,TRANSFER,17.7,C944455655
9333,409000438620',2018-03-13,AEPS Indiaforensic INCOME 120318,0.0,181794.98,272523.06999999314,2018,3,13,CASH_IN,181794.98,C769342184
9334,409000438620',2018-03-13,AEPS Indiaforensic GST 120318,0.0,32723.1,305246.16999999306,2018,3,13,TRANSFER,32723.1,C766681183
9335,409000438620',2018-03-14,Indiaforensic AEPS NPCI WDL SET,0.0,37372930.0,37678176.17,2018,3,14,CASH_IN,37372930.0,C2063763486
9336,409000438620',2018-03-14,Indiaforensic AEPS NPCI DEP SET,30070521.0,0.0,7607655.1699999925,2018,3,14,DEBIT,30070521.0,C2052185144
9337,409000438620',2018-03-14,AEPS Indiaforensic INCOME 100318,0.0,173095.79,7780750.9599999925,2018,3,14,CHECK_CASHING,173095.79,C170899621
9338,409000438620',2018-03-14,AEPS Indiaforensic GST 100318,0.0,31157.24,7811908.199999995,2018,3,14,CHECK_CASHING,31157.24,C1554540309
9339,409000438620',2018-03-14,AEPS Indiaforensic INCOME 110318,0.0,134579.7,7946487.899999995,2018,3,14,TRANSFER,134579.7,C590842329
9340,409000438620',2018-03-14,AEPS Indiaforensic GST 110318,0.0,24224.35,7970712.2499999935,2018,3,14,CHECK_CASHING,24224.35,C1846735756
9341,409000438620',2018-03-14,TRF TO  Indiaforensic SERVICES I,7600000.0,0.0,370712.24999999435,2018,3,14,CHECK_WITHDRAWAL,7600000.0,C1825992554
9342,409000438620',2018-03-14,AEPS ACQUIRING ADJ FEES 1,88.5,0.0,370623.74999999435,2018,3,14,CASH_OUT,88.5,M962126152
9343,409000438620',2018-03-14,AEPS Indiaforensic INCOME 130318,0.0,158094.7,528718.4499999944,2018,3,14,CHECK_CASHING,158094.7,C146305349
9344,409000438620',2018-03-14,AEPS Indiaforensic GST 130318,0.0,28457.05,557175.4999999944,2018,3,14,CHECK_CASHING,28457.05,M1405108810
9345,409000438620',2018-03-15,Indiaforensic AEPS NPCI WDL SET,0.0,46709286.0,47266461.49999999,2018,3,15,CASH_IN,46709286.0,M1082789522
9346,409000438620',2018-03-15,Indiaforensic AEPS NPCI DEP SET,39549547.0,0.0,7716914.499999993,2018,3,15,DEBIT,39549547.0,M2090535958
9347,409000438620',2018-03-15,TRF TO  Indiaforensic SERVICES I,7700000.0,0.0,16914.49999999255,2018,3,15,PAYEMENT,7700000.0,M605004973
9348,409000438620',2018-03-15,AEPS Indiaforensic INCOME 140318,0.0,202910.0,219824.49999999255,2018,3,15,CHECK_CASHING,202910.0,M1802274860
9349,409000438620',2018-03-15,AEPS Indiaforensic GST 140318,0.0,36523.8,256348.2999999925,2018,3,15,CASH_IN,36523.8,M148222723
9350,409000438620',2018-03-15,AEPS ACQUIRING ADJ FEES 1,17.71,0.0,256330.5899999925,2018,3,15,CHECK_WITHDRAWAL,17.71,M1453763291
9351,409000438620',2018-03-16,Indiaforensic AEPS NPCI WDL SET,0.0,41581722.0,41838052.59,2018,3,16,CASH_IN,41581722.0,M275903405
9352,409000438620',2018-03-16,Indiaforensic AEPS NPCI DEP SET,36058966.0,0.0,5779086.589999996,2018,3,16,DEBIT,36058966.0,C482950564
9353,409000438620',2018-03-16,TRF TO  Indiaforensic SERVICES I,5700000.0,0.0,79086.58999999613,2018,3,16,CHECK_WITHDRAWAL,5700000.0,M1950642510
9354,409000438620',2018-03-16,AEPS ACQUIRING ADJ FEES 1,53.09,0.0,79033.49999999613,2018,3,16,CHECK_WITHDRAWAL,53.09,M2009180110
9355,409000438620',2018-03-16,AEPS ACQ GF ADJ FEES 1503,17.7,0.0,79015.79999999612,2018,3,16,DEBIT,17.7,M1128092982
9356,409000438620',2018-03-16,GF732317971954/RMCPL16584/1,10000.0,0.0,69015.79999999612,2018,3,16,DEBIT,10000.0,M1788579635
9357,409000438620',2018-03-16,AEPS ACQ REP ADJ FEES 150,0.0,106.2,69121.99999999613,2018,3,16,TRANSFER,106.2,M1937107943
9358,409000438620',2018-03-16,AEPS Indiaforensic INCOME 150318,0.0,182929.57,252051.5699999961,2018,3,16,CHECK_CASHING,182929.57,M544430253
9359,409000438620',2018-03-16,AEPS Indiaforensic GST 150318,0.0,32927.32,284978.8899999961,2018,3,16,CHECK_CASHING,32927.32,C265845794
9360,409000438620',2018-03-17,Indiaforensic AEPS NPCI WDL SET,0.0,42154001.0,42438979.88999999,2018,3,17,CASH_IN,42154001.0,C1931283804
9361,409000438620',2018-03-17,Indiaforensic AEPS NPCI DEP SET,36956367.0,0.0,5482612.889999993,2018,3,17,DEBIT,36956367.0,C619120762
9362,409000438620',2018-03-17,TRF TO  Indiaforensic SERVICES I,5000000.0,0.0,482612.8899999932,2018,3,17,PAYEMENT,5000000.0,C1816757085
9363,409000438620',2018-03-17,AEPS ACQ REP ADJ FEES 140,0.0,35.4,482648.2899999932,2018,3,17,TRANSFER,35.4,C2083562754
9364,409000438620',2018-03-17,AEPS Indiaforensic INCOME 160318,0.0,183299.59,665947.8799999931,2018,3,17,TRANSFER,183299.59,C1233454027
9365,409000438620',2018-03-17,AEPS Indiaforensic GST 160318,0.0,32993.93,698941.8099999932,2018,3,17,CASH_IN,32993.93,C885951223
9366,409000438620',2018-03-19,Indiaforensic AEPS NPCI WDL SET,0.0,39474500.0,40173441.81,2018,3,19,CASH_IN,39474500.0,C843467284
9367,409000438620',2018-03-19,Indiaforensic AEPS NPCI WDL SET,0.0,26672000.0,66845441.81,2018,3,19,TRANSFER,26672000.0,C794358930
9368,409000438620',2018-03-19,Indiaforensic AEPS NPCI DEP SET,34373112.0,0.0,32472329.809999995,2018,3,19,CHECK_WITHDRAWAL,34373112.0,C1382394077
9369,409000438620',2018-03-19,Indiaforensic AEPS NPCI DEP SET,24167001.0,0.0,8305328.809999995,2018,3,19,CHECK_WITHDRAWAL,24167001.0,C1255024717
9370,409000438620',2018-03-19,TRF TO  Indiaforensic SERVICES I,4000000.0,0.0,4305328.809999995,2018,3,19,DEBIT,4000000.0,C1933965693
9371,409000438620',2018-03-19,TRF TO  Indiaforensic SERVICES I,4000000.0,0.0,305328.8099999949,2018,3,19,PAYEMENT,4000000.0,C804836251
9372,409000438620',2018-03-19,6070940290159769600,11.8,0.0,305317.0099999949,2018,3,19,PAYEMENT,11.8,C1883840933
9373,409000438620',2018-03-19,AEPS Indiaforensic INCOME 170318,0.0,176395.75,481712.759999995,2018,3,19,CASH_IN,176395.75,C1883840933
9374,409000438620',2018-03-19,AEPS Indiaforensic GST 170318,0.0,31751.24,513463.99999999494,2018,3,19,CASH_IN,31751.24,C2094777811
9375,409000438620',2018-03-19,AEPS Indiaforensic INCOME 180318,0.0,125271.67,638735.6699999949,2018,3,19,CASH_IN,125271.67,C1789550256
9376,409000438620',2018-03-19,AEPS Indiaforensic GST 180318,0.0,22548.9,661284.569999995,2018,3,19,CASH_IN,22548.9,C1360767589
9377,409000438620',2018-03-20,Indiaforensic AEPS NPCI WDL SET,0.0,44626000.0,45287284.56999999,2018,3,20,CASH_IN,44626000.0,C2083562754
9378,409000438620',2018-03-20,Indiaforensic AEPS NPCI DEP SET,33290496.0,0.0,11996788.569999993,2018,3,20,PAYEMENT,33290496.0,C555334025
9379,409000438620',2018-03-20,TRF TO  Indiaforensic SERVICES I,11900000.0,0.0,96788.56999999283,2018,3,20,PAYEMENT,11900000.0,C296121376
9380,409000438620',2018-03-20,AEPS ACQUIRING ADJ FEES 1,47.2,0.0,96741.36999999284,2018,3,20,CASH_OUT,47.2,C122086708
9381,409000438620',2018-03-20,AEPS Indiaforensic INCOME 190318,0.0,188170.13,284911.49999999284,2018,3,20,CASH_IN,188170.13,C1359953204
9382,409000438620',2018-03-20,AEPS Indiaforensic GST 190318,0.0,33870.62,318782.11999999284,2018,3,20,CASH_IN,33870.62,C571435580
9383,409000438620',2018-03-21,Indiaforensic AEPS NPCI WDL SET,0.0,41395000.0,41713782.11999999,2018,3,21,CASH_IN,41395000.0,C114618982
9384,409000438620',2018-03-21,Indiaforensic AEPS NPCI DEP SET,36515472.0,0.0,5198310.11999999,2018,3,21,DEBIT,36515472.0,C1013700132
9385,409000438620',2018-03-21,TRF TO  Indiaforensic SERVICES I,5100000.0,0.0,98310.11999998988,2018,3,21,DEBIT,5100000.0,C886517510
9386,409000438620',2018-03-21,AEPS Indiaforensic INCOME 200318,0.0,186017.44,284327.55999998987,2018,3,21,TRANSFER,186017.44,C373928166
9387,409000438620',2018-03-21,AEPS Indiaforensic GST 200318,0.0,33483.14,317810.6999999899,2018,3,21,CASH_IN,33483.14,C466505482
9388,409000438620',2018-03-21,AEPS ACQUIRING ADJ FEES 2,11.8,0.0,317798.8999999899,2018,3,21,PAYEMENT,11.8,C631424220
9389,409000438620',2018-03-21,AEPS ACQ REP ADJ FEES 200,0.0,29.5,317828.3999999899,2018,3,21,CASH_IN,29.5,C665576141
9390,409000438620',2018-03-22,Indiaforensic AEPS NPCI WDL SET,0.0,41773000.0,42090828.39999999,2018,3,22,TRANSFER,41773000.0,C426077729
9391,409000438620',2018-03-22,Indiaforensic AEPS NPCI DEP SET,34898540.0,0.0,7192288.399999991,2018,3,22,CHECK_WITHDRAWAL,34898540.0,C1427067435
9392,409000438620',2018-03-22,TRF TO  Indiaforensic SERVICES I,7100000.0,0.0,92288.39999999106,2018,3,22,DEBIT,7100000.0,C1477979030
9393,409000438620',2018-03-22,AEPS ACQ REP ADJ FEES 210,0.0,23.6,92311.99999999108,2018,3,22,CASH_IN,23.6,C875761527
9394,409000438620',2018-03-22,AEPS Indiaforensic INCOME 210318,0.0,184420.93,276732.9299999911,2018,3,22,CASH_IN,184420.93,C40075281
9395,409000438620',2018-03-22,AEPS Indiaforensic GST 210318,0.0,33195.77,309928.6999999911,2018,3,22,TRANSFER,33195.77,C81639848
9396,409000438620',2018-03-23,Indiaforensic AEPS NPCI WDL SET,0.0,40965000.0,41274928.69999999,2018,3,23,CASH_IN,40965000.0,C878506901
9397,409000438620',2018-03-23,Indiaforensic AEPS NPCI DEP SET,35420578.0,0.0,5854350.699999987,2018,3,23,PAYEMENT,35420578.0,C405881980
9398,409000438620',2018-03-23,TRF TO  Indiaforensic SERVICES I,5800000.0,0.0,54350.699999988086,2018,3,23,CHECK_WITHDRAWAL,5800000.0,C36856762
9399,409000438620',2018-03-23,AEPS Indiaforensic INCOME 220318,0.0,184768.61,239119.3099999881,2018,3,23,TRANSFER,184768.61,C1112414583
9400,409000438620',2018-03-23,AEPS Indiaforensic GST 220318,0.0,33258.35,272377.65999998804,2018,3,23,CHECK_CASHING,33258.35,C1636786811
9401,409000438620',2018-03-23,AEPS ACQUIRING ADJ FEES 2,115.05,0.0,272262.60999998805,2018,3,23,CHECK_WITHDRAWAL,115.05,C931482420
9402,409000438620',2018-03-26,Indiaforensic AEPS NPCI WDL SET,0.0,40808000.0,41080262.60999999,2018,3,26,CHECK_CASHING,40808000.0,C347725669
9403,409000438620',2018-03-26,Indiaforensic AEPS NPCI WDL SET,0.0,32745500.0,73825762.60999998,2018,3,26,TRANSFER,32745500.0,C1266035080
9404,409000438620',2018-03-26,Indiaforensic AEPS NPCI WDL SET,0.0,14313500.0,88139262.60999998,2018,3,26,CASH_IN,14313500.0,C347725669
9405,409000438620',2018-03-26,Indiaforensic AEPS NPCI DEP SET,34056659.0,0.0,54082603.60999999,2018,3,26,CHECK_WITHDRAWAL,34056659.0,C1013700132
9406,409000438620',2018-03-26,CR806210611253/RMCPL14786/0,500.0,0.0,54082103.60999999,2018,3,26,CHECK_WITHDRAWAL,500.0,C1721246982
9407,409000438620',2018-03-26,CR806210611259/RMCPL16428/0,10000.0,0.0,54072103.60999999,2018,3,26,CHECK_WITHDRAWAL,10000.0,C1235151206
9408,409000438620',2018-03-26,CR806210611236/RMCPL17307/0,5000.0,0.0,54067103.60999999,2018,3,26,PAYEMENT,5000.0,C1697258007
9409,409000438620',2018-03-26,CR806210611243/RMCPL18908/0,500.0,0.0,54066603.60999999,2018,3,26,PAYEMENT,500.0,C400720732
9410,409000438620',2018-03-26,CR806210611244/RMCPL22613/0,2600.0,0.0,54064003.60999999,2018,3,26,PAYEMENT,2600.0,C184253187
9411,409000438620',2018-03-26,CR806611158438/RMCPL23196/0,2500.0,0.0,54061503.60999999,2018,3,26,CASH_OUT,2500.0,C1726231784
9412,409000438620',2018-03-26,CR806611158484/RMCPL16118/0,1000.0,0.0,54060503.60999999,2018,3,26,CASH_OUT,1000.0,C935612756
9413,409000438620',2018-03-26,CR806708460925/RMCPL17674/0,2000.0,0.0,54058503.60999999,2018,3,26,DEBIT,2000.0,C75483598
9414,409000438620',2018-03-26,CR806708460927/RMCPL23806/0,10000.0,0.0,54048503.60999999,2018,3,26,DEBIT,10000.0,C1933965693
9415,409000438620',2018-03-26,CR806011889745/RMCPL00125/0,4000.0,0.0,54044503.60999999,2018,3,26,CASH_OUT,4000.0,C1028574311
9416,409000438620',2018-03-26,CR806011889721/RMCPL13972/0,3000.0,0.0,54041503.60999999,2018,3,26,PAYEMENT,3000.0,C2016282692
9417,409000438620',2018-03-26,CR806011889722/RMCPL21897/0,4000.0,0.0,54037503.60999999,2018,3,26,PAYEMENT,4000.0,C451111351
9418,409000438620',2018-03-26,CR806011889716/RMCPL16185/0,5000.0,0.0,54032503.60999999,2018,3,26,CHECK_WITHDRAWAL,5000.0,C2117043942
9419,409000438620',2018-03-26,CR806011889723/RMCPL16858/0,500.0,0.0,54032003.60999999,2018,3,26,CHECK_WITHDRAWAL,500.0,C2016335685
9420,409000438620',2018-03-26,CR805013784370/RMCPL21191/1,5000.0,0.0,54027003.60999999,2018,3,26,CHECK_WITHDRAWAL,5000.0,C1805683209
9421,409000438620',2018-03-26,CR805013784690/RMCPL22173/1,500.0,0.0,54026503.60999999,2018,3,26,CASH_OUT,500.0,C508000580
9422,409000438620',2018-03-26,CR805013784468/RMCPL20001/1,2500.0,0.0,54024003.60999999,2018,3,26,CHECK_WITHDRAWAL,2500.0,C1303868418
9423,409000438620',2018-03-26,CR805013784324/RMCPL20956/1,10000.0,0.0,54014003.60999999,2018,3,26,CHECK_WITHDRAWAL,10000.0,C466505482
9424,409000438620',2018-03-26,CR805013784373/RMCPL20326/1,500.0,0.0,54013503.60999999,2018,3,26,CHECK_WITHDRAWAL,500.0,M567572723
9425,409000438620',2018-03-26,CR805013784355/RMCPL15917/1,100.0,0.0,54013403.60999999,2018,3,26,CASH_OUT,100.0,M434791924
9426,409000438620',2018-03-26,CR807119192029/RMCPL19783/1,1000.0,0.0,54012403.60999999,2018,3,26,CASH_OUT,1000.0,M1064293179
9427,409000438620',2018-03-26,CR807119191914/RMCPL11480/1,1000.0,0.0,54011403.60999999,2018,3,26,PAYEMENT,1000.0,M2127513096
9428,409000438620',2018-03-26,CR807116126055/RMCPL13100/1,1500.0,0.0,54009903.60999999,2018,3,26,PAYEMENT,1500.0,M1945567153
9429,409000438620',2018-03-26,CR807116126028/RMCPL23885/1,5000.0,0.0,54004903.60999999,2018,3,26,CASH_OUT,5000.0,M1107168664
9430,409000438620',2018-03-26,CR807109945500/RMCPL12121/1,1000.0,0.0,54003903.60999999,2018,3,26,CASH_OUT,1000.0,M1072487680
9431,409000438620',2018-03-26,CR807111994177/RMCPL20403/1,2000.0,0.0,54001903.60999999,2018,3,26,DEBIT,2000.0,M1690412910
9432,409000438620',2018-03-26,CR807116126045/RMCPL23091/1,3000.0,0.0,53998903.60999999,2018,3,26,PAYEMENT,3000.0,M1529649769
9433,409000438620',2018-03-26,CR807109945759/RMCPL18525/1,1000.0,0.0,53997903.60999999,2018,3,26,DEBIT,1000.0,M1879769947
9434,409000438620',2018-03-26,CR807110974536/RMCPL00190/1,500.0,0.0,53997403.60999999,2018,3,26,CHECK_WITHDRAWAL,500.0,M1194181141
9435,409000438620',2018-03-26,CR807109947030/RMCPL13750/1,500.0,0.0,53996903.60999999,2018,3,26,CASH_OUT,500.0,M934985972
9436,409000438620',2018-03-26,CR807116126025/RMCPL18012/1,500.0,0.0,53996403.60999999,2018,3,26,PAYEMENT,500.0,M156304703
9437,409000438620',2018-03-26,CR807109946608/RMCPL17823/1,1500.0,0.0,53994903.60999999,2018,3,26,CHECK_WITHDRAWAL,1500.0,M1866841711
9438,409000438620',2018-03-26,CR807119192009/RMCPL15431/1,1000.0,0.0,53993903.60999999,2018,3,26,CASH_OUT,1000.0,C1956477953
9439,409000438620',2018-03-26,CR807109945692/RMCPL21735/1,1000.0,0.0,53992903.60999999,2018,3,26,DEBIT,1000.0,C292665982
9440,409000438620',2018-03-26,CR807214452509/RMCPL14751/1,2000.0,0.0,53990903.60999999,2018,3,26,PAYEMENT,2000.0,C1336996537
9441,409000438620',2018-03-26,CR807214452552/RMCPL15459/1,3000.0,0.0,53987903.60999999,2018,3,26,CHECK_WITHDRAWAL,3000.0,C1626759869
9442,409000438620',2018-03-26,CR807214452502/RMCPL22469/1,1000.0,0.0,53986903.60999999,2018,3,26,DEBIT,1000.0,M780607123
9443,409000438620',2018-03-26,CR807211392934/RMCPL19017/1,3000.0,0.0,53983903.60999999,2018,3,26,CHECK_WITHDRAWAL,3000.0,C128870695
9444,409000438620',2018-03-26,CR807214452553/RMCPL23878/1,1600.0,0.0,53982303.60999999,2018,3,26,CHECK_WITHDRAWAL,1600.0,M578967394
9445,409000438620',2018-03-26,CR807216506754/RMCPL21107/1,500.0,0.0,53981803.60999999,2018,3,26,CHECK_WITHDRAWAL,500.0,M1538784312
9446,409000438620',2018-03-26,CR807211392940/RMCPL23283/1,500.0,0.0,53981303.60999999,2018,3,26,CHECK_WITHDRAWAL,500.0,M400758359
9447,409000438620',2018-03-26,CR807213433369/RMCPL09584/1,10000.0,0.0,53971303.60999999,2018,3,26,CASH_OUT,10000.0,M2056140241
9448,409000438620',2018-03-26,CR807213433385/RMCPL15602/1,1000.0,0.0,53970303.60999999,2018,3,26,DEBIT,1000.0,C1926673338
9449,409000438620',2018-03-26,CR807214452576/RMCPL19319/1,1010.0,0.0,53969293.60999999,2018,3,26,DEBIT,1010.0,M2106220231
9450,409000438620',2018-03-26,CR807216506727/RMCPL21320/1,2000.0,0.0,53967293.60999999,2018,3,26,DEBIT,2000.0,M1501191853
9451,409000438620',2018-03-26,CR807211392907/RMCPL19766/1,2000.0,0.0,53965293.60999999,2018,3,26,PAYEMENT,2000.0,C257999182
9452,409000438620',2018-03-26,CR807216506713/RMCPL14133/1,305.0,0.0,53964988.60999999,2018,3,26,DEBIT,305.0,M1503457997
9453,409000438620',2018-03-26,CR807309712873/RMCPL19696/1,1000.0,0.0,53963988.60999999,2018,3,26,CHECK_WITHDRAWAL,1000.0,M1842714758
9454,409000438620',2018-03-26,CR807311768944/RMCPL11087/1,1000.0,0.0,53962988.60999999,2018,3,26,CASH_OUT,1000.0,M1527980131
9455,409000438620',2018-03-26,CR807309712851/RMCPL18701/1,500.0,0.0,53962488.60999999,2018,3,26,CHECK_WITHDRAWAL,500.0,M172517457
9456,409000438620',2018-03-26,CR807309712861/RMCPL19904/1,510.0,0.0,53961978.60999999,2018,3,26,CHECK_WITHDRAWAL,510.0,M268547125
9457,409000438620',2018-03-26,CR807311768953/RMCPL20016/1,2500.0,0.0,53959478.60999999,2018,3,26,CHECK_WITHDRAWAL,2500.0,M1419194266
9458,409000438620',2018-03-26,CR807313804462/RMCPL24082/1,1000.0,0.0,53958478.60999999,2018,3,26,DEBIT,1000.0,C124540047
9459,409000438620',2018-03-26,CR807311752234/RMCPL19103/1,500.0,0.0,53957978.60999999,2018,3,26,CHECK_WITHDRAWAL,500.0,M1012752603
9460,409000438620',2018-03-26,CR807311752237/RMCPL13039/1,9000.0,0.0,53948978.60999999,2018,3,26,DEBIT,9000.0,M271449893
9461,409000438620',2018-03-26,CR807309712840/RMCPL24395/1,2000.0,0.0,53946978.60999999,2018,3,26,PAYEMENT,2000.0,M1994458484
9462,409000438620',2018-03-26,CR807311752242/RMCPL23609/1,5000.0,0.0,53941978.60999999,2018,3,26,DEBIT,5000.0,M50470449
9463,409000438620',2018-03-26,CR807413186354/RMCPL11361/1,2000.0,0.0,53939978.60999999,2018,3,26,CHECK_WITHDRAWAL,2000.0,C1233454027
9464,409000438620',2018-03-26,CR807412166738/RMCPL22644/1,5000.0,0.0,53934978.60999999,2018,3,26,DEBIT,5000.0,M126560570
9465,409000438620',2018-03-26,CR807415227290/RMCPL20759/1,1500.0,0.0,53933478.60999999,2018,3,26,CASH_OUT,1500.0,M1528194080
9466,409000438620',2018-03-26,CR807415227326/RMCPL17121/1,9000.0,0.0,53924478.60999999,2018,3,26,CHECK_WITHDRAWAL,9000.0,M397262543
9467,409000438620',2018-03-26,CR807413186356/RMCPL20613/1,1000.0,0.0,53923478.60999999,2018,3,26,PAYEMENT,1000.0,M833929219
9468,409000438620',2018-03-26,CR807415227301/RMCPL14380/1,3000.0,0.0,53920478.60999999,2018,3,26,CHECK_WITHDRAWAL,3000.0,M234932558
9469,409000438620',2018-03-26,CR807413186368/RMCPL22022/1,500.0,0.0,53919978.60999999,2018,3,26,DEBIT,500.0,C131837504
9470,409000438620',2018-03-26,CR807413186341/RMCPL21736/1,500.0,0.0,53919478.60999999,2018,3,26,PAYEMENT,500.0,M1653072658
9471,409000438620',2018-03-26,CR807413186350/RMCPL15035/1,3000.0,0.0,53916478.60999999,2018,3,26,DEBIT,3000.0,M206287129
9472,409000438620',2018-03-26,CR807413186340/RMCPL24303/1,1000.0,0.0,53915478.60999999,2018,3,26,PAYEMENT,1000.0,C1467806809
9473,409000438620',2018-03-26,CR807413186370/RMCPL18180/1,3000.0,0.0,53912478.60999999,2018,3,26,CHECK_WITHDRAWAL,3000.0,C1692066743
9474,409000438620',2018-03-26,CR807413186364/RMCPL09580/1,5000.0,0.0,53907478.60999999,2018,3,26,CASH_OUT,5000.0,M674600411
9475,409000438620',2018-03-26,CR807413186346/RMCPL23704/1,2000.0,0.0,53905478.60999999,2018,3,26,CASH_OUT,2000.0,C225852166
9476,409000438620',2018-03-26,CR807415227302/RMCPL20001/1,1500.0,0.0,53903978.60999999,2018,3,26,DEBIT,1500.0,M576407050
9477,409000438620',2018-03-26,CR807410111110/RMCPL12049/1,1000.0,0.0,53902978.60999999,2018,3,26,DEBIT,1000.0,C433115563
9478,409000438620',2018-03-26,CR807415227327/RMCPL20741/1,3000.0,0.0,53899978.60999999,2018,3,26,CASH_OUT,3000.0,M1455940305
9479,409000438620',2018-03-26,CR807410111103/RMCPL21667/1,2000.0,0.0,53897978.60999999,2018,3,26,CHECK_WITHDRAWAL,2000.0,M741658148
9480,409000438620',2018-03-26,CR807512532324/RMCPL23421/1,10000.0,0.0,53887978.60999999,2018,3,26,CASH_OUT,10000.0,M826306219
9481,409000438620',2018-03-26,CR807512532330/RMCPL19173/1,3000.0,0.0,53884978.60999999,2018,3,26,PAYEMENT,3000.0,M838403351
9482,409000438620',2018-03-26,CR807617018294/RMCPL00154/1,500.0,0.0,53884478.60999999,2018,3,26,CASH_OUT,500.0,M501758945
9483,409000438620',2018-03-26,CR807612914711/RMCPL23885/1,5000.0,0.0,53879478.60999999,2018,3,26,CHECK_WITHDRAWAL,5000.0,M1781910735
9484,409000438620',2018-03-26,CR807610858193/RMCPL23283/1,10000.0,0.0,53869478.60999999,2018,3,26,CASH_OUT,10000.0,M1619752179
9485,409000438620',2018-03-26,CR807610858186/RMCPL23230/1,500.0,0.0,53868978.60999999,2018,3,26,DEBIT,500.0,M1517228866
9486,409000438620',2018-03-26,CR807612895432/RMCPL23894/1,1000.0,0.0,53867978.60999999,2018,3,26,PAYEMENT,1000.0,M1587189379
9487,409000438620',2018-03-26,CR807612895471/RMCPL13062/1,9500.0,0.0,53858478.60999999,2018,3,26,CHECK_WITHDRAWAL,9500.0,M626260944
9488,409000438620',2018-03-26,CR807611877597/RMCPL19095/1,500.0,0.0,53857978.60999999,2018,3,26,CHECK_WITHDRAWAL,500.0,M547632296
9489,409000438620',2018-03-26,CR807610858194/RMCPL22560/1,2000.0,0.0,53855978.60999999,2018,3,26,PAYEMENT,2000.0,M1029385246
9490,409000438620',2018-03-26,CR807612895494/RMCPL12563/1,1000.0,0.0,53854978.60999999,2018,3,26,DEBIT,1000.0,M318434010
9491,409000438620',2018-03-26,CR807612895451/RMCPL21641/1,2000.0,0.0,53852978.60999999,2018,3,26,CASH_OUT,2000.0,M402269681
9492,409000438620',2018-03-26,CR807612914691/RMCPL20898/1,5000.0,0.0,53847978.60999999,2018,3,26,PAYEMENT,5000.0,M356904775
9493,409000438620',2018-03-26,CR807612914698/RMCPL23224/1,4000.0,0.0,53843978.60999999,2018,3,26,DEBIT,4000.0,M248295195
9494,409000438620',2018-03-26,CR807612914693/RMCPL13062/1,500.0,0.0,53843478.60999999,2018,3,26,CHECK_WITHDRAWAL,500.0,M122360746
9495,409000438620',2018-03-26,CR807810459599/RMCPL19265/1,3000.0,0.0,53840478.60999999,2018,3,26,DEBIT,3000.0,M1510954343
9496,409000438620',2018-03-26,CR807811476510/RMCPL20241/1,3000.0,0.0,53837478.60999999,2018,3,26,DEBIT,3000.0,M1340508085
9497,409000438620',2018-03-26,CR807809430417/RMCPL19763/1,1500.0,0.0,53835978.60999999,2018,3,26,CASH_OUT,1500.0,M1518735658
9498,409000438620',2018-03-26,CR807809430619/RMCPL23539/1,10000.0,0.0,53825978.60999999,2018,3,26,DEBIT,10000.0,M1227038073
9499,409000438620',2018-03-26,CR807811476549/RMCPL21850/1,2500.0,0.0,53823478.60999999,2018,3,26,CASH_OUT,2500.0,M1335046207
9500,409000438620',2018-03-26,CR807810459603/RMCPL21498/1,2500.0,0.0,53820978.60999999,2018,3,26,CASH_OUT,2500.0,M861479293
9501,409000438620',2018-03-26,CR807809430013/RMCPL16993/1,4000.0,0.0,53816978.60999999,2018,3,26,CASH_OUT,4000.0,M1932190364
9502,409000438620',2018-03-26,TRF TO  Indiaforensic SERVICES I,10000000.0,0.0,43816978.60999999,2018,3,26,PAYEMENT,10000000.0,M1780861357
9503,409000438620',2018-03-26,TRF TO  Indiaforensic SERVICES I,13800000.0,0.0,30016978.609999985,2018,3,26,CHECK_WITHDRAWAL,13800000.0,C1898288372
9504,409000438620',2018-03-26,TRF TO  Indiaforensic SERVICES I,15000000.0,0.0,15016978.609999985,2018,3,26,PAYEMENT,15000000.0,C979778117
9505,409000438620',2018-03-26,TRF TO  Indiaforensic SERVICES I,15000000.0,0.0,16978.609999984503,2018,3,26,CASH_OUT,15000000.0,M607690808
9506,409000438620',2018-03-26,AEPS ACQUIRING ADJ FEES 2,35.4,0.0,16943.209999984498,2018,3,26,CHECK_WITHDRAWAL,35.4,M1359826251
9507,409000438620',2018-03-26,AEPS ACQ CR ADJ FEES 2303,1053.86,0.0,15889.349999984499,2018,3,26,DEBIT,1053.86,M1940612255
9508,409000438620',2018-03-26,AEPS ACQ REP ADJ FEES 230,0.0,97.35,15986.6999999845,2018,3,26,CHECK_CASHING,97.35,M412191417
9509,409000438620',2018-03-26,AEPS ACQ GF REP ADJ FEE 2,0.0,91.45,16078.149999984502,2018,3,26,CHECK_CASHING,91.45,M993194164
9510,409000438620',2018-03-26,GF804612994123/RMCPL22935/1,0.0,10000.0,26078.149999984504,2018,3,26,CHECK_CASHING,10000.0,M1661426385
9511,409000438620',2018-03-26,GF804616087179/RMCPL23260/1,0.0,2500.0,28578.149999984504,2018,3,26,CASH_IN,2500.0,M1941665837
9512,409000438620',2018-03-26,GF803415672053/RMCPL23260/0,0.0,5000.0,33578.149999984504,2018,3,26,CHECK_CASHING,5000.0,M1673228701
9513,409000438620',2018-03-26,GF803811313864/RMCPL21556/0,0.0,500.0,34078.149999984504,2018,3,26,TRANSFER,500.0,C1759482496
9514,409000438620',2018-03-26,GF803914904688/RMCPL00150/0,0.0,1500.0,35578.149999984504,2018,3,26,TRANSFER,1500.0,C12793273
9515,409000438620',2018-03-26,GF805011726109/RMCPL24063/1,0.0,500.0,36078.149999984504,2018,3,26,TRANSFER,500.0,M151060420
9516,409000438620',2018-03-26,GF804413124755/RMCPL20069/1,0.0,500.0,36578.149999984504,2018,3,26,TRANSFER,500.0,M847292314
9517,409000438620',2018-03-26,GF804410003855/RMCPL12343/1,0.0,2000.0,38578.149999984504,2018,3,26,CHECK_CASHING,2000.0,M1997267152
9518,409000438620',2018-03-26,GF804619198621/RMCPL08688/1,0.0,500.0,39078.149999984504,2018,3,26,CHECK_CASHING,500.0,C187019413
9519,409000438620',2018-03-26,GF804412092303/RMCPL17789/1,0.0,500.0,39578.149999984504,2018,3,26,CHECK_CASHING,500.0,C894315519
9520,409000438620',2018-03-26,GF804521780434/RMCPL19703/1,0.0,1000.0,40578.149999984504,2018,3,26,CHECK_CASHING,1000.0,C1085479446
9521,409000438620',2018-03-26,AEPS Indiaforensic INCOME 230318,0.0,180069.5,220647.64999998448,2018,3,26,TRANSFER,180069.5,C2057394816
9522,409000438620',2018-03-26,AEPS Indiaforensic GST 230318,0.0,32412.51,253060.1599999845,2018,3,26,CASH_IN,32412.51,C803116137
9523,409000438620',2018-03-26,AEPS Indiaforensic INCOME 240318,0.0,88386.65,341446.8099999845,2018,3,26,CHECK_CASHING,88386.65,C1609562230
9524,409000438620',2018-03-26,AEPS Indiaforensic GST 240318,0.0,15909.6,357356.40999998455,2018,3,26,CHECK_CASHING,15909.6,C1423992712
9525,409000438620',2018-03-26,AEPS Indiaforensic INCOME 250318,0.0,38628.85,395985.2599999845,2018,3,26,CASH_IN,38628.85,C790722099
9526,409000438620',2018-03-26,AEPS Indiaforensic GST 250318,0.0,6953.19,402938.4499999845,2018,3,26,TRANSFER,6953.19,C1059749024
9527,409000438620',2018-03-27,Indiaforensic AEPS NPCI WDL SET,0.0,21974500.0,22377438.449999984,2018,3,27,CHECK_CASHING,21974500.0,C1059781259
9528,409000438620',2018-03-27,TRF TO  Indiaforensic SERVICES I,15000000.0,0.0,7377438.4499999825,2018,3,27,PAYEMENT,15000000.0,C836514715
9529,409000438620',2018-03-27,TRF TO  Indiaforensic SERVICES I,7000000.0,0.0,377438.44999998435,2018,3,27,DEBIT,7000000.0,C1948471365
9530,409000438620',2018-03-27,AEPS Indiaforensic INCOME 260318,0.0,59507.15,436945.5999999844,2018,3,27,TRANSFER,59507.15,C1671179293
9531,409000438620',2018-03-27,AEPS Indiaforensic GST 260318,0.0,10711.29,447656.88999998436,2018,3,27,TRANSFER,10711.29,C265845794
9532,409000438620',2018-03-28,Indiaforensic AEPS NPCI WDL SET,0.0,22461500.0,22909156.889999986,2018,3,28,CHECK_CASHING,22461500.0,C1670989986
9533,409000438620',2018-03-28,CB806714622893/RMCPL24447/0,10000.0,0.0,22899156.889999986,2018,3,28,PAYEMENT,10000.0,C169904524
9534,409000438620',2018-03-28,CB807111994180/RMCPL22691/1,5000.0,0.0,22894156.889999986,2018,3,28,CASH_OUT,5000.0,C814473635
9535,409000438620',2018-03-28,CB807413186348/RMCPL12580/1,7500.0,0.0,22886656.889999986,2018,3,28,CASH_OUT,7500.0,C1545688642
9536,409000438620',2018-03-28,TRF TO  Indiaforensic SERVICES I,15000000.0,0.0,7886656.889999988,2018,3,28,CHECK_WITHDRAWAL,15000000.0,C1899073220
9537,409000438620',2018-03-28,TRF TO  Indiaforensic SERVICES I,7500000.0,0.0,386656.8899999857,2018,3,28,CASH_OUT,7500000.0,C843467284
9538,409000438620',2018-03-28,MAW/5029649809678170/NAGA,0.0,500.0,387156.8899999857,2018,3,28,CASH_IN,500.0,C935808590
9539,409000438620',2018-03-28,AEPS Indiaforensic INCOME 270318,0.0,60742.75,447899.6399999857,2018,3,28,TRANSFER,60742.75,C384887832
9540,409000438620',2018-03-28,AEPS Indiaforensic GST 270318,0.0,10933.7,458833.3399999857,2018,3,28,CASH_IN,10933.7,C323761934
9541,409000438620',2018-03-28,AEPS ACQUIRING ADJ FEES 2,20.63,0.0,458812.7099999857,2018,3,28,CHECK_WITHDRAWAL,20.63,M1421022166
9542,409000438620',2018-03-28,AEPS ACQ REP ADJ FEES 270,0.0,35.4,458848.1099999857,2018,3,28,CHECK_CASHING,35.4,C1327907419
9543,409000438620',2018-03-29,Indiaforensic AEPS NPCI WDL SET,0.0,22042500.0,22501348.109999985,2018,3,29,CHECK_CASHING,22042500.0,M813611359
9544,409000438620',2018-03-29,AEPS Indiaforensic INCOME 280318,0.0,58842.25,22560190.359999985,2018,3,29,TRANSFER,58842.25,C1671179293
9545,409000438620',2018-03-29,AEPS Indiaforensic GST 280318,0.0,10591.61,22570781.969999984,2018,3,29,CASH_IN,10591.61,M1777016611
9546,409000438620',2018-03-30,FUND TRF TO  Indiaforensic SERVI,15000000.0,0.0,7570781.969999984,2018,3,30,PAYEMENT,15000000.0,M696876463
9547,409000438620',2018-03-30,FUND TRF TO  Indiaforensic SERVI,5000000.0,0.0,2570781.969999984,2018,3,30,DEBIT,5000000.0,M1380336958
9548,409000438620',2018-03-30,FUND TRF TO  Indiaforensic SERVI,2500000.0,0.0,70781.96999998389,2018,3,30,DEBIT,2500000.0,C801142660
9549,409000438620',2018-03-31,Indiaforensic AEPS NPCI WDL SET,0.0,19777500.0,19848281.969999984,2018,3,31,CASH_IN,19777500.0,M39198049
9550,409000438620',2018-03-31,Indiaforensic AEPS NPCI WDL SET,0.0,20281000.0,40129281.969999984,2018,3,31,CHECK_CASHING,20281000.0,C271588719
9551,409000438620',2018-03-31,TRF TO Indiaforensic SERVICES IN,15000000.0,0.0,25129281.969999984,2018,3,31,CASH_OUT,15000000.0,M866796326
9552,409000438620',2018-03-31,TRF TO Indiaforensic SERVICES IN,15000000.0,0.0,10129281.969999984,2018,3,31,CASH_OUT,15000000.0,M770563700
9553,409000438620',2018-03-31,TRF TO Indiaforensic SERVICES IN,10000000.0,0.0,129281.9699999839,2018,3,31,CASH_OUT,10000000.0,M1130368480
9554,409000438620',2018-03-31,AEPS ACQUIRING ADJ FEES 2,79.65,0.0,129202.31999998393,2018,3,31,DEBIT,79.65,M778039764
9555,409000438620',2018-03-31,AEPS ACQ REP ADJ FEES 290,0.0,20.65,129222.9699999839,2018,3,31,CHECK_CASHING,20.65,M1507477906
9556,409000438620',2018-03-31,AEPS Indiaforensic INCOME 290318,0.0,50625.45,179848.41999998392,2018,3,31,TRANSFER,50625.45,M1908591398
9557,409000438620',2018-03-31,AEPS Indiaforensic GST 290318,0.0,9112.58,188960.9999999839,2018,3,31,TRANSFER,9112.58,C872592585
9558,409000438620',2018-03-31,AEPS Indiaforensic INCOME 300318,0.0,52140.15,241101.1499999839,2018,3,31,TRANSFER,52140.15,M1613583383
9559,409000438620',2018-03-31,AEPS Indiaforensic GST 300318,0.0,9385.23,250486.3799999839,2018,3,31,CHECK_CASHING,9385.23,C1825992554
9560,409000438620',2018-04-03,Indiaforensic AEPS NPCI WDL SET,0.0,15327000.0,15577486.379999986,2018,4,3,CASH_IN,15327000.0,M1720624132
9561,409000438620',2018-04-03,NPCI NON RD CHG_AUG17 TO,671091.96,0.0,14906394.419999985,2018,4,3,CASH_OUT,671091.96,M1645253408
9562,409000438620',2018-04-03,NPCI NON RD CHG_AUG17 TO,27.02,0.0,14906367.399999985,2018,4,3,CHECK_WITHDRAWAL,27.02,M661350575
9563,409000438620',2018-04-03,Indiaforensic AEPS NPCI WDL SET,0.0,3425000.0,18331367.399999984,2018,4,3,CASH_IN,3425000.0,M1667637191
9564,409000438620',2018-04-03,Indiaforensic AEPS NPCI WDL SET,0.0,17674000.0,36005367.39999998,2018,4,3,CHECK_CASHING,17674000.0,M423702255
9565,409000438620',2018-04-03,TRF TO  Indiaforensic SERVICES I,15000000.0,0.0,21005367.399999984,2018,4,3,DEBIT,15000000.0,M132158154
9566,409000438620',2018-04-03,TRF TO  Indiaforensic SERVICES I,15000000.0,0.0,6005367.399999984,2018,4,3,DEBIT,15000000.0,M1783567804
9567,409000438620',2018-04-03,TRF TO  Indiaforensic SERVICES I,6000000.0,0.0,5367.399999983609,2018,4,3,PAYEMENT,6000000.0,M1679944167
9568,409000438620',2018-04-03,AEPS ACQUIRING ADJ FEES 0,35.4,0.0,5331.999999983609,2018,4,3,DEBIT,35.4,M1197177197
9569,409000438620',2018-04-03,AEPS ACQUIRING ADJ FEES 3,70.8,0.0,5261.199999983609,2018,4,3,PAYEMENT,70.8,M1774713748
9570,409000438620',2018-04-03,AEPS ACQ CR ADJ FEES 3103,607.7,0.0,4653.499999983609,2018,4,3,CHECK_WITHDRAWAL,607.7,M2076874965
9571,409000438620',2018-04-03,AEPS ACQ REP ADJ FEES 020,0.0,17.7,4671.199999983609,2018,4,3,CHECK_CASHING,17.7,M1030925290
9572,409000438620',2018-04-03,AEPS ACQ REP ADJ FEES 310,0.0,32.45,4703.649999983609,2018,4,3,CASH_IN,32.45,M1172991012
9573,409000438620',2018-04-03,AEPS Indiaforensic INCOME 310318,0.0,41860.2,46563.849999983606,2018,4,3,CHECK_CASHING,41860.2,M2037830530
9574,409000438620',2018-04-03,AEPS Indiaforensic GST 310318,0.0,7534.84,54098.6899999836,2018,4,3,TRANSFER,7534.84,M1341040751
9575,409000438620',2018-04-03,AEPS Indiaforensic INCOME 010418,0.0,9559.3,63657.989999983605,2018,4,3,CHECK_CASHING,9559.3,M1233973724
9576,409000438620',2018-04-03,AEPS Indiaforensic GST 010418,0.0,1720.67,65378.6599999836,2018,4,3,CHECK_CASHING,1720.67,M831253172
9577,409000438620',2018-04-03,AEPS Indiaforensic INCOME 020418,0.0,45153.55,110532.20999998359,2018,4,3,CHECK_CASHING,45153.55,M1468302269
9578,409000438620',2018-04-03,AEPS Indiaforensic GST 020418,0.0,8127.64,118659.84999998359,2018,4,3,TRANSFER,8127.64,M1458893701
9579,409000438620',2018-04-04,MAW/5029649803446863/Akol,0.0,5000.0,123659.84999998359,2018,4,4,TRANSFER,5000.0,M418472732
9580,409000438620',2018-04-04,Indiaforensic AEPS NPCI WDL SET,0.0,26856000.0,26979659.84999999,2018,4,4,TRANSFER,26856000.0,M1924459698
9581,409000438620',2018-04-04,CR807907754349/RMCPL17457/2,2000.0,0.0,26977659.84999999,2018,4,4,DEBIT,2000.0,M1451735609
9582,409000438620',2018-04-04,CR807907754341/RMCPL23284/2,2000.0,0.0,26975659.84999999,2018,4,4,PAYEMENT,2000.0,M1790696670
9583,409000438620',2018-04-04,CR807910808825/RMCPL16254/2,3000.0,0.0,26972659.84999999,2018,4,4,CASH_OUT,3000.0,M705708158
9584,409000438620',2018-04-04,CR807910807697/RMCPL12815/2,2500.0,0.0,26970159.84999999,2018,4,4,PAYEMENT,2500.0,M1513484204
9585,409000438620',2018-04-04,CR807912856826/RMCPL14017/2,2000.0,0.0,26968159.84999999,2018,4,4,CHECK_WITHDRAWAL,2000.0,M1491724370
9586,409000438620',2018-04-04,CR807909790932/RMCPL24499/2,6000.0,0.0,26962159.84999999,2018,4,4,PAYEMENT,6000.0,M664683782
9587,409000438620',2018-04-04,CR807910807693/RMCPL22373/2,1500.0,0.0,26960659.84999999,2018,4,4,CHECK_WITHDRAWAL,1500.0,M1379795356
9588,409000438620',2018-04-04,CR807910807645/RMCPL16561/2,10000.0,0.0,26950659.84999999,2018,4,4,PAYEMENT,10000.0,M1240673227
9589,409000438620',2018-04-04,CR807910807640/RMCPL22746/2,1000.0,0.0,26949659.84999999,2018,4,4,CHECK_WITHDRAWAL,1000.0,M945965626
9590,409000438620',2018-04-04,CR807910807639/RMCPL23650/2,1000.0,0.0,26948659.84999999,2018,4,4,PAYEMENT,1000.0,C347696158
9591,409000438620',2018-04-04,CR807907754359/RMCPL18140/2,500.0,0.0,26948159.84999999,2018,4,4,CASH_OUT,500.0,M2103548875
9592,409000438620',2018-04-04,CR807907754361/RMCPL21477/2,1500.0,0.0,26946659.84999999,2018,4,4,CASH_OUT,1500.0,M1972599192
9593,409000438620',2018-04-04,CR807910807671/RMCPL22518/2,10000.0,0.0,26936659.84999999,2018,4,4,DEBIT,10000.0,M413354443
9594,409000438620',2018-04-04,CR807910808823/RMCPL17432/2,2000.0,0.0,26934659.84999999,2018,4,4,PAYEMENT,2000.0,M1611841256
9595,409000438620',2018-04-04,CR807917963697/RMCPL21759/2,1000.0,0.0,26933659.84999999,2018,4,4,CASH_OUT,1000.0,M1658265745
9596,409000438620',2018-04-04,CR808010151652/RMCPL17491/2,1000.0,0.0,26932659.84999999,2018,4,4,CHECK_WITHDRAWAL,1000.0,M62415796
9597,409000438620',2018-04-04,CR808012214507/RMCPL16659/2,1000.0,0.0,26931659.84999999,2018,4,4,CASH_OUT,1000.0,M2116847138
9598,409000438620',2018-04-04,CR808012214489/RMCPL12832/2,1000.0,0.0,26930659.84999999,2018,4,4,CHECK_WITHDRAWAL,1000.0,C1691272400
9599,409000438620',2018-04-04,CR808010151633/RMCPL19798/2,3000.0,0.0,26927659.84999999,2018,4,4,CHECK_WITHDRAWAL,3000.0,M160189067
9600,409000438620',2018-04-04,CR808012214506/RMCPL14754/2,5000.0,0.0,26922659.84999999,2018,4,4,CASH_OUT,5000.0,M1320590989
9601,409000438620',2018-04-04,CR808012214503/RMCPL13317/2,500.0,0.0,26922159.84999999,2018,4,4,PAYEMENT,500.0,M332317951
9602,409000438620',2018-04-04,CR808111503580/RMCPL23929/2,6000.0,0.0,26916159.84999999,2018,4,4,CHECK_WITHDRAWAL,6000.0,M615535250
9603,409000438620',2018-04-04,CR808112535248/RMCPL20906/2,10000.0,0.0,26906159.84999999,2018,4,4,CASH_OUT,10000.0,M1364863741
9604,409000438620',2018-04-04,CR808112535320/RMCPL22564/2,1000.0,0.0,26905159.84999999,2018,4,4,CHECK_WITHDRAWAL,1000.0,C1439007204
9605,409000438620',2018-04-04,CR808112535290/RMCPL20881/2,5000.0,0.0,26900159.84999999,2018,4,4,CASH_OUT,5000.0,M1840794798
9606,409000438620',2018-04-04,CR808310149875/RMCPL12312/2,1000.0,0.0,26899159.84999999,2018,4,4,DEBIT,1000.0,M850012071
9607,409000438620',2018-04-04,CR808312182983/RMCPL19752/2,10000.0,0.0,26889159.84999999,2018,4,4,PAYEMENT,10000.0,M1938741459
9608,409000438620',2018-04-04,CR808312182971/RMCPL12312/2,1000.0,0.0,26888159.84999999,2018,4,4,CASH_OUT,1000.0,M1367323331
9609,409000438620',2018-04-04,CR808312183001/RMCPL15535/2,1000.0,0.0,26887159.84999999,2018,4,4,DEBIT,1000.0,M1776649574
9610,409000438620',2018-04-04,CR808310149888/RMCPL16723/2,500.0,0.0,26886659.84999999,2018,4,4,PAYEMENT,500.0,C63387985
9611,409000438620',2018-04-04,CR808312182997/RMCPL17670/2,2000.0,0.0,26884659.84999999,2018,4,4,PAYEMENT,2000.0,M102949789
9612,409000438620',2018-04-04,CR808310149857/RMCPL23412/2,5500.0,0.0,26879159.84999999,2018,4,4,CHECK_WITHDRAWAL,5500.0,M1629485709
9613,409000438620',2018-04-04,CR808310149872/RMCPL23263/2,4500.0,0.0,26874659.84999999,2018,4,4,CHECK_WITHDRAWAL,4500.0,M1423709754
9614,409000438620',2018-04-04,CR808311166486/RMCPL11355/2,5000.0,0.0,26869659.84999999,2018,4,4,CHECK_WITHDRAWAL,5000.0,M1164700555
9615,409000438620',2018-04-04,CR808312182996/RMCPL11618/2,1000.0,0.0,26868659.84999999,2018,4,4,CHECK_WITHDRAWAL,1000.0,M767904592
9616,409000438620',2018-04-04,CR808215933338/RMCPL13756/2,3000.0,0.0,26865659.84999999,2018,4,4,CHECK_WITHDRAWAL,3000.0,M423037681
9617,409000438620',2018-04-04,CR808211842720/RMCPL17559/2,4000.0,0.0,26861659.84999999,2018,4,4,PAYEMENT,4000.0,M1615944369
9618,409000438620',2018-04-04,CR808211842699/RMCPL19956/2,500.0,0.0,26861159.84999999,2018,4,4,DEBIT,500.0,M380146513
9619,409000438620',2018-04-04,CR808213895589/RMCPL15326/2,500.0,0.0,26860659.84999999,2018,4,4,CASH_OUT,500.0,M1404437909
9620,409000438620',2018-04-04,CR808214915487/RMCPL18124/2,500.0,0.0,26860159.84999999,2018,4,4,DEBIT,500.0,C717951588
9621,409000438620',2018-04-04,CR808211859848/RMCPL22037/2,1000.0,0.0,26859159.84999999,2018,4,4,CHECK_WITHDRAWAL,1000.0,M108541652
9622,409000438620',2018-04-04,CR808212876772/RMCPL19415/2,8000.0,0.0,26851159.84999999,2018,4,4,CHECK_WITHDRAWAL,8000.0,M551871103
9623,409000438620',2018-04-04,CR808213895578/RMCPL18179/2,2000.0,0.0,26849159.84999999,2018,4,4,CHECK_WITHDRAWAL,2000.0,M1902028362
9624,409000438620',2018-04-04,CR808211859831/RMCPL22777/2,6000.0,0.0,26843159.84999999,2018,4,4,CHECK_WITHDRAWAL,6000.0,M457951161
9625,409000438620',2018-04-04,CR808215933339/RMCPL21104/2,2000.0,0.0,26841159.84999999,2018,4,4,PAYEMENT,2000.0,M381400476
9626,409000438620',2018-04-04,CR808211842716/RMCPL16185/2,500.0,0.0,26840659.84999999,2018,4,4,CHECK_WITHDRAWAL,500.0,M373085350
9627,409000438620',2018-04-04,CR808212876775/RMCPL24654/2,1000.0,0.0,26839659.84999999,2018,4,4,DEBIT,1000.0,C490150701
9628,409000438620',2018-04-04,CR808511672459/RMCPL21174/2,2000.0,0.0,26837659.84999999,2018,4,4,CHECK_WITHDRAWAL,2000.0,M2026488714
9629,409000438620',2018-04-04,CR808509637410/RMCPL22781/2,500.0,0.0,26837159.84999999,2018,4,4,CASH_OUT,500.0,M1842676608
9630,409000438620',2018-04-04,CR808610977804/RMCPL23751/2,2000.0,0.0,26835159.84999999,2018,4,4,CASH_OUT,2000.0,C977993101
9631,409000438620',2018-04-04,CR808610959068/RMCPL17538/2,5000.0,0.0,26830159.84999999,2018,4,4,DEBIT,5000.0,C854671988
9632,409000438620',2018-04-04,CR808610959092/RMCPL18325/2,1500.0,0.0,26828659.84999999,2018,4,4,CASH_OUT,1500.0,C297785169
9633,409000438620',2018-04-04,CR808618148412/RMCPL17292/2,1000.0,0.0,26827659.84999999,2018,4,4,DEBIT,1000.0,C1816757085
9634,409000438620',2018-04-04,CR808610959065/RMCPL22308/2,500.0,0.0,26827159.84999999,2018,4,4,CHECK_WITHDRAWAL,500.0,C1778801068
9635,409000438620',2018-04-04,CR808711326096/RMCPL24082/2,1000.0,0.0,26826159.84999999,2018,4,4,CHECK_WITHDRAWAL,1000.0,C1255024717
9636,409000438620',2018-04-04,CR808711326093/RMCPL18175/2,4500.0,0.0,26821659.84999999,2018,4,4,DEBIT,4500.0,C1360767589
9637,409000438620',2018-04-04,CR808711326109/RMCPL18940/2,1500.0,0.0,26820159.84999999,2018,4,4,PAYEMENT,1500.0,C505973878
9638,409000438620',2018-04-04,TRF TO  Indiaforensic SERVICES I,15000000.0,0.0,11820159.849999985,2018,4,4,PAYEMENT,15000000.0,C801142660
9639,409000438620',2018-04-04,TRF TO  Indiaforensic SERVICES I,11800000.0,0.0,20159.849999982864,2018,4,4,PAYEMENT,11800000.0,C665576141
9640,409000438620',2018-04-04,CB808112535313/RMCPL16998/2,10000.0,0.0,10159.849999982864,2018,4,4,DEBIT,10000.0,C515132998
9641,409000438620',2018-04-04,CB807907754337/RMCPL11735/2,5000.0,0.0,5159.849999982864,2018,4,4,PAYEMENT,5000.0,C306206744
9642,409000438620',2018-04-04,MAW/5029649806318192/DAMO,0.0,500.0,5659.849999982864,2018,4,4,CASH_IN,500.0,C2083562754
9643,409000438620',2018-04-04,MAW/5029649801376989/GUNA,0.0,2000.0,7659.849999982864,2018,4,4,TRANSFER,2000.0,C863811613
9644,409000438620',2018-04-04,MAW/5029649801376955/GUNA,0.0,500.0,8159.849999982864,2018,4,4,CASH_IN,500.0,C266418454
9645,409000438620',2018-04-04,AEPS Indiaforensic INCOME 030418,0.0,69176.0,77335.84999998286,2018,4,4,CASH_IN,69176.0,C991505714
9646,409000438620',2018-04-04,AEPS Indiaforensic GST 030418,0.0,12451.68,89787.52999998287,2018,4,4,CHECK_CASHING,12451.68,C1321640594
9647,409000438620',2018-04-05,Indiaforensic AEPS NPCI WDL SET,0.0,28451000.0,28540787.529999986,2018,4,5,CASH_IN,28451000.0,C1728766751
9648,409000438620',2018-04-05,TRF TO Indiaforensic SERVICES IN,13500000.0,0.0,15040787.529999984,2018,4,5,DEBIT,13500000.0,C728526866
9649,409000438620',2018-04-05,TRF TO Indiaforensic SERVICES IN,15000000.0,0.0,40787.529999982566,2018,4,5,CHECK_WITHDRAWAL,15000000.0,C184253187
9650,409000438620',2018-04-05,AEPS ACQ CR ADJ FEES 0404,38.35,0.0,40749.17999998257,2018,4,5,CHECK_WITHDRAWAL,38.35,C1394526584
9651,409000438620',2018-04-05,CR809213951460/RMCPL22950/2,500.0,0.0,40249.17999998257,2018,4,5,CASH_OUT,500.0,C380242442
9652,409000438620',2018-04-05,CR809012362267/RMCPL15896/3,2500.0,0.0,37749.17999998257,2018,4,5,DEBIT,2500.0,C1450133081
9653,409000438620',2018-04-05,CR809018460466/RMCPL24506/3,500.0,0.0,37249.17999998257,2018,4,5,DEBIT,500.0,C1870252780
9654,409000438620',2018-04-05,CR808810664451/RMCPL11888/2,4500.0,0.0,32749.179999982567,2018,4,5,CHECK_WITHDRAWAL,4500.0,C1339257929
9655,409000438620',2018-04-05,AEPS ACQ REP ADJ FEES 040,0.0,88.5,32837.67999998257,2018,4,5,TRANSFER,88.5,C97730845
9656,409000438620',2018-04-05,AEPS Indiaforensic INCOME 040418,0.0,74051.6,106889.27999998257,2018,4,5,CHECK_CASHING,74051.6,M1690803049
9657,409000438620',2018-04-05,AEPS Indiaforensic GST 040418,0.0,13329.29,120218.56999998256,2018,4,5,CASH_IN,13329.29,C2059996587
9658,409000438620',2018-04-05,CB807910807688/RMCPL13546/2,0.0,1000.0,121218.56999998256,2018,4,5,CASH_IN,1000.0,M42050891
9659,409000438620',2018-04-05,CB807910807642/RMCPL21160/2,0.0,1000.0,122218.56999998256,2018,4,5,TRANSFER,1000.0,M1983541978
9660,409000438620',2018-04-06,Indiaforensic AEPS NPCI WDL SET,0.0,27538000.0,27660218.56999998,2018,4,6,CASH_IN,27538000.0,M1606903090
9661,409000438620',2018-04-06,TRF TO  Indiaforensic SERVICES I,15000000.0,0.0,12660218.569999982,2018,4,6,DEBIT,15000000.0,M196052901
9662,409000438620',2018-04-06,TRF TO  Indiaforensic SERVICES I,12600000.0,0.0,60218.56999998168,2018,4,6,CHECK_WITHDRAWAL,12600000.0,M641975103
9663,409000438620',2018-04-06,MAW/5029649805706785/Akol,0.0,1500.0,61718.56999998168,2018,4,6,CHECK_CASHING,1500.0,C804836251
9664,409000438620',2018-04-06,AEPS ACQUIRING ADJ FEES 0,17.7,0.0,61700.86999998168,2018,4,6,CHECK_WITHDRAWAL,17.7,C1761353343
9665,409000438620',2018-04-06,AEPS Indiaforensic INCOME 050418,0.0,71532.9,133233.76999998168,2018,4,6,CASH_IN,71532.9,M2136509382
9666,409000438620',2018-04-06,AEPS Indiaforensic GST 050418,0.0,12875.92,146109.6899999817,2018,4,6,CHECK_CASHING,12875.92,M565661811
9667,409000438620',2018-04-07,Indiaforensic AEPS NPCI WDL SET,0.0,24265500.0,24411609.689999986,2018,4,7,TRANSFER,24265500.0,M179379830
9668,409000438620',2018-04-07,MAW/5029649805974573/Akol,0.0,4500.0,24416109.689999986,2018,4,7,CASH_IN,4500.0,M1775697525
9669,409000438620',2018-04-07,TRF TO Indiaforensic SERVICES IN,15000000.0,0.0,9416109.689999985,2018,4,7,CASH_OUT,15000000.0,C1034584766
9670,409000438620',2018-04-07,TRF TO Indiaforensic SERVICES IN,5000000.0,0.0,4416109.689999983,2018,4,7,DEBIT,5000000.0,C811597470
9671,409000438620',2018-04-07,TRF TO Indiaforensic SERVICES IN,4000000.0,0.0,416109.6899999827,2018,4,7,DEBIT,4000000.0,M1538995486
9672,409000438620',2018-04-07,AEPS ACQ CR ADJ FEES 0604,165.18,0.0,415944.5099999827,2018,4,7,CASH_OUT,165.18,M1579492862
9673,409000438620',2018-04-07,CR809311202673/RMCPL09155/0,1000.0,0.0,414944.5099999827,2018,4,7,CHECK_WITHDRAWAL,1000.0,M1531406640
9674,409000438620',2018-04-07,CR809313250897/RMCPL23878/0,1000.0,0.0,413944.5099999827,2018,4,7,CHECK_WITHDRAWAL,1000.0,C1345063038
9675,409000438620',2018-04-07,CR809313250881/RMCPL24438/0,2000.0,0.0,411944.5099999827,2018,4,7,CHECK_WITHDRAWAL,2000.0,M451809097
9676,409000438620',2018-04-07,CR809310190188/RMCPL21854/0,10000.0,0.0,401944.5099999827,2018,4,7,CASH_OUT,10000.0,C1457383927
9677,409000438620',2018-04-07,CR809310190176/RMCPL20244/0,3000.0,0.0,398944.5099999827,2018,4,7,PAYEMENT,3000.0,C1515704208
9678,409000438620',2018-04-07,CR809310190194/RMCPL09591/0,10000.0,0.0,388944.5099999827,2018,4,7,DEBIT,10000.0,C1329589315
9679,409000438620',2018-04-07,CR809408467144/RMCPL18750/0,3000.0,0.0,385944.5099999827,2018,4,7,CHECK_WITHDRAWAL,3000.0,C1636786811
9680,409000438620',2018-04-07,CR809409483175/RMCPL24040/0,500.0,0.0,385444.5099999827,2018,4,7,PAYEMENT,500.0,C490150701
9681,409000438620',2018-04-07,CR809411532113/RMCPL11794/0,500.0,0.0,384944.5099999827,2018,4,7,CHECK_WITHDRAWAL,500.0,C1313534832
9682,409000438620',2018-04-07,CR809410496540/RMCPL16457/0,1500.0,0.0,383444.5099999827,2018,4,7,DEBIT,1500.0,C1336996537
9683,409000438620',2018-04-07,CR809409483205/RMCPL16427/0,10000.0,0.0,373444.5099999827,2018,4,7,DEBIT,10000.0,C1951379728
9684,409000438620',2018-04-07,CR809410509699/RMCPL20331/0,4000.0,0.0,369444.5099999827,2018,4,7,CASH_OUT,4000.0,C1883788127
9685,409000438620',2018-04-07,CR809409483184/RMCPL14454/0,5000.0,0.0,364444.5099999827,2018,4,7,CHECK_WITHDRAWAL,5000.0,C1286084959
9686,409000438620',2018-04-07,CR809310190203/RMCPL24086/0,500.0,0.0,363944.5099999827,2018,4,7,DEBIT,500.0,C976133979
9687,409000438620',2018-04-07,AEPS Indiaforensic INCOME 060418,0.0,62385.4,426329.90999998274,2018,4,7,CHECK_CASHING,62385.4,C1450133081
9688,409000438620',2018-04-07,AEPS Indiaforensic GST 060418,0.0,11229.37,437559.27999998274,2018,4,7,CHECK_CASHING,11229.37,C1234776885
9689,409000438620',2018-04-09,Indiaforensic AEPS NPCI WDL SET,0.0,25527000.0,25964559.279999986,2018,4,9,CASH_IN,25527000.0,C872592585
9690,409000438620',2018-04-09,Indiaforensic AEPS NPCI WDL SET,0.0,17816500.0,43781059.27999999,2018,4,9,CASH_IN,17816500.0,C257999182
9691,409000438620',2018-04-09,TRF TO  Indiaforensic SERVICES I,15000000.0,0.0,28781059.279999986,2018,4,9,CASH_OUT,15000000.0,C1494895909
9692,409000438620',2018-04-09,TRF TO  Indiaforensic SERVICES I,15000000.0,0.0,13781059.279999984,2018,4,9,PAYEMENT,15000000.0,C963383848
9693,409000438620',2018-04-09,TRF TO  Indiaforensic SERVICES I,13700000.0,0.0,81059.27999998629,2018,4,9,PAYEMENT,13700000.0,C1436136891
9694,409000438620',2018-04-09,AEPS ACQ CR ADJ FEES 0704,70.8,0.0,80988.47999998629,2018,4,9,CHECK_WITHDRAWAL,70.8,C875761527
9695,409000438620',2018-04-09,CR809513933643/RMCPL19636/0,1500.0,0.0,79488.47999998629,2018,4,9,CASH_OUT,1500.0,C1233454027
9696,409000438620',2018-04-09,CR809513933653/RMCPL22469/0,3000.0,0.0,76488.47999998629,2018,4,9,DEBIT,3000.0,C373928166
9697,409000438620',2018-04-09,CR809512903457/RMCPL20943/0,500.0,0.0,75988.47999998629,2018,4,9,CHECK_WITHDRAWAL,500.0,C977993101
9698,409000438620',2018-04-09,CR809511890847/RMCPL16630/0,10000.0,0.0,65988.47999998629,2018,4,9,CHECK_WITHDRAWAL,10000.0,C872592585
9699,409000438620',2018-04-09,CR809511890832/RMCPL01864/0,10000.0,0.0,55988.47999998629,2018,4,9,CHECK_WITHDRAWAL,10000.0,C1850180796
9700,409000438620',2018-04-09,CR809512903440/RMCPL15901/0,500.0,0.0,55488.47999998629,2018,4,9,CHECK_WITHDRAWAL,500.0,C1459035867
9701,409000438620',2018-04-09,CR809511890843/RMCPL14428/0,500.0,0.0,54988.47999998629,2018,4,9,CASH_OUT,500.0,M909644303
9702,409000438620',2018-04-09,AEPS Indiaforensic INCOME 070418,0.0,67076.4,122064.87999998627,2018,4,9,TRANSFER,67076.4,M1478277241
9703,409000438620',2018-04-09,AEPS Indiaforensic GST 070418,0.0,12073.75,134138.62999998627,2018,4,9,TRANSFER,12073.75,M472467991
9704,409000438620',2018-04-09,AEPS Indiaforensic INCOME 080418,0.0,48032.95,182171.57999998628,2018,4,9,TRANSFER,48032.95,M1202138162
9705,409000438620',2018-04-09,AEPS Indiaforensic GST 080418,0.0,8645.93,190817.5099999863,2018,4,9,TRANSFER,8645.93,M1191183951
9706,409000438620',2018-04-10,AEPS ACQUIRING ADJ FEES 0,53.1,0.0,190764.4099999863,2018,4,10,CHECK_WITHDRAWAL,53.1,C1016689071
9707,409000438620',2018-04-10,AEPS ACQ REP ADJ FEES 090,0.0,17.7,190782.10999998628,2018,4,10,CASH_IN,17.7,C683605346
9708,409000438620',2018-04-10,Indiaforensic AEPS NPCI WDL SET,0.0,26619000.0,26809782.109999985,2018,4,10,TRANSFER,26619000.0,M1166254470
9709,409000438620',2018-04-11,TRF TO  Indiaforensic SERVICES I,15000000.0,0.0,11809782.109999985,2018,4,11,DEBIT,15000000.0,C935612756
9710,409000438620',2018-04-11,TRF TO  Indiaforensic SERVICES I,10000000.0,0.0,1809782.1099999843,2018,4,11,CHECK_WITHDRAWAL,10000000.0,M1299158298
9711,409000438620',2018-04-11,TRF TO  Indiaforensic SERVICES I,1000000.0,0.0,809782.1099999845,2018,4,11,DEBIT,1000000.0,M1792953030
9712,409000438620',2018-04-11,TRRF TO  Indiaforensic SERVICES,500000.0,0.0,309782.1099999845,2018,4,11,CASH_OUT,500000.0,M1044144931
9713,409000438620',2018-04-11,Indiaforensic AEPS NPCI WDL SET,0.0,28279000.0,28588782.109999985,2018,4,11,CHECK_CASHING,28279000.0,M2010162322
9714,409000438620',2018-04-11,TRF TO  Indiaforensic SERVICES I,15000000.0,0.0,13588782.109999985,2018,4,11,PAYEMENT,15000000.0,C1790657739
9715,409000438620',2018-04-11,TRF TO  Indiaforensic SERVICES I,13500000.0,0.0,88782.10999998449,2018,4,11,CASH_OUT,13500000.0,M525180031
9716,409000438620',2018-04-11,AEPS Indiaforensic INCOME 090418,0.0,70462.3,159244.4099999845,2018,4,11,CASH_IN,70462.3,M2012635448
9717,409000438620',2018-04-11,AEPS Indiaforensic GST 090418,0.0,12683.21,171927.61999998448,2018,4,11,TRANSFER,12683.21,M19719769
9718,409000438620',2018-04-11,AEPS Indiaforensic INCOME 100418,0.0,33019.53,204947.14999998448,2018,4,11,CHECK_CASHING,33019.53,M1913836511
9719,409000438620',2018-04-11,AEPS Indiaforensic GST 100418,0.0,73816.15,278763.29999998445,2018,4,11,CASH_IN,73816.15,M1878024069
9720,409000438620',2018-04-12,Indiaforensic AEPS NPCI WDL SET,0.0,25751000.0,26029763.299999986,2018,4,12,CASH_IN,25751000.0,M1905758512
9721,409000438620',2018-04-12,TRF TO  Indiaforensic SERVICES I,15000000.0,0.0,11029763.299999986,2018,4,12,CHECK_WITHDRAWAL,15000000.0,C1782113663
9722,409000438620',2018-04-12,TRF TO  Indiaforensic SERVICES I,11000000.0,0.0,29763.299999985844,2018,4,12,CASH_OUT,11000000.0,C1807896178
9723,409000438620',2018-04-12,AEPS ACQUIRING ADJ FEES 1,29.5,0.0,29733.799999985844,2018,4,12,CHECK_WITHDRAWAL,29.5,M2007058705
9724,409000438620',2018-04-12,AEPS ACQ CR ADJ FEES 1104,79.65,0.0,29654.14999998584,2018,4,12,CASH_OUT,79.65,C2127862399
9725,409000438620',2018-04-12,CR809815923816/RMCPL19374/0,500.0,0.0,29154.14999998584,2018,4,12,DEBIT,500.0,M965988043
9726,409000438620',2018-04-12,CR809711534674/RMCPL23499/0,1500.0,0.0,27654.14999998584,2018,4,12,PAYEMENT,1500.0,M1931205834
9727,409000438620',2018-04-12,CR809709501201/RMCPL10677/0,10000.0,0.0,17654.149999985842,2018,4,12,CASH_OUT,10000.0,M1363130483
9728,409000438620',2018-04-12,CR809709500981/RMCPL23268/0,6000.0,0.0,11654.149999985842,2018,4,12,CASH_OUT,6000.0,M119202251
9729,409000438620',2018-04-12,CR809710506676/RMCPL21966/0,1000.0,0.0,10654.149999985842,2018,4,12,CHECK_WITHDRAWAL,1000.0,M864039229
9730,409000438620',2018-04-12,CR809711534665/RMCPL23878/0,1000.0,0.0,9654.149999985842,2018,4,12,CASH_OUT,1000.0,M492749549
9731,409000438620',2018-04-12,CR809616306546/RMCPL16346/0,3000.0,0.0,6654.149999985842,2018,4,12,CHECK_WITHDRAWAL,3000.0,M928607044
9732,409000438620',2018-04-12,CR809616306542/RMCPL23821/0,500.0,0.0,6154.149999985842,2018,4,12,CHECK_WITHDRAWAL,500.0,M1120843391
9733,409000438620',2018-04-12,AEPS Indiaforensic INCOME 110418,0.0,67246.9,73401.04999998584,2018,4,12,TRANSFER,67246.9,C758750856
9734,409000438620',2018-04-12,AEPS Indiaforensic GST 110418,0.0,12104.44,85505.48999998585,2018,4,12,CASH_IN,12104.44,M1698434204
9735,409000438620',2018-04-13,Indiaforensic AEPS NPCI WDL SET,0.0,25977500.0,26063005.48999999,2018,4,13,CASH_IN,25977500.0,M572088818
9736,409000438620',2018-04-13,REV AEPS Indiaforensic INCOME 10,33019.53,0.0,26029985.959999986,2018,4,13,CHECK_WITHDRAWAL,33019.53,M1371550829
9737,409000438620',2018-04-13,REV AEPS Indiaforensic GST 10041,73816.15,0.0,25956169.80999999,2018,4,13,DEBIT,73816.15,M1538409062
9738,409000438620',2018-04-13,AEPS Indiaforensic INCOME 100418,0.0,73816.16,26029985.96999999,2018,4,13,CHECK_CASHING,73816.16,M871389613
9739,409000438620',2018-04-13,AEPS Indiaforensic GST 100418,0.0,13286.91,26043272.87999999,2018,4,13,CASH_IN,13286.91,M622007863
9740,409000438620',2018-04-13,TRF TO  Indiaforensic SERVICES I,15000000.0,0.0,11043272.879999988,2018,4,13,DEBIT,15000000.0,M1827883912
9741,409000438620',2018-04-13,TRF TO  Indiaforensic SERVICES I,11000000.0,0.0,43272.87999998778,2018,4,13,DEBIT,11000000.0,M1675675460
9742,409000438620',2018-04-13,AEPS Indiaforensic INCOME 120418,0.0,66900.1,110172.97999998779,2018,4,13,CASH_IN,66900.1,M847575327
9743,409000438620',2018-04-13,AEPS Indiaforensic GST 120418,0.0,12042.02,122214.99999998779,2018,4,13,TRANSFER,12042.02,M2011496421
9744,409000438620',2018-04-16,Indiaforensic AEPS NPCI WDL SET,0.0,31464000.0,31586214.99999999,2018,4,16,CASH_IN,31464000.0,C1373172466
9745,409000438620',2018-04-16,Indiaforensic AEPS NPCI WDL SET,0.0,25383000.0,56969214.99999999,2018,4,16,CASH_IN,25383000.0,C979387846
9746,409000438620',2018-04-16,Indiaforensic AEPS NPCI WDL SET,0.0,10377000.0,67346214.99999999,2018,4,16,CHECK_CASHING,10377000.0,M1354373599
9747,409000438620',2018-04-16,TRF TO  Indiaforensic SERVICES I,15000000.0,0.0,52346214.99999999,2018,4,16,DEBIT,15000000.0,M252570530
9748,409000438620',2018-04-16,TRF TO  Indiaforensic SERVICES I,15000000.0,0.0,37346214.99999999,2018,4,16,DEBIT,15000000.0,M19496184
9749,409000438620',2018-04-16,TRF TO  Indiaforensic SERVICES I,15000000.0,0.0,22346214.999999985,2018,4,16,CASH_OUT,15000000.0,M1473375728
9750,409000438620',2018-04-16,TRF TO  Indiaforensic SERVICES I,15000000.0,0.0,7346214.999999985,2018,4,16,CASH_OUT,15000000.0,M1932104087
9751,409000438620',2018-04-16,TRF TO  Indiaforensic SERVICES I,7300000.0,0.0,46214.9999999851,2018,4,16,CASH_OUT,7300000.0,M370265628
9752,409000438620',2018-04-16,AEPS Indiaforensic INCOME 130418,0.0,82174.4,128389.3999999851,2018,4,16,TRANSFER,82174.4,M2144835163
9753,409000438620',2018-04-16,AEPS Indiaforensic GST 130418,0.0,14791.39,143180.78999998508,2018,4,16,CHECK_CASHING,14791.39,M294485518
9754,409000438620',2018-04-16,AEPS Indiaforensic INCOME 140418,0.0,66684.4,209865.18999998507,2018,4,16,TRANSFER,66684.4,C1183572822
9755,409000438620',2018-04-16,AEPS Indiaforensic GST 140418,0.0,12003.19,221868.37999998507,2018,4,16,CHECK_CASHING,12003.19,C638590716
9756,409000438620',2018-04-16,AEPS Indiaforensic INCOME 150418,0.0,28683.75,250552.1299999851,2018,4,16,TRANSFER,28683.75,M671271586
9757,409000438620',2018-04-16,AEPS Indiaforensic GST 150418,0.0,5163.08,255715.20999998503,2018,4,16,CASH_IN,5163.08,M1522002327
9758,409000438620',2018-04-16,AEPS ACQCR ADJ FEES 13041,525.1,0.0,255190.10999998503,2018,4,16,CHECK_WITHDRAWAL,525.1,C811597470
9759,409000438620',2018-04-16,CR809909106807/RMCPL21389/0,3000.0,0.0,252190.10999998503,2018,4,16,CHECK_WITHDRAWAL,3000.0,M182130143
9760,409000438620',2018-04-16,CR809909106746/RMCPL24712/0,6000.0,0.0,246190.10999998503,2018,4,16,CHECK_WITHDRAWAL,6000.0,M1551398625
9761,409000438620',2018-04-16,CR809910122577/RMCPL18122/0,1000.0,0.0,245190.10999998503,2018,4,16,CASH_OUT,1000.0,M1329040766
9762,409000438620',2018-04-16,CR809910122600/RMCPL18701/0,5000.0,0.0,240190.10999998503,2018,4,16,CASH_OUT,5000.0,M311569747
9763,409000438620',2018-04-16,CR809910122599/RMCPL17634/0,1000.0,0.0,239190.10999998503,2018,4,16,CHECK_WITHDRAWAL,1000.0,M2080890623
9764,409000438620',2018-04-16,CR809910122582/RMCPL21457/0,500.0,0.0,238690.10999998503,2018,4,16,CASH_OUT,500.0,M1716257894
9765,409000438620',2018-04-16,CR809910128488/RMCPL19118/0,2000.0,0.0,236690.10999998503,2018,4,16,CHECK_WITHDRAWAL,2000.0,M1827583378
9766,409000438620',2018-04-16,CR809910128148/RMCPL23963/0,2500.0,0.0,234190.10999998503,2018,4,16,CHECK_WITHDRAWAL,2500.0,M902209131
9767,409000438620',2018-04-16,CR809910128230/RMCPL13963/0,2000.0,0.0,232190.10999998503,2018,4,16,PAYEMENT,2000.0,C228902347
9768,409000438620',2018-04-16,CR809910128405/RMCPL24871/0,1000.0,0.0,231190.10999998503,2018,4,16,CASH_OUT,1000.0,M742450262
9769,409000438620',2018-04-16,CR809910128221/RMCPL20329/0,2000.0,0.0,229190.10999998503,2018,4,16,DEBIT,2000.0,M1229356998
9770,409000438620',2018-04-16,CR809910128137/RMCPL23669/0,1500.0,0.0,227690.10999998503,2018,4,16,CASH_OUT,1500.0,M1155636121
9771,409000438620',2018-04-16,CR809910134390/RMCPL21515/0,2000.0,0.0,225690.10999998503,2018,4,16,CASH_OUT,2000.0,C769342184
9772,409000438620',2018-04-16,CR809911139397/RMCPL19904/0,5000.0,0.0,220690.10999998503,2018,4,16,PAYEMENT,5000.0,C1255024717
9773,409000438620',2018-04-16,CR809911146611/RMCPL19949/0,1000.0,0.0,219690.10999998503,2018,4,16,DEBIT,1000.0,C911998047
9774,409000438620',2018-04-16,CR809911153811/RMCPL13526/0,500.0,0.0,219190.10999998503,2018,4,16,PAYEMENT,500.0,C1746150957
9775,409000438620',2018-04-16,CR809911153894/RMCPL16946/0,10000.0,0.0,209190.10999998503,2018,4,16,DEBIT,10000.0,C2145942542
9776,409000438620',2018-04-16,CR809911151696/RMCPL20899/0,1000.0,0.0,208190.10999998503,2018,4,16,CASH_OUT,1000.0,C296121376
9777,409000438620',2018-04-16,CR809911153865/RMCPL11889/0,10000.0,0.0,198190.10999998503,2018,4,16,CASH_OUT,10000.0,C934085675
9778,409000438620',2018-04-16,CR809911153869/RMCPL23425/0,1000.0,0.0,197190.10999998503,2018,4,16,CASH_OUT,1000.0,C803116137
9779,409000438620',2018-04-16,CR809911153899/RMCPL09497/0,3000.0,0.0,194190.10999998503,2018,4,16,DEBIT,3000.0,C872592585
9780,409000438620',2018-04-16,CR809911153898/RMCPL03659/0,2500.0,0.0,191690.10999998503,2018,4,16,DEBIT,2500.0,C365212068
9781,409000438620',2018-04-16,CR809911159372/RMCPL12334/0,500.0,0.0,191190.10999998503,2018,4,16,PAYEMENT,500.0,C1825992554
9782,409000438620',2018-04-16,CR809911158375/RMCPL24812/0,10000.0,0.0,181190.10999998503,2018,4,16,CASH_OUT,10000.0,C657736958
9783,409000438620',2018-04-16,CR809911159397/RMCPL18403/0,500.0,0.0,180690.10999998503,2018,4,16,PAYEMENT,500.0,C1777369261
9784,409000438620',2018-04-16,CR809911160241/RMCPL19587/0,500.0,0.0,180190.10999998503,2018,4,16,CASH_OUT,500.0,C1592415783
9785,409000438620',2018-04-16,CR809911159415/RMCPL17486/0,4500.0,0.0,175690.10999998506,2018,4,16,CHECK_WITHDRAWAL,4500.0,C1882860489
9786,409000438620',2018-04-16,CR809911159265/RMCPL24866/0,5000.0,0.0,170690.10999998506,2018,4,16,CASH_OUT,5000.0,C470217116
9787,409000438620',2018-04-16,CR809911159773/RMCPL14060/0,500.0,0.0,170190.10999998506,2018,4,16,CASH_OUT,500.0,C553790651
9788,409000438620',2018-04-16,CR809911159266/RMCPL21775/0,1500.0,0.0,168690.10999998506,2018,4,16,DEBIT,1500.0,C1059781259
9789,409000438620',2018-04-16,CR809911159398/RMCPL21715/0,2000.0,0.0,166690.10999998506,2018,4,16,CHECK_WITHDRAWAL,2000.0,C403147759
9790,409000438620',2018-04-16,CR809911160670/RMCPL14060/0,10000.0,0.0,156690.10999998506,2018,4,16,CHECK_WITHDRAWAL,10000.0,C798678484
9791,409000438620',2018-04-16,CR809912160684/RMCPL19219/0,5000.0,0.0,151690.10999998506,2018,4,16,PAYEMENT,5000.0,C114618982
9792,409000438620',2018-04-16,CR809911159382/RMCPL20248/0,1000.0,0.0,150690.10999998506,2018,4,16,CASH_OUT,1000.0,C35126588
9793,409000438620',2018-04-16,CR809911160280/RMCPL23072/0,7000.0,0.0,143690.10999998506,2018,4,16,DEBIT,7000.0,C638590716
9794,409000438620',2018-04-16,CR809911160256/RMCPL14360/0,500.0,0.0,143190.10999998506,2018,4,16,DEBIT,500.0,C384537519
9795,409000438620',2018-04-16,CR809914210228/RMCPL00198/0,500.0,0.0,142690.10999998506,2018,4,16,PAYEMENT,500.0,C811597470
9796,409000438620',2018-04-16,CR809914211599/RMCPL23046/0,1500.0,0.0,141190.10999998506,2018,4,16,CASH_OUT,1500.0,C1505755152
9797,409000438620',2018-04-16,CR809914210720/RMCPL13065/0,1000.0,0.0,140190.10999998506,2018,4,16,CASH_OUT,1000.0,C40075281
9798,409000438620',2018-04-16,CR809914211608/RMCPL20049/0,1000.0,0.0,139190.10999998506,2018,4,16,DEBIT,1000.0,C1085479446
9799,409000438620',2018-04-16,CR809914211289/RMCPL09726/0,10000.0,0.0,129190.10999998506,2018,4,16,PAYEMENT,10000.0,C769342184
9800,409000438620',2018-04-16,CR809914211605/RMCPL19017/0,2000.0,0.0,127190.10999998506,2018,4,16,CASH_OUT,2000.0,C1584119395
9801,409000438620',2018-04-16,CR809914211610/RMCPL00198/0,5000.0,0.0,122190.10999998506,2018,4,16,DEBIT,5000.0,C1584119395
9802,409000438620',2018-04-16,CR809916253237/RMCPL22216/0,5000.0,0.0,117190.10999998506,2018,4,16,CHECK_WITHDRAWAL,5000.0,C1327907419
9803,409000438620',2018-04-16,CR810011494131/RMCPL09169/1,1500.0,0.0,115690.10999998506,2018,4,16,CASH_OUT,1500.0,C553790651
9804,409000438620',2018-04-16,CR810014547657/RMCPL21218/1,1000.0,0.0,114690.10999998506,2018,4,16,PAYEMENT,1000.0,C771404135
9805,409000438620',2018-04-16,CR810017599824/RMCPL19554/1,2000.0,0.0,112690.10999998506,2018,4,16,DEBIT,2000.0,C1100439041
9806,409000438620',2018-04-16,CR810011494143/RMCPL20307/1,1500.0,0.0,111190.10999998506,2018,4,16,CASH_OUT,1500.0,C257999182
9807,409000438620',2018-04-16,CR810014548085/RMCPL20332/1,500.0,0.0,110690.10999998506,2018,4,16,CASH_OUT,500.0,C184253187
9808,409000438620',2018-04-16,AEPS ACQREP ADJ FEES 1304,0.0,53.1,110743.20999998506,2018,4,16,CASH_IN,53.1,C339099861
9809,409000438620',2018-04-17,Indiaforensic AEPS NPCI WDL SET,0.0,28248500.0,28359243.209999986,2018,4,17,TRANSFER,28248500.0,C836514715
9810,409000438620',2018-04-17,TRF TO  Indiaforensic SERVICES I,15000000.0,0.0,13359243.209999984,2018,4,17,DEBIT,15000000.0,C128870695
9811,409000438620',2018-04-17,TRF TO  Indiaforensic SERVICES I,13300000.0,0.0,59243.20999998599,2018,4,17,PAYEMENT,13300000.0,C256417920
9812,409000438620',2018-04-17,AEPS ACQ REP ADJ FEES 160,0.0,29.5,59272.70999998599,2018,4,17,CHECK_CASHING,29.5,C292665982
9813,409000438620',2018-04-17,AEPS Indiaforensic INCOME 160418,0.0,75657.6,134930.309999986,2018,4,17,CASH_IN,75657.6,C1387567249
9814,409000438620',2018-04-17,AEPS Indiaforensic GST 160418,0.0,13618.37,148548.679999986,2018,4,17,CHECK_CASHING,13618.37,C2034284329
9815,409000438620',2018-04-18,Indiaforensic AEPS NPCI WDL SET,0.0,27638000.0,27786548.679999985,2018,4,18,TRANSFER,27638000.0,C1345063038
9816,409000438620',2018-04-18,CR810111819036/RMCPL18175/1,10000.0,0.0,27776548.679999985,2018,4,18,CHECK_WITHDRAWAL,10000.0,C1626759869
9817,409000438620',2018-04-18,CR810110781887/RMCPL15556/1,1000.0,0.0,27775548.679999985,2018,4,18,CASH_OUT,1000.0,C800523009
9818,409000438620',2018-04-18,CR810112844687/RMCPL16727/1,2500.0,0.0,27773048.679999985,2018,4,18,PAYEMENT,2500.0,M1322011459
9819,409000438620',2018-04-18,CR810213189711/RMCPL19331/1,1000.0,0.0,27772048.679999985,2018,4,18,DEBIT,1000.0,M487780337
9820,409000438620',2018-04-18,CR810210124776/RMCPL19766/1,3500.0,0.0,27768548.679999985,2018,4,18,DEBIT,3500.0,M206608194
9821,409000438620',2018-04-18,CR810210124641/RMCPL13299/1,3000.0,0.0,27765548.679999985,2018,4,18,CASH_OUT,3000.0,M2101456637
9822,409000438620',2018-04-18,CR810214216611/RMCPL18165/1,500.0,0.0,27765048.679999985,2018,4,18,PAYEMENT,500.0,C1434590943
9823,409000438620',2018-04-18,CR810214216859/RMCPL22502/1,2000.0,0.0,27763048.679999985,2018,4,18,CASH_OUT,2000.0,M1161399216
9824,409000438620',2018-04-18,CR810216244741/RMCPL21855/1,1000.0,0.0,27762048.679999985,2018,4,18,CASH_OUT,1000.0,C1028574311
9825,409000438620',2018-04-18,CR810210124448/RMCPL23993/1,7000.0,0.0,27755048.679999985,2018,4,18,CASH_OUT,7000.0,M778520216
9826,409000438620',2018-04-18,CR810210124784/RMCPL12563/1,10000.0,0.0,27745048.679999985,2018,4,18,CHECK_WITHDRAWAL,10000.0,M1830963489
9827,409000438620',2018-04-18,CR810210124782/RMCPL10752/1,500.0,0.0,27744548.679999985,2018,4,18,DEBIT,500.0,M2075760352
9828,409000438620',2018-04-18,CR810210121557/RMCPL07044/1,500.0,0.0,27744048.679999985,2018,4,18,DEBIT,500.0,M1924533224
9829,409000438620',2018-04-18,CR810213197769/RMCPL09982/1,500.0,0.0,27743548.679999985,2018,4,18,DEBIT,500.0,M1486670059
9830,409000438620',2018-04-18,CR810214216073/RMCPL24602/1,10000.0,0.0,27733548.679999985,2018,4,18,CASH_OUT,10000.0,M109611571
9831,409000438620',2018-04-18,CR810213189712/RMCPL17553/1,2000.0,0.0,27731548.679999985,2018,4,18,CHECK_WITHDRAWAL,2000.0,M2103841285
9832,409000438620',2018-04-18,CR810212164237/RMCPL20998/1,3000.0,0.0,27728548.679999985,2018,4,18,CASH_OUT,3000.0,M1644425487
9833,409000438620',2018-04-18,TRF TO  Indiaforensic SERVICES I,15000000.0,0.0,12728548.679999985,2018,4,18,PAYEMENT,15000000.0,M1995054261
9834,409000438620',2018-04-18,TRF TO  Indiaforensic SERVICES I,12700000.0,0.0,28548.6799999848,2018,4,18,PAYEMENT,12700000.0,M1788132713
9835,409000438620',2018-04-18,AEPS ACQ CR ADJ FEES 1704,191.75,0.0,28356.9299999848,2018,4,18,CASH_OUT,191.75,M2036771172
9836,409000438620',2018-04-18,AEPS Indiaforensic INCOME 170418,0.0,73782.75,102139.6799999848,2018,4,18,TRANSFER,73782.75,M887000223
9837,409000438620',2018-04-18,AEPS Indiaforensic GST 170418,0.0,13280.9,115420.57999998481,2018,4,18,CHECK_CASHING,13280.9,M1595659891
9838,409000438620',2018-04-19,Indiaforensic AEPS NPCI WDL SET,0.0,37473500.0,37588920.57999998,2018,4,19,CASH_IN,37473500.0,M340772346
9839,409000438620',2018-04-19,TRF TO  Indiaforensic SERVICES I,500000.0,0.0,37088920.57999998,2018,4,19,CASH_OUT,500000.0,C762570948
9840,409000438620',2018-04-19,TRF TO  Indiaforensic SERVICES I,2000000.0,0.0,35088920.57999998,2018,4,19,PAYEMENT,2000000.0,C553790651
9841,409000438620',2018-04-19,TRF TO  Indiaforensic SERVICES I,5000000.0,0.0,30088920.579999983,2018,4,19,CASH_OUT,5000000.0,M1133794432
9842,409000438620',2018-04-19,TRF TO  Indiaforensic SERVICES I,15000000.0,0.0,15088920.579999985,2018,4,19,DEBIT,15000000.0,M227996691
9843,409000438620',2018-04-19,TRF TO  Indiaforensic SERVICES I,15000000.0,0.0,88920.57999998333,2018,4,19,DEBIT,15000000.0,M874771283
9844,409000438620',2018-04-19,AEPS Indiaforensic INCOME 180418,0.0,99353.73,188274.3099999833,2018,4,19,TRANSFER,99353.73,M912034375
9845,409000438620',2018-04-19,AEPS Indiaforensic GST 180418,0.0,17883.67,206157.97999998328,2018,4,19,CHECK_CASHING,17883.67,M1553206824
9846,409000438620',2018-04-20,Indiaforensic AEPS NPCI WDL SET,0.0,33964500.0,34170657.97999998,2018,4,20,CHECK_CASHING,33964500.0,C66893623
9847,409000438620',2018-04-20,TRF TO  Indiaforensic SERVICES I,15000000.0,0.0,19170657.97999998,2018,4,20,CASH_OUT,15000000.0,C1271835801
9848,409000438620',2018-04-20,TRF TO  Indiaforensic SERVICES I,15000000.0,0.0,4170657.979999982,2018,4,20,PAYEMENT,15000000.0,M961994506
9849,409000438620',2018-04-20,TRF TO  Indiaforensic SERVICES I,4000000.0,0.0,170657.97999998182,2018,4,20,PAYEMENT,4000000.0,M244114865
9850,409000438620',2018-04-20,AEPS Indiaforensic INCOME 190418,0.0,91050.84,261708.81999998185,2018,4,20,CASH_IN,91050.84,C1816757085
9851,409000438620',2018-04-20,AEPS Indiaforensic GST 190418,0.0,16389.15,278097.9699999818,2018,4,20,TRANSFER,16389.15,M1693575672
9852,409000438620',2018-04-20,AEPS ACQ CR ADJ FEES 1904,542.8,0.0,277555.1699999818,2018,4,20,CASH_OUT,542.8,M1627520381
9853,409000438620',2018-04-20,CR810410756238/RMCPL17909/1,9000.0,0.0,268555.1699999818,2018,4,20,PAYEMENT,9000.0,C433115563
9854,409000438620',2018-04-20,CR810410741727/RMCPL18349/1,1000.0,0.0,267555.1699999818,2018,4,20,DEBIT,1000.0,M617068868
9855,409000438620',2018-04-20,CR810410741728/RMCPL24016/1,10000.0,0.0,257555.16999998182,2018,4,20,PAYEMENT,10000.0,M1409991198
9856,409000438620',2018-04-20,CR810410741726/RMCPL22690/1,500.0,0.0,257055.16999998182,2018,4,20,PAYEMENT,500.0,M351308439
9857,409000438620',2018-04-20,CR810410756293/RMCPL18701/1,1000.0,0.0,256055.16999998182,2018,4,20,PAYEMENT,1000.0,C169904524
9858,409000438620',2018-04-20,CR810411765285/RMCPL18859/1,4000.0,0.0,252055.16999998182,2018,4,20,PAYEMENT,4000.0,C478124129
9859,409000438620',2018-04-20,CR810409726175/RMCPL11405/1,500.0,0.0,251555.16999998182,2018,4,20,DEBIT,500.0,M2070690615
9860,409000438620',2018-04-20,CR810407694679/RMCPL15602/1,2000.0,0.0,249555.16999998182,2018,4,20,PAYEMENT,2000.0,M942802969
9861,409000438620',2018-04-20,CR810310432980/RMCPL18872/1,500.0,0.0,249055.16999998182,2018,4,20,CHECK_WITHDRAWAL,500.0,M216800482
9862,409000438620',2018-04-20,CR810316556537/RMCPL20795/1,6500.0,0.0,242555.16999998182,2018,4,20,CASH_OUT,6500.0,C404923931
9863,409000438620',2018-04-20,CR810316556565/RMCPL23049/1,500.0,0.0,242055.16999998182,2018,4,20,PAYEMENT,500.0,M1792030422
9864,409000438620',2018-04-20,CR810314516672/RMCPL19130/1,500.0,0.0,241555.16999998182,2018,4,20,CHECK_WITHDRAWAL,500.0,C1937294500
9865,409000438620',2018-04-20,CR810314516685/RMCPL17852/1,1500.0,0.0,240055.16999998182,2018,4,20,CASH_OUT,1500.0,M2068534685
9866,409000438620',2018-04-20,CR810314516687/RMCPL15112/1,1000.0,0.0,239055.16999998182,2018,4,20,CHECK_WITHDRAWAL,1000.0,M799887602
9867,409000438620',2018-04-20,CR810311468471/RMCPL14954/1,1000.0,0.0,238055.16999998182,2018,4,20,CASH_OUT,1000.0,M325023242
9868,409000438620',2018-04-20,CR810709532225/RMCPL23592/1,5000.0,0.0,233055.16999998182,2018,4,20,PAYEMENT,5000.0,M1929777568
9869,409000438620',2018-04-20,CR810712594483/RMCPL20185/1,1000.0,0.0,232055.16999998182,2018,4,20,DEBIT,1000.0,M1613819889
9870,409000438620',2018-04-20,CR810712594493/RMCPL16105/1,2000.0,0.0,230055.16999998182,2018,4,20,DEBIT,2000.0,M1510145189
9871,409000438620',2018-04-20,CR810712594484/RMCPL16529/1,500.0,0.0,229555.16999998182,2018,4,20,CHECK_WITHDRAWAL,500.0,M210908320
9872,409000438620',2018-04-20,CR810711569193/RMCPL23561/1,3000.0,0.0,226555.16999998182,2018,4,20,CASH_OUT,3000.0,C789698697
9873,409000438620',2018-04-20,CR810709532218/RMCPL22429/1,1000.0,0.0,225555.16999998182,2018,4,20,DEBIT,1000.0,M815450270
9874,409000438620',2018-04-20,CR810712607580/RMCPL18231/1,10000.0,0.0,215555.16999998182,2018,4,20,CHECK_WITHDRAWAL,10000.0,C362023079
9875,409000438620',2018-04-20,CR810710546195/RMCPL22580/1,3000.0,0.0,212555.16999998182,2018,4,20,DEBIT,3000.0,M828093115
9876,409000438620',2018-04-20,CR810712594479/RMCPL18244/1,500.0,0.0,212055.16999998182,2018,4,20,CASH_OUT,500.0,M2089817542
9877,409000438620',2018-04-20,CR810709532224/RMCPL21130/1,5000.0,0.0,207055.16999998182,2018,4,20,CHECK_WITHDRAWAL,5000.0,M1519387873
9878,409000438620',2018-04-20,CR810711569215/RMCPL11784/1,2000.0,0.0,205055.16999998182,2018,4,20,DEBIT,2000.0,M1770950314
9879,409000438620',2018-04-20,CR810712594480/RMCPL22610/1,2000.0,0.0,203055.16999998182,2018,4,20,DEBIT,2000.0,C304528024
9880,409000438620',2018-04-20,CR810712594485/RMCPL13859/1,1500.0,0.0,201555.16999998182,2018,4,20,CASH_OUT,1500.0,M38294309
9881,409000438620',2018-04-20,CR810710546183/RMCPL24551/1,4000.0,0.0,197555.16999998182,2018,4,20,CHECK_WITHDRAWAL,4000.0,M1982081836
9882,409000438620',2018-04-20,CR810714633840/RMCPL20307/1,1000.0,0.0,196555.16999998182,2018,4,20,PAYEMENT,1000.0,M1844118795
9883,409000438620',2018-04-20,CR810714632158/RMCPL20284/1,500.0,0.0,196055.16999998182,2018,4,20,CHECK_WITHDRAWAL,500.0,C1028574311
9884,409000438620',2018-04-20,CR810711582116/RMCPL21675/1,4000.0,0.0,192055.16999998182,2018,4,20,CASH_OUT,4000.0,C316486913
9885,409000438620',2018-04-20,CR810711582121/RMCPL18254/1,1000.0,0.0,191055.16999998182,2018,4,20,DEBIT,1000.0,M454049792
9886,409000438620',2018-04-20,CR810712607578/RMCPL18486/1,4500.0,0.0,186555.16999998182,2018,4,20,DEBIT,4500.0,M487512024
9887,409000438620',2018-04-20,CR810713621405/RMCPL11793/1,4000.0,0.0,182555.16999998182,2018,4,20,PAYEMENT,4000.0,C1475998599
9888,409000438620',2018-04-20,CR810711569206/RMCPL22950/1,500.0,0.0,182055.16999998182,2018,4,20,PAYEMENT,500.0,M1181666809
9889,409000438620',2018-04-20,CR810711582125/RMCPL23269/1,2000.0,0.0,180055.16999998182,2018,4,20,CASH_OUT,2000.0,M1330697616
9890,409000438620',2018-04-20,CR810613320438/RMCPL09726/1,1000.0,0.0,179055.16999998182,2018,4,20,PAYEMENT,1000.0,M1314489099
9891,409000438620',2018-04-20,CR810610263609/RMCPL14558/1,1000.0,0.0,178055.16999998182,2018,4,20,PAYEMENT,1000.0,M21508699
9892,409000438620',2018-04-20,CR810610251307/RMCPL19701/1,2000.0,0.0,176055.16999998182,2018,4,20,CASH_OUT,2000.0,C1609562230
9893,409000438620',2018-04-20,CR810609232148/RMCPL24928/1,1000.0,0.0,175055.16999998182,2018,4,20,CHECK_WITHDRAWAL,1000.0,M500513427
9894,409000438620',2018-04-20,CR810616359876/RMCPL20427/1,1000.0,0.0,174055.16999998182,2018,4,20,PAYEMENT,1000.0,M1021904626
9895,409000438620',2018-04-20,CR810610251306/RMCPL20358/1,500.0,0.0,173555.16999998182,2018,4,20,PAYEMENT,500.0,M2001356172
9896,409000438620',2018-04-20,CR810610251355/RMCPL20913/1,2000.0,0.0,171555.16999998182,2018,4,20,DEBIT,2000.0,M642143005
9897,409000438620',2018-04-20,CR810610263554/RMCPL12838/1,4500.0,0.0,167055.16999998182,2018,4,20,DEBIT,4500.0,M1060171806
9898,409000438620',2018-04-20,CR810611287694/RMCPL22799/1,5000.0,0.0,162055.16999998182,2018,4,20,PAYEMENT,5000.0,M422397815
9899,409000438620',2018-04-20,CR810616372180/RMCPL15209/1,500.0,0.0,161555.16999998182,2018,4,20,DEBIT,500.0,C1408337297
9900,409000438620',2018-04-20,CR810609232811/RMCPL24472/1,500.0,0.0,161055.16999998182,2018,4,20,CHECK_WITHDRAWAL,500.0,M312367354
9901,409000438620',2018-04-20,CR810609232091/RMCPL17352/1,10000.0,0.0,151055.16999998182,2018,4,20,DEBIT,10000.0,M151746461
9902,409000438620',2018-04-20,CR810613308069/RMCPL16151/1,500.0,0.0,150555.16999998182,2018,4,20,CASH_OUT,500.0,M2091512081
9903,409000438620',2018-04-20,CR810616372174/RMCPL17678/1,500.0,0.0,150055.16999998182,2018,4,20,PAYEMENT,500.0,C1635341595
9904,409000438620',2018-04-20,CR810609231682/RMCPL10689/1,3000.0,0.0,147055.16999998182,2018,4,20,DEBIT,3000.0,C2125012025
9905,409000438620',2018-04-20,CR810609232324/RMCPL23829/1,2000.0,0.0,145055.16999998182,2018,4,20,PAYEMENT,2000.0,M1016260610
9906,409000438620',2018-04-20,CR810613308064/RMCPL10937/1,4000.0,0.0,141055.16999998182,2018,4,20,PAYEMENT,4000.0,M1200411368
9907,409000438620',2018-04-21,Indiaforensic AEPS NPCI WDL SET,0.0,25689200.0,25830255.169999983,2018,4,21,CHECK_CASHING,25689200.0,C1888703417
9908,409000438620',2018-04-21,Indiaforensic NON RD CHG OCT17TO,1480210.6,0.0,24350044.56999998,2018,4,21,CASH_OUT,1480210.6,M615459073
9909,409000438620',2018-04-21,Indfor-IFC NONRD CHG OCT17TO,46.0,0.0,24349998.56999998,2018,4,21,CASH_OUT,46.0,C1003872245
9910,409000438620',2018-04-21,Indiaforensic NON RD GST OCT17TO,266437.91,0.0,24083560.65999998,2018,4,21,CHECK_WITHDRAWAL,266437.91,M1737768779
9911,409000438620',2018-04-21,Indfor-IFC NONRD GST OCT17TO,8.28,0.0,24083552.37999998,2018,4,21,CHECK_WITHDRAWAL,8.28,C490150701
9912,409000438620',2018-04-21,TRF TO  Indiaforensic SERVICES I,15000000.0,0.0,9083552.37999998,2018,4,21,CHECK_WITHDRAWAL,15000000.0,M1793114195
9913,409000438620',2018-04-21,TRF TO  Indiaforensic SERVICES I,5000000.0,0.0,4083552.37999998,2018,4,21,CASH_OUT,5000000.0,M1636265486
9914,409000438620',2018-04-21,TRF TO  Indiaforensic SERVICES I,4000000.0,0.0,83552.37999998032,2018,4,21,PAYEMENT,4000000.0,M1068004739
9915,409000438620',2018-04-21,AEPS ACQ CR ADJ FEES 2004,70.8,0.0,83481.57999998033,2018,4,21,CHECK_WITHDRAWAL,70.8,C683605346
9916,409000438620',2018-04-21,CR810809860497/RMCPL12343/1,1000.0,0.0,82481.57999998033,2018,4,21,CHECK_WITHDRAWAL,1000.0,M1785366805
9917,409000438620',2018-04-21,CR810809860519/RMCPL11566/1,1000.0,0.0,81481.57999998033,2018,4,21,CASH_OUT,1000.0,M428533618
9918,409000438620',2018-04-21,CR810810874422/RMCPL18381/1,5000.0,0.0,76481.57999998033,2018,4,21,PAYEMENT,5000.0,C1274461229
9919,409000438620',2018-04-21,CR810810874437/RMCPL12343/1,5000.0,0.0,71481.57999998033,2018,4,21,CHECK_WITHDRAWAL,5000.0,M485859751
9920,409000438620',2018-04-21,CR810810874457/RMCPL25168/1,1000.0,0.0,70481.57999998033,2018,4,21,DEBIT,1000.0,C1266035080
9921,409000438620',2018-04-21,CR810812914748/RMCPL14698/1,5500.0,0.0,64981.57999998032,2018,4,21,CHECK_WITHDRAWAL,5500.0,M217212459
9922,409000438620',2018-04-21,AEPS Indiaforensic INCOME 200418,0.0,68405.55,133387.12999998033,2018,4,21,CASH_IN,68405.55,M1016151684
9923,409000438620',2018-04-21,AEPS Indiaforensic GST 200418,0.0,12313.0,145700.12999998033,2018,4,21,CHECK_CASHING,12313.0,M843047413
9924,409000438620',2018-04-23,Indiaforensic AEPS NPCI WDL SET,0.0,25149900.0,25295600.12999998,2018,4,23,TRANSFER,25149900.0,M1652934423
9925,409000438620',2018-04-23,Indiaforensic AEPS NPCI WDL SET,0.0,18170800.0,43466400.12999998,2018,4,23,CHECK_CASHING,18170800.0,C1286084959
9926,409000438620',2018-04-23,TRF TO  Indiaforensic SERVICES I,15000000.0,0.0,28466400.12999998,2018,4,23,PAYEMENT,15000000.0,M1618514840
9927,409000438620',2018-04-23,TRF TO  Indiaforensic SERVICES I,15000000.0,0.0,13466400.12999998,2018,4,23,CASH_OUT,15000000.0,C1603338883
9928,409000438620',2018-04-23,TRF TO  Indiaforensic SERVICES I,10000000.0,0.0,3466400.1299999813,2018,4,23,PAYEMENT,10000000.0,C1850803964
9929,409000438620',2018-04-23,TRF TO  Indiaforensic SERVICES I,3000000.0,0.0,466400.12999998033,2018,4,23,PAYEMENT,3000000.0,C184253187
9930,409000438620',2018-04-23,AEPS Indiaforensic INCOME 210418,0.0,67816.39,534216.5199999803,2018,4,23,TRANSFER,67816.39,C909295153
9931,409000438620',2018-04-23,AEPS Indiaforensic GST 210418,0.0,12206.95,546423.4699999803,2018,4,23,CASH_IN,12206.95,C346008447
9932,409000438620',2018-04-23,AEPS Indiaforensic INCOME 220418,0.0,49907.98,596331.4499999803,2018,4,23,TRANSFER,49907.98,C1459757869
9933,409000438620',2018-04-23,AEPS Indiaforensic GST 220418,0.0,8983.44,605314.8899999802,2018,4,23,CHECK_CASHING,8983.44,C898762325
9934,409000438620',2018-04-23,AEPS ACQUIRING ADJ FEES 2,73.75,0.0,605241.1399999802,2018,4,23,CHECK_WITHDRAWAL,73.75,C1627965794
9935,409000438620',2018-04-23,AEPS ACQ CR ADJ FEES 2104,191.75,0.0,605049.3899999802,2018,4,23,PAYEMENT,191.75,C1682264452
9936,409000438620',2018-04-23,CR810912229860/RMCPL24995/1,500.0,0.0,604549.3899999802,2018,4,23,CASH_OUT,500.0,C1217400138
9937,409000438620',2018-04-23,CR810911197212/RMCPL20185/1,2000.0,0.0,602549.3899999802,2018,4,23,CHECK_WITHDRAWAL,2000.0,M1555562654
9938,409000438620',2018-04-23,CR810912229875/RMCPL21532/1,1500.0,0.0,601049.3899999802,2018,4,23,DEBIT,1500.0,C93518808
9939,409000438620',2018-04-23,CR810912229861/RMCPL13859/1,2000.0,0.0,599049.3899999802,2018,4,23,DEBIT,2000.0,C1636786811
9940,409000438620',2018-04-23,CR810912220583/RMCPL12563/1,10000.0,0.0,589049.3899999802,2018,4,23,PAYEMENT,10000.0,C1746038925
9941,409000438620',2018-04-23,CR810910173136/RMCPL17167/1,2000.0,0.0,587049.3899999802,2018,4,23,DEBIT,2000.0,C1967017653
9942,409000438620',2018-04-23,CR810912229843/RMCPL22607/1,1000.0,0.0,586049.3899999802,2018,4,23,PAYEMENT,1000.0,M481820277
9943,409000438620',2018-04-23,CR810912229867/RMCPL16427/1,1000.0,0.0,585049.3899999802,2018,4,23,CHECK_WITHDRAWAL,1000.0,M44206143
9944,409000438620',2018-04-23,CR810912229862/RMCPL12794/1,2000.0,0.0,583049.3899999802,2018,4,23,DEBIT,2000.0,M1807764104
9945,409000438620',2018-04-23,CR810912220565/RMCPL12343/1,1000.0,0.0,582049.3899999802,2018,4,23,CASH_OUT,1000.0,M1284226142
9946,409000438620',2018-04-23,CR810917297684/RMCPL20241/1,2500.0,0.0,579549.3899999802,2018,4,23,CASH_OUT,2500.0,M1471033105
9947,409000438620',2018-04-23,CR810911197226/RMCPL11827/1,10000.0,0.0,569549.3899999802,2018,4,23,CASH_OUT,10000.0,M1830918135
9948,409000438620',2018-04-23,CR810912229863/RMCPL20434/1,1500.0,0.0,568049.3899999802,2018,4,23,DEBIT,1500.0,M1746136350
9949,409000438620',2018-04-23,CR810910173141/RMCPL17468/1,4000.0,0.0,564049.3899999802,2018,4,23,CHECK_WITHDRAWAL,4000.0,M955200837
9950,409000438620',2018-04-23,CR810912229841/RMCPL23228/1,1500.0,0.0,562549.3899999802,2018,4,23,CASH_OUT,1500.0,M494478532
9951,409000438620',2018-04-23,CR810912220563/RMCPL21906/1,3500.0,0.0,559049.3899999802,2018,4,23,PAYEMENT,3500.0,M30244322
9952,409000438620',2018-04-23,CR810912229842/RMCPL14405/1,2000.0,0.0,557049.3899999802,2018,4,23,PAYEMENT,2000.0,M361705653
9953,409000438620',2018-04-24,Indiaforensic AEPS NPCI WDL SET,0.0,31002300.0,31559349.389999986,2018,4,24,CHECK_CASHING,31002300.0,M1995075465
9954,409000438620',2018-04-24,TRF TO  Indiaforensic SERVICES I,15000000.0,0.0,16559349.389999982,2018,4,24,CHECK_WITHDRAWAL,15000000.0,M2020615285
9955,409000438620',2018-04-24,TRF TO  Indiaforensic SERVICES I,15000000.0,0.0,1559349.389999982,2018,4,24,PAYEMENT,15000000.0,M1349556684
9956,409000438620',2018-04-24,TRF TO  Indiaforensic SERVICES I,1000000.0,0.0,559349.3899999821,2018,4,24,DEBIT,1000000.0,M139134521
9957,409000438620',2018-04-24,TRF TO  Indiaforensic SERVICES I,500000.0,0.0,59349.38999998197,2018,4,24,PAYEMENT,500000.0,M817385267
9958,409000438620',2018-04-24,AEPS ACQUIRING ADJ FEES 2,2.95,0.0,59346.43999998197,2018,4,24,CHECK_WITHDRAWAL,2.95,M531832315
9959,409000438620',2018-04-24,AEPS Indiaforensic INCOME 230418,0.0,83504.22,142850.659999982,2018,4,24,CASH_IN,83504.22,M419563367
9960,409000438620',2018-04-24,AEPS Indiaforensic GST 230418,0.0,15030.76,157881.419999982,2018,4,24,TRANSFER,15030.76,M474335405
9961,409000438620',2018-04-25,Indiaforensic AEPS NPCI WDL SET,0.0,28689300.0,28847181.419999983,2018,4,25,TRANSFER,28689300.0,M1992306754
9962,409000438620',2018-04-25,TRF TO  Indiaforensic SERVICES I,15000000.0,0.0,13847181.419999985,2018,4,25,PAYEMENT,15000000.0,M756176465
9963,409000438620',2018-04-25,TRF TO  Indiaforensic SERVICES I,13800000.0,0.0,47181.41999998316,2018,4,25,CASH_OUT,13800000.0,M619056534
9964,409000438620',2018-04-25,AEPS Indiaforensic INCOME 240418,0.0,78195.81,125377.22999998314,2018,4,25,CHECK_CASHING,78195.81,M65816598
9965,409000438620',2018-04-25,AEPS Indiaforensic GST 240418,0.0,14075.25,139452.47999998313,2018,4,25,CHECK_CASHING,14075.25,M1606749232
9966,409000438620',2018-04-25,AEPS ACQ REP ADJ FEES 240,0.0,76.7,139529.17999998314,2018,4,25,TRANSFER,76.7,M467058299
9967,409000438620',2018-04-26,Indiaforensic AEPS NPCI WDL SET,0.0,27061600.0,27201129.179999985,2018,4,26,CHECK_CASHING,27061600.0,M2120220238
9968,409000438620',2018-04-26,TRF TO  Indiaforensic SERVICES I,12200000.0,0.0,15001129.179999985,2018,4,26,DEBIT,12200000.0,M1967442274
9969,409000438620',2018-04-26,TRF TO  Indiaforensic SERVICES I,15000000.0,0.0,1129.1799999848008,2018,4,26,PAYEMENT,15000000.0,C912252532
9970,409000438620',2018-04-26,AEPS Indiaforensic INCOME 250418,0.0,72475.22,73604.3999999848,2018,4,26,CASH_IN,72475.22,M1012264852
9971,409000438620',2018-04-26,AEPS Indiaforensic GST 250418,0.0,13045.54,86649.93999998481,2018,4,26,CHECK_CASHING,13045.54,M949085832
9972,409000438620',2018-04-26,AEPS ACQUIRING ADJ FEES 2,17.7,0.0,86632.23999998481,2018,4,26,CHECK_WITHDRAWAL,17.7,C1849933855
9973,409000438620',2018-04-27,CR811311334831/RMCPL19730/2,1000.0,0.0,85632.23999998481,2018,4,27,CHECK_WITHDRAWAL,1000.0,C2057394816
9974,409000438620',2018-04-27,CR811316443434/RMCPL15112/2,1000.0,0.0,84632.23999998481,2018,4,27,CASH_OUT,1000.0,M221494920
9975,409000438620',2018-04-27,CR811317460579/RMCPL23035/2,1500.0,0.0,83132.23999998481,2018,4,27,DEBIT,1500.0,M1299202584
9976,409000438620',2018-04-27,CR811317460597/RMCPL13376/2,500.0,0.0,82632.23999998481,2018,4,27,CHECK_WITHDRAWAL,500.0,M1793499598
9977,409000438620',2018-04-27,CR811312356000/RMCPL24759/2,3000.0,0.0,79632.23999998481,2018,4,27,CHECK_WITHDRAWAL,3000.0,M302334799
9978,409000438620',2018-04-27,CR811311334841/RMCPL23398/2,500.0,0.0,79132.23999998481,2018,4,27,CHECK_WITHDRAWAL,500.0,M994708886
9979,409000438620',2018-04-27,CR811311334832/RMCPL20827/2,7000.0,0.0,72132.23999998481,2018,4,27,DEBIT,7000.0,C1479813516
9980,409000438620',2018-04-27,CR811311334836/RMCPL18189/2,2000.0,0.0,70132.23999998481,2018,4,27,CASH_OUT,2000.0,C346008447
9981,409000438620',2018-04-27,CR811312367814/RMCPL18061/2,2000.0,0.0,68132.23999998481,2018,4,27,PAYEMENT,2000.0,M1835123749
9982,409000438620',2018-04-27,CR811309298733/RMCPL22246/2,3000.0,0.0,65132.23999998481,2018,4,27,CASH_OUT,3000.0,C657255537
9983,409000438620',2018-04-27,CR811316443395/RMCPL24836/2,3000.0,0.0,62132.23999998481,2018,4,27,DEBIT,3000.0,C1653433120
9984,409000438620',2018-04-27,CR811317460571/RMCPL22523/2,5000.0,0.0,57132.23999998481,2018,4,27,CHECK_WITHDRAWAL,5000.0,M1799528748
9985,409000438620',2018-04-27,CR811111787813/RMCPL16727/2,1000.0,0.0,56132.23999998481,2018,4,27,CASH_OUT,1000.0,C416519915
9986,409000438620',2018-04-27,CR811111787824/RMCPL16736/2,3000.0,0.0,53132.23999998481,2018,4,27,PAYEMENT,3000.0,M1805268033
9987,409000438620',2018-04-27,CR811110774799/RMCPL24926/2,2100.0,0.0,51032.23999998481,2018,4,27,CHECK_WITHDRAWAL,2100.0,C1343642221
9988,409000438620',2018-04-27,CR811113822338/RMCPL11784/2,500.0,0.0,50532.23999998481,2018,4,27,PAYEMENT,500.0,M1695685784
9989,409000438620',2018-04-27,CR811113822370/RMCPL21107/2,1500.0,0.0,49032.23999998481,2018,4,27,CHECK_WITHDRAWAL,1500.0,M935982369
9990,409000438620',2018-04-27,CR811110774831/RMCPL13859/2,2500.0,0.0,46532.23999998481,2018,4,27,PAYEMENT,2500.0,M1572768026
9991,409000438620',2018-04-27,CR811113822367/RMCPL13124/2,600.0,0.0,45932.23999998481,2018,4,27,CASH_OUT,600.0,C676931970
9992,409000438620',2018-04-27,CR811009460540/RMCPL15764/2,500.0,0.0,45432.23999998481,2018,4,27,DEBIT,500.0,C2113508588
9993,409000438620',2018-04-27,CR811009460543/RMCPL19297/2,1000.0,0.0,44432.23999998481,2018,4,27,PAYEMENT,1000.0,M375314189
9994,409000438620',2018-04-27,CR811009456459/RMCPL18217/2,6000.0,0.0,38432.23999998481,2018,4,27,PAYEMENT,6000.0,M714481123
9995,409000438620',2018-04-27,CR811011490074/RMCPL23898/2,10000.0,0.0,28432.239999984813,2018,4,27,PAYEMENT,10000.0,M2128130537
9996,409000438620',2018-04-27,CR811013531324/RMCPL07629/2,2500.0,0.0,25932.23999998481,2018,4,27,CHECK_WITHDRAWAL,2500.0,M1108211033
9997,409000438620',2018-04-27,CR811011490072/RMCPL18042/2,10000.0,0.0,15932.239999984811,2018,4,27,DEBIT,10000.0,M277524255
9998,409000438620',2018-04-27,CR811016588106/RMCPL25199/2,500.0,0.0,15432.239999984811,2018,4,27,CASH_OUT,500.0,C1935506329
9999,409000438620',2018-04-27,CR811015560945/RMCPL12343/2,500.0,0.0,14932.239999984811,2018,4,27,CHECK_WITHDRAWAL,500.0,M176755220
10000,409000438620',2018-04-27,CR811011496631/RMCPL18408/2,5000.0,0.0,9932.239999984811,2018,4,27,DEBIT,5000.0,C1787868648
10001,409000438620',2018-04-27,CR811016588099/RMCPL22063/2,2500.0,0.0,7432.239999984813,2018,4,27,PAYEMENT,2500.0,M916634690
10002,409000438620',2018-04-27,Indiaforensic AEPS NPCI WDL SET,0.0,28401000.0,28408432.239999983,2018,4,27,CASH_IN,28401000.0,M1313722236
10003,409000438620',2018-04-27,TRF TO  Indiaforensic SERVICES I,15000000.0,0.0,13408432.239999985,2018,4,27,DEBIT,15000000.0,M2000407747
10004,409000438620',2018-04-27,TRF TO  Indiaforensic SERVICES I,13400000.0,0.0,8432.23999998346,2018,4,27,CASH_OUT,13400000.0,M1801565096
10005,409000438620',2018-04-27,AEPS ACQUIRING CR ADJ FEE,319.78,0.0,8112.459999983459,2018,4,27,CASH_OUT,319.78,M1468907424
10006,409000438620',2018-04-27,AEPS ACQUIRING REP ADJ FE,0.0,5.9,8118.35999998346,2018,4,27,CHECK_CASHING,5.9,C1621383518
10007,409000438620',2018-04-27,AEPS Indiaforensic INCOME 260418,0.0,76940.71,85059.06999998346,2018,4,27,TRANSFER,76940.71,M1888423382
10008,409000438620',2018-04-27,AEPS Indiaforensic GST 260418,0.0,13849.33,98908.39999998346,2018,4,27,TRANSFER,13849.33,M1776042738
10009,409000438620',2018-04-30,Indiaforensic AEPS NPCI WDL SET,0.0,28639700.0,28738608.399999984,2018,4,30,TRANSFER,28639700.0,C128321421
10010,409000438620',2018-04-30,Indiaforensic AEPS NPCI WDL SET,0.0,24446700.0,53185308.39999998,2018,4,30,TRANSFER,24446700.0,M270284851
10011,409000438620',2018-04-30,Indiaforensic AEPS NPCI WDL SET,0.0,12961800.0,66147108.39999998,2018,4,30,CASH_IN,12961800.0,C1508631684
10012,409000438620',2018-04-30,AEPS Indiaforensic INCOME 270418,0.0,76524.24,66223632.63999999,2018,4,30,CASH_IN,76524.24,C30079792
10013,409000438620',2018-04-30,AEPS Indiaforensic GST 270418,0.0,13774.36,66237406.99999999,2018,4,30,CASH_IN,13774.36,M675546409
10014,409000438620',2018-04-30,AEPS Indiaforensic INCOME 280418,0.0,64691.31,66302098.30999999,2018,4,30,CASH_IN,64691.31,M123358369
10015,409000438620',2018-04-30,AEPS Indiaforensic GST 280418,0.0,11644.44,66313742.74999999,2018,4,30,CHECK_CASHING,11644.44,M357650628
10016,409000438620',2018-04-30,AEPS Indiaforensic INCOME 290418,0.0,36150.66,66349893.40999998,2018,4,30,TRANSFER,36150.66,M1165527660
10017,409000438620',2018-04-30,AEPS Indiaforensic GST 290418,0.0,6507.12,66356400.52999998,2018,4,30,TRANSFER,6507.12,C341156724
10018,409000438620',2018-04-30,AEPS ACQUIRING ADJ FEES 2,17.7,0.0,66356382.82999998,2018,4,30,CASH_OUT,17.7,M1672183035
10019,409000438620',2018-04-30,AEPS ACQ CR ADJ FEES 2704,144.55,0.0,66356238.27999998,2018,4,30,PAYEMENT,144.55,M1244394115
10020,409000438620',2018-04-30,CR811511963467/RMCPL10677/2,5000.0,0.0,66351238.27999998,2018,4,30,CHECK_WITHDRAWAL,5000.0,C968448640
10021,409000438620',2018-04-30,CR811510953138/RMCPL22919/2,500.0,0.0,66350738.27999998,2018,4,30,CASH_OUT,500.0,M1875336604
10022,409000438620',2018-04-30,CR811512989522/RMCPL20772/2,500.0,0.0,66350238.27999998,2018,4,30,PAYEMENT,500.0,M1752953998
10023,409000438620',2018-04-30,CR811511975295/RMCPL18215/2,10000.0,0.0,66340238.27999998,2018,4,30,CASH_OUT,10000.0,M813847747
10024,409000438620',2018-04-30,CR811512989506/RMCPL23152/2,1000.0,0.0,66339238.27999998,2018,4,30,DEBIT,1000.0,M356333043
10025,409000438620',2018-04-30,CR811512989515/RMCPL09897/2,1500.0,0.0,66337738.27999998,2018,4,30,CHECK_WITHDRAWAL,1500.0,M876013030
10026,409000438620',2018-04-30,CR811510953150/RMCPL17403/2,5500.0,0.0,66332238.27999998,2018,4,30,DEBIT,5500.0,M1104263512
10027,409000438620',2018-04-30,CR811510940598/RMCPL15377/2,5000.0,0.0,66327238.27999998,2018,4,30,PAYEMENT,5000.0,M1351933416
10028,409000438620',2018-04-30,CR811511975301/RMCPL20510/2,3000.0,0.0,66324238.27999998,2018,4,30,PAYEMENT,3000.0,C542220524
10029,409000438620',2018-04-30,CR811511963466/RMCPL22837/2,10000.0,0.0,66314238.27999998,2018,4,30,PAYEMENT,10000.0,C1052170153
10030,409000438620',2018-04-30,CR811517068859/RMCPL18011/2,8000.0,0.0,66306238.27999998,2018,4,30,CASH_OUT,8000.0,M147678773
10031,409000438620',2018-04-30,AEPS ACQ REP ADJ FEES 270,0.0,17.7,66306255.97999998,2018,4,30,CHECK_CASHING,17.7,M2137865445
10032,409000438620',2018-05-01,Indiaforensic AEPS NPCI WDL SET,0.0,19262800.0,85569055.97999999,2018,5,1,CASH_IN,19262800.0,M1714745873
10033,409000438620',2018-05-01,TRF TO  Indiaforensic SERVICES I,15000000.0,0.0,70569055.97999999,2018,5,1,DEBIT,15000000.0,M1185727016
10034,409000438620',2018-05-01,TRF TO  Indiaforensic SERVICES I,15000000.0,0.0,55569055.97999999,2018,5,1,PAYEMENT,15000000.0,M1547405018
10035,409000438620',2018-05-01,TRF TO  Indiaforensic SERVICES I,15000000.0,0.0,40569055.97999999,2018,5,1,PAYEMENT,15000000.0,M787647307
10036,409000438620',2018-05-01,TRF TO  Indiaforensic SERVICES I,10000000.0,0.0,30569055.97999999,2018,5,1,PAYEMENT,10000000.0,M1100398651
10037,409000438620',2018-05-01,TRF TO  Indiaforensic SERVICES I,10000000.0,0.0,20569055.97999999,2018,5,1,PAYEMENT,10000000.0,C11003494
10038,409000438620',2018-05-01,AEPS ACQUIRING ADJ FEES 3,17.7,0.0,20569038.27999999,2018,5,1,DEBIT,17.7,M363565965
10039,409000438620',2018-05-01,AEPS Indiaforensic INCOME 300418,0.0,51608.43,20620646.70999999,2018,5,1,CHECK_CASHING,51608.43,M1251980777
10040,409000438620',2018-05-01,AEPS Indiaforensic GST 300418,0.0,9289.52,20629936.22999999,2018,5,1,CHECK_CASHING,9289.52,M39857989
10041,409000438620',2018-05-01,TRF TO  Indiaforensic SERVICES I,5500000.0,0.0,15129936.22999999,2018,5,1,DEBIT,5500000.0,C1805683209
10042,409000438620',2018-05-01,TRF TO  Indiaforensic SERVICES I,15000000.0,0.0,129936.22999998927,2018,5,1,DEBIT,15000000.0,C977993101
10043,409000438620',2018-05-02,Indiaforensic AEPS NPCI WDL SET,0.0,24817400.0,24947336.22999999,2018,5,2,CHECK_CASHING,24817400.0,M806302890
10044,409000438620',2018-05-02,TRF TO  Indiaforensic SERVICES I,15000000.0,0.0,9947336.22999999,2018,5,2,CASH_OUT,15000000.0,M961671136
10045,409000438620',2018-05-02,TRF TO  Indiaforensic SERVICES I,9900000.0,0.0,47336.22999998927,2018,5,2,PAYEMENT,9900000.0,M1926931478
10046,409000438620',2018-05-02,AEPS ACQ REP ADJ FEES 010,0.0,17.7,47353.92999998927,2018,5,2,CASH_IN,17.7,M935577259
10047,409000438620',2018-05-03,Indiaforensic AEPS NPCI WDL SET,0.0,27620500.0,27667853.92999999,2018,5,3,CASH_IN,27620500.0,M1614477207
10048,409000438620',2018-05-03,CR811812844473/RMCPL12334/2,1000.0,0.0,27666853.92999999,2018,5,3,DEBIT,1000.0,M282827877
10049,409000438620',2018-05-03,CR811812844469/RMCPL22724/2,2400.0,0.0,27664453.92999999,2018,5,3,CHECK_WITHDRAWAL,2400.0,M1492742127
10050,409000438620',2018-05-03,CR811812844480/RMCPL25136/2,500.0,0.0,27663953.92999999,2018,5,3,CHECK_WITHDRAWAL,500.0,M176950381
10051,409000438620',2018-05-03,CR811812844481/RMCPL19554/2,500.0,0.0,27663453.92999999,2018,5,3,DEBIT,500.0,C1787868648
10052,409000438620',2018-05-03,CR811711555043/RMCPL12832/2,2500.0,0.0,27660953.92999999,2018,5,3,PAYEMENT,2500.0,M823978176
10053,409000438620',2018-05-03,CR811711555032/RMCPL22583/2,5000.0,0.0,27655953.92999999,2018,5,3,CASH_OUT,5000.0,C295372946
10054,409000438620',2018-05-03,CR811709527835/RMCPL19910/2,2500.0,0.0,27653453.92999999,2018,5,3,CASH_OUT,2500.0,M1687989795
10055,409000438620',2018-05-03,CR811709527839/RMCPL18508/2,2000.0,0.0,27651453.92999999,2018,5,3,PAYEMENT,2000.0,M573965573
10056,409000438620',2018-05-03,CR811709527858/RMCPL18236/2,4000.0,0.0,27647453.92999999,2018,5,3,CHECK_WITHDRAWAL,4000.0,M207769564
10057,409000438620',2018-05-03,CR811710542711/RMCPL23088/2,2000.0,0.0,27645453.92999999,2018,5,3,DEBIT,2000.0,C1787868648
10058,409000438620',2018-05-03,CR811712574047/RMCPL23958/2,1000.0,0.0,27644453.92999999,2018,5,3,CHECK_WITHDRAWAL,1000.0,C801142660
10059,409000438620',2018-05-03,CR811712574062/RMCPL24219/2,2000.0,0.0,27642453.92999999,2018,5,3,DEBIT,2000.0,C1262822392
10060,409000438620',2018-05-03,CR811710542704/RMCPL17468/2,10000.0,0.0,27632453.92999999,2018,5,3,CASH_OUT,10000.0,C991505714
10061,409000438620',2018-05-03,CR811711567977/RMCPL13859/2,600.0,0.0,27631853.92999999,2018,5,3,PAYEMENT,600.0,C465257140
10062,409000438620',2018-05-03,CR812016407412/RMCPL25621/3,1000.0,0.0,27630853.92999999,2018,5,3,CASH_OUT,1000.0,C1915624447
10063,409000438620',2018-05-03,CR812013359147/RMCPL24103/3,10000.0,0.0,27620853.92999999,2018,5,3,PAYEMENT,10000.0,C684896216
10064,409000438620',2018-05-03,CR811611275502/RMCPL25418/2,3000.0,0.0,27617853.92999999,2018,5,3,DEBIT,3000.0,C1761353343
10065,409000438620',2018-05-03,CR811613307254/RMCPL16402/2,1000.0,0.0,27616853.92999999,2018,5,3,CHECK_WITHDRAWAL,1000.0,C1298316171
10066,409000438620',2018-05-03,CR811611275525/RMCPL18236/2,500.0,0.0,27616353.92999999,2018,5,3,CHECK_WITHDRAWAL,500.0,M983553548
10067,409000438620',2018-05-03,CR811611275540/RMCPL15794/2,5600.0,0.0,27610753.92999999,2018,5,3,CHECK_WITHDRAWAL,5600.0,M609545864
10068,409000438620',2018-05-03,CR811609221222/RMCPL24928/2,500.0,0.0,27610253.92999999,2018,5,3,DEBIT,500.0,C1648214200
10069,409000438620',2018-05-03,CR811611275539/RMCPL25362/2,500.0,0.0,27609753.92999999,2018,5,3,CHECK_WITHDRAWAL,500.0,M689460139
10070,409000438620',2018-05-03,CR811612297279/RMCPL14683/2,500.0,0.0,27609253.92999999,2018,5,3,CASH_OUT,500.0,C911380925
10071,409000438620',2018-05-03,CR811613307262/RMCPL19390/2,4000.0,0.0,27605253.92999999,2018,5,3,CHECK_WITHDRAWAL,4000.0,C459172227
10072,409000438620',2018-05-03,CR811611275536/RMCPL24897/2,500.0,0.0,27604753.92999999,2018,5,3,PAYEMENT,500.0,C1475395523
10073,409000438620',2018-05-03,CR811609221195/RMCPL13859/2,1000.0,0.0,27603753.92999999,2018,5,3,PAYEMENT,1000.0,M761677220
10074,409000438620',2018-05-03,CR811609210928/RMCPL15154/2,9000.0,0.0,27594753.92999999,2018,5,3,PAYEMENT,9000.0,M2093512793
10075,409000438620',2018-05-03,TRF TO  Indiaforensic SERVICES I,15000000.0,0.0,12594753.929999987,2018,5,3,DEBIT,15000000.0,M1519192517
10076,409000438620',2018-05-03,TRF TO  Indiaforensic SERVICES I,12500000.0,0.0,94753.92999998851,2018,5,3,CHECK_WITHDRAWAL,12500000.0,M1193352814
10077,409000438620',2018-05-03,AEPS ACQUIRING ADJ FEES 0,26.55,0.0,94727.37999998851,2018,5,3,PAYEMENT,26.55,M2037915255
10078,409000438620',2018-05-03,AEPS ACQ CR ADJ FEES 0205,274.35,0.0,94453.02999998852,2018,5,3,DEBIT,274.35,M1802531523
10079,409000438620',2018-05-03,AEPS ACQ REP ADJ FEES 020,0.0,17.7,94470.72999998851,2018,5,3,CHECK_CASHING,17.7,M1449171985
10080,409000438620',2018-05-04,Indiaforensic AEPS NPCI WDL SET,0.0,30402600.0,30497070.72999999,2018,5,4,CASH_IN,30402600.0,M1956355202
10081,409000438620',2018-05-04,TRF TO  Indiaforensic SERVICES I,15000000.0,0.0,15497070.72999999,2018,5,4,PAYEMENT,15000000.0,M1551911048
10082,409000438620',2018-05-04,TRF TO  Indiaforensic SERVICES I,15000000.0,0.0,497070.7299999893,2018,5,4,DEBIT,15000000.0,M1080786547
10083,409000438620',2018-05-04,TRF TO  Indiaforensic SERVICES I,300000.0,0.0,197070.72999998927,2018,5,4,PAYEMENT,300000.0,M114424917
10084,409000438620',2018-05-04,AEPS ACQUIRING ADJ FEES 0,8.85,0.0,197061.87999998927,2018,5,4,CASH_OUT,8.85,M291601516
10085,409000438620',2018-05-04,AEPS ACQ CR ADJ FEES 0305,64.9,0.0,196996.97999998927,2018,5,4,CHECK_WITHDRAWAL,64.9,C2040603986
10086,409000438620',2018-05-04,CR812112628693/RMCPL11120/0,500.0,0.0,196496.97999998927,2018,5,4,PAYEMENT,500.0,C1315729466
10087,409000438620',2018-05-04,CR812112628699/RMCPL17645/0,10000.0,0.0,186496.97999998927,2018,5,4,PAYEMENT,10000.0,M422714490
10088,409000438620',2018-05-04,CR812112628668/RMCPL21583/0,6500.0,0.0,179996.97999998927,2018,5,4,CASH_OUT,6500.0,M1132102865
10089,409000438620',2018-05-04,CR812112628679/RMCPL10401/0,10000.0,0.0,169996.97999998927,2018,5,4,PAYEMENT,10000.0,C1554540309
10090,409000438620',2018-05-04,CR812110591999/RMCPL18488/0,1500.0,0.0,168496.97999998927,2018,5,4,PAYEMENT,1500.0,M1517766493
10091,409000438620',2018-05-04,AEPS INCOME DT 01-05-2018,0.0,58698.25,227195.2299999893,2018,5,4,CHECK_CASHING,58698.25,M2078801733
10092,409000438620',2018-05-04,AEPS GST INC DT 01-05-201,0.0,11739.65,238934.8799999893,2018,5,4,CHECK_CASHING,11739.65,M1685710582
10093,409000438620',2018-05-04,AEPS INCOME DT 02-05-2018,0.0,65328.7,304263.57999998925,2018,5,4,CHECK_CASHING,65328.7,C1871794198
10094,409000438620',2018-05-04,AEPS GST INC DT 02-05-201,0.0,13065.74,317329.31999998924,2018,5,4,CHECK_CASHING,13065.74,M688069176
10095,409000438620',2018-05-04,AEPS INCOME DT 03-05-2018,0.0,71483.62,388812.93999998923,2018,5,4,TRANSFER,71483.62,M1035070395
10096,409000438620',2018-05-04,AEPS GST INC DT 03-05-201,0.0,14296.72,403109.6599999892,2018,5,4,TRANSFER,14296.72,C1218584230
10097,409000438620',2018-05-05,Indiaforensic AEPS NPCI WDL SET,0.0,29166700.0,29569809.65999999,2018,5,5,CASH_IN,29166700.0,C1410669831
10098,409000438620',2018-05-05,NEFT/000037499765/ICICI B,2000.0,0.0,29567809.65999999,2018,5,5,CHECK_WITHDRAWAL,2000.0,C1797686173
10099,409000438620',2018-05-05,TRF TO  Indiaforensic SERVICES I,10000000.0,0.0,19567809.65999999,2018,5,5,DEBIT,10000000.0,C1145835418
10100,409000438620',2018-05-05,TRF TO  Indiaforensic SERVICES I,5000000.0,0.0,14567809.659999987,2018,5,5,CASH_OUT,5000000.0,M276383650
10101,409000438620',2018-05-05,TRF TO  Indiaforensic SERVICES I,4000000.0,0.0,10567809.659999987,2018,5,5,DEBIT,4000000.0,M1419006874
10102,409000438620',2018-05-05,TRF TO  Indiaforensic SERVICES I,500000.0,0.0,10067809.659999987,2018,5,5,CHECK_WITHDRAWAL,500000.0,M1439000845
10103,409000438620',2018-05-05,TRF TO  Indiaforensic SERVICES I,10000000.0,0.0,67809.65999998897,2018,5,5,CHECK_WITHDRAWAL,10000000.0,C914293025
10104,409000438620',2018-05-05,AEPS INCOME DT 05-04-2018,0.0,69188.98,136998.63999998895,2018,5,5,TRANSFER,69188.98,M519974834
10105,409000438620',2018-05-05,AEPS GST INC DT 05-04-201,0.0,13837.8,150836.43999998894,2018,5,5,CHECK_CASHING,13837.8,M1644975502
10106,409000438620',2018-05-05,AEPS ACQUIRING ADJ FEES 0,256.65,0.0,150579.78999998895,2018,5,5,CASH_OUT,256.65,C257999182
10107,409000438620',2018-05-05,CB811412695732/RMCPL15589/2,1500.0,0.0,149079.78999998895,2018,5,5,CASH_OUT,1500.0,C766681183
10108,409000438620',2018-05-07,Indiaforensic AEPS NPCI WDL SET,0.0,26882600.0,27031679.78999999,2018,5,7,TRANSFER,26882600.0,C309167705
10109,409000438620',2018-05-07,Indiaforensic AEPS NPCI WDL SET,0.0,15156200.0,42187879.78999999,2018,5,7,CASH_IN,15156200.0,C1636786811
10110,409000438620',2018-05-07,TRF TO  Indiaforensic SERVICES I,12100000.0,0.0,30087879.78999999,2018,5,7,CASH_OUT,12100000.0,C935808590
10111,409000438620',2018-05-07,TRF TO  Indiaforensic SERVICES I,15000000.0,0.0,15087879.789999992,2018,5,7,CHECK_WITHDRAWAL,15000000.0,C1040847151
10112,409000438620',2018-05-07,TRF TO  Indiaforensic SERVICES I,15000000.0,0.0,87879.78999999166,2018,5,7,CASH_OUT,15000000.0,C476182975
10113,409000438620',2018-05-07,AEPS INCOME DT 05-05-2018,0.0,65486.93,153366.71999999165,2018,5,7,CASH_IN,65486.93,C33524623
10114,409000438620',2018-05-07,AEPS GST INC DT 05-05-201,0.0,13097.39,166464.10999999163,2018,5,7,CASH_IN,13097.39,C801142660
10115,409000438620',2018-05-07,AEPS INCOME DT 06-05-2018,0.0,37279.9,203744.00999999171,2018,5,7,TRANSFER,37279.9,C675203915
10116,409000438620',2018-05-07,AEPS GST INC DT 06-05-201,0.0,7455.98,211199.98999999167,2018,5,7,CHECK_CASHING,7455.98,M847349888
10117,409000438620',2018-05-07,AEPS ACQUIRING ADJ FEES 0,35.4,0.0,211164.58999999167,2018,5,7,PAYEMENT,35.4,M1002544445
10118,409000438620',2018-05-07,AEPS ACQ REP ADJ FEES 050,0.0,17.7,211182.28999999168,2018,5,7,CASH_IN,17.7,M1439621082
10119,409000438620',2018-05-08,Indiaforensic AEPS NPCI WDL SET,0.0,26789800.0,27000982.28999999,2018,5,8,CHECK_CASHING,26789800.0,C451433836
10120,409000438620',2018-05-08,TRF TO  Indiaforensic SERVICES I,15000000.0,0.0,12000982.289999992,2018,5,8,CASH_OUT,15000000.0,M973207283
10121,409000438620',2018-05-08,TRF TO  Indiaforensic SERVICES I,7000000.0,0.0,5000982.289999992,2018,5,8,PAYEMENT,7000000.0,C578294406
10122,409000438620',2018-05-08,TRF TO  Indiaforensic SERVICES I,5000000.0,0.0,982.2899999916552,2018,5,8,CHECK_WITHDRAWAL,5000000.0,M1424027000
10123,409000438620',2018-05-08,AEPS INCOME DT 05-07-2018,0.0,65100.9,66083.18999999165,2018,5,8,TRANSFER,65100.9,M1854745805
10124,409000438620',2018-05-08,AEPS GST INC DT 05-07-201,0.0,13020.18,79103.36999999164,2018,5,8,CASH_IN,13020.18,M1852900317
10125,409000438620',2018-05-08,AEPS ACQ REP ADJ FEES 070,0.0,265.5,79368.86999999164,2018,5,8,CHECK_CASHING,265.5,M301812950
10126,409000438620',2018-05-09,Indiaforensic AEPS NPCI WDL SET,0.0,29566900.0,29646268.86999999,2018,5,9,TRANSFER,29566900.0,M129774606
10127,409000438620',2018-05-09,TRF TO  Indiaforensic SERVICES I,15000000.0,0.0,14646268.86999999,2018,5,9,PAYEMENT,15000000.0,C577628476
10128,409000438620',2018-05-09,TRF TO  Indiaforensic SERVICES I,14600000.0,0.0,46268.869999989874,2018,5,9,DEBIT,14600000.0,M700535161
10129,409000438620',2018-05-09,AEPS INCOME DT 08-05-2018,0.0,70114.29,116383.15999998985,2018,5,9,CHECK_CASHING,70114.29,M274457305
10130,409000438620',2018-05-09,AEPS GST INC DT 08-05-201,0.0,14022.86,130406.01999998985,2018,5,9,TRANSFER,14022.86,C366015139
10131,409000438620',2018-05-09,AEPS ACQUIRING ADJ FEES 0,17.7,0.0,130388.31999998985,2018,5,9,CHECK_WITHDRAWAL,17.7,M52495444
10132,409000438620',2018-05-09,AEPS ACQ CR ADJ FEES 0805,359.9,0.0,130028.41999998988,2018,5,9,DEBIT,359.9,M1507255981
10133,409000438620',2018-05-09,CR812216005080/RMCPL21314/0,500.0,0.0,129528.41999998988,2018,5,9,DEBIT,500.0,M705156713
10134,409000438620',2018-05-09,CR812210883124/RMCPL12342/0,2500.0,0.0,127028.41999998988,2018,5,9,PAYEMENT,2500.0,M333477647
10135,409000438620',2018-05-09,CR812217016801/RMCPL11247/0,10000.0,0.0,117028.41999998988,2018,5,9,DEBIT,10000.0,M1564000570
10136,409000438620',2018-05-09,CR812216005078/RMCPL22420/0,2000.0,0.0,115028.41999998988,2018,5,9,PAYEMENT,2000.0,M1478805516
10137,409000438620',2018-05-09,CR812212936149/RMCPL11951/0,3000.0,0.0,112028.41999998988,2018,5,9,CHECK_WITHDRAWAL,3000.0,M1301242891
10138,409000438620',2018-05-09,CR812212936154/RMCPL23808/0,500.0,0.0,111528.41999998988,2018,5,9,PAYEMENT,500.0,M535129918
10139,409000438620',2018-05-09,CR812213950234/RMCPL25279/0,3000.0,0.0,108528.41999998988,2018,5,9,PAYEMENT,3000.0,M1431457558
10140,409000438620',2018-05-09,CR812211910411/RMCPL17696/0,1000.0,0.0,107528.41999998988,2018,5,9,PAYEMENT,1000.0,M2103761414
10141,409000438620',2018-05-09,CR812216005085/RMCPL14160/0,1000.0,0.0,106528.41999998988,2018,5,9,DEBIT,1000.0,M134041865
10142,409000438620',2018-05-09,CR812311200773/RMCPL18191/0,3000.0,0.0,103528.41999998988,2018,5,9,PAYEMENT,3000.0,M1937072695
10143,409000438620',2018-05-09,CR812312237492/RMCPL25283/0,1000.0,0.0,102528.41999998988,2018,5,9,PAYEMENT,1000.0,M1516142047
10144,409000438620',2018-05-09,CR812311213880/RMCPL15556/0,10000.0,0.0,92528.41999998988,2018,5,9,PAYEMENT,10000.0,M2068836662
10145,409000438620',2018-05-09,CR812312225964/RMCPL12343/0,2000.0,0.0,90528.41999998988,2018,5,9,CASH_OUT,2000.0,M1429115915
10146,409000438620',2018-05-09,CR812315276358/RMCPL13026/0,500.0,0.0,90028.41999998988,2018,5,9,CHECK_WITHDRAWAL,500.0,M1761298696
10147,409000438620',2018-05-09,CR812311213873/RMCPL11618/0,1000.0,0.0,89028.41999998988,2018,5,9,CHECK_WITHDRAWAL,1000.0,C1651945012
10148,409000438620',2018-05-09,CR812312237485/RMCPL22799/0,1000.0,0.0,88028.41999998988,2018,5,9,DEBIT,1000.0,M709947471
10149,409000438620',2018-05-09,CR812310188123/RMCPL18662/0,500.0,0.0,87528.41999998987,2018,5,9,CHECK_WITHDRAWAL,500.0,M1774525051
10150,409000438620',2018-05-09,CR812315276373/RMCPL22898/0,5000.0,0.0,82528.41999998987,2018,5,9,DEBIT,5000.0,M1852150893
10151,409000438620',2018-05-09,CR812311213858/RMCPL21825/0,500.0,0.0,82028.41999998987,2018,5,9,DEBIT,500.0,M1032389880
10152,409000438620',2018-05-09,CR812311213862/RMCPL17115/0,3000.0,0.0,79028.41999998987,2018,5,9,CASH_OUT,3000.0,M1781829273
10153,409000438620',2018-05-09,CR812311200794/RMCPL13078/0,10000.0,0.0,69028.41999998987,2018,5,9,CASH_OUT,10000.0,M365255349
10154,409000438620',2018-05-09,CR812411490695/RMCPL22237/0,6000.0,0.0,63028.41999998987,2018,5,9,CHECK_WITHDRAWAL,6000.0,M1985916951
10155,409000438620',2018-05-09,CR812412502519/RMCPL16204/0,5000.0,0.0,58028.41999998987,2018,5,9,PAYEMENT,5000.0,M1478153883
10156,409000438620',2018-05-09,CR812412502530/RMCPL18577/0,6000.0,0.0,52028.41999998987,2018,5,9,CASH_OUT,6000.0,M1713662155
10157,409000438620',2018-05-09,CR812412502505/RMCPL15786/0,5000.0,0.0,47028.41999998987,2018,5,9,DEBIT,5000.0,C1286885448
10158,409000438620',2018-05-09,CR812411490705/RMCPL23086/0,2000.0,0.0,45028.41999998987,2018,5,9,CHECK_WITHDRAWAL,2000.0,C1998750048
10159,409000438620',2018-05-09,CR812411490687/RMCPL22777/0,4000.0,0.0,41028.41999998987,2018,5,9,CHECK_WITHDRAWAL,4000.0,C1899073220
10160,409000438620',2018-05-09,CR812512785361/RMCPL23894/0,5000.0,0.0,36028.41999998987,2018,5,9,CASH_OUT,5000.0,M282614543
10161,409000438620',2018-05-09,CR812509730306/RMCPL25099/0,5000.0,0.0,31028.419999989863,2018,5,9,CASH_OUT,5000.0,M671090157
10162,409000438620',2018-05-09,AEPS ACQ REP ADJ FEES 080,0.0,35.4,31063.819999989868,2018,5,9,TRANSFER,35.4,M1842314313
10163,409000438620',2018-05-10,Indiaforensic AEPS NPCI WDL SET,0.0,27216700.0,27247763.81999999,2018,5,10,CASH_IN,27216700.0,M1643542604
10164,409000438620',2018-05-10,TRF TO  Indiaforensic SERVICES I,15000000.0,0.0,12247763.81999999,2018,5,10,PAYEMENT,15000000.0,C978740207
10165,409000438620',2018-05-10,TRF TO  Indiaforensic SERVICES I,12200000.0,0.0,47763.81999998912,2018,5,10,CASH_OUT,12200000.0,M1651442551
10166,409000438620',2018-05-10,AEPS INCOME DT 09-05-2018,0.0,65719.43,113483.24999998912,2018,5,10,TRANSFER,65719.43,M1379484374
10167,409000438620',2018-05-10,AEPS GST INC DT 09-05-201,0.0,13143.89,126627.13999998911,2018,5,10,TRANSFER,13143.89,M1693295705
10168,409000438620',2018-05-10,AEPS ACQUIRING ADJ FEES 0,29.5,0.0,126597.63999998911,2018,5,10,CHECK_WITHDRAWAL,29.5,C667346055
10169,409000438620',2018-05-10,AEPS ACQ REP ADJ FEES 080,0.0,17.7,126615.33999998913,2018,5,10,CASH_IN,17.7,C803116137
10170,409000438620',2018-05-11,Indiaforensic AEPS NPCI WDL SET,0.0,25588400.0,25715015.33999999,2018,5,11,CHECK_CASHING,25588400.0,M1765012857
10171,409000438620',2018-05-11,TRF TO  Indiaforensic SERVICES I,15000000.0,0.0,10715015.339999987,2018,5,11,CHECK_WITHDRAWAL,15000000.0,C1501701470
10172,409000438620',2018-05-11,TRF TO  Indiaforensic SERVICES I,10700000.0,0.0,15015.339999988677,2018,5,11,PAYEMENT,10700000.0,M87800253
10173,409000438620',2018-05-11,AEPS INCOME DT 10-05-2018,0.0,61415.14,76430.47999998867,2018,5,11,CHECK_CASHING,61415.14,M350419467
10174,409000438620',2018-05-11,AEPS GST INC DT 10-05-201,0.0,12283.03,88713.50999998867,2018,5,11,TRANSFER,12283.03,M889834277
10175,409000438620',2018-05-11,AEPS ACQ CR ADJ FEES 1005,249.57,0.0,88463.93999998867,2018,5,11,CASH_OUT,249.57,M1842613059
10176,409000438620',2018-05-11,CR812711265403/RMCPL18417/0,4000.0,0.0,84463.93999998867,2018,5,11,CHECK_WITHDRAWAL,4000.0,C1556995360
10177,409000438620',2018-05-11,CR812711277017/RMCPL23346/0,1000.0,0.0,83463.93999998867,2018,5,11,CASH_OUT,1000.0,M43220286
10178,409000438620',2018-05-11,CR812712288788/RMCPL18125/0,1000.0,0.0,82463.93999998867,2018,5,11,DEBIT,1000.0,M19665040
10179,409000438620',2018-05-11,CR812713301552/RMCPL21311/0,700.0,0.0,81763.93999998867,2018,5,11,PAYEMENT,700.0,M1889214944
10180,409000438620',2018-05-11,CR812710257764/RMCPL17648/0,10000.0,0.0,71763.93999998867,2018,5,11,CASH_OUT,10000.0,M1498104287
10181,409000438620',2018-05-11,CR812712288750/RMCPL20136/0,2400.0,0.0,69363.93999998867,2018,5,11,CHECK_WITHDRAWAL,2400.0,M1610250552
10182,409000438620',2018-05-11,CR812711265425/RMCPL24667/0,500.0,0.0,68863.93999998867,2018,5,11,DEBIT,500.0,C34231099
10183,409000438620',2018-05-11,CR812716358074/RMCPL20396/0,3000.0,0.0,65863.93999998867,2018,5,11,CHECK_WITHDRAWAL,3000.0,M1073602683
10184,409000438620',2018-05-11,CR812715345810/RMCPL22341/0,10000.0,0.0,55863.939999988674,2018,5,11,CASH_OUT,10000.0,M1799043587
10185,409000438620',2018-05-11,CR812711277028/RMCPL14523/0,2000.0,0.0,53863.939999988674,2018,5,11,PAYEMENT,2000.0,M1460208573
10186,409000438620',2018-05-11,CR812816610471/RMCPL17468/0,9000.0,0.0,44863.939999988674,2018,5,11,DEBIT,9000.0,M1171960269
10187,409000438620',2018-05-11,CR812816621117/RMCPL22490/0,5000.0,0.0,39863.93999998867,2018,5,11,CASH_OUT,5000.0,M1676137378
10188,409000438620',2018-05-11,CR812810517978/RMCPL21984/0,1700.0,0.0,38163.93999998867,2018,5,11,CASH_OUT,1700.0,M528250535
10189,409000438620',2018-05-11,CR812810527755/RMCPL12626/0,6000.0,0.0,32163.939999988663,2018,5,11,CHECK_WITHDRAWAL,6000.0,C1163480574
10190,409000438620',2018-05-11,CR812817643120/RMCPL22098/0,5000.0,0.0,27163.939999988663,2018,5,11,CASH_OUT,5000.0,M395541265
10191,409000438620',2018-05-11,CR812811547460/RMCPL00472/0,5000.0,0.0,22163.939999988663,2018,5,11,CASH_OUT,5000.0,M1514903181
10192,409000438620',2018-05-11,CR812816610498/RMCPL20319/0,10000.0,0.0,12163.939999988666,2018,5,11,CASH_OUT,10000.0,M124718754
10193,409000438620',2018-05-11,CR812817643125/RMCPL20899/0,3500.0,0.0,8663.939999988666,2018,5,11,DEBIT,3500.0,M1570536676
10194,409000438620',2018-05-11,AEPS ACQ REP ADJ FEES 100,0.0,29.5,8693.439999988666,2018,5,11,CHECK_CASHING,29.5,M1822883753
10195,409000438620',2018-05-14,Indiaforensic AEPS NPCI WDL SET,0.0,24988000.0,24996693.43999999,2018,5,14,TRANSFER,24988000.0,M583117520
10196,409000438620',2018-05-14,Indiaforensic AEPS NPCI WDL SET,0.0,22863500.0,47860193.43999999,2018,5,14,CHECK_CASHING,22863500.0,M1975901874
10197,409000438620',2018-05-14,Indiaforensic AEPS NPCI WDL SET,0.0,12178400.0,60038593.43999999,2018,5,14,CASH_IN,12178400.0,M1656150503
10198,409000438620',2018-05-14,TRF TO  Indiaforensic SERVICES I,15000000.0,0.0,45038593.43999999,2018,5,14,CASH_OUT,15000000.0,M1050955287
10199,409000438620',2018-05-14,TRF TO  Indiaforensic SERVICES I,15000000.0,0.0,30038593.43999999,2018,5,14,DEBIT,15000000.0,M1414807531
10200,409000438620',2018-05-14,TRF TO  Indiaforensic SERVICES I,15000000.0,0.0,15038593.43999999,2018,5,14,PAYEMENT,15000000.0,M1420664690
10201,409000438620',2018-05-14,TRF TO  Indiaforensic SERVICES I,15000000.0,0.0,38593.439999990165,2018,5,14,CHECK_WITHDRAWAL,15000000.0,M1819851674
10202,409000438620',2018-05-14,AEPS ACQUIRING ADJ FEES 1,23.6,0.0,38569.839999990174,2018,5,14,DEBIT,23.6,M825418640
10203,409000438620',2018-05-14,AEPS ACQ CR ADJ FEES 1105,47.2,0.0,38522.63999999017,2018,5,14,CASH_OUT,47.2,M840059490
10204,409000438620',2018-05-14,CR812911810893/RMCPL25418/0,1000.0,0.0,37522.63999999017,2018,5,14,CASH_OUT,1000.0,M2020905921
10205,409000438620',2018-05-14,CR812911810891/RMCPL16314/0,1000.0,0.0,36522.63999999017,2018,5,14,DEBIT,1000.0,M1071299318
10206,409000438620',2018-05-14,CR812911822799/RMCPL19555/0,500.0,0.0,36022.63999999017,2018,5,14,DEBIT,500.0,M1527231217
10207,409000438620',2018-05-14,CR812917912910/RMCPL23858/0,10000.0,0.0,26022.63999999017,2018,5,14,CASH_OUT,10000.0,M1929964803
10208,409000438620',2018-05-14,CR812916900810/RMCPL20328/0,1500.0,0.0,24522.63999999017,2018,5,14,PAYEMENT,1500.0,M475813386
10209,409000438620',2018-05-14,CR812916900807/RMCPL16293/0,1000.0,0.0,23522.63999999017,2018,5,14,PAYEMENT,1000.0,M1313839007
10210,409000438620',2018-05-14,AEPS INCOME DT 11-05-2018,0.0,60025.45,83548.08999999016,2018,5,14,TRANSFER,60025.45,M491134455
10211,409000438620',2018-05-14,AEPS GST INC DT 11-05-201,0.0,12005.09,95553.17999999016,2018,5,14,TRANSFER,12005.09,M223853098
10212,409000438620',2018-05-14,AEPS INCOME DT 12-05-2018,0.0,55138.28,150691.45999999015,2018,5,14,TRANSFER,55138.28,M1679774995
10213,409000438620',2018-05-14,AEPS GST INC DT 12-05-201,0.0,11027.66,161719.11999999016,2018,5,14,TRANSFER,11027.66,M1513674328
10214,409000438620',2018-05-14,AEPS INCOME DT 13-05-2018,0.0,30276.59,191995.70999999013,2018,5,14,TRANSFER,30276.59,M1461380821
10215,409000438620',2018-05-14,AEPS GST INC DT 13-05-201,0.0,6055.32,198051.02999999016,2018,5,14,CHECK_CASHING,6055.32,C1182148067
10216,409000438620',2018-05-15,Indiaforensic AEPS NPCI WDL SET,0.0,22762100.0,22960151.02999999,2018,5,15,CHECK_CASHING,22762100.0,M32263068
10217,409000438620',2018-05-15,TRF TO  Indiaforensic SERVICES I,15000000.0,0.0,7960151.02999999,2018,5,15,CASH_OUT,15000000.0,C1069568462
10218,409000438620',2018-05-15,TRF TO  Indiaforensic SERVICES I,7900000.0,0.0,60151.029999990016,2018,5,15,CASH_OUT,7900000.0,C824421402
10219,409000438620',2018-05-15,AEPS INCOME DT 14-05-2018,0.0,55161.44,115312.46999999002,2018,5,15,CHECK_CASHING,55161.44,C1101441872
10220,409000438620',2018-05-15,AEPS GST INC DT 14-05-201,0.0,11032.29,126344.75999999006,2018,5,15,CASH_IN,11032.29,M1242479376
10221,409000438620',2018-05-15,AEPS ACQUIRING ADJ FEES 1,20.65,0.0,126324.10999999006,2018,5,15,DEBIT,20.65,M1075939594
10222,409000438620',2018-05-15,AEPS ACQ CR ADJ FEES 1405,269.04,0.0,126055.06999999005,2018,5,15,PAYEMENT,269.04,M187638756
10223,409000438620',2018-05-15,CR811410642644/RMCPL25522/2,1000.0,0.0,125055.06999999005,2018,5,15,CHECK_WITHDRAWAL,1000.0,M2018065488
10224,409000438620',2018-05-15,CR811412681159/RMCPL17890/2,7000.0,0.0,118055.06999999005,2018,5,15,PAYEMENT,7000.0,M143522752
10225,409000438620',2018-05-15,CR811416762463/RMCPL22341/2,1700.0,0.0,116355.06999999005,2018,5,15,PAYEMENT,1700.0,M1769677013
10226,409000438620',2018-05-15,CR811416762476/RMCPL21054/2,3000.0,0.0,113355.06999999005,2018,5,15,PAYEMENT,3000.0,M180308793
10227,409000438620',2018-05-15,CR811416762488/RMCPL16727/2,4000.0,0.0,109355.06999999004,2018,5,15,PAYEMENT,4000.0,M1797496959
10228,409000438620',2018-05-15,CR811411668097/RMCPL24928/2,7000.0,0.0,102355.06999999004,2018,5,15,CASH_OUT,7000.0,M704203609
10229,409000438620',2018-05-15,CR811409614800/RMCPL16899/2,5000.0,0.0,97355.06999999004,2018,5,15,DEBIT,5000.0,M1981451425
10230,409000438620',2018-05-15,CR811412695728/RMCPL18165/2,500.0,0.0,96855.06999999004,2018,5,15,CASH_OUT,500.0,M901463164
10231,409000438620',2018-05-15,CR811410642654/RMCPL11966/2,1000.0,0.0,95855.06999999004,2018,5,15,DEBIT,1000.0,M1894362923
10232,409000438620',2018-05-15,CR811412681032/RMCPL18460/2,3000.0,0.0,92855.06999999004,2018,5,15,DEBIT,3000.0,M303803636
10233,409000438620',2018-05-15,CR813010074710/RMCPL24694/1,1000.0,0.0,91855.06999999004,2018,5,15,DEBIT,1000.0,M1602260456
10234,409000438620',2018-05-15,CR813011086738/RMCPL20680/1,600.0,0.0,91255.06999999004,2018,5,15,CHECK_WITHDRAWAL,600.0,M388448716
10235,409000438620',2018-05-15,CR813011086720/RMCPL21336/1,500.0,0.0,90755.06999999004,2018,5,15,PAYEMENT,500.0,M1098912468
10236,409000438620',2018-05-15,CR813011086722/RMCPL21675/1,10000.0,0.0,80755.06999999004,2018,5,15,CASH_OUT,10000.0,M356043314
10237,409000438620',2018-05-15,CR813010074717/RMCPL17349/1,5000.0,0.0,75755.06999999004,2018,5,15,PAYEMENT,5000.0,M1870486410
10238,409000438620',2018-05-15,CR813013127548/RMCPL14558/1,800.0,0.0,74955.06999999004,2018,5,15,CHECK_WITHDRAWAL,800.0,M1653335286
10239,409000438620',2018-05-15,CR813013127536/RMCPL22799/1,5000.0,0.0,69955.06999999004,2018,5,15,DEBIT,5000.0,M506267740
10240,409000438620',2018-05-15,CR813012108864/RMCPL18236/1,2000.0,0.0,67955.06999999004,2018,5,15,CASH_OUT,2000.0,M482331175
10241,409000438620',2018-05-15,CR813010074713/RMCPL24787/1,5000.0,0.0,62955.06999999004,2018,5,15,PAYEMENT,5000.0,C219416103
10242,409000438620',2018-05-15,CR813010074712/RMCPL19668/1,5000.0,0.0,57955.06999999004,2018,5,15,PAYEMENT,5000.0,M1824503996
10243,409000438620',2018-05-15,CR813010074725/RMCPL19237/1,3000.0,0.0,54955.06999999004,2018,5,15,PAYEMENT,3000.0,M748308369
10244,409000438620',2018-05-15,CR813011086743/RMCPL16831/1,500.0,0.0,54455.06999999004,2018,5,15,CHECK_WITHDRAWAL,500.0,M629977452
10245,409000438620',2018-05-16,Indiaforensic AEPS NPCI WDL SET,0.0,25537700.0,25592155.06999999,2018,5,16,CHECK_CASHING,25537700.0,C423580937
10246,409000438620',2018-05-16,CR813207567302RMCPL16658120,2000.0,0.0,25590155.06999999,2018,5,16,CHECK_WITHDRAWAL,2000.0,C991505714
10247,409000438620',2018-05-16,CR813207567316RMCPL16251120,1400.0,0.0,25588755.06999999,2018,5,16,CASH_OUT,1400.0,M12276332
10248,409000438620',2018-05-16,CR813117458047RMCPL16197110,1000.0,0.0,25587755.06999999,2018,5,16,CASH_OUT,1000.0,M1025674312
10249,409000438620',2018-05-16,CR813110340799RMCPL22847110,500.0,0.0,25587255.06999999,2018,5,16,CHECK_WITHDRAWAL,500.0,C1065997164
10250,409000438620',2018-05-16,CR813110340820RMCPL20319110,2000.0,0.0,25585255.06999999,2018,5,16,PAYEMENT,2000.0,M1714188773
10251,409000438620',2018-05-16,CR813110340802RMCPL22522110,2500.0,0.0,25582755.06999999,2018,5,16,CASH_OUT,2500.0,M894240655
10252,409000438620',2018-05-16,CR813110340810RMCPL14097110,500.0,0.0,25582255.06999999,2018,5,16,PAYEMENT,500.0,M1068147
10253,409000438620',2018-05-16,CR813110340828RMCPL25985110,4500.0,0.0,25577755.06999999,2018,5,16,CHECK_WITHDRAWAL,4500.0,M1033164787
10254,409000438620',2018-05-16,CR813110340818RMCPL18859110,10000.0,0.0,25567755.06999999,2018,5,16,PAYEMENT,10000.0,M265297349
10255,409000438620',2018-05-16,CR813117458061RMCPL18799110,1000.0,0.0,25566755.06999999,2018,5,16,CHECK_WITHDRAWAL,1000.0,C1772085663
10256,409000438620',2018-05-16,CR813117458082RMCPL18320110,2000.0,0.0,25564755.06999999,2018,5,16,PAYEMENT,2000.0,C849038219
10257,409000438620',2018-05-16,TRF TO  Indiaforensic SERVICES I,15000000.0,0.0,10564755.06999999,2018,5,16,CHECK_WITHDRAWAL,15000000.0,M1033435132
10258,409000438620',2018-05-16,TRF TO  Indiaforensic SERVICES I,10500000.0,0.0,64755.06999998912,2018,5,16,CASH_OUT,10500000.0,M624732619
10259,409000438620',2018-05-16,AEPS ACQ CR ADJ FEES 1505,111.5,0.0,64643.56999998912,2018,5,16,PAYEMENT,111.5,C39713115
10260,409000438620',2018-05-16,AEPS ACQ REP ADJ FEES 150,0.0,44.25,64687.81999998912,2018,5,16,TRANSFER,44.25,C869928877
10261,409000438620',2018-05-16,AEPS INCOME DT 15-05-2018,0.0,60150.07,124837.88999998911,2018,5,16,TRANSFER,60150.07,C929452805
10262,409000438620',2018-05-16,AEPS GST INC DT 15-05-201,0.0,12030.01,136867.89999998914,2018,5,16,CHECK_CASHING,12030.01,C853932876
10263,409000438620',2018-05-17,Indiaforensic AEPS NPCI WDL SET,0.0,24547800.0,24684667.89999999,2018,5,17,TRANSFER,24547800.0,C531511436
10264,409000438620',2018-05-17,TRF TO  Indiaforensic SERVICES I,15000000.0,0.0,9684667.899999987,2018,5,17,CHECK_WITHDRAWAL,15000000.0,C716083600
10265,409000438620',2018-05-17,TRF TO  Indiaforensic SERVICES I,9600000.0,0.0,84667.89999998732,2018,5,17,PAYEMENT,9600000.0,C1727565779
10266,409000438620',2018-05-17,AEPS ACQUIRING ADJ FEES 1,44.25,0.0,84623.64999998732,2018,5,17,PAYEMENT,44.25,C1728766751
10267,409000438620',2018-05-17,AEPS INCOME DT 16-05-2018,0.0,58540.49,143164.13999998732,2018,5,17,CHECK_CASHING,58540.49,C843774579
10268,409000438620',2018-05-17,AEPS GST INC DT 16-05-201,0.0,11708.1,154872.23999998733,2018,5,17,CASH_IN,11708.1,M591153984
10269,409000438620',2018-05-18,Indiaforensic AEPS NPCI WDL SET,0.0,23393800.0,23548672.23999999,2018,5,18,TRANSFER,23393800.0,C1479813516
10270,409000438620',2018-05-18,CR813512351165/RMCPL23035/1,2000.0,0.0,23546672.23999999,2018,5,18,CASH_OUT,2000.0,M6178224
10271,409000438620',2018-05-18,CR813516405365/RMCPL14542/1,500.0,0.0,23546172.23999999,2018,5,18,DEBIT,500.0,M806299735
10272,409000438620',2018-05-18,CR813512351174/RMCPL20185/1,1000.0,0.0,23545172.23999999,2018,5,18,CASH_OUT,1000.0,M1436732202
10273,409000438620',2018-05-18,CR813515384176/RMCPL22824/1,500.0,0.0,23544672.23999999,2018,5,18,CHECK_WITHDRAWAL,500.0,M378553315
10274,409000438620',2018-05-18,CR813516405373/RMCPL25283/1,10000.0,0.0,23534672.23999999,2018,5,18,DEBIT,10000.0,M1778052034
10275,409000438620',2018-05-18,CR813516405357/RMCPL21822/1,8600.0,0.0,23526072.23999999,2018,5,18,PAYEMENT,8600.0,C2047373618
10276,409000438620',2018-05-18,CR813510301416/RMCPL15314/1,1000.0,0.0,23525072.23999999,2018,5,18,CASH_OUT,1000.0,M942492376
10277,409000438620',2018-05-18,CR813510301389/RMCPL16346/1,10000.0,0.0,23515072.23999999,2018,5,18,CASH_OUT,10000.0,C2083562754
10278,409000438620',2018-05-18,CR813512341118/RMCPL23144/1,1000.0,0.0,23514072.23999999,2018,5,18,CHECK_WITHDRAWAL,1000.0,M1280383250
10279,409000438620',2018-05-18,CR813515384178/RMCPL18236/1,1400.0,0.0,23512672.23999999,2018,5,18,CHECK_WITHDRAWAL,1400.0,M543617235
10280,409000438620',2018-05-18,CR813411023393/RMCPL21454/1,600.0,0.0,23512072.23999999,2018,5,18,CASH_OUT,600.0,C861958315
10281,409000438620',2018-05-18,CR813411034071/RMCPL23158/1,500.0,0.0,23511572.23999999,2018,5,18,CASH_OUT,500.0,M500963285
10282,409000438620',2018-05-18,CR813411023401/RMCPL16204/1,5000.0,0.0,23506572.23999999,2018,5,18,CHECK_WITHDRAWAL,5000.0,M2083966486
10283,409000438620',2018-05-18,TRF TO  Indiaforensic SERVICES I,15000000.0,0.0,8506572.239999987,2018,5,18,DEBIT,15000000.0,M1531048521
10284,409000438620',2018-05-18,TRF TO  Indiaforensic SERVICES I,8500000.0,0.0,6572.239999987185,2018,5,18,DEBIT,8500000.0,M1196861715
10285,409000438620',2018-05-18,AEPS ACQUIRING ADJ FEES 1,17.7,0.0,6554.539999987185,2018,5,18,CHECK_WITHDRAWAL,17.7,M1141354521
10286,409000438620',2018-05-18,AEPS ACQ CR ADJ FEES 1705,120.95,0.0,6433.589999987185,2018,5,18,CASH_OUT,120.95,M1877887067
10287,409000438620',2018-05-18,AEPS ACQ REP ADJ FEES 170,0.0,44.25,6477.839999987185,2018,5,18,CHECK_CASHING,44.25,M5890434
10288,409000438620',2018-05-18,AEPS INCOME DT 17-05-2018,0.0,55344.94,61822.779999987186,2018,5,18,CHECK_CASHING,55344.94,M323114105
10289,409000438620',2018-05-18,AEPS GST INC DT 17-05-201,0.0,11068.99,72891.76999998718,2018,5,18,CHECK_CASHING,11068.99,M498104537
10290,409000438620',2018-05-19,Indiaforensic AEPS NPCI WDL SET,0.0,20343600.0,20416491.76999999,2018,5,19,CASH_IN,20343600.0,M167585516
10291,409000438620',2018-05-19,TRF TO  Indiaforensic SERVICES I,10000000.0,0.0,10416491.769999988,2018,5,19,PAYEMENT,10000000.0,M327963591
10292,409000438620',2018-05-19,TRF TO  Indiaforensic SERVICES I,10000000.0,0.0,416491.7699999885,2018,5,19,CHECK_WITHDRAWAL,10000000.0,M285836472
10293,409000438620',2018-05-19,AEPS INCOME DT 18-05-2018,0.0,48551.66,465043.4299999884,2018,5,19,TRANSFER,48551.66,M1233598527
10294,409000438620',2018-05-19,AEPS GST INC DT 18-05-201,0.0,9710.33,474753.7599999884,2018,5,19,CHECK_CASHING,9710.33,M2106423676
10295,409000438620',2018-05-19,AEPS ACQ REP ADJ FEES 180,0.0,17.7,474771.4599999885,2018,5,19,CHECK_CASHING,17.7,M401707771
10296,409000438620',2018-05-19,Chq Book Issuance Charges,100.0,0.0,474671.4599999885,2018,5,19,DEBIT,100.0,M1102145646
10297,409000438620',2018-05-19,GST,18.0,0.0,474653.4599999885,2018,5,19,CHECK_WITHDRAWAL,18.0,C543634584
10298,409000438620',2018-05-21,MAW/5029649805879772/Cudd,0.0,3000.0,477653.4599999885,2018,5,21,CASH_IN,3000.0,M1606662256
10299,409000438620',2018-05-21,Indiaforensic AEPS NPCI WDL SET,0.0,21258100.0,21735753.45999999,2018,5,21,CASH_IN,21258100.0,C1354725727
10300,409000438620',2018-05-21,Indiaforensic AEPS NPCI WDL SET,0.0,13316800.0,35052553.45999999,2018,5,21,CASH_IN,13316800.0,M1729043845
10301,409000438620',2018-05-21,TRF TO  Indiaforensic SERVICES I,15000000.0,0.0,20052553.459999993,2018,5,21,DEBIT,15000000.0,M1781936338
10302,409000438620',2018-05-21,TRF TO  Indiaforensic SERVICES I,5000000.0,0.0,15052553.459999992,2018,5,21,PAYEMENT,5000000.0,M1713345994
10303,409000438620',2018-05-21,TRF TO  Indiaforensic SERVICES I,15000000.0,0.0,52553.459999993436,2018,5,21,CHECK_WITHDRAWAL,15000000.0,M1908195668
10304,409000438620',2018-05-21,AEPS INCOME DT 19-05-2018,0.0,50529.83,103083.28999999343,2018,5,21,CHECK_CASHING,50529.83,C796028148
10305,409000438620',2018-05-21,AEPS GST INC DT 19-05-201,0.0,10105.97,113189.25999999346,2018,5,21,TRANSFER,10105.97,M479532507
10306,409000438620',2018-05-21,AEPS INCOME DT 20-05-2018,0.0,32362.52,145551.77999999345,2018,5,21,CHECK_CASHING,32362.52,M1814034089
10307,409000438620',2018-05-21,AEPS GST INC DT 20-05-201,0.0,6472.5,152024.27999999345,2018,5,21,TRANSFER,6472.5,M2128834000
10308,409000438620',2018-05-21,AEPS ACQ CR ADJ FEES 1905,212.4,0.0,151811.87999999346,2018,5,21,PAYEMENT,212.4,M1086878248
10309,409000438620',2018-05-21,CR813608532709/RMCPL22989/1,500.0,0.0,151311.87999999346,2018,5,21,CASH_OUT,500.0,M192292238
10310,409000438620',2018-05-21,CR813612607046/RMCPL11862/1,3000.0,0.0,148311.87999999346,2018,5,21,CASH_OUT,3000.0,M1357357624
10311,409000438620',2018-05-21,CR813619715117/RMCPL12685/1,1000.0,0.0,147311.87999999346,2018,5,21,CASH_OUT,1000.0,M1984310211
10312,409000438620',2018-05-21,CR813616665041/RMCPL09827/1,1000.0,0.0,146311.87999999346,2018,5,21,CASH_OUT,1000.0,M650601476
10313,409000438620',2018-05-21,CR813616674575/RMCPL16346/1,1000.0,0.0,145311.87999999346,2018,5,21,CHECK_WITHDRAWAL,1000.0,M472860435
10314,409000438620',2018-05-21,CR813611580858/RMCPL20185/1,1000.0,0.0,144311.87999999346,2018,5,21,CHECK_WITHDRAWAL,1000.0,M770454960
10315,409000438620',2018-05-21,CR813716965748/RMCPL22261/1,2000.0,0.0,142311.87999999346,2018,5,21,CHECK_WITHDRAWAL,2000.0,M327755132
10316,409000438620',2018-05-21,CR813710845670/RMCPL14462/1,4000.0,0.0,138311.87999999346,2018,5,21,CASH_OUT,4000.0,C199582547
10317,409000438620',2018-05-21,CR813712897037/RMCPL25095/1,6000.0,0.0,132311.87999999346,2018,5,21,CHECK_WITHDRAWAL,6000.0,C1825389809
10318,409000438620',2018-05-21,CR813717976588/RMCPL18789/1,3000.0,0.0,129311.87999999346,2018,5,21,CHECK_WITHDRAWAL,3000.0,C1434389049
10319,409000438620',2018-05-21,CR813712908440/RMCPL16909/1,10000.0,0.0,119311.87999999346,2018,5,21,PAYEMENT,10000.0,M1164323240
10320,409000438620',2018-05-21,CR813711885218/RMCPL23228/1,2500.0,0.0,116811.87999999346,2018,5,21,CHECK_WITHDRAWAL,2500.0,M1620489782
10321,409000438620',2018-05-21,CR813713921091/RMCPL22583/1,1000.0,0.0,115811.87999999346,2018,5,21,DEBIT,1000.0,C2127862399
10322,409000438620',2018-05-21,CR813717976602/RMCPL12785/1,10000.0,0.0,105811.87999999346,2018,5,21,PAYEMENT,10000.0,C1504109395
10323,409000438620',2018-05-21,CR813710845667/RMCPL14453/1,6000.0,0.0,99811.87999999346,2018,5,21,PAYEMENT,6000.0,C929452805
10324,409000438620',2018-05-21,CR813717976575/RMCPL19721/1,1500.0,0.0,98311.87999999346,2018,5,21,PAYEMENT,1500.0,M532398393
10325,409000438620',2018-05-21,CR813712897054/RMCPL17454/1,500.0,0.0,97811.87999999346,2018,5,21,CASH_OUT,500.0,C1354183876
10326,409000438620',2018-05-21,CR813716965749/RMCPL24475/1,10000.0,0.0,87811.87999999347,2018,5,21,PAYEMENT,10000.0,M1733582990
10327,409000438620',2018-05-22,Indiaforensic AEPS NPCI WDL SET,0.0,20959900.0,21047711.879999995,2018,5,22,CHECK_CASHING,20959900.0,C127252077
10328,409000438620',2018-05-22,TRF TO  Indiaforensic SERVICES I,10000000.0,0.0,11047711.879999997,2018,5,22,CASH_OUT,10000000.0,M1635776399
10329,409000438620',2018-05-22,TRF TO  Indiaforensic SERVICES I,10000000.0,0.0,1047711.8799999951,2018,5,22,DEBIT,10000000.0,M1039058336
10330,409000438620',2018-05-22,TRF TO  Indiaforensic SERVICES I,1000000.0,0.0,47711.87999999523,2018,5,22,CHECK_WITHDRAWAL,1000000.0,M585297751
10331,409000438620',2018-05-22,AEPS INCOME DT 21-05-2018,0.0,50858.22,98570.09999999523,2018,5,22,CASH_IN,50858.22,M287346526
10332,409000438620',2018-05-22,AEPS GST INC DT 21-05-201,0.0,10171.64,108741.73999999523,2018,5,22,CHECK_CASHING,10171.64,C79685693
10333,409000438620',2018-05-22,AEPS ACQUIRING ADJ FEES 2,17.7,0.0,108724.03999999524,2018,5,22,CHECK_WITHDRAWAL,17.7,M2070950071
10334,409000438620',2018-05-23,MAW/5029649800521213/NAGA,0.0,1000.0,109724.03999999524,2018,5,23,CHECK_CASHING,1000.0,M2068983649
10335,409000438620',2018-05-23,Indiaforensic AEPS NPCI WDL SET,0.0,23292700.0,23402424.039999995,2018,5,23,CASH_IN,23292700.0,M1341049700
10336,409000438620',2018-05-23,CR814010556839/RMCPL19369/2,2300.0,0.0,23400124.039999995,2018,5,23,PAYEMENT,2300.0,M869529055
10337,409000438620',2018-05-23,CR813911374048/RMCPL13536/1,1000.0,0.0,23399124.039999995,2018,5,23,CHECK_WITHDRAWAL,1000.0,M838976164
10338,409000438620',2018-05-23,CR813911374051/RMCPL11794/1,1000.0,0.0,23398124.039999995,2018,5,23,DEBIT,1000.0,M1075516588
10339,409000438620',2018-05-23,CR813916422161/RMCPL19834/1,2500.0,0.0,23395624.039999995,2018,5,23,PAYEMENT,2500.0,M464733325
10340,409000438620',2018-05-23,CR813916422179/RMCPL17150/1,5000.0,0.0,23390624.039999995,2018,5,23,DEBIT,5000.0,M1009769732
10341,409000438620',2018-05-23,CR813916422254/RMCPL09726/1,10000.0,0.0,23380624.039999995,2018,5,23,CHECK_WITHDRAWAL,10000.0,M1198106017
10342,409000438620',2018-05-23,CR813916422262/RMCPL15446/1,10000.0,0.0,23370624.039999995,2018,5,23,CHECK_WITHDRAWAL,10000.0,M1771305569
10343,409000438620',2018-05-23,CR813910357191/RMCPL20827/1,6000.0,0.0,23364624.039999995,2018,5,23,DEBIT,6000.0,M1571431314
10344,409000438620',2018-05-23,CR813918451696/RMCPL22063/1,2000.0,0.0,23362624.039999995,2018,5,23,PAYEMENT,2000.0,M909651658
10345,409000438620',2018-05-23,CR813916422175/RMCPL26215/1,1000.0,0.0,23361624.039999995,2018,5,23,CASH_OUT,1000.0,C1761353343
10346,409000438620',2018-05-23,CR813910356269/RMCPL19146/1,500.0,0.0,23361124.039999995,2018,5,23,CHECK_WITHDRAWAL,500.0,M2131518213
10347,409000438620',2018-05-23,CR813916422162/RMCPL20328/1,3000.0,0.0,23358124.039999995,2018,5,23,CASH_OUT,3000.0,M1062599950
10348,409000438620',2018-05-23,CR813916422234/RMCPL16092/1,1500.0,0.0,23356624.039999995,2018,5,23,CASH_OUT,1500.0,M1219847836
10349,409000438620',2018-05-23,CR813916422144/RMCPL16338/1,5000.0,0.0,23351624.039999995,2018,5,23,DEBIT,5000.0,M2054019549
10350,409000438620',2018-05-23,CR813918451678/RMCPL18298/1,8000.0,0.0,23343624.039999995,2018,5,23,DEBIT,8000.0,M605386042
10351,409000438620',2018-05-23,CR813811143660/RMCPL10689/1,10000.0,0.0,23333624.039999995,2018,5,23,DEBIT,10000.0,M1571774117
10352,409000438620',2018-05-23,CR813811143641/RMCPL22456/1,2000.0,0.0,23331624.039999995,2018,5,23,DEBIT,2000.0,M784430053
10353,409000438620',2018-05-23,CR813811143653/RMCPL16787/1,2000.0,0.0,23329624.039999995,2018,5,23,CASH_OUT,2000.0,M100722878
10354,409000438620',2018-05-23,CR813811143629/RMCPL24949/1,10000.0,0.0,23319624.039999995,2018,5,23,CHECK_WITHDRAWAL,10000.0,M290043356
10355,409000438620',2018-05-23,CR813810126492/RMCPL22338/1,1000.0,0.0,23318624.039999995,2018,5,23,CASH_OUT,1000.0,M1606246046
10356,409000438620',2018-05-23,CR813811143646/RMCPL22442/1,10000.0,0.0,23308624.039999995,2018,5,23,DEBIT,10000.0,C410033330
10357,409000438620',2018-05-23,CR813812152959/RMCPL20471/1,2000.0,0.0,23306624.039999995,2018,5,23,DEBIT,2000.0,C1060041730
10358,409000438620',2018-05-23,CR813811143674/RMCPL04231/1,1000.0,0.0,23305624.039999995,2018,5,23,DEBIT,1000.0,C366015139
10359,409000438620',2018-05-23,CR813811143671/RMCPL24482/1,2600.0,0.0,23303024.039999995,2018,5,23,PAYEMENT,2600.0,C1501701470
10360,409000438620',2018-05-23,CR813811143626/RMCPL14465/1,2500.0,0.0,23300524.039999995,2018,5,23,CHECK_WITHDRAWAL,2500.0,C1588901702
10361,409000438620',2018-05-23,CR813816203542/RMCPL17395/1,9000.0,0.0,23291524.039999995,2018,5,23,CHECK_WITHDRAWAL,9000.0,C1619402333
10362,409000438620',2018-05-23,CR813812152976/RMCPL19298/1,1000.0,0.0,23290524.039999995,2018,5,23,CASH_OUT,1000.0,C1303868418
10363,409000438620',2018-05-23,CR813816203545/RMCPL19721/1,1300.0,0.0,23289224.039999995,2018,5,23,CASH_OUT,1300.0,C2040603986
10364,409000438620',2018-05-23,TRF TO  Indiaforensic SERVICES I,15000000.0,0.0,8289224.039999995,2018,5,23,DEBIT,15000000.0,M198821790
10365,409000438620',2018-05-23,TRF TO  Indiaforensic SERVICES I,8200000.0,0.0,89224.03999999537,2018,5,23,CASH_OUT,8200000.0,M958623562
10366,409000438620',2018-05-23,AEPS INCOME DT 22-05-2018,0.0,57170.03,146394.06999999538,2018,5,23,TRANSFER,57170.03,M124835943
10367,409000438620',2018-05-23,AEPS GST INC DT 22-05-201,0.0,11434.01,157828.0799999954,2018,5,23,TRANSFER,11434.01,M311196507
10368,409000438620',2018-05-23,AEPS ACQUIRING ADJ FEES 2,17.7,0.0,157810.37999999538,2018,5,23,PAYEMENT,17.7,M1362679354
10369,409000438620',2018-05-23,AEPS ACQ CR ADJ FEES 2205,355.18,0.0,157455.19999999538,2018,5,23,PAYEMENT,355.18,M683247485
10370,409000438620',2018-05-24,Indiaforensic AEPS NPCI WDL SET,0.0,20514400.0,20671855.2,2018,5,24,CHECK_CASHING,20514400.0,M995364892
10371,409000438620',2018-05-24,TRF TO  Indiaforensic SERVICES I,15000000.0,0.0,5671855.199999996,2018,5,24,DEBIT,15000000.0,M1976267310
10372,409000438620',2018-05-24,TRF TO  Indiaforensic SERVICES I,5600000.0,0.0,71855.19999999553,2018,5,24,CASH_OUT,5600000.0,M383980581
10373,409000438620',2018-05-24,AEPS INCOME DT 23-05-2018,0.0,50464.07,122319.26999999555,2018,5,24,TRANSFER,50464.07,M1169118050
10374,409000438620',2018-05-24,AEPS GST INC DT 23-05-201,0.0,10092.81,132412.07999999553,2018,5,24,CHECK_CASHING,10092.81,M656987743
10375,409000438620',2018-05-24,AEPS ACQUIRING ADJ FEES 2,147.5,0.0,132264.57999999553,2018,5,24,PAYEMENT,147.5,M729478030
10376,409000438620',2018-05-24,AEPS ACQ CR ADJ FEES 2305,355.17,0.0,131909.40999999552,2018,5,24,CHECK_WITHDRAWAL,355.17,M1182970984
10377,409000438620',2018-05-24,CB814110752086/RMCPL25879/2,2000.0,0.0,129909.40999999552,2018,5,24,CHECK_WITHDRAWAL,2000.0,M574622929
10378,409000438620',2018-05-24,CB814110751964/RMCPL23387/2,2500.0,0.0,127409.40999999552,2018,5,24,CASH_OUT,2500.0,M511913593
10379,409000438620',2018-05-24,CB814113821728/RMCPL19746/2,2000.0,0.0,125409.40999999552,2018,5,24,CHECK_WITHDRAWAL,2000.0,M834669913
10380,409000438620',2018-05-24,CB814113821828/RMCPL09608/2,10000.0,0.0,115409.40999999552,2018,5,24,PAYEMENT,10000.0,M1956006499
10381,409000438620',2018-05-24,CB814113821783/RMCPL17789/2,1000.0,0.0,114409.40999999552,2018,5,24,DEBIT,1000.0,M1939112405
10382,409000438620',2018-05-24,CB814113821799/RMCPL23561/2,2500.0,0.0,111909.40999999552,2018,5,24,DEBIT,2500.0,M1276853783
10383,409000438620',2018-05-24,CB814110752033/RMCPL18664/2,10000.0,0.0,101909.40999999552,2018,5,24,CASH_OUT,10000.0,M651465589
10384,409000438620',2018-05-24,CB814113821658/RMCPL22583/2,7000.0,0.0,94909.40999999552,2018,5,24,PAYEMENT,7000.0,M2092842099
10385,409000438620',2018-05-24,CB814113821567/RMCPL09758/2,3000.0,0.0,91909.40999999552,2018,5,24,CHECK_WITHDRAWAL,3000.0,M1177013603
10386,409000438620',2018-05-24,CB814112794181/RMCPL24460/2,5000.0,0.0,86909.40999999552,2018,5,24,DEBIT,5000.0,M549065627
10387,409000438620',2018-05-24,CB814110752115/RMCPL19589/2,1500.0,0.0,85409.40999999552,2018,5,24,PAYEMENT,1500.0,M1232658050
10388,409000438620',2018-05-24,CB814110752039/RMCPL16346/2,2000.0,0.0,83409.40999999552,2018,5,24,DEBIT,2000.0,M1128386201
10389,409000438620',2018-05-24,CB814110752017/RMCPL18488/2,2000.0,0.0,81409.40999999552,2018,5,24,CASH_OUT,2000.0,M534113171
10390,409000438620',2018-05-24,CB814110752113/RMCPL16624/2,3000.0,0.0,78409.40999999552,2018,5,24,PAYEMENT,3000.0,M1478332044
10391,409000438620',2018-05-24,CB814110752024/RMCPL15393/2,4000.0,0.0,74409.40999999552,2018,5,24,CHECK_WITHDRAWAL,4000.0,M1292495775
10392,409000438620',2018-05-24,CB814110752015/RMCPL18980/2,5000.0,0.0,69409.40999999552,2018,5,24,CASH_OUT,5000.0,M1106523137
10393,409000438620',2018-05-24,CB814111783080/RMCPL00045/2,1800.0,0.0,67609.40999999552,2018,5,24,DEBIT,1800.0,M1050213685
10394,409000438620',2018-05-24,CB814112794207/RMCPL17491/2,2400.0,0.0,65209.40999999553,2018,5,24,CASH_OUT,2400.0,M1725126860
10395,409000438620',2018-05-24,CB814113821666/RMCPL18460/2,5000.0,0.0,60209.40999999553,2018,5,24,CHECK_WITHDRAWAL,5000.0,C1726301214
10396,409000438620',2018-05-24,CB814113821577/RMCPL22775/2,500.0,0.0,59709.40999999553,2018,5,24,DEBIT,500.0,C1570256460
10397,409000438620',2018-05-24,CB814113821610/RMCPL17213/2,4000.0,0.0,55709.409999995514,2018,5,24,PAYEMENT,4000.0,M486830695
10398,409000438620',2018-05-24,CB814112794210/RMCPL24462/2,1000.0,0.0,54709.409999995514,2018,5,24,CHECK_WITHDRAWAL,1000.0,M632323793
10399,409000438620',2018-05-24,CB814111771794/RMCPL24303/2,500.0,0.0,54209.409999995514,2018,5,24,CHECK_WITHDRAWAL,500.0,M274886926
10400,409000438620',2018-05-24,CB814113821564/RMCPL15233/2,1000.0,0.0,53209.409999995514,2018,5,24,DEBIT,1000.0,M555897633
10401,409000438620',2018-05-24,CB814113821647/RMCPL12343/2,6000.0,0.0,47209.409999995514,2018,5,24,CHECK_WITHDRAWAL,6000.0,M1371327427
10402,409000438620',2018-05-24,CB814113821565/RMCPL12580/2,500.0,0.0,46709.409999995514,2018,5,24,CASH_OUT,500.0,C413177525
10403,409000438620',2018-05-24,CB814113821836/RMCPL19869/2,4500.0,0.0,42209.409999995514,2018,5,24,DEBIT,4500.0,M159642142
10404,409000438620',2018-05-24,CB814113821942/RMCPL24897/2,1000.0,0.0,41209.409999995514,2018,5,24,CHECK_WITHDRAWAL,1000.0,M1930595130
10405,409000438620',2018-05-24,AEPS ACQ REP ADJ FEES 230,0.0,17.7,41227.10999999552,2018,5,24,TRANSFER,17.7,M1550701003
10406,409000438620',2018-05-25,Indiaforensic AEPS NPCI WDL SET,0.0,20628200.0,20669427.11,2018,5,25,TRANSFER,20628200.0,M856602031
10407,409000438620',2018-05-25,CB814113821635/RMCPL11793/2,3000.0,0.0,20666427.11,2018,5,25,PAYEMENT,3000.0,M234349419
10408,409000438620',2018-05-25,TRF TO  Indiaforensic SERVICES I,15000000.0,0.0,5666427.109999998,2018,5,25,CASH_OUT,15000000.0,M168501791
10409,409000438620',2018-05-25,TRF TO  Indiaforensic SERVICES I,5600000.0,0.0,66427.10999999568,2018,5,25,CHECK_WITHDRAWAL,5600000.0,M864961055
10410,409000438620',2018-05-25,AEPS INCOME DT 24-05-2018,0.0,50158.94,116586.04999999568,2018,5,25,CHECK_CASHING,50158.94,M1580793888
10411,409000438620',2018-05-25,AEPS GST INC DT 24-05-201,0.0,10031.79,126617.83999999569,2018,5,25,TRANSFER,10031.79,M513341170
10412,409000438620',2018-05-25,AEPS ACQUIRING ADJ FEES 2,35.4,0.0,126582.43999999572,2018,5,25,PAYEMENT,35.4,M189183471
10413,409000438620',2018-05-26,MAW/5029649807690078/NAGA,0.0,100.0,126682.43999999572,2018,5,26,CASH_IN,100.0,M870046536
10414,409000438620',2018-05-28,Indiaforensic AEPS NPCI WDL SET,0.0,21378100.0,21504782.439999994,2018,5,28,CHECK_CASHING,21378100.0,M1414426942
10415,409000438620',2018-05-28,Indiaforensic AEPS NPCI WDL SET,0.0,18407100.0,39911882.44,2018,5,28,CASH_IN,18407100.0,M1073049081
10416,409000438620',2018-05-28,Indiaforensic AEPS NPCI WDL SET,0.0,11986800.0,51898682.44,2018,5,28,TRANSFER,11986800.0,M946783398
10417,409000438620',2018-05-28,TRF TO  Indiaforensic SERVICES I,6800000.0,0.0,45098682.44,2018,5,28,PAYEMENT,6800000.0,M831500043
10418,409000438620',2018-05-28,TRF TO  Indiaforensic SERVICES I,15000000.0,0.0,30098682.44,2018,5,28,CHECK_WITHDRAWAL,15000000.0,M341859597
10419,409000438620',2018-05-28,TRF TO  Indiaforensic SERVICES I,15000000.0,0.0,15098682.439999998,2018,5,28,DEBIT,15000000.0,M1909740171
10420,409000438620',2018-05-28,TRF TO  Indiaforensic SERVICES I,15000000.0,0.0,98682.43999999762,2018,5,28,CASH_OUT,15000000.0,M303218042
10421,409000438620',2018-05-28,AEPS ACQUIRING ADJ FEES 2,32.45,0.0,98649.98999999762,2018,5,28,PAYEMENT,32.45,M109525828
10422,409000438620',2018-05-28,AEPS ACQ CR ADJ FEES 2505,453.71,0.0,98196.2799999976,2018,5,28,PAYEMENT,453.71,M1704407445
10423,409000438620',2018-05-29,Indiaforensic AEPS NPCI WDL SET,0.0,21538200.0,21636396.28,2018,5,29,CASH_IN,21538200.0,M743237033
10424,409000438620',2018-05-29,CR814311346216/RMCPL19418,500.0,0.0,21635896.28,2018,5,29,CASH_OUT,500.0,M1594037322
10425,409000438620',2018-05-29,CR814311346225/RMCPL22799,3000.0,0.0,21632896.28,2018,5,29,PAYEMENT,3000.0,M1919799084
10426,409000438620',2018-05-29,CR814311346237/RMCPL03657,4500.0,0.0,21628396.28,2018,5,29,CASH_OUT,4500.0,M316259584
10427,409000438620',2018-05-29,CR814312368420/RMCPL18841,3000.0,0.0,21625396.28,2018,5,29,PAYEMENT,3000.0,M255321531
10428,409000438620',2018-05-29,CR814312368430/RMCPL17555,1000.0,0.0,21624396.28,2018,5,29,DEBIT,1000.0,M2145176789
10429,409000438620',2018-05-29,CR814316422042/RMCPL17454,8000.0,0.0,21616396.28,2018,5,29,CASH_OUT,8000.0,M641896206
10430,409000438620',2018-05-29,CR814316422054/RMCPL16754,2400.0,0.0,21613996.28,2018,5,29,PAYEMENT,2400.0,M222454321
10431,409000438620',2018-05-29,CR814316422154/RMCPL22925,3000.0,0.0,21610996.28,2018,5,29,CASH_OUT,3000.0,M1822659962
10432,409000438620',2018-05-29,CR814316422161/RMCPL19130,1000.0,0.0,21609996.28,2018,5,29,CASH_OUT,1000.0,M1810260034
10433,409000438620',2018-05-29,CR814316422177/RMCPL22253,1500.0,0.0,21608496.28,2018,5,29,PAYEMENT,1500.0,M535558022
10434,409000438620',2018-05-29,CR814316422261/RMCPL13556,5000.0,0.0,21603496.28,2018,5,29,CASH_OUT,5000.0,M1827554264
10435,409000438620',2018-05-29,CR814316422265/RMCPL14498,500.0,0.0,21602996.28,2018,5,29,PAYEMENT,500.0,M1579289574
10436,409000438620',2018-05-29,CR814316421834/RMCPL23517,1000.0,0.0,21601996.28,2018,5,29,CASH_OUT,1000.0,M1656185923
10437,409000438620',2018-05-29,CR814316421842/RMCPL24236,3000.0,0.0,21598996.28,2018,5,29,CASH_OUT,3000.0,C309167705
10438,409000438620',2018-05-29,CR814316421865/RMCPL14995,500.0,0.0,21598496.28,2018,5,29,DEBIT,500.0,M711543932
10439,409000438620',2018-05-29,CR814316421866/RMCPL22241,10000.0,0.0,21588496.28,2018,5,29,PAYEMENT,10000.0,M1072234672
10440,409000438620',2018-05-29,CR814316421875/RMCPL18014,1200.0,0.0,21587296.28,2018,5,29,CASH_OUT,1200.0,M1196296884
10441,409000438620',2018-05-29,CR814316421883/RMCPL24959,2100.0,0.0,21585196.28,2018,5,29,PAYEMENT,2100.0,M1856936085
10442,409000438620',2018-05-29,CR814316421900/RMCPL16278,500.0,0.0,21584696.28,2018,5,29,DEBIT,500.0,M1541464431
10443,409000438620',2018-05-29,CR814316421921/RMCPL15384,1000.0,0.0,21583696.28,2018,5,29,CASH_OUT,1000.0,M2008009697
10444,409000438620',2018-05-29,CR814316421931/RMCPL09612,4000.0,0.0,21579696.28,2018,5,29,PAYEMENT,4000.0,C836514715
10445,409000438620',2018-05-29,CR814316421933/RMCPL12343,1000.0,0.0,21578696.28,2018,5,29,CASH_OUT,1000.0,M882695706
10446,409000438620',2018-05-29,CR814316421940/RMCPL21824,1500.0,0.0,21577196.28,2018,5,29,PAYEMENT,1500.0,M1473697285
10447,409000438620',2018-05-29,CR814316421952/RMCPL14190,3500.0,0.0,21573696.28,2018,5,29,CASH_OUT,3500.0,C1196694338
10448,409000438620',2018-05-29,CR814213090372/RMCPL24303,4000.0,0.0,21569696.28,2018,5,29,CHECK_WITHDRAWAL,4000.0,C1781062023
10449,409000438620',2018-05-29,CR814213090413/RMCPL09489,500.0,0.0,21569196.28,2018,5,29,PAYEMENT,500.0,C1933965693
10450,409000438620',2018-05-29,CR814213090346/RMCPL13700,5000.0,0.0,21564196.28,2018,5,29,DEBIT,5000.0,M2113997762
10451,409000438620',2018-05-29,CR814213090354/RMCPL23760,2500.0,0.0,21561696.28,2018,5,29,DEBIT,2500.0,M1010421631
10452,409000438620',2018-05-29,CR814213090387/RMCPL12343,10000.0,0.0,21551696.28,2018,5,29,DEBIT,10000.0,M1907586623
10453,409000438620',2018-05-29,CR814213090402/RMCPL22056,4000.0,0.0,21547696.28,2018,5,29,DEBIT,4000.0,M911264794
10454,409000438620',2018-05-29,CR814213090461/RMCPL25729,6000.0,0.0,21541696.28,2018,5,29,CASH_OUT,6000.0,M174377599
10455,409000438620',2018-05-29,CR814211064246/RMCPL14948,500.0,0.0,21541196.28,2018,5,29,DEBIT,500.0,M2076950851
10456,409000438620',2018-05-29,CR814211064248/RMCPL24617,500.0,0.0,21540696.28,2018,5,29,DEBIT,500.0,M1426599080
10457,409000438620',2018-05-29,CR814211064249/RMCPL22022,1000.0,0.0,21539696.28,2018,5,29,DEBIT,1000.0,M1678956565
10458,409000438620',2018-05-29,CR814211064251/RMCPL25730,700.0,0.0,21538996.28,2018,5,29,DEBIT,700.0,M279903888
10459,409000438620',2018-05-29,CR814213090537/RMCPL21404,2500.0,0.0,21536496.28,2018,5,29,CASH_OUT,2500.0,M357183868
10460,409000438620',2018-05-29,CR814213090270/RMCPL17491,2000.0,0.0,21534496.28,2018,5,29,PAYEMENT,2000.0,M1231365169
10461,409000438620',2018-05-29,CR814212074496/RMCPL12343,3000.0,0.0,21531496.28,2018,5,29,CASH_OUT,3000.0,C1028574311
10462,409000438620',2018-05-29,CR814213090579/RMCPL22941,1000.0,0.0,21530496.28,2018,5,29,CHECK_WITHDRAWAL,1000.0,C440708502
10463,409000438620',2018-05-29,CR814213090262/RMCPL16275,1000.0,0.0,21529496.28,2018,5,29,CHECK_WITHDRAWAL,1000.0,C1169903663
10464,409000438620',2018-05-29,CR814213090551/RMCPL20613,1000.0,0.0,21528496.28,2018,5,29,PAYEMENT,1000.0,C515132998
10465,409000438620',2018-05-29,AEPS ACQ REP ADJ FEES 280,0.0,182.9,21528679.18,2018,5,29,TRANSFER,182.9,M1550514509
10466,409000438620',2018-05-29,TRF TO  Indiaforensic SERVICES I,15000000.0,0.0,6528679.179999996,2018,5,29,CASH_OUT,15000000.0,M454887754
10467,409000438620',2018-05-29,TRF TO  Indiaforensic SERVICES I,500000.0,0.0,6028679.179999996,2018,5,29,PAYEMENT,500000.0,M2099091301
10468,409000438620',2018-05-29,TRF TO  Indiaforensic SERVICES I,3000000.0,0.0,3028679.1799999964,2018,5,29,CASH_OUT,3000000.0,M2007139879
10469,409000438620',2018-05-29,TRF TO  Indiaforensic SERVICES I,2000000.0,0.0,1028679.179999996,2018,5,29,CHECK_WITHDRAWAL,2000000.0,M623059508
10470,409000438620',2018-05-29,TRF TO  Indiaforensic SERVICES I,1000000.0,0.0,28679.179999995977,2018,5,29,CHECK_WITHDRAWAL,1000000.0,M1990255279
10471,409000438620',2018-05-29,MAW/5029649805976016/Akol,0.0,1800.0,30479.179999995977,2018,5,29,CHECK_CASHING,1800.0,C1396297158
10472,409000438620',2018-05-29,AEPS INCOME DT 25-05-2018,0.0,51864.52,82343.69999999598,2018,5,29,CHECK_CASHING,51864.52,C1505755152
10473,409000438620',2018-05-29,AEPS GST INC DT 25-05-201,0.0,10372.9,92716.59999999596,2018,5,29,CHECK_CASHING,10372.9,C453211571
10474,409000438620',2018-05-29,AEPS INCOME DT 26-05-2018,0.0,44084.03,136800.62999999596,2018,5,29,CHECK_CASHING,44084.03,C306206744
10475,409000438620',2018-05-29,AEPS GST INC DT 26-05-201,0.0,8816.81,145617.43999999596,2018,5,29,CASH_IN,8816.81,C170899621
10476,409000438620',2018-05-29,AEPS INCOME DT 27-05-2018,0.0,30108.83,175726.26999999594,2018,5,29,CASH_IN,30108.83,C1746150957
10477,409000438620',2018-05-29,AEPS GST INC DT 27-05-201,0.0,6021.77,181748.03999999593,2018,5,29,TRANSFER,6021.77,M615477623
10478,409000438620',2018-05-29,AEPS INCOME DT 28-05-2018,0.0,52273.3,234021.33999999595,2018,5,29,TRANSFER,52273.3,M407201667
10479,409000438620',2018-05-29,AEPS GST INC DT 28-05-201,0.0,10454.66,244475.99999999593,2018,5,29,CASH_IN,10454.66,M45599104
10480,409000438620',2018-05-30,MAW/5029649804017077/Vara,0.0,10000.0,254475.99999999593,2018,5,30,CASH_IN,10000.0,M2084517260
10481,409000438620',2018-05-30,Indiaforensic AEPS NPCI WDL SET,0.0,20843100.0,21097576.0,2018,5,30,CHECK_CASHING,20843100.0,M2087987156
10482,409000438620',2018-05-30,TRF TO  Indiaforensic SERVICES I,15000000.0,0.0,6097575.999999996,2018,5,30,PAYEMENT,15000000.0,M522557073
10483,409000438620',2018-05-30,TRF TO  Indiaforensic SERVICES I,6000000.0,0.0,97575.99999999627,2018,5,30,CASH_OUT,6000000.0,M448125452
10484,409000438620',2018-05-30,MAW/5029649812210102/Vals,0.0,1000.0,98575.99999999627,2018,5,30,TRANSFER,1000.0,M700239275
10485,409000438620',2018-05-30,AEPS INCOME DT 29-05-2018,0.0,50492.93,149068.92999999627,2018,5,30,TRANSFER,50492.93,M1256554496
10486,409000438620',2018-05-30,AEPS GST INC DT 29-05-201,0.0,10098.59,159167.51999999626,2018,5,30,CHECK_CASHING,10098.59,C2128665553
10487,409000438620',2018-05-30,AEPS ACQUIRING ADJ FEES 2,17.7,0.0,159149.81999999625,2018,5,30,PAYEMENT,17.7,C1277694634
10488,409000438620',2018-05-31,MAW/5029649804017077/Vara,0.0,10000.0,169149.81999999625,2018,5,31,TRANSFER,10000.0,M1466870930
10489,409000438620',2018-05-31,Indiaforensic AEPS NPCI WDL SET,0.0,20946700.0,21115849.82,2018,5,31,CHECK_CASHING,20946700.0,C1954751748
10490,409000438620',2018-05-31,CR814409573437/RMCPL12343/2,1000.0,0.0,21114849.82,2018,5,31,DEBIT,1000.0,C232834050
10491,409000438620',2018-05-31,CR814409573475/RMCPL18214/2,1000.0,0.0,21113849.82,2018,5,31,CHECK_WITHDRAWAL,1000.0,M388864946
10492,409000438620',2018-05-31,CR814409573464/RMCPL20108/2,500.0,0.0,21113349.82,2018,5,31,CHECK_WITHDRAWAL,500.0,C1615804266
10493,409000438620',2018-05-31,CR814417705972/RMCPL22341/2,2900.0,0.0,21110449.82,2018,5,31,DEBIT,2900.0,C345603257
10494,409000438620',2018-05-31,CR814416697987/RMCPL16388/2,2000.0,0.0,21108449.82,2018,5,31,CHECK_WITHDRAWAL,2000.0,C1494895909
10495,409000438620',2018-05-31,CR814416697979/RMCPL23233/2,600.0,0.0,21107849.82,2018,5,31,CHECK_WITHDRAWAL,600.0,C373415859
10496,409000438620',2018-05-31,CR814811565959/RMCPL10677/2,1000.0,0.0,21106849.82,2018,5,31,CASH_OUT,1000.0,C2145942542
10497,409000438620',2018-05-31,CR814811576428/RMCPL20241/2,500.0,0.0,21106349.82,2018,5,31,CHECK_WITHDRAWAL,500.0,C582320549
10498,409000438620',2018-05-31,CR814811581947/RMCPL20275/2,1000.0,0.0,21105349.82,2018,5,31,CHECK_WITHDRAWAL,1000.0,C1661048214
10499,409000438620',2018-05-31,CR814815648246/RMCPL22520/2,1000.0,0.0,21104349.82,2018,5,31,DEBIT,1000.0,C1954751748
10500,409000438620',2018-05-31,CR814815648245/RMCPL09003/2,1000.0,0.0,21103349.82,2018,5,31,CHECK_WITHDRAWAL,1000.0,C1060041730
10501,409000438620',2018-05-31,CR814815648247/RMCPL25783/2,1000.0,0.0,21102349.82,2018,5,31,CHECK_WITHDRAWAL,1000.0,C2063763486
10502,409000438620',2018-05-31,CR814510865344/RMCPL19090/2,1600.0,0.0,21100749.82,2018,5,31,CHECK_WITHDRAWAL,1600.0,C1849933855
10503,409000438620',2018-05-31,CR814511891896/RMCPL21533/2,8000.0,0.0,21092749.82,2018,5,31,DEBIT,8000.0,C9916873
10504,409000438620',2018-05-31,CR814511891876/RMCPL16251/2,2000.0,0.0,21090749.82,2018,5,31,CHECK_WITHDRAWAL,2000.0,C373928166
10505,409000438620',2018-05-31,CR814512904800/RMCPL11375/2,500.0,0.0,21090249.82,2018,5,31,PAYEMENT,500.0,C1273939873
10506,409000438620',2018-05-31,CR814512917969/RMCPL20589/2,3000.0,0.0,21087249.82,2018,5,31,PAYEMENT,3000.0,C603023442
10507,409000438620',2018-05-31,CR814610128283/RMCPL09710/2,2500.0,0.0,21084749.82,2018,5,31,PAYEMENT,2500.0,C1635341595
10508,409000438620',2018-05-31,CR814610128289/RMCPL19751/2,5000.0,0.0,21079749.82,2018,5,31,CHECK_WITHDRAWAL,5000.0,C789195255
10509,409000438620',2018-05-31,MAW/5029649806207502/Akol,0.0,500.0,21080249.82,2018,5,31,CASH_IN,500.0,C248609774
10510,409000438620',2018-05-31,MAW/5029649804272227/Kush,0.0,10000.0,21090249.82,2018,5,31,TRANSFER,10000.0,C1247600089
10511,409000438620',2018-05-31,TRF TO  Indiaforensic SERVICES I,15000000.0,0.0,6090249.8199999975,2018,5,31,CASH_OUT,15000000.0,C952610115
10512,409000438620',2018-05-31,TRF TO  Indiaforensic SERVICES I,6000000.0,0.0,90249.81999999656,2018,5,31,CASH_OUT,6000000.0,C1016689071
10513,409000438620',2018-05-31,AEPS INCOME DT 30-05-2018,0.0,50906.24,141156.05999999653,2018,5,31,CHECK_CASHING,50906.24,C1049804269
10514,409000438620',2018-05-31,AEPS GST INC DT 30-05-201,0.0,10181.25,151337.30999999653,2018,5,31,CHECK_CASHING,10181.25,C2145041211
10515,409000438620',2018-05-31,AEPS ACQ CR ADJ FEES 3005,171.69,0.0,151165.61999999653,2018,5,31,PAYEMENT,171.69,C1060041730
10516,409000438620',2018-05-31,AEPS ACQ REP ADJ FEES 300,0.0,14.75,151180.36999999653,2018,5,31,CASH_IN,14.75,C1315729466
10517,409000438620',2018-06-01,Indiaforensic AEPS NPCI WDL SET,0.0,18806500.0,18957680.37,2018,6,1,TRANSFER,18806500.0,C667504652
10518,409000438620',2018-06-01,CR814911860849/RMCPL24867/2,1000.0,0.0,18956680.37,2018,6,1,CHECK_WITHDRAWAL,1000.0,C1504109395
10519,409000438620',2018-06-01,CR814913883552/RMCPL14048/2,1100.0,0.0,18955580.37,2018,6,1,CHECK_WITHDRAWAL,1100.0,C125722707
10520,409000438620',2018-06-01,CR814911860843/RMCPL09519/2,5000.0,0.0,18950580.37,2018,6,1,PAYEMENT,5000.0,C1039865382
10521,409000438620',2018-06-01,CR814910838160/RMCPL20553/2,500.0,0.0,18950080.37,2018,6,1,CASH_OUT,500.0,C1359484306
10522,409000438620',2018-06-01,MAW/5029649805791001/Akol,0.0,2500.0,18952580.37,2018,6,1,TRANSFER,2500.0,C2007792854
10523,409000438620',2018-06-01,MAW/5029649805791019/Akol,0.0,1500.0,18954080.37,2018,6,1,CHECK_CASHING,1500.0,C289039926
10524,409000438620',2018-06-01,TRF TO  Indiaforensic SERVICES I,15000000.0,0.0,3954080.369999997,2018,6,1,PAYEMENT,15000000.0,C1406749291
10525,409000438620',2018-06-01,TRF TO  Indiaforensic SERVICES I,3900000.0,0.0,54080.36999999732,2018,6,1,PAYEMENT,3900000.0,C1300183775
10526,409000438620',2018-06-01,AEPS INCOME DT 31-05-2018,0.0,44393.68,98474.04999999733,2018,6,1,TRANSFER,44393.68,C551545010
10527,409000438620',2018-06-01,AEPS GST INC DT 31-05-201,0.0,8878.74,107352.78999999733,2018,6,1,TRANSFER,8878.74,C717951588
10528,409000438620',2018-06-01,AEPS ACQ CR ADJ FEES 3105,33.02,0.0,107319.76999999733,2018,6,1,CASH_OUT,33.02,C1529115495
10529,409000438620',2018-06-01,MAW/5029649804017077/Vara,0.0,10000.0,117319.76999999733,2018,6,1,CHECK_CASHING,10000.0,C787033725
10530,409000438620',2018-06-02,Indiaforensic AEPS NPCI WDL SET,0.0,22445200.0,22562519.77,2018,6,2,TRANSFER,22445200.0,C1778801068
10531,409000438620',2018-06-02,TRF TO  Indiaforensic SERVICES I,500000.0,0.0,22062519.77,2018,6,2,CASH_OUT,500000.0,C801142660
10532,409000438620',2018-06-02,TRF TO  Indiaforensic SERVICES I,2000000.0,0.0,20062519.77,2018,6,2,CHECK_WITHDRAWAL,2000000.0,C691636444
10533,409000438620',2018-06-02,TRF TO  Indiaforensic SERVICES I,10000000.0,0.0,10062519.769999996,2018,6,2,CASH_OUT,10000000.0,C2113748097
10534,409000438620',2018-06-02,TRF TO  Indiaforensic SERVICES I,4000000.0,0.0,6062519.769999996,2018,6,2,PAYEMENT,4000000.0,C1671179293
10535,409000438620',2018-06-02,TRF TO  Indiaforensic SERVICES I,3000000.0,0.0,3062519.7699999963,2018,6,2,CASH_OUT,3000000.0,C1247658278
10536,409000438620',2018-06-02,TRF TO  Indiaforensic SERVICES I,3000000.0,0.0,62519.76999999582,2018,6,2,CASH_OUT,3000000.0,C1289453529
10537,409000438620',2018-06-02,AEPS INCOME DT 01-06-2018,0.0,52808.72,115328.48999999586,2018,6,2,CASH_IN,52808.72,C2036762590
10538,409000438620',2018-06-02,AEPS GST INC DT 01-06-201,0.0,10561.74,125890.22999999586,2018,6,2,TRANSFER,10561.74,C904861071
10539,409000438620',2018-06-02,AEPS ACQUIRING ADJ FEES 0,47.2,0.0,125843.02999999588,2018,6,2,PAYEMENT,47.2,C349015546
10540,409000438620',2018-06-02,MAW/5029649804017077/Vara,0.0,10000.0,135843.02999999587,2018,6,2,TRANSFER,10000.0,C127252077
10541,409000438620',2018-06-03,MAW/5029649808809255/NAGA,0.0,1100.0,136943.02999999587,2018,6,3,CASH_IN,1100.0,C1475395523
10542,409000438620',2018-06-04,MAW/5029649804017077/Vara,0.0,10000.0,146943.02999999587,2018,6,4,CASH_IN,10000.0,C705265015
10543,409000438620',2018-06-04,Indiaforensic AEPS NPCI WDL SET,0.0,18390200.0,18537143.03,2018,6,4,TRANSFER,18390200.0,C405804899
10544,409000438620',2018-06-04,Indiaforensic AEPS NPCI WDL SET,0.0,13472900.0,32010043.03,2018,6,4,CASH_IN,13472900.0,C1334272276
10545,409000438620',2018-06-04,MAW/5029649809768476/Vals,0.0,4000.0,32014043.03,2018,6,4,TRANSFER,4000.0,C1619282151
10546,409000438620',2018-06-04,TRF TO  Indiaforensic SERVICES I,15000000.0,0.0,17014043.029999994,2018,6,4,CHECK_WITHDRAWAL,15000000.0,C1354725727
10547,409000438620',2018-06-04,TRF TO  Indiaforensic SERVICES I,15000000.0,0.0,2014043.0299999968,2018,6,4,PAYEMENT,15000000.0,C2040603986
10548,409000438620',2018-06-04,TRF TO  Indiaforensic SERVICES I,2000000.0,0.0,14043.029999997469,2018,6,4,CASH_OUT,2000000.0,C1721246982
10549,409000438620',2018-06-04,AEPS INCOME DT 02-06-2018,0.0,43728.11,57771.13999999747,2018,6,4,TRANSFER,43728.11,M59295878
10550,409000438620',2018-06-04,AEPS GST INC DT 02-06-201,0.0,8745.62,66516.75999999746,2018,6,4,CHECK_CASHING,8745.62,C1261940766
10551,409000438620',2018-06-04,AEPS INCOME DT 03-06-2018,0.0,33563.72,100080.47999999746,2018,6,4,TRANSFER,33563.72,M561525341
10552,409000438620',2018-06-04,AEPS GST INC DT 03-06-201,0.0,6712.74,106793.21999999748,2018,6,4,CASH_IN,6712.74,M332309465
10553,409000438620',2018-06-04,AEPS ACQUIRING ADJ FEES 0,17.7,0.0,106775.51999999749,2018,6,4,CASH_OUT,17.7,C861720625
10554,409000438620',2018-06-04,AEPS ACQ CR ADJ FEES 0206,8.85,0.0,106766.66999999748,2018,6,4,CHECK_WITHDRAWAL,8.85,M749295648
10555,409000438620',2018-06-04,CR815112403718/RMCPL00029/3,500.0,0.0,106266.66999999748,2018,6,4,CHECK_WITHDRAWAL,500.0,C51626955
10556,409000438620',2018-06-04,CR815112403700/RMCPL23829/3,500.0,0.0,105766.66999999748,2018,6,4,DEBIT,500.0,M2063660633
10557,409000438620',2018-06-04,CR815111392731/RMCPL23976/3,500.0,0.0,105266.66999999748,2018,6,4,CASH_OUT,500.0,C1538961175
10558,409000438620',2018-06-05,Indiaforensic AEPS NPCI WDL SET,0.0,20267200.0,20372466.67,2018,6,5,CASH_IN,20267200.0,C1446521801
10559,409000438620',2018-06-05,CB814311346232/RMCPL14145/2,7000.0,0.0,20365466.67,2018,6,5,PAYEMENT,7000.0,M733753625
10560,409000438620',2018-06-05,CB814417705974/RMCPL24076/2,6200.0,0.0,20359266.67,2018,6,5,PAYEMENT,6200.0,C1249000159
10561,409000438620',2018-06-05,TRF TO  Indiaforensic SERVICES I,10000000.0,0.0,10359266.669999998,2018,6,5,DEBIT,10000000.0,M257947563
10562,409000438620',2018-06-05,TRF TO  Indiaforensic SERVICES I,10000000.0,0.0,359266.6699999981,2018,6,5,DEBIT,10000000.0,C1954751748
10563,409000438620',2018-06-05,AEPS INCOME DT 04-06-2018,0.0,48085.36,407352.0299999981,2018,6,5,TRANSFER,48085.36,M1297818790
10564,409000438620',2018-06-05,AEPS GST INC DT 04-06-201,0.0,9617.07,416969.0999999981,2018,6,5,CHECK_CASHING,9617.07,C62593131
10565,409000438620',2018-06-06,Indiaforensic AEPS NPCI WDL SET,0.0,19181800.0,19598769.1,2018,6,6,CASH_IN,19181800.0,C128870695
10566,409000438620',2018-06-06,MAW/5029649807139282/NAGA,0.0,700.0,19599469.1,2018,6,6,TRANSFER,700.0,C977993101
10567,409000438620',2018-06-06,TRF TO  Indiaforensic SERVICES I,15000000.0,0.0,4599469.099999998,2018,6,6,DEBIT,15000000.0,C372017580
10568,409000438620',2018-06-06,TRF TO  Indiaforensic SERVICES I,4500000.0,0.0,99469.09999999775,2018,6,6,CASH_OUT,4500000.0,M348263892
10569,409000438620',2018-06-06,AEPS INCOME DT 05-06-2018,0.0,45698.45,145167.54999999778,2018,6,6,CHECK_CASHING,45698.45,C423580937
10570,409000438620',2018-06-06,AEPS GST INC DT 05-06-201,0.0,9139.69,154307.23999999778,2018,6,6,CASH_IN,9139.69,M1265301783
10571,409000438620',2018-06-06,AEPS ACQ REP ADJ FEES 050,0.0,47.2,154354.4399999978,2018,6,6,CHECK_CASHING,47.2,M2004688390
10572,409000438620',2018-06-07,Indiaforensic AEPS NPCI WDL SET,0.0,20080100.0,20234454.44,2018,6,7,TRANSFER,20080100.0,C2063763486
10573,409000438620',2018-06-07,CR815211655462/RMCPL13894/0,2000.0,0.0,20232454.44,2018,6,7,CHECK_WITHDRAWAL,2000.0,M1614289005
10574,409000438620',2018-06-07,CR815211655455/RMCPL23894/0,3000.0,0.0,20229454.44,2018,6,7,DEBIT,3000.0,M1268142866
10575,409000438620',2018-06-07,CR815218793339/RMCPL19867/0,500.0,0.0,20228954.44,2018,6,7,CASH_OUT,500.0,M874281235
10576,409000438620',2018-06-07,CR815216750138/RMCPL13506/0,1500.0,0.0,20227454.44,2018,6,7,CHECK_WITHDRAWAL,1500.0,M1741788768
10577,409000438620',2018-06-07,CR815216750117/RMCPL09588/0,10000.0,0.0,20217454.44,2018,6,7,CHECK_WITHDRAWAL,10000.0,M456795577
10578,409000438620',2018-06-07,CR815216750131/RMCPL00195/0,700.0,0.0,20216754.44,2018,6,7,CHECK_WITHDRAWAL,700.0,M1551515971
10579,409000438620',2018-06-07,CR815211655459/RMCPL26209/0,4000.0,0.0,20212754.44,2018,6,7,CASH_OUT,4000.0,M315925820
10580,409000438620',2018-06-07,CR815216760362/RMCPL18067/0,5000.0,0.0,20207754.44,2018,6,7,CASH_OUT,5000.0,M921279438
10581,409000438620',2018-06-07,CR815216760346/RMCPL22341/0,10000.0,0.0,20197754.44,2018,6,7,CHECK_WITHDRAWAL,10000.0,M328963989
10582,409000438620',2018-06-07,CR815216760358/RMCPL14165/0,1000.0,0.0,20196754.44,2018,6,7,CHECK_WITHDRAWAL,1000.0,M1827301332
10583,409000438620',2018-06-07,CR815218793614/RMCPL14902/0,2000.0,0.0,20194754.44,2018,6,7,CHECK_WITHDRAWAL,2000.0,M245726135
10584,409000438620',2018-06-07,CR815316036765/RMCPL13859/0,2000.0,0.0,20192754.44,2018,6,7,CASH_OUT,2000.0,M436966008
10585,409000438620',2018-06-07,CR815310934479/RMCPL21595/0,6000.0,0.0,20186754.44,2018,6,7,CHECK_WITHDRAWAL,6000.0,M359166884
10586,409000438620',2018-06-07,TRF TO  Indiaforensic SERVICES I,15000000.0,0.0,5186754.439999999,2018,6,7,DEBIT,15000000.0,M1918455385
10587,409000438620',2018-06-07,TRF TO  Indiaforensic SERVICES I,4000000.0,0.0,1186754.4399999976,2018,6,7,CASH_OUT,4000000.0,C1549086472
10588,409000438620',2018-06-07,TRF TO  Indiaforensic SERVICES I,1000000.0,0.0,186754.43999999762,2018,6,7,CHECK_WITHDRAWAL,1000000.0,C1327907419
10589,409000438620',2018-06-07,AEPS INCOME DT 06-06-2018,0.0,48614.9,235369.3399999976,2018,6,7,CHECK_CASHING,48614.9,M170680424
10590,409000438620',2018-06-07,AEPS GST INC DT 06-06-201,0.0,9722.98,245092.31999999762,2018,6,7,CASH_IN,9722.98,M1092551416
10591,409000438620',2018-06-07,AEPS ACQ CR ADJ FEES 0606,163.43,0.0,244928.8899999977,2018,6,7,CASH_OUT,163.43,M1685438350
10592,409000438620',2018-06-07,MAW/5029649805749819/NAGA,0.0,6000.0,250928.8899999977,2018,6,7,CASH_IN,6000.0,M1775743481
10593,409000438620',2018-06-07,TRF TO  Indiaforensic SERVICES I,250000.0,0.0,928.8899999976276,2018,6,7,DEBIT,250000.0,C1805445027
10594,409000438620',2018-06-08,Indiaforensic AEPS NPCI WDL SET,0.0,19505400.0,19506328.89,2018,6,8,TRANSFER,19505400.0,C529404054
10595,409000438620',2018-06-08,TRFT O  Indiaforensic SERVICES I,15000000.0,0.0,4506328.889999997,2018,6,8,CHECK_WITHDRAWAL,15000000.0,M129540299
10596,409000438620',2018-06-08,TRF TO  Indiaforensic SERVICES I,500000.0,0.0,4006328.889999997,2018,6,8,CHECK_WITHDRAWAL,500000.0,M1291354646
10597,409000438620',2018-06-08,TRF TO  Indiaforensic SERVICES I,4000000.0,0.0,6328.889999996873,2018,6,8,DEBIT,4000000.0,M2040419352
10598,409000438620',2018-06-08,AEPS INCOME DT 07-06-2018,0.0,45683.32,52012.20999999686,2018,6,8,CASH_IN,45683.32,M215797901
10599,409000438620',2018-06-08,AEPS GST INC DT 07-06-201,0.0,9136.66,61148.86999999688,2018,6,8,TRANSFER,9136.66,M747280919
10600,409000438620',2018-06-08,AEPS ACQUIRING ADJ FEES 0,23.6,0.0,61125.26999999688,2018,6,8,PAYEMENT,23.6,M573698551
10601,409000438620',2018-06-08,AEPS ACQ CR ADJ FEES 0706,279.66,0.0,60845.60999999687,2018,6,8,PAYEMENT,279.66,M72440498
10602,409000438620',2018-06-08,CR815609734470/RMCPL11459/0,5000.0,0.0,55845.609999996865,2018,6,8,CASH_OUT,5000.0,M2044160724
10603,409000438620',2018-06-08,CR815610745510/RMCPL22124/0,1500.0,0.0,54345.609999996865,2018,6,8,PAYEMENT,1500.0,M304301695
10604,409000438620',2018-06-08,CR815609723994/RMCPL20257/0,1000.0,0.0,53345.609999996865,2018,6,8,DEBIT,1000.0,M552304533
10605,409000438620',2018-06-08,CR815611774518/RMCPL25552/0,1500.0,0.0,51845.609999996865,2018,6,8,CHECK_WITHDRAWAL,1500.0,M2085795145
10606,409000438620',2018-06-08,CR815610755903/RMCPL12343/0,3000.0,0.0,48845.609999996865,2018,6,8,CASH_OUT,3000.0,M611538916
10607,409000438620',2018-06-08,CR815611765135/RMCPL19418/0,1000.0,0.0,47845.609999996865,2018,6,8,PAYEMENT,1000.0,M1763977540
10608,409000438620',2018-06-08,CR815611765137/RMCPL14558/0,1200.0,0.0,46645.609999996865,2018,6,8,DEBIT,1200.0,M1955090397
10609,409000438620',2018-06-08,CR815616850064/RMCPL11794/0,7000.0,0.0,39645.60999999687,2018,6,8,CHECK_WITHDRAWAL,7000.0,M357921749
10610,409000438620',2018-06-08,CR815611774525/RMCPL18380/0,1000.0,0.0,38645.60999999687,2018,6,8,CHECK_WITHDRAWAL,1000.0,M1050302074
10611,409000438620',2018-06-08,CR815611774500/RMCPL15054/0,3500.0,0.0,35145.609999996865,2018,6,8,CASH_OUT,3500.0,M1159789396
10612,409000438620',2018-06-08,CR815611765136/RMCPL25344/0,5500.0,0.0,29645.609999996865,2018,6,8,CASH_OUT,5500.0,M1901558635
10613,409000438620',2018-06-08,CR815610745494/RMCPL12343/0,1000.0,0.0,28645.609999996865,2018,6,8,DEBIT,1000.0,M1733251124
10614,409000438620',2018-06-08,CR815612794979/RMCPL22866/0,500.0,0.0,28145.609999996865,2018,6,8,DEBIT,500.0,M640236114
10615,409000438620',2018-06-08,CR815612795003/RMCPL22086/0,2000.0,0.0,26145.609999996865,2018,6,8,CASH_OUT,2000.0,M557551894
10616,409000438620',2018-06-08,CR815613804753/RMCPL18492/0,2700.0,0.0,23445.609999996865,2018,6,8,DEBIT,2700.0,M1586776398
10617,409000438620',2018-06-08,CR815612784228/RMCPL20316/0,3000.0,0.0,20445.60999999686,2018,6,8,DEBIT,3000.0,M1510583900
10618,409000438620',2018-06-08,CR815617868688/RMCPL09591/0,3000.0,0.0,17445.60999999686,2018,6,8,CHECK_WITHDRAWAL,3000.0,M393123259
10619,409000438620',2018-06-08,CR815509433633/RMCPL11793/0,2000.0,0.0,15445.609999996863,2018,6,8,CHECK_WITHDRAWAL,2000.0,C767544292
10620,409000438620',2018-06-08,CR815519613869/RMCPL21345/0,1000.0,0.0,14445.609999996863,2018,6,8,CASH_OUT,1000.0,M380007800
10621,409000438620',2018-06-08,CR815509433629/RMCPL19789/0,1000.0,0.0,13445.609999996863,2018,6,8,CHECK_WITHDRAWAL,1000.0,C2136672550
10622,409000438620',2018-06-08,CR815510454879/RMCPL20680/0,1000.0,0.0,12445.609999996863,2018,6,8,DEBIT,1000.0,C242131142
10623,409000438620',2018-06-08,CR815513507794/RMCPL09591/0,8000.0,0.0,4445.609999996866,2018,6,8,CHECK_WITHDRAWAL,8000.0,C35263828
10624,409000438620',2018-06-08,CR815517571476/RMCPL18769/0,1500.0,0.0,2945.609999996865,2018,6,8,PAYEMENT,1500.0,M1687894945
10625,409000438620',2018-06-08,CR815511483827/RMCPL12959/0,1500.0,0.0,1445.6099999968646,2018,6,8,DEBIT,1500.0,M1553011216
10626,409000438620',2018-06-08,CR815510454883/RMCPL22312/0,1000.0,0.0,445.60999999686464,2018,6,8,CHECK_WITHDRAWAL,1000.0,M1831041361
10627,409000438620',2018-06-11,MAW/5029649806189049/Akol,0.0,4500.0,4945.609999996866,2018,6,11,TRANSFER,4500.0,C945327594
10628,409000438620',2018-06-11,Indiaforensic AEPS NPCI WDL SET,0.0,22173100.0,22178045.61,2018,6,11,CASH_IN,22173100.0,M892693231
10629,409000438620',2018-06-11,Indiaforensic AEPS NPCI WDL SET,0.0,20183900.0,42361945.61,2018,6,11,TRANSFER,20183900.0,M1147710054
10630,409000438620',2018-06-11,Indiaforensic AEPS NPCI WDL SET,0.0,11853000.0,54214945.61,2018,6,11,CASH_IN,11853000.0,C1736800800
10631,409000438620',2018-06-11,TRF TO  Indiaforensic SERVICES I,9200000.0,0.0,45014945.61,2018,6,11,PAYEMENT,9200000.0,M898304834
10632,409000438620',2018-06-11,TRF TO  Indiaforensic SERVICES I,15000000.0,0.0,30014945.61,2018,6,11,CHECK_WITHDRAWAL,15000000.0,M1509686365
10633,409000438620',2018-06-11,TRF TO  Indiaforensic SERVICES I,15000000.0,0.0,15014945.61,2018,6,11,PAYEMENT,15000000.0,C667346055
10634,409000438620',2018-06-11,TRF TO  Indiaforensic SERVICES I,15000000.0,0.0,14945.609999999404,2018,6,11,CASH_OUT,15000000.0,M500712548
10635,409000438620',2018-06-11,MAW/5029649803446863/Akol,0.0,6500.0,21445.609999999404,2018,6,11,CHECK_CASHING,6500.0,M844134705
10636,409000438620',2018-06-11,AEPS INCOME DT 08-06-2018,0.0,52153.57,73599.17999999941,2018,6,11,CHECK_CASHING,52153.57,C2036926986
10637,409000438620',2018-06-11,AEPS GST INC DT 08-06-201,0.0,10430.71,84029.8899999994,2018,6,11,TRANSFER,10430.71,M1862112967
10638,409000438620',2018-06-11,AEPS INCOME DT 09-06-2018,0.0,47961.71,131991.5999999994,2018,6,11,TRANSFER,47961.71,C580441921
10639,409000438620',2018-06-11,AEPS GST INC DT 09-06-201,0.0,9592.34,141583.9399999994,2018,6,11,CHECK_CASHING,9592.34,M618808159
10640,409000438620',2018-06-11,AEPS INCOME DT 10-06-2018,0.0,29655.23,171239.1699999994,2018,6,11,CHECK_CASHING,29655.23,M1443909252
10641,409000438620',2018-06-11,AEPS GST INC DT 10-06-201,0.0,5931.05,177170.21999999942,2018,6,11,CASH_IN,5931.05,M719868514
10642,409000438620',2018-06-11,AEPS ACQUIRING ADJ FEES 0,91.45,0.0,177078.76999999938,2018,6,11,PAYEMENT,91.45,M94210984
10643,409000438620',2018-06-12,Indiaforensic AEPS NPCI WDL SET,0.0,23390600.0,23567678.77,2018,6,12,TRANSFER,23390600.0,C1588318071
10644,409000438620',2018-06-12,CR815609724476/RMCPL20978/0,1000.0,0.0,23566678.77,2018,6,12,DEBIT,1000.0,C703957828
10645,409000438620',2018-06-12,TRF TO  Indiaforensic SERVICES I,15000000.0,0.0,8566678.77,2018,6,12,CHECK_WITHDRAWAL,15000000.0,M360073749
10646,409000438620',2018-06-12,TRF TO  Indiaforensic SERVICES I,8500000.0,0.0,66678.76999999955,2018,6,12,DEBIT,8500000.0,M1685325748
10647,409000438620',2018-06-12,AEPS INCOME DT 11-06-2018,0.0,55754.39,122433.15999999955,2018,6,12,CHECK_CASHING,55754.39,M1163648349
10648,409000438620',2018-06-12,AEPS GST INC DT 11-06-201,0.0,11150.88,133584.03999999954,2018,6,12,CHECK_CASHING,11150.88,M1789024671
10649,409000438620',2018-06-13,Indiaforensic AEPS NPCI WDL SET,0.0,25480600.0,25614184.04,2018,6,13,TRANSFER,25480600.0,C1085479446
10650,409000438620',2018-06-13,CR816011886923/RMCPL20527/0,1000.0,0.0,25613184.04,2018,6,13,PAYEMENT,1000.0,M270625801
10651,409000438620',2018-06-13,CR816009836626/RMCPL22967/0,1000.0,0.0,25612184.04,2018,6,13,CHECK_WITHDRAWAL,1000.0,C760563749
10652,409000438620',2018-06-13,CR816010867298/RMCPL20871/0,1000.0,0.0,25611184.04,2018,6,13,DEBIT,1000.0,M665440582
10653,409000438620',2018-06-13,CR816010867288/RMCPL24082/0,2000.0,0.0,25609184.04,2018,6,13,PAYEMENT,2000.0,M1763192842
10654,409000438620',2018-06-13,CR815911595626/RMCPL18460/0,2000.0,0.0,25607184.04,2018,6,13,CHECK_WITHDRAWAL,2000.0,C1276319779
10655,409000438620',2018-06-13,CR815916689441/RMCPL13836/0,1000.0,0.0,25606184.04,2018,6,13,CHECK_WITHDRAWAL,1000.0,M766147571
10656,409000438620',2018-06-13,CR815910576719/RMCPL17224/0,2000.0,0.0,25604184.04,2018,6,13,PAYEMENT,2000.0,C991505714
10657,409000438620',2018-06-13,CR815910576675/RMCPL23925/0,5000.0,0.0,25599184.04,2018,6,13,CHECK_WITHDRAWAL,5000.0,C1234059684
10658,409000438620',2018-06-13,CR815910586349/RMCPL16314/0,500.0,0.0,25598684.04,2018,6,13,CASH_OUT,500.0,C329829198
10659,409000438620',2018-06-13,CR815917706079/RMCPL11353/0,500.0,0.0,25598184.04,2018,6,13,CHECK_WITHDRAWAL,500.0,C1181708889
10660,409000438620',2018-06-13,CR815911595629/RMCPL22249/0,500.0,0.0,25597684.04,2018,6,13,CASH_OUT,500.0,M1682599387
10661,409000438620',2018-06-13,CR815912618442/RMCPL18492/0,2000.0,0.0,25595684.04,2018,6,13,CHECK_WITHDRAWAL,2000.0,M1181351354
10662,409000438620',2018-06-13,CR815916696102/RMCPL15451/0,5000.0,0.0,25590684.04,2018,6,13,PAYEMENT,5000.0,M299001026
10663,409000438620',2018-06-13,CR815912629648/RMCPL24871/0,1000.0,0.0,25589684.04,2018,6,13,CHECK_WITHDRAWAL,1000.0,M211486595
10664,409000438620',2018-06-13,CR815912629717/RMCPL18214/0,1500.0,0.0,25588184.04,2018,6,13,CASH_OUT,1500.0,M663656764
10665,409000438620',2018-06-13,CR815912618441/RMCPL25099/0,1000.0,0.0,25587184.04,2018,6,13,CHECK_WITHDRAWAL,1000.0,M1135528450
10666,409000438620',2018-06-13,CR815910576718/RMCPL09957/0,2100.0,0.0,25585084.04,2018,6,13,CHECK_WITHDRAWAL,2100.0,M1968098409
10667,409000438620',2018-06-13,CR815910576697/RMCPL17789/0,7000.0,0.0,25578084.04,2018,6,13,CASH_OUT,7000.0,M1017639320
10668,409000438620',2018-06-13,CR815816422734/RMCPL14126/0,500.0,0.0,25577584.04,2018,6,13,DEBIT,500.0,M1318413695
10669,409000438620',2018-06-13,CR815817426325/RMCPL21765/0,1000.0,0.0,25576584.04,2018,6,13,PAYEMENT,1000.0,M580747747
10670,409000438620',2018-06-13,CR815816417439/RMCPL25186/0,500.0,0.0,25576084.04,2018,6,13,PAYEMENT,500.0,M1422380969
10671,409000438620',2018-06-13,CR815712081324/RMCPL14380/0,600.0,0.0,25575484.04,2018,6,13,CHECK_WITHDRAWAL,600.0,M400057592
10672,409000438620',2018-06-13,CR815710048938/RMCPL18177/0,500.0,0.0,25574984.04,2018,6,13,PAYEMENT,500.0,M722544215
10673,409000438620',2018-06-13,CR815712081203/RMCPL23090/0,5000.0,0.0,25569984.04,2018,6,13,CHECK_WITHDRAWAL,5000.0,M90253078
10674,409000438620',2018-06-13,CB809618333637/RMCPL15079/0,10000.0,0.0,25559984.04,2018,6,13,DEBIT,10000.0,M1852986295
10675,409000438620',2018-06-13,CB815612795005/RMCPL23228/0,1000.0,0.0,25558984.04,2018,6,13,CASH_OUT,1000.0,M1625066228
10676,409000438620',2018-06-13,TRF TO  Indiaforensic SERVICES I,15000000.0,0.0,10558984.04,2018,6,13,PAYEMENT,15000000.0,M1330691916
10677,409000438620',2018-06-13,TRF TO  Indiaforensic SERVICES I,10500000.0,0.0,58984.03999999911,2018,6,13,PAYEMENT,10500000.0,M1832858963
10678,409000438620',2018-06-13,MAW/5029649805794468/Akol,0.0,1100.0,60084.03999999911,2018,6,13,CASH_IN,1100.0,M165220357
10679,409000438620',2018-06-13,AEPS INCOME DT 12-06-2018,0.0,61210.16,121294.19999999912,2018,6,13,CHECK_CASHING,61210.16,M1892190499
10680,409000438620',2018-06-13,AEPS GST INC DT 12-06-201,0.0,12242.03,133536.2299999991,2018,6,13,TRANSFER,12242.03,M957270657
10681,409000438620',2018-06-13,AEPS ACQUIRING ADJ FEES 1,17.7,0.0,133518.5299999991,2018,6,13,CHECK_WITHDRAWAL,17.7,C572453104
10682,409000438620',2018-06-13,AEPS ACQ CR ADJ FEES 1206,201.78,0.0,133316.7499999991,2018,6,13,CHECK_WITHDRAWAL,201.78,C710481910
10683,409000438620',2018-06-13,AEPS ACQ REP ADJ FEES 120,0.0,109.15,133425.8999999991,2018,6,13,CASH_IN,109.15,M643434317
10684,409000438620',2018-06-14,MAW/5029649805976016/Akol,0.0,1200.0,134625.8999999991,2018,6,14,TRANSFER,1200.0,C1758590178
10685,409000438620',2018-06-14,MAW/5029649809760978/Vals,0.0,10000.0,144625.8999999991,2018,6,14,CHECK_CASHING,10000.0,M791531721
10686,409000438620',2018-06-14,Indiaforensic AEPS NPCI WDL SET,0.0,22831100.0,22975725.9,2018,6,14,CHECK_CASHING,22831100.0,M2102626938
10687,409000438620',2018-06-14,TRF TO  Indiaforensic SERVICES I,15000000.0,0.0,7975725.8999999985,2018,6,14,CASH_OUT,15000000.0,C1938348365
10688,409000438620',2018-06-14,TRF TO  Indiaforensic SERVICES I,7900000.0,0.0,75725.89999999851,2018,6,14,DEBIT,7900000.0,M815817331
10689,409000438620',2018-06-14,MAW/5029649805528221/Akol,0.0,2100.0,77825.89999999851,2018,6,14,CASH_IN,2100.0,M392431380
10690,409000438620',2018-06-14,AEPS INCOME DT 13-06-2018,0.0,55166.35,132992.24999999852,2018,6,14,TRANSFER,55166.35,M1918333984
10691,409000438620',2018-06-14,AEPS GST INC DT 13-06-201,0.0,11033.27,144025.5199999985,2018,6,14,CASH_IN,11033.27,M492249567
10692,409000438620',2018-06-14,AEPS ACQUIRING ADJ FEES 1,60.18,0.0,143965.33999999848,2018,6,14,CHECK_WITHDRAWAL,60.18,M745269941
10693,409000438620',2018-06-14,AEPS ACQ REP ADJ FEES 130,0.0,17.7,143983.03999999852,2018,6,14,CHECK_CASHING,17.7,M1151283614
10694,409000438620',2018-06-15,MAW/502964XXXXXX0978/Vals,0.0,10000.0,153983.03999999852,2018,6,15,TRANSFER,10000.0,M1910644552
10695,409000438620',2018-06-15,Indiaforensic AEPS NPCI WDL SET,0.0,22893600.0,23047583.04,2018,6,15,CASH_IN,22893600.0,C522632546
10696,409000438620',2018-06-15,TRF TO  Indiaforensic SERVICES I,15000000.0,0.0,8047583.039999999,2018,6,15,CHECK_WITHDRAWAL,15000000.0,M1082053838
10697,409000438620',2018-06-15,TRF TO  Indiaforensic SERVICES I,4000000.0,0.0,4047583.04,2018,6,15,CASH_OUT,4000000.0,M1833298785
10698,409000438620',2018-06-15,TRF TO  Indiaforensic SERVICES I,4000000.0,0.0,47583.03999999911,2018,6,15,CASH_OUT,4000000.0,M1545271684
10699,409000438620',2018-06-15,AEPS INCOME DT 14-06-2018,0.0,53974.72,101557.7599999991,2018,6,15,CHECK_CASHING,53974.72,M58877251
10700,409000438620',2018-06-15,AEPS GST INC DT 14-06-201,0.0,10794.94,112352.69999999912,2018,6,15,CASH_IN,10794.94,C1856036778
10701,409000438620',2018-06-15,AEPS ACQUIRING ADJ FEES 1,35.4,0.0,112317.29999999912,2018,6,15,CHECK_WITHDRAWAL,35.4,C384887832
10702,409000438620',2018-06-15,AEPS INCOME DT 14-06-2018,0.0,53974.72,166292.01999999912,2018,6,15,CASH_IN,53974.72,C306206744
10703,409000438620',2018-06-15,AEPS GST INC DT 14-06-201,0.0,10794.94,177086.95999999915,2018,6,15,CASH_IN,10794.94,M1078625713
10704,409000438620',2018-06-16,MAW/502964XXXXXX0978/Vals,0.0,10000.0,187086.95999999915,2018,6,16,TRANSFER,10000.0,M360188840
10705,409000438620',2018-06-18,Indiaforensic AEPS NPCI WDL SET,0.0,16291500.0,16478586.96,2018,6,18,TRANSFER,16291500.0,C2043257128
10706,409000438620',2018-06-18,Indiaforensic AEPS NPCI WDL SET,0.0,12921000.0,29399586.96,2018,6,18,TRANSFER,12921000.0,M762202310
10707,409000438620',2018-06-18,TRF TO  Indiaforensic SERVICES I,15000000.0,0.0,14399586.96,2018,6,18,PAYEMENT,15000000.0,M1628765199
10708,409000438620',2018-06-18,TRF TO  Indiaforensic SERVICES I,5000000.0,0.0,9399586.96,2018,6,18,CHECK_WITHDRAWAL,5000000.0,M680941254
10709,409000438620',2018-06-18,TRF TO  Indiaforensic SERVICES I,5000000.0,0.0,4399586.960000001,2018,6,18,PAYEMENT,5000000.0,M1731155607
10710,409000438620',2018-06-18,TRF TO  Indiaforensic SERVICES I,4000000.0,0.0,399586.96000000095,2018,6,18,CASH_OUT,4000000.0,M47125104
10711,409000438620',2018-06-18,Indiaforensic AEPS NPCI WDL SET,0.0,21409400.0,21808986.96,2018,6,18,CASH_IN,21409400.0,M1460513012
10712,409000438620',2018-06-18,TRF TO  Indiaforensic SERVICES I,15000000.0,0.0,6808986.960000001,2018,6,18,CASH_OUT,15000000.0,M533863584
10713,409000438620',2018-06-18,TRF TO  Indiaforensic SERVICES I,6500000.0,0.0,308986.9600000009,2018,6,18,DEBIT,6500000.0,M823903651
10714,409000438620',2018-06-18,AEPS INCOME DT 15-06-2018,0.0,50970.31,359957.27000000095,2018,6,18,CHECK_CASHING,50970.31,M2112048053
10715,409000438620',2018-06-18,AEPS GST INC DT 15-06-201,0.0,10194.06,370151.33000000095,2018,6,18,TRANSFER,10194.06,M1161291278
10716,409000438620',2018-06-18,AEPS INCOME DT 16-06-2018,0.0,40528.05,410679.38000000094,2018,6,18,CASH_IN,40528.05,M200210900
10717,409000438620',2018-06-18,AEPS GST INC DT 16-06-201,0.0,8105.61,418784.9900000009,2018,6,18,CHECK_CASHING,8105.61,M728149087
10718,409000438620',2018-06-18,AEPS INCOME DT 17-06-2018,0.0,32311.55,451096.5400000009,2018,6,18,TRANSFER,32311.55,M110377322
10719,409000438620',2018-06-18,AEPS GST INC DT 17-06-201,0.0,6462.31,457558.850000001,2018,6,18,CHECK_CASHING,6462.31,M279104407
10720,409000438620',2018-06-18,REV AEPS INC DT 14-06-201,53974.72,0.0,403584.13000000076,2018,6,18,PAYEMENT,53974.72,C1705929636
10721,409000438620',2018-06-18,REV AEPS GST DT 14-06-201,10794.94,0.0,392789.19000000076,2018,6,18,DEBIT,10794.94,M1173866999
10722,409000438620',2018-06-19,Indiaforensic AEPS NPCI WDL SET,0.0,20585700.0,20978489.19,2018,6,19,CHECK_CASHING,20585700.0,M292435101
10723,409000438620',2018-06-19,TRF TO  Indiaforensic SERVICES I,15000000.0,0.0,5978489.190000001,2018,6,19,DEBIT,15000000.0,M1590360259
10724,409000438620',2018-06-19,TRF TO  Indiaforensic SERVICES I,5900000.0,0.0,78489.19000000134,2018,6,19,PAYEMENT,5900000.0,M129214241
10725,409000438620',2018-06-19,AEPS INCOME DT 18-06-2018,0.0,50166.78,128655.97000000135,2018,6,19,CHECK_CASHING,50166.78,M1660712442
10726,409000438620',2018-06-19,AEPS GST INC DT 18-06-201,0.0,10033.36,138689.33000000136,2018,6,19,CHECK_CASHING,10033.36,M1387468185
10727,409000438620',2018-06-20,Indiaforensic AEPS NPCI WDL SET,0.0,22099300.0,22237989.33,2018,6,20,CHECK_CASHING,22099300.0,M1956253499
10728,409000438620',2018-06-20,TRF TO Indiaforensic SERVICES IN,15000000.0,0.0,7237989.330000003,2018,6,20,CHECK_WITHDRAWAL,15000000.0,M1869942250
10729,409000438620',2018-06-20,TRF  FROM Indiaforensic SERVICES,7200000.0,0.0,37989.33000000194,2018,6,20,DEBIT,7200000.0,M2037798412
10730,409000438620',2018-06-20,AEPS INCOME DT 19-06-2018,0.0,53933.71,91923.04000000193,2018,6,20,CHECK_CASHING,53933.71,C219913687
10731,409000438620',2018-06-20,AEPS GST INC DT 19-06-201,0.0,10786.74,102709.78000000193,2018,6,20,CHECK_CASHING,10786.74,M1272825712
10732,409000438620',2018-06-20,AEPS ACQ CR ADJ FEES 1906,453.12,0.0,102256.66000000194,2018,6,20,CHECK_WITHDRAWAL,453.12,M924841146
10733,409000438620',2018-06-20,CR816410013229/RMCPL19723/1,500.0,0.0,101756.66000000194,2018,6,20,PAYEMENT,500.0,M134539897
10734,409000438620',2018-06-20,CR816410013230/RMCPL20185/1,1000.0,0.0,100756.66000000194,2018,6,20,DEBIT,1000.0,M1104601924
10735,409000438620',2018-06-20,CR816413068195/RMCPL12626/1,6400.0,0.0,94356.66000000194,2018,6,20,CASH_OUT,6400.0,M2039044723
10736,409000438620',2018-06-20,CR816413068178/RMCPL09617/1,800.0,0.0,93556.66000000194,2018,6,20,CHECK_WITHDRAWAL,800.0,M626663387
10737,409000438620',2018-06-20,CR816411022628/RMCPL14734/1,1000.0,0.0,92556.66000000194,2018,6,20,CHECK_WITHDRAWAL,1000.0,M1236424697
10738,409000438620',2018-06-20,CR816411022644/RMCPL22022/1,1500.0,0.0,91056.66000000194,2018,6,20,CHECK_WITHDRAWAL,1500.0,M1862374691
10739,409000438620',2018-06-20,CR816411022629/RMCPL20943/1,500.0,0.0,90556.66000000194,2018,6,20,DEBIT,500.0,M279482369
10740,409000438620',2018-06-20,CR816410013225/RMCPL12343/1,500.0,0.0,90056.66000000194,2018,6,20,DEBIT,500.0,C2109470512
10741,409000438620',2018-06-20,CR816312748180/RMCPL24661/1,3000.0,0.0,87056.66000000194,2018,6,20,CHECK_WITHDRAWAL,3000.0,C1009195400
10742,409000438620',2018-06-20,CR816710892427/RMCPL23564/1,4500.0,0.0,82556.66000000194,2018,6,20,CHECK_WITHDRAWAL,4500.0,M31771138
10743,409000438620',2018-06-20,CR816612663210/RMCPL09003/1,1000.0,0.0,81556.66000000194,2018,6,20,DEBIT,1000.0,M1001763339
10744,409000438620',2018-06-20,CR816618752066/RMCPL19959/1,500.0,0.0,81056.66000000194,2018,6,20,DEBIT,500.0,M170485514
10745,409000438620',2018-06-20,CR816618752073/RMCPL23923/1,500.0,0.0,80556.66000000194,2018,6,20,DEBIT,500.0,M1512380475
10746,409000438620',2018-06-20,CR816618752082/RMCPL17294/1,1000.0,0.0,79556.66000000194,2018,6,20,CHECK_WITHDRAWAL,1000.0,M1716640867
10747,409000438620',2018-06-20,CR816610624970/RMCPL20628/1,10000.0,0.0,69556.66000000194,2018,6,20,DEBIT,10000.0,M1859722525
10748,409000438620',2018-06-20,CR816617740873/RMCPL22821/1,4000.0,0.0,65556.66000000194,2018,6,20,CASH_OUT,4000.0,M778015889
10749,409000438620',2018-06-20,CR816516396045/RMCPL24462/1,500.0,0.0,65056.660000001924,2018,6,20,PAYEMENT,500.0,M1831961195
10750,409000438620',2018-06-20,CR816517413920/RMCPL18514/1,500.0,0.0,64556.660000001924,2018,6,20,PAYEMENT,500.0,M1445191933
10751,409000438620',2018-06-20,CR816510296677/RMCPL12343/1,1000.0,0.0,63556.660000001924,2018,6,20,CASH_OUT,1000.0,M1312864744
10752,409000438620',2018-06-20,CR816510296663/RMCPL14724/1,5000.0,0.0,58556.660000001924,2018,6,20,DEBIT,5000.0,M1405887855
10753,409000438620',2018-06-20,CR816510296661/RMCPL12252/1,1000.0,0.0,57556.660000001924,2018,6,20,PAYEMENT,1000.0,M765165561
10754,409000438620',2018-06-20,CR816510296670/RMCPL18859/1,6000.0,0.0,51556.66000000193,2018,6,20,CASH_OUT,6000.0,M220973619
10755,409000438620',2018-06-20,CR816419174216/RMCPL21735/1,3000.0,0.0,48556.66000000193,2018,6,20,DEBIT,3000.0,C1502143342
10756,409000438620',2018-06-20,CR816415106340/RMCPL09726/1,2000.0,0.0,46556.66000000193,2018,6,20,CASH_OUT,2000.0,M693939037
10757,409000438620',2018-06-20,CR816316816501/RMCPL22941/1,1500.0,0.0,45056.66000000193,2018,6,20,CHECK_WITHDRAWAL,1500.0,C534662976
10758,409000438620',2018-06-20,CR816311713817/RMCPL24066/1,500.0,0.0,44556.66000000193,2018,6,20,PAYEMENT,500.0,M445574409
10759,409000438620',2018-06-20,CR816310704026/RMCPL25821/1,8000.0,0.0,36556.66000000194,2018,6,20,CASH_OUT,8000.0,M5753511
10760,409000438620',2018-06-20,CR816317825182/RMCPL19559/1,500.0,0.0,36056.66000000194,2018,6,20,PAYEMENT,500.0,M1350622354
10761,409000438620',2018-06-20,CR816211426816/RMCPL20957/1,500.0,0.0,35556.66000000194,2018,6,20,PAYEMENT,500.0,M500279159
10762,409000438620',2018-06-20,CR816211418865/RMCPL25027/1,500.0,0.0,35056.66000000194,2018,6,20,CHECK_WITHDRAWAL,500.0,M718122227
10763,409000438620',2018-06-20,CR816211418847/RMCPL11793/1,2000.0,0.0,33056.66000000194,2018,6,20,DEBIT,2000.0,C1340904400
10764,409000438620',2018-06-20,CR816617728842/RMCPL18625/1,500.0,0.0,32556.66000000194,2018,6,20,DEBIT,500.0,M1932212992
10765,409000438620',2018-06-20,CR816617728591/RMCPL05229/1,2500.0,0.0,30056.66000000194,2018,6,20,PAYEMENT,2500.0,M1214735857
10766,409000438620',2018-06-20,CR816617728574/RMCPL22700/1,2000.0,0.0,28056.66000000194,2018,6,20,DEBIT,2000.0,M1508514212
10767,409000438620',2018-06-20,CR816419162571/RMCPL19808/1,2000.0,0.0,26056.66000000194,2018,6,20,DEBIT,2000.0,M734760066
10768,409000438620',2018-06-20,CR816419162534/RMCPL00125/1,3000.0,0.0,23056.66000000194,2018,6,20,PAYEMENT,3000.0,C545707113
10769,409000438620',2018-06-20,CR816614686134/RMCPL21959/1,1000.0,0.0,22056.66000000194,2018,6,20,CHECK_WITHDRAWAL,1000.0,M377031439
10770,409000438620',2018-06-20,CR816614686132/RMCPL22799/1,3000.0,0.0,19056.660000001943,2018,6,20,CASH_OUT,3000.0,C1465478513
10771,409000438620',2018-06-20,CR816614686137/RMCPL22681/1,1000.0,0.0,18056.660000001943,2018,6,20,CASH_OUT,1000.0,C526035976
10772,409000438620',2018-06-20,CR816512335400/RMCPL22326/1,2000.0,0.0,16056.66000000194,2018,6,20,PAYEMENT,2000.0,C141213117
10773,409000438620',2018-06-20,CR816517415566/RMCPL26215/1,1000.0,0.0,15056.66000000194,2018,6,20,DEBIT,1000.0,M774161970
10774,409000438620',2018-06-20,CR816311713785/RMCPL13111/1,10000.0,0.0,5056.660000001939,2018,6,20,CASH_OUT,10000.0,C1036454560
10775,409000438620',2018-06-20,CR816211418829/RMCPL20772/1,500.0,0.0,4556.660000001939,2018,6,20,CASH_OUT,500.0,M570884289
10776,409000438620',2018-06-20,CR816211426787/RMCPL23898/1,3500.0,0.0,1056.660000001939,2018,6,20,CASH_OUT,3500.0,C1182461167
10777,409000438620',2018-06-20,AEPS ACQ REP ADJ FEES 190,0.0,35.4,1092.060000001939,2018,6,20,CHECK_CASHING,35.4,M1506941325
10778,409000438620',2018-06-21,Indiaforensic AEPS NPCI WDL SET,0.0,19624600.0,19625692.06,2018,6,21,TRANSFER,19624600.0,M999610765
10779,409000438620',2018-06-21,CB815612793122/RMCPL12204/0,10000.0,0.0,19615692.06,2018,6,21,PAYEMENT,10000.0,M1685415106
10780,409000438620',2018-06-21,CB815513507914/RMCPL23519/0,10000.0,0.0,19605692.06,2018,6,21,CASH_OUT,10000.0,C1379589736
10781,409000438620',2018-06-21,CB815509444154/RMCPL14700/0,700.0,0.0,19604992.06,2018,6,21,DEBIT,700.0,M1338139545
10782,409000438620',2018-06-21,CB815312968821/RMCPL18085/0,10000.0,0.0,19594992.06,2018,6,21,DEBIT,10000.0,M263448284
10783,409000438620',2018-06-21,CB815116470962/RMCPL25816/3,500.0,0.0,19594492.06,2018,6,21,DEBIT,500.0,C87702732
10784,409000438620',2018-06-21,TRF TO  Indiaforensic SERVICES I,4600000.0,0.0,14994492.060000002,2018,6,21,PAYEMENT,4600000.0,M474970119
10785,409000438620',2018-06-21,TRF TO  Indiaforensic SERVICES I,14900000.0,0.0,94492.06000000238,2018,6,21,PAYEMENT,14900000.0,M1149305123
10786,409000438620',2018-06-21,AEPS INCOME DT 20-06-2018,0.0,48644.74,143136.80000000235,2018,6,21,CHECK_CASHING,48644.74,C863811613
10787,409000438620',2018-06-21,AEPS GST INC DT 20-06-201,0.0,9728.95,152865.75000000242,2018,6,21,CHECK_CASHING,9728.95,C151400576
10788,409000438620',2018-06-22,Indiaforensic AEPS NPCI WDL SET,0.0,18803400.0,18956265.750000004,2018,6,22,TRANSFER,18803400.0,C1440325059
10789,409000438620',2018-06-22,CR817011723188/RMCPL18083/1,4000.0,0.0,18952265.750000004,2018,6,22,CHECK_WITHDRAWAL,4000.0,C1207178960
10790,409000438620',2018-06-22,CR817012751705/RMCPL14573/1,700.0,0.0,18951565.750000004,2018,6,22,CHECK_WITHDRAWAL,700.0,M311634968
10791,409000438620',2018-06-22,CR817011723155/RMCPL14954/1,500.0,0.0,18951065.750000004,2018,6,22,CHECK_WITHDRAWAL,500.0,M2060056788
10792,409000438620',2018-06-22,CR817011739722/RMCPL11875/1,1800.0,0.0,18949265.750000004,2018,6,22,CHECK_WITHDRAWAL,1800.0,M1892664813
10793,409000438620',2018-06-22,CR817010712711/RMCPL13376/1,1800.0,0.0,18947465.750000004,2018,6,22,CHECK_WITHDRAWAL,1800.0,M885114858
10794,409000438620',2018-06-22,CR817010712485/RMCPL20610/1,4000.0,0.0,18943465.750000004,2018,6,22,DEBIT,4000.0,C382934088
10795,409000438620',2018-06-22,CR817017833421/RMCPL24532/1,2000.0,0.0,18941465.750000004,2018,6,22,PAYEMENT,2000.0,C716442925
10796,409000438620',2018-06-22,CR817010713140/RMCPL23693/1,2300.0,0.0,18939165.750000004,2018,6,22,CHECK_WITHDRAWAL,2300.0,M404123675
10797,409000438620',2018-06-22,CR817010713031/RMCPL20307/1,2000.0,0.0,18937165.750000004,2018,6,22,CHECK_WITHDRAWAL,2000.0,C625647461
10798,409000438620',2018-06-22,CR817010713304/RMCPL10451/1,3000.0,0.0,18934165.750000004,2018,6,22,PAYEMENT,3000.0,C1842297286
10799,409000438620',2018-06-22,CR817017833405/RMCPL11811/1,10000.0,0.0,18924165.750000004,2018,6,22,PAYEMENT,10000.0,M2108368453
10800,409000438620',2018-06-22,CR817017833433/RMCPL10108/1,10000.0,0.0,18914165.750000004,2018,6,22,DEBIT,10000.0,C1803078638
10801,409000438620',2018-06-22,CR817010712436/RMCPL00045/1,4000.0,0.0,18910165.750000004,2018,6,22,PAYEMENT,4000.0,C1487669283
10802,409000438620',2018-06-22,CR817011723172/RMCPL18078/1,8000.0,0.0,18902165.750000004,2018,6,22,CASH_OUT,8000.0,M1729666324
10803,409000438620',2018-06-22,CR817010712973/RMCPL24657/1,9000.0,0.0,18893165.750000004,2018,6,22,DEBIT,9000.0,M1212855004
10804,409000438620',2018-06-22,CR817010713168/RMCPL24426/1,10000.0,0.0,18883165.750000004,2018,6,22,DEBIT,10000.0,M4594799
10805,409000438620',2018-06-22,CR817010713047/RMCPL13376/1,2200.0,0.0,18880965.750000004,2018,6,22,CHECK_WITHDRAWAL,2200.0,M1713942956
10806,409000438620',2018-06-22,CR817010713160/RMCPL26552/1,1500.0,0.0,18879465.750000004,2018,6,22,CASH_OUT,1500.0,M1527523536
10807,409000438620',2018-06-22,CR817010713332/RMCPL25168/1,1000.0,0.0,18878465.750000004,2018,6,22,PAYEMENT,1000.0,M1246984673
10808,409000438620',2018-06-22,CR817010713158/RMCPL23448/1,4000.0,0.0,18874465.750000004,2018,6,22,CASH_OUT,4000.0,M1421547398
10809,409000438620',2018-06-22,CR817010713083/RMCPL26215/1,1000.0,0.0,18873465.750000004,2018,6,22,CASH_OUT,1000.0,M1147634354
10810,409000438620',2018-06-22,CR816917548522/RMCPL11764/1,7000.0,0.0,18866465.750000004,2018,6,22,PAYEMENT,7000.0,M2035805891
10811,409000438620',2018-06-22,CR816913477500/RMCPL26743/1,5000.0,0.0,18861465.750000004,2018,6,22,CASH_OUT,5000.0,M1197282785
10812,409000438620',2018-06-22,CR816910423754/RMCPL24426/1,2000.0,0.0,18859465.750000004,2018,6,22,PAYEMENT,2000.0,M309527276
10813,409000438620',2018-06-22,CR816910423739/RMCPL09829/1,5500.0,0.0,18853965.750000004,2018,6,22,PAYEMENT,5500.0,M971543945
10814,409000438620',2018-06-22,CR816917541174/RMCPL18749/1,2100.0,0.0,18851865.750000004,2018,6,22,DEBIT,2100.0,M1100670088
10815,409000438620',2018-06-22,CR816913477488/RMCPL23207/1,1000.0,0.0,18850865.750000004,2018,6,22,DEBIT,1000.0,M32406182
10816,409000438620',2018-06-22,CR816914499690/RMCPL19952/1,1500.0,0.0,18849365.750000004,2018,6,22,CHECK_WITHDRAWAL,1500.0,M2063956417
10817,409000438620',2018-06-22,CR816914499682/RMCPL22227/1,500.0,0.0,18848865.750000004,2018,6,22,CASH_OUT,500.0,M1253804055
10818,409000438620',2018-06-22,CR816917548542/RMCPL10689/1,700.0,0.0,18848165.750000004,2018,6,22,CHECK_WITHDRAWAL,700.0,M486097674
10819,409000438620',2018-06-22,CR816911442407/RMCPL24117/1,1000.0,0.0,18847165.750000004,2018,6,22,CASH_OUT,1000.0,C464345779
10820,409000438620',2018-06-22,CR816912467535/RMCPL23222/1,2500.0,0.0,18844665.750000004,2018,6,22,DEBIT,2500.0,M2122774970
10821,409000438620',2018-06-22,CR816914499653/RMCPL16484/1,2500.0,0.0,18842165.750000004,2018,6,22,DEBIT,2500.0,M55897184
10822,409000438620',2018-06-22,TRF TO  Indiaforensic SERVICES I,3800000.0,0.0,15042165.750000006,2018,6,22,DEBIT,3800000.0,M432819069
10823,409000438620',2018-06-22,TRF TO  Indiaforensic SERVICES I,15000000.0,0.0,42165.750000003725,2018,6,22,PAYEMENT,15000000.0,M493689368
10824,409000438620',2018-06-22,AEPS INCOME DT 21-06-2018,0.0,46923.8,89089.55000000373,2018,6,22,CHECK_CASHING,46923.8,M1198612500
10825,409000438620',2018-06-22,AEPS GST INC DT 21-06-201,0.0,9384.76,98474.31000000374,2018,6,22,TRANSFER,9384.76,M2101169027
10826,409000438620',2018-06-22,AEPS ACQ CR ADJ FEES 2106,410.64,0.0,98063.67000000372,2018,6,22,DEBIT,410.64,C1894575391
10827,409000438620',2018-06-22,CR816310704019/RMCPL17430/1,10000.0,0.0,88063.67000000372,2018,6,22,CHECK_WITHDRAWAL,10000.0,M1181690543
10828,409000438620',2018-06-22,CR816211418783/RMCPL20307/1,3500.0,0.0,84563.67000000372,2018,6,22,PAYEMENT,3500.0,M486264223
10829,409000438620',2018-06-25,Indiaforensic AEPS NPCI WDL SET,0.0,19558700.0,19643263.67000001,2018,6,25,CASH_IN,19558700.0,M1327831858
10830,409000438620',2018-06-25,Indiaforensic AEPS NPCI WDL SET,0.0,16619500.0,36262763.67,2018,6,25,TRANSFER,16619500.0,M343221898
10831,409000438620',2018-06-25,Indiaforensic AEPS NPCI WDL SET,0.0,11601800.0,47864563.67,2018,6,25,TRANSFER,11601800.0,M5485738
10832,409000438620',2018-06-25,TRF TO  Indiaforensic SERVICES I,2800000.0,0.0,45064563.67,2018,6,25,PAYEMENT,2800000.0,M1865052252
10833,409000438620',2018-06-25,RTGS CHARGES AND GST/YESB,29.5,0.0,45064534.17,2018,6,25,PAYEMENT,29.5,C2033711470
10834,409000438620',2018-06-25,RTGS/YESBH18176501898/Indfor,15000000.0,0.0,30064534.17,2018,6,25,PAYEMENT,15000000.0,M864973000
10835,409000438620',2018-06-25,RTGS CHARGES AND GST/YESB,29.5,0.0,30064504.67,2018,6,25,CASH_OUT,29.5,M656439407
10836,409000438620',2018-06-25,RTGS/YESBH18176502779/Indfor,15000000.0,0.0,15064504.670000002,2018,6,25,PAYEMENT,15000000.0,C899625985
10837,409000438620',2018-06-25,RTGS CHARGES AND GST/YESB,29.5,0.0,15064475.170000002,2018,6,25,PAYEMENT,29.5,M1460961354
10838,409000438620',2018-06-25,RTGS/YESBH18176503243/Indfor,15000000.0,0.0,64475.17000000179,2018,6,25,CASH_OUT,15000000.0,M2085456234
10839,409000438620',2018-06-25,AEPS INCOME DT 22-06-2018,0.0,49171.96,113647.13000000178,2018,6,25,CHECK_CASHING,49171.96,M32701520
10840,409000438620',2018-06-25,AEPS GST INC DT 22-06-201,0.0,9834.39,123481.52000000178,2018,6,25,TRANSFER,9834.39,M2039575147
10841,409000438620',2018-06-25,AEPS INCOME DT 23-06-2018,0.0,40706.18,164187.7000000018,2018,6,25,CASH_IN,40706.18,M611270724
10842,409000438620',2018-06-25,AEPS GST INC DT 23-06-201,0.0,8141.24,172328.94000000178,2018,6,25,CHECK_CASHING,8141.24,M46891655
10843,409000438620',2018-06-25,AEPS INCOME DT 24-06-2018,0.0,29917.31,202246.25000000172,2018,6,25,TRANSFER,29917.31,M658193148
10844,409000438620',2018-06-25,AEPS GST INC DT 24-06-201,0.0,5983.46,208229.71000000177,2018,6,25,CASH_IN,5983.46,M1418394522
10845,409000438620',2018-06-25,AEPS ACQUIRING ADJ FEES 2,29.5,0.0,208200.21000000177,2018,6,25,DEBIT,29.5,M317683003
10846,409000438620',2018-06-25,AEPS ACQ CR ADJ FEES 2206,109.15,0.0,208091.06000000171,2018,6,25,CHECK_WITHDRAWAL,109.15,M1201199367
10847,409000438620',2018-06-25,CR817109957523/RMCPL18869/2,9000.0,0.0,199091.06000000171,2018,6,25,PAYEMENT,9000.0,M674821516
10848,409000438620',2018-06-25,CR817118112380/RMCPL02175/2,4000.0,0.0,195091.06000000171,2018,6,25,DEBIT,4000.0,M7092513
10849,409000438620',2018-06-25,CR817110980869/RMCPL15464/2,3000.0,0.0,192091.06000000171,2018,6,25,CASH_OUT,3000.0,M373839741
10850,409000438620',2018-06-25,CR817110972964/RMCPL18408/2,1000.0,0.0,191091.06000000171,2018,6,25,CHECK_WITHDRAWAL,1000.0,M446409895
10851,409000438620',2018-06-25,CR817110972958/RMCPL22022/2,1500.0,0.0,189591.06000000171,2018,6,25,PAYEMENT,1500.0,M765873293
10852,409000438620',2018-06-25,CR817110975522/RMCPL18236/2,500.0,0.0,189091.06000000171,2018,6,25,PAYEMENT,500.0,M1761345657
10853,409000438620',2018-06-25,CR817110980728/RMCPL11253/2,500.0,0.0,188591.06000000171,2018,6,25,PAYEMENT,500.0,M103474665
10854,409000438620',2018-06-25,CR817110980764/RMCPL16314/2,3000.0,0.0,185591.06000000171,2018,6,25,CHECK_WITHDRAWAL,3000.0,C1525409936
10855,409000438620',2018-06-25,CR817112005622/RMCPL21975/2,3000.0,0.0,182591.06000000171,2018,6,25,PAYEMENT,3000.0,C1761865559
10856,409000438620',2018-06-25,AEPS ACQUIRING ADJ FEES 2,17.7,0.0,182573.36000000176,2018,6,25,PAYEMENT,17.7,M2053123554
10857,409000438620',2018-06-26,Indiaforensic AEPS NPCI WDL SET,0.0,18813700.0,18996273.360000007,2018,6,26,TRANSFER,18813700.0,M1268374728
10858,409000438620',2018-06-26,CR817212263979/RMCPL23655/2,2300.0,0.0,18993973.360000007,2018,6,26,DEBIT,2300.0,M1062227232
10859,409000438620',2018-06-26,CR817212267312/RMCPL26238/2,1600.0,0.0,18992373.360000007,2018,6,26,CASH_OUT,1600.0,M1667931416
10860,409000438620',2018-06-26,CR817212267323/RMCPL22522/2,500.0,0.0,18991873.360000007,2018,6,26,CHECK_WITHDRAWAL,500.0,M966153678
10861,409000438620',2018-06-26,CR817211249534/RMCPL11613/2,10000.0,0.0,18981873.360000007,2018,6,26,DEBIT,10000.0,M1807913019
10862,409000438620',2018-06-26,CR817211258807/RMCPL17863/2,2300.0,0.0,18979573.360000007,2018,6,26,CHECK_WITHDRAWAL,2300.0,M1979657593
10863,409000438620',2018-06-26,CR817213294235/RMCPL18850/2,1000.0,0.0,18978573.360000007,2018,6,26,CHECK_WITHDRAWAL,1000.0,M1819651816
10864,409000438620',2018-06-26,CR817213294233/RMCPL14558/2,5000.0,0.0,18973573.360000007,2018,6,26,CASH_OUT,5000.0,M2135199037
10865,409000438620',2018-06-26,CR817216336056/RMCPL17244/2,1500.0,0.0,18972073.360000007,2018,6,26,CHECK_WITHDRAWAL,1500.0,M1622092603
10866,409000438620',2018-06-26,CR817217339541/RMCPL23655/2,1000.0,0.0,18971073.360000007,2018,6,26,DEBIT,1000.0,M788994304
10867,409000438620',2018-06-26,RTGS CHARGES AND GST/YESB,29.5,0.0,18971043.860000007,2018,6,26,DEBIT,29.5,M1901798269
10868,409000438620',2018-06-26,RTGS/YESBH18177599358/Indfor,3900000.0,0.0,15071043.860000005,2018,6,26,PAYEMENT,3900000.0,M418548371
10869,409000438620',2018-06-26,RTGS CHARGES AND GST/YESB,29.5,0.0,15071014.360000005,2018,6,26,DEBIT,29.5,M2033893905
10870,409000438620',2018-06-26,RTGS/YESBH18177600906/Indfor,15000000.0,0.0,71014.36000000313,2018,6,26,PAYEMENT,15000000.0,M680302953
10871,409000438620',2018-06-26,MAW/502964XXXXXX6863/Akol,0.0,7000.0,78014.36000000313,2018,6,26,CASH_IN,7000.0,M1141114101
10872,409000438620',2018-06-26,MAW/502964XXXXXX6863/Akol,0.0,200.0,78214.36000000313,2018,6,26,CASH_IN,200.0,M502740055
10873,409000438620',2018-06-26,AEPS INCOME DT 25-06-2018,0.0,46179.69,124394.05000000313,2018,6,26,TRANSFER,46179.69,M429908444
10874,409000438620',2018-06-26,AEPS GST INC DT 25-06-201,0.0,9235.94,133629.99000000313,2018,6,26,CASH_IN,9235.94,M165690478
10875,409000438620',2018-06-26,AEPS ACQUIRING ADJ FEES 2,26.55,0.0,133603.44000000315,2018,6,26,CASH_OUT,26.55,M1366850497
10876,409000438620',2018-06-26,AEPS ACQ CR ADJ FEES 2506,95.58,0.0,133507.86000000316,2018,6,26,CASH_OUT,95.58,M2076240234
10877,409000438620',2018-06-27,Indiaforensic AEPS NPCI WDL SET,0.0,19526600.0,19660107.860000007,2018,6,27,CASH_IN,19526600.0,M568119477
10878,409000438620',2018-06-27,TRF TO  Indiaforensic SERVICES I,9600000.0,0.0,10060107.860000003,2018,6,27,PAYEMENT,9600000.0,C1262016786
10879,409000438620',2018-06-27,RTGS CHARGES AND GST/YESB,29.5,0.0,10060078.360000003,2018,6,27,PAYEMENT,29.5,M1012603
10880,409000438620',2018-06-27,RTGS/YESBH18178695745/Indfor,10000000.0,0.0,60078.36000000312,2018,6,27,DEBIT,10000000.0,C1474120649
10881,409000438620',2018-06-27,AEPS INCOME DT 26-06-2018,0.0,47661.58,107739.94000000313,2018,6,27,TRANSFER,47661.58,M45770448
10882,409000438620',2018-06-27,AEPS GST INC DT 26-06-201,0.0,9532.32,117272.26000000312,2018,6,27,CASH_IN,9532.32,M882685984
10883,409000438620',2018-06-28,Indiaforensic AEPS NPCI WDL SET,0.0,16865100.0,16982372.26,2018,6,28,TRANSFER,16865100.0,M1614251472
10884,409000438620',2018-06-28,CR817411782281/RMCPL18354/2,3000.0,0.0,16979372.26,2018,6,28,PAYEMENT,3000.0,M1652003991
10885,409000438620',2018-06-28,CR817411782282/RMCPL14643/2,5000.0,0.0,16974372.26,2018,6,28,DEBIT,5000.0,M1483739632
10886,409000438620',2018-06-28,CR817411776616/RMCPL18014/2,500.0,0.0,16973872.26,2018,6,28,DEBIT,500.0,M1859503177
10887,409000438620',2018-06-28,CR817317605451/RMCPL25198/2,1000.0,0.0,16972872.26,2018,6,28,CASH_OUT,1000.0,M445018640
10888,409000438620',2018-06-28,CR817316595526/RMCPL11966/2,2700.0,0.0,16970172.26,2018,6,28,PAYEMENT,2700.0,M729273825
10889,409000438620',2018-06-28,CR817316595522/RMCPL16817/2,500.0,0.0,16969672.26,2018,6,28,PAYEMENT,500.0,M1208124611
10890,409000438620',2018-06-28,CR817316595502/RMCPL19297/2,1400.0,0.0,16968272.26,2018,6,28,DEBIT,1400.0,M863737126
10891,409000438620',2018-06-28,CR817312540196/RMCPL26071/2,2000.0,0.0,16966272.26,2018,6,28,DEBIT,2000.0,M1708408313
10892,409000438620',2018-06-28,CR817312531513/RMCPL24213/2,500.0,0.0,16965772.26,2018,6,28,CHECK_WITHDRAWAL,500.0,M409713682
10893,409000438620',2018-06-28,CR817312531539/RMCPL24844/2,4000.0,0.0,16961772.26,2018,6,28,CASH_OUT,4000.0,M32594875
10894,409000438620',2018-06-28,CR817609225859/RMCPL25781/2,1000.0,0.0,16960772.26,2018,6,28,PAYEMENT,1000.0,M92472516
10895,409000438620',2018-06-28,CR817616339194/RMCPL25346/2,3500.0,0.0,16957272.26,2018,6,28,PAYEMENT,3500.0,M1072948973
10896,409000438620',2018-06-28,CR817612278991/RMCPL14558/2,1200.0,0.0,16956072.26,2018,6,28,CASH_OUT,1200.0,M259277674
10897,409000438620',2018-06-28,CR817610250420/RMCPL24033/2,1000.0,0.0,16955072.26,2018,6,28,PAYEMENT,1000.0,M967311910
10898,409000438620',2018-06-28,CR817612288042/RMCPL17579/2,500.0,0.0,16954572.26,2018,6,28,CHECK_WITHDRAWAL,500.0,M1624564291
10899,409000438620',2018-06-28,CR817612288045/RMCPL23710/2,2000.0,0.0,16952572.26,2018,6,28,CHECK_WITHDRAWAL,2000.0,M1652054781
10900,409000438620',2018-06-28,CR817611260350/RMCPL25813/2,1500.0,0.0,16951072.26,2018,6,28,DEBIT,1500.0,M1546257585
10901,409000438620',2018-06-28,CR817611270099/RMCPL15381/2,9000.0,0.0,16942072.26,2018,6,28,PAYEMENT,9000.0,M567544956
10902,409000438620',2018-06-28,CR817612278980/RMCPL11618/2,500.0,0.0,16941572.26,2018,6,28,PAYEMENT,500.0,M1868932153
10903,409000438620',2018-06-28,CR817614309773/RMCPL13065/2,500.0,0.0,16941072.26,2018,6,28,CHECK_WITHDRAWAL,500.0,M936994385
10904,409000438620',2018-06-28,RTGS CHARGES AND GST/YESB,29.5,0.0,16941042.76,2018,6,28,CASH_OUT,29.5,C1746150957
10905,409000438620',2018-06-28,RTGS/YESBH18179801413/Indfor,1900000.0,0.0,15041042.760000002,2018,6,28,PAYEMENT,1900000.0,M1749613291
10906,409000438620',2018-06-28,RTGS CHARGES AND GST/YESB,29.5,0.0,15041013.260000002,2018,6,28,DEBIT,29.5,C1298177219
10907,409000438620',2018-06-28,RTGS/YESBH18179801622/Indfor,15000000.0,0.0,41013.26000000164,2018,6,28,PAYEMENT,15000000.0,C1874138331
10908,409000438620',2018-06-28,AEPS INCOME DT 27-06-2018,0.0,41473.49,82486.75000000162,2018,6,28,CHECK_CASHING,41473.49,M1220400304
10909,409000438620',2018-06-28,AEPS GST INC DT 27-06-201,0.0,8294.7,90781.45000000164,2018,6,28,TRANSFER,8294.7,M662698775
10910,409000438620',2018-06-28,AEPS ACQUIRING ADJ FEES 2,53.1,0.0,90728.35000000162,2018,6,28,PAYEMENT,53.1,M158086875
10911,409000438620',2018-06-28,AEPS ACQ CR ADJ FEES 2706,187.62,0.0,90540.73000000164,2018,6,28,CASH_OUT,187.62,M707005187
10912,409000438620',2018-06-28,AEPS ACQ REP ADJ FEES 270,0.0,73.75,90614.48000000164,2018,6,28,CHECK_CASHING,73.75,M2122732470
10913,409000438620',2018-06-29,Indiaforensic AEPS NPCI WDL SET,0.0,16653600.0,16744214.480000002,2018,6,29,CASH_IN,16653600.0,M1502509956
10914,409000438620',2018-06-29,TRF TO  Indiaforensic SERVICES I,15000000.0,0.0,1744214.4800000025,2018,6,29,DEBIT,15000000.0,M552748668
10915,409000438620',2018-06-29,TRF TO  Indiaforensic SERVICES I,1600000.0,0.0,144214.4800000023,2018,6,29,PAYEMENT,1600000.0,M420877437
10916,409000438620',2018-06-29,AEPS INCOME DT 28-06-2018,0.0,40141.18,184355.6600000023,2018,6,29,CHECK_CASHING,40141.18,C1384149246
10917,409000438620',2018-06-29,AEPS GST INC DT 28-06-201,0.0,8028.24,192383.9000000023,2018,6,29,TRANSFER,8028.24,M703579649
10918,409000438620',2018-06-29,AEPS ACQ REP ADJ FEES 280,0.0,53.1,192437.0000000023,2018,6,29,CASH_IN,53.1,M597616822
10919,409000438620',2018-06-30,Indiaforensic AEPS NPCI WDL SET,0.0,19723400.0,19915837.000000004,2018,6,30,CASH_IN,19723400.0,M2118605749
10920,409000438620',2018-06-30,CB809618333637/RMCPL15079/0,0.0,10000.0,19925837.000000004,2018,6,30,CHECK_CASHING,10000.0,C1165313953
10921,409000438620',2018-06-30,TRF TO  Indiaforensic SERVICES I,15000000.0,0.0,4925837.000000004,2018,6,30,CASH_OUT,15000000.0,M1704262601
10922,409000438620',2018-06-30,TRF TO  Indiaforensic SERVICES I,4000000.0,0.0,925837.0000000036,2018,6,30,DEBIT,4000000.0,M800875062
10923,409000438620',2018-06-30,TRF TO  Indiaforensic SERVICES I,500000.0,0.0,425837.00000000367,2018,6,30,CASH_OUT,500000.0,M1259897373
10924,409000438620',2018-06-30,AEPS INCOME DT 29-06-2018,0.0,49101.5,474938.50000000367,2018,6,30,CHECK_CASHING,49101.5,M1916222987
10925,409000438620',2018-06-30,AEPS GST INC DT 29-06-201,0.0,9820.3,484758.80000000366,2018,6,30,CASH_IN,9820.3,C772070337
10926,409000438620',2018-06-30,AEPS ACQUIRING ADJ FEES 2,23.6,0.0,484735.2000000037,2018,6,30,DEBIT,23.6,M2073250454
10927,409000438620',2018-07-02,Indiaforensic AEPS NPCI WDL SET,0.0,17213700.0,17698435.200000007,2018,7,2,TRANSFER,17213700.0,M904100768
10928,409000438620',2018-07-02,Indiaforensic AEPS NPCI WDL SET,0.0,10978600.0,28677035.20000001,2018,7,2,CASH_IN,10978600.0,C1479813516
10929,409000438620',2018-07-02,TRF TO  Indiaforensic SERVICES I,15000000.0,0.0,13677035.200000005,2018,7,2,CHECK_WITHDRAWAL,15000000.0,C425298744
10930,409000438620',2018-07-02,TRF TO  Indiaforensic SERVICES I,10000000.0,0.0,3677035.200000003,2018,7,2,CHECK_WITHDRAWAL,10000000.0,M67453847
10931,409000438620',2018-07-02,TRF TO  Indiaforensic SERVICES I,3000000.0,0.0,677035.200000003,2018,7,2,CASH_OUT,3000000.0,M1411158100
10932,409000438620',2018-07-02,AEPS INCOME DT 30-06-2018,0.0,42968.17,720003.370000003,2018,7,2,TRANSFER,42968.17,C124540047
10933,409000438620',2018-07-02,AEPS GST INC DT 30-06-201,0.0,8593.63,728597.000000003,2018,7,2,TRANSFER,8593.63,C266418454
10934,409000438620',2018-07-02,AEPS INCOME DT 01-07-2018,0.0,28448.23,757045.230000003,2018,7,2,CHECK_CASHING,28448.23,C194746285
10935,409000438620',2018-07-02,AEPS GST INC DT 01-07-201,0.0,5689.65,762734.8800000029,2018,7,2,CHECK_CASHING,5689.65,C571113365
10936,409000438620',2018-07-02,TRF TO  Indiaforensic SERVICES I,500000.0,0.0,262734.88000000303,2018,7,2,PAYEMENT,500000.0,C1016689071
10937,409000438620',2018-07-03,Indiaforensic AEPS NPCI WDL SET,0.0,14566600.0,14829334.880000005,2018,7,3,CASH_IN,14566600.0,C225852166
10938,409000438620',2018-07-03,TRF TO  Indiaforensic SERVICES I,14800000.0,0.0,29334.880000002682,2018,7,3,PAYEMENT,14800000.0,C251557282
10939,409000438620',2018-07-03,AEPS ACQUIRING ADJ FEES 0,2.95,0.0,29331.93000000268,2018,7,3,CHECK_WITHDRAWAL,2.95,C1554565380
10940,409000438620',2018-07-03,AEPS ACQ REP ADJ FEES 020,0.0,5.9,29337.83000000269,2018,7,3,CASH_IN,5.9,C630085121
10941,409000438620',2018-07-03,AEPS INCOME DT 02-07-2018,0.0,36266.16,65603.99000000268,2018,7,3,CHECK_CASHING,36266.16,C474166728
10942,409000438620',2018-07-03,AEPS GST INC DT 02-07-201,0.0,7253.23,72857.22000000268,2018,7,3,CHECK_CASHING,7253.23,C155439298
10943,409000438620',2018-07-03,MAW/502964XXXXXX9901/Band,0.0,500.0,73357.22000000268,2018,7,3,CASH_IN,500.0,C507538622
10944,409000438620',2018-07-03,MAW/502964XXXXXX9901/Band,0.0,1800.0,75157.22000000268,2018,7,3,CHECK_CASHING,1800.0,C705265015
10945,409000438620',2018-07-04,Indiaforensic AEPS NPCI WDL SET,0.0,21993000.0,22068157.220000006,2018,7,4,TRANSFER,21993000.0,C1272615921
10946,409000438620',2018-07-04,TRF TO  Indiaforensic SERVICES I,15000000.0,0.0,7068157.2200000025,2018,7,4,CASH_OUT,15000000.0,C182755121
10947,409000438620',2018-07-04,TRF TO  Indiaforensic SERVICES I,7000000.0,0.0,68157.22000000253,2018,7,4,CHECK_WITHDRAWAL,7000000.0,C952610115
10948,409000438620',2018-07-04,AEPS ACQUIRING ADJ FEES 0,35.4,0.0,68121.82000000254,2018,7,4,PAYEMENT,35.4,C1916720513
10949,409000438620',2018-07-04,AEPS INCOME DT 03-07-2018,0.0,55769.54,123891.36000000256,2018,7,4,TRANSFER,55769.54,C448070390
10950,409000438620',2018-07-04,AEPS GST INC DT 03-07-201,0.0,11153.91,135045.27000000255,2018,7,4,CASH_IN,11153.91,C582320549
10951,409000438620',2018-07-05,Indiaforensic AEPS NPCI WDL SET,0.0,19312500.0,19447545.270000003,2018,7,5,CASH_IN,19312500.0,C1153015561
10952,409000438620',2018-07-05,CR817911060625/RMCPL20259/2,1000.0,0.0,19446545.270000003,2018,7,5,CHECK_WITHDRAWAL,1000.0,C1917485266
10953,409000438620',2018-07-05,CR817913095139/RMCPL17150/2,4000.0,0.0,19442545.270000003,2018,7,5,CHECK_WITHDRAWAL,4000.0,C1634190383
10954,409000438620',2018-07-05,CR817913090718/RMCPL20680/2,3200.0,0.0,19439345.270000003,2018,7,5,PAYEMENT,3200.0,C1334973394
10955,409000438620',2018-07-05,CR817910049378/RMCPL09617/2,1700.0,0.0,19437645.270000003,2018,7,5,PAYEMENT,1700.0,C716442925
10956,409000438620',2018-07-05,CR817913087788/RMCPL14724/2,500.0,0.0,19437145.270000003,2018,7,5,DEBIT,500.0,C1286084959
10957,409000438620',2018-07-05,CR817913087774/RMCPL20185/2,5000.0,0.0,19432145.270000003,2018,7,5,PAYEMENT,5000.0,C2072030256
10958,409000438620',2018-07-05,CR818313032506/RMCPL14700/0,5000.0,0.0,19427145.270000003,2018,7,5,DEBIT,5000.0,C2040603986
10959,409000438620',2018-07-05,CR818312015733/RMCPL17511/0,1000.0,0.0,19426145.270000003,2018,7,5,PAYEMENT,1000.0,C170899621
10960,409000438620',2018-07-05,CR818312015805/RMCPL19070/0,10000.0,0.0,19416145.270000003,2018,7,5,CASH_OUT,10000.0,C571113365
10961,409000438620',2018-07-05,CR818313026150/RMCPL25168/0,500.0,0.0,19415645.270000003,2018,7,5,CASH_OUT,500.0,C306206744
10962,409000438620',2018-07-05,CR818316076786/RMCPL09386/0,3000.0,0.0,19412645.270000003,2018,7,5,PAYEMENT,3000.0,C12793273
10963,409000438620',2018-07-05,CR818312011337/RMCPL20275/0,6000.0,0.0,19406645.270000003,2018,7,5,CASH_OUT,6000.0,C935612756
10964,409000438620',2018-07-05,CR818312011290/RMCPL18460/0,1200.0,0.0,19405445.270000003,2018,7,5,CASH_OUT,1200.0,C459857341
10965,409000438620',2018-07-05,CR818317083670/RMCPL21965/0,1000.0,0.0,19404445.270000003,2018,7,5,CASH_OUT,1000.0,C686592713
10966,409000438620',2018-07-05,CR818317084842/RMCPL14558/0,1600.0,0.0,19402845.270000003,2018,7,5,CASH_OUT,1600.0,C1636786811
10967,409000438620',2018-07-05,CR818312005818/RMCPL22522/0,2000.0,0.0,19400845.270000003,2018,7,5,CASH_OUT,2000.0,C1606102556
10968,409000438620',2018-07-05,CR818312011354/RMCPL20933/0,500.0,0.0,19400345.270000003,2018,7,5,CHECK_WITHDRAWAL,500.0,C1054542265
10969,409000438620',2018-07-05,CR818312014256/RMCPL09617/0,3000.0,0.0,19397345.270000003,2018,7,5,CHECK_WITHDRAWAL,3000.0,C78614515
10970,409000438620',2018-07-05,CR818315054200/RMCPL21339/0,2000.0,0.0,19395345.270000003,2018,7,5,CHECK_WITHDRAWAL,2000.0,C495071437
10971,409000438620',2018-07-05,CR818312015709/RMCPL16347/0,1000.0,0.0,19394345.270000003,2018,7,5,CHECK_WITHDRAWAL,1000.0,C141213117
10972,409000438620',2018-07-05,CR818013345168/RMCPL09533/2,4000.0,0.0,19390345.270000003,2018,7,5,DEBIT,4000.0,C861720625
10973,409000438620',2018-07-05,CR818012318019/RMCPL14562/2,10000.0,0.0,19380345.270000003,2018,7,5,CASH_OUT,10000.0,C391734039
10974,409000438620',2018-07-05,CR818012318045/RMCPL19605/2,500.0,0.0,19379845.270000003,2018,7,5,CASH_OUT,500.0,C811597470
10975,409000438620',2018-07-05,CR818012315110/RMCPL21362/2,2000.0,0.0,19377845.270000003,2018,7,5,CHECK_WITHDRAWAL,2000.0,C1191924243
10976,409000438620',2018-07-05,CR818015388097/RMCPL21965/2,2000.0,0.0,19375845.270000003,2018,7,5,DEBIT,2000.0,C470217116
10977,409000438620',2018-07-05,CR818311999091/RMCPL24618/0,2500.0,0.0,19373345.270000003,2018,7,5,CASH_OUT,2500.0,M851703827
10978,409000438620',2018-07-05,CR817917134148/RMCPL21524/2,1500.0,0.0,19371845.270000003,2018,7,5,CASH_OUT,1500.0,M1717027225
10979,409000438620',2018-07-05,CR817915118355/RMCPL21455/2,2000.0,0.0,19369845.270000003,2018,7,5,CHECK_WITHDRAWAL,2000.0,M433502988
10980,409000438620',2018-07-05,CR817915118351/RMCPL22628/2,500.0,0.0,19369345.270000003,2018,7,5,CASH_OUT,500.0,M1457006650
10981,409000438620',2018-07-05,CR817917134154/RMCPL21904/2,2000.0,0.0,19367345.270000003,2018,7,5,CHECK_WITHDRAWAL,2000.0,C23426726
10982,409000438620',2018-07-05,CR817917134145/RMCPL24604/2,500.0,0.0,19366845.270000003,2018,7,5,CHECK_WITHDRAWAL,500.0,M1565675662
10983,409000438620',2018-07-05,CR818011300595/RMCPL18952/2,8500.0,0.0,19358345.270000003,2018,7,5,DEBIT,8500.0,M1172865913
10984,409000438620',2018-07-05,CR818015385415/RMCPL11811/2,10000.0,0.0,19348345.270000003,2018,7,5,CASH_OUT,10000.0,M1071096509
10985,409000438620',2018-07-05,CR818012327671/RMCPL21354/2,3000.0,0.0,19345345.270000003,2018,7,5,PAYEMENT,3000.0,M352652823
10986,409000438620',2018-07-05,CR818016404298/RMCPL16251/2,2500.0,0.0,19342845.270000003,2018,7,5,DEBIT,2500.0,M366580387
10987,409000438620',2018-07-05,CR818012327692/RMCPL26747/2,1400.0,0.0,19341445.270000003,2018,7,5,CHECK_WITHDRAWAL,1400.0,M23755370
10988,409000438620',2018-07-05,CR818009258507/RMCPL12219/2,500.0,0.0,19340945.270000003,2018,7,5,CASH_OUT,500.0,M125590436
10989,409000438620',2018-07-05,CR818111578716/RMCPL20276/3,10000.0,0.0,19330945.270000003,2018,7,5,CASH_OUT,10000.0,C667346055
10990,409000438620',2018-07-05,CR818111568607/RMCPL23894/3,3500.0,0.0,19327445.270000003,2018,7,5,PAYEMENT,3500.0,M1856440729
10991,409000438620',2018-07-05,CR818110558087/RMCPL19297/3,5000.0,0.0,19322445.270000003,2018,7,5,CHECK_WITHDRAWAL,5000.0,M252247393
10992,409000438620',2018-07-05,CR818118674563/RMCPL20275/3,5000.0,0.0,19317445.270000003,2018,7,5,PAYEMENT,5000.0,C1628737580
10993,409000438620',2018-07-05,CR817917134139/RMCPL16173/2,500.0,0.0,19316945.270000003,2018,7,5,CHECK_WITHDRAWAL,500.0,M1175289418
10994,409000438620',2018-07-05,CR817917141269/RMCPL16256/2,2000.0,0.0,19314945.270000003,2018,7,5,CHECK_WITHDRAWAL,2000.0,M465118237
10995,409000438620',2018-07-05,CR818011281869/RMCPL22028/2,5000.0,0.0,19309945.270000003,2018,7,5,CASH_OUT,5000.0,M471962962
10996,409000438620',2018-07-05,CR818010267029/RMCPL16251/2,1000.0,0.0,19308945.270000003,2018,7,5,CASH_OUT,1000.0,M1936849335
10997,409000438620',2018-07-05,CR818011301402/RMCPL24338/2,500.0,0.0,19308445.270000003,2018,7,5,CHECK_WITHDRAWAL,500.0,M1218610051
10998,409000438620',2018-07-05,CR818018423001/RMCPL19798/2,500.0,0.0,19307945.270000003,2018,7,5,DEBIT,500.0,M1089386629
10999,409000438620',2018-07-05,CR818112597341/RMCPL22022/3,2000.0,0.0,19305945.270000003,2018,7,5,CHECK_WITHDRAWAL,2000.0,M202612435
11000,409000438620',2018-07-05,TRF TO  Indiaforensic SERVICES I,15000000.0,0.0,4305945.270000003,2018,7,5,PAYEMENT,15000000.0,M2004608652
11001,409000438620',2018-07-05,TRF TO  Indiaforensic SERVICES I,4300000.0,0.0,5945.270000003277,2018,7,5,CHECK_WITHDRAWAL,4300000.0,M976025777
11002,409000438620',2018-07-05,AEPS ACQ CR ADJ FEES 0407,515.66,0.0,5429.610000003278,2018,7,5,CHECK_WITHDRAWAL,515.66,M1919484678
11003,409000438620',2018-07-05,AEPS ACQ REP ADJ FEES 040,0.0,2.95,5432.560000003278,2018,7,5,TRANSFER,2.95,M1301792983
11004,409000438620',2018-07-05,AEPS INCOME DT 04-07-2018,0.0,49800.23,55232.79000000328,2018,7,5,CASH_IN,49800.23,M1542726275
11005,409000438620',2018-07-05,AEPS GST INC DT 04-07-201,0.0,9960.05,65192.84000000329,2018,7,5,CHECK_CASHING,9960.05,M577239715
11006,409000438620',2018-07-06,MAW/502964XXXXXX6863/Akol,0.0,7000.0,72192.84000000329,2018,7,6,TRANSFER,7000.0,M1111264439
11007,409000438620',2018-07-06,Indiaforensic AEPS NPCI WDL SET,0.0,18632000.0,18704192.840000004,2018,7,6,CASH_IN,18632000.0,M614739613
11008,409000438620',2018-07-06,CR818410227877/RMCPL09497/0,2000.0,0.0,18702192.840000004,2018,7,6,DEBIT,2000.0,C1917105166
11009,409000438620',2018-07-06,CR818412260023/RMCPL18625/0,10000.0,0.0,18692192.840000004,2018,7,6,CHECK_WITHDRAWAL,10000.0,M1784228258
11010,409000438620',2018-07-06,CR818411245398/RMCPL18408/0,6000.0,0.0,18686192.840000004,2018,7,6,DEBIT,6000.0,C378081024
11011,409000438620',2018-07-06,CR818415308774/RMCPL09534/0,5000.0,0.0,18681192.840000004,2018,7,6,CASH_OUT,5000.0,C1207178960
11012,409000438620',2018-07-06,CR818412274562/RMCPL18521/0,2100.0,0.0,18679092.840000004,2018,7,6,CHECK_WITHDRAWAL,2100.0,C2029310301
11013,409000438620',2018-07-06,CR818411236569/RMCPL18136/0,1000.0,0.0,18678092.840000004,2018,7,6,CHECK_WITHDRAWAL,1000.0,M525101116
11014,409000438620',2018-07-06,CR818415322197/RMCPL16774/0,8000.0,0.0,18670092.840000004,2018,7,6,CASH_OUT,8000.0,M2131663948
11015,409000438620',2018-07-06,CR818416329948/RMCPL17854/0,500.0,0.0,18669592.840000004,2018,7,6,DEBIT,500.0,C71555810
11016,409000438620',2018-07-06,CR818409216440/RMCPL18524/0,1000.0,0.0,18668592.840000004,2018,7,6,PAYEMENT,1000.0,C1185567380
11017,409000438620',2018-07-06,CR818412260029/RMCPL17748/0,500.0,0.0,18668092.840000004,2018,7,6,PAYEMENT,500.0,C935808590
11018,409000438620',2018-07-06,CR818412267120/RMCPL15775/0,1000.0,0.0,18667092.840000004,2018,7,6,CASH_OUT,1000.0,C1220897602
11019,409000438620',2018-07-06,CR818408198262/RMCPL11592/0,10000.0,0.0,18657092.840000004,2018,7,6,DEBIT,10000.0,C909295153
11020,409000438620',2018-07-06,CR818415322198/RMCPL14523/0,1000.0,0.0,18656092.840000004,2018,7,6,DEBIT,1000.0,C1982740534
11021,409000438620',2018-07-06,CR818409216443/RMCPL15451/0,6000.0,0.0,18650092.840000004,2018,7,6,CASH_OUT,6000.0,C1504109395
11022,409000438620',2018-07-06,CR818410227876/RMCPL25095/0,3000.0,0.0,18647092.840000004,2018,7,6,CASH_OUT,3000.0,C405881980
11023,409000438620',2018-07-06,CR818417353905/RMCPL11784/0,2000.0,0.0,18645092.840000004,2018,7,6,CHECK_WITHDRAWAL,2000.0,C151400576
11024,409000438620',2018-07-06,CR818412274688/RMCPL26684/0,10000.0,0.0,18635092.840000004,2018,7,6,CASH_OUT,10000.0,C1423992712
11025,409000438620',2018-07-06,CR818417353932/RMCPL09185/0,1000.0,0.0,18634092.840000004,2018,7,6,DEBIT,1000.0,C767544292
11026,409000438620',2018-07-06,CR818412274692/RMCPL17652/0,10000.0,0.0,18624092.840000004,2018,7,6,PAYEMENT,10000.0,C455218098
11027,409000438620',2018-07-06,CR818413281719/RMCPL20610/0,1500.0,0.0,18622592.840000004,2018,7,6,PAYEMENT,1500.0,C798678484
11028,409000438620',2018-07-06,CR818413281756/RMCPL12522/0,1000.0,0.0,18621592.840000004,2018,7,6,CASH_OUT,1000.0,C832279283
11029,409000438620',2018-07-06,CR818411236552/RMCPL20023/0,1000.0,0.0,18620592.840000004,2018,7,6,DEBIT,1000.0,C2013091073
11030,409000438620',2018-07-06,CR818412260018/RMCPL19639/0,4000.0,0.0,18616592.840000004,2018,7,6,CHECK_WITHDRAWAL,4000.0,C1917105166
11031,409000438620',2018-07-06,TRF TO  Indiaforensic SERVICES I,15000000.0,0.0,3616592.8400000036,2018,7,6,PAYEMENT,15000000.0,C1956477953
11032,409000438620',2018-07-06,AEPS ACQUIRING ADJ FEES 0,17.7,0.0,3616575.140000003,2018,7,6,CHECK_WITHDRAWAL,17.7,C599726537
11033,409000438620',2018-07-06,AEPS ACQ CR ADJ FEES 0507,269.04,0.0,3616306.1000000034,2018,7,6,PAYEMENT,269.04,C311662903
11034,409000438620',2018-07-06,AEPS ACQ REP ADJ FEES 050,0.0,17.7,3616323.8000000035,2018,7,6,CHECK_CASHING,17.7,C1333404258
11035,409000438620',2018-07-06,AEPS INCOME DT 05-07-2018,0.0,47084.77,3663408.5700000036,2018,7,6,TRANSFER,47084.77,C1141049797
11036,409000438620',2018-07-06,AEPS GST INC DT 05-07-201,0.0,9416.95,3672825.5200000037,2018,7,6,TRANSFER,9416.95,C978740207
11037,409000438620',2018-07-06,TRF TO  Indiaforensic SERVICES I,3600000.0,0.0,72825.52000000374,2018,7,6,PAYEMENT,3600000.0,C1070146065
11038,409000438620',2018-07-07,Indiaforensic AEPS NPCI WDL SET,0.0,18843900.0,18916725.520000003,2018,7,7,CHECK_CASHING,18843900.0,C1671179293
11039,409000438620',2018-07-07,CR818508479479/RMCPL18106/0,2600.0,0.0,18914125.520000003,2018,7,7,DEBIT,2600.0,C1891834647
11040,409000438620',2018-07-07,CR818511536215/RMCPL12778/0,1000.0,0.0,18913125.520000003,2018,7,7,CASH_OUT,1000.0,M911931517
11041,409000438620',2018-07-07,CR818511536234/RMCPL16251/0,3000.0,0.0,18910125.520000003,2018,7,7,PAYEMENT,3000.0,M1468156407
11042,409000438620',2018-07-07,CR818516611615/RMCPL24303/0,1000.0,0.0,18909125.520000003,2018,7,7,CHECK_WITHDRAWAL,1000.0,M1059705149
11043,409000438620',2018-07-07,CR818511523838/RMCPL12363/0,2000.0,0.0,18907125.520000003,2018,7,7,PAYEMENT,2000.0,M991819579
11044,409000438620',2018-07-07,CR818511525588/RMCPL24609/0,2500.0,0.0,18904625.520000003,2018,7,7,CASH_OUT,2500.0,C1347890180
11045,409000438620',2018-07-07,CR818512544376/RMCPL22656/0,2000.0,0.0,18902625.520000003,2018,7,7,PAYEMENT,2000.0,C459857341
11046,409000438620',2018-07-07,CR818512544371/RMCPL16956/0,1000.0,0.0,18901625.520000003,2018,7,7,DEBIT,1000.0,M440903150
11047,409000438620',2018-07-07,CR818511524865/RMCPL23088/0,5000.0,0.0,18896625.520000003,2018,7,7,CASH_OUT,5000.0,M1741451001
11048,409000438620',2018-07-07,CR818511527060/RMCPL18600/0,1000.0,0.0,18895625.520000003,2018,7,7,PAYEMENT,1000.0,M930776278
11049,409000438620',2018-07-07,CR818516611619/RMCPL25854/0,2500.0,0.0,18893125.520000003,2018,7,7,PAYEMENT,2500.0,M1008966478
11050,409000438620',2018-07-07,CR818511524286/RMCPL22056/0,1000.0,0.0,18892125.520000003,2018,7,7,CHECK_WITHDRAWAL,1000.0,M1724869902
11051,409000438620',2018-07-07,CR818511524239/RMCPL20743/0,2000.0,0.0,18890125.520000003,2018,7,7,PAYEMENT,2000.0,M450814369
11052,409000438620',2018-07-07,MAW/502964XXXXXX6016/Akol,0.0,700.0,18890825.520000003,2018,7,7,TRANSFER,700.0,M37422174
11053,409000438620',2018-07-07,TRF TO  Indiaforensic SERVICES I,15000000.0,0.0,3890825.5200000033,2018,7,7,PAYEMENT,15000000.0,C1930765902
11054,409000438620',2018-07-07,TRF TO  Indiaforensic SERVICES I,500000.0,0.0,3390825.5200000037,2018,7,7,CASH_OUT,500000.0,C2011996123
11055,409000438620',2018-07-07,TRF TO  Indiaforensic SERVICES I,3000000.0,0.0,390825.5200000033,2018,7,7,PAYEMENT,3000000.0,C988138425
11056,409000438620',2018-07-07,AEPS ACQ CR ADJ FEES 0607,145.14,0.0,390680.38000000326,2018,7,7,DEBIT,145.14,C1778801068
11057,409000438620',2018-07-07,AEPS INCOME DT 06-07-2018,0.0,47565.41,438245.7900000033,2018,7,7,TRANSFER,47565.41,C665576141
11058,409000438620',2018-07-07,AEPS GST INC DT 06-07-201,0.0,9513.08,447758.87000000325,2018,7,7,CHECK_CASHING,9513.08,C1787868648
11059,409000438620',2018-07-09,Indiaforensic AEPS NPCI WDL SET,0.0,17365500.0,17813258.870000005,2018,7,9,CASH_IN,17365500.0,C935808590
11060,409000438620',2018-07-09,Indiaforensic AEPS NPCI WDL SET,0.0,12625100.0,30438358.870000005,2018,7,9,CASH_IN,12625100.0,C942226723
11061,409000438620',2018-07-09,CR818610778061/RMCPL24389/0,1000.0,0.0,30437358.870000005,2018,7,9,DEBIT,1000.0,C373928166
11062,409000438620',2018-07-09,CR818618909621/RMCPL18599/0,1000.0,0.0,30436358.870000005,2018,7,9,DEBIT,1000.0,C248609774
11063,409000438620',2018-07-09,CR818613838475/RMCPL24532/0,2000.0,0.0,30434358.870000005,2018,7,9,CHECK_WITHDRAWAL,2000.0,C755355682
11064,409000438620',2018-07-09,CR818613838491/RMCPL19108/0,4500.0,0.0,30429858.870000005,2018,7,9,CASH_OUT,4500.0,C248609774
11065,409000438620',2018-07-09,CR818618908084/RMCPL15322/0,1000.0,0.0,30428858.870000005,2018,7,9,CASH_OUT,1000.0,C1797686173
11066,409000438620',2018-07-09,CR818608755841/RMCPL17729/0,1000.0,0.0,30427858.870000005,2018,7,9,DEBIT,1000.0,C872592585
11067,409000438620',2018-07-09,CR818618911045/RMCPL24776/0,2400.0,0.0,30425458.870000005,2018,7,9,CHECK_WITHDRAWAL,2400.0,C1621383518
11068,409000438620',2018-07-09,CR818608755838/RMCPL21831/0,500.0,0.0,30424958.870000005,2018,7,9,PAYEMENT,500.0,C1181733275
11069,409000438620',2018-07-09,CR818618919538/RMCPL23653/0,1000.0,0.0,30423958.870000005,2018,7,9,DEBIT,1000.0,C1262822392
11070,409000438620',2018-07-09,CR818615872244/RMCPL14838/0,2000.0,0.0,30421958.870000005,2018,7,9,CASH_OUT,2000.0,C1894575391
11071,409000438620',2018-07-09,CR818618907008/RMCPL24776/0,10000.0,0.0,30411958.870000005,2018,7,9,CASH_OUT,10000.0,M838698170
11072,409000438620',2018-07-09,CR818611805318/RMCPL23482/0,10000.0,0.0,30401958.870000005,2018,7,9,DEBIT,10000.0,M1413011734
11073,409000438620',2018-07-09,CR818617902000/RMCPL17890/0,1000.0,0.0,30400958.870000005,2018,7,9,PAYEMENT,1000.0,M154819692
11074,409000438620',2018-07-09,CR818617906464/RMCPL25318/0,500.0,0.0,30400458.870000005,2018,7,9,CHECK_WITHDRAWAL,500.0,M1880323433
11075,409000438620',2018-07-09,CR818611796795/RMCPL24657/0,2000.0,0.0,30398458.870000005,2018,7,9,CHECK_WITHDRAWAL,2000.0,M30709766
11076,409000438620',2018-07-09,CR818611796804/RMCPL12805/0,500.0,0.0,30397958.870000005,2018,7,9,CASH_OUT,500.0,M127488921
11077,409000438620',2018-07-09,CR818611796754/RMCPL12509/0,5000.0,0.0,30392958.870000005,2018,7,9,DEBIT,5000.0,M1260880412
11078,409000438620',2018-07-09,CR818618907118/RMCPL18215/0,2000.0,0.0,30390958.870000005,2018,7,9,PAYEMENT,2000.0,M1011183860
11079,409000438620',2018-07-09,CR818618907044/RMCPL09982/0,2000.0,0.0,30388958.870000005,2018,7,9,CASH_OUT,2000.0,M349667507
11080,409000438620',2018-07-09,CR818618907269/RMCPL09615/0,7000.0,0.0,30381958.870000005,2018,7,9,PAYEMENT,7000.0,M496452170
11081,409000438620',2018-07-09,CR818610792624/RMCPL20121/0,500.0,0.0,30381458.870000005,2018,7,9,DEBIT,500.0,M1751836751
11082,409000438620',2018-07-09,CR818616887075/RMCPL11922/0,500.0,0.0,30380958.870000005,2018,7,9,DEBIT,500.0,M1469830730
11083,409000438620',2018-07-09,CR818608755837/RMCPL21533/0,10000.0,0.0,30370958.870000005,2018,7,9,CHECK_WITHDRAWAL,10000.0,M688565193
11084,409000438620',2018-07-09,CR818618906640/RMCPL17538/0,1000.0,0.0,30369958.870000005,2018,7,9,CHECK_WITHDRAWAL,1000.0,M449918264
11085,409000438620',2018-07-09,CR818618910927/RMCPL23764/0,1000.0,0.0,30368958.870000005,2018,7,9,PAYEMENT,1000.0,M412399411
11086,409000438620',2018-07-09,CR818611796803/RMCPL18201/0,2500.0,0.0,30366458.870000005,2018,7,9,CHECK_WITHDRAWAL,2500.0,M341136601
11087,409000438620',2018-07-09,CR818615872249/RMCPL20978/0,10000.0,0.0,30356458.870000005,2018,7,9,CASH_OUT,10000.0,C1982828534
11088,409000438620',2018-07-09,CR818618910200/RMCPL22856/0,2000.0,0.0,30354458.870000005,2018,7,9,CASH_OUT,2000.0,C1465478513
11089,409000438620',2018-07-09,CR818617894311/RMCPL12321/0,1000.0,0.0,30353458.870000005,2018,7,9,PAYEMENT,1000.0,M1649714043
11090,409000438620',2018-07-09,CR818611813747/RMCPL25225/0,2500.0,0.0,30350958.870000005,2018,7,9,DEBIT,2500.0,M1601818742
11091,409000438620',2018-07-09,CR818611813775/RMCPL18244/0,1000.0,0.0,30349958.870000005,2018,7,9,DEBIT,1000.0,M172457250
11092,409000438620',2018-07-09,CR818618909994/RMCPL12626/0,9500.0,0.0,30340458.870000005,2018,7,9,PAYEMENT,9500.0,M475465260
11093,409000438620',2018-07-09,CR818618910659/RMCPL20797/0,7000.0,0.0,30333458.870000005,2018,7,9,PAYEMENT,7000.0,M439619599
11094,409000438620',2018-07-09,TRF TO  Indiaforensic SERVICES I,15000000.0,0.0,15333458.870000005,2018,7,9,PAYEMENT,15000000.0,C1317731757
11095,409000438620',2018-07-09,TRF TO  Indiaforensic SERVICES I,10000000.0,0.0,5333458.870000005,2018,7,9,CHECK_WITHDRAWAL,10000000.0,C914293025
11096,409000438620',2018-07-09,TRF TO  Indiaforensic SERVICES I,5000000.0,0.0,333458.8700000048,2018,7,9,CASH_OUT,5000000.0,C1491676195
11097,409000438620',2018-07-09,AEPS ACQ CR ADJ FEES 0707,347.51,0.0,333111.3600000048,2018,7,9,DEBIT,347.51,M101490433
11098,409000438620',2018-07-09,AEPS INCOME DT 07-07-2018,0.0,43328.45,376439.81000000477,2018,7,9,CHECK_CASHING,43328.45,M211315337
11099,409000438620',2018-07-09,AEPS GST INC DT 07-07-201,0.0,8665.69,385105.5000000048,2018,7,9,CHECK_CASHING,8665.69,C85102332
11100,409000438620',2018-07-09,AEPS INCOME DT 08-07-2018,0.0,32497.97,417603.47000000475,2018,7,9,TRANSFER,32497.97,M1706232905
11101,409000438620',2018-07-09,AEPS GST INC DT 08-07-201,0.0,6499.59,424103.06000000477,2018,7,9,CHECK_CASHING,6499.59,M431194126
11102,409000438620',2018-07-09,TRF TO  Indiaforensic SERVICES I,400000.0,0.0,24103.06000000477,2018,7,9,PAYEMENT,400000.0,M111640508
11103,409000438620',2018-07-10,Indiaforensic AEPS NPCI WDL SET,0.0,18969000.0,18993103.060000006,2018,7,10,TRANSFER,18969000.0,M788444645
11104,409000438620',2018-07-10,TRF TO  Indiaforensic SERVICES I,5000000.0,0.0,13993103.060000004,2018,7,10,CHECK_WITHDRAWAL,5000000.0,M924365923
11105,409000438620',2018-07-10,TRF TO  Indiaforensic SERVICES I,5000000.0,0.0,8993103.060000006,2018,7,10,PAYEMENT,5000000.0,M2999709
11106,409000438620',2018-07-10,TRF TO  Indiaforensic SERVICES I,5000000.0,0.0,3993103.060000006,2018,7,10,CASH_OUT,5000000.0,M65715044
11107,409000438620',2018-07-10,TRF TO  Indiaforensic SERVICES I,3000000.0,0.0,993103.060000006,2018,7,10,CASH_OUT,3000000.0,M240460453
11108,409000438620',2018-07-10,TRF TO  Indiaforensic SERVICES I,500000.0,0.0,493103.0600000061,2018,7,10,CASH_OUT,500000.0,M879323268
11109,409000438620',2018-07-10,TRF TO  Indiaforensic SERVICES I,400000.0,0.0,93103.06000000614,2018,7,10,CASH_OUT,400000.0,M596905128
11110,409000438620',2018-07-10,AEPS INCOME DT 09-07-2018,0.0,48533.01,141636.07000000612,2018,7,10,CHECK_CASHING,48533.01,M1210944221
11111,409000438620',2018-07-10,AEPS GST INC DT 09-07-201,0.0,9706.6,151342.67000000612,2018,7,10,TRANSFER,9706.6,M1434906101
11112,409000438620',2018-07-10,AEPS ACQ REP ADJ FEES 080,0.0,11.8,151354.47000000608,2018,7,10,CASH_IN,11.8,M958514226
11113,409000438620',2018-07-11,Indiaforensic AEPS NPCI WDL SET,0.0,20547500.0,20698854.470000006,2018,7,11,TRANSFER,20547500.0,M796718693
11114,409000438620',2018-07-11,TRF TO  Indiaforensic SERVICES I,15000000.0,0.0,5698854.470000006,2018,7,11,PAYEMENT,15000000.0,M1932525059
11115,409000438620',2018-07-11,TRF TO  Indiaforensic SERVICES I,5600000.0,0.0,98854.47000000627,2018,7,11,PAYEMENT,5600000.0,C1149273771
11116,409000438620',2018-07-11,AEPS INCOME DT 10-07-2018,0.0,51568.79,150423.26000000627,2018,7,11,CASH_IN,51568.79,M1295844041
11117,409000438620',2018-07-11,AEPS GST INC DT 10-07-201,0.0,10313.76,160737.02000000628,2018,7,11,CHECK_CASHING,10313.76,M1698825479
11118,409000438620',2018-07-11,AEPS ACQUIRING ADJ FEES 1,32.45,0.0,160704.57000000626,2018,7,11,DEBIT,32.45,M345908843
11119,409000438620',2018-07-12,MAW/502964XXXXXX3725/Karu,0.0,1600.0,162304.57000000626,2018,7,12,TRANSFER,1600.0,C1474120649
11120,409000438620',2018-07-12,Indiaforensic AEPS NPCI WDL SET,0.0,18954100.0,19116404.570000008,2018,7,12,TRANSFER,18954100.0,M1659302619
11121,409000438620',2018-07-12,MAW/502964XXXXXX1878/Karu,0.0,1600.0,19118004.570000008,2018,7,12,CASH_IN,1600.0,C726762476
11122,409000438620',2018-07-12,MAW/502964XXXXXX6904/Karu,0.0,1600.0,19119604.570000008,2018,7,12,CHECK_CASHING,1600.0,C50317758
11123,409000438620',2018-07-12,MAW/502964XXXXXX1886/Karu,0.0,1600.0,19121204.570000008,2018,7,12,TRANSFER,1600.0,M1560688570
11124,409000438620',2018-07-12,MAW/502964XXXXXX3632/Karu,0.0,1600.0,19122804.570000008,2018,7,12,TRANSFER,1600.0,C221632586
11125,409000438620',2018-07-12,CR818910567520/RMCPL19766/0,1000.0,0.0,19121804.570000008,2018,7,12,DEBIT,1000.0,M1732796220
11126,409000438620',2018-07-12,CR818910567410/RMCPL23172/0,500.0,0.0,19121304.570000008,2018,7,12,DEBIT,500.0,M848154149
11127,409000438620',2018-07-12,CR818810313632/RMCPL18971/0,4300.0,0.0,19117004.570000008,2018,7,12,PAYEMENT,4300.0,M855657957
11128,409000438620',2018-07-12,CR818716144454/RMCPL15214/0,1500.0,0.0,19115504.570000008,2018,7,12,CASH_OUT,1500.0,M472933779
11129,409000438620',2018-07-12,CR818716152598/RMCPL24568/0,1500.0,0.0,19114004.570000008,2018,7,12,DEBIT,1500.0,M432243027
11130,409000438620',2018-07-12,CR819014861159/RMCPL18940/0,800.0,0.0,19113204.570000008,2018,7,12,CHECK_WITHDRAWAL,800.0,M1168717285
11131,409000438620',2018-07-12,CR819011815294/RMCPL18312/0,3500.0,0.0,19109704.570000008,2018,7,12,CASH_OUT,3500.0,C43121577
11132,409000438620',2018-07-12,CR819011815300/RMCPL18122/0,1200.0,0.0,19108504.570000008,2018,7,12,PAYEMENT,1200.0,M143815452
11133,409000438620',2018-07-12,CR819011815326/RMCPL20111/0,3900.0,0.0,19104604.570000008,2018,7,12,PAYEMENT,3900.0,M862525395
11134,409000438620',2018-07-12,CR819011807398/RMCPL19220/0,1000.0,0.0,19103604.570000008,2018,7,12,PAYEMENT,1000.0,C295372946
11135,409000438620',2018-07-12,CR819011807396/RMCPL24591/0,8000.0,0.0,19095604.570000008,2018,7,12,PAYEMENT,8000.0,C777790557
11136,409000438620',2018-07-12,CR818813371165/RMCPL20869/0,1000.0,0.0,19094604.570000008,2018,7,12,DEBIT,1000.0,M1083829130
11137,409000438620',2018-07-12,CR818813371167/RMCPL11793/0,500.0,0.0,19094104.570000008,2018,7,12,CASH_OUT,500.0,M1471419632
11138,409000438620',2018-07-12,CR818819458388/RMCPL21152/0,3500.0,0.0,19090604.570000008,2018,7,12,DEBIT,3500.0,M1324932101
11139,409000438620',2018-07-12,CR818810304652/RMCPL16726/0,500.0,0.0,19090104.570000008,2018,7,12,CASH_OUT,500.0,M1546887603
11140,409000438620',2018-07-12,CR818811323820/RMCPL21354/0,1000.0,0.0,19089104.570000008,2018,7,12,CHECK_WITHDRAWAL,1000.0,C1076835071
11141,409000438620',2018-07-12,CR818810304681/RMCPL17774/0,1000.0,0.0,19088104.570000008,2018,7,12,CHECK_WITHDRAWAL,1000.0,M315465224
11142,409000438620',2018-07-12,CR818712100809/RMCPL17070/0,1000.0,0.0,19087104.570000008,2018,7,12,CHECK_WITHDRAWAL,1000.0,M1887706810
11143,409000438620',2018-07-12,CR818717165778/RMCPL18014/0,3000.0,0.0,19084104.570000008,2018,7,12,DEBIT,3000.0,M578940391
11144,409000438620',2018-07-12,CR818714126531/RMCPL26747/0,10000.0,0.0,19074104.570000008,2018,7,12,PAYEMENT,10000.0,M898364926
11145,409000438620',2018-07-12,CR819010789968/RMCPL23352/0,5000.0,0.0,19069104.570000008,2018,7,12,PAYEMENT,5000.0,M1424713148
11146,409000438620',2018-07-12,CR819011807449/RMCPL15696/0,500.0,0.0,19068604.570000008,2018,7,12,CHECK_WITHDRAWAL,500.0,M151611315
11147,409000438620',2018-07-12,CR819017920509/RMCPL11996/0,1000.0,0.0,19067604.570000008,2018,7,12,DEBIT,1000.0,C1945802665
11148,409000438620',2018-07-12,CR819010797887/RMCPL22378/0,800.0,0.0,19066804.570000008,2018,7,12,CHECK_WITHDRAWAL,800.0,C1477979030
11149,409000438620',2018-07-12,CR819011807456/RMCPL15500/0,4500.0,0.0,19062304.570000008,2018,7,12,PAYEMENT,4500.0,M644289492
11150,409000438620',2018-07-12,CR819010789974/RMCPL26747/0,500.0,0.0,19061804.570000008,2018,7,12,CHECK_WITHDRAWAL,500.0,M1665203643
11151,409000438620',2018-07-12,CR819012824692/RMCPL20757/0,4000.0,0.0,19057804.570000008,2018,7,12,CHECK_WITHDRAWAL,4000.0,M394043289
11152,409000438620',2018-07-12,CR818712095216/RMCPL26867/0,1000.0,0.0,19056804.570000008,2018,7,12,CASH_OUT,1000.0,M362934956
11153,409000438620',2018-07-12,CR818711076151/RMCPL18216/0,1800.0,0.0,19055004.570000008,2018,7,12,CASH_OUT,1800.0,M825802350
11154,409000438620',2018-07-12,CR818710049716/RMCPL20307/0,1500.0,0.0,19053504.570000008,2018,7,12,PAYEMENT,1500.0,M434920092
11155,409000438620',2018-07-12,MAW/502964XXXXXX7940/Karu,0.0,1600.0,19055104.570000008,2018,7,12,CASH_IN,1600.0,C1209271652
11156,409000438620',2018-07-12,MAW/502964XXXXXX7614/Karu,0.0,1600.0,19056704.570000008,2018,7,12,TRANSFER,1600.0,M1623074608
11157,409000438620',2018-07-12,MAW/502964XXXXXX6896/Karu,0.0,1600.0,19058304.570000008,2018,7,12,TRANSFER,1600.0,M375820339
11158,409000438620',2018-07-12,TRF TO  Indiaforensic SERVICES I,15000000.0,0.0,4058304.570000008,2018,7,12,CHECK_WITHDRAWAL,15000000.0,M116735306
11159,409000438620',2018-07-12,TRF TO  Indiaforensic SERVICES I,4000000.0,0.0,58304.57000000776,2018,7,12,PAYEMENT,4000000.0,C1311325237
11160,409000438620',2018-07-12,AEPS INCOME DT 11-07-2018,0.0,46763.67,105068.24000000775,2018,7,12,TRANSFER,46763.67,M1566986209
11161,409000438620',2018-07-12,AEPS GST INC DT 11-07-201,0.0,9352.73,114420.97000000776,2018,7,12,CHECK_CASHING,9352.73,M862506509
11162,409000438620',2018-07-12,AEPS ACQ CR ADJ FEES 1107,292.64,0.0,114128.33000000776,2018,7,12,DEBIT,292.64,M283224765
11163,409000438620',2018-07-12,MAW/502964XXXXXX1963/NAGA,0.0,700.0,114828.33000000776,2018,7,12,TRANSFER,700.0,M640323454
11164,409000438620',2018-07-12,TRF TO  Indiaforensic SERVICES I,100000.0,0.0,14828.330000007743,2018,7,12,CASH_OUT,100000.0,M2072713946
11165,409000438620',2018-07-13,Indiaforensic AEPS NPCI WDL SET,0.0,17435700.0,17450528.33000001,2018,7,13,TRANSFER,17435700.0,M1666740331
11166,409000438620',2018-07-13,CR819115163468/RMCPL21107/1,1100.0,0.0,17449428.33000001,2018,7,13,CASH_OUT,1100.0,M837985480
11167,409000438620',2018-07-13,CR819115163485/RMCPL15540/1,5000.0,0.0,17444428.33000001,2018,7,13,CHECK_WITHDRAWAL,5000.0,M1524343632
11168,409000438620',2018-07-13,CR819112110491/RMCPL22588/1,1000.0,0.0,17443428.33000001,2018,7,13,CHECK_WITHDRAWAL,1000.0,M232318178
11169,409000438620',2018-07-13,CR819113123586/RMCPL23228/1,3000.0,0.0,17440428.33000001,2018,7,13,DEBIT,3000.0,C884262954
11170,409000438620',2018-07-13,CR819115156767/RMCPL12778/1,3500.0,0.0,17436928.33000001,2018,7,13,CHECK_WITHDRAWAL,3500.0,M502535312
11171,409000438620',2018-07-13,CR819115156780/RMCPL18799/1,500.0,0.0,17436428.33000001,2018,7,13,CASH_OUT,500.0,M1893448633
11172,409000438620',2018-07-13,CR819115156769/RMCPL22584/1,2000.0,0.0,17434428.33000001,2018,7,13,DEBIT,2000.0,M1513946341
11173,409000438620',2018-07-13,CR819118214018/RMCPL09003/1,500.0,0.0,17433928.33000001,2018,7,13,DEBIT,500.0,M686321204
11174,409000438620',2018-07-13,CR819115160060/RMCPL11811/1,10000.0,0.0,17423928.33000001,2018,7,13,PAYEMENT,10000.0,M2064736561
11175,409000438620',2018-07-13,CR819111087856/RMCPL09523/1,10000.0,0.0,17413928.33000001,2018,7,13,CHECK_WITHDRAWAL,10000.0,M224888598
11176,409000438620',2018-07-13,CR819113123593/RMCPL11480/1,500.0,0.0,17413428.33000001,2018,7,13,CHECK_WITHDRAWAL,500.0,C1144318801
11177,409000438620',2018-07-13,CR819115160040/RMCPL11151/1,3000.0,0.0,17410428.33000001,2018,7,13,DEBIT,3000.0,M1208968741
11178,409000438620',2018-07-13,CR819109062279/RMCPL19554/1,500.0,0.0,17409928.33000001,2018,7,13,PAYEMENT,500.0,C345603257
11179,409000438620',2018-07-13,CR819117183044/RMCPL17349/1,1000.0,0.0,17408928.33000001,2018,7,13,PAYEMENT,1000.0,C1031639563
11180,409000438620',2018-07-13,CR819111094917/RMCPL17167/1,2000.0,0.0,17406928.33000001,2018,7,13,CHECK_WITHDRAWAL,2000.0,C1161865950
11181,409000438620',2018-07-13,CR819113124841/RMCPL17454/1,8500.0,0.0,17398428.33000001,2018,7,13,DEBIT,8500.0,C952876299
11182,409000438620',2018-07-13,CR819113124815/RMCPL18460/1,1200.0,0.0,17397228.33000001,2018,7,13,PAYEMENT,1200.0,M129596433
11183,409000438620',2018-07-13,CR819111094924/RMCPL17957/1,6500.0,0.0,17390728.33000001,2018,7,13,PAYEMENT,6500.0,M1596052577
11184,409000438620',2018-07-13,CB817712550115/RMCPL25522/2,6500.0,0.0,17384228.33000001,2018,7,13,CHECK_WITHDRAWAL,6500.0,M887914802
11185,409000438620',2018-07-13,CB817711530397/RMCPL19108/1,10000.0,0.0,17374228.33000001,2018,7,13,DEBIT,10000.0,C1615804266
11186,409000438620',2018-07-13,CB817812811494/RMCPL18940/2,1000.0,0.0,17373228.33000001,2018,7,13,DEBIT,1000.0,C1169903663
11187,409000438620',2018-07-13,TRF TO  Indiaforensic SERVICES I,15000000.0,0.0,2373228.330000009,2018,7,13,CASH_OUT,15000000.0,C1450417897
11188,409000438620',2018-07-13,TRF TO  Indiaforensic SERVICES I,2300000.0,0.0,73228.33000000939,2018,7,13,CHECK_WITHDRAWAL,2300000.0,C1233454027
11189,409000438620',2018-07-13,MAW/502964XXXXXX7548/Karu,0.0,2000.0,75228.33000000939,2018,7,13,CHECK_CASHING,2000.0,M1544429494
11190,409000438620',2018-07-13,MAW/502964XXXXXX8066/Karu,0.0,2000.0,77228.33000000939,2018,7,13,CHECK_CASHING,2000.0,M597836072
11191,409000438620',2018-07-13,AEPS INCOME DT 12-07-2018,0.0,43633.34,120861.67000000936,2018,7,13,CASH_IN,43633.34,M749285042
11192,409000438620',2018-07-13,AEPS GST INC DT 12-07-201,0.0,8726.67,129588.34000000935,2018,7,13,CHECK_CASHING,8726.67,C444920847
11193,409000438620',2018-07-13,AEPS ACQUIRING ADJ FEES 1,8.85,0.0,129579.49000000938,2018,7,13,CASH_OUT,8.85,C284829454
11194,409000438620',2018-07-13,AEPS ACQ CR ADJ FEES 1207,202.27,0.0,129377.22000000936,2018,7,13,CASH_OUT,202.27,C1233191588
11195,409000438620',2018-07-13,AEPS ACQ REP ADJ FEES 120,0.0,14.75,129391.97000000936,2018,7,13,TRANSFER,14.75,M630463323
11196,409000438620',2018-07-16,MAW/502964XXXXXX8768/Karu,0.0,1600.0,130991.97000000936,2018,7,16,TRANSFER,1600.0,M386002713
11197,409000438620',2018-07-16,MAW/502964XXXXXX0681/Karu,0.0,1600.0,132591.97000000934,2018,7,16,CHECK_CASHING,1600.0,M630913051
11198,409000438620',2018-07-16,MAW/502964XXXXXX4077/Karu,0.0,1600.0,134191.97000000934,2018,7,16,CASH_IN,1600.0,M2136765659
11199,409000438620',2018-07-16,Indiaforensic AEPS NPCI WDL SET,0.0,19193300.0,19327491.97000001,2018,7,16,CASH_IN,19193300.0,M646086446
11200,409000438620',2018-07-16,Indiaforensic AEPS NPCI WDL SET,0.0,16914600.0,36242091.97000001,2018,7,16,CASH_IN,16914600.0,M887587629
11201,409000438620',2018-07-16,Indiaforensic AEPS NPCI WDL SET,0.0,11609400.0,47851491.97000001,2018,7,16,CASH_IN,11609400.0,M91958937
11202,409000438620',2018-07-16,MAW/502964XXXXXX6586/Karu,0.0,1700.0,47853191.97000001,2018,7,16,CHECK_CASHING,1700.0,M732445761
11203,409000438620',2018-07-16,MAW/502964XXXXXX3387/Karu,0.0,1700.0,47854891.97000001,2018,7,16,CHECK_CASHING,1700.0,M1831975653
11204,409000438620',2018-07-16,MAW/502964XXXXXX6214/Karu,0.0,1700.0,47856591.97000001,2018,7,16,CASH_IN,1700.0,M1441964653
11205,409000438620',2018-07-16,TRF TO  Indiaforensic SERVICES I,15000000.0,0.0,32856591.97000001,2018,7,16,CASH_OUT,15000000.0,M379090980
11206,409000438620',2018-07-16,TRF TO  Indiaforensic SERVICES I,15000000.0,0.0,17856591.970000014,2018,7,16,CASH_OUT,15000000.0,M2132639902
11207,409000438620',2018-07-16,TRF TO  Indiaforensic SERVICES I,15000000.0,0.0,2856591.9700000137,2018,7,16,CHECK_WITHDRAWAL,15000000.0,M748525873
11208,409000438620',2018-07-16,TRF TO  Indiaforensic SERVICES I,2000000.0,0.0,856591.9700000137,2018,7,16,CASH_OUT,2000000.0,C461640598
11209,409000438620',2018-07-16,MAW/502964XXXXXX1047/Karu,0.0,1700.0,858291.9700000137,2018,7,16,CASH_IN,1700.0,M281556143
11210,409000438620',2018-07-16,MAW/502964XXXXXX1310/Karu,0.0,1700.0,859991.9700000137,2018,7,16,TRANSFER,1700.0,M1242218279
11211,409000438620',2018-07-16,MAW/502964XXXXXX5053/Karu,0.0,1700.0,861691.9700000137,2018,7,16,CASH_IN,1700.0,M1100185368
11212,409000438620',2018-07-16,MAW/502964XXXXXX7075/Karu,0.0,1700.0,863391.9700000137,2018,7,16,TRANSFER,1700.0,M1829543571
11213,409000438620',2018-07-16,MAW/502964XXXXXX5532/Karu,0.0,1700.0,865091.9700000137,2018,7,16,TRANSFER,1700.0,M1570710450
11214,409000438620',2018-07-16,MAW/502964XXXXXX3475/Karu,0.0,1700.0,866791.9700000137,2018,7,16,CHECK_CASHING,1700.0,C481402298
11215,409000438620',2018-07-16,MAW/502964XXXXXX8727/Karu,0.0,1700.0,868491.9700000137,2018,7,16,TRANSFER,1700.0,M1371139678
11216,409000438620',2018-07-16,MAW/502964XXXXXX8715/Karu,0.0,1700.0,870191.9700000137,2018,7,16,CASH_IN,1700.0,M308981470
11217,409000438620',2018-07-16,MAW/502964XXXXXX8005/Karu,0.0,1700.0,871891.9700000137,2018,7,16,CHECK_CASHING,1700.0,M1843512523
11218,409000438620',2018-07-16,MAW/502964XXXXXX7705/Karu,0.0,1700.0,873591.9700000137,2018,7,16,TRANSFER,1700.0,M562411217
11219,409000438620',2018-07-16,MAW/502964XXXXXX8041/Karu,0.0,1700.0,875291.9700000137,2018,7,16,CASH_IN,1700.0,M297389039
11220,409000438620',2018-07-16,AEPS INCOME DT 13-07-2018,0.0,48836.32,924128.2900000135,2018,7,16,CHECK_CASHING,48836.32,M210626051
11221,409000438620',2018-07-16,AEPS GST INC DT 13-07-201,0.0,9767.26,933895.5500000136,2018,7,16,CHECK_CASHING,9767.26,M1296075836
11222,409000438620',2018-07-16,AEPS INCOME DT 14-07-2018,0.0,44515.6,978411.1500000136,2018,7,16,CASH_IN,44515.6,M962890623
11223,409000438620',2018-07-16,AEPS GST INC DT 14-07-201,0.0,8903.12,987314.2700000136,2018,7,16,CHECK_CASHING,8903.12,C2052185144
11224,409000438620',2018-07-16,AEPS INCOME DT 15-07-2018,0.0,31345.66,1018659.9300000136,2018,7,16,CHECK_CASHING,31345.66,C1247260007
11225,409000438620',2018-07-16,AEPS GST INC DT 15-07-201,0.0,6269.13,1024929.0600000136,2018,7,16,CHECK_CASHING,6269.13,C1628737580
11226,409000438620',2018-07-16,AEPS ACQUIRING ADJ FEES 1,17.7,0.0,1024911.3600000136,2018,7,16,DEBIT,17.7,M473521820
11227,409000438620',2018-07-16,TRF TO  Indiaforensic SERVICES I,800000.0,0.0,224911.36000001366,2018,7,16,PAYEMENT,800000.0,M1443526691
11228,409000438620',2018-07-17,MAW/502964XXXXXX7484/Karu,0.0,1700.0,226611.36000001372,2018,7,17,TRANSFER,1700.0,C410816406
11229,409000438620',2018-07-17,MAW/502964XXXXXX1797/Karu,0.0,1000.0,227611.36000001372,2018,7,17,TRANSFER,1000.0,M1858570667
11230,409000438620',2018-07-17,Indiaforensic AEPS NPCI WDL SET,0.0,17007300.0,17234911.360000014,2018,7,17,CASH_IN,17007300.0,M156700332
11231,409000438620',2018-07-17,MAW/502964XXXXXX4420/Karu,0.0,1700.0,17236611.360000014,2018,7,17,CHECK_CASHING,1700.0,C1723463463
11232,409000438620',2018-07-17,CB818910567761/RMCPL18971/0,10000.0,0.0,17226611.360000014,2018,7,17,PAYEMENT,10000.0,C1298316171
11233,409000438620',2018-07-17,TRF TO  Indiaforensic SERVICES I,15000000.0,0.0,2226611.3600000143,2018,7,17,CHECK_WITHDRAWAL,15000000.0,M656856272
11234,409000438620',2018-07-17,TRF TO  Indiaforensic SERVICES I,2200000.0,0.0,26611.3600000143,2018,7,17,CASH_OUT,2200000.0,M928226706
11235,409000438620',2018-07-17,MAW/502964XXXXXX3285/Karu,0.0,1800.0,28411.3600000143,2018,7,17,CHECK_CASHING,1800.0,M479954739
11236,409000438620',2018-07-17,MAW/502964XXXXXX0600/Karu,0.0,1800.0,30211.3600000143,2018,7,17,TRANSFER,1800.0,C1615443145
11237,409000438620',2018-07-17,MAW/502964XXXXXX3780/Karu,0.0,1800.0,32011.3600000143,2018,7,17,CHECK_CASHING,1800.0,M1427628907
11238,409000438620',2018-07-17,MAW/502964XXXXXX0872/Karu,0.0,1500.0,33511.360000014305,2018,7,17,CHECK_CASHING,1500.0,M29416213
11239,409000438620',2018-07-17,MAW/502964XXXXXX7106/Karu,0.0,1500.0,35011.360000014305,2018,7,17,CASH_IN,1500.0,M1899814241
11240,409000438620',2018-07-17,AEPS INCOME DT 16-07-2018,0.0,44746.7,79758.0600000143,2018,7,17,TRANSFER,44746.7,M1229889395
11241,409000438620',2018-07-17,AEPS GST INC DT 16-07-201,0.0,8949.34,88707.4000000143,2018,7,17,TRANSFER,8949.34,M382871999
11242,409000438620',2018-07-17,AEPS ACQUIRING ADJ FEES 1,47.2,0.0,88660.2000000143,2018,7,17,CHECK_WITHDRAWAL,47.2,M1789180334
11243,409000438620',2018-07-17,AEPS ACQ REP ADJ FEES 160,0.0,8.85,88669.05000001432,2018,7,17,TRANSFER,8.85,M2112310529
11244,409000438620',2018-07-18,MAW/502964XXXXXX6739/Karu,0.0,1700.0,90369.05000001432,2018,7,18,CASH_IN,1700.0,M97728322
11245,409000438620',2018-07-18,MAW/502964XXXXXX0731/Karu,0.0,1500.0,91869.05000001432,2018,7,18,CASH_IN,1500.0,M1082654713
11246,409000438620',2018-07-18,MAW/502964XXXXXX6389/Karu,0.0,1500.0,93369.05000001432,2018,7,18,TRANSFER,1500.0,C724821526
11247,409000438620',2018-07-18,MAW/502964XXXXXX1195/Karu,0.0,1500.0,94869.05000001432,2018,7,18,TRANSFER,1500.0,C782432613
11248,409000438620',2018-07-18,MAW/502964XXXXXX4640/Karu,0.0,1700.0,96569.05000001432,2018,7,18,CHECK_CASHING,1700.0,M999185713
11249,409000438620',2018-07-18,MAW/502964XXXXXX0192/Karu,0.0,1700.0,98269.05000001432,2018,7,18,TRANSFER,1700.0,M228129890
11250,409000438620',2018-07-18,MAW/502964XXXXXX7622/Karu,0.0,1700.0,99969.05000001432,2018,7,18,CASH_IN,1700.0,M1214316440
11251,409000438620',2018-07-18,MAW/502964XXXXXX7721/Karu,0.0,1700.0,101669.05000001432,2018,7,18,CASH_IN,1700.0,M1658655896
11252,409000438620',2018-07-18,MAW/502964XXXXXX2057/Karu,0.0,1700.0,103369.05000001432,2018,7,18,TRANSFER,1700.0,C1408337297
11253,409000438620',2018-07-18,MAW/502964XXXXXX4274/Karu,0.0,1700.0,105069.05000001432,2018,7,18,TRANSFER,1700.0,C1645903235
11254,409000438620',2018-07-18,MAW/502964XXXXXX1054/Karu,0.0,1700.0,106769.05000001432,2018,7,18,CASH_IN,1700.0,M414867198
11255,409000438620',2018-07-18,MAW/502964XXXXXX0617/Karu,0.0,1500.0,108269.05000001432,2018,7,18,CHECK_CASHING,1500.0,M1245124745
11256,409000438620',2018-07-18,Indiaforensic AEPS NPCI WDL SET,0.0,18409200.0,18517469.050000016,2018,7,18,TRANSFER,18409200.0,C1983747920
11257,409000438620',2018-07-18,MAW/502964XXXXXX4828/Karu,0.0,1700.0,18519169.050000016,2018,7,18,TRANSFER,1700.0,M1681937363
11258,409000438620',2018-07-18,MAW/502964XXXXXX3533/Karu,0.0,1700.0,18520869.050000016,2018,7,18,CASH_IN,1700.0,M1718165585
11259,409000438620',2018-07-18,MAW/502964XXXXXX7564/Karu,0.0,1700.0,18522569.050000016,2018,7,18,TRANSFER,1700.0,M92715012
11260,409000438620',2018-07-18,MAW/502964XXXXXX3989/Karu,0.0,1500.0,18524069.050000016,2018,7,18,TRANSFER,1500.0,M863941044
11261,409000438620',2018-07-18,MAW/502964XXXXXX9721/NAGA,0.0,1800.0,18525869.050000016,2018,7,18,TRANSFER,1800.0,M355185134
11262,409000438620',2018-07-18,TRF TO  Indiaforensic SERVICES I,15000000.0,0.0,3525869.050000016,2018,7,18,CHECK_WITHDRAWAL,15000000.0,M484794335
11263,409000438620',2018-07-18,TRF TO  Indiaforensic SERVICES I,3500000.0,0.0,25869.05000001565,2018,7,18,DEBIT,3500000.0,M449086419
11264,409000438620',2018-07-18,AEPS INCOME DT 17-07-2018,0.0,49534.89,75403.94000001566,2018,7,18,TRANSFER,49534.89,C405881980
11265,409000438620',2018-07-18,AEPS GST INC DT 17-07-201,0.0,9906.98,85310.92000001564,2018,7,18,CASH_IN,9906.98,M1720681645
11266,409000438620',2018-07-18,AEPS ACQUIRING ADJ FEES 1,11.8,0.0,85299.12000001564,2018,7,18,CHECK_WITHDRAWAL,11.8,C344247127
11267,409000438620',2018-07-18,AEPS ACQ REP ADJ FEES 170,0.0,64.9,85364.02000001562,2018,7,18,CASH_IN,64.9,M62639125
11268,409000438620',2018-07-19,MAW/502964XXXXXX9008/Karu,0.0,1700.0,87064.02000001562,2018,7,19,CASH_IN,1700.0,C1856036778
11269,409000438620',2018-07-19,MAW/502964XXXXXX0487/Karu,0.0,1700.0,88764.02000001562,2018,7,19,TRANSFER,1700.0,M99835974
11270,409000438620',2018-07-19,MAW/502964XXXXXX9802/Karu,0.0,1700.0,90464.02000001565,2018,7,19,CHECK_CASHING,1700.0,M493489190
11271,409000438620',2018-07-19,MAW/502964XXXXXX5596/Karu,0.0,1700.0,92164.02000001565,2018,7,19,CASH_IN,1700.0,M1719472894
11272,409000438620',2018-07-19,Indiaforensic AEPS NPCI WDL SET,0.0,20714779.0,20806943.02000001,2018,7,19,CHECK_CASHING,20714779.0,M1564747061
11273,409000438620',2018-07-19,MAW/502964XXXXXX8799/Karu,0.0,1500.0,20808443.02000001,2018,7,19,CASH_IN,1500.0,M1043900828
11274,409000438620',2018-07-19,MAW/502964XXXXXX4977/Karu,0.0,1500.0,20809943.02000001,2018,7,19,TRANSFER,1500.0,M1110057571
11275,409000438620',2018-07-19,MAW/502964XXXXXX8939/Karu,0.0,1600.0,20811543.02000001,2018,7,19,CHECK_CASHING,1600.0,M1812994660
11276,409000438620',2018-07-19,MAW/502964XXXXXX3400/Karu,0.0,1600.0,20813143.02000001,2018,7,19,CASH_IN,1600.0,M524923786
11277,409000438620',2018-07-19,MAW/502964XXXXXX4094/Karu,0.0,1700.0,20814843.02000001,2018,7,19,CHECK_CASHING,1700.0,M498980712
11278,409000438620',2018-07-19,MAW/502964XXXXXX4177/Karu,0.0,1700.0,20816543.02000001,2018,7,19,CHECK_CASHING,1700.0,M1581433656
11279,409000438620',2018-07-19,MAW/502964XXXXXX2847/Karu,0.0,1700.0,20818243.02000001,2018,7,19,CASH_IN,1700.0,M1296424013
11280,409000438620',2018-07-19,MAW/502964XXXXXX2336/Karu,0.0,1700.0,20819943.02000001,2018,7,19,CHECK_CASHING,1700.0,M647421947
11281,409000438620',2018-07-19,MAW/502964XXXXXX5727/Karu,0.0,1700.0,20821643.02000001,2018,7,19,CASH_IN,1700.0,M2030949015
11282,409000438620',2018-07-19,TRF TO  Indiaforensic SERVICES I,15000000.0,0.0,5821643.0200000135,2018,7,19,CHECK_WITHDRAWAL,15000000.0,M736357171
11283,409000438620',2018-07-19,TRF TO  Indiaforensic SERVICES I,5800000.0,0.0,21643.020000014454,2018,7,19,PAYEMENT,5800000.0,M1751199746
11284,409000438620',2018-07-19,CB819212371057/RMCPL12343/1,2000.0,0.0,19643.020000014454,2018,7,19,PAYEMENT,2000.0,M865012080
11285,409000438620',2018-07-19,TRF FROM  Indiaforensic SERVICES,0.0,2400000.0,2419643.0200000145,2018,7,19,CHECK_CASHING,2400000.0,C1894575391
11286,409000438620',2018-07-19,AEPS INCOME DT 18-07-2018,0.0,49165.27,2468808.2900000145,2018,7,19,CASH_IN,49165.27,C33524623
11287,409000438620',2018-07-19,AEPS GST INC DT 18-07-201,0.0,9833.05,2478641.3400000143,2018,7,19,CHECK_CASHING,9833.05,C1515704208
11288,409000438620',2018-07-19,AEPS ACQUIRING ADJ FEES 1,102.66,0.0,2478538.680000014,2018,7,19,CASH_OUT,102.66,C713961699
11289,409000438620',2018-07-19,TRF FROM  Indiaforensic SERVICES,0.0,100000.0,2578538.680000014,2018,7,19,CHECK_CASHING,100000.0,C158876320
11290,409000438620',2018-07-19,Indiaforensic AEPS NPCI WDL SET,0.0,18216700.0,20795238.68000001,2018,7,19,CASH_IN,18216700.0,C1060041730
11291,409000438620',2018-07-19,Indiaforensic AEPS NPCI WDL SET,20714779.0,0.0,80459.6800000146,2018,7,19,CASH_OUT,20714779.0,C531511436
11292,409000438620',2018-07-20,MAW/502964XXXXXX3027/Karu,0.0,1800.0,82259.6800000146,2018,7,20,TRANSFER,1800.0,C1207178960
11293,409000438620',2018-07-20,MAW/502964XXXXXX8058/Karu,0.0,1700.0,83959.6800000146,2018,7,20,CHECK_CASHING,1700.0,C265845794
11294,409000438620',2018-07-20,MAW/502964XXXXXX7499/Karu,0.0,1800.0,85759.6800000146,2018,7,20,CHECK_CASHING,1800.0,C1621383518
11295,409000438620',2018-07-20,MAW/502964XXXXXX8784/Karu,0.0,1800.0,87559.6800000146,2018,7,20,CHECK_CASHING,1800.0,C500153041
11296,409000438620',2018-07-20,MAW/502964XXXXXX8146/Karu,0.0,1800.0,89359.6800000146,2018,7,20,CHECK_CASHING,1800.0,C306285887
11297,409000438620',2018-07-20,MAW/502964XXXXXX4799/Karu,0.0,1700.0,91059.6800000146,2018,7,20,TRANSFER,1700.0,C758750856
11298,409000438620',2018-07-20,MAW/502964XXXXXX0932/Karu,0.0,1700.0,92759.6800000146,2018,7,20,CHECK_CASHING,1700.0,C413177525
11299,409000438620',2018-07-20,MAW/502964XXXXXX5046/Karu,0.0,1700.0,94459.6800000146,2018,7,20,CHECK_CASHING,1700.0,C1286084959
11300,409000438620',2018-07-20,MAW/502964XXXXXX0924/Karu,0.0,1700.0,96159.6800000146,2018,7,20,TRANSFER,1700.0,C1359484306
11301,409000438620',2018-07-20,Indiaforensic AEPS NPCI WDL SET,0.0,15327400.0,15423559.680000015,2018,7,20,TRANSFER,15327400.0,C114618982
11302,409000438620',2018-07-20,MAW/502964XXXXXX3657/Karu,0.0,1700.0,15425259.680000015,2018,7,20,CASH_IN,1700.0,C372017580
11303,409000438620',2018-07-20,CR819510057075/RMCPL09726/1,500.0,0.0,15424759.680000015,2018,7,20,CHECK_WITHDRAWAL,500.0,C1865370526
11304,409000438620',2018-07-20,CR819512093323/RMCPL23438/1,10000.0,0.0,15414759.680000015,2018,7,20,CHECK_WITHDRAWAL,10000.0,C219913687
11305,409000438620',2018-07-20,CR819512093335/RMCPL14829/1,1000.0,0.0,15413759.680000015,2018,7,20,CHECK_WITHDRAWAL,1000.0,C1541385794
11306,409000438620',2018-07-20,CR819409814638/RMCPL26284/1,6500.0,0.0,15407259.680000015,2018,7,20,CASH_OUT,6500.0,C306206744
11307,409000438620',2018-07-20,CR819410830329/RMCPL27513/1,4000.0,0.0,15403259.680000015,2018,7,20,CHECK_WITHDRAWAL,4000.0,M1735846260
11308,409000438620',2018-07-20,CR819410830344/RMCPL25071/1,7100.0,0.0,15396159.680000015,2018,7,20,PAYEMENT,7100.0,M785942574
11309,409000438620',2018-07-20,CR819412852130/RMCPL26215/1,1000.0,0.0,15395159.680000015,2018,7,20,CHECK_WITHDRAWAL,1000.0,C2046578329
11310,409000438620',2018-07-20,CR819412859792/RMCPL16684/1,3000.0,0.0,15392159.680000015,2018,7,20,CASH_OUT,3000.0,C1948471365
11311,409000438620',2018-07-20,CR819408798450/RMCPL25277/1,3700.0,0.0,15388459.680000015,2018,7,20,DEBIT,3700.0,M1698134579
11312,409000438620',2018-07-20,CR819408798465/RMCPL24836/1,2500.0,0.0,15385959.680000015,2018,7,20,PAYEMENT,2500.0,C1360767589
11313,409000438620',2018-07-20,CR819410830328/RMCPL18734/1,1500.0,0.0,15384459.680000015,2018,7,20,PAYEMENT,1500.0,C1034584766
11314,409000438620',2018-07-20,CR819414882749/RMCPL18017/1,2000.0,0.0,15382459.680000015,2018,7,20,DEBIT,2000.0,C1003872245
11315,409000438620',2018-07-20,CR819413875089/RMCPL11151/1,500.0,0.0,15381959.680000015,2018,7,20,PAYEMENT,500.0,C1354725727
11316,409000438620',2018-07-20,CR819311603821/RMCPL25729/1,600.0,0.0,15381359.680000015,2018,7,20,DEBIT,600.0,C803116137
11317,409000438620',2018-07-20,CR819310587519/RMCPL11613/1,5000.0,0.0,15376359.680000015,2018,7,20,PAYEMENT,5000.0,C578102596
11318,409000438620',2018-07-20,CR819311595569/RMCPL09211/1,10000.0,0.0,15366359.680000015,2018,7,20,PAYEMENT,10000.0,M1123118708
11319,409000438620',2018-07-20,CR819314649580/RMCPL23084/1,1000.0,0.0,15365359.680000015,2018,7,20,CHECK_WITHDRAWAL,1000.0,M1171498878
11320,409000438620',2018-07-20,CR819311603822/RMCPL14751/1,1000.0,0.0,15364359.680000015,2018,7,20,CHECK_WITHDRAWAL,1000.0,M875813519
11321,409000438620',2018-07-20,CR819314649584/RMCPL20628/1,1000.0,0.0,15363359.680000015,2018,7,20,CASH_OUT,1000.0,C1013700132
11322,409000438620',2018-07-20,CR819312619019/RMCPL23821/1,500.0,0.0,15362859.680000015,2018,7,20,DEBIT,500.0,C40075281
11323,409000438620',2018-07-20,CR819718578875/RMCPL20628/1,1000.0,0.0,15361859.680000015,2018,7,20,DEBIT,1000.0,C123428105
11324,409000438620',2018-07-20,CR819710457151/RMCPL25095/1,2000.0,0.0,15359859.680000015,2018,7,20,PAYEMENT,2000.0,C1504109395
11325,409000438620',2018-07-20,CR819714518258/RMCPL26865/1,1000.0,0.0,15358859.680000015,2018,7,20,CASH_OUT,1000.0,C932583850
11326,409000438620',2018-07-20,CR819716554288/RMCPL23126/1,2500.0,0.0,15356359.680000015,2018,7,20,PAYEMENT,2500.0,C728526866
11327,409000438620',2018-07-20,CR819716547677/RMCPL24790/1,10000.0,0.0,15346359.680000015,2018,7,20,PAYEMENT,10000.0,C248609774
11328,409000438620',2018-07-20,CR819710457158/RMCPL19712/1,5000.0,0.0,15341359.680000015,2018,7,20,CASH_OUT,5000.0,C161140376
11329,409000438620',2018-07-20,CR819710457138/RMCPL19469/1,2000.0,0.0,15339359.680000015,2018,7,20,CHECK_WITHDRAWAL,2000.0,C1916720513
11330,409000438620',2018-07-20,CR819712485995/RMCPL18298/1,500.0,0.0,15338859.680000015,2018,7,20,CHECK_WITHDRAWAL,500.0,C1419794148
11331,409000438620',2018-07-20,CR819714518249/RMCPL21642/1,2000.0,0.0,15336859.680000015,2018,7,20,CASH_OUT,2000.0,C991505714
11332,409000438620',2018-07-20,CR819715534653/RMCPL22303/1,500.0,0.0,15336359.680000015,2018,7,20,DEBIT,500.0,C1169903663
11333,409000438620',2018-07-20,CR819712494589/RMCPL18519/1,1200.0,0.0,15335159.680000015,2018,7,20,PAYEMENT,1200.0,C534662976
11334,409000438620',2018-07-20,CR819717566389/RMCPL24959/1,2300.0,0.0,15332859.680000015,2018,7,20,PAYEMENT,2300.0,C991363637
11335,409000438620',2018-07-20,CR819717572444/RMCPL14098/1,10000.0,0.0,15322859.680000015,2018,7,20,DEBIT,10000.0,C710481910
11336,409000438620',2018-07-20,CR819713509728/RMCPL19766/1,1000.0,0.0,15321859.680000015,2018,7,20,CHECK_WITHDRAWAL,1000.0,C1531333864
11337,409000438620',2018-07-20,CR819713509727/RMCPL11862/1,3500.0,0.0,15318359.680000015,2018,7,20,CHECK_WITHDRAWAL,3500.0,C861720625
11338,409000438620',2018-07-20,CR819713509725/RMCPL22180/1,7100.0,0.0,15311259.680000015,2018,7,20,CHECK_WITHDRAWAL,7100.0,C257999182
11339,409000438620',2018-07-20,CR819716547672/RMCPL19819/1,1000.0,0.0,15310259.680000015,2018,7,20,DEBIT,1000.0,C388527192
11340,409000438620',2018-07-20,CR819712486732/RMCPL24694/1,500.0,0.0,15309759.680000015,2018,7,20,DEBIT,500.0,C1825775199
11341,409000438620',2018-07-20,CR819711479665/RMCPL09588/1,5000.0,0.0,15304759.680000015,2018,7,20,CASH_OUT,5000.0,C1410669831
11342,409000438620',2018-07-20,CR819712485939/RMCPL22963/1,2000.0,0.0,15302759.680000015,2018,7,20,DEBIT,2000.0,C1590550415
11343,409000438620',2018-07-20,CR819712485906/RMCPL03659/1,2000.0,0.0,15300759.680000015,2018,7,20,PAYEMENT,2000.0,C459857341
11344,409000438620',2018-07-20,CR819718593662/RMCPL20869/1,5000.0,0.0,15295759.680000015,2018,7,20,PAYEMENT,5000.0,C288197656
11345,409000438620',2018-07-20,CR819711479657/RMCPL20773/1,1800.0,0.0,15293959.680000015,2018,7,20,CHECK_WITHDRAWAL,1800.0,C571435580
11346,409000438620',2018-07-20,CR819713501886/RMCPL21354/1,1500.0,0.0,15292459.680000015,2018,7,20,PAYEMENT,1500.0,C1856036778
11347,409000438620',2018-07-20,CR819711479670/RMCPL17957/1,3000.0,0.0,15289459.680000015,2018,7,20,CASH_OUT,3000.0,M1102735260
11348,409000438620',2018-07-20,CR819213393965/RMCPL24568/1,2000.0,0.0,15287459.680000015,2018,7,20,PAYEMENT,2000.0,M468896384
11349,409000438620',2018-07-20,CR819213393949/RMCPL16075/1,2000.0,0.0,15285459.680000015,2018,7,20,DEBIT,2000.0,M791558311
11350,409000438620',2018-07-20,CR819216423774/RMCPL22522/1,5000.0,0.0,15280459.680000015,2018,7,20,CASH_OUT,5000.0,M1850570056
11351,409000438620',2018-07-20,CR819212371097/RMCPL11784/1,1000.0,0.0,15279459.680000015,2018,7,20,DEBIT,1000.0,M1558064902
11352,409000438620',2018-07-20,CR819216423768/RMCPL17349/1,500.0,0.0,15278959.680000015,2018,7,20,CHECK_WITHDRAWAL,500.0,M178446099
11353,409000438620',2018-07-20,CR819209325209/RMCPL15464/1,4000.0,0.0,15274959.680000015,2018,7,20,CHECK_WITHDRAWAL,4000.0,M2075755840
11354,409000438620',2018-07-20,CR819212371071/RMCPL16457/1,2500.0,0.0,15272459.680000015,2018,7,20,CASH_OUT,2500.0,M1758757195
11355,409000438620',2018-07-20,MAW/502964XXXXXX0044/Karu,0.0,1600.0,15274059.680000015,2018,7,20,CASH_IN,1600.0,M414304055
11356,409000438620',2018-07-20,MAW/502964XXXXXX0077/Karu,0.0,1600.0,15275659.680000015,2018,7,20,TRANSFER,1600.0,M876945614
11357,409000438620',2018-07-20,MAW/502964XXXXXX8760/Karu,0.0,1600.0,15277259.680000015,2018,7,20,CHECK_CASHING,1600.0,M602908276
11358,409000438620',2018-07-20,MAW/502964XXXXXX3988/Karu,0.0,1600.0,15278859.680000015,2018,7,20,CASH_IN,1600.0,M2137366542
11359,409000438620',2018-07-20,TRF TO  Indiaforensic SERVICES I,4000000.0,0.0,11278859.680000015,2018,7,20,PAYEMENT,4000000.0,M513107783
11360,409000438620',2018-07-20,TRF TO  Indiaforensic SERVICES I,3000000.0,0.0,8278859.680000015,2018,7,20,CASH_OUT,3000000.0,M1935181750
11361,409000438620',2018-07-20,TRF TO  Indiaforensic SERVICES I,3000000.0,0.0,5278859.680000015,2018,7,20,CASH_OUT,3000000.0,M989977532
11362,409000438620',2018-07-20,TRF TO  Indiaforensic SERVICES I,3000000.0,0.0,2278859.6800000146,2018,7,20,PAYEMENT,3000000.0,C1760682593
11363,409000438620',2018-07-20,TRF TO  Indiaforensic SERVICES I,2000000.0,0.0,278859.6800000146,2018,7,20,CHECK_WITHDRAWAL,2000000.0,M63508873
11364,409000438620',2018-07-20,MAW/502964XXXXXX7502/Akol,0.0,500.0,279359.6800000146,2018,7,20,TRANSFER,500.0,C1092318644
11365,409000438620',2018-07-20,AEPS INCOME DT 19-07-2018,0.0,40441.88,319801.5600000146,2018,7,20,CASH_IN,40441.88,M329293111
11366,409000438620',2018-07-20,AEPS GST INC DT 19-07-201,0.0,8088.38,327889.9400000146,2018,7,20,TRANSFER,8088.38,M1770804671
11367,409000438620',2018-07-20,AEPS ACQ CR ADJ FEES 1907,589.41,0.0,327300.53000001464,2018,7,20,CHECK_WITHDRAWAL,589.41,M1388137600
11368,409000438620',2018-07-21,MAW/502964XXXXXX8138/Karu,0.0,1700.0,329000.53000001464,2018,7,21,TRANSFER,1700.0,C1210879412
11369,409000438620',2018-07-21,MAW/502964XXXXXX6797/Karu,0.0,1600.0,330600.53000001464,2018,7,21,TRANSFER,1600.0,C1808652004
11370,409000438620',2018-07-21,MAW/502964XXXXXX2325/Karu,0.0,1600.0,332200.53000001464,2018,7,21,CASH_IN,1600.0,M286693548
11371,409000438620',2018-07-21,MAW/502964XXXXXX2473/Karu,0.0,1600.0,333800.53000001464,2018,7,21,CASH_IN,1600.0,M1325241326
11372,409000438620',2018-07-21,MAW/502964XXXXXX2355/Karu,0.0,1700.0,335500.53000001464,2018,7,21,CHECK_CASHING,1700.0,M2058348472
11373,409000438620',2018-07-21,MAW/502964XXXXXX6461/Karu,0.0,1500.0,337000.53000001464,2018,7,21,TRANSFER,1500.0,C1619402333
11374,409000438620',2018-07-21,MAW/502964XXXXXX8776/Karu,0.0,1700.0,338700.53000001464,2018,7,21,CASH_IN,1700.0,C306206744
11375,409000438620',2018-07-21,Indiaforensic AEPS NPCI WDL SET,0.0,16702700.0,17041400.530000016,2018,7,21,TRANSFER,16702700.0,C1954751748
11376,409000438620',2018-07-21,MAW/502964XXXXXX4085/Karu,0.0,1700.0,17043100.530000016,2018,7,21,TRANSFER,1700.0,C766681183
11377,409000438620',2018-07-21,MAW/502964XXXXXX4097/Karu,0.0,1600.0,17044700.530000016,2018,7,21,CASH_IN,1600.0,C1515704208
11378,409000438620',2018-07-21,MAW/502964XXXXXX0815/Akol,0.0,900.0,17045600.530000016,2018,7,21,CASH_IN,900.0,C1636786811
11379,409000438620',2018-07-21,TRF TO  Indiaforensic SERVICES I,2000000.0,0.0,15045600.530000014,2018,7,21,CHECK_WITHDRAWAL,2000000.0,C863811613
11380,409000438620',2018-07-21,TRF TO  Indiaforensic SERVICES I,15000000.0,0.0,45600.530000016086,2018,7,21,CASH_OUT,15000000.0,C1040847151
11381,409000438620',2018-07-21,AEPS INCOME DT 20-07-2018,0.0,44006.5,89607.0300000161,2018,7,21,TRANSFER,44006.5,C2086207545
11382,409000438620',2018-07-21,AEPS GST INC DT 20-07-201,0.0,8801.3,98408.3300000161,2018,7,21,CHECK_CASHING,8801.3,C1423992712
11383,409000438620',2018-07-23,MAW/502964XXXXXX1956/Karu,0.0,1700.0,100108.3300000161,2018,7,23,CASH_IN,1700.0,C722999505
11384,409000438620',2018-07-23,MAW/502964XXXXXX7940/Karu,0.0,1600.0,101708.3300000161,2018,7,23,TRANSFER,1600.0,C285527187
11385,409000438620',2018-07-23,MAW/502964XXXXXX5620/Karu,0.0,1000.0,102708.3300000161,2018,7,23,TRANSFER,1000.0,M463750024
11386,409000438620',2018-07-23,MAW/502964XXXXXX4185/Karu,0.0,1800.0,104508.3300000161,2018,7,23,CHECK_CASHING,1800.0,C1440325059
11387,409000438620',2018-07-23,Indiaforensic AEPS NPCI WDL SET,0.0,12744100.0,12848608.330000015,2018,7,23,TRANSFER,12744100.0,M1276683030
11388,409000438620',2018-07-23,Indiaforensic AEPS NPCI WDL SET,0.0,9462300.0,22310908.330000017,2018,7,23,CHECK_CASHING,9462300.0,M207976641
11389,409000438620',2018-07-23,MAW/502964XXXXXX7382/Karu,0.0,1700.0,22312608.330000017,2018,7,23,CHECK_CASHING,1700.0,M1841374723
11390,409000438620',2018-07-23,MAW/502964XXXXXX4793/Karu,0.0,1600.0,22314208.330000017,2018,7,23,CHECK_CASHING,1600.0,M2011763448
11391,409000438620',2018-07-23,MAW/502964XXXXXX3574/Karu,0.0,1700.0,22315908.330000017,2018,7,23,TRANSFER,1700.0,M912071871
11392,409000438620',2018-07-23,TRF TO  Indiaforensic SERVICES I,15000000.0,0.0,7315908.330000018,2018,7,23,CASH_OUT,15000000.0,C653593128
11393,409000438620',2018-07-23,TRF TO  Indiaforensic SERVICES I,7300000.0,0.0,15908.330000016838,2018,7,23,CHECK_WITHDRAWAL,7300000.0,C1107146140
11394,409000438620',2018-07-23,MAW/502964XXXXXX4620/Karu,0.0,1600.0,17508.330000016842,2018,7,23,CHECK_CASHING,1600.0,M2103521912
11395,409000438620',2018-07-23,AEPS INCOME DT 21-07-2018,0.0,33659.8,51168.130000016834,2018,7,23,CASH_IN,33659.8,M1341858364
11396,409000438620',2018-07-23,AEPS GST INC DT 21-07-201,0.0,6731.96,57900.090000016826,2018,7,23,CHECK_CASHING,6731.96,C1626759869
11397,409000438620',2018-07-23,AEPS INCOME DT 22-07-2018,0.0,25988.38,83888.47000001684,2018,7,23,CHECK_CASHING,25988.38,M506003120
11398,409000438620',2018-07-23,AEPS GST INC DT 22-07-201,0.0,5197.68,89086.15000001686,2018,7,23,CASH_IN,5197.68,M1801625087
11399,409000438620',2018-07-23,AEPS ACQUIRING ADJ FEES 2,10.03,0.0,89076.12000001686,2018,7,23,CASH_OUT,10.03,C306206744
11400,409000438620',2018-07-23,AEPS ACQ REP ADJ FEES 210,0.0,38.35,89114.47000001685,2018,7,23,CASH_IN,38.35,C40075281
11401,409000438620',2018-07-24,MAW/502964XXXXXX1253/Cudd,0.0,1000.0,90114.47000001684,2018,7,24,CHECK_CASHING,1000.0,C1034584766
11402,409000438620',2018-07-24,MAW/502964XXXXXX7755/Karu,0.0,1400.0,91514.47000001684,2018,7,24,TRANSFER,1400.0,C991363637
11403,409000438620',2018-07-24,MAW/502964XXXXXX8707/Karu,0.0,1600.0,93114.47000001684,2018,7,24,TRANSFER,1600.0,C872592585
11404,409000438620',2018-07-24,MAW/502964XXXXXX0398/Karu,0.0,1600.0,94714.47000001684,2018,7,24,TRANSFER,1600.0,C1059781259
11405,409000438620',2018-07-24,Indiaforensic AEPS NPCI WDL SET,0.0,16437300.0,16532014.470000016,2018,7,24,CASH_IN,16437300.0,C1570256460
11406,409000438620',2018-07-24,CB819415898854/RMCPL24383/1,2900.0,0.0,16529114.470000016,2018,7,24,CHECK_WITHDRAWAL,2900.0,C1092318644
11407,409000438620',2018-07-24,CB819211357541/RMCPL24646/1,6500.0,0.0,16522614.470000016,2018,7,24,CASH_OUT,6500.0,C801142660
11408,409000438620',2018-07-24,CB819311603799/RMCPL16763/1,2000.0,0.0,16520614.470000016,2018,7,24,PAYEMENT,2000.0,C1926673338
11409,409000438620',2018-07-24,CB819418937654/RMCPL03043/1,10000.0,0.0,16510614.470000016,2018,7,24,CHECK_WITHDRAWAL,10000.0,M530056966
11410,409000438620',2018-07-24,MAW/502964XXXXXX4740/Karu,0.0,1600.0,16512214.470000016,2018,7,24,TRANSFER,1600.0,C1983747920
11411,409000438620',2018-07-24,TRF TO  Indiaforensic SERVICES I,15000000.0,0.0,1512214.4700000174,2018,7,24,DEBIT,15000000.0,C609116570
11412,409000438620',2018-07-24,TRF TO  Indiaforensic SERVICES I,1000000.0,0.0,512214.47000001743,2018,7,24,CHECK_WITHDRAWAL,1000000.0,M2075873911
11413,409000438620',2018-07-24,TRF TO  Indiaforensic SERVICES I,500000.0,0.0,12214.470000017434,2018,7,24,DEBIT,500000.0,C1838584624
11414,409000438620',2018-07-24,MAW/502964XXXXXX6016/Akol,0.0,1200.0,13414.470000017434,2018,7,24,CASH_IN,1200.0,M267816427
11415,409000438620',2018-07-24,AEPS INCOME DT 23-07-2018,0.0,42863.77,56278.24000001743,2018,7,24,CASH_IN,42863.77,M2137287089
11416,409000438620',2018-07-24,AEPS GST INC DT 23-07-201,0.0,8572.75,64850.990000017424,2018,7,24,CHECK_CASHING,8572.75,M977000076
11417,409000438620',2018-07-25,MAW/502964XXXXXX8905/Karu,0.0,1700.0,66550.99000001742,2018,7,25,CASH_IN,1700.0,C998255530
11418,409000438620',2018-07-25,MAW/502964XXXXXX8560/Karu,0.0,1700.0,68250.99000001742,2018,7,25,TRANSFER,1700.0,M2140227584
11419,409000438620',2018-07-25,MAW/502964XXXXXX0532/Karu,0.0,1900.0,70150.99000001742,2018,7,25,CHECK_CASHING,1900.0,M1466963910
11420,409000438620',2018-07-25,MAW/502964XXXXXX4234/Karu,0.0,1800.0,71950.99000001742,2018,7,25,TRANSFER,1800.0,C1493448513
11421,409000438620',2018-07-25,Indiaforensic AEPS NPCI WDL SET,0.0,16227500.0,16299450.990000015,2018,7,25,CHECK_CASHING,16227500.0,C1246134024
11422,409000438620',2018-07-25,CB819814785772/RMCPL12343/1,1000.0,0.0,16298450.990000015,2018,7,25,CASH_OUT,1000.0,M61365661
11423,409000438620',2018-07-25,CB819819868826/RMCPL12522/1,700.0,0.0,16297750.990000015,2018,7,25,CHECK_WITHDRAWAL,700.0,M1392427590
11424,409000438620',2018-07-25,TRF TO  Indiaforensic SERVICES I,15000000.0,0.0,1297750.990000017,2018,7,25,DEBIT,15000000.0,C566698125
11425,409000438620',2018-07-25,MAW/502964XXXXXX1898/NAGA,0.0,300.0,1298050.990000017,2018,7,25,CHECK_CASHING,300.0,C40641765
11426,409000438620',2018-07-25,MAW/502964XXXXXX9772/Cudd,0.0,2500.0,1300550.990000017,2018,7,25,TRANSFER,2500.0,C1825174365
11427,409000438620',2018-07-25,TRF TO  Indiaforensic SERVICES I,1300000.0,0.0,550.9900000169873,2018,7,25,CHECK_WITHDRAWAL,1300000.0,M381073902
11428,409000438620',2018-07-25,AEPS INCOME DT 24-07-2018,0.0,41884.37,42435.36000001699,2018,7,25,TRANSFER,41884.37,M809221378
11429,409000438620',2018-07-25,AEPS GST INC DT 24-07-201,0.0,8376.87,50812.23000001699,2018,7,25,TRANSFER,8376.87,M1066369235
11430,409000438620',2018-07-25,AEPS ACQUIRING ADJ FEES 2,64.9,0.0,50747.33000001699,2018,7,25,CHECK_WITHDRAWAL,64.9,M1512973579
11431,409000438620',2018-07-26,MAW/502964XXXXXX6771/Karu,0.0,1600.0,52347.33000001699,2018,7,26,CHECK_CASHING,1600.0,C1308497108
11432,409000438620',2018-07-26,MAW/502964XXXXXX0886/Karu,0.0,1600.0,53947.33000001699,2018,7,26,TRANSFER,1600.0,C1589477624
11433,409000438620',2018-07-26,MAW/502964XXXXXX7333/Karu,0.0,1600.0,55547.33000001699,2018,7,26,TRANSFER,1600.0,M855463334
11434,409000438620',2018-07-26,MAW/502964XXXXXX1420/Karu,0.0,1600.0,57147.33000001699,2018,7,26,CASH_IN,1600.0,M625046082
11435,409000438620',2018-07-26,MAW/502964XXXXXX2221/Karu,0.0,1600.0,58747.33000001699,2018,7,26,TRANSFER,1600.0,M1701713538
11436,409000438620',2018-07-26,MAW/502964XXXXXX3626/Karu,0.0,1600.0,60347.33000001699,2018,7,26,CASH_IN,1600.0,C803116137
11437,409000438620',2018-07-26,MAW/502964XXXXXX0404/Karu,0.0,1600.0,61947.33000001699,2018,7,26,CHECK_CASHING,1600.0,M442759658
11438,409000438620',2018-07-26,MAW/502964XXXXXX7114/Karu,0.0,1600.0,63547.33000001699,2018,7,26,TRANSFER,1600.0,M769394051
11439,409000438620',2018-07-26,MAW/502964XXXXXX3741/Karu,0.0,1500.0,65047.33000001699,2018,7,26,CHECK_CASHING,1500.0,C675203915
11440,409000438620',2018-07-26,MAW/502964XXXXXX0931/Karu,0.0,1500.0,66547.33000001697,2018,7,26,CHECK_CASHING,1500.0,M670676562
11441,409000438620',2018-07-26,MAW/502964XXXXXX5678/Karu,0.0,1600.0,68147.33000001697,2018,7,26,CHECK_CASHING,1600.0,M988953795
11442,409000438620',2018-07-26,MAW/502964XXXXXX5780/Karu,0.0,1500.0,69647.33000001697,2018,7,26,CHECK_CASHING,1500.0,C188246551
11443,409000438620',2018-07-26,MAW/502964XXXXXX1669/Karu,0.0,1500.0,71147.33000001697,2018,7,26,CHECK_CASHING,1500.0,M93467778
11444,409000438620',2018-07-26,MAW/502964XXXXXX0226/Karu,0.0,1600.0,72747.33000001697,2018,7,26,CHECK_CASHING,1600.0,M948906954
11445,409000438620',2018-07-26,MAW/502964XXXXXX5619/Karu,0.0,1600.0,74347.33000001697,2018,7,26,CHECK_CASHING,1600.0,C1862972704
11446,409000438620',2018-07-26,MAW/502964XXXXXX1544/Karu,0.0,1500.0,75847.33000001697,2018,7,26,TRANSFER,1500.0,M491672911
11447,409000438620',2018-07-26,MAW/502964XXXXXX8345/Karu,0.0,1600.0,77447.33000001697,2018,7,26,CHECK_CASHING,1600.0,C954723689
11448,409000438620',2018-07-26,MAW/502964XXXXXX3641/Karu,0.0,1500.0,78947.33000001697,2018,7,26,CHECK_CASHING,1500.0,M1478629136
11449,409000438620',2018-07-26,MAW/502964XXXXXX2539/Karu,0.0,1600.0,80547.33000001697,2018,7,26,TRANSFER,1600.0,M482257808
11450,409000438620',2018-07-26,Indiaforensic AEPS NPCI WDL SET,0.0,14891800.0,14972347.330000015,2018,7,26,TRANSFER,14891800.0,M881292742
11451,409000438620',2018-07-26,MAW/502964XXXXXX3058/Karu,0.0,1600.0,14973947.330000015,2018,7,26,TRANSFER,1600.0,M611828817
11452,409000438620',2018-07-26,MAW/502964XXXXXX1160/Karu,0.0,1700.0,14975647.330000015,2018,7,26,CASH_IN,1700.0,M2087548497
11453,409000438620',2018-07-26,MAW/502964XXXXXX1728/Karu,0.0,1500.0,14977147.330000015,2018,7,26,TRANSFER,1500.0,M1263634443
11454,409000438620',2018-07-26,MAW/502964XXXXXX5815/Karu,0.0,1600.0,14978747.330000015,2018,7,26,TRANSFER,1600.0,M2002554411
11455,409000438620',2018-07-26,TRF TO  Indiaforensic SERVICES I,14900000.0,0.0,78747.33000001684,2018,7,26,CHECK_WITHDRAWAL,14900000.0,M359149386
11456,409000438620',2018-07-26,MAW/502964XXXXXX3649/Karu,0.0,1600.0,80347.33000001684,2018,7,26,CHECK_CASHING,1600.0,M1125897995
11457,409000438620',2018-07-26,MAW/502964XXXXXX2994/Pand,0.0,2800.0,83147.33000001684,2018,7,26,TRANSFER,2800.0,C885136436
11458,409000438620',2018-07-26,MAW/502964XXXXXX6318/Pand,0.0,2000.0,85147.33000001684,2018,7,26,CASH_IN,2000.0,C545707113
11459,409000438620',2018-07-26,AEPS INCOME DT 25-07-2018,0.0,37667.2,122814.53000001685,2018,7,26,CASH_IN,37667.2,C1653433120
11460,409000438620',2018-07-26,AEPS GST INC DT 25-07-201,0.0,7533.44,130347.97000001685,2018,7,26,TRANSFER,7533.44,C767544292
11461,409000438620',2018-07-26,AEPS ACQUIRING ADJ FEES 2,5.9,0.0,130342.07000001686,2018,7,26,PAYEMENT,5.9,C1698704934
11462,409000438620',2018-07-26,CB817812820575/RMCPL24646/2,5000.0,0.0,125342.07000001686,2018,7,26,PAYEMENT,5000.0,C2059316944
11463,409000438620',2018-07-26,CB820109485569/RMCPL17015/2,2000.0,0.0,123342.07000001686,2018,7,26,DEBIT,2000.0,C1207178960
11464,409000438620',2018-07-26,CB819910976249/RMCPL21990/1,500.0,0.0,122842.07000001686,2018,7,26,DEBIT,500.0,C75629578
11465,409000438620',2018-07-26,CB819918110598/RMCPL18940/1,500.0,0.0,122342.07000001686,2018,7,26,DEBIT,500.0,C846382515
11466,409000438620',2018-07-27,MAW/502964XXXXXX4158/Karu,0.0,1600.0,123942.07000001686,2018,7,27,CASH_IN,1600.0,C1390121014
11467,409000438620',2018-07-27,MAW/502964XXXXXX8723/Karu,0.0,1700.0,125642.07000001686,2018,7,27,CASH_IN,1700.0,C40075281
11468,409000438620',2018-07-27,MAW/502964XXXXXX3402/Pand,0.0,500.0,126142.07000001686,2018,7,27,CASH_IN,500.0,C2145867337
11469,409000438620',2018-07-27,Indiaforensic AEPS NPCI WDL SET,0.0,14254200.0,14380342.070000015,2018,7,27,CASH_IN,14254200.0,C1339208728
11470,409000438620',2018-07-27,MAW/502964XXXXXX2937/Karu,0.0,1900.0,14382242.070000015,2018,7,27,TRANSFER,1900.0,C1220911229
11471,409000438620',2018-07-27,CR819917092607/RMCPL15334/1,5000.0,0.0,14377242.070000015,2018,7,27,PAYEMENT,5000.0,C465257140
11472,409000438620',2018-07-27,CR819912021310/RMCPL18408/1,10000.0,0.0,14367242.070000015,2018,7,27,DEBIT,10000.0,C836514715
11473,409000438620',2018-07-27,CR819912023938/RMCPL11949/1,600.0,0.0,14366642.070000015,2018,7,27,DEBIT,600.0,C1880332929
11474,409000438620',2018-07-27,CR819917098353/RMCPL22994/1,4000.0,0.0,14362642.070000015,2018,7,27,PAYEMENT,4000.0,C1645903235
11475,409000438620',2018-07-27,CR819911007740/RMCPL00154/1,2000.0,0.0,14360642.070000015,2018,7,27,CASH_OUT,2000.0,M1248751024
11476,409000438620',2018-07-27,CR819912021309/RMCPL11764/1,1000.0,0.0,14359642.070000015,2018,7,27,DEBIT,1000.0,M1419489153
11477,409000438620',2018-07-27,CR819912021212/RMCPL24338/1,10000.0,0.0,14349642.070000015,2018,7,27,CASH_OUT,10000.0,M2061116776
11478,409000438620',2018-07-27,CR819911000456/RMCPL22523/1,2500.0,0.0,14347142.070000015,2018,7,27,PAYEMENT,2500.0,M2095705095
11479,409000438620',2018-07-27,CR819916085930/RMCPL23181/1,500.0,0.0,14346642.070000015,2018,7,27,CASH_OUT,500.0,M311198191
11480,409000438620',2018-07-27,CR819912027846/RMCPL12052/1,500.0,0.0,14346142.070000015,2018,7,27,CASH_OUT,500.0,M1768778780
11481,409000438620',2018-07-27,CR819919141332/RMCPL26914/1,1000.0,0.0,14345142.070000015,2018,7,27,CASH_OUT,1000.0,M374412585
11482,409000438620',2018-07-27,CR819809690007/RMCPL25253/1,2000.0,0.0,14343142.070000015,2018,7,27,CASH_OUT,2000.0,C2067640441
11483,409000438620',2018-07-27,CR820011264548/RMCPL25245/1,500.0,0.0,14342642.070000015,2018,7,27,CASH_OUT,500.0,M876642597
11484,409000438620',2018-07-27,CR819917104584/RMCPL24821/1,3000.0,0.0,14339642.070000015,2018,7,27,CHECK_WITHDRAWAL,3000.0,C2141994208
11485,409000438620',2018-07-27,CR820018376246/RMCPL24794/1,3000.0,0.0,14336642.070000015,2018,7,27,CASH_OUT,3000.0,C1523536343
11486,409000438620',2018-07-27,CR819909957303/RMCPL24589/1,2000.0,0.0,14334642.070000015,2018,7,27,DEBIT,2000.0,C1821075330
11487,409000438620',2018-07-27,CR819909957301/RMCPL24302/1,1400.0,0.0,14333242.070000015,2018,7,27,PAYEMENT,1400.0,C569675628
11488,409000438620',2018-07-27,CR819813764444/RMCPL23898/1,2000.0,0.0,14331242.070000015,2018,7,27,PAYEMENT,2000.0,C755583709
11489,409000438620',2018-07-27,CR819819868804/RMCPL23305/1,1000.0,0.0,14330242.070000015,2018,7,27,CASH_OUT,1000.0,M1135268579
11490,409000438620',2018-07-27,CR820011264539/RMCPL22461/1,1000.0,0.0,14329242.070000015,2018,7,27,DEBIT,1000.0,M49666395
11491,409000438620',2018-07-27,CR819817827428/RMCPL22427/1,10000.0,0.0,14319242.070000015,2018,7,27,CASH_OUT,10000.0,M1908643182
11492,409000438620',2018-07-27,CR820112542092/RMCPL21598/2,1000.0,0.0,14318242.070000015,2018,7,27,DEBIT,1000.0,M1882021493
11493,409000438620',2018-07-27,CR819810712087/RMCPL20826/1,5000.0,0.0,14313242.070000015,2018,7,27,CASH_OUT,5000.0,M579532654
11494,409000438620',2018-07-27,CR820010249908/RMCPL20736/1,1700.0,0.0,14311542.070000015,2018,7,27,CHECK_WITHDRAWAL,1700.0,M386007559
11495,409000438620',2018-07-27,CR819918110644/RMCPL19898/1,2000.0,0.0,14309542.070000015,2018,7,27,PAYEMENT,2000.0,C1685837139
11496,409000438620',2018-07-27,CR819918116966/RMCPL19748/1,1000.0,0.0,14308542.070000015,2018,7,27,CHECK_WITHDRAWAL,1000.0,M1791371414
11497,409000438620',2018-07-27,CR819817827434/RMCPL19235/1,800.0,0.0,14307742.070000015,2018,7,27,CASH_OUT,800.0,C392292416
11498,409000438620',2018-07-27,CR819816820592/RMCPL18651/1,2100.0,0.0,14305642.070000015,2018,7,27,PAYEMENT,2100.0,C663202788
11499,409000438620',2018-07-27,CR820110511833/RMCPL17906/2,2000.0,0.0,14303642.070000015,2018,7,27,DEBIT,2000.0,C319086807
11500,409000438620',2018-07-27,CR819811738541/RMCPL17454/1,10000.0,0.0,14293642.070000015,2018,7,27,PAYEMENT,10000.0,M331561490
11501,409000438620',2018-07-27,CR820017355598/RMCPL16996/1,500.0,0.0,14293142.070000015,2018,7,27,CHECK_WITHDRAWAL,500.0,C1973538135
11502,409000438620',2018-07-27,CR819817835126/RMCPL16659/1,1500.0,0.0,14291642.070000015,2018,7,27,DEBIT,1500.0,M906576462
11503,409000438620',2018-07-27,CR819813764458/RMCPL16314/1,5000.0,0.0,14286642.070000015,2018,7,27,DEBIT,5000.0,M1804777673
11504,409000438620',2018-07-27,CR819816820588/RMCPL15326/1,2000.0,0.0,14284642.070000015,2018,7,27,DEBIT,2000.0,M1466691033
11505,409000438620',2018-07-27,CR819818851513/RMCPL15233/1,2500.0,0.0,14282142.070000015,2018,7,27,PAYEMENT,2500.0,M310637290
11506,409000438620',2018-07-27,CR819816820600/RMCPL14354/1,4000.0,0.0,14278142.070000015,2018,7,27,DEBIT,4000.0,M1463924746
11507,409000438620',2018-07-27,CR819813771396/RMCPL13026/1,1000.0,0.0,14277142.070000015,2018,7,27,CHECK_WITHDRAWAL,1000.0,M2089652789
11508,409000438620',2018-07-27,CR819810712096/RMCPL10339/1,1000.0,0.0,14276142.070000015,2018,7,27,CHECK_WITHDRAWAL,1000.0,C1387567249
11509,409000438620',2018-07-27,CR820018376224/RMCPL09982/1,3000.0,0.0,14273142.070000015,2018,7,27,CASH_OUT,3000.0,C893339434
11510,409000438620',2018-07-27,CR819813764441/RMCPL09615/1,1300.0,0.0,14271842.070000015,2018,7,27,PAYEMENT,1300.0,C604555852
11511,409000438620',2018-07-27,CR820112550800/RMCPL12509/2,10000.0,0.0,14261842.070000015,2018,7,27,PAYEMENT,10000.0,M251999752
11512,409000438620',2018-07-27,CR820117615481/RMCPL24066/2,500.0,0.0,14261342.070000015,2018,7,27,CHECK_WITHDRAWAL,500.0,M1808449675
11513,409000438620',2018-07-27,CR820112550803/RMCPL18940/2,500.0,0.0,14260842.070000015,2018,7,27,PAYEMENT,500.0,C199582547
11514,409000438620',2018-07-27,CR820017362351/RMCPL14820/1,2000.0,0.0,14258842.070000015,2018,7,27,CASH_OUT,2000.0,C1531333864
11515,409000438620',2018-07-27,CR820010249848/RMCPL15451/1,3000.0,0.0,14255842.070000015,2018,7,27,DEBIT,3000.0,M1739409373
11516,409000438620',2018-07-27,CR819918110622/RMCPL23450/1,2500.0,0.0,14253342.070000015,2018,7,27,CASH_OUT,2500.0,M1596993754
11517,409000438620',2018-07-27,CR819917104554/RMCPL26845/1,2000.0,0.0,14251342.070000015,2018,7,27,PAYEMENT,2000.0,M2014191947
11518,409000438620',2018-07-27,CR819919141306/RMCPL26454/1,900.0,0.0,14250442.070000015,2018,7,27,PAYEMENT,900.0,M1242524532
11519,409000438620',2018-07-27,CR819817835108/RMCPL20628/1,2000.0,0.0,14248442.070000015,2018,7,27,DEBIT,2000.0,M922439609
11520,409000438620',2018-07-27,CR819818843011/RMCPL15869/1,500.0,0.0,14247942.070000015,2018,7,27,CHECK_WITHDRAWAL,500.0,C1220911229
11521,409000438620',2018-07-27,CR819818851500/RMCPL23652/1,1000.0,0.0,14246942.070000015,2018,7,27,CHECK_WITHDRAWAL,1000.0,M620340848
11522,409000438620',2018-07-27,CR820511552400/RMCPL03657/2,10000.0,0.0,14236942.070000015,2018,7,27,CASH_OUT,10000.0,M751054575
11523,409000438620',2018-07-27,CR820515615254/RMCPL18236/2,1000.0,0.0,14235942.070000015,2018,7,27,DEBIT,1000.0,C1983025922
11524,409000438620',2018-07-27,CR820511552417/RMCPL22050/2,2000.0,0.0,14233942.070000015,2018,7,27,CHECK_WITHDRAWAL,2000.0,M1769359145
11525,409000438620',2018-07-27,CR820513589977/RMCPL17454/2,1000.0,0.0,14232942.070000015,2018,7,27,CHECK_WITHDRAWAL,1000.0,M1501377438
11526,409000438620',2018-07-27,CR820514603451/RMCPL18042/2,2200.0,0.0,14230742.070000015,2018,7,27,CASH_OUT,2200.0,C1426908073
11527,409000438620',2018-07-27,CR820519678429/RMCPL20122/2,1000.0,0.0,14229742.070000015,2018,7,27,CASH_OUT,1000.0,C49388214
11528,409000438620',2018-07-27,CR820514603463/RMCPL24698/2,2000.0,0.0,14227742.070000015,2018,7,27,PAYEMENT,2000.0,M1484516428
11529,409000438620',2018-07-27,CR820510538018/RMCPL18600/2,1200.0,0.0,14226542.070000015,2018,7,27,DEBIT,1200.0,M562379098
11530,409000438620',2018-07-27,CR820511552405/RMCPL16043/2,3000.0,0.0,14223542.070000015,2018,7,27,DEBIT,3000.0,C1104070576
11531,409000438620',2018-07-27,CR820511552402/RMCPL14954/2,500.0,0.0,14223042.070000015,2018,7,27,PAYEMENT,500.0,C1256732367
11532,409000438620',2018-07-27,CR820519678449/RMCPL20439/2,2600.0,0.0,14220442.070000015,2018,7,27,CASH_OUT,2600.0,C872592585
11533,409000438620',2018-07-27,CR820510538012/RMCPL22799/2,500.0,0.0,14219942.070000015,2018,7,27,DEBIT,500.0,M1951154278
11534,409000438620',2018-07-27,CR820510538031/RMCPL24011/2,1900.0,0.0,14218042.070000015,2018,7,27,DEBIT,1900.0,C1297804967
11535,409000438620',2018-07-27,CR820513583031/RMCPL19037/2,1000.0,0.0,14217042.070000015,2018,7,27,PAYEMENT,1000.0,M1648541820
11536,409000438620',2018-07-27,CR820513583032/RMCPL14558/2,2200.0,0.0,14214842.070000015,2018,7,27,DEBIT,2200.0,M1807719602
11537,409000438620',2018-07-27,CR820511545636/RMCPL10976/2,5000.0,0.0,14209842.070000015,2018,7,27,DEBIT,5000.0,M1588090074
11538,409000438620',2018-07-27,CR820512565280/RMCPL00045/2,3000.0,0.0,14206842.070000015,2018,7,27,CHECK_WITHDRAWAL,3000.0,M1657595584
11539,409000438620',2018-07-27,CR820514603448/RMCPL00225/2,3000.0,0.0,14203842.070000015,2018,7,27,PAYEMENT,3000.0,M1032222648
11540,409000438620',2018-07-27,CR820515609674/RMCPL14558/2,5300.0,0.0,14198542.070000015,2018,7,27,PAYEMENT,5300.0,M1089887631
11541,409000438620',2018-07-27,CR820514597013/RMCPL14954/2,1000.0,0.0,14197542.070000015,2018,7,27,CASH_OUT,1000.0,M1218396742
11542,409000438620',2018-07-27,CR820416358819/RMCPL19298/2,1000.0,0.0,14196542.070000015,2018,7,27,DEBIT,1000.0,M901362836
11543,409000438620',2018-07-27,CR820417366291/RMCPL25532/2,1000.0,0.0,14195542.070000015,2018,7,27,CHECK_WITHDRAWAL,1000.0,M386461963
11544,409000438620',2018-07-27,CR820414326397/RMCPL23013/2,1500.0,0.0,14194042.070000015,2018,7,27,CASH_OUT,1500.0,M610864412
11545,409000438620',2018-07-27,CR820415343604/RMCPL24439/2,2000.0,0.0,14192042.070000015,2018,7,27,CASH_OUT,2000.0,M1774687834
11546,409000438620',2018-07-27,CR820410254654/RMCPL18138/2,10000.0,0.0,14182042.070000015,2018,7,27,CASH_OUT,10000.0,M962752072
11547,409000438620',2018-07-27,CR820411277633/RMCPL25977/2,1800.0,0.0,14180242.070000015,2018,7,27,DEBIT,1800.0,M1754756348
11548,409000438620',2018-07-27,CR820418389325/RMCPL21832/2,1000.0,0.0,14179242.070000015,2018,7,27,CASH_OUT,1000.0,M1800128758
11549,409000438620',2018-07-27,CR820415335095/RMCPL23870/2,500.0,0.0,14178742.070000015,2018,7,27,CASH_OUT,500.0,M1058716110
11550,409000438620',2018-07-27,CR820414317232/RMCPL10728/2,2000.0,0.0,14176742.070000015,2018,7,27,CHECK_WITHDRAWAL,2000.0,M1147756217
11551,409000438620',2018-07-27,CR820410246031/RMCPL16699/2,1000.0,0.0,14175742.070000015,2018,7,27,CHECK_WITHDRAWAL,1000.0,M176912212
11552,409000438620',2018-07-27,CR820412291800/RMCPL18408/2,500.0,0.0,14175242.070000015,2018,7,27,CASH_OUT,500.0,M1956241210
11553,409000438620',2018-07-27,CR820412291853/RMCPL24777/2,5000.0,0.0,14170242.070000015,2018,7,27,CHECK_WITHDRAWAL,5000.0,M1857382731
11554,409000438620',2018-07-27,CR820311035130/RMCPL12838/2,10000.0,0.0,14160242.070000015,2018,7,27,CHECK_WITHDRAWAL,10000.0,M1888657743
11555,409000438620',2018-07-27,CR820315083550/RMCPL25969/2,500.0,0.0,14159742.070000015,2018,7,27,DEBIT,500.0,M640643567
11556,409000438620',2018-07-27,CR820315083973/RMCPL25969/2,500.0,0.0,14159242.070000015,2018,7,27,DEBIT,500.0,M1336876826
11557,409000438620',2018-07-27,CR820211779160/RMCPL21524/2,1000.0,0.0,14158242.070000015,2018,7,27,PAYEMENT,1000.0,M1553346248
11558,409000438620',2018-07-27,CR820213812201/RMCPL22318/2,2000.0,0.0,14156242.070000015,2018,7,27,CASH_OUT,2000.0,M1396885030
11559,409000438620',2018-07-27,CR820111517597/RMCPL23096/2,5000.0,0.0,14151242.070000015,2018,7,27,CHECK_WITHDRAWAL,5000.0,C18928637
11560,409000438620',2018-07-27,TRF TO  Indiaforensic SERVICES I,14100000.0,0.0,51242.07000001706,2018,7,27,CASH_OUT,14100000.0,M352737480
11561,409000438620',2018-07-27,AEPS INCOME DT 26-07-2018,0.0,36475.41,87717.48000001707,2018,7,27,CHECK_CASHING,36475.41,C1231842708
11562,409000438620',2018-07-27,AEPS GST INC DT 26-07-201,0.0,7295.08,95012.56000001707,2018,7,27,CASH_IN,7295.08,M1363629044
11563,409000438620',2018-07-27,AEPS ACQ CR ADJ FEES 2607,936.33,0.0,94076.23000001707,2018,7,27,DEBIT,936.33,M549150079
11564,409000438620',2018-07-27,AEPS ACQ REP ADJ FEES 260,0.0,29.5,94105.73000001707,2018,7,27,CHECK_CASHING,29.5,M1440597413
11565,409000438620',2018-07-27,MICROATM SETTLEMNT DATED2,0.0,100.0,94205.73000001707,2018,7,27,CHECK_CASHING,100.0,M1571682265
11566,409000438620',2018-07-28,MAW/502964XXXXXX1287/Cudd,0.0,1000.0,95205.73000001707,2018,7,28,TRANSFER,1000.0,C1101441872
11567,409000438620',2018-07-28,MAW/502964XXXXXX7344/Karu,0.0,1700.0,96905.73000001707,2018,7,28,CHECK_CASHING,1700.0,M816147662
11568,409000438620',2018-07-28,MAW/502964XXXXXX6863/Akol,0.0,7000.0,103905.73000001707,2018,7,28,TRANSFER,7000.0,M471572278
11569,409000438620',2018-07-28,MAW/502964XXXXXX6863/Akol,0.0,400.0,104305.73000001707,2018,7,28,CHECK_CASHING,400.0,M2055875800
11570,409000438620',2018-07-30,MAW/502964XXXXXX9275/Karu,0.0,1500.0,105805.73000001707,2018,7,30,CHECK_CASHING,1500.0,C1556875182
11571,409000438620',2018-07-30,MAW/502964XXXXXX6805/Karu,0.0,1800.0,107605.73000001707,2018,7,30,TRANSFER,1800.0,C1772085663
11572,409000438620',2018-07-30,Indiaforensic AEPS NPCI WDL SET,0.0,14060200.0,14167805.730000015,2018,7,30,CASH_IN,14060200.0,M1193782521
11573,409000438620',2018-07-30,Indiaforensic AEPS NPCI WDL SET,0.0,12802800.0,26970605.73000002,2018,7,30,CHECK_CASHING,12802800.0,M291618514
11574,409000438620',2018-07-30,Indiaforensic AEPS NPCI WDL SET,0.0,8355400.0,35326005.73000002,2018,7,30,TRANSFER,8355400.0,M47731847
11575,409000438620',2018-07-30,TRF TO Indiaforensic SERVICES IN,15000000.0,0.0,20326005.73000002,2018,7,30,CHECK_WITHDRAWAL,15000000.0,M577624937
11576,409000438620',2018-07-30,TRF TO Indiaforensic SERVICES IN,15000000.0,0.0,5326005.730000019,2018,7,30,CHECK_WITHDRAWAL,15000000.0,M153097013
11577,409000438620',2018-07-30,TRF TO Indiaforensic SERVICES IN,5300000.0,0.0,26005.73000001908,2018,7,30,CHECK_WITHDRAWAL,5300000.0,M1209783955
11578,409000438620',2018-07-30,MAW/502964XXXXXX1213/NAGA,0.0,2300.0,28305.73000001908,2018,7,30,CHECK_CASHING,2300.0,M1749641406
11579,409000438620',2018-07-30,MAW/502964XXXXXX9796/NAGA,0.0,1400.0,29705.73000001908,2018,7,30,TRANSFER,1400.0,M1971662131
11580,409000438620',2018-07-30,AEPS INCOME DT 27-07-2018,0.0,35695.19,65400.920000019076,2018,7,30,CASH_IN,35695.19,M2085223384
11581,409000438620',2018-07-30,AEPS GST INC DT 27-07-201,0.0,7139.04,72539.96000001907,2018,7,30,CASH_IN,7139.04,M633635448
11582,409000438620',2018-07-30,AEPS INCOME DT 28-07-2018,0.0,32768.24,105308.20000001909,2018,7,30,CASH_IN,32768.24,M2051707384
11583,409000438620',2018-07-30,AEPS GST INC DT 28-07-201,0.0,6553.65,111861.85000001908,2018,7,30,TRANSFER,6553.65,M613521831
11584,409000438620',2018-07-30,AEPS INCOME DT 29-07-2018,0.0,22221.41,134083.26000001907,2018,7,30,TRANSFER,22221.41,M839729442
11585,409000438620',2018-07-30,AEPS GST INC DT 29-07-201,0.0,4444.28,138527.54000001907,2018,7,30,CHECK_CASHING,4444.28,M123902210
11586,409000438620',2018-07-30,AEPS ACQ REP ADJ FEES 270,0.0,5.9,138533.4400000191,2018,7,30,TRANSFER,5.9,M1975677271
11587,409000438620',2018-07-30,MAW/502964XXXXXX1592/Cudd,0.0,1000.0,139533.4400000191,2018,7,30,CASH_IN,1000.0,M2063469051
11588,409000438620',2018-07-31,MAW/502964XXXXXX0237/Karu,0.0,1500.0,141033.4400000191,2018,7,31,CASH_IN,1500.0,M1075714162
11589,409000438620',2018-07-31,MAW/502964XXXXXX0455/Karu,0.0,1900.0,142933.4400000191,2018,7,31,TRANSFER,1900.0,C935001848
11590,409000438620',2018-07-31,MAW/502964XXXXXX8633/Karu,0.0,1900.0,144833.4400000191,2018,7,31,CHECK_CASHING,1900.0,C503485607
11591,409000438620',2018-07-31,Indiaforensic AEPS NPCI WDL SET,0.0,13265300.0,13410133.44000002,2018,7,31,CASH_IN,13265300.0,M136232368
11592,409000438620',2018-07-31,CR820710035611/RMCPL15981/2,1000.0,0.0,13409133.44000002,2018,7,31,CHECK_WITHDRAWAL,1000.0,M1499792515
11593,409000438620',2018-07-31,CR820712064599/RMCPL23887/2,2500.0,0.0,13406633.44000002,2018,7,31,CASH_OUT,2500.0,M54860016
11594,409000438620',2018-07-31,CR820712064604/RMCPL14558/2,1400.0,0.0,13405233.44000002,2018,7,31,DEBIT,1400.0,M1795371613
11595,409000438620',2018-07-31,CR820616891506/RMCPL22488/2,2000.0,0.0,13403233.44000002,2018,7,31,CHECK_WITHDRAWAL,2000.0,M1619842028
11596,409000438620',2018-07-31,CR820617897946/RMCPL20680/2,600.0,0.0,13402633.44000002,2018,7,31,DEBIT,600.0,M322507529
11597,409000438620',2018-07-31,CR820614865780/RMCPL15535/2,2000.0,0.0,13400633.44000002,2018,7,31,CASH_OUT,2000.0,C981198566
11598,409000438620',2018-07-31,CR820610787875/RMCPL20516/2,10000.0,0.0,13390633.44000002,2018,7,31,CHECK_WITHDRAWAL,10000.0,M1135034378
11599,409000438620',2018-07-31,CR820610787880/RMCPL25977/2,500.0,0.0,13390133.44000002,2018,7,31,DEBIT,500.0,M431768298
11600,409000438620',2018-07-31,CR820611812837/RMCPL20827/2,7000.0,0.0,13383133.44000002,2018,7,31,DEBIT,7000.0,C1479813516
11601,409000438620',2018-07-31,CR820618918372/RMCPL24928/2,500.0,0.0,13382633.44000002,2018,7,31,CASH_OUT,500.0,C1373172466
11602,409000438620',2018-07-31,CR820618918374/RMCPL26117/2,2000.0,0.0,13380633.44000002,2018,7,31,CHECK_WITHDRAWAL,2000.0,M1151362551
11603,409000438620',2018-07-31,MAW/502964XXXXXX2043/Karu,0.0,2000.0,13382633.44000002,2018,7,31,TRANSFER,2000.0,C801412408
11604,409000438620',2018-07-31,MAW/502964XXXXXX4894/Karu,0.0,1600.0,13384233.44000002,2018,7,31,CHECK_CASHING,1600.0,M1911530845
11605,409000438620',2018-07-31,TRF TO  Indiaforensic SERVICES I,13300000.0,0.0,84233.44000001997,2018,7,31,PAYEMENT,13300000.0,C1316198760
11606,409000438620',2018-07-31,AEPS INCOME DT 30-07-2018,0.0,34013.25,118246.69000001994,2018,7,31,CHECK_CASHING,34013.25,M1216602799
11607,409000438620',2018-07-31,AEPS GST INC DT 30-07-201,0.0,6802.65,125049.34000001995,2018,7,31,CHECK_CASHING,6802.65,M1294905285
11608,409000438620',2018-07-31,AEPS ACQUIRING ADJ FEES 3,38.35,0.0,125010.99000001994,2018,7,31,PAYEMENT,38.35,C928023753
11609,409000438620',2018-07-31,AEPS ACQ CR ADJ FEES 3007,109.14,0.0,124901.85000001994,2018,7,31,DEBIT,109.14,M1036713116
11610,409000438620',2018-07-31,NPCI/PUNBR520180723127283,0.0,24000000.0,24124901.85000002,2018,7,31,CHECK_CASHING,24000000.0,M637460152
11611,409000438620',2018-07-31,FDRL NEFT/RTGS CHARGS FORF,9455.0,0.0,24115446.85000002,2018,7,31,CASH_OUT,9455.0,C955097010
11612,409000438620',2018-07-31,MONTHLY SER GST FEB 18,1003.0,0.0,24114443.85000002,2018,7,31,CASH_OUT,1003.0,C160632822
11613,409000438620',2018-07-31,FDRL NEFT/RTGS CHARGS FOR,41113.16,0.0,24073330.69000002,2018,7,31,DEBIT,41113.16,M2003434760
11614,409000438620',2018-07-31,MONTHLY SER GST MAR 18,9024.84,0.0,24064305.85000002,2018,7,31,PAYEMENT,9024.84,C1050991813
11615,409000438620',2018-07-31,FDRL NEFT/RTGS CHARGS FOR,59988.74,0.0,24004317.11000002,2018,7,31,DEBIT,59988.74,M399707805
11616,409000438620',2018-07-31,MONTHLY SER GST APR 18,13168.26,0.0,23991148.85000002,2018,7,31,PAYEMENT,13168.26,M430993534
11617,409000438620',2018-07-31,FDRL NEFT/RTGS CHARGS FOR,62359.36,0.0,23928789.49000002,2018,7,31,CASH_OUT,62359.36,M1768406003
11618,409000438620',2018-07-31,MONTHLY SER GST MAY 18,13688.64,0.0,23915100.85000002,2018,7,31,CASH_OUT,13688.64,C824009085
11619,409000438620',2018-07-31,NETWORK CHARGES/VISA/DEC,228609.95,0.0,23686490.90000002,2018,7,31,CASH_OUT,228609.95,M347621817
11620,409000438620',2018-07-31,NETWORK CHARGES/VISA/JAN,534789.13,0.0,23151701.770000026,2018,7,31,PAYEMENT,534789.13,M2018306763
11621,409000438620',2018-07-31,NETWORK CHARGES/VISA/FEB,91075.13,0.0,23060626.64000003,2018,7,31,CHECK_WITHDRAWAL,91075.13,M1099014528
11622,409000438620',2018-07-31,NETWORK CHARGES/VISA/MAR,169259.98,0.0,22891366.660000026,2018,7,31,CASH_OUT,169259.98,M942765793
11623,409000438620',2018-07-31,NETWORK CHARGES/VISA/APR,215249.25,0.0,22676117.410000026,2018,7,31,PAYEMENT,215249.25,M1969878296
11624,409000438620',2018-07-31,NETWORK CHARGES/VISA/MAY,150474.1,0.0,22525643.31000002,2018,7,31,DEBIT,150474.1,M1203392623
11625,409000438620',2018-07-31,NETWORK CHARGES/VISA/JUN,386791.22,0.0,22138852.090000026,2018,7,31,CHECK_WITHDRAWAL,386791.22,C861958315
11626,409000438620',2018-07-31,NETWORK CHARGES/VISA/JUL,182585.03,0.0,21956267.06000002,2018,7,31,CASH_OUT,182585.03,C1095587424
11627,409000438620',2018-07-31,NETWORK CHARGES/VISA/AUG,109435.25,0.0,21846831.81000002,2018,7,31,CASH_OUT,109435.25,C1189861498
11628,409000438620',2018-07-31,NETWORK CHARGES/VISA/SEPT,202168.56,0.0,21644663.250000026,2018,7,31,PAYEMENT,202168.56,M1262639649
11629,409000438620',2018-07-31,NETWORK CHARGES/VISA/OCT,232241.02,0.0,21412422.230000027,2018,7,31,CASH_OUT,232241.02,C1385126783
11630,409000438620',2018-07-31,NETWORK CHARGES/VISA/NOV,225454.73,0.0,21186967.500000026,2018,7,31,PAYEMENT,225454.73,M237007682
11631,409000438620',2018-07-31,NETWORK CHARGES/VISA/DEC,130671.6,0.0,21056295.90000002,2018,7,31,CHECK_WITHDRAWAL,130671.6,M1770902540
11632,409000438620',2018-07-31,NETWORK CHARGES/VISA/JAN,216098.66,0.0,20840197.24000002,2018,7,31,CASH_OUT,216098.66,M958161465
11633,409000438620',2018-07-31,NETWORK CHARGES/VISA/FEB,95336.98,0.0,20744860.26000002,2018,7,31,PAYEMENT,95336.98,C413177525
11634,409000438620',2018-07-31,NETWORK CHARGES/VISA/MAR,93875.5,0.0,20650984.76000002,2018,7,31,DEBIT,93875.5,M1433338097
11635,409000438620',2018-07-31,NETWORK CHARGES/VISA/APR,134727.13,0.0,20516257.63000002,2018,7,31,CHECK_WITHDRAWAL,134727.13,M1827611495
11636,409000438620',2018-07-31,NETWORK CHARGES/VISA/MAY,32935.0,0.0,20483322.63000002,2018,7,31,CASH_OUT,32935.0,M1903341753
11637,409000438620',2018-07-31,NETWORK CHARGES/VISA/JUNE,79170.36,0.0,20404152.270000026,2018,7,31,CHECK_WITHDRAWAL,79170.36,M781145484
11638,409000438620',2018-07-31,NETWORK CHARGES/MASTER/AU,509579.88,0.0,19894572.390000027,2018,7,31,CASH_OUT,509579.88,C769342184
11639,409000438620',2018-07-31,NETWORK CHARGES/MASTER/SE,225418.14,0.0,19669154.250000026,2018,7,31,PAYEMENT,225418.14,C2083562754
11640,409000438620',2018-07-31,NETWORK CHARGES/MASTER/OC,90780.8,0.0,19578373.45000002,2018,7,31,DEBIT,90780.8,M908888201
11641,409000438620',2018-07-31,NETWORK CHARGES/MASTER/NO,399930.0,0.0,19178443.45000002,2018,7,31,CHECK_WITHDRAWAL,399930.0,C339082934
11642,409000438620',2018-07-31,NETWORK CHARGES/MASTER/DE,484640.98,0.0,18693802.47000002,2018,7,31,DEBIT,484640.98,C1907159141
11643,409000438620',2018-07-31,NETWORK CHARGES/MASTER/JA,70058.55,0.0,18623743.92000002,2018,7,31,CASH_OUT,70058.55,M582849451
11644,409000438620',2018-07-31,NETWORK CHARGES/MASTER/FE,88288.78,0.0,18535455.14000002,2018,7,31,CASH_OUT,88288.78,M849767246
11645,409000438620',2018-07-31,NETWORK CHARGES/MASTER/MA,85779.25,0.0,18449675.89000002,2018,7,31,CHECK_WITHDRAWAL,85779.25,M891880661
11646,409000438620',2018-07-31,NETWORK CHARGES/MASTER/AP,184449.4,0.0,18265226.49000002,2018,7,31,CHECK_WITHDRAWAL,184449.4,C1304495746
11647,409000438620',2018-07-31,NETWORK CHARGES/MASTER/MA,252989.09,0.0,18012237.40000002,2018,7,31,DEBIT,252989.09,M80749340
11648,409000438620',2018-07-31,NETWORK CHARGES/MASTER/JU,229329.0,0.0,17782908.40000002,2018,7,31,CASH_OUT,229329.0,M2086821885
11649,409000438620',2018-08-01,MAW/502964XXXXXX2164/Karu,0.0,1600.0,17784508.40000002,2018,8,1,TRANSFER,1600.0,M310898814
11650,409000438620',2018-08-01,MAW/502964XXXXXX0146/Karu,0.0,1600.0,17786108.40000002,2018,8,1,TRANSFER,1600.0,M297568794
11651,409000438620',2018-08-01,MAW/502964XXXXXX7791/Karu,0.0,1700.0,17787808.40000002,2018,8,1,TRANSFER,1700.0,M2085994381
11652,409000438620',2018-08-01,Indiaforensic AEPS NPCI WDL SET,0.0,14351900.0,32139708.40000002,2018,8,1,TRANSFER,14351900.0,M201120837
11653,409000438620',2018-08-01,CR820912526016/RMCPL14643/2,500.0,0.0,32139208.40000002,2018,8,1,DEBIT,500.0,C170899621
11654,409000438620',2018-08-01,CR820916589443/RMCPL19766/2,500.0,0.0,32138708.40000002,2018,8,1,CASH_OUT,500.0,C35126588
11655,409000438620',2018-08-01,CR820811281905/RMCPL19298/2,500.0,0.0,32138208.40000002,2018,8,1,DEBIT,500.0,C1951379728
11656,409000438620',2018-08-01,CR820812296862/RMCPL14136/2,1500.0,0.0,32136708.40000002,2018,8,1,CASH_OUT,1500.0,C1805445027
11657,409000438620',2018-08-01,CR820813311195/RMCPL15227/2,1700.0,0.0,32135008.40000002,2018,8,1,CHECK_WITHDRAWAL,1700.0,C690241874
11658,409000438620',2018-08-01,CR820813303579/RMCPL18216/2,1500.0,0.0,32133508.40000002,2018,8,1,CHECK_WITHDRAWAL,1500.0,C237988421
11659,409000438620',2018-08-01,CR820817363716/RMCPL16581/2,2000.0,0.0,32131508.40000002,2018,8,1,DEBIT,2000.0,C725215101
11660,409000438620',2018-08-01,CR820819397960/RMCPL25168/2,1000.0,0.0,32130508.40000002,2018,8,1,CHECK_WITHDRAWAL,1000.0,C1339257929
11661,409000438620',2018-08-01,CR820819397969/RMCPL13148/2,5000.0,0.0,32125508.40000002,2018,8,1,DEBIT,5000.0,C1479813516
11662,409000438620',2018-08-01,CR820812289471/RMCPL14558/2,1200.0,0.0,32124308.40000002,2018,8,1,PAYEMENT,1200.0,C1281580764
11663,409000438620',2018-08-01,CR820812289465/RMCPL18108/2,1000.0,0.0,32123308.40000002,2018,8,1,DEBIT,1000.0,C1007392323
11664,409000438620',2018-08-01,CR820814318486/RMCPL20463/2,1000.0,0.0,32122308.40000002,2018,8,1,CASH_OUT,1000.0,C773898763
11665,409000438620',2018-08-01,CR820812296841/RMCPL11798/2,5000.0,0.0,32117308.40000002,2018,8,1,CASH_OUT,5000.0,C75629578
11666,409000438620',2018-08-01,CR820818371466/RMCPL22655/2,2000.0,0.0,32115308.40000002,2018,8,1,CHECK_WITHDRAWAL,2000.0,C1089993541
11667,409000438620',2018-08-01,MAW/502964XXXXXX6606/Karu,0.0,1700.0,32117008.40000002,2018,8,1,CHECK_CASHING,1700.0,C1320217924
11668,409000438620',2018-08-01,MAW/502964XXXXXX6242/Pand,0.0,900.0,32117908.40000002,2018,8,1,CHECK_CASHING,900.0,C1003872245
11669,409000438620',2018-08-01,TRF TO  Indiaforensic SERVICES I,4000000.0,0.0,28117908.40000002,2018,8,1,CHECK_WITHDRAWAL,4000000.0,C1258662321
11670,409000438620',2018-08-01,TRF TO  Indiaforensic SERVICES I,10000000.0,0.0,18117908.40000002,2018,8,1,CHECK_WITHDRAWAL,10000000.0,C599726537
11671,409000438620',2018-08-01,AEPS INCOME DT 31-07-2018,0.0,37184.6,18155093.000000026,2018,8,1,CHECK_CASHING,37184.6,C1791017898
11672,409000438620',2018-08-01,AEPS GST INC DT 31-07-201,0.0,7436.92,18162529.920000024,2018,8,1,CHECK_CASHING,7436.92,C997588432
11673,409000438620',2018-08-01,AEPS ACQ CR ADJ FEES 3107,120.31,0.0,18162409.610000025,2018,8,1,PAYEMENT,120.31,C1014923261
11674,409000438620',2018-08-01,AEPS ACQ REP ADJ FEES 310,0.0,38.35,18162447.960000027,2018,8,1,CHECK_CASHING,38.35,C1373467808
11675,409000438620',2018-08-01,NFS MICRO ATM SETT DT 310,0.0,400.0,18162847.960000027,2018,8,1,CASH_IN,400.0,C925574515
11676,409000438620',2018-08-01,NFS MICRO ATM SETTLEMENT,0.0,3000.0,18165847.960000027,2018,8,1,CASH_IN,3000.0,C977993101
11677,409000438620',2018-08-01,TRF TO  Indiaforensic SERVICES I,500000.0,0.0,17665847.960000027,2018,8,1,CHECK_WITHDRAWAL,500000.0,C425298744
11678,409000438620',2018-08-02,MAW/502964XXXXXX0812/Karu,0.0,1700.0,17667547.960000027,2018,8,2,TRANSFER,1700.0,C459857341
11679,409000438620',2018-08-02,MAW/502964XXXXXX0628/Karu,0.0,1700.0,17669247.960000027,2018,8,2,TRANSFER,1700.0,C1765998352
11680,409000438620',2018-08-02,MAW/502964XXXXXX4940/Karu,0.0,1700.0,17670947.960000027,2018,8,2,CASH_IN,1700.0,C898762325
11681,409000438620',2018-08-02,MAW/502964XXXXXX6685/Karu,0.0,1700.0,17672647.960000027,2018,8,2,CASH_IN,1700.0,C1383831706
11682,409000438620',2018-08-02,Indiaforensic AEPS NPCI WDL SET,0.0,14598400.0,32271047.96000003,2018,8,2,TRANSFER,14598400.0,C1603338883
11683,409000438620',2018-08-02,MAW/502964XXXXXX1302/Karu,0.0,1700.0,32272747.96000003,2018,8,2,TRANSFER,1700.0,C1234059684
11684,409000438620',2018-08-02,MAW/502964XXXXXX4464/Karu,0.0,1700.0,32274447.96000003,2018,8,2,TRANSFER,1700.0,C93518808
11685,409000438620',2018-08-02,MAW/502964XXXXXX6052/Karu,0.0,2000.0,32276447.96000003,2018,8,2,CHECK_CASHING,2000.0,C1448348248
11686,409000438620',2018-08-02,MAW/502964XXXXXX2945/NAGA,0.0,600.0,32277047.96000003,2018,8,2,CHECK_CASHING,600.0,C370034120
11687,409000438620',2018-08-02,MAW/502964XXXXXX5604/Karu,0.0,1700.0,32278747.96000003,2018,8,2,CHECK_CASHING,1700.0,C219416103
11688,409000438620',2018-08-02,MAW/502964XXXXXX4275/Karu,0.0,600.0,32279347.96000003,2018,8,2,CHECK_CASHING,600.0,C2009378486
11689,409000438620',2018-08-02,TRF TO  Indiaforensic SERVICES I,14600000.0,0.0,17679347.960000027,2018,8,2,DEBIT,14600000.0,C1915091057
11690,409000438620',2018-08-02,MAW/502964XXXXXX9739/NAGA,0.0,1800.0,17681147.960000027,2018,8,2,CASH_IN,1800.0,C1311325237
11691,409000438620',2018-08-02,AEPS INCOME DT 01-08-2018,0.0,36988.0,17718135.960000027,2018,8,2,TRANSFER,36988.0,C1438594533
11692,409000438620',2018-08-02,AEPS GST INC DT 01-08-201,0.0,7397.6,17725533.56000003,2018,8,2,CHECK_CASHING,7397.6,C9916873
11693,409000438620',2018-08-02,AEPS ACQUIRING ADJ FEES 0,23.6,0.0,17725509.960000027,2018,8,2,CASH_OUT,23.6,C1473237843
11694,409000438620',2018-08-03,Indiaforensic AEPS NPCI WDL SET,0.0,15348300.0,33073809.96000003,2018,8,3,TRANSFER,15348300.0,C1514834483
11695,409000438620',2018-08-03,CR821112966534/RMCPL2486930,1000.0,0.0,33072809.96000003,2018,8,3,PAYEMENT,1000.0,C199582547
11696,409000438620',2018-08-03,CR821111945364/RMCPL2659230,1000.0,0.0,33071809.96000003,2018,8,3,CASH_OUT,1000.0,C1007876221
11697,409000438620',2018-08-03,CR821111938241/RMCPL0016630,500.0,0.0,33071309.96000003,2018,8,3,DEBIT,500.0,C1207178960
11698,409000438620',2018-08-03,CR821117035979/RMCPL2459130,1000.0,0.0,33070309.96000003,2018,8,3,CHECK_WITHDRAWAL,1000.0,C1213485528
11699,409000438620',2018-08-03,CR821113987840/RMCPL1522730,2000.0,0.0,33068309.96000003,2018,8,3,DEBIT,2000.0,C1181733275
11700,409000438620',2018-08-03,CR821115016119/RMCPL2289730,1000.0,0.0,33067309.96000003,2018,8,3,DEBIT,1000.0,C188246551
11701,409000438620',2018-08-03,CR821110930443/RMCPL2123530,1000.0,0.0,33066309.96000003,2018,8,3,DEBIT,1000.0,C1261940766
11702,409000438620',2018-08-03,CR821116029326/RMCPL2062830,10000.0,0.0,33056309.96000003,2018,8,3,CASH_OUT,10000.0,C1558550579
11703,409000438620',2018-08-03,CR821118050110/RMCPL1234330,1000.0,0.0,33055309.96000003,2018,8,3,PAYEMENT,1000.0,C114618982
11704,409000438620',2018-08-03,CR821214263054/RMCPL2359231,2000.0,0.0,33053309.96000003,2018,8,3,DEBIT,2000.0,C101571284
11705,409000438620',2018-08-03,CR821211212373/RMCPL1495431,500.0,0.0,33052809.96000003,2018,8,3,PAYEMENT,500.0,C77652925
11706,409000438620',2018-08-03,CR821217324453/RMCPL2684531,1800.0,0.0,33051009.96000003,2018,8,3,DEBIT,1800.0,C47827984
11707,409000438620',2018-08-03,CR821212234463/RMCPL2286631,1000.0,0.0,33050009.96000003,2018,8,3,CASH_OUT,1000.0,C271588719
11708,409000438620',2018-08-03,CR821212234471/RMCPL1846631,4000.0,0.0,33046009.96000003,2018,8,3,CASH_OUT,4000.0,C461640598
11709,409000438620',2018-08-03,CR821219351166/RMCPL1550331,1000.0,0.0,33045009.96000003,2018,8,3,PAYEMENT,1000.0,C1108121945
11710,409000438620',2018-08-03,CR821216296910/RMCPL2390631,600.0,0.0,33044409.96000003,2018,8,3,CHECK_WITHDRAWAL,600.0,C934300202
11711,409000438620',2018-08-03,CR821215290412/RMCPL1113131,3500.0,0.0,33040909.96000003,2018,8,3,DEBIT,3500.0,C1394526584
11712,409000438620',2018-08-03,TRFT O  Indiaforensic SERVICES I,15000000.0,0.0,18040909.960000027,2018,8,3,CASH_OUT,15000000.0,C988138425
11713,409000438620',2018-08-03,MAW/502964XXXXXX1356/Karu,0.0,1100.0,18042009.960000027,2018,8,3,CHECK_CASHING,1100.0,C309167705
11714,409000438620',2018-08-03,MAW/502964XXXXXX3961/Karu,0.0,1900.0,18043909.960000027,2018,8,3,TRANSFER,1900.0,C1434389049
11715,409000438620',2018-08-03,MAW/502964XXXXXX4399/Karu,0.0,1800.0,18045709.960000027,2018,8,3,TRANSFER,1800.0,C128870695
11716,409000438620',2018-08-03,MICRO ATM SETTLEMENT DT 0,0.0,100.0,18045809.960000027,2018,8,3,CASH_IN,100.0,C798678484
11717,409000438620',2018-08-03,TRF TO  Indiaforensic SERVICES I,300000.0,0.0,17745809.960000027,2018,8,3,DEBIT,300000.0,C1628737580
11718,409000438620',2018-08-03,AEPS INCOME DT 02-08-2018,0.0,38834.96,17784644.920000028,2018,8,3,TRANSFER,38834.96,C410816406
11719,409000438620',2018-08-03,AEPS GST INC DT 02-08-201,0.0,7766.99,17792411.910000026,2018,8,3,CASH_IN,7766.99,C663202788
11720,409000438620',2018-08-03,AEPS ACQ CR ADJ FEES 0208,143.96,0.0,17792267.950000025,2018,8,3,DEBIT,143.96,C955097010
11721,409000438620',2018-08-03,AEPS ACQ REP ADJ FEES 020,0.0,23.6,17792291.550000027,2018,8,3,CASH_IN,23.6,C513145905
11722,409000438620',2018-08-03,NFS MICROATMSETTLEMENTDT0,0.0,100.0,17792391.550000027,2018,8,3,TRANSFER,100.0,M1670141042
11723,409000438620',2018-08-04,Indiaforensic AEPS NPCI WDL SET,0.0,15358000.0,33150391.55000003,2018,8,4,TRANSFER,15358000.0,M990847564
11724,409000438620',2018-08-04,TRF TO  Indiaforensic SERVICES I,15000000.0,0.0,18150391.550000027,2018,8,4,PAYEMENT,15000000.0,M181272378
11725,409000438620',2018-08-04,NPCI SETT DIFF_030818_1,0.0,100.0,18150491.550000027,2018,8,4,TRANSFER,100.0,M635385661
11726,409000438620',2018-08-04,MICRO ATM SETTLEMENT DT 0,0.0,200.0,18150691.550000027,2018,8,4,CASH_IN,200.0,C1983747920
11727,409000438620',2018-08-04,AEPS INCOME DT 03-08-2018,0.0,38639.78,18189331.330000028,2018,8,4,TRANSFER,38639.78,C932493233
11728,409000438620',2018-08-04,AEPS GST INC DT 03-08-201,0.0,7727.96,18197059.29000003,2018,8,4,TRANSFER,7727.96,M1806276835
11729,409000438620',2018-08-04,AEPS ACQUIRING ADJ FEES 0,17.7,0.0,18197041.59000003,2018,8,4,CASH_OUT,17.7,M117150895
11730,409000438620',2018-08-04,TRF TO  Indiaforensic SERVICES I,500000.0,0.0,17697041.59000003,2018,8,4,DEBIT,500000.0,M263224384
11731,409000438620',2018-08-06,MAW/502964XXXXXX4267/Karu,0.0,1800.0,17698841.59000003,2018,8,6,CASH_IN,1800.0,M1459096037
11732,409000438620',2018-08-06,MAW/502964XXXXXX3988/Karu,0.0,1800.0,17700641.59000003,2018,8,6,CASH_IN,1800.0,M1040354326
11733,409000438620',2018-08-06,MAW/502964XXXXXX2946/Karu,0.0,1800.0,17702441.59000003,2018,8,6,TRANSFER,1800.0,M1097324593
11734,409000438620',2018-08-06,MAW/502964XXXXXX2870/Karu,0.0,1800.0,17704241.59000003,2018,8,6,CASH_IN,1800.0,M1015500579
11735,409000438620',2018-08-06,MAW/502964XXXXXX6222/Karu,0.0,1800.0,17706041.59000003,2018,8,6,CHECK_CASHING,1800.0,M652050259
11736,409000438620',2018-08-06,MAW/502964XXXXXX3751/Karu,0.0,1800.0,17707841.59000003,2018,8,6,CHECK_CASHING,1800.0,M1310333347
11737,409000438620',2018-08-06,MAW/502964XXXXXX5160/Karu,0.0,1800.0,17709641.59000003,2018,8,6,CASH_IN,1800.0,M2124009530
11738,409000438620',2018-08-06,MAW/502964XXXXXX2953/Karu,0.0,1800.0,17711441.59000003,2018,8,6,CHECK_CASHING,1800.0,M1025589260
11739,409000438620',2018-08-06,MAW/502964XXXXXX4558/Karu,0.0,1600.0,17713041.59000003,2018,8,6,CASH_IN,1600.0,M652615485
11740,409000438620',2018-08-06,MAW/502964XXXXXX2938/Karu,0.0,1800.0,17714841.59000003,2018,8,6,TRANSFER,1800.0,M1995007531
11741,409000438620',2018-08-06,MAW/502964XXXXXX1212/Cudd,0.0,1000.0,17715841.59000003,2018,8,6,TRANSFER,1000.0,M107386650
11742,409000438620',2018-08-06,Indiaforensic AEPS NPCI WDL SET,0.0,13440900.0,31156741.59000003,2018,8,6,CHECK_CASHING,13440900.0,M29315039
11743,409000438620',2018-08-06,Indiaforensic AEPS NPCI WDL SET,0.0,9689800.0,40846541.59000003,2018,8,6,CHECK_CASHING,9689800.0,M1488572343
11744,409000438620',2018-08-06,MAW/502964XXXXXX8477/Karu,0.0,1800.0,40848341.59000003,2018,8,6,CASH_IN,1800.0,M1254271504
11745,409000438620',2018-08-06,MAW/502964XXXXXX0485/Karu,0.0,1800.0,40850141.59000003,2018,8,6,CHECK_CASHING,1800.0,M475550258
11746,409000438620',2018-08-06,TRF TO  Indiaforensic SERVICES I,15000000.0,0.0,25850141.590000033,2018,8,6,CHECK_WITHDRAWAL,15000000.0,M877182150
11747,409000438620',2018-08-06,TRF TO  Indiaforensic SERVICES I,8100000.0,0.0,17750141.590000033,2018,8,6,CHECK_WITHDRAWAL,8100000.0,M923618247
11748,409000438620',2018-08-06,NPCI SETT DIFF_050818_1,0.0,400.0,17750541.590000033,2018,8,6,TRANSFER,400.0,M98058633
11749,409000438620',2018-08-06,MAW/502964XXXXXX9734/NAGA,0.0,700.0,17751241.590000033,2018,8,6,CASH_IN,700.0,M1663002925
11750,409000438620',2018-08-06,AEPS INCOME DT 04-08-2018,0.0,34620.46,17785862.050000034,2018,8,6,CASH_IN,34620.46,M1798219135
11751,409000438620',2018-08-06,AEPS GST INC DT 04-08-201,0.0,6924.09,17792786.140000034,2018,8,6,TRANSFER,6924.09,M1194791300
11752,409000438620',2018-08-06,AEPS INCOME DT 05-08-2018,0.0,25551.09,17818337.230000034,2018,8,6,CHECK_CASHING,25551.09,M507361937
11753,409000438620',2018-08-06,AEPS GST INC DT 05-08-201,0.0,5110.22,17823447.450000033,2018,8,6,CASH_IN,5110.22,M1954530486
11754,409000438620',2018-08-07,MAW/502964XXXXXX4713/Karu,0.0,1600.0,17825047.450000033,2018,8,7,CHECK_CASHING,1600.0,M820113416
11755,409000438620',2018-08-07,MAW/502964XXXXXX7625/Karu,0.0,5800.0,17830847.450000033,2018,8,7,CASH_IN,5800.0,M1805675363
11756,409000438620',2018-08-07,MAW/502964XXXXXX7666/Karu,0.0,2800.0,17833647.450000033,2018,8,7,CASH_IN,2800.0,M1308741443
11757,409000438620',2018-08-07,Indiaforensic AEPS NPCI WDL SET,0.0,14060800.0,31894447.45000004,2018,8,7,CHECK_CASHING,14060800.0,M1171084822
11758,409000438620',2018-08-07,TRF TO  Indiaforensic SERVICES I,14200000.0,0.0,17694447.450000033,2018,8,7,DEBIT,14200000.0,M203825912
11759,409000438620',2018-08-07,AEPS INCOME DT 06-08-2018,0.0,36440.88,17730888.33000003,2018,8,7,CHECK_CASHING,36440.88,C766681183
11760,409000438620',2018-08-07,AEPS GST INC DT 06-08-201,0.0,7288.18,17738176.51000003,2018,8,7,CHECK_CASHING,7288.18,C347696158
11761,409000438620',2018-08-07,AEPS ACQUIRING ADJ FEES 0,57.82,0.0,17738118.69000003,2018,8,7,CHECK_WITHDRAWAL,57.82,C801142660
11762,409000438620',2018-08-08,Indiaforensic AEPS NPCI WDL SET,0.0,14792500.0,32530618.69000003,2018,8,8,CHECK_CASHING,14792500.0,C1856036778
11763,409000438620',2018-08-08,TRF TO  Indiaforensic SERVICES I,10000000.0,0.0,22530618.69000003,2018,8,8,CHECK_WITHDRAWAL,10000000.0,C1028574311
11764,409000438620',2018-08-08,TRF TO  Indiaforensic SERVICES I,4000000.0,0.0,18530618.69000003,2018,8,8,CASH_OUT,4000000.0,C184253187
11765,409000438620',2018-08-08,TRF TO  Indiaforensic SERVICES I,500000.0,0.0,18030618.69000003,2018,8,8,DEBIT,500000.0,C1850180796
11766,409000438620',2018-08-08,AEPS INCOME DT 07-08-2018,0.0,39377.51,18069996.20000004,2018,8,8,TRANSFER,39377.51,C1085479446
11767,409000438620',2018-08-08,AEPS GST INC DT 07-08-201,0.0,7875.5,18077871.70000004,2018,8,8,TRANSFER,7875.5,C1234776885
11768,409000438620',2018-08-08,AEPS ACQUIRING ADJ FEES 0,42.48,0.0,18077829.220000032,2018,8,8,CASH_OUT,42.48,C1297685781
11769,409000438620',2018-08-08,AEPS ACQ REP ADJ FEES 070,0.0,17.7,18077846.92000003,2018,8,8,CHECK_CASHING,17.7,C1076835071
11770,409000438620',2018-08-08,CB821415843979/RMCPL19766/0,1500.0,0.0,18076346.92000003,2018,8,8,CHECK_WITHDRAWAL,1500.0,C1060041730
11771,409000438620',2018-08-08,CB821410746099/RMCPL23513/0,3000.0,0.0,18073346.92000003,2018,8,8,PAYEMENT,3000.0,C1566246889
11772,409000438620',2018-08-08,CB821412793337/RMCPL22583/0,2300.0,0.0,18071046.92000003,2018,8,8,CHECK_WITHDRAWAL,2300.0,C423580937
11773,409000438620',2018-08-08,CB821512035170/RMCPL12343/0,2700.0,0.0,18068346.92000003,2018,8,8,CASH_OUT,2700.0,C715819458
11774,409000438620',2018-08-08,CB821513054925/RMCPL22148/0,1500.0,0.0,18066846.92000003,2018,8,8,CASH_OUT,1500.0,C906718881
11775,409000438620',2018-08-08,CB821617334805/RMCPL17395/0,6000.0,0.0,18060846.92000003,2018,8,8,DEBIT,6000.0,M313627991
11776,409000438620',2018-08-08,TRF TO  Indiaforensic SERVICES I,300000.0,0.0,17760846.92000003,2018,8,8,PAYEMENT,300000.0,M494625485
11777,409000438620',2018-08-09,MAW/502964XXXXXX4347/Karu,0.0,1700.0,17762546.92000003,2018,8,9,TRANSFER,1700.0,M1194273408
11778,409000438620',2018-08-09,Indiaforensic AEPS NPCI WDL SET,0.0,16820200.0,34582746.92000003,2018,8,9,TRANSFER,16820200.0,M1372670602
11779,409000438620',2018-08-09,CR817815858416/RMCPL14406/2,5000.0,0.0,34577746.92000003,2018,8,9,CHECK_WITHDRAWAL,5000.0,M1720312243
11780,409000438620',2018-08-09,CR817815858350/RMCPL09619/2,4000.0,0.0,34573746.92000003,2018,8,9,CASH_OUT,4000.0,M2065096438
11781,409000438620',2018-08-09,CR817815858354/RMCPL11966/2,3100.0,0.0,34570646.92000003,2018,8,9,PAYEMENT,3100.0,C316106307
11782,409000438620',2018-08-09,CR817817893314/RMCPL09768/2,1700.0,0.0,34568946.92000003,2018,8,9,CASH_OUT,1700.0,C1292838001
11783,409000438620',2018-08-09,CR817812810359/RMCPL25450/2,500.0,0.0,34568446.92000003,2018,8,9,CASH_OUT,500.0,M1077892648
11784,409000438620',2018-08-09,CR817812810342/RMCPL26592/2,1500.0,0.0,34566946.92000003,2018,8,9,PAYEMENT,1500.0,C264843581
11785,409000438620',2018-08-09,CR817812810343/RMCPL18216/2,2000.0,0.0,34564946.92000003,2018,8,9,CHECK_WITHDRAWAL,2000.0,M356274819
11786,409000438620',2018-08-09,CR817810782985/RMCPL18915/2,500.0,0.0,34564446.92000003,2018,8,9,PAYEMENT,500.0,M921503579
11787,409000438620',2018-08-09,CR817818907786/RMCPL14700/2,500.0,0.0,34563946.92000003,2018,8,9,PAYEMENT,500.0,M560346359
11788,409000438620',2018-08-09,CR817812819549/RMCPL09536/2,1000.0,0.0,34562946.92000003,2018,8,9,CHECK_WITHDRAWAL,1000.0,M374268229
11789,409000438620',2018-08-09,CR817812819572/RMCPL11613/2,3000.0,0.0,34559946.92000003,2018,8,9,PAYEMENT,3000.0,M509179355
11790,409000438620',2018-08-09,CR817812819568/RMCPL25428/2,1000.0,0.0,34558946.92000003,2018,8,9,PAYEMENT,1000.0,M139108160
11791,409000438620',2018-08-09,CR817812811520/RMCPL21021/2,1800.0,0.0,34557146.92000003,2018,8,9,CHECK_WITHDRAWAL,1800.0,M308559511
11792,409000438620',2018-08-09,CR817810782993/RMCPL12604/2,4000.0,0.0,34553146.92000003,2018,8,9,CASH_OUT,4000.0,M1594463246
11793,409000438620',2018-08-09,CR817818904413/RMCPL21965/2,2000.0,0.0,34551146.92000003,2018,8,9,CASH_OUT,2000.0,M418909736
11794,409000438620',2018-08-09,CR817812811801/RMCPL13680/2,1000.0,0.0,34550146.92000003,2018,8,9,CASH_OUT,1000.0,M634662382
11795,409000438620',2018-08-09,CR817812811795/RMCPL18729/2,500.0,0.0,34549646.92000003,2018,8,9,CASH_OUT,500.0,M239552687
11796,409000438620',2018-08-09,CR817810782975/RMCPL22488/2,1000.0,0.0,34548646.92000003,2018,8,9,CHECK_WITHDRAWAL,1000.0,M1340428360
11797,409000438620',2018-08-09,CR817710518442/RMCPL22799/2,500.0,0.0,34548146.92000003,2018,8,9,CHECK_WITHDRAWAL,500.0,M420420938
11798,409000438620',2018-08-09,CR817714579462/RMCPL09726/2,1000.0,0.0,34547146.92000003,2018,8,9,CHECK_WITHDRAWAL,1000.0,M1656053866
11799,409000438620',2018-08-09,CR817710511413/RMCPL16684/2,3600.0,0.0,34543546.92000003,2018,8,9,PAYEMENT,3600.0,M1732215844
11800,409000438620',2018-08-09,CR817710518871/RMCPL12826/2,5000.0,0.0,34538546.92000003,2018,8,9,CASH_OUT,5000.0,M292989931
11801,409000438620',2018-08-09,CR817710518547/RMCPL16908/2,500.0,0.0,34538046.92000003,2018,8,9,CASH_OUT,500.0,C1103621993
11802,409000438620',2018-08-09,CR817710520808/RMCPL25095/2,4000.0,0.0,34534046.92000003,2018,8,9,DEBIT,4000.0,M1155353291
11803,409000438620',2018-08-09,CR817710520804/RMCPL23968/2,1000.0,0.0,34533046.92000003,2018,8,9,CASH_OUT,1000.0,M17639934
11804,409000438620',2018-08-09,CR817710520779/RMCPL22038/2,5000.0,0.0,34528046.92000003,2018,8,9,DEBIT,5000.0,M2019318648
11805,409000438620',2018-08-09,CR817716609893/RMCPL20143/2,1000.0,0.0,34527046.92000003,2018,8,9,CHECK_WITHDRAWAL,1000.0,M1946191441
11806,409000438620',2018-08-09,CR817716609868/RMCPL11611/2,1000.0,0.0,34526046.92000003,2018,8,9,PAYEMENT,1000.0,M1992264544
11807,409000438620',2018-08-09,CR817716609869/RMCPL23345/2,1000.0,0.0,34525046.92000003,2018,8,9,CASH_OUT,1000.0,C1909597726
11808,409000438620',2018-08-09,TRF TO  Indiaforensic SERVICES I,15000000.0,0.0,19525046.92000003,2018,8,9,CHECK_WITHDRAWAL,15000000.0,C83827469
11809,409000438620',2018-08-09,TRF TO  Indiaforensic SERVICES I,1800000.0,0.0,17725046.92000003,2018,8,9,CASH_OUT,1800000.0,C1869228744
11810,409000438620',2018-08-09,MAW/502964XXXXXX5347/Karu,0.0,1700.0,17726746.92000003,2018,8,9,CHECK_CASHING,1700.0,M1947750538
11811,409000438620',2018-08-09,MAW/502964XXXXXX8487/Karu,0.0,1700.0,17728446.92000003,2018,8,9,TRANSFER,1700.0,C1213485528
11812,409000438620',2018-08-09,MAW/502964XXXXXX9291/Karu,0.0,1700.0,17730146.92000003,2018,8,9,CHECK_CASHING,1700.0,M539582450
11813,409000438620',2018-08-09,NFS MICRO ATM SETT DT 090,0.0,100.0,17730246.92000003,2018,8,9,CASH_IN,100.0,M1457246292
11814,409000438620',2018-08-09,MAW/502964XXXXXX7808/Karu,0.0,1700.0,17731946.92000003,2018,8,9,CHECK_CASHING,1700.0,M1587306957
11815,409000438620',2018-08-09,MAW/502964XXXXXX7269/Karu,0.0,1700.0,17733646.92000003,2018,8,9,CASH_IN,1700.0,M1593663165
11816,409000438620',2018-08-09,MAW/502964XXXXXX4893/Karu,0.0,1700.0,17735346.92000003,2018,8,9,TRANSFER,1700.0,M1421233855
11817,409000438620',2018-08-09,MAW/502964XXXXXX3499/Karu,0.0,1700.0,17737046.92000003,2018,8,9,CASH_IN,1700.0,M1442393563
11818,409000438620',2018-08-09,MAW/502964XXXXXX4901/Karu,0.0,1700.0,17738746.92000003,2018,8,9,CASH_IN,1700.0,M337645549
11819,409000438620',2018-08-09,AEPS INCOME DT 08-08-2018,0.0,43210.21,17781957.130000032,2018,8,9,CHECK_CASHING,43210.21,C591862575
11820,409000438620',2018-08-09,AEPS GST INC DT 08-08-201,0.0,8642.04,17790599.17000003,2018,8,9,CASH_IN,8642.04,C861720625
11821,409000438620',2018-08-09,AEPS ACQUIRING ADJ FEES 0,8.85,0.0,17790590.32000003,2018,8,9,PAYEMENT,8.85,M149866127
11822,409000438620',2018-08-09,AEPS ACQ CR ADJ FEES 0808,253.7,0.0,17790336.62000003,2018,8,9,CASH_OUT,253.7,M1332367388
11823,409000438620',2018-08-09,AEPS ACQ REP ADJ FEES 080,0.0,17.7,17790354.32000003,2018,8,9,TRANSFER,17.7,M36998710
11824,409000438620',2018-08-10,MAW/502964XXXXXX3889/Karu,0.0,1800.0,17792154.32000003,2018,8,10,CHECK_CASHING,1800.0,M464277949
11825,409000438620',2018-08-10,MAW/502964XXXXXX8476/Vals,0.0,4000.0,17796154.32000003,2018,8,10,TRANSFER,4000.0,M1174979589
11826,409000438620',2018-08-10,MAW/502964XXXXXX8161/Karu,0.0,1700.0,17797854.32000003,2018,8,10,CHECK_CASHING,1700.0,M1636538715
11827,409000438620',2018-08-10,Indiaforensic AEPS NPCI WDL SET,0.0,15830300.0,33628154.32000003,2018,8,10,TRANSFER,15830300.0,M1550654008
11828,409000438620',2018-08-10,TRF T  Indiaforensic SERVICES IN,900000.0,0.0,32728154.32000003,2018,8,10,CASH_OUT,900000.0,M1632690629
11829,409000438620',2018-08-10,TRF T  Indiaforensic SERVICES IN,15000000.0,0.0,17728154.32000003,2018,8,10,PAYEMENT,15000000.0,M667286432
11830,409000438620',2018-08-10,NPCI SETT DIFF_090818_1,0.0,100.0,17728254.32000003,2018,8,10,CASH_IN,100.0,M2058923828
11831,409000438620',2018-08-10,MAW/502964XXXXXX9200/Karu,0.0,1700.0,17729954.32000003,2018,8,10,TRANSFER,1700.0,M233025642
11832,409000438620',2018-08-10,MAW/502964XXXXXX9226/Karu,0.0,1700.0,17731654.32000003,2018,8,10,CASH_IN,1700.0,C2093546827
11833,409000438620',2018-08-10,MAW/502964XXXXXX8252/Karu,0.0,1700.0,17733354.32000003,2018,8,10,TRANSFER,1700.0,M816646757
11834,409000438620',2018-08-10,MAW/502964XXXXXX5206/Karu,0.0,1700.0,17735054.32000003,2018,8,10,CHECK_CASHING,1700.0,M751741003
11835,409000438620',2018-08-10,AEPS INCOME DT 09-08-2018,0.0,40219.08,17775273.40000003,2018,8,10,TRANSFER,40219.08,C952610115
11836,409000438620',2018-08-10,AEPS GST INC DT 09-08-201,0.0,8043.82,17783317.22000003,2018,8,10,TRANSFER,8043.82,M2103121798
11837,409000438620',2018-08-10,MAW/502964XXXXXX9192/Karu,0.0,1700.0,17785017.22000003,2018,8,10,CHECK_CASHING,1700.0,M268625482
11838,409000438620',2018-08-10,MAW/502964XXXXXX5869/Karu,0.0,1700.0,17786717.22000003,2018,8,10,CASH_IN,1700.0,M1871701992
11839,409000438620',2018-08-10,MAW/502964XXXXXX8828/Karu,0.0,1700.0,17788417.22000003,2018,8,10,CHECK_CASHING,1700.0,M1061492137
11840,409000438620',2018-08-10,MAW/502964XXXXXX5612/Karu,0.0,1700.0,17790117.22000003,2018,8,10,CHECK_CASHING,1700.0,M217781547
11841,409000438620',2018-08-10,MAW/502964XXXXXX0069/Karu,0.0,1700.0,17791817.22000003,2018,8,10,CASH_IN,1700.0,M939043159
11842,409000438620',2018-08-10,MAW/502964XXXXXX8339/Karu,0.0,1700.0,17793517.22000003,2018,8,10,CASH_IN,1700.0,M661521317
11843,409000438620',2018-08-10,Indfor-MICRO ATM INC DT 0908,0.0,0.36,17793517.580000028,2018,8,10,CASH_IN,0.36,M1307861467
11844,409000438620',2018-08-10,Indfor-MICRO ATM WDL GST DT0,0.0,0.07,17793517.65000003,2018,8,10,TRANSFER,0.07,C904383922
11845,409000438620',2018-08-10,Indfor-MICRO ATM INC DT 3107,0.0,0.72,17793518.370000027,2018,8,10,CASH_IN,0.72,C1401316767
11846,409000438620',2018-08-10,Indfor-MICRO ATM WDL GST DT3,0.0,0.14,17793518.510000028,2018,8,10,CASH_IN,0.14,M1577873988
11847,409000438620',2018-08-10,Indfor-MICRO ATM INC DT 3107,0.0,0.36,17793518.870000027,2018,8,10,TRANSFER,0.36,M728229415
11848,409000438620',2018-08-10,Indfor-MICRO ATM WDL GST DT3,0.0,0.07,17793518.940000027,2018,8,10,TRANSFER,0.07,M1729399329
11849,409000438620',2018-08-10,Indfor-MICRO ATM INC DT 3107,0.0,0.36,17793519.300000027,2018,8,10,CHECK_CASHING,0.36,M381504811
11850,409000438620',2018-08-10,Indfor-MICRO ATM WDL GST DT3,0.0,0.07,17793519.370000027,2018,8,10,CHECK_CASHING,0.07,M889655083
11851,409000438620',2018-08-10,Indfor-MICRO ATM INC DT 0108,0.0,10.8,17793530.170000028,2018,8,10,CASH_IN,10.8,M889237296
11852,409000438620',2018-08-10,Indfor-MICRO ATM WDL GST DT0,0.0,2.16,17793532.330000028,2018,8,10,CHECK_CASHING,2.16,M1077427339
11853,409000438620',2018-08-10,Indfor-MICRO ATM INC DT 0208,0.0,0.36,17793532.690000027,2018,8,10,TRANSFER,0.36,M2053817683
11854,409000438620',2018-08-10,Indfor-MICRO ATM WDL GST DT0,0.0,0.07,17793532.760000028,2018,8,10,TRANSFER,0.07,M1846262441
11855,409000438620',2018-08-10,Indfor-MICRO ATM INC DT 0308,0.0,0.36,17793533.120000027,2018,8,10,CHECK_CASHING,0.36,M348292129
11856,409000438620',2018-08-10,Indfor-MICRO ATM WDL GST DT0,0.0,0.07,17793533.190000027,2018,8,10,CASH_IN,0.07,C189963646
11857,409000438620',2018-08-10,Indfor-MICRO ATM INC DT 0308,0.0,0.36,17793533.550000027,2018,8,10,CHECK_CASHING,0.36,M885582120
11858,409000438620',2018-08-10,Indfor-MICRO ATM WDL GST DT0,0.0,0.07,17793533.620000027,2018,8,10,TRANSFER,0.07,M1232549345
11859,409000438620',2018-08-10,Indfor-MICRO ATM INC DT 0308,0.0,0.36,17793533.980000027,2018,8,10,TRANSFER,0.36,C1149273771
11860,409000438620',2018-08-10,Indfor-MICRO ATM WDL GST DT0,0.0,0.07,17793534.050000027,2018,8,10,CHECK_CASHING,0.07,M1971649348
11861,409000438620',2018-08-10,Indfor-MICRO ATM INC DT 0908,0.0,0.36,17793534.410000026,2018,8,10,TRANSFER,0.36,C803116137
11862,409000438620',2018-08-10,Indfor-MICRO ATM WDL GST DT0,0.0,0.07,17793534.480000027,2018,8,10,CASH_IN,0.07,C372017580
11863,409000438620',2018-08-11,MAW/502964XXXXXX9461/Akol,0.0,900.0,17794434.480000027,2018,8,11,CASH_IN,900.0,C1023714065
11864,409000438620',2018-08-11,MAW/502964XXXXXX2374/Karu,0.0,1700.0,17796134.480000027,2018,8,11,CHECK_CASHING,1700.0,C71555810
11865,409000438620',2018-08-11,MAW/502964XXXXXX5745/Karu,0.0,1700.0,17797834.480000027,2018,8,11,CHECK_CASHING,1700.0,C846947180
11866,409000438620',2018-08-11,MAW/502964XXXXXX6499/Karu,0.0,1700.0,17799534.480000027,2018,8,11,CASH_IN,1700.0,C1426908073
11867,409000438620',2018-08-11,MAW/502964XXXXXX2291/Karu,0.0,1700.0,17801234.480000027,2018,8,11,CASH_IN,1700.0,C98102770
11868,409000438620',2018-08-11,MAW/502964XXXXXX5115/Karu,0.0,1700.0,17802934.480000027,2018,8,11,TRANSFER,1700.0,C423580937
11869,409000438620',2018-08-11,MAW/502964XXXXXX6531/Karu,0.0,1700.0,17804634.480000027,2018,8,11,CHECK_CASHING,1700.0,C1347890180
11870,409000438620',2018-08-11,MAW/502964XXXXXX2723/Karu,0.0,1700.0,17806334.480000027,2018,8,11,CASH_IN,1700.0,C345603257
11871,409000438620',2018-08-13,MAW/502964XXXXXX7634/Karu,0.0,1700.0,17808034.480000027,2018,8,13,CASH_IN,1700.0,C1036454560
11872,409000438620',2018-08-13,MAW/502964XXXXXX7973/Karu,0.0,1700.0,17809734.480000027,2018,8,13,CASH_IN,1700.0,M833638426
11873,409000438620',2018-08-13,MAW/502964XXXXXX0718/Karu,0.0,1600.0,17811334.480000027,2018,8,13,CASH_IN,1600.0,M273161335
11874,409000438620',2018-08-13,MAW/502964XXXXXX0385/Karu,0.0,1500.0,17812834.480000027,2018,8,13,TRANSFER,1500.0,M1220690588
11875,409000438620',2018-08-13,MAW/502964XXXXXX5466/Karu,0.0,1500.0,17814334.480000027,2018,8,13,CHECK_CASHING,1500.0,C349015546
11876,409000438620',2018-08-13,MAW/502964XXXXXX7313/Karu,0.0,1700.0,17816034.480000027,2018,8,13,CASH_IN,1700.0,C1429623854
11877,409000438620',2018-08-13,Indiaforensic AEPS NPCI WDL SET,0.0,17341500.0,35157534.48000003,2018,8,13,CASH_IN,17341500.0,C1869228744
11878,409000438620',2018-08-13,MAW/502964XXXXXX3929/Karu,0.0,1700.0,35159234.48000003,2018,8,13,CASH_IN,1700.0,C1726408169
11879,409000438620',2018-08-13,MAW/502964XXXXXX0388/Karu,0.0,1700.0,35160934.48000003,2018,8,13,TRANSFER,1700.0,C1311325237
11880,409000438620',2018-08-13,MAW/502964XXXXXX6763/Karu,0.0,1700.0,35162634.48000003,2018,8,13,TRANSFER,1700.0,C1406749291
11881,409000438620',2018-08-13,Indiaforensic AEPS NPCI WDL SET,0.0,14579700.0,49742334.48000003,2018,8,13,CASH_IN,14579700.0,C1313534832
11882,409000438620',2018-08-13,Indiaforensic AEPS NPCI WDL SET,0.0,8626000.0,58368334.48000003,2018,8,13,CHECK_CASHING,8626000.0,C466505482
11883,409000438620',2018-08-13,CR821310480091/RMCPL19769/0,1000.0,0.0,58367334.48000003,2018,8,13,PAYEMENT,1000.0,C1916720513
11884,409000438620',2018-08-13,CR821310476743/RMCPL23207/0,3400.0,0.0,58363934.48000003,2018,8,13,CHECK_WITHDRAWAL,3400.0,C1260434481
11885,409000438620',2018-08-13,CR821310476796/RMCPL25390/0,1000.0,0.0,58362934.48000003,2018,8,13,DEBIT,1000.0,C1530856786
11886,409000438620',2018-08-13,CR821310481668/RMCPL11793/0,5000.0,0.0,58357934.48000003,2018,8,13,CASH_OUT,5000.0,C232812328
11887,409000438620',2018-08-13,CR821310482145/RMCPL25809/0,1000.0,0.0,58356934.48000003,2018,8,13,DEBIT,1000.0,C1389405694
11888,409000438620',2018-08-13,CR821310482060/RMCPL15559/0,900.0,0.0,58356034.48000003,2018,8,13,CHECK_WITHDRAWAL,900.0,M257866956
11889,409000438620',2018-08-13,CR821310481791/RMCPL16659/0,1000.0,0.0,58355034.48000003,2018,8,13,PAYEMENT,1000.0,M1990762490
11890,409000438620',2018-08-13,CR821310481689/RMCPL25729/0,3000.0,0.0,58352034.48000003,2018,8,13,DEBIT,3000.0,M1992744664
11891,409000438620',2018-08-13,CR821312511477/RMCPL22235/0,2000.0,0.0,58350034.48000003,2018,8,13,CHECK_WITHDRAWAL,2000.0,C1595278145
11892,409000438620',2018-08-13,CR821309456931/RMCPL20620/0,1000.0,0.0,58349034.48000003,2018,8,13,PAYEMENT,1000.0,M51581349
11893,409000438620',2018-08-13,CR821310474527/RMCPL02810/0,1000.0,0.0,58348034.48000003,2018,8,13,CHECK_WITHDRAWAL,1000.0,M1444979520
11894,409000438620',2018-08-13,CR821310474533/RMCPL15438/0,5000.0,0.0,58343034.48000003,2018,8,13,DEBIT,5000.0,M1111792139
11895,409000438620',2018-08-13,CR821310474542/RMCPL24866/0,2000.0,0.0,58341034.48000003,2018,8,13,PAYEMENT,2000.0,M1265415318
11896,409000438620',2018-08-13,CR821312516490/RMCPL23268/0,4900.0,0.0,58336134.48000003,2018,8,13,CASH_OUT,4900.0,M2100974250
11897,409000438620',2018-08-13,CR821309463804/RMCPL22867/0,1000.0,0.0,58335134.48000003,2018,8,13,DEBIT,1000.0,C787028959
11898,409000438620',2018-08-13,CR821309463807/RMCPL14382/0,2000.0,0.0,58333134.48000003,2018,8,13,CASH_OUT,2000.0,C1248712846
11899,409000438620',2018-08-13,CR821311494351/RMCPL18547/0,4000.0,0.0,58329134.48000003,2018,8,13,CHECK_WITHDRAWAL,4000.0,M372304371
11900,409000438620',2018-08-13,CR821316573894/RMCPL24425/0,2000.0,0.0,58327134.48000003,2018,8,13,DEBIT,2000.0,M241573605
11901,409000438620',2018-08-13,CR821317593082/RMCPL12121/0,1000.0,0.0,58326134.48000003,2018,8,13,CHECK_WITHDRAWAL,1000.0,M613976003
11902,409000438620',2018-08-13,CR821417863056/RMCPL16622/0,2000.0,0.0,58324134.48000003,2018,8,13,CASH_OUT,2000.0,M807019219
11903,409000438620',2018-08-13,CR821411780146/RMCPL22397/0,10000.0,0.0,58314134.48000003,2018,8,13,DEBIT,10000.0,M1364522278
11904,409000438620',2018-08-13,CR821415832923/RMCPL22499/0,2500.0,0.0,58311634.48000003,2018,8,13,DEBIT,2500.0,M302542971
11905,409000438620',2018-08-13,CR821415832935/RMCPL25229/0,1000.0,0.0,58310634.48000003,2018,8,13,DEBIT,1000.0,M1139054118
11906,409000438620',2018-08-13,CR821410760028/RMCPL20987/0,10000.0,0.0,58300634.48000003,2018,8,13,PAYEMENT,10000.0,M1329963164
11907,409000438620',2018-08-13,CR821409738106/RMCPL23810/0,500.0,0.0,58300134.48000003,2018,8,13,PAYEMENT,500.0,M1620254208
11908,409000438620',2018-08-13,CR821418882744/RMCPL19779/0,4000.0,0.0,58296134.48000003,2018,8,13,CASH_OUT,4000.0,M1623849199
11909,409000438620',2018-08-13,CR821410760021/RMCPL24710/0,1500.0,0.0,58294634.48000003,2018,8,13,DEBIT,1500.0,M277873616
11910,409000438620',2018-08-13,CR821408722985/RMCPL19942/0,800.0,0.0,58293834.48000003,2018,8,13,PAYEMENT,800.0,C1247658278
11911,409000438620',2018-08-13,CR821419909370/RMCPL23880/0,2000.0,0.0,58291834.48000003,2018,8,13,PAYEMENT,2000.0,C219913687
11912,409000438620',2018-08-13,CR821412786895/RMCPL15696/0,1000.0,0.0,58290834.48000003,2018,8,13,DEBIT,1000.0,C211528162
11913,409000438620',2018-08-13,CR821410760016/RMCPL15388/0,1000.0,0.0,58289834.48000003,2018,8,13,PAYEMENT,1000.0,C1533182537
11914,409000438620',2018-08-13,CR821413805629/RMCPL22628/0,2000.0,0.0,58287834.48000003,2018,8,13,DEBIT,2000.0,C515132998
11915,409000438620',2018-08-13,CR821413805632/RMCPL15794/0,1000.0,0.0,58286834.48000003,2018,8,13,DEBIT,1000.0,C1566246889
11916,409000438620',2018-08-13,CR821412799046/RMCPL17234/0,500.0,0.0,58286334.48000003,2018,8,13,PAYEMENT,500.0,C1549086472
11917,409000438620',2018-08-13,CR821412786891/RMCPL19899/0,500.0,0.0,58285834.48000003,2018,8,13,DEBIT,500.0,C1076835071
11918,409000438620',2018-08-13,CR821416845346/RMCPL28105/0,3000.0,0.0,58282834.48000003,2018,8,13,PAYEMENT,3000.0,C199582547
11919,409000438620',2018-08-13,CR821419914338/RMCPL07093/0,500.0,0.0,58282334.48000003,2018,8,13,DEBIT,500.0,C667504652
11920,409000438620',2018-08-13,CR821415838737/RMCPL18312/0,1200.0,0.0,58281134.48000003,2018,8,13,PAYEMENT,1200.0,C1396297158
11921,409000438620',2018-08-13,CR821510002626/RMCPL21455/0,1000.0,0.0,58280134.48000003,2018,8,13,CHECK_WITHDRAWAL,1000.0,C304528024
11922,409000438620',2018-08-13,CR821515087154/RMCPL22133/0,8000.0,0.0,58272134.48000003,2018,8,13,CASH_OUT,8000.0,C1049804269
11923,409000438620',2018-08-13,CR821515087156/RMCPL15326/0,2000.0,0.0,58270134.48000003,2018,8,13,CHECK_WITHDRAWAL,2000.0,C309167705
11924,409000438620',2018-08-13,CR821512035153/RMCPL14126/0,10000.0,0.0,58260134.48000003,2018,8,13,PAYEMENT,10000.0,C667346055
11925,409000438620',2018-08-13,CR821514068387/RMCPL24066/0,10000.0,0.0,58250134.48000003,2018,8,13,CASH_OUT,10000.0,C310737318
11926,409000438620',2018-08-13,CR821516096498/RMCPL23378/0,2000.0,0.0,58248134.48000003,2018,8,13,CHECK_WITHDRAWAL,2000.0,C1339257929
11927,409000438620',2018-08-13,CR821513054924/RMCPL07093/0,2000.0,0.0,58246134.48000003,2018,8,13,PAYEMENT,2000.0,C1034584766
11928,409000438620',2018-08-13,CR821513054922/RMCPL11613/0,1500.0,0.0,58244634.48000003,2018,8,13,DEBIT,1500.0,C755583709
11929,409000438620',2018-08-13,CR821510001664/RMCPL25366/0,2000.0,0.0,58242634.48000003,2018,8,13,DEBIT,2000.0,C1327282178
11930,409000438620',2018-08-13,CR821510003474/RMCPL21354/0,500.0,0.0,58242134.48000003,2018,8,13,CASH_OUT,500.0,C1846530780
11931,409000438620',2018-08-13,CR821511016141/RMCPL18859/0,10000.0,0.0,58232134.48000003,2018,8,13,CASH_OUT,10000.0,C1508631684
11932,409000438620',2018-08-13,CR821516097248/RMCPL21455/0,2000.0,0.0,58230134.48000003,2018,8,13,DEBIT,2000.0,C1558550579
11933,409000438620',2018-08-13,CR821517108841/RMCPL15602/0,500.0,0.0,58229634.48000003,2018,8,13,CHECK_WITHDRAWAL,500.0,C1816986148
11934,409000438620',2018-08-13,CR821510015182/RMCPL19108/0,500.0,0.0,58229134.48000003,2018,8,13,CHECK_WITHDRAWAL,500.0,C1233454027
11935,409000438620',2018-08-13,CR821917029973/RMCPL18303/0,1000.0,0.0,58228134.48000003,2018,8,13,CASH_OUT,1000.0,C2011996123
11936,409000438620',2018-08-13,CR821916012845/RMCPL21454/0,5000.0,0.0,58223134.48000003,2018,8,13,DEBIT,5000.0,C2113508588
11937,409000438620',2018-08-13,CR821917024565/RMCPL08225/0,4000.0,0.0,58219134.48000003,2018,8,13,CHECK_WITHDRAWAL,4000.0,C1028574311
11938,409000438620',2018-08-13,CR821916009021/RMCPL20404/0,1000.0,0.0,58218134.48000003,2018,8,13,CASH_OUT,1000.0,C968448640
11939,409000438620',2018-08-13,CR821916009025/RMCPL10073/0,1800.0,0.0,58216334.48000003,2018,8,13,PAYEMENT,1800.0,C1641169735
11940,409000438620',2018-08-13,CR821916009022/RMCPL22133/0,2000.0,0.0,58214334.48000003,2018,8,13,CHECK_WITHDRAWAL,2000.0,C170899621
11941,409000438620',2018-08-13,CR821812714768/RMCPL20871/0,1000.0,0.0,58213334.48000003,2018,8,13,DEBIT,1000.0,C1282745381
11942,409000438620',2018-08-13,CR821910931765/RMCPL24605/0,2500.0,0.0,58210834.48000003,2018,8,13,CHECK_WITHDRAWAL,2500.0,C1412095226
11943,409000438620',2018-08-13,CR821911949429/RMCPL18380/0,500.0,0.0,58210334.48000003,2018,8,13,CHECK_WITHDRAWAL,500.0,C1601071362
11944,409000438620',2018-08-13,CR821910931807/RMCPL00216/0,1000.0,0.0,58209334.48000003,2018,8,13,CASH_OUT,1000.0,C2040603986
11945,409000438620',2018-08-13,CR821518121626/RMCPL16774/0,2000.0,0.0,58207334.48000003,2018,8,13,PAYEMENT,2000.0,C1825174365
11946,409000438620',2018-08-13,CR821517108863/RMCPL18538/0,4000.0,0.0,58203334.48000003,2018,8,13,CHECK_WITHDRAWAL,4000.0,C1746150957
11947,409000438620',2018-08-13,CR821516103298/RMCPL18536/0,500.0,0.0,58202834.48000003,2018,8,13,CASH_OUT,500.0,C656977363
11948,409000438620',2018-08-13,CR821518121634/RMCPL24066/0,500.0,0.0,58202334.48000003,2018,8,13,DEBIT,500.0,C1171931309
11949,409000438620',2018-08-13,CR821710455734/RMCPL05050/0,1000.0,0.0,58201334.48000003,2018,8,13,PAYEMENT,1000.0,C1941598182
11950,409000438620',2018-08-13,CR821610252852/RMCPL23688/0,10000.0,0.0,58191334.48000003,2018,8,13,CASH_OUT,10000.0,C665576141
11951,409000438620',2018-08-13,CR821616322349/RMCPL20628/0,2000.0,0.0,58189334.48000003,2018,8,13,CHECK_WITHDRAWAL,2000.0,C264843581
11952,409000438620',2018-08-13,CR821610252840/RMCPL10073/0,1800.0,0.0,58187534.48000003,2018,8,13,DEBIT,1800.0,C248609774
11953,409000438620',2018-08-13,CR821617327305/RMCPL05050/0,1000.0,0.0,58186534.48000003,2018,8,13,CHECK_WITHDRAWAL,1000.0,C1095587424
11954,409000438620',2018-08-13,CR821616322353/RMCPL20001/0,2300.0,0.0,58184234.48000003,2018,8,13,DEBIT,2300.0,C1084435493
11955,409000438620',2018-08-13,CR821611258999/RMCPL25029/0,3000.0,0.0,58181234.48000003,2018,8,13,PAYEMENT,3000.0,C755583709
11956,409000438620',2018-08-13,CR821610239561/RMCPL15535/0,2000.0,0.0,58179234.48000003,2018,8,13,CASH_OUT,2000.0,C1527761090
11957,409000438620',2018-08-13,CR821610239559/RMCPL22976/0,2000.0,0.0,58177234.48000003,2018,8,13,CHECK_WITHDRAWAL,2000.0,C1595278145
11958,409000438620',2018-08-13,CR821611271770/RMCPL23513/0,1000.0,0.0,58176234.48000003,2018,8,13,DEBIT,1000.0,C1196694338
11959,409000438620',2018-08-13,CR821613298060/RMCPL26557/0,500.0,0.0,58175734.48000003,2018,8,13,DEBIT,500.0,C1556875182
11960,409000438620',2018-08-13,CR821818802319/RMCPL15326/0,1500.0,0.0,58174234.48000003,2018,8,13,DEBIT,1500.0,C1315729466
11961,409000438620',2018-08-13,CR821809666818/RMCPL14884/0,500.0,0.0,58173734.48000003,2018,8,13,DEBIT,500.0,C456305354
11962,409000438620',2018-08-13,CR821813735030/RMCPL07629/0,500.0,0.0,58173234.48000003,2018,8,13,DEBIT,500.0,C875917495
11963,409000438620',2018-08-13,CR821814749289/RMCPL11131/0,500.0,0.0,58172734.48000003,2018,8,13,DEBIT,500.0,C142211154
11964,409000438620',2018-08-13,CR821814749276/RMCPL15879/0,500.0,0.0,58172234.48000003,2018,8,13,CHECK_WITHDRAWAL,500.0,C804836251
11965,409000438620',2018-08-13,CR821811697526/RMCPL20136/0,800.0,0.0,58171434.48000003,2018,8,13,PAYEMENT,800.0,C928023753
11966,409000438620',2018-08-13,CR821816781041/RMCPL27951/0,2000.0,0.0,58169434.48000003,2018,8,13,CASH_OUT,2000.0,C1682264452
11967,409000438620',2018-08-13,CR821816781021/RMCPL08171/0,700.0,0.0,58168734.48000003,2018,8,13,CHECK_WITHDRAWAL,700.0,M1760562576
11968,409000438620',2018-08-13,CR821911942153/RMCPL15388/0,1000.0,0.0,58167734.48000003,2018,8,13,CHECK_WITHDRAWAL,1000.0,M621131632
11969,409000438620',2018-08-13,CR821910933655/RMCPL22284/0,1000.0,0.0,58166734.48000003,2018,8,13,PAYEMENT,1000.0,C1210315704
11970,409000438620',2018-08-13,CR821914988746/RMCPL12343/0,6000.0,0.0,58160734.48000003,2018,8,13,CASH_OUT,6000.0,M1175343296
11971,409000438620',2018-08-13,CR821910927437/RMCPL19418/0,1500.0,0.0,58159234.48000003,2018,8,13,CASH_OUT,1500.0,C790722099
11972,409000438620',2018-08-13,CR821913977913/RMCPL12796/0,1000.0,0.0,58158234.48000003,2018,8,13,PAYEMENT,1000.0,C1894575391
11973,409000438620',2018-08-13,CR821913977915/RMCPL27447/0,500.0,0.0,58157734.48000003,2018,8,13,PAYEMENT,500.0,C1964390106
11974,409000438620',2018-08-13,CR821912957636/RMCPL02151/0,500.0,0.0,58157234.48000003,2018,8,13,CASH_OUT,500.0,M984850994
11975,409000438620',2018-08-13,CR821914988764/RMCPL20182/0,2000.0,0.0,58155234.48000003,2018,8,13,PAYEMENT,2000.0,M1486946639
11976,409000438620',2018-08-13,CR821618340924/RMCPL01394/0,500.0,0.0,58154734.48000003,2018,8,13,CHECK_WITHDRAWAL,500.0,M107642469
11977,409000438620',2018-08-13,CR821814752787/RMCPL00791/0,700.0,0.0,58154034.48000003,2018,8,13,PAYEMENT,700.0,M988940284
11978,409000438620',2018-08-13,CR821814749247/RMCPL26549/0,500.0,0.0,58153534.48000003,2018,8,13,CASH_OUT,500.0,M836588769
11979,409000438620',2018-08-13,CR821913968354/RMCPL16879/0,2000.0,0.0,58151534.48000003,2018,8,13,PAYEMENT,2000.0,M1062418412
11980,409000438620',2018-08-13,CR821911937853/RMCPL19554/0,1000.0,0.0,58150534.48000003,2018,8,13,DEBIT,1000.0,M204550286
11981,409000438620',2018-08-13,CR821913969426/RMCPL24053/0,2500.0,0.0,58148034.48000003,2018,8,13,CASH_OUT,2500.0,M528532700
11982,409000438620',2018-08-13,CR822018290487/RMCPL15429/0,800.0,0.0,58147234.48000003,2018,8,13,DEBIT,800.0,C1888439681
11983,409000438620',2018-08-13,CR822015252635/RMCPL17788/0,500.0,0.0,58146734.48000003,2018,8,13,PAYEMENT,500.0,M670285911
11984,409000438620',2018-08-13,CR822009144722/RMCPL27311/0,1000.0,0.0,58145734.48000003,2018,8,13,DEBIT,1000.0,C69736093
11985,409000438620',2018-08-13,CR822011196797/RMCPL23084/0,10000.0,0.0,58135734.48000003,2018,8,13,PAYEMENT,10000.0,M1008252046
11986,409000438620',2018-08-13,CR822014243835/RMCPL24591/0,3500.0,0.0,58132234.48000003,2018,8,13,PAYEMENT,3500.0,C1530856786
11987,409000438620',2018-08-13,CR822016260521/RMCPL15717/0,5000.0,0.0,58127234.48000003,2018,8,13,CASH_OUT,5000.0,M530826487
11988,409000438620',2018-08-13,CR822009144741/RMCPL16439/0,2000.0,0.0,58125234.48000003,2018,8,13,CHECK_WITHDRAWAL,2000.0,M1650657437
11989,409000438620',2018-08-13,CR822011184660/RMCPL12864/0,1100.0,0.0,58124134.48000003,2018,8,13,CASH_OUT,1100.0,C919331070
11990,409000438620',2018-08-13,CR822012211927/RMCPL16282/0,1000.0,0.0,58123134.48000003,2018,8,13,CASH_OUT,1000.0,M2042795873
11991,409000438620',2018-08-13,CR822012222780/RMCPL23472/0,10000.0,0.0,58113134.48000003,2018,8,13,DEBIT,10000.0,M1751076887
11992,409000438620',2018-08-13,CR822011180750/RMCPL19869/0,600.0,0.0,58112534.48000003,2018,8,13,PAYEMENT,600.0,M1078945374
11993,409000438620',2018-08-13,CR822011192709/RMCPL26747/0,600.0,0.0,58111934.48000003,2018,8,13,PAYEMENT,600.0,M723343305
11994,409000438620',2018-08-13,CR822012217426/RMCPL18017/0,1000.0,0.0,58110934.48000003,2018,8,13,DEBIT,1000.0,C1031639563
11995,409000438620',2018-08-13,CR822012217407/RMCPL22967/0,4000.0,0.0,58106934.48000003,2018,8,13,CHECK_WITHDRAWAL,4000.0,M1527480279
11996,409000438620',2018-08-13,CR822010166166/RMCPL14380/0,1000.0,0.0,58105934.48000003,2018,8,13,DEBIT,1000.0,M993274701
11997,409000438620',2018-08-13,CR822011197625/RMCPL23207/0,600.0,0.0,58105334.48000003,2018,8,13,DEBIT,600.0,M382867004
11998,409000438620',2018-08-13,CR822013233320/RMCPL22628/0,2000.0,0.0,58103334.48000003,2018,8,13,CHECK_WITHDRAWAL,2000.0,M1490600709
11999,409000438620',2018-08-13,CR822011194168/RMCPL21556/0,1000.0,0.0,58102334.48000003,2018,8,13,DEBIT,1000.0,C861958315
12000,409000438620',2018-08-13,CR822011194066/RMCPL25136/0,1000.0,0.0,58101334.48000003,2018,8,13,DEBIT,1000.0,C968448640
12001,409000438620',2018-08-13,CR822011184573/RMCPL00857/0,10000.0,0.0,58091334.48000003,2018,8,13,CHECK_WITHDRAWAL,10000.0,C161140376
12002,409000438620',2018-08-13,CR822011194124/RMCPL10943/0,1600.0,0.0,58089734.48000003,2018,8,13,PAYEMENT,1600.0,C391903689
12003,409000438620',2018-08-13,CR822017275969/RMCPL24294/0,2000.0,0.0,58087734.48000003,2018,8,13,DEBIT,2000.0,C1935506329
12004,409000438620',2018-08-13,CR822011196135/RMCPL16221/0,8000.0,0.0,58079734.48000003,2018,8,13,PAYEMENT,8000.0,C248609774
12005,409000438620',2018-08-13,CR822014239139/RMCPL15998/0,500.0,0.0,58079234.48000003,2018,8,13,CASH_OUT,500.0,C957388291
12006,409000438620',2018-08-13,CR822012207266/RMCPL17436/0,3000.0,0.0,58076234.48000003,2018,8,13,DEBIT,3000.0,C1565987193
12007,409000438620',2018-08-13,CR822012211917/RMCPL27399/0,500.0,0.0,58075734.48000003,2018,8,13,PAYEMENT,500.0,C35126588
12008,409000438620',2018-08-13,TRF TO  Indiaforensic SERVICES I,10000000.0,0.0,48075734.48000003,2018,8,13,DEBIT,10000000.0,C2086425573
12009,409000438620',2018-08-13,TRF TO  Indiaforensic SERVICES I,10000000.0,0.0,38075734.48000003,2018,8,13,DEBIT,10000000.0,C863811613
12010,409000438620',2018-08-13,TRF TO  Indiaforensic SERVICES I,5000000.0,0.0,33075734.48000003,2018,8,13,DEBIT,5000000.0,C205091536
12011,409000438620',2018-08-13,TRF TO  Indiaforensic SERVICES I,15000000.0,0.0,18075734.480000027,2018,8,13,DEBIT,15000000.0,C1315729466
12012,409000438620',2018-08-13,MAW/502964XXXXXX2205/Karu,0.0,1700.0,18077434.480000027,2018,8,13,TRANSFER,1700.0,C1203172736
12013,409000438620',2018-08-13,MAW/502964XXXXXX8671/Karu,0.0,800.0,18078234.480000027,2018,8,13,TRANSFER,800.0,C221632586
12014,409000438620',2018-08-13,CB821411780133/RMCPL24646/0,1000.0,0.0,18077234.480000027,2018,8,13,DEBIT,1000.0,M1639463197
12015,409000438620',2018-08-13,CB821712484614/RMCPL15602/0,500.0,0.0,18076734.480000027,2018,8,13,PAYEMENT,500.0,M920696073
12016,409000438620',2018-08-13,AEPS INCOME DT 10-08-2018,0.0,43897.82,18120632.300000027,2018,8,13,CHECK_CASHING,43897.82,M433438422
12017,409000438620',2018-08-13,AEPS GST INC DT 10-08-201,0.0,8779.56,18129411.860000025,2018,8,13,TRANSFER,8779.56,M998235897
12018,409000438620',2018-08-13,AEPS INCOME DT 11-08-2018,0.0,37338.6,18166750.460000027,2018,8,13,TRANSFER,37338.6,M507346425
12019,409000438620',2018-08-13,AEPS GST INC DT 11-08-201,0.0,7467.72,18174218.180000026,2018,8,13,TRANSFER,7467.72,M1888432358
12020,409000438620',2018-08-13,AEPS INCOME DT 12-08-2018,0.0,22804.51,18197022.690000027,2018,8,13,CASH_IN,22804.51,C579634511
12021,409000438620',2018-08-13,AEPS GST INC DT 12-08-201,0.0,4560.9,18201583.590000026,2018,8,13,CASH_IN,4560.9,M1568019471
12022,409000438620',2018-08-13,AEPS ACQUIRING ADJ FEES 1,17.7,0.0,18201565.890000027,2018,8,13,CASH_OUT,17.7,M1852330693
12023,409000438620',2018-08-13,AEPS ACQ CR ADJ FEES 1008,1184.66,0.0,18200381.230000027,2018,8,13,CASH_OUT,1184.66,M2006436502
12024,409000438620',2018-08-14,MAW/502964XXXXXX6046/Karu,0.0,1800.0,18202181.230000027,2018,8,14,TRANSFER,1800.0,M937701845
12025,409000438620',2018-08-14,MAW/502964XXXXXX5059/Karu,0.0,1800.0,18203981.230000027,2018,8,14,CASH_IN,1800.0,C8290162
12026,409000438620',2018-08-14,MAW/502964XXXXXX8295/Karu,0.0,1700.0,18205681.230000027,2018,8,14,CHECK_CASHING,1700.0,C1515979807
12027,409000438620',2018-08-14,MAW/502964XXXXXX4672/Karu,0.0,1800.0,18207481.230000027,2018,8,14,CHECK_CASHING,1800.0,C1305830291
12028,409000438620',2018-08-14,MAW/502964XXXXXX4046/Karu,0.0,1800.0,18209281.230000027,2018,8,14,TRANSFER,1800.0,M316163617
12029,409000438620',2018-08-14,MAW/502964XXXXXX7166/Karu,0.0,1700.0,18210981.230000027,2018,8,14,CHECK_CASHING,1700.0,M2115587464
12030,409000438620',2018-08-14,Indiaforensic AEPS NPCI WDL SET,0.0,15837200.0,34048181.23000003,2018,8,14,CHECK_CASHING,15837200.0,C2006081398
12031,409000438620',2018-08-14,MAW/502964XXXXXX7567/Karu,0.0,3500.0,34051681.23000003,2018,8,14,TRANSFER,3500.0,M229088529
12032,409000438620',2018-08-14,MAW/502964XXXXXX7641/Karu,0.0,4000.0,34055681.23000003,2018,8,14,CASH_IN,4000.0,M835472955
12033,409000438620',2018-08-14,MAW/502964XXXXXX9119/Karu,0.0,1700.0,34057381.23000003,2018,8,14,CHECK_CASHING,1700.0,M366310941
12034,409000438620',2018-08-14,TRF TO  Indiaforensic SERVICES I,15000000.0,0.0,19057381.230000027,2018,8,14,CHECK_WITHDRAWAL,15000000.0,M1215492013
12035,409000438620',2018-08-14,TRF TO  Indiaforensic SERVICES I,1300000.0,0.0,17757381.230000027,2018,8,14,CHECK_WITHDRAWAL,1300000.0,M188464216
12036,409000438620',2018-08-14,AEPS INCOME DT 13-08-2018,0.0,40268.85,17797650.080000028,2018,8,14,TRANSFER,40268.85,M691098469
12037,409000438620',2018-08-14,AEPS GST INC DT 13-08-201,0.0,8053.77,17805703.850000028,2018,8,14,TRANSFER,8053.77,M1214407332
12038,409000438620',2018-08-14,AEPS ACQUIRING ADJ FEES 1,29.5,0.0,17805674.350000028,2018,8,14,CHECK_WITHDRAWAL,29.5,M324942962
12039,409000438620',2018-08-16,MAW/502964XXXXXX3725/Karu,0.0,1500.0,17807174.350000028,2018,8,16,TRANSFER,1500.0,M953017586
12040,409000438620',2018-08-16,MAW/502964XXXXXX0369/Karu,0.0,1500.0,17808674.350000028,2018,8,16,TRANSFER,1500.0,M1427223409
12041,409000438620',2018-08-16,MAW/502964XXXXXX9647/Karu,0.0,1500.0,17810174.350000028,2018,8,16,CASH_IN,1500.0,M1875621806
12042,409000438620',2018-08-16,MAW/502964XXXXXX2333/Karu,0.0,1700.0,17811874.350000028,2018,8,16,TRANSFER,1700.0,M1966601843
12043,409000438620',2018-08-16,Indiaforensic AEPS NPCI WDL SET,0.0,15454900.0,33266774.35000003,2018,8,16,CHECK_CASHING,15454900.0,M1316867843
12044,409000438620',2018-08-16,Indiaforensic AEPS NPCI WDL SET,0.0,8543600.0,41810374.35000002,2018,8,16,CASH_IN,8543600.0,M54869535
12045,409000438620',2018-08-16,CR822113472358/RMCPL25339/0,1000.0,0.0,41809374.35000002,2018,8,16,CHECK_WITHDRAWAL,1000.0,M341955919
12046,409000438620',2018-08-16,CR822113472368/RMCPL10452/0,500.0,0.0,41808874.35000002,2018,8,16,CHECK_WITHDRAWAL,500.0,M688587550
12047,409000438620',2018-08-16,CR822108389493/RMCPL14522/0,2000.0,0.0,41806874.35000002,2018,8,16,PAYEMENT,2000.0,M654455405
12048,409000438620',2018-08-16,CR822108396086/RMCPL15763/0,3000.0,0.0,41803874.35000002,2018,8,16,DEBIT,3000.0,M1985056619
12049,409000438620',2018-08-16,CR822113478231/RMCPL25450/0,600.0,0.0,41803274.35000002,2018,8,16,DEBIT,600.0,M1738236287
12050,409000438620',2018-08-16,CR822111439561/RMCPL14522/0,2000.0,0.0,41801274.35000002,2018,8,16,CASH_OUT,2000.0,M18819142
12051,409000438620',2018-08-16,CR822116508396/RMCPL20589/0,600.0,0.0,41800674.35000002,2018,8,16,CHECK_WITHDRAWAL,600.0,M154685462
12052,409000438620',2018-08-16,CR822117523315/RMCPL26038/0,800.0,0.0,41799874.35000002,2018,8,16,PAYEMENT,800.0,M1946405930
12053,409000438620',2018-08-16,CR822111445057/RMCPL11764/0,4000.0,0.0,41795874.35000002,2018,8,16,DEBIT,4000.0,M680109998
12054,409000438620',2018-08-16,CR822108396076/RMCPL25520/0,5000.0,0.0,41790874.35000002,2018,8,16,PAYEMENT,5000.0,C428796726
12055,409000438620',2018-08-16,CR822115494737/RMCPL22148/0,500.0,0.0,41790374.35000002,2018,8,16,CASH_OUT,500.0,M1309638748
12056,409000438620',2018-08-16,CR822113478232/RMCPL26217/0,10000.0,0.0,41780374.35000002,2018,8,16,CASH_OUT,10000.0,C1520941958
12057,409000438620',2018-08-16,CR822115494743/RMCPL19766/0,800.0,0.0,41779574.35000002,2018,8,16,DEBIT,800.0,M111020311
12058,409000438620',2018-08-16,CR822115494758/RMCPL16622/0,3100.0,0.0,41776474.35000002,2018,8,16,PAYEMENT,3100.0,M1760862530
12059,409000438620',2018-08-16,CR822115499210/RMCPL09583/0,4000.0,0.0,41772474.35000002,2018,8,16,CHECK_WITHDRAWAL,4000.0,C1121453612
12060,409000438620',2018-08-16,CR822116508442/RMCPL24977/0,5000.0,0.0,41767474.35000002,2018,8,16,CASH_OUT,5000.0,M202632707
12061,409000438620',2018-08-16,TRF TO  Indiaforensic SERVICES I,2000000.0,0.0,39767474.35000002,2018,8,16,CASH_OUT,2000000.0,M1436014246
12062,409000438620',2018-08-16,TRF TO  Indiaforensic SERVICES I,10000000.0,0.0,29767474.350000024,2018,8,16,CASH_OUT,10000000.0,M662519504
12063,409000438620',2018-08-16,TRF TO  Indiaforensic SERVICES I,10000000.0,0.0,19767474.350000024,2018,8,16,CHECK_WITHDRAWAL,10000000.0,M148070734
12064,409000438620',2018-08-16,MAW/502964XXXXXX8802/Karu,0.0,1700.0,19769174.350000024,2018,8,16,CHECK_CASHING,1700.0,M531608238
12065,409000438620',2018-08-16,MAW/502964XXXXXX8279/Karu,0.0,1700.0,19770874.350000024,2018,8,16,CASH_IN,1700.0,M973241361
12066,409000438620',2018-08-16,MAW/502964XXXXXX8329/Karu,0.0,1700.0,19772574.350000024,2018,8,16,CHECK_CASHING,1700.0,M1574626501
12067,409000438620',2018-08-16,MAW/502964XXXXXX6141/Karu,0.0,1700.0,19774274.350000024,2018,8,16,CHECK_CASHING,1700.0,M415118795
12068,409000438620',2018-08-16,MAW/502964XXXXXX1592/Cudd,0.0,500.0,19774774.350000024,2018,8,16,TRANSFER,500.0,M1035963174
12069,409000438620',2018-08-16,MAW/502964XXXXXX6701/Karu,0.0,1800.0,19776574.350000024,2018,8,16,CASH_IN,1800.0,M1283693885
12070,409000438620',2018-08-16,AEPS INCOME DT 14-08-2018,0.0,39041.03,19815615.380000025,2018,8,16,CHECK_CASHING,39041.03,M2012833184
12071,409000438620',2018-08-16,AEPS GST INC DT 14-08-201,0.0,7808.21,19823423.590000026,2018,8,16,TRANSFER,7808.21,M1441430349
12072,409000438620',2018-08-16,AEPS INCOME DT 15-08-2018,0.0,21938.81,19845362.400000025,2018,8,16,CHECK_CASHING,21938.81,M778859789
12073,409000438620',2018-08-16,AEPS GST INC DT 15-08-201,0.0,4387.76,19849750.160000026,2018,8,16,TRANSFER,4387.76,M774451134
12074,409000438620',2018-08-16,AEPS ACQUIRING ADJ FEES 1,20.65,0.0,19849729.510000028,2018,8,16,CASH_OUT,20.65,M1461995168
12075,409000438620',2018-08-16,AEPS ACQ CR ADJ FEES 1408,175.82,0.0,19849553.690000027,2018,8,16,CASH_OUT,175.82,M1612125747
12076,409000438620',2018-08-16,AEPS ACQ REP ADJ FEES 140,0.0,17.7,19849571.390000027,2018,8,16,CASH_IN,17.7,M1674522963
12077,409000438620',2018-08-16,MAW/502964XXXXXX2088/NAGA,0.0,700.0,19850271.390000027,2018,8,16,CASH_IN,700.0,M417036696
12078,409000438620',2018-08-16,TRF TO  Indiaforensic SERVICES I,1000000.0,0.0,18850271.390000027,2018,8,16,DEBIT,1000000.0,C1247600089
12079,409000438620',2018-08-16,TRF TO  Indiaforensic SERVICES I,1000000.0,0.0,17850271.390000027,2018,8,16,DEBIT,1000000.0,M633848902
12080,409000438620',2018-08-16,MICRO ATM WDL FEE DATED 1,0.0,100.0,17850371.390000027,2018,8,16,TRANSFER,100.0,M1134092836
12081,409000438620',2018-08-16,MICRO ATM WDL FEE DATED 1,0.0,500.0,17850871.390000027,2018,8,16,CASH_IN,500.0,M417671240
12082,409000438620',2018-08-16,NFS MICRO ATM GST DATED 1,0.0,0.36,17850871.750000026,2018,8,16,TRANSFER,0.36,M1634770756
12083,409000438620',2018-08-16,NFS MICRO ATM INC DATED 1,0.0,0.07,17850871.820000026,2018,8,16,TRANSFER,0.07,M183201101
12084,409000438620',2018-08-16,NFS MICRO ATM GST DATED 1,0.0,1.8,17850873.620000027,2018,8,16,TRANSFER,1.8,M1681016045
12085,409000438620',2018-08-16,NFS MICRO ATM INC DATED 1,0.0,0.36,17850873.980000027,2018,8,16,TRANSFER,0.36,M1675737810
12086,409000438620',2018-08-17,MAW/502964XXXXXX8203/Karu,0.0,1700.0,17852573.980000027,2018,8,17,CASH_IN,1700.0,M2143081456
12087,409000438620',2018-08-17,MAW/502964XXXXXX1765/NAGA,0.0,400.0,17852973.980000027,2018,8,17,TRANSFER,400.0,M707360501
12088,409000438620',2018-08-17,MAW/502964XXXXXX7160/Karu,0.0,1700.0,17854673.980000027,2018,8,17,CHECK_CASHING,1700.0,M1164092473
12089,409000438620',2018-08-17,MAW/502964XXXXXX3507/Karu,0.0,1700.0,17856373.980000027,2018,8,17,CASH_IN,1700.0,C1476213591
12090,409000438620',2018-08-17,MAW/502964XXXXXX7286/Karu,0.0,1700.0,17858073.980000027,2018,8,17,CASH_IN,1700.0,M2039218223
12091,409000438620',2018-08-17,Indiaforensic AEPS NPCI WDL SET,0.0,14622300.0,32480373.98000003,2018,8,17,CASH_IN,14622300.0,M1657205958
12092,409000438620',2018-08-17,CB822510350607/RMCPL22469/1,1000.0,0.0,32479373.98000003,2018,8,17,DEBIT,1000.0,M728557194
12093,409000438620',2018-08-17,CB822513412053/RMCPL22133/1,3400.0,0.0,32475973.98000003,2018,8,17,PAYEMENT,3400.0,M773074354
12094,409000438620',2018-08-17,CB822516456061/RMCPL22038/1,600.0,0.0,32475373.98000003,2018,8,17,PAYEMENT,600.0,M270928973
12095,409000438620',2018-08-17,CB822511383884/RMCPL20827/1,2000.0,0.0,32473373.98000003,2018,8,17,PAYEMENT,2000.0,M1748006732
12096,409000438620',2018-08-17,CB822515443583/RMCPL20628/1,4000.0,0.0,32469373.98000003,2018,8,17,CHECK_WITHDRAWAL,4000.0,C683605346
12097,409000438620',2018-08-17,CB822515446244/RMCPL26809/1,500.0,0.0,32468873.98000003,2018,8,17,DEBIT,500.0,C1446521801
12098,409000438620',2018-08-17,CB822509342226/RMCPL21549/1,700.0,0.0,32468173.98000003,2018,8,17,CHECK_WITHDRAWAL,700.0,M980068735
12099,409000438620',2018-08-17,CB822512405900/RMCPL27013/1,10000.0,0.0,32458173.98000003,2018,8,17,DEBIT,10000.0,M1001193966
12100,409000438620',2018-08-17,CB822512391894/RMCPL19782/1,3000.0,0.0,32455173.98000003,2018,8,17,PAYEMENT,3000.0,M1552981325
12101,409000438620',2018-08-17,CB822511383950/RMCPL26747/1,1000.0,0.0,32454173.98000003,2018,8,17,DEBIT,1000.0,M1975425420
12102,409000438620',2018-08-17,CB822512391786/RMCPL22469/1,500.0,0.0,32453673.98000003,2018,8,17,PAYEMENT,500.0,M1767809935
12103,409000438620',2018-08-17,CB822513418056/RMCPL10677/1,500.0,0.0,32453173.98000003,2018,8,17,DEBIT,500.0,M877134882
12104,409000438620',2018-08-17,CB822515447805/RMCPL19298/1,2000.0,0.0,32451173.98000003,2018,8,17,PAYEMENT,2000.0,C444613285
12105,409000438620',2018-08-17,CB822511371870/RMCPL15382/1,1000.0,0.0,32450173.98000003,2018,8,17,CHECK_WITHDRAWAL,1000.0,M301409263
12106,409000438620',2018-08-17,CB822516467483/RMCPL23184/1,500.0,0.0,32449673.98000003,2018,8,17,CHECK_WITHDRAWAL,500.0,M666553887
12107,409000438620',2018-08-17,CB822512394146/RMCPL24427/1,1000.0,0.0,32448673.98000003,2018,8,17,CHECK_WITHDRAWAL,1000.0,M624071536
12108,409000438620',2018-08-17,CB822512405848/RMCPL18216/1,1200.0,0.0,32447473.98000003,2018,8,17,DEBIT,1200.0,M1664286781
12109,409000438620',2018-08-17,CB822512399903/RMCPL11814/1,1500.0,0.0,32445973.98000003,2018,8,17,PAYEMENT,1500.0,C395536383
12110,409000438620',2018-08-17,CB822510359049/RMCPL16119/1,3000.0,0.0,32442973.98000003,2018,8,17,DEBIT,3000.0,M459375635
12111,409000438620',2018-08-17,CB822512394080/RMCPL20722/1,5000.0,0.0,32437973.98000003,2018,8,17,DEBIT,5000.0,M731357691
12112,409000438620',2018-08-17,CB822512394141/RMCPL19441/1,1500.0,0.0,32436473.98000003,2018,8,17,CHECK_WITHDRAWAL,1500.0,M54416043
12113,409000438620',2018-08-17,CB822512394147/RMCPL14558/1,500.0,0.0,32435973.98000003,2018,8,17,CASH_OUT,500.0,C1300519073
12114,409000438620',2018-08-17,CB822515447523/RMCPL21533/1,6000.0,0.0,32429973.98000003,2018,8,17,CHECK_WITHDRAWAL,6000.0,C1518728219
12115,409000438620',2018-08-17,CB822510365473/RMCPL20874/1,4000.0,0.0,32425973.98000003,2018,8,17,CHECK_WITHDRAWAL,4000.0,M316182677
12116,409000438620',2018-08-17,CB822515444448/RMCPL24591/1,3000.0,0.0,32422973.98000003,2018,8,17,PAYEMENT,3000.0,M1931117501
12117,409000438620',2018-08-17,CB822517472729/RMCPL20482/1,2500.0,0.0,32420473.98000003,2018,8,17,CASH_OUT,2500.0,C1821075330
12118,409000438620',2018-08-17,CB822312942465/RMCPL20088/1,1000.0,0.0,32419473.98000003,2018,8,17,CHECK_WITHDRAWAL,1000.0,M1382254830
12119,409000438620',2018-08-17,CB822309894665/RMCPL18974/1,10000.0,0.0,32409473.98000003,2018,8,17,DEBIT,10000.0,C439917369
12120,409000438620',2018-08-17,CB822312942476/RMCPL11794/1,1000.0,0.0,32408473.98000003,2018,8,17,CASH_OUT,1000.0,C420398953
12121,409000438620',2018-08-17,CB822309894013/RMCPL11405/1,700.0,0.0,32407773.98000003,2018,8,17,PAYEMENT,700.0,C1121453612
12122,409000438620',2018-08-17,CB822311918510/RMCPL20937/1,500.0,0.0,32407273.98000003,2018,8,17,CHECK_WITHDRAWAL,500.0,C569675628
12123,409000438620',2018-08-17,CB822310908796/RMCPL25186/1,1700.0,0.0,32405573.98000003,2018,8,17,PAYEMENT,1700.0,C1453382929
12124,409000438620',2018-08-17,CB822313954638/RMCPL26215/1,1000.0,0.0,32404573.98000003,2018,8,17,DEBIT,1000.0,C1189861498
12125,409000438620',2018-08-17,CB822317009929/RMCPL13501/1,10000.0,0.0,32394573.98000003,2018,8,17,DEBIT,10000.0,C1934714849
12126,409000438620',2018-08-17,CB822212702779/RMCPL23821/1,1000.0,0.0,32393573.98000003,2018,8,17,CASH_OUT,1000.0,C392292416
12127,409000438620',2018-08-17,CB822215750398/RMCPL18216/1,2000.0,0.0,32391573.98000003,2018,8,17,CASH_OUT,2000.0,C1401721023
12128,409000438620',2018-08-17,CB822213722595/RMCPL20827/1,7000.0,0.0,32384573.98000003,2018,8,17,CHECK_WITHDRAWAL,7000.0,C611621587
12129,409000438620',2018-08-17,CB822213722612/RMCPL21336/1,1500.0,0.0,32383073.98000003,2018,8,17,CHECK_WITHDRAWAL,1500.0,C1916873789
12130,409000438620',2018-08-17,CB822217774856/RMCPL22130/1,4500.0,0.0,32378573.98000003,2018,8,17,CASH_OUT,4500.0,C1075238398
12131,409000438620',2018-08-17,CB822218797405/RMCPL19474/1,1000.0,0.0,32377573.98000003,2018,8,17,DEBIT,1000.0,C1354952534
12132,409000438620',2018-08-17,CB822208642955/RMCPL17405/1,10000.0,0.0,32367573.98000003,2018,8,17,PAYEMENT,10000.0,C1360767589
12133,409000438620',2018-08-17,CB822212701654/RMCPL26560/1,2000.0,0.0,32365573.98000003,2018,8,17,CHECK_WITHDRAWAL,2000.0,C1564931235
12134,409000438620',2018-08-17,CB822212701720/RMCPL09588/1,8000.0,0.0,32357573.98000003,2018,8,17,DEBIT,8000.0,C662736689
12135,409000438620',2018-08-17,CB822217769366/RMCPL18216/1,700.0,0.0,32356873.98000003,2018,8,17,DEBIT,700.0,C435161028
12136,409000438620',2018-08-17,CB822217769348/RMCPL17454/1,500.0,0.0,32356373.98000003,2018,8,17,DEBIT,500.0,C1027017168
12137,409000438620',2018-08-17,CB822213716841/RMCPL25243/1,4000.0,0.0,32352373.98000003,2018,8,17,CASH_OUT,4000.0,C374625527
12138,409000438620',2018-08-17,MAW/502964XXXXXX5674/Karu,0.0,1700.0,32354073.98000003,2018,8,17,TRANSFER,1700.0,C476800120
12139,409000438620',2018-08-17,AEPS INCOME DT 16-08-2018,0.0,37085.29,32391159.270000026,2018,8,17,CASH_IN,37085.29,C1373172466
12140,409000438620',2018-08-17,AEPS GST INC DT 16-08-201,0.0,7417.06,32398576.330000024,2018,8,17,CHECK_CASHING,7417.06,C483370168
12141,409000438620',2018-08-17,AEPS ACQUIRING ADJ FEES 1,5.9,0.0,32398570.430000026,2018,8,17,PAYEMENT,5.9,C1543005080
12142,409000438620',2018-08-17,AEPS ACQ CR ADJ FEES 1608,478.49,0.0,32398091.94000003,2018,8,17,CASH_OUT,478.49,C1281898359
12143,409000438620',2018-08-17,AEPS ACQ REP ADJ FEES 160,0.0,11.8,32398103.74000003,2018,8,17,CHECK_CASHING,11.8,C132058033
12144,409000438620',2018-08-17,TRF TO  Indiaforensic SERVICES I,14600000.0,0.0,17798103.74000003,2018,8,17,PAYEMENT,14600000.0,C1487669283
12145,409000438620',2018-08-18,MAW/502964XXXXXX6125/Karu,0.0,1700.0,17799803.74000003,2018,8,18,CASH_IN,1700.0,C657255537
12146,409000438620',2018-08-18,Indiaforensic AEPS NPCI WDL SET,0.0,13022400.0,30822203.74000003,2018,8,18,CASH_IN,13022400.0,C935612756
12147,409000438620',2018-08-18,MAW/502964XXXXXX8595/NAGA,0.0,200.0,30822403.74000003,2018,8,18,TRANSFER,200.0,C332391051
12148,409000438620',2018-08-18,TRF TO  Indiaforensic SERVICES I,3000000.0,0.0,27822403.74000003,2018,8,18,CHECK_WITHDRAWAL,3000000.0,C2145041211
12149,409000438620',2018-08-18,TRF TO  Indiaforensic SERVICES I,10000000.0,0.0,17822403.74000003,2018,8,18,CHECK_WITHDRAWAL,10000000.0,C1315729466
12150,409000438620',2018-08-18,MAW/502964XXXXXX7770/Karu,0.0,1700.0,17824103.74000003,2018,8,18,CHECK_CASHING,1700.0,C968448640
12151,409000438620',2018-08-18,MAW/502964XXXXXX8073/Pand,0.0,2000.0,17826103.74000003,2018,8,18,TRANSFER,2000.0,C188246551
12152,409000438620',2018-08-18,MAW/502964XXXXXX8303/Karu,0.0,1700.0,17827803.74000003,2018,8,18,TRANSFER,1700.0,C803116137
12153,409000438620',2018-08-18,MAW/502964XXXXXX4638/Karu,0.0,1700.0,17829503.74000003,2018,8,18,CASH_IN,1700.0,C580441921
12154,409000438620',2018-08-18,MAW/502964XXXXXX9077/Karu,0.0,1700.0,17831203.74000003,2018,8,18,TRANSFER,1700.0,C801142660
12155,409000438620',2018-08-18,MAW/502964XXXXXX6224/Karu,0.0,1700.0,17832903.74000003,2018,8,18,CHECK_CASHING,1700.0,C875761527
12156,409000438620',2018-08-18,MAW/502964XXXXXX7020/Karu,0.0,1700.0,17834603.74000003,2018,8,18,CASH_IN,1700.0,C1092318644
12157,409000438620',2018-08-18,MAW/502964XXXXXX9036/Karu,0.0,1700.0,17836303.74000003,2018,8,18,CHECK_CASHING,1700.0,C1883840933
12158,409000438620',2018-08-18,MAW/502964XXXXXX7358/Karu,0.0,1700.0,17838003.74000003,2018,8,18,CHECK_CASHING,1700.0,C56868765
12159,409000438620',2018-08-18,AEPS INCOME DT 17-08-2018,0.0,32685.84,17870689.580000028,2018,8,18,CHECK_CASHING,32685.84,C1297685781
12160,409000438620',2018-08-18,AEPS GST INC DT 17-08-201,0.0,6537.17,17877226.75000003,2018,8,18,CASH_IN,6537.17,C1273939873
12161,409000438620',2018-08-20,MAW/502964XXXXXX0568/Karu,0.0,1800.0,17879026.75000003,2018,8,20,CASH_IN,1800.0,C965197768
12162,409000438620',2018-08-20,MAW/502964XXXXXX1930/NAGA,0.0,500.0,17879526.75000003,2018,8,20,TRANSFER,500.0,C265108079
12163,409000438620',2018-08-20,MAW/502964XXXXXX3590/Karu,0.0,1700.0,17881226.75000003,2018,8,20,CASH_IN,1700.0,C801142660
12164,409000438620',2018-08-20,MAW/502964XXXXXX7117/Karu,0.0,1600.0,17882826.75000003,2018,8,20,CHECK_CASHING,1600.0,C12793273
12165,409000438620',2018-08-20,Indiaforensic AEPS NPCI WDL SET,0.0,11543300.0,29426126.75000003,2018,8,20,CHECK_CASHING,11543300.0,C1019670582
12166,409000438620',2018-08-20,Indiaforensic AEPS NPCI WDL SET,0.0,9093300.0,38519426.75000003,2018,8,20,CHECK_CASHING,9093300.0,C423580937
12167,409000438620',2018-08-20,MAW/502964XXXXXX6016/Akol,0.0,1200.0,38520626.75000003,2018,8,20,CHECK_CASHING,1200.0,C33837320
12168,409000438620',2018-08-20,CR822717990279/RMCPL15035/1,500.0,0.0,38520126.75000003,2018,8,20,CHECK_WITHDRAWAL,500.0,C569675628
12169,409000438620',2018-08-20,CR822611659234/RMCPL19298/1,1000.0,0.0,38519126.75000003,2018,8,20,PAYEMENT,1000.0,C1914282536
12170,409000438620',2018-08-20,CR822611659240/RMCPL09617/1,3000.0,0.0,38516126.75000003,2018,8,20,CHECK_WITHDRAWAL,3000.0,C1545454825
12171,409000438620',2018-08-20,CR822616737151/RMCPL19298/1,500.0,0.0,38515626.75000003,2018,8,20,PAYEMENT,500.0,C1216745400
12172,409000438620',2018-08-20,CR822608596182/RMCPL25186/1,3600.0,0.0,38512026.75000003,2018,8,20,CASH_OUT,3600.0,C465257140
12173,409000438620',2018-08-20,CR822610623049/RMCPL09735/1,500.0,0.0,38511526.75000003,2018,8,20,PAYEMENT,500.0,C1627965794
12174,409000438620',2018-08-20,CR822612669139/RMCPL22607/1,1100.0,0.0,38510426.75000003,2018,8,20,CASH_OUT,1100.0,C22918364
12175,409000438620',2018-08-20,CR822612669129/RMCPL22310/1,700.0,0.0,38509726.75000003,2018,8,20,PAYEMENT,700.0,C1065997164
12176,409000438620',2018-08-20,CR822618768834/RMCPL14511/1,4000.0,0.0,38505726.75000003,2018,8,20,CHECK_WITHDRAWAL,4000.0,C1523536343
12177,409000438620',2018-08-20,CR822618775048/RMCPL10943/1,500.0,0.0,38505226.75000003,2018,8,20,PAYEMENT,500.0,M3306404
12178,409000438620',2018-08-20,CR822611647486/RMCPL26747/1,10000.0,0.0,38495226.75000003,2018,8,20,DEBIT,10000.0,M964442556
12179,409000438620',2018-08-20,CR822611647423/RMCPL12164/1,2500.0,0.0,38492726.75000003,2018,8,20,CASH_OUT,2500.0,C2119910556
12180,409000438620',2018-08-20,CR822610635451/RMCPL15559/1,10000.0,0.0,38482726.75000003,2018,8,20,PAYEMENT,10000.0,C1769947269
12181,409000438620',2018-08-20,CR822616737139/RMCPL25071/1,500.0,0.0,38482226.75000003,2018,8,20,PAYEMENT,500.0,M268858250
12182,409000438620',2018-08-20,CR822617752478/RMCPL24821/1,500.0,0.0,38481726.75000003,2018,8,20,PAYEMENT,500.0,M1694464687
12183,409000438620',2018-08-20,CR822617752469/RMCPL11793/1,4000.0,0.0,38477726.75000003,2018,8,20,CHECK_WITHDRAWAL,4000.0,M2005843823
12184,409000438620',2018-08-20,CR822617752464/RMCPL14724/1,7000.0,0.0,38470726.75000003,2018,8,20,DEBIT,7000.0,M242812591
12185,409000438620',2018-08-20,CR822617757589/RMCPL11949/1,6500.0,0.0,38464226.75000003,2018,8,20,DEBIT,6500.0,M1622667356
12186,409000438620',2018-08-20,CR822614709871/RMCPL11019/1,500.0,0.0,38463726.75000003,2018,8,20,PAYEMENT,500.0,M1449170393
12187,409000438620',2018-08-20,CR822614709846/RMCPL23810/1,2000.0,0.0,38461726.75000003,2018,8,20,CASH_OUT,2000.0,M1776265117
12188,409000438620',2018-08-20,CR822616737134/RMCPL09409/1,3500.0,0.0,38458226.75000003,2018,8,20,CHECK_WITHDRAWAL,3500.0,M2118448049
12189,409000438620',2018-08-20,CR822616737152/RMCPL12393/1,5000.0,0.0,38453226.75000003,2018,8,20,CHECK_WITHDRAWAL,5000.0,M1883006233
12190,409000438620',2018-08-20,CR822611659248/RMCPL22022/1,1500.0,0.0,38451726.75000003,2018,8,20,DEBIT,1500.0,M1176943131
12191,409000438620',2018-08-20,CR822717990279/RMCPL15035/1,500.0,0.0,38451226.75000003,2018,8,20,CASH_OUT,500.0,M1878667491
12192,409000438620',2018-08-20,CR822611659234/RMCPL19298/1,1000.0,0.0,38450226.75000003,2018,8,20,CHECK_WITHDRAWAL,1000.0,M867134838
12193,409000438620',2018-08-20,CR822611659240/RMCPL09617/1,3000.0,0.0,38447226.75000003,2018,8,20,CHECK_WITHDRAWAL,3000.0,M490153912
12194,409000438620',2018-08-20,CR822616737151/RMCPL19298/1,500.0,0.0,38446726.75000003,2018,8,20,DEBIT,500.0,M1116651486
12195,409000438620',2018-08-20,CR822608596182/RMCPL25186/1,3600.0,0.0,38443126.75000003,2018,8,20,CHECK_WITHDRAWAL,3600.0,M1726257306
12196,409000438620',2018-08-20,CR822610623049/RMCPL09735/1,500.0,0.0,38442626.75000003,2018,8,20,CHECK_WITHDRAWAL,500.0,M1309085893
12197,409000438620',2018-08-20,CR822612669139/RMCPL22607/1,1100.0,0.0,38441526.75000003,2018,8,20,CASH_OUT,1100.0,M500318624
12198,409000438620',2018-08-20,CR822612669129/RMCPL22310/1,700.0,0.0,38440826.75000003,2018,8,20,DEBIT,700.0,M329184374
12199,409000438620',2018-08-20,CR822618768834/RMCPL14511/1,4000.0,0.0,38436826.75000003,2018,8,20,CASH_OUT,4000.0,M1110726606
12200,409000438620',2018-08-20,CR822618775048/RMCPL10943/1,500.0,0.0,38436326.75000003,2018,8,20,DEBIT,500.0,M161626690
12201,409000438620',2018-08-20,CR822611647486/RMCPL26747/1,10000.0,0.0,38426326.75000003,2018,8,20,CHECK_WITHDRAWAL,10000.0,M37954065
12202,409000438620',2018-08-20,CR822611647423/RMCPL12164/1,2500.0,0.0,38423826.75000003,2018,8,20,CASH_OUT,2500.0,M756143591
12203,409000438620',2018-08-20,CR822610635451/RMCPL15559/1,10000.0,0.0,38413826.75000003,2018,8,20,DEBIT,10000.0,M407107161
12204,409000438620',2018-08-20,CR822616737139/RMCPL25071/1,500.0,0.0,38413326.75000003,2018,8,20,CASH_OUT,500.0,M1108837203
12205,409000438620',2018-08-20,CR822617752478/RMCPL24821/1,500.0,0.0,38412826.75000003,2018,8,20,CASH_OUT,500.0,M508405717
12206,409000438620',2018-08-20,CR822617752469/RMCPL11793/1,4000.0,0.0,38408826.75000003,2018,8,20,PAYEMENT,4000.0,C1787868648
12207,409000438620',2018-08-20,CR822617752464/RMCPL14724/1,7000.0,0.0,38401826.75000003,2018,8,20,PAYEMENT,7000.0,C1738973904
12208,409000438620',2018-08-20,CR822617757589/RMCPL11949/1,6500.0,0.0,38395326.75000003,2018,8,20,DEBIT,6500.0,C1183653836
12209,409000438620',2018-08-20,CR822614709871/RMCPL11019/1,500.0,0.0,38394826.75000003,2018,8,20,PAYEMENT,500.0,C2040603986
12210,409000438620',2018-08-20,CR822614709846/RMCPL23810/1,2000.0,0.0,38392826.75000003,2018,8,20,CASH_OUT,2000.0,M4964230
12211,409000438620',2018-08-20,CR822616737134/RMCPL09409/1,3500.0,0.0,38389326.75000003,2018,8,20,CASH_OUT,3500.0,M1892165065
12212,409000438620',2018-08-20,CR822616737152/RMCPL12393/1,5000.0,0.0,38384326.75000003,2018,8,20,DEBIT,5000.0,M686950238
12213,409000438620',2018-08-20,CR822611659248/RMCPL22022/1,1500.0,0.0,38382826.75000003,2018,8,20,CASH_OUT,1500.0,C2122200303
12214,409000438620',2018-08-20,TRF TO  Indiaforensic SERVICES I,14800000.0,0.0,23582826.75000003,2018,8,20,DEBIT,14800000.0,C1666314150
12215,409000438620',2018-08-20,TRF TO  Indiaforensic SERVICES I,5800000.0,0.0,17782826.75000003,2018,8,20,PAYEMENT,5800000.0,C2089016471
12216,409000438620',2018-08-20,CR822717990279/RMCPL15035/1,0.0,500.0,17783326.75000003,2018,8,20,TRANSFER,500.0,M1492888172
12217,409000438620',2018-08-20,CR822611659234/RMCPL19298/1,0.0,1000.0,17784326.75000003,2018,8,20,CHECK_CASHING,1000.0,M1961490892
12218,409000438620',2018-08-20,CR822611659240/RMCPL09617/1,0.0,3000.0,17787326.75000003,2018,8,20,CASH_IN,3000.0,M328457586
12219,409000438620',2018-08-20,CR822616737151/RMCPL19298/1,0.0,500.0,17787826.75000003,2018,8,20,CASH_IN,500.0,M39650278
12220,409000438620',2018-08-20,CR822608596182/RMCPL25186/1,0.0,3600.0,17791426.75000003,2018,8,20,CASH_IN,3600.0,M1822284041
12221,409000438620',2018-08-20,CR822610623049/RMCPL09735/1,0.0,500.0,17791926.75000003,2018,8,20,TRANSFER,500.0,M848582961
12222,409000438620',2018-08-20,CR822612669139/RMCPL22607/1,0.0,1100.0,17793026.75000003,2018,8,20,CHECK_CASHING,1100.0,M378390979
12223,409000438620',2018-08-20,CR822612669129/RMCPL22310/1,0.0,700.0,17793726.75000003,2018,8,20,CHECK_CASHING,700.0,C1059781259
12224,409000438620',2018-08-20,CR822618768834/RMCPL14511/1,0.0,4000.0,17797726.75000003,2018,8,20,CASH_IN,4000.0,C1335946878
12225,409000438620',2018-08-20,CR822618775048/RMCPL10943/1,0.0,500.0,17798226.75000003,2018,8,20,CASH_IN,500.0,C686592713
12226,409000438620',2018-08-20,CR822611647486/RMCPL26747/1,0.0,10000.0,17808226.75000003,2018,8,20,CHECK_CASHING,10000.0,C515132998
12227,409000438620',2018-08-20,CR822611647423/RMCPL12164/1,0.0,2500.0,17810726.75000003,2018,8,20,TRANSFER,2500.0,C1447218435
12228,409000438620',2018-08-20,CR822610635451/RMCPL15559/1,0.0,10000.0,17820726.75000003,2018,8,20,CHECK_CASHING,10000.0,C1234059684
12229,409000438620',2018-08-20,CR822616737139/RMCPL25071/1,0.0,500.0,17821226.75000003,2018,8,20,CHECK_CASHING,500.0,C232812328
12230,409000438620',2018-08-20,CR822617752478/RMCPL24821/1,0.0,500.0,17821726.75000003,2018,8,20,CASH_IN,500.0,C413177525
12231,409000438620',2018-08-20,CR822617752469/RMCPL11793/1,0.0,4000.0,17825726.75000003,2018,8,20,CASH_IN,4000.0,C19422918
12232,409000438620',2018-08-20,CR822617752464/RMCPL14724/1,0.0,7000.0,17832726.75000003,2018,8,20,CASH_IN,7000.0,C9916873
12233,409000438620',2018-08-20,CR822617757589/RMCPL11949/1,0.0,6500.0,17839226.75000003,2018,8,20,TRANSFER,6500.0,C458582664
12234,409000438620',2018-08-20,CR822614709871/RMCPL11019/1,0.0,500.0,17839726.75000003,2018,8,20,CASH_IN,500.0,M904635608
12235,409000438620',2018-08-20,CR822614709846/RMCPL23810/1,0.0,2000.0,17841726.75000003,2018,8,20,CASH_IN,2000.0,M1231966279
12236,409000438620',2018-08-20,CR822616737134/RMCPL09409/1,0.0,3500.0,17845226.75000003,2018,8,20,TRANSFER,3500.0,M1528182438
12237,409000438620',2018-08-20,CR822616737152/RMCPL12393/1,0.0,5000.0,17850226.75000003,2018,8,20,CHECK_CASHING,5000.0,M728875923
12238,409000438620',2018-08-20,CR822611659248/RMCPL22022/1,0.0,1500.0,17851726.75000003,2018,8,20,CHECK_CASHING,1500.0,C936455438
12239,409000438620',2018-08-20,AEPS INCOME DT 18-08-2018,0.0,29995.1,17881721.85000003,2018,8,20,CHECK_CASHING,29995.1,M1288073532
12240,409000438620',2018-08-20,AEPS GST INC DT 18-08-201,0.0,5999.02,17887720.87000003,2018,8,20,CASH_IN,5999.02,M1596017970
12241,409000438620',2018-08-20,AEPS INCOME DT 19-18-2018,0.0,24515.78,17912236.650000032,2018,8,20,CHECK_CASHING,24515.78,M830077564
12242,409000438620',2018-08-20,AEPS GST INC DT 19-18-201,0.0,4903.16,17917139.810000032,2018,8,20,TRANSFER,4903.16,M2139275181
12243,409000438620',2018-08-20,AEPS ACQ CR ADJ FEES 1808,249.57,0.0,17916890.240000032,2018,8,20,CASH_OUT,249.57,M116442074
12244,409000438620',2018-08-20,AEPS ACQ REP ADJ FEES 180,0.0,26.55,17916916.790000033,2018,8,20,CHECK_CASHING,26.55,M1070674288
12245,409000438620',2018-08-20,AEPS PAY SPICE DIGITAL 18,0.0,298.93,17917215.720000032,2018,8,20,CHECK_CASHING,298.93,C1588901702
12246,409000438620',2018-08-20,AEPS PAY SPICE DIGITAL 19,0.0,848.31,17918064.03000003,2018,8,20,CHECK_CASHING,848.31,C716083600
12247,409000438620',2018-08-21,MAW/502964XXXXXX3522/NAGA,0.0,900.0,17918964.03000003,2018,8,21,TRANSFER,900.0,M601949467
12248,409000438620',2018-08-21,MAW/502964XXXXXX0634/Karu,0.0,1700.0,17920664.03000003,2018,8,21,CASH_IN,1700.0,M1425151983
12249,409000438620',2018-08-21,MAW/502964XXXXXX3506/NAGA,0.0,800.0,17921464.03000003,2018,8,21,CASH_IN,800.0,C1538264524
12250,409000438620',2018-08-21,MAW/502964XXXXXX7840/Karu,0.0,1700.0,17923164.03000003,2018,8,21,TRANSFER,1700.0,C1846530780
12251,409000438620',2018-08-21,MAW/502964XXXXXX2000/Karu,0.0,1700.0,17924864.03000003,2018,8,21,TRANSFER,1700.0,M1039384768
12252,409000438620',2018-08-21,MAW/502964XXXXXX6125/Karu,0.0,1700.0,17926564.03000003,2018,8,21,TRANSFER,1700.0,M102918291
12253,409000438620',2018-08-21,CB822218790836/RMCPL21107/1,9400.0,0.0,17917164.03000003,2018,8,21,CASH_OUT,9400.0,C1545121117
12254,409000438620',2018-08-21,Indiaforensic AEPS NPCI WDL SET,0.0,9962200.0,27879364.03000003,2018,8,21,TRANSFER,9962200.0,M723785127
12255,409000438620',2018-08-21,CR822909383503/RMCPL02155/1,3000.0,0.0,27876364.03000003,2018,8,21,PAYEMENT,3000.0,M2103994707
12256,409000438620',2018-08-21,CR822912440795/RMCPL19348/1,2500.0,0.0,27873864.03000003,2018,8,21,CASH_OUT,2500.0,M663835124
12257,409000438620',2018-08-21,CR822917495069/RMCPL22133/1,1500.0,0.0,27872364.03000003,2018,8,21,CASH_OUT,1500.0,C1987564320
12258,409000438620',2018-08-21,CR822914468844/RMCPL13026/1,4000.0,0.0,27868364.03000003,2018,8,21,CASH_OUT,4000.0,M684351789
12259,409000438620',2018-08-21,CR822909375712/RMCPL17229/1,500.0,0.0,27867864.03000003,2018,8,21,CHECK_WITHDRAWAL,500.0,M690864655
12260,409000438620',2018-08-21,CR822910390579/RMCPL21549/1,4000.0,0.0,27863864.03000003,2018,8,21,DEBIT,4000.0,M649976964
12261,409000438620',2018-08-21,TRF TO  Indiaforensic SERVICES I,10000000.0,0.0,17863864.03000003,2018,8,21,CASH_OUT,10000000.0,M682549550
12262,409000438620',2018-08-21,MAW/502964XXXXXX0234/Karu,0.0,1700.0,17865564.03000003,2018,8,21,CHECK_CASHING,1700.0,C1137350304
12263,409000438620',2018-08-21,MAW/502964XXXXXX5164/Karu,0.0,1700.0,17867264.03000003,2018,8,21,CASH_IN,1700.0,C2059996587
12264,409000438620',2018-08-21,MAW/502964XXXXXX6255/Karu,0.0,1900.0,17869164.03000003,2018,8,21,CASH_IN,1900.0,M110950877
12265,409000438620',2018-08-21,AEPS PAY Indiaforensic 2008,0.0,408.57,17869572.60000003,2018,8,21,CASH_IN,408.57,M1136549218
12266,409000438620',2018-08-21,AEPS INCOME DT 20-08-2018,0.0,25884.34,17895456.94000003,2018,8,21,CHECK_CASHING,25884.34,M1563747251
12267,409000438620',2018-08-21,AEPS GST INC DT 20-08-201,0.0,5176.87,17900633.810000032,2018,8,21,CASH_IN,5176.87,M354122755
12268,409000438620',2018-08-21,AEPS ACQUIRING ADJ FEES 2,17.7,0.0,17900616.110000033,2018,8,21,CHECK_WITHDRAWAL,17.7,M1852951004
12269,409000438620',2018-08-21,AEPS ACQ CR ADJ FEES 2008,79.65,0.0,17900536.460000034,2018,8,21,DEBIT,79.65,M2145472404
12270,409000438620',2018-08-21,TRF TO  Indiaforensic SERVICES I,200000.0,0.0,17700536.460000034,2018,8,21,CASH_OUT,200000.0,M525348453
12271,409000438620',2018-08-23,Indiaforensic AEPS NPCI WDL SET,0.0,14982100.0,32682636.460000034,2018,8,23,CASH_IN,14982100.0,M2102211239
12272,409000438620',2018-08-23,TRF TO  Indiaforensic SERVICES I,15000000.0,0.0,17682636.460000034,2018,8,23,PAYEMENT,15000000.0,M1707252812
12273,409000438620',2018-08-23,Indiaforensic AEPS NPCI WDL SET,0.0,8678400.0,26361036.460000034,2018,8,23,CHECK_CASHING,8678400.0,M1401413753
12274,409000438620',2018-08-23,MAW/502964XXXXXX1906/NAGA,0.0,600.0,26361636.460000034,2018,8,23,CHECK_CASHING,600.0,M614324198
12275,409000438620',2018-08-23,NPCI SETELEMENT DIFF_2208,0.0,500.0,26362136.460000034,2018,8,23,CASH_IN,500.0,M1458647176
12276,409000438620',2018-08-23,NPCI SETELEMENT DIFF_2108,0.0,500.0,26362636.460000034,2018,8,23,CASH_IN,500.0,M703547809
12277,409000438620',2018-08-23,TRF TO  Indiaforensic SERVICES I,8700000.0,0.0,17662636.460000034,2018,8,23,CHECK_WITHDRAWAL,8700000.0,M7789646
12278,409000438620',2018-08-23,AEPS PAY Indiaforensic 2108,0.0,897.99,17663534.450000033,2018,8,23,CHECK_CASHING,897.99,M207205637
12279,409000438620',2018-08-23,AEPS PAY Indiaforensic 2208,0.0,697.82,17664232.270000033,2018,8,23,TRANSFER,697.82,M51146286
12280,409000438620',2018-08-23,MICRO ATM WDL FEE DATED 2,0.0,5600.0,17669832.270000033,2018,8,23,TRANSFER,5600.0,M1608588352
12281,409000438620',2018-08-23,AEPS ACQUIRING ADJ FEES 2,23.01,0.0,17669809.26000003,2018,8,23,DEBIT,23.01,M2014724716
12282,409000438620',2018-08-23,AEPS INCOME DT 21-08-2018,0.0,39138.53,17708947.790000033,2018,8,23,CASH_IN,39138.53,M975070698
12283,409000438620',2018-08-23,AEPS GST INC DT 21-08-201,0.0,7827.71,17716775.500000034,2018,8,23,CASH_IN,7827.71,M831101336
12284,409000438620',2018-08-23,AEPS INCOME DT 22-08-2018,0.0,22739.0,17739514.500000034,2018,8,23,CHECK_CASHING,22739.0,M1186850702
12285,409000438620',2018-08-23,AEPS GST INC DT 22-08-201,0.0,4547.8,17744062.300000034,2018,8,23,CASH_IN,4547.8,M1962998000
12286,409000438620',2018-08-23,MICRO ATM WDL FEE DATED 2,0.0,39300.0,17783362.300000034,2018,8,23,TRANSFER,39300.0,M2086146276
12287,409000438620',2018-08-23,MICRO ATM WDL FEE DATED 2,0.0,8500.0,17791862.300000034,2018,8,23,CASH_IN,8500.0,M1093923444
12288,409000438620',2018-08-23,NFS MICRO ATM INC DATED 2,0.0,20.16,17791882.460000034,2018,8,23,TRANSFER,20.16,M672629087
12289,409000438620',2018-08-23,NFS MICRO ATM GST DATED 2,0.0,4.03,17791886.490000036,2018,8,23,CASH_IN,4.03,M1999766133
12290,409000438620',2018-08-23,NFS MICRO ATM INC DATED 2,0.0,30.6,17791917.090000033,2018,8,23,CHECK_CASHING,30.6,M1410900214
12291,409000438620',2018-08-23,NFS MICRO ATM GST DATED 2,0.0,6.12,17791923.21000004,2018,8,23,TRANSFER,6.12,M2104975539
12292,409000438620',2018-08-24,Indiaforensic AEPS NPCI WDL SET,0.0,11450800.0,29242723.21000004,2018,8,24,CHECK_CASHING,11450800.0,M574643596
12293,409000438620',2018-08-24,MAW/502964XXXXXX9780/Karu,0.0,1700.0,29244423.21000004,2018,8,24,CHECK_CASHING,1700.0,M1896942953
12294,409000438620',2018-08-24,TRF TO  Indiaforensic SERVICES I,11500000.0,0.0,17744423.21000004,2018,8,24,DEBIT,11500000.0,M271726242
12295,409000438620',2018-08-24,MICRO ATM WDL FEE DATED 2,0.0,35200.0,17779623.21000004,2018,8,24,CASH_IN,35200.0,M1912672399
12296,409000438620',2018-08-24,AEPS PAY Indiaforensic 2308,0.0,199.29,17779822.500000034,2018,8,24,TRANSFER,199.29,M921968176
12297,409000438620',2018-08-24,MICRO ATM WDL FEE DATED 2,0.0,42200.0,17822022.500000034,2018,8,24,TRANSFER,42200.0,M1449505391
12298,409000438620',2018-08-24,AEPS INCOME DT 23-08-2018,0.0,29882.63,17851905.130000036,2018,8,24,CHECK_CASHING,29882.63,M1659694257
12299,409000438620',2018-08-24,AEPS GST INC DT 23-08-201,0.0,5976.53,17857881.660000034,2018,8,24,CHECK_CASHING,5976.53,M1742014299
12300,409000438620',2018-08-24,AEPS ACQ REP ADJ FEES 230,0.0,17.7,17857899.360000037,2018,8,24,CASH_IN,17.7,M1835348240
12301,409000438620',2018-08-24,NFS MICRO ATM INC DT 2308,0.0,123.48,17858022.840000033,2018,8,24,CHECK_CASHING,123.48,C977993101
12302,409000438620',2018-08-24,NFS MICRO ATM GST DT 2308,0.0,24.7,17858047.540000036,2018,8,24,CHECK_CASHING,24.7,M1505913056
12303,409000438620',2018-08-24,NFS MICRO ATM INC DT 2308,0.0,72.0,17858119.540000036,2018,8,24,CASH_IN,72.0,C281632155
12304,409000438620',2018-08-24,NFS MICRO ATM GST DT 2308,0.0,14.4,17858133.940000035,2018,8,24,CASH_IN,14.4,M1395759225
12305,409000438620',2018-08-24,NFS MICRO ATM INC DT 2408,0.0,94.32,17858228.260000035,2018,8,24,CHECK_CASHING,94.32,M1563073318
12306,409000438620',2018-08-24,NFS MICRO ATM GST DT 2408,0.0,18.87,17858247.130000036,2018,8,24,CASH_IN,18.87,C836514715
12307,409000438620',2018-08-25,MAW/502964XXXXXX0102/Vals,0.0,500.0,17858747.130000036,2018,8,25,TRANSFER,500.0,M573127351
12308,409000438620',2018-08-27,MAW/502964XXXXXX2319/Karu,0.0,1600.0,17860347.130000036,2018,8,27,TRANSFER,1600.0,M1518313648
12309,409000438620',2018-08-27,MAW/502964XXXXXX7609/Karu,0.0,1600.0,17861947.130000036,2018,8,27,CASH_IN,1600.0,M1927134738
12310,409000438620',2018-08-27,MAW/502964XXXXXX2685/Karu,0.0,1600.0,17863547.130000036,2018,8,27,CASH_IN,1600.0,M1699744889
12311,409000438620',2018-08-27,MAW/502964XXXXXX1369/Karu,0.0,1700.0,17865247.130000036,2018,8,27,TRANSFER,1700.0,M897542027
12312,409000438620',2018-08-27,Indiaforensic AEPS NPCI WDL SET,0.0,12078100.0,29943347.13000004,2018,8,27,CHECK_CASHING,12078100.0,M2021225242
12313,409000438620',2018-08-27,CR823409642388/RMCPL25604/2,1200.0,0.0,29942147.13000004,2018,8,27,CASH_OUT,1200.0,C2031368275
12314,409000438620',2018-08-27,CR823409642385/RMCPL24364/2,1100.0,0.0,29941047.13000004,2018,8,27,CASH_OUT,1100.0,M377608730
12315,409000438620',2018-08-27,CR823410651153/RMCPL21169/2,2100.0,0.0,29938947.13000004,2018,8,27,PAYEMENT,2100.0,M1228567772
12316,409000438620',2018-08-27,CR823410651170/RMCPL12251/2,1000.0,0.0,29937947.13000004,2018,8,27,CASH_OUT,1000.0,M409906770
12317,409000438620',2018-08-27,CR823412689161/RMCPL19555/2,1000.0,0.0,29936947.13000004,2018,8,27,CASH_OUT,1000.0,M995177292
12318,409000438620',2018-08-27,CR823311376480/RMCPL11592/2,2000.0,0.0,29934947.13000004,2018,8,27,DEBIT,2000.0,M1771200085
12319,409000438620',2018-08-27,CR823309325597/RMCPL19474/2,1100.0,0.0,29933847.13000004,2018,8,27,CHECK_WITHDRAWAL,1100.0,C2006081398
12320,409000438620',2018-08-27,CR823309325596/RMCPL25038/2,1800.0,0.0,29932047.13000004,2018,8,27,PAYEMENT,1800.0,C1174600239
12321,409000438620',2018-08-27,CR823309325690/RMCPL19515/2,3000.0,0.0,29929047.13000004,2018,8,27,DEBIT,3000.0,C1076835071
12322,409000438620',2018-08-27,CR823310359043/RMCPL09585/2,1500.0,0.0,29927547.13000004,2018,8,27,PAYEMENT,1500.0,C1948558238
12323,409000438620',2018-08-27,CR823308318429/RMCPL12739/2,2500.0,0.0,29925047.13000004,2018,8,27,PAYEMENT,2500.0,C295081230
12324,409000438620',2018-08-27,CR823308323007/RMCPL26809/2,10000.0,0.0,29915047.13000004,2018,8,27,CASH_OUT,10000.0,C1408337297
12325,409000438620',2018-08-27,CR823308318968/RMCPL19369/2,1000.0,0.0,29914047.13000004,2018,8,27,DEBIT,1000.0,C179678995
12326,409000438620',2018-08-27,CR823308318958/RMCPL13536/2,2000.0,0.0,29912047.13000004,2018,8,27,CHECK_WITHDRAWAL,2000.0,C147647618
12327,409000438620',2018-08-27,CR823308319000/RMCPL26845/2,2000.0,0.0,29910047.13000004,2018,8,27,CASH_OUT,2000.0,C312537393
12328,409000438620',2018-08-27,CR823308319008/RMCPL23562/2,3000.0,0.0,29907047.13000004,2018,8,27,PAYEMENT,3000.0,C1549086472
12329,409000438620',2018-08-27,CR823308319794/RMCPL24786/2,3700.0,0.0,29903347.13000004,2018,8,27,DEBIT,3700.0,C1157297801
12330,409000438620',2018-08-27,CR823314437810/RMCPL13369/2,4000.0,0.0,29899347.13000004,2018,8,27,CHECK_WITHDRAWAL,4000.0,C1538264524
12331,409000438620',2018-08-27,CR823315447904/RMCPL20307/2,1000.0,0.0,29898347.13000004,2018,8,27,CHECK_WITHDRAWAL,1000.0,C70895366
12332,409000438620',2018-08-27,CR823316461664/RMCPL19369/2,2000.0,0.0,29896347.13000004,2018,8,27,CHECK_WITHDRAWAL,2000.0,C306285887
12333,409000438620',2018-08-27,CR823316461689/RMCPL19701/2,2000.0,0.0,29894347.13000004,2018,8,27,PAYEMENT,2000.0,C1556875182
12334,409000438620',2018-08-27,CR823316461684/RMCPL19173/2,1000.0,0.0,29893347.13000004,2018,8,27,DEBIT,1000.0,C942226723
12335,409000438620',2018-08-27,CR823316457185/RMCPL11793/2,2000.0,0.0,29891347.13000004,2018,8,27,DEBIT,2000.0,C2017484544
12336,409000438620',2018-08-27,CR823311381415/RMCPL25987/2,4000.0,0.0,29887347.13000004,2018,8,27,CHECK_WITHDRAWAL,4000.0,C1983025922
12337,409000438620',2018-08-27,CR823312385910/RMCPL16968/2,1000.0,0.0,29886347.13000004,2018,8,27,CASH_OUT,1000.0,C1009972184
12338,409000438620',2018-08-27,CR823309334001/RMCPL14751/2,2600.0,0.0,29883747.13000004,2018,8,27,CHECK_WITHDRAWAL,2600.0,C380242442
12339,409000438620',2018-08-27,CR823309334004/RMCPL11996/2,4500.0,0.0,29879247.13000004,2018,8,27,PAYEMENT,4500.0,M951233281
12340,409000438620',2018-08-27,CR823309333984/RMCPL25311/2,1000.0,0.0,29878247.13000004,2018,8,27,CHECK_WITHDRAWAL,1000.0,M1221878786
12341,409000438620',2018-08-27,CR823311381404/RMCPL25390/2,1000.0,0.0,29877247.13000004,2018,8,27,CASH_OUT,1000.0,M27273777
12342,409000438620',2018-08-27,CR823308318191/RMCPL19793/2,1300.0,0.0,29875947.13000004,2018,8,27,CHECK_WITHDRAWAL,1300.0,M173568863
12343,409000438620',2018-08-27,CR823308322948/RMCPL19369/2,500.0,0.0,29875447.13000004,2018,8,27,PAYEMENT,500.0,M493447989
12344,409000438620',2018-08-27,CR823308323045/RMCPL20893/2,500.0,0.0,29874947.13000004,2018,8,27,CHECK_WITHDRAWAL,500.0,M167993803
12345,409000438620',2018-08-27,CR823308322995/RMCPL23967/2,5000.0,0.0,29869947.13000004,2018,8,27,PAYEMENT,5000.0,M16341544
12346,409000438620',2018-08-27,CR823309333995/RMCPL03220/2,500.0,0.0,29869447.13000004,2018,8,27,CASH_OUT,500.0,C348708793
12347,409000438620',2018-08-27,CR823312385923/RMCPL19782/2,4000.0,0.0,29865447.13000004,2018,8,27,PAYEMENT,4000.0,M943749902
12348,409000438620',2018-08-27,CR823309326745/RMCPL19181/2,3500.0,0.0,29861947.13000004,2018,8,27,DEBIT,3500.0,M1960599968
12349,409000438620',2018-08-27,CR823310352252/RMCPL20736/2,500.0,0.0,29861447.13000004,2018,8,27,CASH_OUT,500.0,M969421003
12350,409000438620',2018-08-27,CR823309325692/RMCPL25397/2,1200.0,0.0,29860247.13000004,2018,8,27,CASH_OUT,1200.0,M1312666054
12351,409000438620',2018-08-27,CR823309326134/RMCPL13888/2,500.0,0.0,29859747.13000004,2018,8,27,CHECK_WITHDRAWAL,500.0,M1763921976
12352,409000438620',2018-08-27,CR823309326281/RMCPL25346/2,1400.0,0.0,29858347.13000004,2018,8,27,PAYEMENT,1400.0,M1259868840
12353,409000438620',2018-08-27,CR823309326275/RMCPL15524/2,1000.0,0.0,29857347.13000004,2018,8,27,CHECK_WITHDRAWAL,1000.0,M46349252
12354,409000438620',2018-08-27,CR823309326266/RMCPL22856/2,1000.0,0.0,29856347.13000004,2018,8,27,PAYEMENT,1000.0,M537648036
12355,409000438620',2018-08-27,CR823309326576/RMCPL26695/2,2000.0,0.0,29854347.13000004,2018,8,27,DEBIT,2000.0,M1522835195
12356,409000438620',2018-08-27,CR823309326378/RMCPL22264/2,7200.0,0.0,29847147.13000004,2018,8,27,CASH_OUT,7200.0,M1730922138
12357,409000438620',2018-08-27,CR823309326747/RMCPL15326/2,2000.0,0.0,29845147.13000004,2018,8,27,PAYEMENT,2000.0,M1282509673
12358,409000438620',2018-08-27,CR823308316722/RMCPL12739/2,2000.0,0.0,29843147.13000004,2018,8,27,PAYEMENT,2000.0,M1939146248
12359,409000438620',2018-08-27,CR823308316700/RMCPL12805/2,700.0,0.0,29842447.13000004,2018,8,27,PAYEMENT,700.0,M1725099364
12360,409000438620',2018-08-27,CR823308316658/RMCPL21855/2,1500.0,0.0,29840947.13000004,2018,8,27,DEBIT,1500.0,M1878722468
12361,409000438620',2018-08-27,CR823315447901/RMCPL09617/2,1000.0,0.0,29839947.13000004,2018,8,27,CHECK_WITHDRAWAL,1000.0,M2020450183
12362,409000438620',2018-08-27,Indiaforensic AEPS NPCI WDL SET,0.0,12473800.0,42313747.13000004,2018,8,27,TRANSFER,12473800.0,M1418811821
12363,409000438620',2018-08-27,Indiaforensic AEPS NPCI WDL SET,0.0,4943400.0,47257147.13000004,2018,8,27,CHECK_CASHING,4943400.0,C1169903663
12364,409000438620',2018-08-27,MAW/502964XXXXXX7609/Karu,0.0,1400.0,47258547.13000004,2018,8,27,CASH_IN,1400.0,C1554540309
12365,409000438620',2018-08-27,CR822815216318/RMCPL25821/1,7000.0,0.0,47251547.13000004,2018,8,27,CASH_OUT,7000.0,M1591845721
12366,409000438620',2018-08-27,CR822815216308/RMCPL23584/1,3300.0,0.0,47248247.13000004,2018,8,27,CHECK_WITHDRAWAL,3300.0,M1671041425
12367,409000438620',2018-08-27,CR822811159473/RMCPL16917/1,1500.0,0.0,47246747.13000004,2018,8,27,DEBIT,1500.0,M775524797
12368,409000438620',2018-08-27,CR822816227899/RMCPL24804/1,1000.0,0.0,47245747.13000004,2018,8,27,PAYEMENT,1000.0,M184153149
12369,409000438620',2018-08-27,CR822814203586/RMCPL11949/1,500.0,0.0,47245247.13000004,2018,8,27,CHECK_WITHDRAWAL,500.0,M498737408
12370,409000438620',2018-08-27,CR822814203599/RMCPL25729/1,4000.0,0.0,47241247.13000004,2018,8,27,PAYEMENT,4000.0,C1326243087
12371,409000438620',2018-08-27,CR822816238878/RMCPL09506/1,2000.0,0.0,47239247.13000004,2018,8,27,CASH_OUT,2000.0,C170899621
12372,409000438620',2018-08-27,CR822812165398/RMCPL16204/1,1500.0,0.0,47237747.13000004,2018,8,27,DEBIT,1500.0,M1448247489
12373,409000438620',2018-08-27,CR822811146697/RMCPL24578/1,5000.0,0.0,47232747.13000004,2018,8,27,CASH_OUT,5000.0,C1315729466
12374,409000438620',2018-08-27,CR822811157886/RMCPL24427/1,3000.0,0.0,47229747.13000004,2018,8,27,PAYEMENT,3000.0,C1217062947
12375,409000438620',2018-08-27,CR822809111076/RMCPL18789/1,3000.0,0.0,47226747.13000004,2018,8,27,PAYEMENT,3000.0,M1094922724
12376,409000438620',2018-08-27,CR822811156558/RMCPL11794/1,500.0,0.0,47226247.13000004,2018,8,27,CASH_OUT,500.0,M435565740
12377,409000438620',2018-08-27,CR822809111058/RMCPL17831/1,2100.0,0.0,47224147.13000004,2018,8,27,DEBIT,2100.0,C1761291320
12378,409000438620',2018-08-27,CR822814196766/RMCPL26141/1,3500.0,0.0,47220647.13000004,2018,8,27,CHECK_WITHDRAWAL,3500.0,M369858154
12379,409000438620',2018-08-27,CR822811153304/RMCPL24790/1,500.0,0.0,47220147.13000004,2018,8,27,CASH_OUT,500.0,M98727108
12380,409000438620',2018-08-27,CR822818263327/RMCPL13776/1,4000.0,0.0,47216147.13000004,2018,8,27,DEBIT,4000.0,M171097935
12381,409000438620',2018-08-27,CR822817256526/RMCPL17244/1,1000.0,0.0,47215147.13000004,2018,8,27,PAYEMENT,1000.0,M640702925
12382,409000438620',2018-08-27,CR822817256593/RMCPL19721/1,500.0,0.0,47214647.13000004,2018,8,27,DEBIT,500.0,M2142158966
12383,409000438620',2018-08-27,CR822816233178/RMCPL21524/1,1000.0,0.0,47213647.13000004,2018,8,27,CHECK_WITHDRAWAL,1000.0,C1945802665
12384,409000438620',2018-08-27,CR822816233200/RMCPL20772/1,1300.0,0.0,47212347.13000004,2018,8,27,CASH_OUT,1300.0,M1460074072
12385,409000438620',2018-08-27,CR823117951432/RMCPL20463/1,4000.0,0.0,47208347.13000004,2018,8,27,PAYEMENT,4000.0,M659494599
12386,409000438620',2018-08-27,CR823116945787/RMCPL12343/1,700.0,0.0,47207647.13000004,2018,8,27,CHECK_WITHDRAWAL,700.0,M1283220866
12387,409000438620',2018-08-27,CR823012674488/RMCPL11486/1,500.0,0.0,47207147.13000004,2018,8,27,CASH_OUT,500.0,C1136811657
12388,409000438620',2018-08-27,CR823017747230/RMCPL11131/1,4000.0,0.0,47203147.13000004,2018,8,27,PAYEMENT,4000.0,M938135484
12389,409000438620',2018-08-27,CR823017747237/RMCPL26650/1,2000.0,0.0,47201147.13000004,2018,8,27,DEBIT,2000.0,M2138956500
12390,409000438620',2018-08-27,CR823010630488/RMCPL24692/1,2000.0,0.0,47199147.13000004,2018,8,27,CASH_OUT,2000.0,C1348373832
12391,409000438620',2018-08-27,CR823010638304/RMCPL23164/1,3000.0,0.0,47196147.13000004,2018,8,27,CASH_OUT,3000.0,C1778300121
12392,409000438620',2018-08-27,CR823010638281/RMCPL18267/1,2000.0,0.0,47194147.13000004,2018,8,27,CASH_OUT,2000.0,C1354725727
12393,409000438620',2018-08-27,CR823011648086/RMCPL18789/1,2000.0,0.0,47192147.13000004,2018,8,27,DEBIT,2000.0,C1163480574
12394,409000438620',2018-08-27,CR823010638227/RMCPL22367/1,10000.0,0.0,47182147.13000004,2018,8,27,CHECK_WITHDRAWAL,10000.0,C1495724689
12395,409000438620',2018-08-27,CR823010637801/RMCPL22700/1,500.0,0.0,47181647.13000004,2018,8,27,DEBIT,500.0,C1341257842
12396,409000438620',2018-08-27,CR823010638344/RMCPL23721/1,1000.0,0.0,47180647.13000004,2018,8,27,CHECK_WITHDRAWAL,1000.0,M719492088
12397,409000438620',2018-08-27,CR823013685701/RMCPL23228/1,1000.0,0.0,47179647.13000004,2018,8,27,CHECK_WITHDRAWAL,1000.0,M1391527655
12398,409000438620',2018-08-27,CR823011652425/RMCPL23888/1,3000.0,0.0,47176647.13000004,2018,8,27,DEBIT,3000.0,C1429623854
12399,409000438620',2018-08-27,CR823016727908/RMCPL18519/1,500.0,0.0,47176147.13000004,2018,8,27,PAYEMENT,500.0,C1477979030
12400,409000438620',2018-08-27,CR823017742300/RMCPL21990/1,1800.0,0.0,47174347.13000004,2018,8,27,CASH_OUT,1800.0,C1825992554
12401,409000438620',2018-08-27,CR823010638095/RMCPL26384/1,1000.0,0.0,47173347.13000004,2018,8,27,DEBIT,1000.0,C1034382650
12402,409000438620',2018-08-27,CR823010630973/RMCPL19631/1,2000.0,0.0,47171347.13000004,2018,8,27,DEBIT,2000.0,C616998001
12403,409000438620',2018-08-27,CR823010630974/RMCPL21463/1,10000.0,0.0,47161347.13000004,2018,8,27,CASH_OUT,10000.0,C2072030256
12404,409000438620',2018-08-27,CR823017742304/RMCPL21565/1,500.0,0.0,47160847.13000004,2018,8,27,PAYEMENT,500.0,C1656756667
12405,409000438620',2018-08-27,CR823017742293/RMCPL16407/1,700.0,0.0,47160147.13000004,2018,8,27,PAYEMENT,700.0,C1502143342
12406,409000438620',2018-08-27,CR823012680055/RMCPL15580/1,500.0,0.0,47159647.13000004,2018,8,27,CHECK_WITHDRAWAL,500.0,C728526866
12407,409000438620',2018-08-27,CR823010638065/RMCPL11699/1,2000.0,0.0,47157647.13000004,2018,8,27,CHECK_WITHDRAWAL,2000.0,C349015546
12408,409000438620',2018-08-27,CR823010638049/RMCPL18488/1,1000.0,0.0,47156647.13000004,2018,8,27,CASH_OUT,1000.0,C30516998
12409,409000438620',2018-08-27,CR823010642191/RMCPL11019/1,6000.0,0.0,47150647.13000004,2018,8,27,PAYEMENT,6000.0,C1891031939
12410,409000438620',2018-08-27,CR823011652432/RMCPL11945/1,5000.0,0.0,47145647.13000004,2018,8,27,CHECK_WITHDRAWAL,5000.0,C1261940766
12411,409000438620',2018-08-27,CR823010637808/RMCPL20773/1,1800.0,0.0,47143847.13000004,2018,8,27,CHECK_WITHDRAWAL,1800.0,C1107146140
12412,409000438620',2018-08-27,CR823010638345/RMCPL21282/1,7500.0,0.0,47136347.13000004,2018,8,27,DEBIT,7500.0,C1298316171
12413,409000438620',2018-08-27,CR823010638030/RMCPL16917/1,500.0,0.0,47135847.13000004,2018,8,27,CHECK_WITHDRAWAL,500.0,C1034382650
12414,409000438620',2018-08-27,CR823012674482/RMCPL14483/1,1000.0,0.0,47134847.13000004,2018,8,27,PAYEMENT,1000.0,C775937840
12415,409000438620',2018-08-27,CR823010642217/RMCPL24648/1,1000.0,0.0,47133847.13000004,2018,8,27,PAYEMENT,1000.0,C1297685781
12416,409000438620',2018-08-27,CR823010638186/RMCPL14751/1,10000.0,0.0,47123847.13000004,2018,8,27,DEBIT,10000.0,C893548422
12417,409000438620',2018-08-27,CR823010638026/RMCPL21990/1,1800.0,0.0,47122047.13000004,2018,8,27,DEBIT,1800.0,C1670989986
12418,409000438620',2018-08-27,CR823010637709/RMCPL13166/1,2000.0,0.0,47120047.13000004,2018,8,27,DEBIT,2000.0,C1475998599
12419,409000438620',2018-08-27,CR823010638308/RMCPL13166/1,2000.0,0.0,47118047.13000004,2018,8,27,CASH_OUT,2000.0,C2093546827
12420,409000438620',2018-08-27,CR823011652455/RMCPL24195/1,3500.0,0.0,47114547.13000004,2018,8,27,CASH_OUT,3500.0,C301749835
12421,409000438620',2018-08-27,CR823010642203/RMCPL18519/1,1900.0,0.0,47112647.13000004,2018,8,27,PAYEMENT,1900.0,C254669696
12422,409000438620',2018-08-27,CR823010642261/RMCPL25247/1,5000.0,0.0,47107647.13000004,2018,8,27,DEBIT,5000.0,C1825634724
12423,409000438620',2018-08-27,CR823011652418/RMCPL24066/1,10000.0,0.0,47097647.13000004,2018,8,27,PAYEMENT,10000.0,C978740207
12424,409000438620',2018-08-27,CR823010637948/RMCPL09590/1,10000.0,0.0,47087647.13000004,2018,8,27,PAYEMENT,10000.0,C1286885448
12425,409000438620',2018-08-27,CR823210073323/RMCPL22022/2,1500.0,0.0,47086147.13000004,2018,8,27,CHECK_WITHDRAWAL,1500.0,C1533182537
12426,409000438620',2018-08-27,CR823209066681/RMCPL13619/2,4000.0,0.0,47082147.13000004,2018,8,27,CHECK_WITHDRAWAL,4000.0,C380242442
12427,409000438620',2018-08-27,CR823214141177/RMCPL11523/2,3000.0,0.0,47079147.13000004,2018,8,27,DEBIT,3000.0,C726762476
12428,409000438620',2018-08-27,CR823214152456/RMCPL18519/2,3000.0,0.0,47076147.13000004,2018,8,27,CHECK_WITHDRAWAL,3000.0,C1360767589
12429,409000438620',2018-08-27,CR823214146448/RMCPL20628/2,1000.0,0.0,47075147.13000004,2018,8,27,CASH_OUT,1000.0,C1717547480
12430,409000438620',2018-08-27,CR823210068009/RMCPL24151/2,2000.0,0.0,47073147.13000004,2018,8,27,CASH_OUT,2000.0,C1127705091
12431,409000438620',2018-08-27,CR823214141190/RMCPL27346/2,5000.0,0.0,47068147.13000004,2018,8,27,CASH_OUT,5000.0,C1231842708
12432,409000438620',2018-08-27,CR823211101146/RMCPL22022/2,1500.0,0.0,47066647.13000004,2018,8,27,PAYEMENT,1500.0,C2083117811
12433,409000438620',2018-08-27,CR823211105901/RMCPL15391/2,500.0,0.0,47066147.13000004,2018,8,27,CASH_OUT,500.0,C1305830291
12434,409000438620',2018-08-27,CR823209060071/RMCPL23895/2,1000.0,0.0,47065147.13000004,2018,8,27,CASH_OUT,1000.0,C1036454560
12435,409000438620',2018-08-27,CR823209066686/RMCPL22581/2,1200.0,0.0,47063947.13000004,2018,8,27,PAYEMENT,1200.0,C1983747920
12436,409000438620',2018-08-27,CR823212120375/RMCPL14786/2,500.0,0.0,47063447.13000004,2018,8,27,CHECK_WITHDRAWAL,500.0,C1691655733
12437,409000438620',2018-08-27,CR823211105889/RMCPL18108/2,1200.0,0.0,47062247.13000004,2018,8,27,CASH_OUT,1200.0,C306285887
12438,409000438620',2018-08-27,CR823213136217/RMCPL09511/2,1000.0,0.0,47061247.13000004,2018,8,27,PAYEMENT,1000.0,C1822871957
12439,409000438620',2018-08-27,CR823211096191/RMCPL17567/2,10000.0,0.0,47051247.13000004,2018,8,27,CHECK_WITHDRAWAL,10000.0,C44293675
12440,409000438620',2018-08-27,CR823211096198/RMCPL12794/2,5000.0,0.0,47046247.13000004,2018,8,27,DEBIT,5000.0,C2019147162
12441,409000438620',2018-08-27,CR823212106797/RMCPL15391/2,500.0,0.0,47045747.13000004,2018,8,27,CASH_OUT,500.0,C1444842411
12442,409000438620',2018-08-27,CR823211105886/RMCPL25366/2,700.0,0.0,47045047.13000004,2018,8,27,PAYEMENT,700.0,C691636444
12443,409000438620',2018-08-27,CR822821324572/RMCPL27560/1,100.0,0.0,47044947.13000004,2018,8,27,PAYEMENT,100.0,C1059781259
12444,409000438620',2018-08-27,CR822821322998/RMCPL27560/1,100.0,0.0,47044847.13000004,2018,8,27,CHECK_WITHDRAWAL,100.0,C1183572822
12445,409000438620',2018-08-27,CR823209060026/RMCPL19744/2,7500.0,0.0,47037347.13000004,2018,8,27,DEBIT,7500.0,C158876320
12446,409000438620',2018-08-27,MAW/502964XXXXXX9772/Cudd,0.0,1000.0,47038347.13000004,2018,8,27,CASH_IN,1000.0,C2017484544
12447,409000438620',2018-08-27,TRF TO  Indiaforensic SERVICES I,15000000.0,0.0,32038347.13000004,2018,8,27,CASH_OUT,15000000.0,C347725669
12448,409000438620',2018-08-27,TRF TO  Indiaforensic SERVICES I,14300000.0,0.0,17738347.13000004,2018,8,27,CHECK_WITHDRAWAL,14300000.0,C1434389049
12449,409000438620',2018-08-27,MAW/502964XXXXXX7575/Karu,0.0,1700.0,17740047.13000004,2018,8,27,CASH_IN,1700.0,C843774579
12450,409000438620',2018-08-27,MICRO ATM WDL FEE DATED 2,0.0,20700.0,17760747.13000004,2018,8,27,TRANSFER,20700.0,C1076835071
12451,409000438620',2018-08-27,MICRO ATM WDL FEE DATED 2,0.0,56700.0,17817447.13000004,2018,8,27,CASH_IN,56700.0,C56868765
12452,409000438620',2018-08-27,MICRO ATM WDL FEE DATED 2,0.0,7000.0,17824447.13000004,2018,8,27,CHECK_CASHING,7000.0,C1404112538
12453,409000438620',2018-08-27,NFS MICRO ATM INC DT 2408,0.0,49.32,17824496.45000004,2018,8,27,CHECK_CASHING,49.32,C1953886321
12454,409000438620',2018-08-27,NFS MICRO ATM GST DT 2408,0.0,9.86,17824506.31000004,2018,8,27,TRANSFER,9.86,C2063763486
12455,409000438620',2018-08-27,NFS MICRO ATM INC DT 2508,0.0,109.8,17824616.11000004,2018,8,27,CASH_IN,109.8,C292665982
12456,409000438620',2018-08-27,NFS MICRO ATM GST DT 2508,0.0,21.96,17824638.07000004,2018,8,27,CHECK_CASHING,21.96,C549221039
12457,409000438620',2018-08-27,AEPS PAY Indiaforensic 2408,0.0,449.0,17825087.07000004,2018,8,27,TRANSFER,449.0,C476182975
12458,409000438620',2018-08-27,AEPS PAY Indiaforensic 2508,0.0,298.21,17825385.280000042,2018,8,27,CASH_IN,298.21,C444920847
12459,409000438620',2018-08-27,AEPS PAY Indiaforensic 2608,0.0,598.73,17825984.010000046,2018,8,27,CASH_IN,598.73,C459172227
12460,409000438620',2018-08-27,AEPS INCOME DT 24-08-2018,0.0,32338.88,17858322.89000004,2018,8,27,CHECK_CASHING,32338.88,C767544292
12461,409000438620',2018-08-27,AEPS GST INC DT 24-08-201,0.0,6467.78,17864790.670000046,2018,8,27,TRANSFER,6467.78,C1023714065
12462,409000438620',2018-08-27,AEPS INCOME DT 25-08-2018,0.0,33287.46,17898078.130000044,2018,8,27,CASH_IN,33287.46,C1778289781
12463,409000438620',2018-08-27,AEPS GST INC DT 25-08-201,0.0,6657.49,17904735.620000042,2018,8,27,CHECK_CASHING,6657.49,C476800120
12464,409000438620',2018-08-27,AEPS INCOME DT 26-08-2018,0.0,13780.6,17918516.220000044,2018,8,27,TRANSFER,13780.6,C1655039175
12465,409000438620',2018-08-27,AEPS GST INC DT 26-08-201,0.0,2756.12,17921272.340000045,2018,8,27,CASH_IN,2756.12,C1292435170
12466,409000438620',2018-08-27,AEPS ACQ CR ADJ FEES 2408,1365.22,0.0,17919907.120000046,2018,8,27,DEBIT,1365.22,C232834050
12467,409000438620',2018-08-27,AEPS ACQ REP ADJ FEES 240,0.0,5.31,17919912.430000044,2018,8,27,CHECK_CASHING,5.31,C847761155
12468,409000438620',2018-08-27,NEFT/000048051021/SUBSID,4500.0,0.0,17915412.430000044,2018,8,27,DEBIT,4500.0,C2072030256
12469,409000438620',2018-08-27,MICRO ATM INC DATED 27081,0.0,18.0,17915430.430000044,2018,8,27,CASH_IN,18.0,M977320966
12470,409000438620',2018-08-27,MICRO ATM GST DATED 27081,0.0,3.6,17915434.030000046,2018,8,27,CHECK_CASHING,3.6,C1220911229
12471,409000438620',2018-08-28,Indiaforensic AEPS NPCI WDL SET,0.0,9853700.0,27769134.03000005,2018,8,28,CHECK_CASHING,9853700.0,M1953587149
12472,409000438620',2018-08-28,CR823518045615/RMCPL23994/2,500.0,0.0,27768634.03000005,2018,8,28,PAYEMENT,500.0,M163520153
12473,409000438620',2018-08-28,TRF TO  Indiaforensic SERVICES I,5000000.0,0.0,22768634.03000005,2018,8,28,PAYEMENT,5000000.0,C1796712971
12474,409000438620',2018-08-28,TRF TO  Indiaforensic SERVICES I,5000000.0,0.0,17768634.030000046,2018,8,28,PAYEMENT,5000000.0,M1296008802
12475,409000438620',2018-08-28,MICRO ATM WDL FEE DATED 2,0.0,6100.0,17774734.030000046,2018,8,28,CASH_IN,6100.0,M65606260
12476,409000438620',2018-08-28,AEPS PAY Indiaforensic 2408,449.0,0.0,17774285.030000046,2018,8,28,DEBIT,449.0,C1182148067
12477,409000438620',2018-08-28,AEPS PAY Indiaforensic 2408,0.0,539.09,17774824.120000046,2018,8,28,CASH_IN,539.09,C366015139
12478,409000438620',2018-08-28,AEPS INCOME DT 27-08-2018,0.0,25472.78,17800296.900000047,2018,8,28,TRANSFER,25472.78,C1354725727
12479,409000438620',2018-08-28,AEPS GST INC DT 27-08-201,0.0,5094.56,17805391.460000046,2018,8,28,CASH_IN,5094.56,C1728766751
12480,409000438620',2018-08-28,AEPS ACQUIRING ADJ FEES 2,39.53,0.0,17805351.930000044,2018,8,28,DEBIT,39.53,M2092595013
12481,409000438620',2018-08-28,AEPS ACQ CR ADJ FEES 2708,2.95,0.0,17805348.980000045,2018,8,28,DEBIT,2.95,C991363637
12482,409000438620',2018-08-28,MICRO ATM INC DATED 27081,0.0,21.96,17805370.940000046,2018,8,28,CASH_IN,21.96,C2103065350
12483,409000438620',2018-08-28,MICRO ATM GST DATED 27081,0.0,4.39,17805375.330000047,2018,8,28,TRANSFER,4.39,C2072030256
12484,409000438620',2018-08-29,Indiaforensic AEPS NPCI WDL SET,0.0,10893600.0,28698975.33000005,2018,8,29,CASH_IN,10893600.0,C667346055
12485,409000438620',2018-08-29,CB823015717554/RMCPL10943/1,10000.0,0.0,28688975.33000005,2018,8,29,CHECK_WITHDRAWAL,10000.0,C1495001462
12486,409000438620',2018-08-29,TRF TO  Indiaforensic SERVICES I,5000000.0,0.0,23688975.33000005,2018,8,29,DEBIT,5000000.0,C68113386
12487,409000438620',2018-08-29,TRF TO  Indiaforensic SERVICES I,5000000.0,0.0,18688975.330000047,2018,8,29,DEBIT,5000000.0,C2113748097
12488,409000438620',2018-08-29,TRF TO  Indiaforensic SERVICES I,1000000.0,0.0,17688975.330000047,2018,8,29,CASH_OUT,1000000.0,C1832580921
12489,409000438620',2018-08-29,AEPS INCOME DT 28-08-2018,0.0,28044.41,17717019.740000047,2018,8,29,TRANSFER,28044.41,C444613285
12490,409000438620',2018-08-29,AEPS GST INC DT 28-08-201,0.0,5608.88,17722628.620000046,2018,8,29,CHECK_CASHING,5608.88,C1109485117
12491,409000438620',2018-08-30,MAW/502964XXXXXX5863/Karu,0.0,1700.0,17724328.620000046,2018,8,30,CHECK_CASHING,1700.0,C566698125
12492,409000438620',2018-08-30,Indiaforensic AEPS NPCI WDL SET,0.0,10587800.0,28312128.62000005,2018,8,30,CASH_IN,10587800.0,C932583850
12493,409000438620',2018-08-30,MAW/502964XXXXXX1833/NAGA,0.0,800.0,28312928.62000005,2018,8,30,TRANSFER,800.0,C2104165942
12494,409000438620',2018-08-30,MICRO ATM WDL FEE DATED 2,0.0,47800.0,28360728.62000005,2018,8,30,CHECK_CASHING,47800.0,C1495001462
12495,409000438620',2018-08-30,TRF TO  Indiaforensic SERVICES I,10600000.0,0.0,17760728.620000046,2018,8,30,PAYEMENT,10600000.0,C1495001462
12496,409000438620',2018-08-30,MICRO ATM WDL FEE DT30081,0.0,17500.0,17778228.620000046,2018,8,30,TRANSFER,17500.0,C1234776885
12497,409000438620',2018-08-30,AEPS INCOME DT 29-08-2018,0.0,27995.03,17806223.650000047,2018,8,30,CHECK_CASHING,27995.03,C2040603986
12498,409000438620',2018-08-30,AEPS GST INC DT 29-08-201,0.0,5599.01,17811822.66000005,2018,8,30,CHECK_CASHING,5599.01,M860033910
12499,409000438620',2018-08-30,AEPS ACQUIRING ADJ FEES 2,46.61,0.0,17811776.05000005,2018,8,30,PAYEMENT,46.61,M965129555
12500,409000438620',2018-08-30,AEPS ACQ REP ADJ FEES 290,0.0,35.4,17811811.450000048,2018,8,30,CHECK_CASHING,35.4,C1651379334
12501,409000438620',2018-08-30,NFS MICRO ATM INC DATED 2,0.0,116.28,17811927.73000005,2018,8,30,CHECK_CASHING,116.28,C188246551
12502,409000438620',2018-08-30,NFS MICRO ATM GST DATED 2,0.0,23.26,17811950.99000005,2018,8,30,TRANSFER,23.26,M642389872
12503,409000438620',2018-08-30,NFS MICRO ATM INC DATED 3,0.0,37.8,17811988.79000005,2018,8,30,TRANSFER,37.8,C79467401
12504,409000438620',2018-08-30,NFS MICRO ATM GST DATED 3,0.0,7.56,17811996.35000005,2018,8,30,CASH_IN,7.56,M1823771636
12505,409000438620',2018-08-31,MAW/502964XXXXXX9692/Karu,0.0,1700.0,17813696.35000005,2018,8,31,TRANSFER,1700.0,M462983860
12506,409000438620',2018-08-31,Indiaforensic AEPS NPCI WDL SET,0.0,11184700.0,28998396.35000005,2018,8,31,TRANSFER,11184700.0,M855103875
12507,409000438620',2018-08-31,TRF TO  Indiaforensic SERVICES I,11300000.0,0.0,17698396.35000005,2018,8,31,DEBIT,11300000.0,M1754733038
12508,409000438620',2018-08-31,MICRO ATM WDL FEE DT30081,0.0,34900.0,17733296.35000005,2018,8,31,CASH_IN,34900.0,M1050557003
12509,409000438620',2018-08-31,NPCI SETELEMENT DIFF_3008,0.0,500.0,17733796.35000005,2018,8,31,CASH_IN,500.0,C36437323
12510,409000438620',2018-08-31,AEPS PAY Indiaforensic 3008,0.0,1188.39,17734984.74000005,2018,8,31,CHECK_CASHING,1188.39,C1964947881
12511,409000438620',2018-08-31,MICRO ATM WDL FEE DT31081,0.0,41000.0,17775984.74000005,2018,8,31,CHECK_CASHING,41000.0,C2110180989
12512,409000438620',2018-08-31,MICRO ATM INC DATED 30081,0.0,98.64,17776083.38000005,2018,8,31,CASH_IN,98.64,C1231842708
12513,409000438620',2018-08-31,MICROATM GST DATED 300818,0.0,19.73,17776103.11000005,2018,8,31,CHECK_CASHING,19.73,C1163480574
12514,409000438620',2018-08-31,AEPS INCOME DT 30-08-2018,0.0,29030.02,17805133.13000005,2018,8,31,TRANSFER,29030.02,M748589334
12515,409000438620',2018-08-31,AEPS GST INC DT 30-08-201,0.0,5806.0,17810939.13000005,2018,8,31,CASH_IN,5806.0,M1464407166
12516,409000438620',2018-08-31,AEPS ACQUIRING ADJ FEES 3,67.85,0.0,17810871.28000005,2018,8,31,DEBIT,67.85,M432186299
12517,409000438620',2018-08-31,MICRO ATM INC DATED 31081,0.0,64.8,17810936.08000005,2018,8,31,CHECK_CASHING,64.8,M121393343
12518,409000438620',2018-08-31,MICRO ATM GST DATED 31081,0.0,12.96,17810949.04000005,2018,8,31,TRANSFER,12.96,C259915853
12519,409000438620',2018-09-01,Indiaforensic AEPS NPCI WDL SET,0.0,11148300.0,28959249.04000005,2018,9,1,CHECK_CASHING,11148300.0,C1640961071
12520,409000438620',2018-09-01,CR823518045609/RMCPL23207/2,500.0,0.0,28958749.04000005,2018,9,1,PAYEMENT,500.0,M428698567
12521,409000438620',2018-09-01,CR823513976917/RMCPL09592/2,3000.0,0.0,28955749.04000005,2018,9,1,DEBIT,3000.0,M139196446
12522,409000438620',2018-09-01,CR823511927139/RMCPL17333/2,1000.0,0.0,28954749.04000005,2018,9,1,PAYEMENT,1000.0,M233191572
12523,409000438620',2018-09-01,CR823513976943/RMCPL11131/2,500.0,0.0,28954249.04000005,2018,9,1,CHECK_WITHDRAWAL,500.0,M1244791828
12524,409000438620',2018-09-01,CR823513976918/RMCPL20650/2,2500.0,0.0,28951749.04000005,2018,9,1,CHECK_WITHDRAWAL,2500.0,M873871680
12525,409000438620',2018-09-01,CR823513976897/RMCPL28457/2,1000.0,0.0,28950749.04000005,2018,9,1,CASH_OUT,1000.0,M125580551
12526,409000438620',2018-09-01,CR823516016429/RMCPL22344/2,10000.0,0.0,28940749.04000005,2018,9,1,DEBIT,10000.0,M1324591555
12527,409000438620',2018-09-01,CR823512956345/RMCPL23829/2,2600.0,0.0,28938149.04000005,2018,9,1,PAYEMENT,2600.0,M1363942249
12528,409000438620',2018-09-01,CR823512956337/RMCPL11018/2,1000.0,0.0,28937149.04000005,2018,9,1,CASH_OUT,1000.0,C283923651
12529,409000438620',2018-09-01,CR823511938871/RMCPL07955/2,2500.0,0.0,28934649.04000005,2018,9,1,CASH_OUT,2500.0,M1512329221
12530,409000438620',2018-09-01,CR823517020223/RMCPL22994/2,2200.0,0.0,28932449.04000005,2018,9,1,CHECK_WITHDRAWAL,2200.0,C208427878
12531,409000438620',2018-09-01,CR823518036160/RMCPL14542/2,800.0,0.0,28931649.04000005,2018,9,1,CASH_OUT,800.0,C1519716618
12532,409000438620',2018-09-01,CR823512947797/RMCPL22994/2,3000.0,0.0,28928649.04000005,2018,9,1,PAYEMENT,3000.0,C1446521801
12533,409000438620',2018-09-01,CR823516016438/RMCPL12283/2,3000.0,0.0,28925649.04000005,2018,9,1,CHECK_WITHDRAWAL,3000.0,C662736689
12534,409000438620',2018-09-01,CR823518031866/RMCPL25522/2,4000.0,0.0,28921649.04000005,2018,9,1,CHECK_WITHDRAWAL,4000.0,C1635341595
12535,409000438620',2018-09-01,CR823518031893/RMCPL07044/2,1000.0,0.0,28920649.04000005,2018,9,1,CHECK_WITHDRAWAL,1000.0,C1373172466
12536,409000438620',2018-09-01,CR823518031865/RMCPL18796/2,1200.0,0.0,28919449.04000005,2018,9,1,PAYEMENT,1200.0,M1724339660
12537,409000438620',2018-09-01,CR823507876926/RMCPL24601/2,3000.0,0.0,28916449.04000005,2018,9,1,CASH_OUT,3000.0,C1948471365
12538,409000438620',2018-09-01,CR823512960793/RMCPL26238/2,3500.0,0.0,28912949.04000005,2018,9,1,PAYEMENT,3500.0,C79708552
12539,409000438620',2018-09-01,CR823914996150/RMCPL22522/2,500.0,0.0,28912449.04000005,2018,9,1,PAYEMENT,500.0,C97730845
12540,409000438620',2018-09-01,CR823916021935/RMCPL16020/2,2000.0,0.0,28910449.04000005,2018,9,1,PAYEMENT,2000.0,C1679546686
12541,409000438620',2018-09-01,CR823911948016/RMCPL22273/2,1000.0,0.0,28909449.04000005,2018,9,1,CHECK_WITHDRAWAL,1000.0,C728526866
12542,409000438620',2018-09-01,CR823911941089/RMCPL22184/2,10000.0,0.0,28899449.04000005,2018,9,1,CASH_OUT,10000.0,C1505755152
12543,409000438620',2018-09-01,CR823911941111/RMCPL22595/2,1000.0,0.0,28898449.04000005,2018,9,1,CHECK_WITHDRAWAL,1000.0,C312537393
12544,409000438620',2018-09-01,CR823911941094/RMCPL25478/2,2500.0,0.0,28895949.04000005,2018,9,1,PAYEMENT,2500.0,C1359484306
12545,409000438620',2018-09-01,CR823911941118/RMCPL21661/2,500.0,0.0,28895449.04000005,2018,9,1,CASH_OUT,500.0,C490150701
12546,409000438620',2018-09-01,CR823916030824/RMCPL25261/2,1100.0,0.0,28894349.04000005,2018,9,1,CASH_OUT,1100.0,C1315729466
12547,409000438620',2018-09-01,CR823918060532/RMCPL23207/2,2100.0,0.0,28892249.04000005,2018,9,1,DEBIT,2100.0,C1040847151
12548,409000438620',2018-09-01,CR823911952800/RMCPL18312/2,900.0,0.0,28891349.04000005,2018,9,1,DEBIT,900.0,C1251686742
12549,409000438620',2018-09-01,CR823711450422/RMCPL19766/2,2000.0,0.0,28889349.04000005,2018,9,1,PAYEMENT,2000.0,C1031639563
12550,409000438620',2018-09-01,CR823711453658/RMCPL21943/2,4000.0,0.0,28885349.04000005,2018,9,1,DEBIT,4000.0,C2006081398
12551,409000438620',2018-09-01,CR823710421563/RMCPL25071/2,1300.0,0.0,28884049.04000005,2018,9,1,PAYEMENT,1300.0,C1759482496
12552,409000438620',2018-09-01,CR823712463895/RMCPL16645/2,1500.0,0.0,28882549.04000005,2018,9,1,CASH_OUT,1500.0,C1501701470
12553,409000438620',2018-09-01,CR823713477054/RMCPL09595/2,5000.0,0.0,28877549.04000005,2018,9,1,CASH_OUT,5000.0,C1538264524
12554,409000438620',2018-09-01,CR823712472806/RMCPL12384/2,2000.0,0.0,28875549.04000005,2018,9,1,CHECK_WITHDRAWAL,2000.0,C8290162
12555,409000438620',2018-09-01,CR823715512468/RMCPL20178/2,1000.0,0.0,28874549.04000005,2018,9,1,CASH_OUT,1000.0,C1938348365
12556,409000438620',2018-09-01,CR823715517046/RMCPL25854/2,1000.0,0.0,28873549.04000005,2018,9,1,PAYEMENT,1000.0,C160284738
12557,409000438620',2018-09-01,CR823715517049/RMCPL18085/2,500.0,0.0,28873049.04000005,2018,9,1,PAYEMENT,500.0,C1679546686
12558,409000438620',2018-09-01,CR823711442489/RMCPL09593/2,1000.0,0.0,28872049.04000005,2018,9,1,DEBIT,1000.0,C1436838899
12559,409000438620',2018-09-01,CR823712465303/RMCPL26560/2,500.0,0.0,28871549.04000005,2018,9,1,CHECK_WITHDRAWAL,500.0,M1633577477
12560,409000438620',2018-09-01,CR823712465299/RMCPL15290/2,10000.0,0.0,28861549.04000005,2018,9,1,DEBIT,10000.0,M226024831
12561,409000438620',2018-09-01,CR823712465315/RMCPL19849/2,1000.0,0.0,28860549.04000005,2018,9,1,CASH_OUT,1000.0,M1007580952
12562,409000438620',2018-09-01,CR823713486078/RMCPL25854/2,2000.0,0.0,28858549.04000005,2018,9,1,CASH_OUT,2000.0,M451652370
12563,409000438620',2018-09-01,CR823714508095/RMCPL21313/2,1000.0,0.0,28857549.04000005,2018,9,1,CASH_OUT,1000.0,C928023753
12564,409000438620',2018-09-01,CR823610149259/RMCPL24446/2,700.0,0.0,28856849.04000005,2018,9,1,PAYEMENT,700.0,M596311901
12565,409000438620',2018-09-01,CR823611165550/RMCPL15176/2,2500.0,0.0,28854349.04000005,2018,9,1,CHECK_WITHDRAWAL,2500.0,M1362699574
12566,409000438620',2018-09-01,CR823613199098/RMCPL09827/2,600.0,0.0,28853749.04000005,2018,9,1,CHECK_WITHDRAWAL,600.0,M388797014
12567,409000438620',2018-09-01,CR823615229413/RMCPL10425/2,2000.0,0.0,28851749.04000005,2018,9,1,PAYEMENT,2000.0,M408270917
12568,409000438620',2018-09-01,CR823613197541/RMCPL21107/2,1200.0,0.0,28850549.04000005,2018,9,1,DEBIT,1200.0,M1331688161
12569,409000438620',2018-09-01,CR823610153396/RMCPL20518/2,2000.0,0.0,28848549.04000005,2018,9,1,CASH_OUT,2000.0,M329682871
12570,409000438620',2018-09-01,CR823613197533/RMCPL21943/2,10000.0,0.0,28838549.04000005,2018,9,1,CASH_OUT,10000.0,M204186372
12571,409000438620',2018-09-01,CR823616247513/RMCPL25813/2,500.0,0.0,28838049.04000005,2018,9,1,PAYEMENT,500.0,C1089993541
12572,409000438620',2018-09-01,CR823612184497/RMCPL00154/2,2000.0,0.0,28836049.04000005,2018,9,1,DEBIT,2000.0,M166948587
12573,409000438620',2018-09-01,CR823611165511/RMCPL24605/2,500.0,0.0,28835549.04000005,2018,9,1,DEBIT,500.0,M283956824
12574,409000438620',2018-09-01,CR823611165547/RMCPL17636/2,2200.0,0.0,28833349.04000005,2018,9,1,CHECK_WITHDRAWAL,2200.0,C1966562224
12575,409000438620',2018-09-01,CR823616249677/RMCPL23000/2,1000.0,0.0,28832349.04000005,2018,9,1,PAYEMENT,1000.0,M1550643491
12576,409000438620',2018-09-01,CR823617256532/RMCPL25071/2,5500.0,0.0,28826849.04000005,2018,9,1,CASH_OUT,5500.0,C2089779261
12577,409000438620',2018-09-01,CR823617256547/RMCPL09794/2,500.0,0.0,28826349.04000005,2018,9,1,CHECK_WITHDRAWAL,500.0,C1450828900
12578,409000438620',2018-09-01,CR823614216207/RMCPL22293/2,2000.0,0.0,28824349.04000005,2018,9,1,CHECK_WITHDRAWAL,2000.0,M916826656
12579,409000438620',2018-09-01,CR823616242585/RMCPL24589/2,500.0,0.0,28823849.04000005,2018,9,1,CHECK_WITHDRAWAL,500.0,M1494697069
12580,409000438620',2018-09-01,CR824010201553/RMCPL14542/2,5000.0,0.0,28818849.04000005,2018,9,1,DEBIT,5000.0,M308924095
12581,409000438620',2018-09-01,CR824013256623/RMCPL20978/2,9000.0,0.0,28809849.04000005,2018,9,1,CASH_OUT,9000.0,C2088104872
12582,409000438620',2018-09-01,CR824011213435/RMCPL21832/2,1500.0,0.0,28808349.04000005,2018,9,1,DEBIT,1500.0,M1063950014
12583,409000438620',2018-09-01,CR824011213447/RMCPL21824/2,1200.0,0.0,28807149.04000005,2018,9,1,CHECK_WITHDRAWAL,1200.0,M1939438059
12584,409000438620',2018-09-01,CR824013249229/RMCPL22278/2,1800.0,0.0,28805349.04000005,2018,9,1,CHECK_WITHDRAWAL,1800.0,C1297342391
12585,409000438620',2018-09-01,CR824014267517/RMCPL26217/2,10000.0,0.0,28795349.04000005,2018,9,1,CHECK_WITHDRAWAL,10000.0,C188246551
12586,409000438620',2018-09-01,CR824010196738/RMCPL12394/2,500.0,0.0,28794849.04000005,2018,9,1,CASH_OUT,500.0,M1570576723
12587,409000438620',2018-09-01,CR824015284584/RMCPL21533/2,1000.0,0.0,28793849.04000005,2018,9,1,DEBIT,1000.0,C908776502
12588,409000438620',2018-09-01,CR824010191912/RMCPL24303/2,2000.0,0.0,28791849.04000005,2018,9,1,CHECK_WITHDRAWAL,2000.0,M1829604769
12589,409000438620',2018-09-01,CR824009171240/RMCPL23569/2,1500.0,0.0,28790349.04000005,2018,9,1,DEBIT,1500.0,C1520941958
12590,409000438620',2018-09-01,TRF TO  Indiaforensic SERVICES I,10000000.0,0.0,18790349.04000005,2018,9,1,CHECK_WITHDRAWAL,10000000.0,C1325626015
12591,409000438620',2018-09-01,TRF TO  Indiaforensic SERVICES I,1000000.0,0.0,17790349.04000005,2018,9,1,CASH_OUT,1000000.0,C1805445027
12592,409000438620',2018-09-01,AEPS INCOME DT 31-08-2018,0.0,29191.23,17819540.27000005,2018,9,1,TRANSFER,29191.23,C1337720486
12593,409000438620',2018-09-01,AEPS GST INC DT 31-08-201,0.0,5838.25,17825378.52000005,2018,9,1,CASH_IN,5838.25,C686592713
12594,409000438620',2018-09-01,AEPS ACQ CR ADJ FEES 3108,701.51,0.0,17824677.01000005,2018,9,1,PAYEMENT,701.51,C929452805
12595,409000438620',2018-09-01,NPCI SETELEMENT DIFF_3108,0.0,500.0,17825177.01000005,2018,9,1,TRANSFER,500.0,C306285887
12596,409000438620',2018-09-01,MICRO ATM WDL FEE DT01091,0.0,20700.0,17845877.01000005,2018,9,1,TRANSFER,20700.0,C105002686
12597,409000438620',2018-09-01,MICRO ATM INC DATED 01091,0.0,49.32,17845926.33000005,2018,9,1,TRANSFER,49.32,C1832580921
12598,409000438620',2018-09-01,MICRO ATM GST DATED 01091,0.0,9.86,17845936.19000005,2018,9,1,CASH_IN,9.86,C811597470
12599,409000438620',2018-09-01,MICRO ATM WDL FEE DT31081,0.0,41700.0,17887636.19000005,2018,9,1,TRANSFER,41700.0,C289045778
12600,409000438620',2018-09-01,MICRO ATM INC DATED 31081,0.0,101.52,17887737.71000005,2018,9,1,CHECK_CASHING,101.52,C1467806809
12601,409000438620',2018-09-01,MICRO ATM GST DATED 31081,0.0,20.3,17887758.01000005,2018,9,1,CASH_IN,20.3,C1849933855
12602,409000438620',2018-09-03,MAW/502964XXXXXX4307/Karu,0.0,1700.0,17889458.01000005,2018,9,3,TRANSFER,1700.0,C2109470512
12603,409000438620',2018-09-03,Indiaforensic AEPS NPCI WDL SET,0.0,10862000.0,28751458.01000005,2018,9,3,TRANSFER,10862000.0,C527175306
12604,409000438620',2018-09-03,Indiaforensic AEPS NPCI WDL SET,0.0,7837500.0,36588958.01000005,2018,9,3,TRANSFER,7837500.0,C1627965794
12605,409000438620',2018-09-03,CB819418940693/RMCPL16717/1,700.0,0.0,36588258.01000005,2018,9,3,PAYEMENT,700.0,C1256732367
12606,409000438620',2018-09-03,TRF TO  Indiaforensic SERVICES I,10000000.0,0.0,26588258.01000005,2018,9,3,DEBIT,10000000.0,C653745564
12607,409000438620',2018-09-03,TRF TO  Indiaforensic SERVICES I,1000000.0,0.0,25588258.01000005,2018,9,3,PAYEMENT,1000000.0,C929856893
12608,409000438620',2018-09-03,TRF TO  Indiaforensic SERVICES I,7800000.0,0.0,17788258.01000005,2018,9,3,CASH_OUT,7800000.0,C1369695156
12609,409000438620',2018-09-03,MAW/502964XXXXXX7658/Karu,0.0,1200.0,17789458.01000005,2018,9,3,CHECK_CASHING,1200.0,C373928166
12610,409000438620',2018-09-03,MICRO ATM WDL FEE DT01091,0.0,62700.0,17852158.01000005,2018,9,3,TRANSFER,62700.0,C728885526
12611,409000438620',2018-09-03,MICRO ATM INC DATED 01091,0.0,114.12,17852272.13000005,2018,9,3,TRANSFER,114.12,C101571284
12612,409000438620',2018-09-03,MICRO ATM GST DATED 01091,0.0,22.82,17852294.95000005,2018,9,3,CHECK_CASHING,22.82,C505973878
12613,409000438620',2018-09-03,MICRO ATM WDL FEE DT02091,0.0,148000.0,18000294.95000005,2018,9,3,TRANSFER,148000.0,C1013700132
12614,409000438620',2018-09-03,MICRO ATM WDL FEE DT03091,0.0,53800.0,18054094.95000005,2018,9,3,CASH_IN,53800.0,C2086207545
12615,409000438620',2018-09-03,MICRO ATM INC DATED 03091,0.0,109.8,18054204.75000005,2018,9,3,TRANSFER,109.8,C1360767589
12616,409000438620',2018-09-03,MICRO ATM GST DATED 03091,0.0,21.96,18054226.710000053,2018,9,3,CASH_IN,21.96,C1635341595
12617,409000438620',2018-09-03,AEPS INCOME DT 01-09-2018,0.0,28462.19,18082688.90000005,2018,9,3,CHECK_CASHING,28462.19,C875761527
12618,409000438620',2018-09-03,AEPS GST INC DT 01-09-201,0.0,5692.44,18088381.340000056,2018,9,3,CHECK_CASHING,5692.44,C935612756
12619,409000438620',2018-09-03,AEPS INCOME DT 02-09-2018,0.0,20682.67,18109064.010000054,2018,9,3,CASH_IN,20682.67,C2040603986
12620,409000438620',2018-09-03,AEPS GST INC DT 02-09-201,0.0,4136.53,18113200.54000006,2018,9,3,TRANSFER,4136.53,C1220911229
12621,409000438620',2018-09-03,AEPS ACQUIRING ADJ FEES 0,20.06,0.0,18113180.48000006,2018,9,3,PAYEMENT,20.06,C374625527
12622,409000438620',2018-09-04,MAW/502964XXXXXX3430/Karu,0.0,2000.0,18115180.48000006,2018,9,4,CASH_IN,2000.0,C1583408697
12623,409000438620',2018-09-04,MAW/502964XXXXXX7517/NAGA,0.0,700.0,18115880.48000006,2018,9,4,CHECK_CASHING,700.0,C2137734988
12624,409000438620',2018-09-04,Indiaforensic AEPS NPCI WDL SET,0.0,11183700.0,29299580.48000006,2018,9,4,CASH_IN,11183700.0,C1786622318
12625,409000438620',2018-09-04,CR824310995528/RMCPL14572/3,1000.0,0.0,29298580.48000006,2018,9,4,DEBIT,1000.0,C2096900616
12626,409000438620',2018-09-04,CR824319127866/RMCPL15696/3,10000.0,0.0,29288580.48000006,2018,9,4,CHECK_WITHDRAWAL,10000.0,C1722141669
12627,409000438620',2018-09-04,CR824309984275/RMCPL23387/3,4000.0,0.0,29284580.48000006,2018,9,4,DEBIT,4000.0,C875761527
12628,409000438620',2018-09-04,CR824309984323/RMCPL23345/3,1000.0,0.0,29283580.48000006,2018,9,4,CHECK_WITHDRAWAL,1000.0,C70895366
12629,409000438620',2018-09-04,CR824309979998/RMCPL24446/3,700.0,0.0,29282880.48000006,2018,9,4,PAYEMENT,700.0,C1887692104
12630,409000438620',2018-09-04,CR824309979995/RMCPL16755/3,1200.0,0.0,29281680.48000006,2018,9,4,CASH_OUT,1200.0,C1676792692
12631,409000438620',2018-09-04,CR824309979982/RMCPL11699/3,1000.0,0.0,29280680.48000006,2018,9,4,DEBIT,1000.0,C996907393
12632,409000438620',2018-09-04,CR824317102915/RMCPL16250/3,1000.0,0.0,29279680.48000006,2018,9,4,CASH_OUT,1000.0,C1315729466
12633,409000438620',2018-09-04,CR824308970329/RMCPL15326/3,800.0,0.0,29278880.48000006,2018,9,4,CHECK_WITHDRAWAL,800.0,C2078011503
12634,409000438620',2018-09-04,CR824308970324/RMCPL18858/3,1000.0,0.0,29277880.48000006,2018,9,4,PAYEMENT,1000.0,C1998750048
12635,409000438620',2018-09-04,CR824312018914/RMCPL21313/3,2000.0,0.0,29275880.48000006,2018,9,4,CHECK_WITHDRAWAL,2000.0,C1242584406
12636,409000438620',2018-09-04,CR824310995435/RMCPL15326/3,2000.0,0.0,29273880.48000006,2018,9,4,PAYEMENT,2000.0,C1834186423
12637,409000438620',2018-09-04,CR824317097322/RMCPL26695/3,10000.0,0.0,29263880.48000006,2018,9,4,CHECK_WITHDRAWAL,10000.0,C836514715
12638,409000438620',2018-09-04,CR824309979976/RMCPL24066/3,1000.0,0.0,29262880.48000006,2018,9,4,CHECK_WITHDRAWAL,1000.0,C1570256460
12639,409000438620',2018-09-04,CR824310991201/RMCPL23561/3,3500.0,0.0,29259380.48000006,2018,9,4,DEBIT,3500.0,M1100877541
12640,409000438620',2018-09-04,CR824311005493/RMCPL25499/3,600.0,0.0,29258780.48000006,2018,9,4,PAYEMENT,600.0,M1277863131
12641,409000438620',2018-09-04,CR824311011054/RMCPL18466/3,5000.0,0.0,29253780.48000006,2018,9,4,DEBIT,5000.0,M285255926
12642,409000438620',2018-09-04,CR824318121405/RMCPL11592/3,2600.0,0.0,29251180.48000006,2018,9,4,CASH_OUT,2600.0,M1767728846
12643,409000438620',2018-09-04,CR824311005477/RMCPL24364/3,1700.0,0.0,29249480.48000006,2018,9,4,CHECK_WITHDRAWAL,1700.0,M506263545
12644,409000438620',2018-09-04,CR824311008538/RMCPL07903/3,1000.0,0.0,29248480.48000006,2018,9,4,CHECK_WITHDRAWAL,1000.0,M746463182
12645,409000438620',2018-09-04,CR824311009492/RMCPL17729/3,2000.0,0.0,29246480.48000006,2018,9,4,CHECK_WITHDRAWAL,2000.0,M576123201
12646,409000438620',2018-09-04,CR824312022540/RMCPL22489/3,3600.0,0.0,29242880.48000006,2018,9,4,PAYEMENT,3600.0,M1798726228
12647,409000438620',2018-09-04,CR824318114147/RMCPL19805/3,8000.0,0.0,29234880.48000006,2018,9,4,DEBIT,8000.0,M1204653436
12648,409000438620',2018-09-04,CR824311014176/RMCPL28330/3,500.0,0.0,29234380.48000006,2018,9,4,DEBIT,500.0,M2086706755
12649,409000438620',2018-09-04,CR824311004289/RMCPL12219/3,500.0,0.0,29233880.48000006,2018,9,4,DEBIT,500.0,M545966520
12650,409000438620',2018-09-04,MAW/502964XXXXXX6016/Akol,0.0,2100.0,29235980.48000006,2018,9,4,CHECK_CASHING,2100.0,M534345488
12651,409000438620',2018-09-04,TRF TO  Indiaforensic SERVICES I,10000000.0,0.0,19235980.48000006,2018,9,4,CASH_OUT,10000000.0,C988705496
12652,409000438620',2018-09-04,TRF TO  Indiaforensic SERVICES I,1000000.0,0.0,18235980.48000006,2018,9,4,PAYEMENT,1000000.0,M653544266
12653,409000438620',2018-09-04,MAW/502964XXXXXX2262/Karu,0.0,1800.0,18237780.48000006,2018,9,4,CHECK_CASHING,1800.0,M1127283004
12654,409000438620',2018-09-04,MICRO ATM WDL FEE DT03091,0.0,108300.0,18346080.48000006,2018,9,4,CASH_IN,108300.0,C1178471274
12655,409000438620',2018-09-04,MICRO ATM INC DATED 03091,0.0,249.48,18346329.96000006,2018,9,4,CHECK_CASHING,249.48,M1921907255
12656,409000438620',2018-09-04,MICRO ATM GST DATED 03091,0.0,49.9,18346379.86000006,2018,9,4,CHECK_CASHING,49.9,M809597256
12657,409000438620',2018-09-04,CB823716534065/RMCPL24609/2,3500.0,0.0,18342879.86000006,2018,9,4,DEBIT,3500.0,M2049630450
12658,409000438620',2018-09-04,CB823613210175/RMCPL09615/2,500.0,0.0,18342379.86000006,2018,9,4,DEBIT,500.0,M2000575000
12659,409000438620',2018-09-04,CB823611175202/RMCPL22042/2,10000.0,0.0,18332379.86000006,2018,9,4,CASH_OUT,10000.0,M1660836554
12660,409000438620',2018-09-04,CB823612184507/RMCPL19298/2,3000.0,0.0,18329379.86000006,2018,9,4,DEBIT,3000.0,C843467284
12661,409000438620',2018-09-04,TRF TO  Indiaforensic SERVICES I,500000.0,0.0,17829379.86000006,2018,9,4,PAYEMENT,500000.0,M1662726002
12662,409000438620',2018-09-04,AEPS PAY Indiaforensic 0309,0.0,199.58,17829579.440000053,2018,9,4,TRANSFER,199.58,M153840495
12663,409000438620',2018-09-04,AEPS PAY Indiaforensic 0109,0.0,548.57,17830128.010000058,2018,9,4,CASH_IN,548.57,C381605910
12664,409000438620',2018-09-04,AEPS PAY Indiaforensic 3108,0.0,100.64,17830228.650000058,2018,9,4,TRANSFER,100.64,C1283595719
12665,409000438620',2018-09-04,MICRO ATM WDL FEE DT04091,0.0,124800.0,17955028.650000058,2018,9,4,TRANSFER,124800.0,M785725353
12666,409000438620',2018-09-04,AEPS INCOME DT 03-09-2018,0.0,29912.45,17984941.100000054,2018,9,4,TRANSFER,29912.45,C1021790512
12667,409000438620',2018-09-04,AEPS GST INC DT 03-09-201,0.0,5982.49,17990923.590000056,2018,9,4,TRANSFER,5982.49,C1647754924
12668,409000438620',2018-09-04,AEPS ACQ CR ADJ FEES 0309,251.34,0.0,17990672.250000056,2018,9,4,CASH_OUT,251.34,C320919849
12669,409000438620',2018-09-04,AEPS ACQ REP ADJ FEES 030,0.0,58.41,17990730.660000056,2018,9,4,CASH_IN,58.41,C787028959
12670,409000438620',2018-09-04,MICROATM INC DATED040918_,0.0,229.68,17990960.340000056,2018,9,4,CASH_IN,229.68,C1014154376
12671,409000438620',2018-09-04,MICROATM GST DATED040918_,0.0,45.94,17991006.280000053,2018,9,4,CASH_IN,45.94,C75629578
12672,409000438620',2018-09-05,MAW/502964XXXXXX1825/NAGA,0.0,800.0,17991806.280000053,2018,9,5,TRANSFER,800.0,C1419794148
12673,409000438620',2018-09-05,MAW/502964XXXXXX2475/Karu,0.0,1700.0,17993506.280000053,2018,9,5,TRANSFER,1700.0,C1495724689
12674,409000438620',2018-09-05,Indiaforensic AEPS NPCI WDL SET,0.0,11870700.0,29864206.28000005,2018,9,5,TRANSFER,11870700.0,C2017484544
12675,409000438620',2018-09-05,CR824415350479/RMCPL17511/0,2100.0,0.0,29862106.28000005,2018,9,5,PAYEMENT,2100.0,C1348373832
12676,409000438620',2018-09-05,CR824411288703/RMCPL16831/0,1000.0,0.0,29861106.28000005,2018,9,5,DEBIT,1000.0,C1927159174
12677,409000438620',2018-09-05,CR824417372409/RMCPL23861/0,1300.0,0.0,29859806.28000005,2018,9,5,CASH_OUT,1300.0,C242131142
12678,409000438620',2018-09-05,CR824417372414/RMCPL13888/0,2600.0,0.0,29857206.28000005,2018,9,5,CASH_OUT,2600.0,C1949485879
12679,409000438620',2018-09-05,CR824410261581/RMCPL16660/0,4000.0,0.0,29853206.28000005,2018,9,5,DEBIT,4000.0,C465499079
12680,409000438620',2018-09-05,CR824410261780/RMCPL16774/0,1500.0,0.0,29851706.28000005,2018,9,5,CASH_OUT,1500.0,M335552439
12681,409000438620',2018-09-05,CR824410276617/RMCPL14573/0,500.0,0.0,29851206.28000005,2018,9,5,DEBIT,500.0,M539734147
12682,409000438620',2018-09-05,CR824411293186/RMCPL21339/0,10000.0,0.0,29841206.28000005,2018,9,5,CASH_OUT,10000.0,C711248671
12683,409000438620',2018-09-05,TRF TO  Indiaforensic SERVICES I,12100000.0,0.0,17741206.280000053,2018,9,5,PAYEMENT,12100000.0,M336043742
12684,409000438620',2018-09-05,AEPS ACQUIRING ADJ FEES 0,2.95,0.0,17741203.330000058,2018,9,5,CASH_OUT,2.95,M44323070
12685,409000438620',2018-09-05,AEPS ACQ CR ADJ FEES 0409,88.5,0.0,17741114.830000058,2018,9,5,CHECK_WITHDRAWAL,88.5,M535385832
12686,409000438620',2018-09-05,AEPS ACQ REP ADJ FEES 040,0.0,20.06,17741134.890000056,2018,9,5,TRANSFER,20.06,M2049011801
12687,409000438620',2018-09-05,MICRO ATM WDL FEE DT04091,0.0,98300.0,17839434.890000056,2018,9,5,CASH_IN,98300.0,M517364889
12688,409000438620',2018-09-05,MICROATM INCDATED040918_1,0.0,250.92,17839685.81000006,2018,9,5,CASH_IN,250.92,M573165182
12689,409000438620',2018-09-05,MICROATM GST DATED040918_,0.0,50.18,17839735.990000058,2018,9,5,CHECK_CASHING,50.18,M757183584
12690,409000438620',2018-09-05,AEPS INCOME DT 04-09-2018,0.0,30950.0,17870685.990000058,2018,9,5,TRANSFER,30950.0,M1285429806
12691,409000438620',2018-09-05,AEPS GST INC DT 04-09-201,0.0,6190.0,17876875.990000058,2018,9,5,TRANSFER,6190.0,M359193816
12692,409000438620',2018-09-05,MICRO ATM WDL FEE DT05091,0.0,54400.0,17931275.990000058,2018,9,5,TRANSFER,54400.0,M1241754806
12693,409000438620',2018-09-05,MICRO ATM INC DATED 05091,0.0,113.04,17931389.030000053,2018,9,5,CASH_IN,113.04,M2073254346
12694,409000438620',2018-09-05,MICRO ATM GST DATED 05091,0.0,22.61,17931411.640000056,2018,9,5,CHECK_CASHING,22.61,M1578701804
12695,409000438620',2018-09-06,MAW/502964XXXXXX1989/NAGA,0.0,900.0,17932311.640000056,2018,9,6,TRANSFER,900.0,M1640334482
12696,409000438620',2018-09-06,Indiaforensic AEPS NPCI WDL SET,0.0,11126400.0,29058711.640000056,2018,9,6,TRANSFER,11126400.0,M1039426522
12697,409000438620',2018-09-06,CR824611720052/RMCPL05229/0,2000.0,0.0,29056711.640000056,2018,9,6,CASH_OUT,2000.0,M1047385204
12698,409000438620',2018-09-06,CR824611720069/RMCPL22640/0,1000.0,0.0,29055711.640000056,2018,9,6,DEBIT,1000.0,M795552257
12699,409000438620',2018-09-06,CR824610700151/RMCPL17766/0,1000.0,0.0,29054711.640000056,2018,9,6,DEBIT,1000.0,M95608124
12700,409000438620',2018-09-06,CR824610710829/RMCPL19251/0,1200.0,0.0,29053511.640000056,2018,9,6,PAYEMENT,1200.0,M964740518
12701,409000438620',2018-09-06,CR824611728573/RMCPL15429/0,500.0,0.0,29053011.640000056,2018,9,6,DEBIT,500.0,M473841749
12702,409000438620',2018-09-06,CR824614767105/RMCPL24098/0,2000.0,0.0,29051011.640000056,2018,9,6,CASH_OUT,2000.0,M48975847
12703,409000438620',2018-09-06,CR824617800610/RMCPL12739/0,1400.0,0.0,29049611.640000056,2018,9,6,DEBIT,1400.0,M1380757593
12704,409000438620',2018-09-06,CR824612744613/RMCPL16204/0,2500.0,0.0,29047111.640000056,2018,9,6,DEBIT,2500.0,M2139913275
12705,409000438620',2018-09-06,CR824612744619/RMCPL20757/0,700.0,0.0,29046411.640000056,2018,9,6,DEBIT,700.0,M121572687
12706,409000438620',2018-09-06,CR824612744620/RMCPL26216/0,500.0,0.0,29045911.640000056,2018,9,6,CASH_OUT,500.0,M947345911
12707,409000438620',2018-09-06,CR824612744617/RMCPL18214/0,500.0,0.0,29045411.640000056,2018,9,6,DEBIT,500.0,M1123375379
12708,409000438620',2018-09-06,CR824113527057/RMCPL27717/2,2000.0,0.0,29043411.640000056,2018,9,6,PAYEMENT,2000.0,M1358886719
12709,409000438620',2018-09-06,CR824109459591/RMCPL25478/2,800.0,0.0,29042611.640000056,2018,9,6,PAYEMENT,800.0,M2118538972
12710,409000438620',2018-09-06,CR824109453068/RMCPL21235/2,10000.0,0.0,29032611.640000056,2018,9,6,PAYEMENT,10000.0,M775314387
12711,409000438620',2018-09-06,CR824117592543/RMCPL25689/2,5000.0,0.0,29027611.640000056,2018,9,6,PAYEMENT,5000.0,M1775505750
12712,409000438620',2018-09-06,CR824115564885/RMCPL16204/2,500.0,0.0,29027111.640000056,2018,9,6,PAYEMENT,500.0,C716083600
12713,409000438620',2018-09-06,CR824111490964/RMCPL16430/2,2500.0,0.0,29024611.640000056,2018,9,6,CASH_OUT,2500.0,C1435804085
12714,409000438620',2018-09-06,CR824113541270/RMCPL17417/2,1000.0,0.0,29023611.640000056,2018,9,6,DEBIT,1000.0,M1658678197
12715,409000438620',2018-09-06,CR824111500621/RMCPL26112/2,10000.0,0.0,29013611.640000056,2018,9,6,CHECK_WITHDRAWAL,10000.0,M1595677101
12716,409000438620',2018-09-06,CR824110480790/RMCPL20610/2,2200.0,0.0,29011411.640000056,2018,9,6,CHECK_WITHDRAWAL,2200.0,M690577230
12717,409000438620',2018-09-06,CR824110480784/RMCPL17641/2,1300.0,0.0,29010111.640000056,2018,9,6,CASH_OUT,1300.0,M805659726
12718,409000438620',2018-09-06,CR824115559927/RMCPL11838/2,10000.0,0.0,29000111.640000056,2018,9,6,CASH_OUT,10000.0,M1936983523
12719,409000438620',2018-09-06,CR824116580810/RMCPL23323/2,500.0,0.0,28999611.640000056,2018,9,6,PAYEMENT,500.0,M970539353
12720,409000438620',2018-09-06,CR824112510230/RMCPL22133/2,1000.0,0.0,28998611.640000056,2018,9,6,CASH_OUT,1000.0,M1576973027
12721,409000438620',2018-09-06,CR824112510209/RMCPL24552/2,5200.0,0.0,28993411.640000056,2018,9,6,DEBIT,5200.0,C1782704802
12722,409000438620',2018-09-06,CR824117596300/RMCPL22588/2,2500.0,0.0,28990911.640000056,2018,9,6,CASH_OUT,2500.0,M518066455
12723,409000438620',2018-09-06,CR824109459569/RMCPL20307/2,10000.0,0.0,28980911.640000056,2018,9,6,CASH_OUT,10000.0,M1708653507
12724,409000438620',2018-09-06,CR824215837579/RMCPL23034/3,1000.0,0.0,28979911.640000056,2018,9,6,CHECK_WITHDRAWAL,1000.0,M1368183192
12725,409000438620',2018-09-06,CR824210750155/RMCPL22489/3,3600.0,0.0,28976311.640000056,2018,9,6,PAYEMENT,3600.0,M994263288
12726,409000438620',2018-09-06,CR824210750143/RMCPL26808/3,600.0,0.0,28975711.640000056,2018,9,6,DEBIT,600.0,C495071437
12727,409000438620',2018-09-06,CR824212775778/RMCPL20057/3,3000.0,0.0,28972711.640000056,2018,9,6,DEBIT,3000.0,C1220897602
12728,409000438620',2018-09-06,CR824211766673/RMCPL23688/3,10000.0,0.0,28962711.640000056,2018,9,6,CHECK_WITHDRAWAL,10000.0,C1527761090
12729,409000438620',2018-09-06,CR824213795302/RMCPL22640/3,2000.0,0.0,28960711.640000056,2018,9,6,PAYEMENT,2000.0,C1894575391
12730,409000438620',2018-09-06,CR824208718148/RMCPL13815/3,5100.0,0.0,28955611.640000056,2018,9,6,DEBIT,5100.0,M425754658
12731,409000438620',2018-09-06,CR824208718149/RMCPL21810/3,500.0,0.0,28955111.640000056,2018,9,6,CASH_OUT,500.0,M379498606
12732,409000438620',2018-09-06,CR824217856842/RMCPL11793/3,500.0,0.0,28954611.640000056,2018,9,6,CHECK_WITHDRAWAL,500.0,C2006206648
12733,409000438620',2018-09-06,CR824210741048/RMCPL19766/3,8900.0,0.0,28945711.640000056,2018,9,6,CHECK_WITHDRAWAL,8900.0,C650657798
12734,409000438620',2018-09-06,TRF TO  Indiaforensic SERVICES I,11200000.0,0.0,17745711.640000056,2018,9,6,CASH_OUT,11200000.0,M659134474
12735,409000438620',2018-09-06,MAW/502964XXXXXX3513/Karu,0.0,2000.0,17747711.640000056,2018,9,6,TRANSFER,2000.0,M1563320404
12736,409000438620',2018-09-06,MICRO ATM WDL FEE DT05091,0.0,74300.0,17822011.640000056,2018,9,6,TRANSFER,74300.0,M1215053117
12737,409000438620',2018-09-06,MICRO ATM INC DATED 05091,0.0,198.72,17822210.360000055,2018,9,6,TRANSFER,198.72,M1542809092
12738,409000438620',2018-09-06,MICRO ATM GST DATED 05091,0.0,39.74,17822250.100000054,2018,9,6,TRANSFER,39.74,M574848617
12739,409000438620',2018-09-06,MICRO ATM WDL FEE DT06091,0.0,88200.0,17910450.100000054,2018,9,6,CASH_IN,88200.0,C564742142
12740,409000438620',2018-09-06,AEPS INCOME DT 05-09-2018,0.0,29020.73,17939470.830000054,2018,9,6,CASH_IN,29020.73,C1790831319
12741,409000438620',2018-09-06,AEPS GST INC DT 05-09-201,0.0,5804.15,17945274.980000053,2018,9,6,CHECK_CASHING,5804.15,M1350734194
12742,409000438620',2018-09-06,AEPS ACQ CR ADJ FEES 0509,384.68,0.0,17944890.300000053,2018,9,6,DEBIT,384.68,C1028574311
12743,409000438620',2018-09-06,MICRO ATM INC DATED 06091,0.0,187.92,17945078.220000055,2018,9,6,CHECK_CASHING,187.92,M1039147594
12744,409000438620',2018-09-06,MICRO ATM GST DATED 06091,0.0,37.58,17945115.800000053,2018,9,6,TRANSFER,37.58,C1562946595
12745,409000438620',2018-09-07,Indiaforensic AEPS NPCI WDL SET,0.0,8840500.0,26785615.80000005,2018,9,7,TRANSFER,8840500.0,C1935365522
12746,409000438620',2018-09-07,MAW/502964XXXXXX6863/Akol,0.0,7000.0,26792615.80000005,2018,9,7,TRANSFER,7000.0,C665639335
12747,409000438620',2018-09-07,TRF TO  Indiaforensic SERVICES I,9000000.0,0.0,17792615.800000053,2018,9,7,PAYEMENT,9000000.0,C929452805
12748,409000438620',2018-09-07,MICRO ATM WDL FEE DT06091,0.0,144700.0,17937315.800000053,2018,9,7,TRANSFER,144700.0,C329829198
12749,409000438620',2018-09-07,MICRO ATM INC DATED 06091,0.0,342.0,17937657.800000053,2018,9,7,CASH_IN,342.0,C435161028
12750,409000438620',2018-09-07,MICRO ATM GST DATED 06091,0.0,68.4,17937726.20000005,2018,9,7,CASH_IN,68.4,C256516555
12751,409000438620',2018-09-07,MICRO ATM WDL FEE DT07091,0.0,91300.0,18029026.20000005,2018,9,7,CASH_IN,91300.0,C116289363
12752,409000438620',2018-09-07,MICRO ATM INC DATED 07091,0.0,202.32,18029228.52000005,2018,9,7,CASH_IN,202.32,C648021642
12753,409000438620',2018-09-07,MICRO ATM GST DATED 07091,0.0,40.46,18029268.980000053,2018,9,7,TRANSFER,40.46,C1629709129
12754,409000438620',2018-09-07,AEPS INCOME DT 06-09-2018,0.0,23325.35,18052594.330000054,2018,9,7,CASH_IN,23325.35,C1805162633
12755,409000438620',2018-09-07,AEPS GST INC DT 06-09-201,0.0,4665.07,18057259.40000005,2018,9,7,CASH_IN,4665.07,C943166837
12756,409000438620',2018-09-07,AEPS ACQUIRING ADJ FEES 0,35.4,0.0,18057224.000000056,2018,9,7,CHECK_WITHDRAWAL,35.4,C141458554
12757,409000438620',2018-09-07,AEPS ACQ REP ADJ FEES 060,0.0,2.95,18057226.95000005,2018,9,7,CHECK_CASHING,2.95,C911380925
12758,409000438620',2018-09-07,AEPS PAY Indiaforensic 0609,0.0,148.62,18057375.570000056,2018,9,7,CHECK_CASHING,148.62,C586009238
12759,409000438620',2018-09-07,TRF TO  Indiaforensic SERVICES I,300000.0,0.0,17757375.570000056,2018,9,7,CASH_OUT,300000.0,C115457323
12760,409000438620',2018-09-08,MAW/502964XXXXXX4820/Karu,0.0,1700.0,17759075.570000056,2018,9,8,CHECK_CASHING,1700.0,M1991554431
12761,409000438620',2018-09-10,MAW/502964XXXXXX8257/Karu,0.0,1700.0,17760775.570000056,2018,9,10,CHECK_CASHING,1700.0,C1379289710
12762,409000438620',2018-09-10,Indiaforensic AEPS NPCI WDL SET,0.0,10038000.0,27798775.570000056,2018,9,10,CASH_IN,10038000.0,C458582664
12763,409000438620',2018-09-10,MICRO ATM WDL FEE DT07091,0.0,208900.0,28007675.570000056,2018,9,10,TRANSFER,208900.0,C47827984
12764,409000438620',2018-09-10,MICRO ATM INC DATED 07091,0.0,520.56,28008196.13000005,2018,9,10,CASH_IN,520.56,C884262954
12765,409000438620',2018-09-10,MICRO ATM GST DATED 07091,0.0,104.11,28008300.24000005,2018,9,10,CASH_IN,104.11,C1531333864
12766,409000438620',2018-09-10,TRF TO  Indiaforensic SERVICES I,2000000.0,0.0,26008300.24000005,2018,9,10,CHECK_WITHDRAWAL,2000000.0,M461531682
12767,409000438620',2018-09-10,TRF TO  Indiaforensic SERVICES I,4000000.0,0.0,22008300.240000054,2018,9,10,DEBIT,4000000.0,C1450828900
12768,409000438620',2018-09-10,TRF TO  Indiaforensic SERVICES I,4000000.0,0.0,18008300.240000054,2018,9,10,CASH_OUT,4000000.0,C1870252780
12769,409000438620',2018-09-10,Indiaforensic AEPS NPCI WDL SET,0.0,11184700.0,29193000.24000005,2018,9,10,CHECK_CASHING,11184700.0,M1651133690
12770,409000438620',2018-09-10,Indiaforensic AEPS NPCI WDL SET,0.0,6852900.0,36045900.24000005,2018,9,10,TRANSFER,6852900.0,C2144647660
12771,409000438620',2018-09-10,TRF TO  Indiaforensic SERVICES I,3000000.0,0.0,33045900.24000005,2018,9,10,DEBIT,3000000.0,M279239794
12772,409000438620',2018-09-10,TRF TO  Indiaforensic SERVICES I,15000000.0,0.0,18045900.240000054,2018,9,10,CASH_OUT,15000000.0,M301868544
12773,409000438620',2018-09-10,MICRO ATM WDL FEE DT10091,0.0,217300.0,18263200.240000054,2018,9,10,TRANSFER,217300.0,C1731824557
12774,409000438620',2018-09-10,MICRO ATM INC DATED 10091,0.0,448.92,18263649.160000056,2018,9,10,CHECK_CASHING,448.92,M52330324
12775,409000438620',2018-09-10,MICRO ATM GST DATED 10091,0.0,89.78,18263738.940000053,2018,9,10,CHECK_CASHING,89.78,M516852888
12776,409000438620',2018-09-10,AEPS PAY Indiaforensic 0709,0.0,398.46,18264137.40000005,2018,9,10,CASH_IN,398.46,C1137350304
12777,409000438620',2018-09-10,MICRO ATM WDL FEE DT08091,0.0,384100.0,18648237.40000005,2018,9,10,CHECK_CASHING,384100.0,C1027017168
12778,409000438620',2018-09-10,MICRO ATM INC DATED 08091,0.0,861.84,18649099.240000054,2018,9,10,TRANSFER,861.84,M541237871
12779,409000438620',2018-09-10,MICRO ATM GST DATED 08091,0.0,172.37,18649271.61000006,2018,9,10,CHECK_CASHING,172.37,M1896264985
12780,409000438620',2018-09-10,MICRO ATM WDL FEE DT09091,0.0,456900.0,19106171.61000006,2018,9,10,CHECK_CASHING,456900.0,C1698704934
12781,409000438620',2018-09-10,MICRO ATM INC DATED 09091,0.0,927.0,19107098.61000006,2018,9,10,CASH_IN,927.0,C187649742
12782,409000438620',2018-09-10,MICRO ATM GST DATED 09091,0.0,185.4,19107284.010000054,2018,9,10,TRANSFER,185.4,M2140413786
12783,409000438620',2018-09-10,AEPS INCOME DT 07-09-2018,0.0,26112.81,19133396.820000056,2018,9,10,TRANSFER,26112.81,M1855295276
12784,409000438620',2018-09-10,AEPS GST INC DT 07-09-201,0.0,5222.56,19138619.38000005,2018,9,10,TRANSFER,5222.56,C683605346
12785,409000438620',2018-09-10,AEPS INCOME DT 08-09-2018,0.0,29379.12,19167998.500000056,2018,9,10,CHECK_CASHING,29379.12,M1718453229
12786,409000438620',2018-09-10,AEPS GST INC DT 08-09-201,0.0,5875.82,19173874.320000056,2018,9,10,CHECK_CASHING,5875.82,M1691377154
12787,409000438620',2018-09-10,AEPS INCOME DT 09-09-2018,0.0,17798.99,19191673.31000005,2018,9,10,CASH_IN,17798.99,C1504109395
12788,409000438620',2018-09-10,AEPS GST INC DT 09-09-201,0.0,3559.8,19195233.11000005,2018,9,10,CASH_IN,3559.8,C451111351
12789,409000438620',2018-09-10,TRF TO  Indiaforensic SERVICES I,500000.0,0.0,18695233.11000005,2018,9,10,PAYEMENT,500000.0,C1916720513
12790,409000438620',2018-09-11,Indiaforensic AEPS NPCI WDL SET,0.0,9000600.0,27695833.11000005,2018,9,11,CASH_IN,9000600.0,C1360767589
12791,409000438620',2018-09-11,CR824915504362/RMCPL13597/0,3000.0,0.0,27692833.11000005,2018,9,11,CASH_OUT,3000.0,C1635341595
12792,409000438620',2018-09-11,CR824914481588/RMCPL22184/0,1900.0,0.0,27690933.11000005,2018,9,11,DEBIT,1900.0,C861720625
12793,409000438620',2018-09-11,CR824911443269/RMCPL14047/0,1500.0,0.0,27689433.11000005,2018,9,11,PAYEMENT,1500.0,C1945802665
12794,409000438620',2018-09-11,CR824918539773/RMCPL24700/0,1000.0,0.0,27688433.11000005,2018,9,11,PAYEMENT,1000.0,C1266035080
12795,409000438620',2018-09-11,CR824911431110/RMCPL22700/0,4000.0,0.0,27684433.11000005,2018,9,11,CASH_OUT,4000.0,C1982828534
12796,409000438620',2018-09-11,CR824911431137/RMCPL23936/0,1500.0,0.0,27682933.11000005,2018,9,11,PAYEMENT,1500.0,C287711177
12797,409000438620',2018-09-11,CR824918539790/RMCPL14382/0,500.0,0.0,27682433.11000005,2018,9,11,CASH_OUT,500.0,C1870252780
12798,409000438620',2018-09-11,CR824918539781/RMCPL22362/0,4500.0,0.0,27677933.11000005,2018,9,11,PAYEMENT,4500.0,C1487669283
12799,409000438620',2018-09-11,CR824911438777/RMCPL24255/0,500.0,0.0,27677433.11000005,2018,9,11,DEBIT,500.0,C872592585
12800,409000438620',2018-09-11,CR824915497356/RMCPL18216/0,1000.0,0.0,27676433.11000005,2018,9,11,DEBIT,1000.0,C2083562754
12801,409000438620',2018-09-11,CR824917524814/RMCPL24821/0,500.0,0.0,27675933.11000005,2018,9,11,PAYEMENT,500.0,C2103065350
12802,409000438620',2018-09-11,CR824913464067/RMCPL18569/0,2000.0,0.0,27673933.11000005,2018,9,11,PAYEMENT,2000.0,C1945802665
12803,409000438620',2018-09-11,CR824913464073/RMCPL16256/0,5000.0,0.0,27668933.11000005,2018,9,11,CASH_OUT,5000.0,M845354266
12804,409000438620',2018-09-11,CR824913464079/RMCPL19691/0,500.0,0.0,27668433.11000005,2018,9,11,DEBIT,500.0,M34261895
12805,409000438620',2018-09-11,CR824913468174/RMCPL15500/0,6000.0,0.0,27662433.11000005,2018,9,11,CHECK_WITHDRAWAL,6000.0,C1554565380
12806,409000438620',2018-09-11,CR824917521115/RMCPL26552/0,1000.0,0.0,27661433.11000005,2018,9,11,DEBIT,1000.0,C295081230
12807,409000438620',2018-09-11,CR824915497383/RMCPL25341/0,1500.0,0.0,27659933.11000005,2018,9,11,PAYEMENT,1500.0,M135940264
12808,409000438620',2018-09-11,CR824916504630/RMCPL22344/0,1000.0,0.0,27658933.11000005,2018,9,11,CHECK_WITHDRAWAL,1000.0,M719448032
12809,409000438620',2018-09-11,TRF TO  Indiaforensic SERVICES I,1000000.0,0.0,26658933.11000005,2018,9,11,CASH_OUT,1000000.0,M1800738791
12810,409000438620',2018-09-11,TRF TO  Indiaforensic SERVICES I,5000000.0,0.0,21658933.11000005,2018,9,11,PAYEMENT,5000000.0,M2075113762
12811,409000438620',2018-09-11,TRF TO  Indiaforensic SERVICES I,4000000.0,0.0,17658933.110000055,2018,9,11,CHECK_WITHDRAWAL,4000000.0,M190195539
12812,409000438620',2018-09-11,AEPS PAY Indiaforensic 1009,0.0,1718.4,17660651.510000054,2018,9,11,TRANSFER,1718.4,M2009534362
12813,409000438620',2018-09-11,MICRO ATM WDL FEE DT11091,0.0,250500.0,17911151.510000054,2018,9,11,TRANSFER,250500.0,M2055545547
12814,409000438620',2018-09-11,MICRO ATM INC DATED 11091,0.0,610.56,17911762.070000052,2018,9,11,CHECK_CASHING,610.56,M2062057406
12815,409000438620',2018-09-11,MICRO ATM GST DATED 11091,0.0,122.11,17911884.18000005,2018,9,11,CASH_IN,122.11,M1995278043
12816,409000438620',2018-09-11,MICRO ATM WDL FEE DT10091,0.0,235400.0,18147284.18000005,2018,9,11,TRANSFER,235400.0,M451030475
12817,409000438620',2018-09-11,MICRO ATM INC DATED 10091,0.0,600.12,18147884.300000053,2018,9,11,CASH_IN,600.12,M1318994245
12818,409000438620',2018-09-11,MICRO ATM GST DATED 10091,0.0,120.02,18148004.32000005,2018,9,11,TRANSFER,120.02,M320686867
12819,409000438620',2018-09-11,MICRO ATM INC DATED 02091,0.0,344.88,18148349.20000005,2018,9,11,CASH_IN,344.88,M87201826
12820,409000438620',2018-09-11,MICRO ATM GST DATED 02091,0.0,68.98,18148418.18000005,2018,9,11,TRANSFER,68.98,M827605414
12821,409000438620',2018-09-11,AEPS INCOME DT 10-09-2018,0.0,22974.55,18171392.730000053,2018,9,11,TRANSFER,22974.55,M1247225463
12822,409000438620',2018-09-11,AEPS GST INC DT 10-09-201,0.0,4594.91,18175987.640000053,2018,9,11,TRANSFER,4594.91,M1460146719
12823,409000438620',2018-09-11,AEPS ACQCR ADJ FEES 10091,173.46,0.0,18175814.18000005,2018,9,11,CHECK_WITHDRAWAL,173.46,M1433335917
12824,409000438620',2018-09-11,TRF TO  Indiaforensic SERVICES I,500000.0,0.0,17675814.18000005,2018,9,11,PAYEMENT,500000.0,M392454746
12825,409000438620',2018-09-12,MAW/502964XXXXXX8587/NAGA,0.0,600.0,17676414.18000005,2018,9,12,CASH_IN,600.0,M1540282358
12826,409000438620',2018-09-12,MAW/502964XXXXXX8983/NAGA,0.0,900.0,17677314.18000005,2018,9,12,CASH_IN,900.0,M934999594
12827,409000438620',2018-09-12,MAW/502964XXXXXX0502/NAGA,0.0,2500.0,17679814.18000005,2018,9,12,CASH_IN,2500.0,C1434389049
12828,409000438620',2018-09-12,Indiaforensic AEPS NPCI WDL SET,0.0,8415100.0,26094914.18000005,2018,9,12,CASH_IN,8415100.0,M777503070
12829,409000438620',2018-09-12,CR824713976638/RMCPL23823/0,1500.0,0.0,26093414.18000005,2018,9,12,CASH_OUT,1500.0,M743604657
12830,409000438620',2018-09-12,CR824710918547/RMCPL24066/0,500.0,0.0,26092914.18000005,2018,9,12,CASH_OUT,500.0,M328570562
12831,409000438620',2018-09-12,CR824710918534/RMCPL16228/0,3200.0,0.0,26089714.18000005,2018,9,12,CASH_OUT,3200.0,C1722141669
12832,409000438620',2018-09-12,CR824713968403/RMCPL24804/0,6000.0,0.0,26083714.18000005,2018,9,12,CHECK_WITHDRAWAL,6000.0,M1113709625
12833,409000438620',2018-09-12,CR824716016023/RMCPL19639/0,1000.0,0.0,26082714.18000005,2018,9,12,CASH_OUT,1000.0,M556120910
12834,409000438620',2018-09-12,CR824711936476/RMCPL28029/0,2000.0,0.0,26080714.18000005,2018,9,12,CASH_OUT,2000.0,M870270157
12835,409000438620',2018-09-12,CR824717028874/RMCPL24195/0,4100.0,0.0,26076614.18000005,2018,9,12,DEBIT,4100.0,M701427548
12836,409000438620',2018-09-12,CR824711949645/RMCPL22284/0,900.0,0.0,26075714.18000005,2018,9,12,PAYEMENT,900.0,M32768721
12837,409000438620',2018-09-12,CR824712953180/RMCPL21720/0,1000.0,0.0,26074714.18000005,2018,9,12,CHECK_WITHDRAWAL,1000.0,M345229602
12838,409000438620',2018-09-12,CR824711945406/RMCPL24213/0,1000.0,0.0,26073714.18000005,2018,9,12,PAYEMENT,1000.0,C1661355634
12839,409000438620',2018-09-12,CR824714985636/RMCPL22800/0,1000.0,0.0,26072714.18000005,2018,9,12,CHECK_WITHDRAWAL,1000.0,M1521104704
12840,409000438620',2018-09-12,CR824712953200/RMCPL27487/0,1000.0,0.0,26071714.18000005,2018,9,12,DEBIT,1000.0,M1829480887
12841,409000438620',2018-09-12,CR824719058609/RMCPL14219/0,5000.0,0.0,26066714.18000005,2018,9,12,PAYEMENT,5000.0,M1637883525
12842,409000438620',2018-09-12,CR824812211920/RMCPL20815/0,1000.0,0.0,26065714.18000005,2018,9,12,CHECK_WITHDRAWAL,1000.0,M1355977634
12843,409000438620',2018-09-12,CR824810176271/RMCPL22523/0,4000.0,0.0,26061714.18000005,2018,9,12,PAYEMENT,4000.0,M38462941
12844,409000438620',2018-09-12,CR824813220351/RMCPL21720/0,500.0,0.0,26061214.18000005,2018,9,12,CASH_OUT,500.0,M14880096
12845,409000438620',2018-09-12,CR824813220346/RMCPL27285/0,600.0,0.0,26060614.18000005,2018,9,12,CHECK_WITHDRAWAL,600.0,M1248515013
12846,409000438620',2018-09-12,CR824810170921/RMCPL15297/0,1300.0,0.0,26059314.18000005,2018,9,12,CHECK_WITHDRAWAL,1300.0,M1356749081
12847,409000438620',2018-09-12,CR824818289600/RMCPL16006/0,500.0,0.0,26058814.18000005,2018,9,12,PAYEMENT,500.0,M241210330
12848,409000438620',2018-09-12,CR824812211933/RMCPL27368/0,2300.0,0.0,26056514.18000005,2018,9,12,CASH_OUT,2300.0,M311380825
12849,409000438620',2018-09-12,CR824818289629/RMCPL22522/0,1000.0,0.0,26055514.18000005,2018,9,12,CHECK_WITHDRAWAL,1000.0,M1322268566
12850,409000438620',2018-09-12,CR824818289644/RMCPL16787/0,1800.0,0.0,26053714.18000005,2018,9,12,CHECK_WITHDRAWAL,1800.0,M1215195952
12851,409000438620',2018-09-12,CR824810166081/RMCPL16774/0,10000.0,0.0,26043714.18000005,2018,9,12,CASH_OUT,10000.0,M1738368762
12852,409000438620',2018-09-12,CR824810166056/RMCPL15535/0,2000.0,0.0,26041714.18000005,2018,9,12,CHECK_WITHDRAWAL,2000.0,M1697908956
12853,409000438620',2018-09-12,CR824816262576/RMCPL15510/0,1000.0,0.0,26040714.18000005,2018,9,12,DEBIT,1000.0,M901193360
12854,409000438620',2018-09-12,CR824810166083/RMCPL21260/0,500.0,0.0,26040214.18000005,2018,9,12,DEBIT,500.0,M1751027248
12855,409000438620',2018-09-12,CR824813228719/RMCPL23821/0,4000.0,0.0,26036214.18000005,2018,9,12,DEBIT,4000.0,M1419709972
12856,409000438620',2018-09-12,CR824811199479/RMCPL14558/0,8000.0,0.0,26028214.18000005,2018,9,12,CASH_OUT,8000.0,M766353002
12857,409000438620',2018-09-12,CR824811199477/RMCPL20272/0,3000.0,0.0,26025214.18000005,2018,9,12,DEBIT,3000.0,M1445531088
12858,409000438620',2018-09-12,CR824811190870/RMCPL24712/0,4100.0,0.0,26021114.18000005,2018,9,12,PAYEMENT,4100.0,M1403474304
12859,409000438620',2018-09-12,MICRO ATM WDL FEE DT11091,0.0,278200.0,26299314.18000005,2018,9,12,TRANSFER,278200.0,M1696962186
12860,409000438620',2018-09-12,MICRO ATM INC DATED 11091,0.0,645.84,26299960.02000005,2018,9,12,CASH_IN,645.84,M1477447293
12861,409000438620',2018-09-12,MICRO ATM GST DATED 11091,0.0,129.17,26300089.19000005,2018,9,12,TRANSFER,129.17,M137410725
12862,409000438620',2018-09-12,MAW/502964XXXXXX8690/Karu,0.0,1800.0,26301889.19000005,2018,9,12,TRANSFER,1800.0,C34231099
12863,409000438620',2018-09-12,TRF TO  Indiaforensic SERVICES I,8400000.0,0.0,17901889.190000053,2018,9,12,CHECK_WITHDRAWAL,8400000.0,M1958716152
12864,409000438620',2018-09-12,MAW/502964XXXXXX7981/NAGA,0.0,200.0,17902089.190000053,2018,9,12,CHECK_CASHING,200.0,M1995700240
12865,409000438620',2018-09-12,MAW/502964XXXXXX8542/NAGA,0.0,400.0,17902489.190000053,2018,9,12,TRANSFER,400.0,M1960786112
12866,409000438620',2018-09-12,AEPS INCOME DT 11-09-2018,0.0,21006.04,17923495.230000053,2018,9,12,TRANSFER,21006.04,M1523547922
12867,409000438620',2018-09-12,AEPS GST INC DT 11-09-201,0.0,4201.21,17927696.440000053,2018,9,12,TRANSFER,4201.21,C554385733
12868,409000438620',2018-09-12,MICRO ATM WDL FEE DT12091,0.0,176400.0,18104096.440000053,2018,9,12,CASH_IN,176400.0,C985934102
12869,409000438620',2018-09-12,MICRO ATM INC DATED 12091,0.0,449.28,18104545.72000005,2018,9,12,CASH_IN,449.28,C1979563377
12870,409000438620',2018-09-12,MICRO ATM GST DATED 12091,0.0,89.86,18104635.580000054,2018,9,12,CHECK_CASHING,89.86,M334467079
12871,409000438620',2018-09-12,AEPS ACQUIRING ADJ FEES 1,14.75,0.0,18104620.830000054,2018,9,12,DEBIT,14.75,M1928793617
12872,409000438620',2018-09-12,AEPS ACQUIRING CR ADJ FEE,309.1,0.0,18104311.730000053,2018,9,12,CHECK_WITHDRAWAL,309.1,M850359367
12873,409000438620',2018-09-12,AEPS ACQUIRING REP ADJ FE,0.0,35.4,18104347.13000005,2018,9,12,CHECK_CASHING,35.4,C1340123681
12874,409000438620',2018-09-13,Indiaforensic AEPS NPCI WDL SET,0.0,13092900.0,31197247.13000005,2018,9,13,TRANSFER,13092900.0,M1618275624
12875,409000438620',2018-09-13,CR825210093725/RMCPL24117/0,5100.0,0.0,31192147.13000005,2018,9,13,CASH_OUT,5100.0,M95093344
12876,409000438620',2018-09-13,CR825210098363/RMCPL20272/0,4000.0,0.0,31188147.13000005,2018,9,13,CASH_OUT,4000.0,M1283659601
12877,409000438620',2018-09-13,CR825110899088/RMCPL10452/0,6000.0,0.0,31182147.13000005,2018,9,13,PAYEMENT,6000.0,M1039913285
12878,409000438620',2018-09-13,CR825110893137/RMCPL22333/0,600.0,0.0,31181547.13000005,2018,9,13,CASH_OUT,600.0,M792518063
12879,409000438620',2018-09-13,CR825115958890/RMCPL11793/0,2000.0,0.0,31179547.13000005,2018,9,13,CHECK_WITHDRAWAL,2000.0,M1595549446
12880,409000438620',2018-09-13,CR825109883520/RMCPL11634/0,1000.0,0.0,31178547.13000005,2018,9,13,CHECK_WITHDRAWAL,1000.0,M1711509547
12881,409000438620',2018-09-13,CR825115962168/RMCPL22502/0,5000.0,0.0,31173547.13000005,2018,9,13,DEBIT,5000.0,M287249351
12882,409000438620',2018-09-13,CR825110891834/RMCPL28497/0,5000.0,0.0,31168547.13000005,2018,9,13,CASH_OUT,5000.0,M453124891
12883,409000438620',2018-09-13,CR825110892932/RMCPL22349/0,3000.0,0.0,31165547.13000005,2018,9,13,DEBIT,3000.0,M1953932833
12884,409000438620',2018-09-13,CR825110893491/RMCPL26434/0,8000.0,0.0,31157547.13000005,2018,9,13,CASH_OUT,8000.0,M1275123735
12885,409000438620',2018-09-13,CR825112921990/RMCPL25247/0,4000.0,0.0,31153547.13000005,2018,9,13,CHECK_WITHDRAWAL,4000.0,C1761291320
12886,409000438620',2018-09-13,CR825112927748/RMCPL23041/0,1000.0,0.0,31152547.13000005,2018,9,13,CASH_OUT,1000.0,M667953797
12887,409000438620',2018-09-13,CR825112927752/RMCPL23906/0,800.0,0.0,31151747.13000005,2018,9,13,DEBIT,800.0,C1757533511
12888,409000438620',2018-09-13,CR825113936167/RMCPL19766/0,1000.0,0.0,31150747.13000005,2018,9,13,CHECK_WITHDRAWAL,1000.0,C1303868418
12889,409000438620',2018-09-13,CR825110895057/RMCPL12826/0,500.0,0.0,31150247.13000005,2018,9,13,PAYEMENT,500.0,C863811613
12890,409000438620',2018-09-13,CR825110895007/RMCPL15016/0,1000.0,0.0,31149247.13000005,2018,9,13,DEBIT,1000.0,C1031639563
12891,409000438620',2018-09-13,CR825110895268/RMCPL19730/0,1400.0,0.0,31147847.13000005,2018,9,13,DEBIT,1400.0,C1394526584
12892,409000438620',2018-09-13,CR825110895260/RMCPL21872/0,5600.0,0.0,31142247.13000005,2018,9,13,PAYEMENT,5600.0,C1360767589
12893,409000438620',2018-09-13,CR825110895351/RMCPL09827/0,4000.0,0.0,31138247.13000005,2018,9,13,CHECK_WITHDRAWAL,4000.0,C1805683209
12894,409000438620',2018-09-13,CR825110895262/RMCPL24236/0,1000.0,0.0,31137247.13000005,2018,9,13,DEBIT,1000.0,C490150701
12895,409000438620',2018-09-13,CR825114954741/RMCPL19639/0,6000.0,0.0,31131247.13000005,2018,9,13,DEBIT,6000.0,C481402298
12896,409000438620',2018-09-13,CR825114954740/RMCPL23370/0,2000.0,0.0,31129247.13000005,2018,9,13,CHECK_WITHDRAWAL,2000.0,C374625527
12897,409000438620',2018-09-13,CR825018780521/RMCPL09617/0,2500.0,0.0,31126747.13000005,2018,9,13,CASH_OUT,2500.0,C1450133081
12898,409000438620',2018-09-13,CR825015741720/RMCPL18088/0,5000.0,0.0,31121747.13000005,2018,9,13,PAYEMENT,5000.0,C2086207545
12899,409000438620',2018-09-13,CR825011684767/RMCPL15121/0,7000.0,0.0,31114747.13000005,2018,9,13,PAYEMENT,7000.0,M221483258
12900,409000438620',2018-09-13,CR825017765022/RMCPL25604/0,1000.0,0.0,31113747.13000005,2018,9,13,CASH_OUT,1000.0,M1790564803
12901,409000438620',2018-09-13,CR825013722827/RMCPL22022/0,700.0,0.0,31113047.13000005,2018,9,13,DEBIT,700.0,M314882437
12902,409000438620',2018-09-13,CR825011686381/RMCPL23088/0,2000.0,0.0,31111047.13000005,2018,9,13,DEBIT,2000.0,C1343134043
12903,409000438620',2018-09-13,CR825011686376/RMCPL14827/0,10000.0,0.0,31101047.13000005,2018,9,13,PAYEMENT,10000.0,M1033793042
12904,409000438620',2018-09-13,CR825012699270/RMCPL23228/0,2000.0,0.0,31099047.13000005,2018,9,13,CASH_OUT,2000.0,M1654021279
12905,409000438620',2018-09-13,CR825014734706/RMCPL22919/0,500.0,0.0,31098547.13000005,2018,9,13,CHECK_WITHDRAWAL,500.0,M2102129861
12906,409000438620',2018-09-13,CR825016754606/RMCPL25362/0,1100.0,0.0,31097447.13000005,2018,9,13,DEBIT,1100.0,M675831479
12907,409000438620',2018-09-13,CR825016754615/RMCPL24821/0,1000.0,0.0,31096447.13000005,2018,9,13,DEBIT,1000.0,M1712511402
12908,409000438620',2018-09-13,CR825014734632/RMCPL21030/0,2000.0,0.0,31094447.13000005,2018,9,13,PAYEMENT,2000.0,M541056618
12909,409000438620',2018-09-13,CR825014734707/RMCPL24700/0,800.0,0.0,31093647.13000005,2018,9,13,PAYEMENT,800.0,M2078761279
12910,409000438620',2018-09-13,CR825318390155/RMCPL09600/1,500.0,0.0,31093147.13000005,2018,9,13,CASH_OUT,500.0,M737187137
12911,409000438620',2018-09-13,CR825318390198/RMCPL09472/1,500.0,0.0,31092647.13000005,2018,9,13,CASH_OUT,500.0,M569347802
12912,409000438620',2018-09-13,CR825312311460/RMCPL24532/1,5000.0,0.0,31087647.13000005,2018,9,13,DEBIT,5000.0,M1842576999
12913,409000438620',2018-09-13,CR825311288272/RMCPL26314/1,1500.0,0.0,31086147.13000005,2018,9,13,PAYEMENT,1500.0,M1578273442
12914,409000438620',2018-09-13,CR825313324748/RMCPL23562/1,3100.0,0.0,31083047.13000005,2018,9,13,CASH_OUT,3100.0,M1603928654
12915,409000438620',2018-09-13,CR825310280697/RMCPL20518/1,1000.0,0.0,31082047.13000005,2018,9,13,CHECK_WITHDRAWAL,1000.0,M614095030
12916,409000438620',2018-09-13,CR825310280716/RMCPL11793/1,3000.0,0.0,31079047.13000005,2018,9,13,CHECK_WITHDRAWAL,3000.0,M1636908236
12917,409000438620',2018-09-13,CR825312311453/RMCPL11029/1,4000.0,0.0,31075047.13000005,2018,9,13,CHECK_WITHDRAWAL,4000.0,M1161768166
12918,409000438620',2018-09-13,CR825311296307/RMCPL26646/1,500.0,0.0,31074547.13000005,2018,9,13,CHECK_WITHDRAWAL,500.0,M1974962333
12919,409000438620',2018-09-13,CR825316357793/RMCPL25346/1,5000.0,0.0,31069547.13000005,2018,9,13,DEBIT,5000.0,M1319954831
12920,409000438620',2018-09-13,CR825317371393/RMCPL11996/1,5000.0,0.0,31064547.13000005,2018,9,13,CHECK_WITHDRAWAL,5000.0,M1600371764
12921,409000438620',2018-09-13,AEPS ACQ CR ADJ FEES 1209,530.41,0.0,31064016.72000005,2018,9,13,PAYEMENT,530.41,M1103911337
12922,409000438620',2018-09-13,TRF TO  Indiaforensic SERVICES I,13400000.0,0.0,17664016.72000005,2018,9,13,CHECK_WITHDRAWAL,13400000.0,M1549979843
12923,409000438620',2018-09-13,AEPS INCOME DT 12-09-2018,0.0,33558.14,17697574.86000005,2018,9,13,CASH_IN,33558.14,M1051327852
12924,409000438620',2018-09-13,AEPS GST INC DT 12-09-201,0.0,6711.63,17704286.49000005,2018,9,13,TRANSFER,6711.63,C2111798903
12925,409000438620',2018-09-14,MAW/502964XXXXXX7427/Karu,0.0,1800.0,17706086.49000005,2018,9,14,CHECK_CASHING,1800.0,C1019670582
12926,409000438620',2018-09-14,Indiaforensic AEPS NPCI WDL SET,0.0,11661100.0,29367186.49000005,2018,9,14,TRANSFER,11661100.0,C1013700132
12927,409000438620',2018-09-14,MAW/502964XXXXXX0702/Karu,0.0,1700.0,29368886.49000005,2018,9,14,CASH_IN,1700.0,C1628737580
12928,409000438620',2018-09-14,MAW/502964XXXXXX6630/Karu,0.0,1700.0,29370586.49000005,2018,9,14,TRANSFER,1700.0,C283923651
12929,409000438620',2018-09-14,MAW/502964XXXXXX4599/Karu,0.0,1700.0,29372286.49000005,2018,9,14,CASH_IN,1700.0,C456538529
12930,409000438620',2018-09-14,MAW/502964XXXXXX2617/Karu,0.0,1700.0,29373986.49000005,2018,9,14,TRANSFER,1700.0,C421639228
12931,409000438620',2018-09-14,MAW/502964XXXXXX7625/Karu,0.0,1300.0,29375286.49000005,2018,9,14,CHECK_CASHING,1300.0,C1255024717
12932,409000438620',2018-09-14,MAW/502964XXXXXX0636/Karu,0.0,1700.0,29376986.49000005,2018,9,14,CASH_IN,1700.0,C1816757085
12933,409000438620',2018-09-14,MAW/502964XXXXXX2502/Karu,0.0,1700.0,29378686.49000005,2018,9,14,TRANSFER,1700.0,C1810730392
12934,409000438620',2018-09-14,TRF TO  Indiaforensic SERVICES I,11700000.0,0.0,17678686.49000005,2018,9,14,PAYEMENT,11700000.0,C2052185144
12935,409000438620',2018-09-14,AEPS ACQUIRING ADJ FEES 1,2.95,0.0,17678683.54000005,2018,9,14,PAYEMENT,2.95,C787028959
12936,409000438620',2018-09-14,MAW/502964XXXXXX7658/Karu,0.0,1000.0,17679683.54000005,2018,9,14,CHECK_CASHING,1000.0,C405881980
12937,409000438620',2018-09-14,MICRO ATM WDL FEE DT12091,0.0,247400.0,17927083.54000005,2018,9,14,CASH_IN,247400.0,C604555852
12938,409000438620',2018-09-14,MICRO ATM INC DATED 12091,0.0,678.6,17927762.140000053,2018,9,14,CHECK_CASHING,678.6,C1009972184
12939,409000438620',2018-09-14,MICRO ATM GST DATED 12091,0.0,135.72,17927897.86000005,2018,9,14,CHECK_CASHING,135.72,C1401721023
12940,409000438620',2018-09-14,MICRO ATM WDL FEE DT13091,0.0,207500.0,18135397.86000005,2018,9,14,CASH_IN,207500.0,M605172860
12941,409000438620',2018-09-14,MICRO ATM INC DATED 13091,0.0,516.24,18135914.10000005,2018,9,14,CASH_IN,516.24,M640917152
12942,409000438620',2018-09-14,MICRO ATM GST DATED 13091,0.0,103.25,18136017.35000005,2018,9,14,TRANSFER,103.25,M57445513
12943,409000438620',2018-09-14,AEPS INCOME DT 13-09-2018,0.0,29323.52,18165340.87000005,2018,9,14,CASH_IN,29323.52,M2101500913
12944,409000438620',2018-09-14,AEPS GST INC DT 13-09-201,0.0,5864.7,18171205.57000005,2018,9,14,CASH_IN,5864.7,M1800110435
12945,409000438620',2018-09-14,MICRO ATM WDL FEE DT13091,0.0,138400.0,18309605.57000005,2018,9,14,TRANSFER,138400.0,M862549320
12946,409000438620',2018-09-14,MICRO ATM INC DATED 13091,0.0,326.88,18309932.450000048,2018,9,14,TRANSFER,326.88,C1457383927
12947,409000438620',2018-09-14,MICRO ATM GST DATED 13091,0.0,65.38,18309997.830000047,2018,9,14,TRANSFER,65.38,M795383174
12948,409000438620',2018-09-14,TRF TO  Indiaforensic SERVICES I,400000.0,0.0,17909997.830000047,2018,9,14,PAYEMENT,400000.0,M2064231641
12949,409000438620',2018-09-14,MICRO ATM WDL FEE DT14091,0.0,169600.0,18079597.830000047,2018,9,14,CASH_IN,169600.0,M902866609
12950,409000438620',2018-09-14,MICRO ATM INC DATED 14091,0.0,327.24,18079925.070000045,2018,9,14,TRANSFER,327.24,C1247658278
12951,409000438620',2018-09-14,MICRO ATM GST DATED 14091,0.0,65.45,18079990.520000044,2018,9,14,TRANSFER,65.45,M1864085828
12952,409000438620',2018-09-15,MAW/502964XXXXXX9796/NAGA,0.0,1100.0,18081090.520000044,2018,9,15,CHECK_CASHING,1100.0,C1163480574
12953,409000438620',2018-09-15,Indiaforensic AEPS NPCI WDL SET1,0.0,12001100.0,30082190.520000044,2018,9,15,TRANSFER,12001100.0,M567123588
12954,409000438620',2018-09-15,CR825413542567/RMCPL11793/1,4000.0,0.0,30078190.520000044,2018,9,15,DEBIT,4000.0,C1028574311
12955,409000438620',2018-09-15,CR825410495898/RMCPL23228/1,3000.0,0.0,30075190.520000044,2018,9,15,PAYEMENT,3000.0,M302026611
12956,409000438620',2018-09-15,CR825418598482/RMCPL11019/1,500.0,0.0,30074690.520000044,2018,9,15,PAYEMENT,500.0,M950953557
12957,409000438620',2018-09-15,CR825418599864/RMCPL17831/1,2200.0,0.0,30072490.520000044,2018,9,15,CASH_OUT,2200.0,M992473487
12958,409000438620',2018-09-15,CR825418598450/RMCPL12666/1,10000.0,0.0,30062490.520000044,2018,9,15,CASH_OUT,10000.0,C1339765646
12959,409000438620',2018-09-15,CR825418598513/RMCPL17574/1,1000.0,0.0,30061490.520000044,2018,9,15,CASH_OUT,1000.0,M1994017691
12960,409000438620',2018-09-15,CR825418601918/RMCPL19959/1,700.0,0.0,30060790.520000044,2018,9,15,CHECK_WITHDRAWAL,700.0,C1529115495
12961,409000438620',2018-09-15,CR825410495903/RMCPL25416/1,1000.0,0.0,30059790.520000044,2018,9,15,PAYEMENT,1000.0,M50535987
12962,409000438620',2018-09-15,CR825415564449/RMCPL20307/1,2500.0,0.0,30057290.520000044,2018,9,15,CASH_OUT,2500.0,C1450828900
12963,409000438620',2018-09-15,CR825411515307/RMCPL21894/1,10000.0,0.0,30047290.520000044,2018,9,15,PAYEMENT,10000.0,M1277715856
12964,409000438620',2018-09-15,CR825413542667/RMCPL28382/1,1000.0,0.0,30046290.520000044,2018,9,15,CASH_OUT,1000.0,C1725548614
12965,409000438620',2018-09-15,CR825413536284/RMCPL13065/1,1500.0,0.0,30044790.520000044,2018,9,15,PAYEMENT,1500.0,M1046075419
12966,409000438620',2018-09-15,CR825418598457/RMCPL17491/1,2000.0,0.0,30042790.520000044,2018,9,15,CHECK_WITHDRAWAL,2000.0,C400720732
12967,409000438620',2018-09-15,CR825409473309/RMCPL24700/1,1100.0,0.0,30041690.520000044,2018,9,15,DEBIT,1100.0,C824899696
12968,409000438620',2018-09-15,CR825410493135/RMCPL17831/1,3100.0,0.0,30038590.520000044,2018,9,15,PAYEMENT,3100.0,C582320549
12969,409000438620',2018-09-15,CR825410493140/RMCPL27843/1,500.0,0.0,30038090.520000044,2018,9,15,PAYEMENT,500.0,M1811019433
12970,409000438620',2018-09-15,CR825414550348/RMCPL18408/1,1000.0,0.0,30037090.520000044,2018,9,15,CASH_OUT,1000.0,M220228047
12971,409000438620',2018-09-15,CR825410490043/RMCPL15535/1,10000.0,0.0,30027090.520000044,2018,9,15,DEBIT,10000.0,M351856637
12972,409000438620',2018-09-15,CR825411518601/RMCPL18244/1,2000.0,0.0,30025090.520000044,2018,9,15,CASH_OUT,2000.0,M547829031
12973,409000438620',2018-09-15,CR825408472677/RMCPL25806/1,500.0,0.0,30024590.520000044,2018,9,15,DEBIT,500.0,M1128544033
12974,409000438620',2018-09-15,CR825419614691/RMCPL09071/1,4000.0,0.0,30020590.520000044,2018,9,15,PAYEMENT,4000.0,M1316573032
12975,409000438620',2018-09-15,CR825416572935/RMCPL18729/1,4000.0,0.0,30016590.520000044,2018,9,15,PAYEMENT,4000.0,M1003459823
12976,409000438620',2018-09-15,CR825408468589/RMCPL18136/1,5000.0,0.0,30011590.520000044,2018,9,15,PAYEMENT,5000.0,C404923931
12977,409000438620',2018-09-15,CR825408468720/RMCPL19766/1,500.0,0.0,30011090.520000044,2018,9,15,DEBIT,500.0,M1104330814
12978,409000438620',2018-09-15,CR825413542894/RMCPL25247/1,2500.0,0.0,30008590.520000044,2018,9,15,DEBIT,2500.0,C1373467808
12979,409000438620',2018-09-15,CR825408466834/RMCPL16684/1,600.0,0.0,30007990.520000044,2018,9,15,DEBIT,600.0,C459172227
12980,409000438620',2018-09-15,CR825408466971/RMCPL23283/1,500.0,0.0,30007490.520000044,2018,9,15,DEBIT,500.0,M1698582091
12981,409000438620',2018-09-15,CR825408467341/RMCPL26120/1,3300.0,0.0,30004190.520000044,2018,9,15,DEBIT,3300.0,M1992676412
12982,409000438620',2018-09-15,CR825414550338/RMCPL24462/1,4000.0,0.0,30000190.520000044,2018,9,15,DEBIT,4000.0,C420561530
12983,409000438620',2018-09-15,CR825408467628/RMCPL24691/1,10000.0,0.0,29990190.520000044,2018,9,15,DEBIT,10000.0,M1929120567
12984,409000438620',2018-09-15,CR825408467711/RMCPL21872/1,6000.0,0.0,29984190.520000044,2018,9,15,CASH_OUT,6000.0,M1066104222
12985,409000438620',2018-09-15,CR825408468256/RMCPL26120/1,3300.0,0.0,29980890.520000044,2018,9,15,DEBIT,3300.0,M1973597610
12986,409000438620',2018-09-15,CR825413539218/RMCPL28497/1,2000.0,0.0,29978890.520000044,2018,9,15,DEBIT,2000.0,M966929548
12987,409000438620',2018-09-15,CR825413539895/RMCPL00195/1,500.0,0.0,29978390.520000044,2018,9,15,CHECK_WITHDRAWAL,500.0,M334297860
12988,409000438620',2018-09-15,CR825413542615/RMCPL11862/1,3000.0,0.0,29975390.520000044,2018,9,15,CHECK_WITHDRAWAL,3000.0,M1788571137
12989,409000438620',2018-09-15,CR825413539753/RMCPL23569/1,1500.0,0.0,29973890.520000044,2018,9,15,CASH_OUT,1500.0,M1976185152
12990,409000438620',2018-09-15,CR825408468711/RMCPL11776/1,1500.0,0.0,29972390.520000044,2018,9,15,DEBIT,1500.0,M694953091
12991,409000438620',2018-09-15,CR825418611968/RMCPL09135/1,1000.0,0.0,29971390.520000044,2018,9,15,CASH_OUT,1000.0,M1512082967
12992,409000438620',2018-09-15,MAW/502964XXXXXX7354/Karu,0.0,1700.0,29973090.520000044,2018,9,15,CASH_IN,1700.0,M1072477273
12993,409000438620',2018-09-15,TRFT O  Indiaforensic SERVICES I,10000000.0,0.0,19973090.520000044,2018,9,15,PAYEMENT,10000000.0,M947558501
12994,409000438620',2018-09-15,TRFT O  Indiaforensic SERVICES I,2000000.0,0.0,17973090.520000044,2018,9,15,CHECK_WITHDRAWAL,2000000.0,M1944265340
12995,409000438620',2018-09-15,AEPS INCOME DT 14-09-2018,0.0,30609.72,18003700.240000047,2018,9,15,TRANSFER,30609.72,C1601071362
12996,409000438620',2018-09-15,AEPS GST INC DT 14-09-201,0.0,6121.94,18009822.180000044,2018,9,15,CASH_IN,6121.94,M1331301181
12997,409000438620',2018-09-15,AEPS ACQCR ADJ FEES 14091,431.29,0.0,18009390.890000045,2018,9,15,CHECK_WITHDRAWAL,431.29,M80914902
12998,409000438620',2018-09-15,MAW/502964XXXXXX6629/Karu,0.0,1700.0,18011090.890000045,2018,9,15,TRANSFER,1700.0,M2117146187
12999,409000438620',2018-09-15,MICRO ATM WDL FEE DT14091,0.0,173800.0,18184890.890000045,2018,9,15,CHECK_CASHING,173800.0,M1264264192
13000,409000438620',2018-09-15,MICRO ATM INC DATED 14091,0.0,434.88,18185325.770000044,2018,9,15,CASH_IN,434.88,M861465089
13001,409000438620',2018-09-15,MICRO ATM GST DATED 14091,0.0,86.98,18185412.750000045,2018,9,15,CASH_IN,86.98,M1323051231
13002,409000438620',2018-09-15,AEPS PAY Indiaforensic 1409,0.0,658.02,18186070.770000044,2018,9,15,TRANSFER,658.02,M383561909
13003,409000438620',2018-09-15,MAW/502964XXXXXX0296/NAGA,0.0,800.0,18186870.770000044,2018,9,15,TRANSFER,800.0,M1321739815
13004,409000438620',2018-09-15,MICRO ATM WDL FEE DT15091,0.0,136800.0,18323670.770000044,2018,9,15,TRANSFER,136800.0,M1569897808
13005,409000438620',2018-09-15,MICRO ATM INC DATED 15091,0.0,309.96,18323980.730000045,2018,9,15,CASH_IN,309.96,M1486057064
13006,409000438620',2018-09-15,MICRO ATM GST DATED 15091,0.0,61.99,18324042.720000044,2018,9,15,CHECK_CASHING,61.99,M2033937957
13007,409000438620',2018-09-17,Indiaforensic AEPS NPCI WDL SET1,0.0,10150100.0,28474142.720000044,2018,9,17,CHECK_CASHING,10150100.0,C1052170153
13008,409000438620',2018-09-17,Indiaforensic AEPS NPCI WDL SET1,0.0,6310000.0,34784142.72000004,2018,9,17,TRANSFER,6310000.0,C1257704323
13009,409000438620',2018-09-17,TRF TO  Indiaforensic SERVICES I,2000000.0,0.0,32784142.720000044,2018,9,17,CASH_OUT,2000000.0,C1978557426
13010,409000438620',2018-09-17,TRF TO  Indiaforensic SERVICES I,15000000.0,0.0,17784142.720000044,2018,9,17,CASH_OUT,15000000.0,C35534346
13011,409000438620',2018-09-17,MAW/502964XXXXXX4574/Karu,0.0,1700.0,17785842.720000044,2018,9,17,CHECK_CASHING,1700.0,M1458910529
13012,409000438620',2018-09-17,MICRO ATM WDL FEE DT15091,0.0,196100.0,17981942.720000044,2018,9,17,TRANSFER,196100.0,M884310148
13013,409000438620',2018-09-17,MICRO ATM WDL FEE DT16091,0.0,418400.0,18400342.720000044,2018,9,17,CASH_IN,418400.0,M123929713
13014,409000438620',2018-09-17,AEPS PAY Indiaforensic 1509,0.0,297.23,18400639.950000044,2018,9,17,TRANSFER,297.23,M864787391
13015,409000438620',2018-09-17,NPCI SETELEMENT DIFF_1509,0.0,4000.0,18404639.950000044,2018,9,17,CHECK_CASHING,4000.0,M1337725291
13016,409000438620',2018-09-17,NPCI SETELEMENT DIFF_1609,0.0,21500.0,18426139.950000044,2018,9,17,CASH_IN,21500.0,M526879043
13017,409000438620',2018-09-17,MICRO ATM WDL FEE DT17091,0.0,181400.0,18607539.950000044,2018,9,17,TRANSFER,181400.0,M2129536686
13018,409000438620',2018-09-17,MICRO ATM INC DATED 15091,0.0,440.64,18607980.590000045,2018,9,17,CHECK_CASHING,440.64,M1479529027
13019,409000438620',2018-09-17,MICRO ATM GST DATED 15091,0.0,88.13,18608068.720000044,2018,9,17,TRANSFER,88.13,M888889899
13020,409000438620',2018-09-17,MICRO ATM INC DATED 16091,0.0,998.64,18609067.360000044,2018,9,17,CHECK_CASHING,998.64,C5592464
13021,409000438620',2018-09-17,MICRO ATM GST DATED 16091,0.0,199.73,18609267.090000045,2018,9,17,CHECK_CASHING,199.73,C2083562754
13022,409000438620',2018-09-17,MICRO ATM INC DATED 17091,0.0,395.64,18609662.730000045,2018,9,17,CASH_IN,395.64,C591862575
13023,409000438620',2018-09-17,MICRO ATM GST DATED 17091,0.0,79.13,18609741.860000044,2018,9,17,CASH_IN,79.13,C1787868648
13024,409000438620',2018-09-17,AEPS INCOME DT 15-09-2018,0.0,25791.8,18635533.660000045,2018,9,17,TRANSFER,25791.8,C314245922
13025,409000438620',2018-09-17,AEPS GST INCDT 15-09-2018,0.0,5158.36,18640692.020000044,2018,9,17,CHECK_CASHING,5158.36,M271208048
13026,409000438620',2018-09-17,AEPS INCOME DT 16-09-2018,0.0,17034.35,18657726.370000046,2018,9,17,CASH_IN,17034.35,C1533182537
13027,409000438620',2018-09-17,AEPS GST INCDT 16-09-2018,0.0,3406.87,18661133.240000047,2018,9,17,CASH_IN,3406.87,C339082934
13028,409000438620',2018-09-17,AEPS ACQUIRING ADJ FEES 1,17.7,0.0,18661115.540000048,2018,9,17,DEBIT,17.7,M2114190891
13029,409000438620',2018-09-17,AEPS ACQ REP ADJ FEES 150,0.0,11.8,18661127.34000005,2018,9,17,TRANSFER,11.8,M144730920
13030,409000438620',2018-09-17,TRF TO  Indiaforensic SERVICES I,300000.0,0.0,18361127.34000005,2018,9,17,DEBIT,300000.0,M379885087
13031,409000438620',2018-09-18,MAW/502964XXXXXX2110/NAGA,0.0,900.0,18362027.34000005,2018,9,18,CHECK_CASHING,900.0,M2126255629
13032,409000438620',2018-09-18,MAW/502964XXXXXX0486/NAGA,0.0,900.0,18362927.34000005,2018,9,18,TRANSFER,900.0,M84364759
13033,409000438620',2018-09-18,Indiaforensic AEPS NPCI WDL SET1,0.0,8495900.0,26858827.34000005,2018,9,18,CHECK_CASHING,8495900.0,M411948562
13034,409000438620',2018-09-18,CR825517815484/RMCPL18654/1,1000.0,0.0,26857827.34000005,2018,9,18,PAYEMENT,1000.0,C934651164
13035,409000438620',2018-09-18,CR825511735245/RMCPL16439/1,10000.0,0.0,26847827.34000005,2018,9,18,DEBIT,10000.0,M1645206206
13036,409000438620',2018-09-18,CR825518826423/RMCPL11949/1,1000.0,0.0,26846827.34000005,2018,9,18,CHECK_WITHDRAWAL,1000.0,C1218365329
13037,409000438620',2018-09-18,CR825513760815/RMCPL12663/1,1100.0,0.0,26845727.34000005,2018,9,18,CHECK_WITHDRAWAL,1100.0,C2019147162
13038,409000438620',2018-09-18,CR825515791935/RMCPL23592/1,500.0,0.0,26845227.34000005,2018,9,18,PAYEMENT,500.0,M60347317
13039,409000438620',2018-09-18,CR825512757689/RMCPL11529/1,1500.0,0.0,26843727.34000005,2018,9,18,CASH_OUT,1500.0,C947982595
13040,409000438620',2018-09-18,CR825517822586/RMCPL26361/1,500.0,0.0,26843227.34000005,2018,9,18,CHECK_WITHDRAWAL,500.0,C1027017168
13041,409000438620',2018-09-18,CR825508688514/RMCPL23949/1,2000.0,0.0,26841227.34000005,2018,9,18,CASH_OUT,2000.0,M1430608513
13042,409000438620',2018-09-18,CR825511738155/RMCPL11612/1,1600.0,0.0,26839627.34000005,2018,9,18,DEBIT,1600.0,M22498485
13043,409000438620',2018-09-18,CR825511728786/RMCPL19659/1,1000.0,0.0,26838627.34000005,2018,9,18,CHECK_WITHDRAWAL,1000.0,M1194811718
13044,409000438620',2018-09-18,CR825511735321/RMCPL20482/1,3000.0,0.0,26835627.34000005,2018,9,18,CHECK_WITHDRAWAL,3000.0,C2120528456
13045,409000438620',2018-09-18,CR825511735323/RMCPL17978/1,3500.0,0.0,26832127.34000005,2018,9,18,DEBIT,3500.0,M288787366
13046,409000438620',2018-09-18,CR825513767167/RMCPL09592/1,1000.0,0.0,26831127.34000005,2018,9,18,CASH_OUT,1000.0,M1237194742
13047,409000438620',2018-09-18,CR825515796262/RMCPL18829/1,10000.0,0.0,26821127.34000005,2018,9,18,PAYEMENT,10000.0,M1034431300
13048,409000438620',2018-09-18,CR825510717769/RMCPL28800/1,4000.0,0.0,26817127.34000005,2018,9,18,CASH_OUT,4000.0,M1452872094
13049,409000438620',2018-09-18,CR825510707878/RMCPL21549/1,1000.0,0.0,26816127.34000005,2018,9,18,CASH_OUT,1000.0,M94149045
13050,409000438620',2018-09-18,CR825518830871/RMCPL28708/1,4200.0,0.0,26811927.34000005,2018,9,18,CHECK_WITHDRAWAL,4200.0,M2038821697
13051,409000438620',2018-09-18,CR825508688516/RMCPL22875/1,500.0,0.0,26811427.34000005,2018,9,18,CHECK_WITHDRAWAL,500.0,C2083562754
13052,409000438620',2018-09-18,CR825510721033/RMCPL19597/1,2000.0,0.0,26809427.34000005,2018,9,18,CASH_OUT,2000.0,C8290162
13053,409000438620',2018-09-18,CR825610954747/RMCPL17491/1,10000.0,0.0,26799427.34000005,2018,9,18,CASH_OUT,10000.0,C716083600
13054,409000438620',2018-09-18,CR825610954757/RMCPL18364/1,500.0,0.0,26798927.34000005,2018,9,18,DEBIT,500.0,C787033725
13055,409000438620',2018-09-18,CR825612981585/RMCPL27346/1,1900.0,0.0,26797027.34000005,2018,9,18,PAYEMENT,1900.0,C1880332929
13056,409000438620',2018-09-18,CR825610942024/RMCPL11656/1,1000.0,0.0,26796027.34000005,2018,9,18,DEBIT,1000.0,C490150701
13057,409000438620',2018-09-18,CR825616039998/RMCPL21533/1,10000.0,0.0,26786027.34000005,2018,9,18,CHECK_WITHDRAWAL,10000.0,C1808652004
13058,409000438620',2018-09-18,CR825614010127/RMCPL21736/1,500.0,0.0,26785527.34000005,2018,9,18,CHECK_WITHDRAWAL,500.0,C638590716
13059,409000438620',2018-09-18,CR825614021932/RMCPL20077/1,500.0,0.0,26785027.34000005,2018,9,18,DEBIT,500.0,C1149273771
13060,409000438620',2018-09-18,CR825610946182/RMCPL22898/1,4000.0,0.0,26781027.34000005,2018,9,18,CHECK_WITHDRAWAL,4000.0,C1902797635
13061,409000438620',2018-09-18,CR825610946185/RMCPL15381/1,1000.0,0.0,26780027.34000005,2018,9,18,CHECK_WITHDRAWAL,1000.0,C490150701
13062,409000438620',2018-09-18,CR825615029007/RMCPL23853/1,800.0,0.0,26779227.34000005,2018,9,18,CHECK_WITHDRAWAL,800.0,M852405159
13063,409000438620',2018-09-18,CR825614017952/RMCPL17491/1,10000.0,0.0,26769227.34000005,2018,9,18,PAYEMENT,10000.0,M267555321
13064,409000438620',2018-09-18,CR825614017967/RMCPL24928/1,3600.0,0.0,26765627.34000005,2018,9,18,CHECK_WITHDRAWAL,3600.0,C641009714
13065,409000438620',2018-09-18,TRF TO  Indiaforensic SERVICES I,9100000.0,0.0,17665627.34000005,2018,9,18,CHECK_WITHDRAWAL,9100000.0,M1626785846
13066,409000438620',2018-09-18,MICRO ATM WDL FEE DT17091,0.0,337800.0,18003427.34000005,2018,9,18,CASH_IN,337800.0,M1296189022
13067,409000438620',2018-09-18,MICRO ATM INC DATED 17091,0.0,679.32,18004106.66000005,2018,9,18,CHECK_CASHING,679.32,C193864812
13068,409000438620',2018-09-18,MICRO ATM GST DATED 17091,0.0,135.86,18004242.520000048,2018,9,18,CASH_IN,135.86,M918903264
13069,409000438620',2018-09-18,MAW/502964XXXXXX6016/Akol,0.0,2000.0,18006242.520000048,2018,9,18,CHECK_CASHING,2000.0,M345633487
13070,409000438620',2018-09-18,MICRO ATM WDL FEE DT18091,0.0,199300.0,18205542.520000048,2018,9,18,CASH_IN,199300.0,M765698114
13071,409000438620',2018-09-18,MICRO ATM INC DATED 18091,0.0,447.48,18205990.00000005,2018,9,18,CASH_IN,447.48,M1273929597
13072,409000438620',2018-09-18,MICRO ATM GST DATED 18091,0.0,89.5,18206079.50000005,2018,9,18,TRANSFER,89.5,M1710889871
13073,409000438620',2018-09-18,MAW/502964XXXXXX4836/Karu,0.0,1800.0,18207879.50000005,2018,9,18,TRANSFER,1800.0,M443251421
13074,409000438620',2018-09-18,MAW/502964XXXXXX4565/Akol,0.0,300.0,18208179.50000005,2018,9,18,CHECK_CASHING,300.0,M572019549
13075,409000438620',2018-09-18,TRF TO  Indiaforensic SERVICES I,500000.0,0.0,17708179.50000005,2018,9,18,DEBIT,500000.0,M1324072744
13076,409000438620',2018-09-18,AEPS INCOME DT 17-09-2018,0.0,22086.69,17730266.19000005,2018,9,18,CASH_IN,22086.69,M1634710134
13077,409000438620',2018-09-18,AEPS GST INC DT 17-09-201,0.0,4417.34,17734683.53000005,2018,9,18,CHECK_CASHING,4417.34,C90250170
13078,409000438620',2018-09-18,AEPS ACQ CR ADJ FEES 1709,318.01,0.0,17734365.520000048,2018,9,18,CASH_OUT,318.01,C158876320
13079,409000438620',2018-09-18,AEPS ACQ REP ADJ FEES 170,0.0,2.95,17734368.470000047,2018,9,18,TRANSFER,2.95,C465499079
13080,409000438620',2018-09-19,Indiaforensic AEPS NPCI WDL SET1,0.0,9386100.0,27120468.47000005,2018,9,19,CASH_IN,9386100.0,M1582680409
13081,409000438620',2018-09-19,CR825911835419/RMCPL27487/1,1000.0,0.0,27119468.47000005,2018,9,19,PAYEMENT,1000.0,M1563670805
13082,409000438620',2018-09-19,CR825910820694/RMCPL18726/1,2700.0,0.0,27116768.47000005,2018,9,19,PAYEMENT,2700.0,M1207004818
13083,409000438620',2018-09-19,CR825916934155/RMCPL24076/1,1000.0,0.0,27115768.47000005,2018,9,19,CASH_OUT,1000.0,M2016241502
13084,409000438620',2018-09-19,CR825812556390/RMCPL13501/1,500.0,0.0,27115268.47000005,2018,9,19,DEBIT,500.0,M1880036664
13085,409000438620',2018-09-19,CR825817634506/RMCPL19591/1,1000.0,0.0,27114268.47000005,2018,9,19,DEBIT,1000.0,M1866697466
13086,409000438620',2018-09-19,CR825817640642/RMCPL25428/1,1000.0,0.0,27113268.47000005,2018,9,19,PAYEMENT,1000.0,M1751808290
13087,409000438620',2018-09-19,CR825817646184/RMCPL24341/1,500.0,0.0,27112768.47000005,2018,9,19,CASH_OUT,500.0,M1604520049
13088,409000438620',2018-09-19,CR825817646171/RMCPL14643/1,1000.0,0.0,27111768.47000005,2018,9,19,CASH_OUT,1000.0,C1698593276
13089,409000438620',2018-09-19,CR825818673927/RMCPL13013/1,3000.0,0.0,27108768.47000005,2018,9,19,PAYEMENT,3000.0,M710526726
13090,409000438620',2018-09-19,CR825811514524/RMCPL19639/1,1000.0,0.0,27107768.47000005,2018,9,19,DEBIT,1000.0,M2088894144
13091,409000438620',2018-09-19,CR825811523141/RMCPL16457/1,6000.0,0.0,27101768.47000005,2018,9,19,CASH_OUT,6000.0,M1951653968
13092,409000438620',2018-09-19,CR825813573793/RMCPL11613/1,1000.0,0.0,27100768.47000005,2018,9,19,CASH_OUT,1000.0,M530891662
13093,409000438620',2018-09-19,CR825811525352/RMCPL22093/1,1000.0,0.0,27099768.47000005,2018,9,19,PAYEMENT,1000.0,M1464744275
13094,409000438620',2018-09-19,CR825811525350/RMCPL28678/1,2000.0,0.0,27097768.47000005,2018,9,19,CHECK_WITHDRAWAL,2000.0,C1286084959
13095,409000438620',2018-09-19,CR825815605745/RMCPL14060/1,2000.0,0.0,27095768.47000005,2018,9,19,CASH_OUT,2000.0,C619068319
13096,409000438620',2018-09-19,CR825818658745/RMCPL13876/1,4000.0,0.0,27091768.47000005,2018,9,19,DEBIT,4000.0,C382934088
13097,409000438620',2018-09-19,CR825811531004/RMCPL26443/1,1400.0,0.0,27090368.47000005,2018,9,19,CHECK_WITHDRAWAL,1400.0,C1360767589
13098,409000438620',2018-09-19,CR825810508970/RMCPL09617/1,2300.0,0.0,27088068.47000005,2018,9,19,CASH_OUT,2300.0,M190658747
13099,409000438620',2018-09-19,CR825812545045/RMCPL21906/1,600.0,0.0,27087468.47000005,2018,9,19,CHECK_WITHDRAWAL,600.0,M1014709238
13100,409000438620',2018-09-19,CR825813562208/RMCPL19942/1,4800.0,0.0,27082668.47000005,2018,9,19,DEBIT,4800.0,M1910492313
13101,409000438620',2018-09-19,CR825812556317/RMCPL12961/1,1200.0,0.0,27081468.47000005,2018,9,19,CASH_OUT,1200.0,M994976213
13102,409000438620',2018-09-19,CR825711218055/RMCPL25049/1,500.0,0.0,27080968.47000005,2018,9,19,CHECK_WITHDRAWAL,500.0,M181702589
13103,409000438620',2018-09-19,CR825711218041/RMCPL22866/1,500.0,0.0,27080468.47000005,2018,9,19,DEBIT,500.0,M1725737877
13104,409000438620',2018-09-19,CR825711222478/RMCPL20773/1,2000.0,0.0,27078468.47000005,2018,9,19,CHECK_WITHDRAWAL,2000.0,M1287344543
13105,409000438620',2018-09-19,CR825710202597/RMCPL15535/1,1000.0,0.0,27077468.47000005,2018,9,19,DEBIT,1000.0,C1002031672
13106,409000438620',2018-09-19,CR825710202560/RMCPL26854/1,1000.0,0.0,27076468.47000005,2018,9,19,CASH_OUT,1000.0,M1458175955
13107,409000438620',2018-09-19,CR825710198707/RMCPL16457/1,10000.0,0.0,27066468.47000005,2018,9,19,CASH_OUT,10000.0,M1439439342
13108,409000438620',2018-09-19,CR825710198709/RMCPL22472/1,3000.0,0.0,27063468.47000005,2018,9,19,CHECK_WITHDRAWAL,3000.0,M1175793473
13109,409000438620',2018-09-19,CR825710206288/RMCPL26685/1,4000.0,0.0,27059468.47000005,2018,9,19,CASH_OUT,4000.0,C1856036778
13110,409000438620',2018-09-19,CR825710206290/RMCPL12796/1,1200.0,0.0,27058268.47000005,2018,9,19,DEBIT,1200.0,C1211297851
13111,409000438620',2018-09-19,CR825715280563/RMCPL25532/1,3000.0,0.0,27055268.47000005,2018,9,19,CHECK_WITHDRAWAL,3000.0,M445638804
13112,409000438620',2018-09-19,CR825716283585/RMCPL16250/1,500.0,0.0,27054768.47000005,2018,9,19,CASH_OUT,500.0,M472783563
13113,409000438620',2018-09-19,CR825716283564/RMCPL21742/1,2500.0,0.0,27052268.47000005,2018,9,19,CASH_OUT,2500.0,M1903547260
13114,409000438620',2018-09-19,CR825709178660/RMCPL24555/1,4600.0,0.0,27047668.47000005,2018,9,19,CHECK_WITHDRAWAL,4600.0,M306045599
13115,409000438620',2018-09-19,CR825710202600/RMCPL09542/1,700.0,0.0,27046968.47000005,2018,9,19,CASH_OUT,700.0,C75457651
13116,409000438620',2018-09-19,CR825711222438/RMCPL21533/1,10000.0,0.0,27036968.47000005,2018,9,19,CHECK_WITHDRAWAL,10000.0,M933965532
13117,409000438620',2018-09-19,CR825713249145/RMCPL09612/1,10000.0,0.0,27026968.47000005,2018,9,19,CHECK_WITHDRAWAL,10000.0,M1607750898
13118,409000438620',2018-09-19,TRF TO  Indiaforensic SERVICES I,5000000.0,0.0,22026968.470000047,2018,9,19,DEBIT,5000000.0,M1964677152
13119,409000438620',2018-09-19,TRF TO  Indiaforensic SERVICES I,4000000.0,0.0,18026968.470000047,2018,9,19,PAYEMENT,4000000.0,M973398147
13120,409000438620',2018-09-19,MICRO ATM WDL FEE DT18091,0.0,305100.0,18332068.470000047,2018,9,19,TRANSFER,305100.0,M1287844539
13121,409000438620',2018-09-19,MICRO ATM INC DATED 18091,0.0,717.12,18332785.59000005,2018,9,19,CHECK_CASHING,717.12,M1153075015
13122,409000438620',2018-09-19,MICRO ATM GST DATED 18091,0.0,143.42,18332929.01000005,2018,9,19,TRANSFER,143.42,C110721357
13123,409000438620',2018-09-19,MICRO ATM WDL FEE DT19091,0.0,231600.0,18564529.01000005,2018,9,19,TRANSFER,231600.0,M1436945204
13124,409000438620',2018-09-19,MICRO ATM INC DATED 19091,0.0,571.32,18565100.33000005,2018,9,19,TRANSFER,571.32,M1461489832
13125,409000438620',2018-09-19,MICRO ATM GST DATED 19091,0.0,114.26,18565214.59000005,2018,9,19,CASH_IN,114.26,M412670762
13126,409000438620',2018-09-19,AEPS INCOME DT 18-09-2018,0.0,24619.82,18589834.41000005,2018,9,19,CHECK_CASHING,24619.82,M1594046274
13127,409000438620',2018-09-19,AEPS GST INC DT 18-09-201,0.0,4923.96,18594758.370000053,2018,9,19,CHECK_CASHING,4923.96,M1752652387
13128,409000438620',2018-09-19,AEPS ACQ CR ADJ FEES 1809,378.19,0.0,18594380.18000005,2018,9,19,CHECK_WITHDRAWAL,378.19,M161218368
13129,409000438620',2018-09-19,TRF TO  Indiaforensic SERVICES I,500000.0,0.0,18094380.18000005,2018,9,19,CHECK_WITHDRAWAL,500000.0,M700948805
13130,409000438620',2018-09-20,CB825012695127/RMCPL24928/0,500.0,0.0,18093880.18000005,2018,9,20,CHECK_WITHDRAWAL,500.0,C439078113
13131,409000438620',2018-09-20,Indiaforensic AEPS NPCI WDL SET1,0.0,8097300.0,26191180.18000005,2018,9,20,CHECK_CASHING,8097300.0,C1211297851
13132,409000438620',2018-09-20,CR826012181229/RMCPL26592/1,500.0,0.0,26190680.18000005,2018,9,20,DEBIT,500.0,M1994900396
13133,409000438620',2018-09-20,CR826012168678/RMCPL19942/1,500.0,0.0,26190180.18000005,2018,9,20,CASH_OUT,500.0,M478815058
13134,409000438620',2018-09-20,CR826010145312/RMCPL28890/1,5000.0,0.0,26185180.18000005,2018,9,20,CASH_OUT,5000.0,M1112095751
13135,409000438620',2018-09-20,CR826013191639/RMCPL21824/1,4000.0,0.0,26181180.18000005,2018,9,20,DEBIT,4000.0,M1646002643
13136,409000438620',2018-09-20,CR826017253850/RMCPL19963/1,2000.0,0.0,26179180.18000005,2018,9,20,CASH_OUT,2000.0,M943076330
13137,409000438620',2018-09-20,CR826009115697/RMCPL20722/1,1000.0,0.0,26178180.18000005,2018,9,20,DEBIT,1000.0,M478098502
13138,409000438620',2018-09-20,CR826011151018/RMCPL13013/1,3000.0,0.0,26175180.18000005,2018,9,20,PAYEMENT,3000.0,M35159292
13139,409000438620',2018-09-20,CR826011151021/RMCPL18095/1,3000.0,0.0,26172180.18000005,2018,9,20,DEBIT,3000.0,M71963814
13140,409000438620',2018-09-20,CR826017248487/RMCPL03676/1,500.0,0.0,26171680.18000005,2018,9,20,PAYEMENT,500.0,M188369322
13141,409000438620',2018-09-20,CR826016244053/RMCPL25432/1,7000.0,0.0,26164680.18000005,2018,9,20,PAYEMENT,7000.0,M680161538
13142,409000438620',2018-09-20,AEPS INCOME DT 19-09-2018,0.0,21519.26,26186199.44000005,2018,9,20,CASH_IN,21519.26,M450328998
13143,409000438620',2018-09-20,AEPS GST INC DT 19-09-201,0.0,4303.85,26190503.29000005,2018,9,20,CHECK_CASHING,4303.85,M273062011
13144,409000438620',2018-09-20,AEPS ACQ CR ADJ FEES 1909,115.05,0.0,26190388.24000005,2018,9,20,CHECK_WITHDRAWAL,115.05,M989075280
13145,409000438620',2018-09-20,TRF TO  Indiaforensic SERVICES I,8500000.0,0.0,17690388.240000054,2018,9,20,PAYEMENT,8500000.0,M172835353
13146,409000438620',2018-09-21,Indiaforensic AEPS NPCI WDL SET,0.0,7500800.0,25191188.24000005,2018,9,21,TRANSFER,7500800.0,M1904841165
13147,409000438620',2018-09-21,FUND TRF TO  Indiaforensic SERVI,7500000.0,0.0,17691188.240000054,2018,9,21,CHECK_WITHDRAWAL,7500000.0,M1535462941
13148,409000438620',2018-09-21,NPCI SETELEMENT DIFF_1909,0.0,1000.0,17692188.240000054,2018,9,21,TRANSFER,1000.0,M1732778795
13149,409000438620',2018-09-21,MAW/502964XXXXXX9031/NAGA,0.0,1000.0,17693188.240000054,2018,9,21,CASH_IN,1000.0,M1778175705
13150,409000438620',2018-09-21,MICRO ATM WDL FEE DT19091,0.0,250300.0,17943488.240000054,2018,9,21,CHECK_CASHING,250300.0,M50848559
13151,409000438620',2018-09-21,MICRO ATM INC DATED 19091,0.0,577.8,17944066.040000055,2018,9,21,CHECK_CASHING,577.8,M1356171633
13152,409000438620',2018-09-21,MICRO ATM GST DATED 19091,0.0,115.56,17944181.600000054,2018,9,21,TRANSFER,115.56,M1095089055
13153,409000438620',2018-09-21,MICRO ATM WDL FEE DT20091,0.0,193500.0,18137681.600000054,2018,9,21,TRANSFER,193500.0,C440708502
13154,409000438620',2018-09-21,MICRO ATM INC DATED 20091,0.0,483.12,18138164.72000005,2018,9,21,CHECK_CASHING,483.12,C713987035
13155,409000438620',2018-09-21,MICRO ATM GST DATED 20091,0.0,96.62,18138261.340000056,2018,9,21,CHECK_CASHING,96.62,M1249903549
13156,409000438620',2018-09-21,AEPS INCOME DT 20-09-2018,0.0,19886.88,18158148.22000005,2018,9,21,TRANSFER,19886.88,M586136541
13157,409000438620',2018-09-21,AEPS GST INC DT 20-09-201,0.0,3977.38,18162125.600000054,2018,9,21,CHECK_CASHING,3977.38,M1613291907
13158,409000438620',2018-09-21,FUND TRF TO  Indiaforensic SERVI,400000.0,0.0,17762125.600000054,2018,9,21,CASH_OUT,400000.0,M1188683118
13159,409000438620',2018-09-21,AEPS PAY Indiaforensic 2009,0.0,298.93,17762424.530000053,2018,9,21,CHECK_CASHING,298.93,M929543051
13160,409000438620',2018-09-21,MICRO ATM WDL FEE DT20091,0.0,296400.0,18058824.530000053,2018,9,21,CHECK_CASHING,296400.0,C1937962514
13161,409000438620',2018-09-21,MICRO ATM INC DATED 20091,0.0,613.8,18059438.330000054,2018,9,21,CASH_IN,613.8,M672723344
13162,409000438620',2018-09-21,MICRO ATM GST DATED 20091,0.0,122.76,18059561.090000056,2018,9,21,CASH_IN,122.76,M649999107
13163,409000438620',2018-09-21,MICRO ATM WDL FEE DT21091,0.0,216500.0,18276061.090000056,2018,9,21,CHECK_CASHING,216500.0,M295292016
13164,409000438620',2018-09-21,MICRO ATM INC DATED 21091,0.0,490.32,18276551.410000056,2018,9,21,CHECK_CASHING,490.32,C1174600239
13165,409000438620',2018-09-21,MICRO ATM GST DATED 21091,0.0,98.06,18276649.47000005,2018,9,21,CHECK_CASHING,98.06,M1148482953
13166,409000438620',2018-09-24,MAW/502964XXXXXX0502/NAGA,0.0,1100.0,18277749.47000005,2018,9,24,CHECK_CASHING,1100.0,M807831681
13167,409000438620',2018-09-24,CR826111430714/RMCPL16251/1,1000.0,0.0,18276749.47000005,2018,9,24,PAYEMENT,1000.0,M601206185
13168,409000438620',2018-09-24,CR826112443718/RMCPL26770/1,1000.0,0.0,18275749.47000005,2018,9,24,CASH_OUT,1000.0,M850318899
13169,409000438620',2018-09-24,CR826115497785/RMCPL24609/1,1000.0,0.0,18274749.47000005,2018,9,24,CHECK_WITHDRAWAL,1000.0,M710977520
13170,409000438620',2018-09-24,CR826111435504/RMCPL28497/1,2500.0,0.0,18272249.47000005,2018,9,24,DEBIT,2500.0,M420728297
13171,409000438620',2018-09-24,CR826116516516/RMCPL20307/1,1000.0,0.0,18271249.47000005,2018,9,24,CHECK_WITHDRAWAL,1000.0,C814900611
13172,409000438620',2018-09-24,CR826119571766/RMCPL11265/1,1000.0,0.0,18270249.47000005,2018,9,24,CASH_OUT,1000.0,M1019204680
13173,409000438620',2018-09-24,CR826113470792/RMCPL24066/1,800.0,0.0,18269449.47000005,2018,9,24,CHECK_WITHDRAWAL,800.0,M216894663
13174,409000438620',2018-09-24,CR826117524554/RMCPL09386/1,500.0,0.0,18268949.47000005,2018,9,24,DEBIT,500.0,M1426815634
13175,409000438620',2018-09-24,CR826114486373/RMCPL20178/1,1000.0,0.0,18267949.47000005,2018,9,24,DEBIT,1000.0,C1207946845
13176,409000438620',2018-09-24,CR826118538421/RMCPL19146/1,500.0,0.0,18267449.47000005,2018,9,24,CASH_OUT,500.0,C1083142315
13177,409000438620',2018-09-24,CR826219844286/RMCPL23833/1,10000.0,0.0,18257449.47000005,2018,9,24,PAYEMENT,10000.0,C1926673338
13178,409000438620',2018-09-24,CR826212725111/RMCPL26544/1,7300.0,0.0,18250149.47000005,2018,9,24,PAYEMENT,7300.0,C758750856
13179,409000438620',2018-09-24,CR826212714641/RMCPL09582/1,500.0,0.0,18249649.47000005,2018,9,24,CHECK_WITHDRAWAL,500.0,C1501701470
13180,409000438620',2018-09-24,CR826209671909/RMCPL20928/1,1500.0,0.0,18248149.47000005,2018,9,24,CASH_OUT,1500.0,C306206744
13181,409000438620',2018-09-24,CR826214745737/RMCPL14060/1,500.0,0.0,18247649.47000005,2018,9,24,CHECK_WITHDRAWAL,500.0,C128870695
13182,409000438620',2018-09-24,CR826213741387/RMCPL09612/1,3000.0,0.0,18244649.47000005,2018,9,24,CASH_OUT,3000.0,C1948471365
13183,409000438620',2018-09-24,CR826213741407/RMCPL19783/1,2200.0,0.0,18242449.47000005,2018,9,24,CHECK_WITHDRAWAL,2200.0,C875917495
13184,409000438620',2018-09-24,CR826209671897/RMCPL26348/1,1500.0,0.0,18240949.47000005,2018,9,24,CASH_OUT,1500.0,C1060041730
13185,409000438620',2018-09-24,CR826209671910/RMCPL03043/1,3000.0,0.0,18237949.47000005,2018,9,24,CASH_OUT,3000.0,C875761527
13186,409000438620',2018-09-24,CR826210688649/RMCPL22291/1,3000.0,0.0,18234949.47000005,2018,9,24,CASH_OUT,3000.0,C216890954
13187,409000438620',2018-09-24,CR826214750216/RMCPL22038/1,500.0,0.0,18234449.47000005,2018,9,24,DEBIT,500.0,C295372946
13188,409000438620',2018-09-24,CR826213736565/RMCPL16914/1,500.0,0.0,18233949.47000005,2018,9,24,DEBIT,500.0,C1450133081
13189,409000438620',2018-09-24,CR826211699376/RMCPL19631/1,2000.0,0.0,18231949.47000005,2018,9,24,DEBIT,2000.0,C1453128758
13190,409000438620',2018-09-24,CR826215760784/RMCPL19485/1,1800.0,0.0,18230149.47000005,2018,9,24,CHECK_WITHDRAWAL,1800.0,C1266035080
13191,409000438620',2018-09-24,CR826212725782/RMCPL24718/1,2000.0,0.0,18228149.47000005,2018,9,24,DEBIT,2000.0,C599726537
13192,409000438620',2018-09-24,MAW/502964XXXXXX2699/Karu,0.0,1700.0,18229849.47000005,2018,9,24,TRANSFER,1700.0,C1559145228
13193,409000438620',2018-09-24,MAW/502964XXXXXX2326/Karu,0.0,1700.0,18231549.47000005,2018,9,24,CHECK_CASHING,1700.0,C459172227
13194,409000438620',2018-09-24,MAW/502964XXXXXX6017/Karu,0.0,1700.0,18233249.47000005,2018,9,24,CASH_IN,1700.0,C533866202
13195,409000438620',2018-09-24,MAW/502964XXXXXX6461/Karu,0.0,1700.0,18234949.47000005,2018,9,24,CHECK_CASHING,1700.0,C2078522098
13196,409000438620',2018-09-24,MAW/502964XXXXXX8931/Karu,0.0,1700.0,18236649.47000005,2018,9,24,CASH_IN,1700.0,C1092318644
13197,409000438620',2018-09-24,MAW/502964XXXXXX2659/Karu,0.0,1700.0,18238349.47000005,2018,9,24,CHECK_CASHING,1700.0,C1754599205
13198,409000438620',2018-09-24,Indiaforensic AEPS NPCI WDL SET,0.0,7035300.0,25273649.47000005,2018,9,24,CASH_IN,7035300.0,C1317731757
13199,409000438620',2018-09-24,MAW/502964XXXXXX6867/Karu,0.0,1700.0,25275349.47000005,2018,9,24,CASH_IN,1700.0,C72565662
13200,409000438620',2018-09-24,MAW/502964XXXXXX4752/Karu,0.0,1700.0,25277049.47000005,2018,9,24,TRANSFER,1700.0,C1601071362
13201,409000438620',2018-09-24,MAW/502964XXXXXX0153/Karu,0.0,1700.0,25278749.47000005,2018,9,24,CASH_IN,1700.0,C643996026
13202,409000438620',2018-09-24,MAW/502964XXXXXX8972/Karu,0.0,1700.0,25280449.47000005,2018,9,24,TRANSFER,1700.0,C798678484
13203,409000438620',2018-09-24,MAW/502964XXXXXX0609/Karu,0.0,1700.0,25282149.47000005,2018,9,24,TRANSFER,1700.0,C1933965693
13204,409000438620',2018-09-24,Indiaforensic AEPS NPCI WDL SET,0.0,6940100.0,32222249.47000005,2018,9,24,CHECK_CASHING,6940100.0,C646059443
13205,409000438620',2018-09-24,Indiaforensic AEPS NPCI WDL SET,0.0,4423800.0,36646049.47000006,2018,9,24,CHECK_CASHING,4423800.0,C1149273771
13206,409000438620',2018-09-24,MAW/502964XXXXXX0429/Karu,0.0,4800.0,36650849.47000006,2018,9,24,CASH_IN,4800.0,C1103621993
13207,409000438620',2018-09-24,TRF TO  Indiaforensic SERVICES I,2000000.0,0.0,34650849.47000006,2018,9,24,PAYEMENT,2000000.0,M622132005
13208,409000438620',2018-09-24,TRF TO  Indiaforensic SERVICES I,5000000.0,0.0,29650849.47000006,2018,9,24,DEBIT,5000000.0,M1147079853
13209,409000438620',2018-09-24,TRF TO  Indiaforensic SERVICES I,11900000.0,0.0,17750849.47000006,2018,9,24,PAYEMENT,11900000.0,C611621587
13210,409000438620',2018-09-24,MICRO ATM WDL FEE DT21091,0.0,269100.0,18019949.47000006,2018,9,24,CASH_IN,269100.0,M1425928133
13211,409000438620',2018-09-24,MICRO ATM INC DATED 21091,0.0,615.6,18020565.07000006,2018,9,24,CHECK_CASHING,615.6,C1394526584
13212,409000438620',2018-09-24,MICRO ATM GST DATED 21091,0.0,123.12,18020688.19000006,2018,9,24,TRANSFER,123.12,C1816757085
13213,409000438620',2018-09-24,MAW/502964XXXXXX2136/NAGA,0.0,900.0,18021588.19000006,2018,9,24,CASH_IN,900.0,C766681183
13214,409000438620',2018-09-24,MICRO ATM WDL FEE DT22091,0.0,709300.0,18730888.19000006,2018,9,24,TRANSFER,709300.0,C1590550415
13215,409000438620',2018-09-24,MICRO ATM INC DATED 22091,0.0,1614.96,18732503.15000006,2018,9,24,TRANSFER,1614.96,C459172227
13216,409000438620',2018-09-24,MICRO ATM GST DATED 22091,0.0,322.99,18732826.14000006,2018,9,24,CASH_IN,322.99,C1727565779
13217,409000438620',2018-09-24,AEPS PAY Indiaforensic 2109,0.0,299.52,18733125.66000006,2018,9,24,CASH_IN,299.52,C1334272276
13218,409000438620',2018-09-24,AEPS INCOME DT 21-09-2018,0.0,18785.17,18751910.83000006,2018,9,24,CHECK_CASHING,18785.17,C97730845
13219,409000438620',2018-09-24,AEPS GST INC DT 21-09-201,0.0,3757.03,18755667.860000066,2018,9,24,TRANSFER,3757.03,M1375798147
13220,409000438620',2018-09-24,AEPS INCOME DT 22-09-2018,0.0,18378.95,18774046.810000066,2018,9,24,CASH_IN,18378.95,C1541743053
13221,409000438620',2018-09-24,AEPS GST INC DT 22-09-201,0.0,3675.79,18777722.60000006,2018,9,24,CHECK_CASHING,3675.79,C413177525
13222,409000438620',2018-09-24,AEPS INCOME DT 23-09-2018,0.0,11916.23,18789638.83000006,2018,9,24,CASH_IN,11916.23,M715982304
13223,409000438620',2018-09-24,AEPS GST INC DT 23-09-201,0.0,2383.25,18792022.08000006,2018,9,24,TRANSFER,2383.25,M407068374
13224,409000438620',2018-09-24,MICRO ATM WDL FEE DT23091,0.0,510600.0,19302622.08000006,2018,9,24,CASH_IN,510600.0,M2049079655
13225,409000438620',2018-09-24,MICRO ATM INC DATED 23091,0.0,1182.96,19303805.040000066,2018,9,24,TRANSFER,1182.96,M191732156
13226,409000438620',2018-09-24,MICRO ATM GST DATED 23091,0.0,236.59,19304041.630000066,2018,9,24,CASH_IN,236.59,M1298961405
13227,409000438620',2018-09-24,AEPS ACQ CR ADJ FEES 2109,225.97,0.0,19303815.660000063,2018,9,24,CASH_OUT,225.97,M1966288335
13228,409000438620',2018-09-24,GFCB819418940693/RMCPL16717,0.0,700.0,19304515.660000063,2018,9,24,CHECK_CASHING,700.0,M423244858
13229,409000438620',2018-09-24,AEPS ACQ GF RE ADJ FEES 2,0.0,4.13,19304519.790000066,2018,9,24,CHECK_CASHING,4.13,M1081621020
13230,409000438620',2018-09-24,TRF TO  Indiaforensic SERVICES I,1000000.0,0.0,18304519.790000066,2018,9,24,CHECK_WITHDRAWAL,1000000.0,C35534346
13231,409000438620',2018-09-24,MICRO ATM WDL FEE DT24091,0.0,212600.0,18517119.790000066,2018,9,24,CASH_IN,212600.0,M1488975117
13232,409000438620',2018-09-24,MICRO ATM INC DATED 24091,0.0,504.0,18517623.790000066,2018,9,24,CASH_IN,504.0,M1832051218
13233,409000438620',2018-09-24,MICRO ATM GST DATED 24091,0.0,100.8,18517724.590000063,2018,9,24,CHECK_CASHING,100.8,C1782704802
13234,409000438620',2018-09-24,NPCI SETELEMENT DIFF_2209,0.0,9000.0,18526724.590000063,2018,9,24,CASH_IN,9000.0,M1085323526
13235,409000438620',2018-09-25,MAW/502964XXXXXX6008/Karu,0.0,1700.0,18528424.590000063,2018,9,25,CHECK_CASHING,1700.0,C1247037042
13236,409000438620',2018-09-25,MAW/502964XXXXXX6577/Karu,0.0,1700.0,18530124.590000063,2018,9,25,CASH_IN,1700.0,M430248020
13237,409000438620',2018-09-25,MAW/502964XXXXXX3051/Karu,0.0,1700.0,18531824.590000063,2018,9,25,CHECK_CASHING,1700.0,M554105725
13238,409000438620',2018-09-25,MAW/502964XXXXXX4589/Karu,0.0,1700.0,18533524.590000063,2018,9,25,TRANSFER,1700.0,C2065199032
13239,409000438620',2018-09-25,MAW/502964XXXXXX2288/Karu,0.0,1700.0,18535224.590000063,2018,9,25,CASH_IN,1700.0,M304607110
13240,409000438620',2018-09-25,MAW/502964XXXXXX2806/Karu,0.0,1700.0,18536924.590000063,2018,9,25,CHECK_CASHING,1700.0,M327654471
13241,409000438620',2018-09-25,Indiaforensic AEPS NPCI WDL SET,0.0,7673300.0,26210224.590000063,2018,9,25,TRANSFER,7673300.0,C1424731356
13242,409000438620',2018-09-25,CB825611969503/RMCPL09590/1,10000.0,0.0,26200224.590000063,2018,9,25,PAYEMENT,10000.0,M1234867113
13243,409000438620',2018-09-25,TRF TO  Indiaforensic SERVICES I,4000000.0,0.0,22200224.590000063,2018,9,25,CASH_OUT,4000000.0,M585699882
13244,409000438620',2018-09-25,TFR TO  Indiaforensic SERVICES I,4000000.0,0.0,18200224.590000063,2018,9,25,DEBIT,4000000.0,M1644622125
13245,409000438620',2018-09-25,TRF TO  Indiaforensic SERVICES I,500000.0,0.0,17700224.590000063,2018,9,25,CASH_OUT,500000.0,M1828446002
13246,409000438620',2018-09-25,MAW/502964XXXXXX1757/NAGA,0.0,2200.0,17702424.590000063,2018,9,25,CASH_IN,2200.0,M666243498
13247,409000438620',2018-09-25,MICRO ATM WDL FEE DT24091,0.0,316700.0,18019124.590000063,2018,9,25,TRANSFER,316700.0,M1544211884
13248,409000438620',2018-09-25,MICRO ATM INC DATED 24091,0.0,770.4,18019894.99000006,2018,9,25,CHECK_CASHING,770.4,M1502741059
13249,409000438620',2018-09-25,MICRO ATM GST DATED 24091,0.0,154.08,18020049.07000006,2018,9,25,TRANSFER,154.08,M1763160116
13250,409000438620',2018-09-25,AEPS INCOME DT 24-09-2018,0.0,20561.65,18040610.72000006,2018,9,25,TRANSFER,20561.65,M500597034
13251,409000438620',2018-09-25,AEPS GST INC DT 24-09-201,0.0,4112.33,18044723.050000057,2018,9,25,CASH_IN,4112.33,M2037186541
13252,409000438620',2018-09-25,MICRO ATM WDL FEE DT25091,0.0,242900.0,18287623.050000057,2018,9,25,TRANSFER,242900.0,M2082923888
13253,409000438620',2018-09-25,MICRO ATM INC DATED 25091,0.0,568.8,18288191.850000054,2018,9,25,CHECK_CASHING,568.8,M1010350904
13254,409000438620',2018-09-25,MICRO ATM GST DATED 25091,0.0,113.76,18288305.61000006,2018,9,25,CHECK_CASHING,113.76,M628455732
13255,409000438620',2018-09-26,TRF TO  Indiaforensic SERVICES I,300000.0,0.0,17988305.61000006,2018,9,26,CHECK_WITHDRAWAL,300000.0,M1393493012
13256,409000438620',2018-09-26,MAW/502964XXXXXX6735/Karu,0.0,1700.0,17990005.61000006,2018,9,26,TRANSFER,1700.0,M731844590
13257,409000438620',2018-09-26,MAW/502964XXXXXX4720/Karu,0.0,1700.0,17991705.61000006,2018,9,26,CHECK_CASHING,1700.0,M381872803
13258,409000438620',2018-09-26,MAW/502964XXXXXX2193/Karu,0.0,1700.0,17993405.61000006,2018,9,26,CASH_IN,1700.0,M199719432
13259,409000438620',2018-09-26,MAW/502964XXXXXX8654/Karu,0.0,1700.0,17995105.61000006,2018,9,26,CASH_IN,1700.0,M76337939
13260,409000438620',2018-09-26,MAW/502964XXXXXX4715/Karu,0.0,1700.0,17996805.61000006,2018,9,26,CASH_IN,1700.0,M1263835071
13261,409000438620',2018-09-26,MAW/502964XXXXXX4597/Karu,0.0,1700.0,17998505.61000006,2018,9,26,CHECK_CASHING,1700.0,M2044674471
13262,409000438620',2018-09-26,MAW/502964XXXXXX4570/Karu,0.0,1700.0,18000205.61000006,2018,9,26,CASH_IN,1700.0,M1908574814
13263,409000438620',2018-09-26,MAW/502964XXXXXX4471/Karu,0.0,1700.0,18001905.61000006,2018,9,26,TRANSFER,1700.0,M554017717
13264,409000438620',2018-09-26,CR826309941199/RMCPL22800/2,1100.0,0.0,18000805.61000006,2018,9,26,CHECK_WITHDRAWAL,1100.0,M2054213432
13265,409000438620',2018-09-26,CR826311974588/RMCPL15429/2,1000.0,0.0,17999805.61000006,2018,9,26,PAYEMENT,1000.0,C118648358
13266,409000438620',2018-09-26,CR826314021260/RMCPL21030/2,1800.0,0.0,17998005.61000006,2018,9,26,DEBIT,1800.0,M1113003845
13267,409000438620',2018-09-26,CR826311972670/RMCPL24597/2,5000.0,0.0,17993005.61000006,2018,9,26,CASH_OUT,5000.0,M2041096918
13268,409000438620',2018-09-26,MICRO ATM WDL FEE DT25091,0.0,280500.0,18273505.61000006,2018,9,26,TRANSFER,280500.0,M1760074870
13269,409000438620',2018-09-26,MICRO ATM INC DATED 25091,0.0,727.2,18274232.81000006,2018,9,26,CASH_IN,727.2,M2054147987
13270,409000438620',2018-09-26,MICRO ATM GST DATED 25091,0.0,145.44,18274378.25000006,2018,9,26,CASH_IN,145.44,M1044200656
13271,409000438620',2018-09-26,MAW/502964XXXXXX2353/Karu,0.0,1700.0,18276078.25000006,2018,9,26,TRANSFER,1700.0,M364167070
13272,409000438620',2018-09-26,MAW/502964XXXXXX8746/Karu,0.0,1700.0,18277778.25000006,2018,9,26,TRANSFER,1700.0,M3065272
13273,409000438620',2018-09-26,MAW/502964XXXXXX4475/Karu,0.0,1700.0,18279478.25000006,2018,9,26,TRANSFER,1700.0,M1051730626
13274,409000438620',2018-09-26,MAW/502964XXXXXX1243/Karu,0.0,1700.0,18281178.25000006,2018,9,26,TRANSFER,1700.0,M182773555
13275,409000438620',2018-09-26,MAW/502964XXXXXX7641/Karu,0.0,1900.0,18283078.25000006,2018,9,26,CHECK_CASHING,1900.0,M2052907145
13276,409000438620',2018-09-26,AEPS INCOME DT 25-09-2018,0.0,19792.8,18302871.05000006,2018,9,26,CASH_IN,19792.8,M608056229
13277,409000438620',2018-09-26,AEPS GST INC DT 25-09-201,0.0,3958.56,18306829.61000006,2018,9,26,TRANSFER,3958.56,M1463163240
13278,409000438620',2018-09-26,AEPS ACQ CR ADJ FEES 2509,40.71,0.0,18306788.90000005,2018,9,26,CHECK_WITHDRAWAL,40.71,M2138437168
13279,409000438620',2018-09-26,MICRO ATM WDL FEE DT26091,0.0,206400.0,18513188.90000005,2018,9,26,TRANSFER,206400.0,M1305076714
13280,409000438620',2018-09-26,MICRO ATM INC DATED 26091,0.0,448.56,18513637.460000057,2018,9,26,TRANSFER,448.56,M766554564
13281,409000438620',2018-09-26,MICRO ATM GST DATED 26091,0.0,89.71,18513727.170000054,2018,9,26,TRANSFER,89.71,M529747928
13282,409000438620',2018-09-26,TRF TO  Indiaforensic SERVICES I,600000.0,0.0,17913727.170000058,2018,9,26,CASH_OUT,600000.0,M1788678692
13283,409000438620',2018-09-27,CR826611636134/RMCPL17978/2,1000.0,0.0,17912727.170000058,2018,9,27,PAYEMENT,1000.0,M1272912830
13284,409000438620',2018-09-27,CR826610623875/RMCPL09726/2,10000.0,0.0,17902727.170000058,2018,9,27,DEBIT,10000.0,M1458319818
13285,409000438620',2018-09-27,CR826513431620/RMCPL23812/2,1500.0,0.0,17901227.170000058,2018,9,27,PAYEMENT,1500.0,M278853760
13286,409000438620',2018-09-27,CR826513431614/RMCPL24609/2,700.0,0.0,17900527.170000058,2018,9,27,PAYEMENT,700.0,M1674034927
13287,409000438620',2018-09-27,CR826509377221/RMCPL11592/2,1500.0,0.0,17899027.170000058,2018,9,27,CHECK_WITHDRAWAL,1500.0,M1604550873
13288,409000438620',2018-09-27,CR826516471482/RMCPL15559/2,500.0,0.0,17898527.170000058,2018,9,27,CHECK_WITHDRAWAL,500.0,M1084278156
13289,409000438620',2018-09-27,CR826512424822/RMCPL15375/2,2000.0,0.0,17896527.170000058,2018,9,27,CASH_OUT,2000.0,M1253881765
13290,409000438620',2018-09-27,CR826509383063/RMCPL24026/2,500.0,0.0,17896027.170000058,2018,9,27,DEBIT,500.0,M1666453188
13291,409000438620',2018-09-27,CR826515457448/RMCPL25669/2,3000.0,0.0,17893027.170000058,2018,9,27,DEBIT,3000.0,M396601897
13292,409000438620',2018-09-27,CR826510399934/RMCPL23324/2,500.0,0.0,17892527.170000058,2018,9,27,PAYEMENT,500.0,M1240004
13293,409000438620',2018-09-27,CR826514449998/RMCPL24794/2,1500.0,0.0,17891027.170000058,2018,9,27,PAYEMENT,1500.0,M1529759638
13294,409000438620',2018-09-27,CR826512421168/RMCPL09290/2,500.0,0.0,17890527.170000058,2018,9,27,CASH_OUT,500.0,M278969660
13295,409000438620',2018-09-27,CR826412200332/RMCPL15566/2,500.0,0.0,17890027.170000058,2018,9,27,CHECK_WITHDRAWAL,500.0,M1522900020
13296,409000438620',2018-09-27,CR826411183653/RMCPL18655/2,1500.0,0.0,17888527.170000058,2018,9,27,DEBIT,1500.0,C2011996123
13297,409000438620',2018-09-27,CR826411194847/RMCPL24092/2,1000.0,0.0,17887527.170000058,2018,9,27,DEBIT,1000.0,M296556077
13298,409000438620',2018-09-27,CR826412206046/RMCPL23887/2,5000.0,0.0,17882527.170000058,2018,9,27,CASH_OUT,5000.0,M1358763317
13299,409000438620',2018-09-27,CR826414235519/RMCPL21107/2,500.0,0.0,17882027.170000058,2018,9,27,CASH_OUT,500.0,M1804905894
13300,409000438620',2018-09-27,CR826414235516/RMCPL20034/2,1000.0,0.0,17881027.170000058,2018,9,27,CASH_OUT,1000.0,M1291375698
13301,409000438620',2018-09-27,CR826412200352/RMCPL23592/2,2000.0,0.0,17879027.170000058,2018,9,27,DEBIT,2000.0,C559483701
13302,409000438620',2018-09-27,CR826410173918/RMCPL15535/2,500.0,0.0,17878527.170000058,2018,9,27,PAYEMENT,500.0,M1259656245
13303,409000438620',2018-09-27,MAW/502964XXXXXX7642/Karu,0.0,1700.0,17880227.170000058,2018,9,27,TRANSFER,1700.0,M1468909766
13304,409000438620',2018-09-27,MAW/502964XXXXXX5073/Karu,0.0,1700.0,17881927.170000058,2018,9,27,CASH_IN,1700.0,M1504675381
13305,409000438620',2018-09-27,MAW/502964XXXXXX9723/Karu,0.0,1700.0,17883627.170000058,2018,9,27,CHECK_CASHING,1700.0,M124009590
13306,409000438620',2018-09-27,MICRO ATM WDL FEE DT26091,0.0,267500.0,18151127.170000054,2018,9,27,CASH_IN,267500.0,M745110672
13307,409000438620',2018-09-27,MICRO ATM INC DATED 26091,0.0,698.76,18151825.93000006,2018,9,27,TRANSFER,698.76,M76836067
13308,409000438620',2018-09-27,MICRO ATM GST DATED 26091,0.0,139.75,18151965.68000006,2018,9,27,TRANSFER,139.75,M2094953615
13309,409000438620',2018-09-27,MICRO ATM WDL FEE DT27091,0.0,176900.0,18328865.68000006,2018,9,27,CASH_IN,176900.0,C1113848808
13310,409000438620',2018-09-27,MICRO ATM INC DATED 27091,0.0,455.4,18329321.080000054,2018,9,27,CASH_IN,455.4,M1763140246
13311,409000438620',2018-09-27,MICRO ATM GST DATED 27091,0.0,91.08,18329412.160000056,2018,9,27,CHECK_CASHING,91.08,M1431817332
13312,409000438620',2018-09-27,AEPS INCOME DT 26-09-2018,0.0,18929.11,18348341.27000005,2018,9,27,TRANSFER,18929.11,C1788961047
13313,409000438620',2018-09-27,AEPS GST INC DT 26-09-201,0.0,3785.82,18352127.090000056,2018,9,27,TRANSFER,3785.82,M1097898664
13314,409000438620',2018-09-27,AEPS ACQUIRING ADJ FEES 2,17.7,0.0,18352109.390000056,2018,9,27,PAYEMENT,17.7,M755839392
13315,409000438620',2018-09-27,AEPS ACQ CR ADJ FEES 2609,154.58,0.0,18351954.81000006,2018,9,27,CASH_OUT,154.58,C811037326
13316,409000438620',2018-09-27,TRF TO  Indiaforensic SERVICES I,600000.0,0.0,17751954.81000006,2018,9,27,PAYEMENT,600000.0,M1736628078
13317,409000438620',2018-09-27,Indiaforensic AEPS NPCI WDL SET,0.0,2400.0,17754354.81000006,2018,9,27,CHECK_CASHING,2400.0,M1042184866
13318,409000438620',2018-09-27,AEPS INCOME DT 19-09-2018,0.0,9.0,17754363.81000006,2018,9,27,CHECK_CASHING,9.0,C1304046855
13319,409000438620',2018-09-27,AEPS GST INC DT 19-09-201,0.0,1.8,17754365.61000006,2018,9,27,CASH_IN,1.8,M77838683
13320,409000438620',2018-09-28,MAW/502964XXXXXX0384/Karu,0.0,1700.0,17756065.61000006,2018,9,28,CHECK_CASHING,1700.0,M1168739480
13321,409000438620',2018-09-28,MICRO ATM INC DATED 27091,0.0,600.84,17756666.45000006,2018,9,28,TRANSFER,600.84,M1706817395
13322,409000438620',2018-09-28,MICRO ATM GST DATED 27091,0.0,120.17,17756786.62000006,2018,9,28,CASH_IN,120.17,M234602416
13323,409000438620',2018-09-28,CB826710835389/RMCPL25078/2,1500.0,0.0,17755286.62000006,2018,9,28,CHECK_WITHDRAWAL,1500.0,M338684257
13324,409000438620',2018-09-28,CB826718950168/RMCPL23157/2,4500.0,0.0,17750786.62000006,2018,9,28,CHECK_WITHDRAWAL,4500.0,M969679245
13325,409000438620',2018-09-28,CB826712872484/RMCPL22300/2,2000.0,0.0,17748786.62000006,2018,9,28,PAYEMENT,2000.0,M1347012376
13326,409000438620',2018-09-28,CB826710830595/RMCPL18204/2,5000.0,0.0,17743786.62000006,2018,9,28,CASH_OUT,5000.0,C1921838990
13327,409000438620',2018-09-28,CB826711860270/RMCPL18061/2,500.0,0.0,17743286.62000006,2018,9,28,DEBIT,500.0,C1036454560
13328,409000438620',2018-09-28,CB826710830627/RMCPL23228/2,2000.0,0.0,17741286.62000006,2018,9,28,PAYEMENT,2000.0,C1311325237
13329,409000438620',2018-09-28,CB826710835396/RMCPL26423/2,5000.0,0.0,17736286.62000006,2018,9,28,CHECK_WITHDRAWAL,5000.0,C9916873
13330,409000438620',2018-09-28,CB826709805313/RMCPL14954/2,500.0,0.0,17735786.62000006,2018,9,28,CASH_OUT,500.0,C1473237843
13331,409000438620',2018-09-28,CB826711848137/RMCPL19636/2,1000.0,0.0,17734786.62000006,2018,9,28,DEBIT,1000.0,C728885526
13332,409000438620',2018-09-28,CB826710839237/RMCPL24446/2,700.0,0.0,17734086.62000006,2018,9,28,CHECK_WITHDRAWAL,700.0,C439917369
13333,409000438620',2018-09-28,CB826715911932/RMCPL21941/2,500.0,0.0,17733586.62000006,2018,9,28,PAYEMENT,500.0,C1233191588
13334,409000438620',2018-09-28,CB826715911923/RMCPL21642/2,1200.0,0.0,17732386.62000006,2018,9,28,PAYEMENT,1200.0,C1389405694
13335,409000438620',2018-09-28,CB826710839163/RMCPL14558/2,2000.0,0.0,17730386.62000006,2018,9,28,CASH_OUT,2000.0,C578294406
13336,409000438620',2018-09-28,CB826711852097/RMCPL20757/2,800.0,0.0,17729586.62000006,2018,9,28,DEBIT,800.0,C1036454560
13337,409000438620',2018-09-28,CB826711852091/RMCPL15429/2,800.0,0.0,17728786.62000006,2018,9,28,CHECK_WITHDRAWAL,800.0,C420398953
13338,409000438620',2018-09-28,CB826816178542/RMCPL01460/2,500.0,0.0,17728286.62000006,2018,9,28,DEBIT,500.0,C1916720513
13339,409000438620',2018-09-28,CB826818219659/RMCPL05148/2,500.0,0.0,17727786.62000006,2018,9,28,DEBIT,500.0,C295081230
13340,409000438620',2018-09-28,CB826811091771/RMCPL16275/2,1500.0,0.0,17726286.62000006,2018,9,28,PAYEMENT,1500.0,C1759482496
13341,409000438620',2018-09-28,CB826811091764/RMCPL19639/2,6000.0,0.0,17720286.62000006,2018,9,28,PAYEMENT,6000.0,C1979563377
13342,409000438620',2018-09-28,CB826810077915/RMCPL16221/2,3000.0,0.0,17717286.62000006,2018,9,28,CHECK_WITHDRAWAL,3000.0,C683605346
13343,409000438620',2018-09-28,CB826814147648/RMCPL19146/2,600.0,0.0,17716686.62000006,2018,9,28,PAYEMENT,600.0,C381605910
13344,409000438620',2018-09-28,CB826811084752/RMCPL16755/2,600.0,0.0,17716086.62000006,2018,9,28,CASH_OUT,600.0,C914293025
13345,409000438620',2018-09-28,CB826811088087/RMCPL23562/2,2000.0,0.0,17714086.62000006,2018,9,28,CASH_OUT,2000.0,C1348373832
13346,409000438620',2018-09-28,CB826812101807/RMCPL18083/2,500.0,0.0,17713586.62000006,2018,9,28,CHECK_WITHDRAWAL,500.0,C1674899618
13347,409000438620',2018-09-28,CB826816168621/RMCPL22525/2,4000.0,0.0,17709586.62000006,2018,9,28,CASH_OUT,4000.0,C1161820020
13348,409000438620',2018-09-28,CB826816168644/RMCPL16787/2,1500.0,0.0,17708086.62000006,2018,9,28,CASH_OUT,1500.0,C717951588
13349,409000438620',2018-09-28,CB826809061164/RMCPL14572/2,600.0,0.0,17707486.62000006,2018,9,28,PAYEMENT,600.0,M558046602
13350,409000438620',2018-09-28,MAW/502964XXXXXX2088/NAGA,0.0,200.0,17707686.62000006,2018,9,28,CHECK_CASHING,200.0,M139533828
13351,409000438620',2018-09-28,MAW/502964XXXXXX7046/Karu,0.0,1700.0,17709386.62000006,2018,9,28,TRANSFER,1700.0,M131372697
13352,409000438620',2018-09-28,AEPS INCOME DT 27-09-2018,0.0,18179.24,17727565.86000006,2018,9,28,CHECK_CASHING,18179.24,M1920212100
13353,409000438620',2018-09-28,AEPS GST INC DT 27-09-201,0.0,3635.85,17731201.71000006,2018,9,28,CHECK_CASHING,3635.85,M2093267512
13354,409000438620',2018-09-28,AEPS ACQ CR ADJ FEES 2709,234.82,0.0,17730966.89000006,2018,9,28,DEBIT,234.82,M1885510165
13355,409000438620',2018-09-28,MICRO ATM WDL FEE DT27091,0.0,266300.0,17997266.89000006,2018,9,28,TRANSFER,266300.0,M1253241180
13356,409000438620',2018-09-28,AEPS PAY Indiaforensic 2509,0.0,99.64,17997366.53000006,2018,9,28,CASH_IN,99.64,M233846794
13357,409000438620',2018-09-28,MICRO ATM WDL FEE DT28091,0.0,207300.0,18204666.53000006,2018,9,28,TRANSFER,207300.0,M930022621
13358,409000438620',2018-09-28,TRF TO  Indiaforensic SERVICES I,300000.0,0.0,17904666.53000006,2018,9,28,DEBIT,300000.0,M1736549441
13359,409000438620',2018-09-28,MICRO ATM INC DATED 28091,0.0,545.4,17905211.93000006,2018,9,28,CHECK_CASHING,545.4,M330343151
13360,409000438620',2018-09-28,MICRO ATM GST DATED 28091,0.0,109.08,17905321.010000058,2018,9,28,CHECK_CASHING,109.08,M2110446353
13361,409000438620',2018-09-29,MAW/502964XXXXXX1997/NAGA,0.0,1200.0,17906521.010000058,2018,9,29,CASH_IN,1200.0,M121873207
13362,409000438620',2018-09-29,Indiaforensic AEPS NPCI WDL SET,0.0,6659400.0,24565921.01000005,2018,9,29,CHECK_CASHING,6659400.0,M625010424
13363,409000438620',2018-09-29,TRF TO  Indiaforensic SERVICES I,5000000.0,0.0,19565921.010000054,2018,9,29,PAYEMENT,5000000.0,C1113848808
13364,409000438620',2018-09-29,TRF TO  Indiaforensic SERVICES I,1000000.0,0.0,18565921.010000054,2018,9,29,DEBIT,1000000.0,M2065554383
13365,409000438620',2018-09-29,TRF TO  Indiaforensic SERVICES I,500000.0,0.0,18065921.010000054,2018,9,29,CHECK_WITHDRAWAL,500000.0,M1568045398
13366,409000438620',2018-09-29,MICRO ATM WDL FEE DT28091,0.0,310600.0,18376521.010000054,2018,9,29,TRANSFER,310600.0,M1416491949
13367,409000438620',2018-09-29,MICRO ATM INC DATED 28091,0.0,766.8,18377287.81000006,2018,9,29,CASH_IN,766.8,M666989546
13368,409000438620',2018-09-29,MICRO ATM GST DATED 28091,0.0,153.36,18377441.170000054,2018,9,29,CHECK_CASHING,153.36,M32720062
13369,409000438620',2018-09-29,AEPS INCOME DT 28-09-2018,0.0,17553.54,18394994.710000057,2018,9,29,TRANSFER,17553.54,C1076835071
13370,409000438620',2018-09-29,AEPS GST INC DT 28-09-201,0.0,3510.71,18398505.420000054,2018,9,29,TRANSFER,3510.71,C305646302
13371,409000438620',2018-09-29,TRF TO  Indiaforensic SERVICES I,500000.0,0.0,17898505.420000058,2018,9,29,CHECK_WITHDRAWAL,500000.0,C323302928
13372,409000438620',2018-09-29,MICRO ATM WDL FEE DT29091,0.0,135300.0,18033805.420000054,2018,9,29,CHECK_CASHING,135300.0,C36437323
13373,409000438620',2018-09-29,MICRO ATM INC DATED 29091,0.0,348.48,18034153.90000005,2018,9,29,CHECK_CASHING,348.48,C985537694
13374,409000438620',2018-09-29,MICRO ATM GST DATED 29091,0.0,69.7,18034223.600000054,2018,9,29,CASH_IN,69.7,C98102770
13375,409000438620',2018-09-29,AEPS PAY Indiaforensic 2809,0.0,198.58,18034422.180000056,2018,9,29,CHECK_CASHING,198.58,C382934088
13376,409000438620',2018-10-01,Indiaforensic AEPS NPCI WDL SET,0.0,6021200.0,24055622.180000056,2018,10,1,CHECK_CASHING,6021200.0,C981198566
13377,409000438620',2018-10-01,CR826909336684/RMCPL23368/2,500.0,0.0,24055122.180000056,2018,10,1,DEBIT,500.0,C801412408
13378,409000438620',2018-10-01,CR826914413653/RMCPL28707/2,2000.0,0.0,24053122.180000056,2018,10,1,DEBIT,2000.0,C559483701
13379,409000438620',2018-10-01,CR826910362947/RMCPL23368/2,1500.0,0.0,24051622.180000056,2018,10,1,DEBIT,1500.0,C30013970
13380,409000438620',2018-10-01,CR826914414769/RMCPL16184/2,4000.0,0.0,24047622.180000056,2018,10,1,DEBIT,4000.0,C490150701
13381,409000438620',2018-10-01,CR826918466864/RMCPL27607/2,4000.0,0.0,24043622.180000056,2018,10,1,CASH_OUT,4000.0,C1746150957
13382,409000438620',2018-10-01,CR826916444392/RMCPL14829/2,500.0,0.0,24043122.180000056,2018,10,1,CHECK_WITHDRAWAL,500.0,C1797686173
13383,409000438620',2018-10-01,CR826916444394/RMCPL23228/2,7000.0,0.0,24036122.180000056,2018,10,1,CHECK_WITHDRAWAL,7000.0,C1508518454
13384,409000438620',2018-10-01,CR826917454888/RMCPL22278/2,700.0,0.0,24035422.180000056,2018,10,1,CHECK_WITHDRAWAL,700.0,C267063122
13385,409000438620',2018-10-01,CR826917454894/RMCPL22832/2,2000.0,0.0,24033422.180000056,2018,10,1,DEBIT,2000.0,C1621383518
13386,409000438620',2018-10-01,CR826913399246/RMCPL15079/2,7000.0,0.0,24026422.180000056,2018,10,1,CASH_OUT,7000.0,C549221039
13387,409000438620',2018-10-01,CR826913411386/RMCPL24449/2,8000.0,0.0,24018422.180000056,2018,10,1,DEBIT,8000.0,C2104165942
13388,409000438620',2018-10-01,CR826911370628/RMCPL14558/2,2000.0,0.0,24016422.180000056,2018,10,1,PAYEMENT,2000.0,C1121453612
13389,409000438620',2018-10-01,CR826911372910/RMCPL22489/2,1800.0,0.0,24014622.180000056,2018,10,1,PAYEMENT,1800.0,C762570948
13390,409000438620',2018-10-01,CR826911372906/RMCPL28497/2,10000.0,0.0,24004622.180000056,2018,10,1,CHECK_WITHDRAWAL,10000.0,C1608433267
13391,409000438620',2018-10-01,CR826911372916/RMCPL09617/2,10000.0,0.0,23994622.180000056,2018,10,1,PAYEMENT,10000.0,M512341974
13392,409000438620',2018-10-01,CR826913408278/RMCPL12772/2,500.0,0.0,23994122.180000056,2018,10,1,DEBIT,500.0,M1492573721
13393,409000438620',2018-10-01,CR826919485843/RMCPL22472/2,1000.0,0.0,23993122.180000056,2018,10,1,DEBIT,1000.0,M461592476
13394,409000438620',2018-10-01,CR826919485869/RMCPL11330/2,500.0,0.0,23992622.180000056,2018,10,1,PAYEMENT,500.0,C1343642221
13395,409000438620',2018-10-01,CR826918466870/RMCPL16187/2,1000.0,0.0,23991622.180000056,2018,10,1,PAYEMENT,1000.0,C1842297286
13396,409000438620',2018-10-01,CR826908319737/RMCPL05110/2,500.0,0.0,23991122.180000056,2018,10,1,CASH_OUT,500.0,C1549086472
13397,409000438620',2018-10-01,CR826908319730/RMCPL17970/2,4000.0,0.0,23987122.180000056,2018,10,1,DEBIT,4000.0,C1103621993
13398,409000438620',2018-10-01,CR826912392486/RMCPL11996/2,1500.0,0.0,23985622.180000056,2018,10,1,PAYEMENT,1500.0,C1174600239
13399,409000438620',2018-10-01,CR826913406059/RMCPL15935/2,1500.0,0.0,23984122.180000056,2018,10,1,CASH_OUT,1500.0,C976133979
13400,409000438620',2018-10-01,CR827012637608/RMCPL21824/2,600.0,0.0,23983522.180000056,2018,10,1,DEBIT,600.0,C1467301185
13401,409000438620',2018-10-01,CR827012633238/RMCPL24284/2,2000.0,0.0,23981522.180000056,2018,10,1,DEBIT,2000.0,C998255530
13402,409000438620',2018-10-01,CR827010587603/RMCPL10073/2,600.0,0.0,23980922.180000056,2018,10,1,CASH_OUT,600.0,C1862972704
13403,409000438620',2018-10-01,CR827009577725/RMCPL18376/2,2500.0,0.0,23978422.180000056,2018,10,1,CHECK_WITHDRAWAL,2500.0,C1336996537
13404,409000438620',2018-10-01,CR827013659591/RMCPL28890/2,700.0,0.0,23977722.180000056,2018,10,1,DEBIT,700.0,C1894575391
13405,409000438620',2018-10-01,CR827009568914/RMCPL11607/2,3000.0,0.0,23974722.180000056,2018,10,1,PAYEMENT,3000.0,C1343134043
13406,409000438620',2018-10-01,CR827011608939/RMCPL15690/2,5000.0,0.0,23969722.180000056,2018,10,1,CHECK_WITHDRAWAL,5000.0,C1034382650
13407,409000438620',2018-10-01,CR827011613264/RMCPL28997/2,500.0,0.0,23969222.180000056,2018,10,1,PAYEMENT,500.0,C1240730624
13408,409000438620',2018-10-01,CR827011617493/RMCPL18940/2,500.0,0.0,23968722.180000056,2018,10,1,DEBIT,500.0,C1541743053
13409,409000438620',2018-10-01,CR827015681662/RMCPL22581/2,500.0,0.0,23968222.180000056,2018,10,1,PAYEMENT,500.0,C1487669283
13410,409000438620',2018-10-01,CR827009582430/RMCPL27211/2,2000.0,0.0,23966222.180000056,2018,10,1,DEBIT,2000.0,C861720625
13411,409000438620',2018-10-01,CR827017708843/RMCPL14572/2,1800.0,0.0,23964422.180000056,2018,10,1,DEBIT,1800.0,C1130075212
13412,409000438620',2018-10-01,CR827013659612/RMCPL20758/2,3500.0,0.0,23960922.180000056,2018,10,1,PAYEMENT,3500.0,C141458554
13413,409000438620',2018-10-01,CR827011613242/RMCPL21526/2,4000.0,0.0,23956922.180000056,2018,10,1,PAYEMENT,4000.0,C1257704323
13414,409000438620',2018-10-01,CR827017716673/RMCPL16447/2,9500.0,0.0,23947422.180000056,2018,10,1,PAYEMENT,9500.0,C36856762
13415,409000438620',2018-10-01,CR827013646271/RMCPL22628/2,800.0,0.0,23946622.180000056,2018,10,1,DEBIT,800.0,C1554565380
13416,409000438620',2018-10-01,CR827014664235/RMCPL24759/2,1000.0,0.0,23945622.180000056,2018,10,1,CASH_OUT,1000.0,C410033330
13417,409000438620',2018-10-01,CR827013654962/RMCPL14558/2,9000.0,0.0,23936622.180000056,2018,10,1,PAYEMENT,9000.0,C1339678445
13418,409000438620',2018-10-01,CR827017712386/RMCPL22523/2,1000.0,0.0,23935622.180000056,2018,10,1,DEBIT,1000.0,C1298242208
13419,409000438620',2018-10-01,CR827012641904/RMCPL21208/2,1000.0,0.0,23934622.180000056,2018,10,1,CASH_OUT,1000.0,C653593128
13420,409000438620',2018-10-01,CR827013646275/RMCPL18486/2,500.0,0.0,23934122.180000056,2018,10,1,CHECK_WITHDRAWAL,500.0,C1085479446
13421,409000438620',2018-10-01,CR827012637611/RMCPL23228/2,2000.0,0.0,23932122.180000056,2018,10,1,CHECK_WITHDRAWAL,2000.0,C39713115
13422,409000438620',2018-10-01,MAW/502964XXXXXX4993/Karu,0.0,1700.0,23933822.180000056,2018,10,1,TRANSFER,1700.0,C1636786811
13423,409000438620',2018-10-01,Indiaforensic AEPS NPCI WDL SET,0.0,3550700.0,27484522.180000056,2018,10,1,CASH_IN,3550700.0,C2086207545
13424,409000438620',2018-10-01,TRF TO  Indiaforensic SERVICES I,4000000.0,0.0,23484522.180000056,2018,10,1,CASH_OUT,4000000.0,C723551604
13425,409000438620',2018-10-01,TRF TO  Indiaforensic SERVICES I,5000000.0,0.0,18484522.180000056,2018,10,1,CHECK_WITHDRAWAL,5000000.0,C1538961175
13426,409000438620',2018-10-01,NPCI SETELEMENT DIFF_3009,0.0,1600.0,18486122.180000056,2018,10,1,TRANSFER,1600.0,C1297804967
13427,409000438620',2018-10-01,MICRO ATM WDL FEE DT29091,0.0,248100.0,18734222.180000056,2018,10,1,CASH_IN,248100.0,C2110623348
13428,409000438620',2018-10-01,MICRO ATM INC DATED 29091,0.0,614.16,18734836.340000056,2018,10,1,TRANSFER,614.16,C1315234892
13429,409000438620',2018-10-01,MICRO ATM GST DATED 29091,0.0,122.83,18734959.170000054,2018,10,1,TRANSFER,122.83,C1080993648
13430,409000438620',2018-10-01,MAW/502964XXXXXX1997/NAGA,0.0,1200.0,18736159.170000054,2018,10,1,CHECK_CASHING,1200.0,C603904068
13431,409000438620',2018-10-01,AEPS PAY Indiaforensic 2909,0.0,389.46,18736548.63000005,2018,10,1,CASH_IN,389.46,C1354725727
13432,409000438620',2018-10-01,AEPS PAY Indiaforensic 3009,0.0,499.4,18737048.030000053,2018,10,1,CASH_IN,499.4,C1520941958
13433,409000438620',2018-10-01,TRF TO  Indiaforensic SERVICES I,800000.0,0.0,17937048.030000053,2018,10,1,CHECK_WITHDRAWAL,800000.0,C1502287290
13434,409000438620',2018-10-01,AEPS ACQUIRING ADJ FEES 2,26.55,0.0,17937021.480000053,2018,10,1,CHECK_WITHDRAWAL,26.55,C1842297286
13435,409000438620',2018-10-01,AEPS ACQ CR ADJ FEES 2909,457.25,0.0,17936564.230000053,2018,10,1,CASH_OUT,457.25,C1976089236
13436,409000438620',2018-10-01,AEPS INCOME DT 29-09-2018,0.0,16404.69,17952968.920000054,2018,10,1,CASH_IN,16404.69,C1185567380
13437,409000438620',2018-10-01,AEPS GST INC DT 29-09-201,0.0,3280.94,17956249.860000055,2018,10,1,CHECK_CASHING,3280.94,C101571284
13438,409000438620',2018-10-01,AEPS INCOME DT 30-09-2018,0.0,9503.69,17965753.550000057,2018,10,1,TRANSFER,9503.69,C2122200303
13439,409000438620',2018-10-01,AEPS GST INC DT 30-09-201,0.0,1900.74,17967654.290000055,2018,10,1,TRANSFER,1900.74,C1326243087
13440,409000438620',2018-10-01,MICRO ATM WDL FEE DT30091,0.0,501700.0,18469354.29000005,2018,10,1,CASH_IN,501700.0,C505973878
13441,409000438620',2018-10-01,MICRO ATM INC DATED 30091,0.0,1193.04,18470547.330000054,2018,10,1,TRANSFER,1193.04,C311662903
13442,409000438620',2018-10-01,MICRO ATM GST DATED 30091,0.0,238.61,18470785.940000053,2018,10,1,CASH_IN,238.61,C557030255
13443,409000438620',2018-10-01,MICRO ATM WDL FEE DT01101,0.0,157400.0,18628185.940000053,2018,10,1,TRANSFER,157400.0,C1917105166
13444,409000438620',2018-10-01,MICRO ATM INC DATED 01101,0.0,345.24,18628531.18000005,2018,10,1,CASH_IN,345.24,M1320442877
13445,409000438620',2018-10-01,MICRO ATM GST DATED 01101,0.0,69.05,18628600.230000053,2018,10,1,CHECK_CASHING,69.05,M172326956
13446,409000438620',2018-10-02,MAW/502964XXXXXX9255/NAGA,0.0,500.0,18629100.230000053,2018,10,2,TRANSFER,500.0,M1747913106
13447,409000438620',2018-10-02,MAW/502964XXXXXX9466/NAGA,0.0,2800.0,18631900.230000053,2018,10,2,TRANSFER,2800.0,M1684069726
13448,409000438620',2018-10-03,MAW/502964XXXXXX1100/NAGA,0.0,800.0,18632700.230000053,2018,10,3,TRANSFER,800.0,M921933001
13449,409000438620',2018-10-03,MAW/502964XXXXXX8617/Karu,0.0,1700.0,18634400.230000053,2018,10,3,CASH_IN,1700.0,M88528034
13450,409000438620',2018-10-03,Indiaforensic AEPS NPCI WDL SET,0.0,5587100.0,24221500.23000005,2018,10,3,CHECK_CASHING,5587100.0,M181203825
13451,409000438620',2018-10-03,Indiaforensic AEPS NPCI WDL SET,0.0,5676100.0,29897600.23000005,2018,10,3,CHECK_CASHING,5676100.0,M769613428
13452,409000438620',2018-10-03,MAW/502964XXXXXX9004/Karu,0.0,1700.0,29899300.23000005,2018,10,3,CASH_IN,1700.0,M2073971469
13453,409000438620',2018-10-03,MAW/502964XXXXXX6635/Karu,0.0,1700.0,29901000.23000005,2018,10,3,CHECK_CASHING,1700.0,M1230581265
13454,409000438620',2018-10-03,MAW/502964XXXXXX8781/Karu,0.0,1700.0,29902700.23000005,2018,10,3,TRANSFER,1700.0,M1965636278
13455,409000438620',2018-10-03,MAW/502964XXXXXX2144/Karu,0.0,1700.0,29904400.23000005,2018,10,3,TRANSFER,1700.0,M2085710691
13456,409000438620',2018-10-03,MAW/502964XXXXXX1146/Karu,0.0,1700.0,29906100.23000005,2018,10,3,CASH_IN,1700.0,M171770622
13457,409000438620',2018-10-03,MAW/502964XXXXXX2251/Karu,0.0,1700.0,29907800.23000005,2018,10,3,TRANSFER,1700.0,M1188691301
13458,409000438620',2018-10-03,MAW/502964XXXXXX4430/Karu,0.0,1700.0,29909500.23000005,2018,10,3,CASH_IN,1700.0,M2032224712
13459,409000438620',2018-10-03,MAW/502964XXXXXX3044/Karu,0.0,1700.0,29911200.23000005,2018,10,3,TRANSFER,1700.0,M1698271367
13460,409000438620',2018-10-03,MICRO ATM WDL FEE DT01101,0.0,527100.0,30438300.23000005,2018,10,3,CASH_IN,527100.0,M1091459664
13461,409000438620',2018-10-03,MICRO ATM INC DATED 01101,0.0,1257.84,30439558.07000005,2018,10,3,CASH_IN,1257.84,M397563391
13462,409000438620',2018-10-03,MICRO ATM GST DATED 01101,0.0,251.57,30439809.64000005,2018,10,3,CASH_IN,251.57,M129671544
13463,409000438620',2018-10-03,MICRO ATM WDL FEE DT02101,0.0,892900.0,31332709.64000005,2018,10,3,CASH_IN,892900.0,C991363637
13464,409000438620',2018-10-03,MICRO ATM INC DATED 02101,0.0,2048.04,31334757.68000005,2018,10,3,CHECK_CASHING,2048.04,M402081684
13465,409000438620',2018-10-03,MICRO ATM GST DATED 02101,0.0,409.61,31335167.29000005,2018,10,3,CHECK_CASHING,409.61,M146164245
13466,409000438620',2018-10-03,TRF TO  Indiaforensic SERVICES I,12200000.0,0.0,19135167.29000005,2018,10,3,DEBIT,12200000.0,M673425442
13467,409000438620',2018-10-03,MICRO ATM WDL FEE DT03101,0.0,324600.0,19459767.29000005,2018,10,3,CHECK_CASHING,324600.0,M1931543168
13468,409000438620',2018-10-03,MICRO ATM INC DATED 03101,0.0,698.04,19460465.33000005,2018,10,3,CHECK_CASHING,698.04,M1874719622
13469,409000438620',2018-10-03,MICRO ATM GST DATED 03101,0.0,139.61,19460604.94000005,2018,10,3,CHECK_CASHING,139.61,C1369695156
13470,409000438620',2018-10-03,AEPS INCOME DT 01-10-2018,0.0,14586.57,19475191.51000005,2018,10,3,TRANSFER,14586.57,M1051090166
13471,409000438620',2018-10-03,AEPS GST INC DT 01-10-201,0.0,2917.31,19478108.82000005,2018,10,3,TRANSFER,2917.31,C1321139761
13472,409000438620',2018-10-03,AEPS INCOME DT 02-10-2018,0.0,15018.5,19493127.32000005,2018,10,3,TRANSFER,15018.5,M875639287
13473,409000438620',2018-10-03,AEPS GST INC DT 02-10-201,0.0,3003.7,19496131.020000048,2018,10,3,CASH_IN,3003.7,M1001607298
13474,409000438620',2018-10-03,AEPS ACQ REP ADJ FEES 011,0.0,17.7,19496148.720000047,2018,10,3,TRANSFER,17.7,M1332206765
13475,409000438620',2018-10-03,TRF TO  Indiaforensic SERVICES I,1800000.0,0.0,17696148.720000047,2018,10,3,DEBIT,1800000.0,M847433048
13476,409000438620',2018-10-03,AEPS PAY Indiaforensic 0110,0.0,1218.69,17697367.41000005,2018,10,3,TRANSFER,1218.69,M376186096
13477,409000438620',2018-10-04,Indiaforensic AEPS NPCI WDL SET,0.0,3783600.0,21480967.41000005,2018,10,4,TRANSFER,3783600.0,M71662825
13478,409000438620',2018-10-04,MICRO ATM WDL FEE DT03101,0.0,577800.0,22058767.41000005,2018,10,4,TRANSFER,577800.0,M1820926231
13479,409000438620',2018-10-04,MICRO ATM INC DATED 03101,0.0,1321.56,22060088.970000047,2018,10,4,TRANSFER,1321.56,M789326739
13480,409000438620',2018-10-04,MICRO ATM GST DATED 03101,0.0,264.31,22060353.280000046,2018,10,4,TRANSFER,264.31,M1069653088
13481,409000438620',2018-10-04,TRF TO  Indiaforensic SERVICES I,3800000.0,0.0,18260353.280000046,2018,10,4,CASH_OUT,3800000.0,M2084165743
13482,409000438620',2018-10-04,AEPS INCOME DT 03-10-2018,0.0,9960.14,18270313.420000046,2018,10,4,CASH_IN,9960.14,M2043031547
13483,409000438620',2018-10-04,AEPS GST INC DT 03-10-201,0.0,1992.03,18272305.450000048,2018,10,4,CHECK_CASHING,1992.03,M1087004210
13484,409000438620',2018-10-04,AEPS ACQUIRING ADJ FEES 0,35.4,0.0,18272270.05000005,2018,10,4,CASH_OUT,35.4,C1315729466
13485,409000438620',2018-10-04,MICRO ATM WDL FEE DT04101,0.0,307700.0,18579970.05000005,2018,10,4,CHECK_CASHING,307700.0,M485310811
13486,409000438620',2018-10-04,MICRO ATM INC DATED 04101,0.0,653.76,18580623.81000005,2018,10,4,CHECK_CASHING,653.76,C1978557426
13487,409000438620',2018-10-04,MICRO ATM GST DATED 04101,0.0,130.75,18580754.56000005,2018,10,4,CASH_IN,130.75,C2014517831
13488,409000438620',2018-10-04,TRF TO  Indiaforensic SERVICES I,900000.0,0.0,17680754.56000005,2018,10,4,CHECK_WITHDRAWAL,900000.0,M975206494
13489,409000438620',2018-10-05,Indiaforensic AEPS NPCI WDL SET,0.0,4719800.0,22400554.56000005,2018,10,5,TRANSFER,4719800.0,M880731682
13490,409000438620',2018-10-05,TRF TO  Indiaforensic SERVICES I,2500000.0,0.0,19900554.56000005,2018,10,5,CASH_OUT,2500000.0,C1174600239
13491,409000438620',2018-10-05,TRF TO  Indiaforensic SERVICES I,2200000.0,0.0,17700554.56000005,2018,10,5,PAYEMENT,2200000.0,M1800837647
13492,409000438620',2018-10-05,MICRO ATM WDL FEE DT04101,0.0,548900.0,18249454.56000005,2018,10,5,CASH_IN,548900.0,M1207295476
13493,409000438620',2018-10-05,MICRO ATM INC DATED 04101,0.0,1284.84,18250739.40000005,2018,10,5,TRANSFER,1284.84,C42165108
13494,409000438620',2018-10-05,MICRO ATM GST DATED 04101,0.0,256.97,18250996.37000005,2018,10,5,CHECK_CASHING,256.97,M1825180841
13495,409000438620',2018-10-05,AEPS INCOME DT 04-10-2018,0.0,12165.97,18263162.34000005,2018,10,5,CHECK_CASHING,12165.97,M1615613068
13496,409000438620',2018-10-05,AEPS GST INC DT 04-10-201,0.0,2433.19,18265595.53000005,2018,10,5,CASH_IN,2433.19,M764043945
13497,409000438620',2018-10-05,AEPS ACQUIRING ADJ FEES 0,8.85,0.0,18265586.680000048,2018,10,5,CHECK_WITHDRAWAL,8.85,M1633836502
13498,409000438620',2018-10-05,AEPS ACQ REP ADJ FEES 041,0.0,26.55,18265613.23000005,2018,10,5,CHECK_CASHING,26.55,M1117553186
13499,409000438620',2018-10-05,MICRO ATM WDL FEE DT05101,0.0,332800.0,18598413.23000005,2018,10,5,CHECK_CASHING,332800.0,M279095827
13500,409000438620',2018-10-05,MICRO ATM INC DATED 05101,0.0,780.48,18599193.71000005,2018,10,5,TRANSFER,780.48,M1663079416
13501,409000438620',2018-10-05,MICRO ATM GST DATED 05101,0.0,156.1,18599349.81000005,2018,10,5,TRANSFER,156.1,M1799223928
13502,409000438620',2018-10-05,TRF TO  Indiaforensic SERVICES I,500000.0,0.0,18099349.81000005,2018,10,5,DEBIT,500000.0,C483370168
13503,409000438620',2018-10-06,CR827112904021/RMCPL21208/2,1000.0,0.0,18098349.81000005,2018,10,6,PAYEMENT,1000.0,C1825389809
13504,409000438620',2018-10-06,CR827108835586/RMCPL24703/2,3000.0,0.0,18095349.81000005,2018,10,6,PAYEMENT,3000.0,C423580937
13505,409000438620',2018-10-06,CR827117972923/RMCPL22655/2,2000.0,0.0,18093349.81000005,2018,10,6,CASH_OUT,2000.0,C8733802
13506,409000438620',2018-10-06,CR827117972945/RMCPL23207/2,1500.0,0.0,18091849.81000005,2018,10,6,PAYEMENT,1500.0,C505973878
13507,409000438620',2018-10-06,CR827112908061/RMCPL17957/2,500.0,0.0,18091349.81000005,2018,10,6,CASH_OUT,500.0,C641009714
13508,409000438620',2018-10-06,CR827114925332/RMCPL27276/2,500.0,0.0,18090849.81000005,2018,10,6,CASH_OUT,500.0,C392292416
13509,409000438620',2018-10-06,CR827116952157/RMCPL14573/2,900.0,0.0,18089949.81000005,2018,10,6,CHECK_WITHDRAWAL,900.0,C968448640
13510,409000438620',2018-10-06,CR827113917059/RMCPL25318/2,1000.0,0.0,18088949.81000005,2018,10,6,CASH_OUT,1000.0,C35263828
13511,409000438620',2018-10-06,CR827111893853/RMCPL22022/2,700.0,0.0,18088249.81000005,2018,10,6,DEBIT,700.0,C776404949
13512,409000438620',2018-10-06,CR827116955605/RMCPL22499/2,2000.0,0.0,18086249.81000005,2018,10,6,CASH_OUT,2000.0,C1982828534
13513,409000438620',2018-10-06,CR827110871201/RMCPL12604/2,2400.0,0.0,18083849.81000005,2018,10,6,CHECK_WITHDRAWAL,2400.0,C158876320
13514,409000438620',2018-10-06,CR827111890219/RMCPL19247/2,3000.0,0.0,18080849.81000005,2018,10,6,PAYEMENT,3000.0,C23678140
13515,409000438620',2018-10-06,CR827115948261/RMCPL20998/2,600.0,0.0,18080249.81000005,2018,10,6,CASH_OUT,600.0,C1887692104
13516,409000438620',2018-10-06,CR827317422723/RMCPL22967/3,2400.0,0.0,18077849.81000005,2018,10,6,CHECK_WITHDRAWAL,2400.0,C183354406
13517,409000438620',2018-10-06,CR827210104010/RMCPL28636/2,6000.0,0.0,18071849.81000005,2018,10,6,CHECK_WITHDRAWAL,6000.0,C1628737580
13518,409000438620',2018-10-06,CR827211111469/RMCPL09035/2,1200.0,0.0,18070649.81000005,2018,10,6,DEBIT,1200.0,C122086708
13519,409000438620',2018-10-06,CR827213149349/RMCPL10110/2,1000.0,0.0,18069649.81000005,2018,10,6,CHECK_WITHDRAWAL,1000.0,C998255530
13520,409000438620',2018-10-06,CR827214154109/RMCPL15112/2,10000.0,0.0,18059649.81000005,2018,10,6,PAYEMENT,10000.0,C533866202
13521,409000438620',2018-10-06,CR827214154119/RMCPL15296/2,3000.0,0.0,18056649.81000005,2018,10,6,PAYEMENT,3000.0,C571514738
13522,409000438620',2018-10-06,CR827511799411/RMCPL26120/0,6100.0,0.0,18050549.81000005,2018,10,6,CHECK_WITHDRAWAL,6100.0,C1898859288
13523,409000438620',2018-10-06,CR827512807484/RMCPL23812/0,10000.0,0.0,18040549.81000005,2018,10,6,CASH_OUT,10000.0,M2041957520
13524,409000438620',2018-10-06,CR827508750858/RMCPL16659/0,1000.0,0.0,18039549.81000005,2018,10,6,PAYEMENT,1000.0,M479184088
13525,409000438620',2018-10-06,CR827411560119/RMCPL19909/0,500.0,0.0,18039049.81000005,2018,10,6,CASH_OUT,500.0,M1502013531
13526,409000438620',2018-10-06,CR827410552579/RMCPL27206/0,8000.0,0.0,18031049.81000005,2018,10,6,CASH_OUT,8000.0,M652574670
13527,409000438620',2018-10-06,CR827416628290/RMCPL19909/0,500.0,0.0,18030549.81000005,2018,10,6,CHECK_WITHDRAWAL,500.0,M1163977739
13528,409000438620',2018-10-06,CR827416621722/RMCPL24103/0,5000.0,0.0,18025549.81000005,2018,10,6,CHECK_WITHDRAWAL,5000.0,C1207946845
13529,409000438620',2018-10-06,CR827417633983/RMCPL19963/0,1100.0,0.0,18024449.81000005,2018,10,6,DEBIT,1100.0,C596299019
13530,409000438620',2018-10-06,CR827417633996/RMCPL09612/0,2000.0,0.0,18022449.81000005,2018,10,6,CASH_OUT,2000.0,C657255537
13531,409000438620',2018-10-06,CR827417633985/RMCPL21549/0,700.0,0.0,18021749.81000005,2018,10,6,CASH_OUT,700.0,C668345982
13532,409000438620',2018-10-06,CR827411562326/RMCPL23895/0,500.0,0.0,18021249.81000005,2018,10,6,CHECK_WITHDRAWAL,500.0,M2120178031
13533,409000438620',2018-10-06,CR827410542617/RMCPL20680/0,900.0,0.0,18020349.81000005,2018,10,6,CHECK_WITHDRAWAL,900.0,C411880300
13534,409000438620',2018-10-06,CR827413591224/RMCPL19888/0,600.0,0.0,18019749.81000005,2018,10,6,CASH_OUT,600.0,C665576141
13535,409000438620',2018-10-06,CR827613019341/RMCPL20587/0,2000.0,0.0,18017749.81000005,2018,10,6,CHECK_WITHDRAWAL,2000.0,C1634190383
13536,409000438620',2018-10-06,CR827610984312/RMCPL17948/0,2700.0,0.0,18015049.81000005,2018,10,6,CASH_OUT,2700.0,C1327907419
13537,409000438620',2018-10-06,CR827610984845/RMCPL22640/0,1000.0,0.0,18014049.81000005,2018,10,6,DEBIT,1000.0,C1369695156
13538,409000438620',2018-10-06,CR827611001739/RMCPL23228/0,1000.0,0.0,18013049.81000005,2018,10,6,PAYEMENT,1000.0,M1466011597
13539,409000438620',2018-10-06,CR827611001887/RMCPL19060/0,2000.0,0.0,18011049.81000005,2018,10,6,CASH_OUT,2000.0,M724035526
13540,409000438620',2018-10-06,CR827611998907/RMCPL17234/0,1000.0,0.0,18010049.81000005,2018,10,6,DEBIT,1000.0,C1888439681
13541,409000438620',2018-10-06,CR827611999286/RMCPL00216/0,4000.0,0.0,18006049.81000005,2018,10,6,DEBIT,4000.0,M1027943661
13542,409000438620',2018-10-06,CR827616057766/RMCPL16272/0,500.0,0.0,18005549.81000005,2018,10,6,CHECK_WITHDRAWAL,500.0,C2057394816
13543,409000438620',2018-10-06,CR827616057743/RMCPL20978/0,500.0,0.0,18005049.81000005,2018,10,6,CASH_OUT,500.0,C405881980
13544,409000438620',2018-10-06,CR827611999705/RMCPL24449/0,3000.0,0.0,18002049.81000005,2018,10,6,CHECK_WITHDRAWAL,3000.0,M1095836955
13545,409000438620',2018-10-06,CR827616057760/RMCPL18729/0,600.0,0.0,18001449.81000005,2018,10,6,CASH_OUT,600.0,M151681899
13546,409000438620',2018-10-06,CR827610986907/RMCPL18157/0,500.0,0.0,18000949.81000005,2018,10,6,CHECK_WITHDRAWAL,500.0,M779871442
13547,409000438620',2018-10-06,CR827610986927/RMCPL27694/0,5500.0,0.0,17995449.81000005,2018,10,6,PAYEMENT,5500.0,C1934634055
13548,409000438620',2018-10-06,CR827611996499/RMCPL27696/0,10000.0,0.0,17985449.81000005,2018,10,6,CASH_OUT,10000.0,M111359831
13549,409000438620',2018-10-06,CR827611998719/RMCPL19469/0,3000.0,0.0,17982449.81000005,2018,10,6,DEBIT,3000.0,M502023852
13550,409000438620',2018-10-06,CR827612005997/RMCPL23710/0,1800.0,0.0,17980649.81000005,2018,10,6,CASH_OUT,1800.0,M1845257375
13551,409000438620',2018-10-06,CR827613020659/RMCPL23228/0,500.0,0.0,17980149.81000005,2018,10,6,CASH_OUT,500.0,C2128665553
13552,409000438620',2018-10-06,CR827615042999/RMCPL19899/0,2000.0,0.0,17978149.81000005,2018,10,6,DEBIT,2000.0,M949250025
13553,409000438620',2018-10-06,CR827612014014/RMCPL09550/0,9000.0,0.0,17969149.81000005,2018,10,6,CHECK_WITHDRAWAL,9000.0,M1036853034
13554,409000438620',2018-10-06,CR827612014632/RMCPL21642/0,1000.0,0.0,17968149.81000005,2018,10,6,DEBIT,1000.0,C1373172466
13555,409000438620',2018-10-06,CR827612014941/RMCPL15326/0,2000.0,0.0,17966149.81000005,2018,10,6,DEBIT,2000.0,C1619402333
13556,409000438620',2018-10-06,CR827611001077/RMCPL15535/0,500.0,0.0,17965649.81000005,2018,10,6,DEBIT,500.0,M388092920
13557,409000438620',2018-10-06,CR827612008398/RMCPL16262/0,500.0,0.0,17965149.81000005,2018,10,6,CHECK_WITHDRAWAL,500.0,M148286862
13558,409000438620',2018-10-06,CR827611001378/RMCPL11352/0,800.0,0.0,17964349.81000005,2018,10,6,CHECK_WITHDRAWAL,800.0,C288106800
13559,409000438620',2018-10-06,CR827611001385/RMCPL17789/0,1000.0,0.0,17963349.81000005,2018,10,6,CHECK_WITHDRAWAL,1000.0,C1973191571
13560,409000438620',2018-10-06,CR827615052295/RMCPL14840/0,1000.0,0.0,17962349.81000005,2018,10,6,PAYEMENT,1000.0,M1256815829
13561,409000438620',2018-10-06,CR827611003570/RMCPL26216/0,2000.0,0.0,17960349.81000005,2018,10,6,CHECK_WITHDRAWAL,2000.0,M1858783614
13562,409000438620',2018-10-06,CR827611003461/RMCPL14096/0,500.0,0.0,17959849.81000005,2018,10,6,CHECK_WITHDRAWAL,500.0,M1753618993
13563,409000438620',2018-10-06,CR827610988291/RMCPL22963/0,1000.0,0.0,17958849.81000005,2018,10,6,PAYEMENT,1000.0,C1414529337
13564,409000438620',2018-10-06,CR827610988638/RMCPL25592/0,1000.0,0.0,17957849.81000005,2018,10,6,CHECK_WITHDRAWAL,1000.0,M84528413
13565,409000438620',2018-10-06,CR827610989034/RMCPL22042/0,10000.0,0.0,17947849.81000005,2018,10,6,CASH_OUT,10000.0,M1974275753
13566,409000438620',2018-10-06,CR827610987129/RMCPL23065/0,1000.0,0.0,17946849.81000005,2018,10,6,CASH_OUT,1000.0,M1664108362
13567,409000438620',2018-10-06,CR827610987141/RMCPL26156/0,500.0,0.0,17946349.81000005,2018,10,6,PAYEMENT,500.0,M333341423
13568,409000438620',2018-10-06,CR827610987054/RMCPL24482/0,600.0,0.0,17945749.81000005,2018,10,6,CHECK_WITHDRAWAL,600.0,M182765399
13569,409000438620',2018-10-06,CR827610987417/RMCPL16282/0,500.0,0.0,17945249.81000005,2018,10,6,PAYEMENT,500.0,C806667375
13570,409000438620',2018-10-06,CR827610987812/RMCPL27487/0,2000.0,0.0,17943249.81000005,2018,10,6,PAYEMENT,2000.0,M776516137
13571,409000438620',2018-10-06,CR827610987587/RMCPL22250/0,1000.0,0.0,17942249.81000005,2018,10,6,CASH_OUT,1000.0,C1337741679
13572,409000438620',2018-10-06,CR827615050474/RMCPL22832/0,1500.0,0.0,17940749.81000005,2018,10,6,PAYEMENT,1500.0,C577628476
13573,409000438620',2018-10-06,CR827616056272/RMCPL23534/0,1000.0,0.0,17939749.81000005,2018,10,6,CASH_OUT,1000.0,M1196160524
13574,409000438620',2018-10-06,CR827616056659/RMCPL21824/0,1500.0,0.0,17938249.81000005,2018,10,6,CHECK_WITHDRAWAL,1500.0,M2091012460
13575,409000438620',2018-10-06,CR827612016763/RMCPL21743/0,4000.0,0.0,17934249.81000005,2018,10,6,CHECK_WITHDRAWAL,4000.0,M114854837
13576,409000438620',2018-10-06,CR827613020101/RMCPL23065/0,1500.0,0.0,17932749.81000005,2018,10,6,CASH_OUT,1500.0,C1436838899
13577,409000438620',2018-10-06,CR827613020536/RMCPL21646/0,500.0,0.0,17932249.81000005,2018,10,6,PAYEMENT,500.0,C492997256
13578,409000438620',2018-10-06,CR827613020691/RMCPL28457/0,1000.0,0.0,17931249.81000005,2018,10,6,CASH_OUT,1000.0,M1460130079
13579,409000438620',2018-10-06,CR827614035234/RMCPL25806/0,5500.0,0.0,17925749.81000005,2018,10,6,CASH_OUT,5500.0,M32431281
13580,409000438620',2018-10-06,CR827612010073/RMCPL21807/0,500.0,0.0,17925249.81000005,2018,10,6,PAYEMENT,500.0,M2121788420
13581,409000438620',2018-10-06,CR827611992408/RMCPL24148/0,500.0,0.0,17924749.81000005,2018,10,6,DEBIT,500.0,M1181411185
13582,409000438620',2018-10-06,CR827612010056/RMCPL18157/0,2000.0,0.0,17922749.81000005,2018,10,6,DEBIT,2000.0,M443953160
13583,409000438620',2018-10-06,CR827612010079/RMCPL23887/0,1700.0,0.0,17921049.81000005,2018,10,6,CASH_OUT,1700.0,M265384882
13584,409000438620',2018-10-06,CR827611992848/RMCPL16457/0,1500.0,0.0,17919549.81000005,2018,10,6,PAYEMENT,1500.0,C1825634724
13585,409000438620',2018-10-06,CR827611992708/RMCPL16247/0,10000.0,0.0,17909549.81000005,2018,10,6,DEBIT,10000.0,C1251686742
13586,409000438620',2018-10-06,CR827611992690/RMCPL15375/0,500.0,0.0,17909049.81000005,2018,10,6,CASH_OUT,500.0,C2117043942
13587,409000438620',2018-10-06,CR827609973109/RMCPL19028/0,1000.0,0.0,17908049.81000005,2018,10,6,CASH_OUT,1000.0,C439917369
13588,409000438620',2018-10-06,CR827611991426/RMCPL11793/0,1000.0,0.0,17907049.81000005,2018,10,6,PAYEMENT,1000.0,C216890954
13589,409000438620',2018-10-06,CR827611991851/RMCPL00111/0,2000.0,0.0,17905049.81000005,2018,10,6,CHECK_WITHDRAWAL,2000.0,C219543946
13590,409000438620',2018-10-06,CR827611991931/RMCPL20871/0,1000.0,0.0,17904049.81000005,2018,10,6,CASH_OUT,1000.0,C2100990049
13591,409000438620',2018-10-06,CR827612016815/RMCPL22481/0,2000.0,0.0,17902049.81000005,2018,10,6,PAYEMENT,2000.0,C1938348365
13592,409000438620',2018-10-06,CR827611001667/RMCPL14431/0,1000.0,0.0,17901049.81000005,2018,10,6,DEBIT,1000.0,C1674899618
13593,409000438620',2018-10-06,CR827612006381/RMCPL22042/0,3000.0,0.0,17898049.81000005,2018,10,6,CASH_OUT,3000.0,C863811613
13594,409000438620',2018-10-06,CR827615046964/RMCPL09827/0,600.0,0.0,17897449.81000005,2018,10,6,PAYEMENT,600.0,M619415936
13595,409000438620',2018-10-06,CR827615053248/RMCPL13161/0,1200.0,0.0,17896249.81000005,2018,10,6,DEBIT,1200.0,M2004021597
13596,409000438620',2018-10-06,CR827615054005/RMCPL09612/0,10000.0,0.0,17886249.81000005,2018,10,6,PAYEMENT,10000.0,C455218098
13597,409000438620',2018-10-06,CR827615053863/RMCPL15326/0,3000.0,0.0,17883249.81000005,2018,10,6,CASH_OUT,3000.0,C914293025
13598,409000438620',2018-10-06,CR827615054327/RMCPL13776/0,1000.0,0.0,17882249.81000005,2018,10,6,PAYEMENT,1000.0,C2096900616
13599,409000438620',2018-10-06,CR827616059196/RMCPL24829/0,1000.0,0.0,17881249.81000005,2018,10,6,CASH_OUT,1000.0,C571514738
13600,409000438620',2018-10-06,CR827616059256/RMCPL15110/0,1000.0,0.0,17880249.81000005,2018,10,6,CHECK_WITHDRAWAL,1000.0,C1540720037
13601,409000438620',2018-10-06,CR827617075326/RMCPL16457/0,500.0,0.0,17879749.81000005,2018,10,6,CHECK_WITHDRAWAL,500.0,C1340123681
13602,409000438620',2018-10-06,CR827617077786/RMCPL18042/0,600.0,0.0,17879149.81000005,2018,10,6,DEBIT,600.0,C1137350304
13603,409000438620',2018-10-06,CR827613020137/RMCPL20482/0,500.0,0.0,17878649.81000005,2018,10,6,CHECK_WITHDRAWAL,500.0,C1787868648
13604,409000438620',2018-10-06,CR827611003447/RMCPL11131/0,5000.0,0.0,17873649.81000005,2018,10,6,CHECK_WITHDRAWAL,5000.0,C580441921
13605,409000438620',2018-10-06,CR827610989367/RMCPL11281/0,1000.0,0.0,17872649.81000005,2018,10,6,PAYEMENT,1000.0,C1964390106
13606,409000438620',2018-10-06,CR827611993127/RMCPL23157/0,4500.0,0.0,17868149.81000005,2018,10,6,CASH_OUT,4500.0,C843774579
13607,409000438620',2018-10-06,CR827611993114/RMCPL15609/0,2000.0,0.0,17866149.81000005,2018,10,6,DEBIT,2000.0,C1564588329
13608,409000438620',2018-10-06,CR827610987772/RMCPL22744/0,500.0,0.0,17865649.81000005,2018,10,6,CHECK_WITHDRAWAL,500.0,C1772085663
13609,409000438620',2018-10-06,CR827611992724/RMCPL27696/0,2500.0,0.0,17863149.81000005,2018,10,6,PAYEMENT,2500.0,C1983025922
13610,409000438620',2018-10-06,CR827610988169/RMCPL23562/0,500.0,0.0,17862649.81000005,2018,10,6,CHECK_WITHDRAWAL,500.0,C1973191571
13611,409000438620',2018-10-06,CR827610988188/RMCPL20871/0,1000.0,0.0,17861649.81000005,2018,10,6,CASH_OUT,1000.0,C332911016
13612,409000438620',2018-10-06,CR827612015572/RMCPL09617/0,10000.0,0.0,17851649.81000005,2018,10,6,PAYEMENT,10000.0,C1954751748
13613,409000438620',2018-10-06,CR827612015563/RMCPL12664/0,3000.0,0.0,17848649.81000005,2018,10,6,CHECK_WITHDRAWAL,3000.0,C1036454560
13614,409000438620',2018-10-06,CR827616056265/RMCPL18061/0,500.0,0.0,17848149.81000005,2018,10,6,CHECK_WITHDRAWAL,500.0,C1538264524
13615,409000438620',2018-10-06,CR827615046987/RMCPL24692/0,4000.0,0.0,17844149.81000005,2018,10,6,CASH_OUT,4000.0,C232834050
13616,409000438620',2018-10-06,CR827616056431/RMCPL20034/0,500.0,0.0,17843649.81000005,2018,10,6,CASH_OUT,500.0,C1321139761
13617,409000438620',2018-10-06,CR827617083159/RMCPL09821/0,5000.0,0.0,17838649.81000005,2018,10,6,PAYEMENT,5000.0,C405804899
13618,409000438620',2018-10-06,Indiaforensic AEPS NPCI WDL SET,0.0,5442700.0,23281349.81000005,2018,10,6,CASH_IN,5442700.0,C1406193485
13619,409000438620',2018-10-06,TRF TO  Indiaforensic SERVICES I,5000000.0,0.0,18281349.81000005,2018,10,6,CHECK_WITHDRAWAL,5000000.0,C1009972184
13620,409000438620',2018-10-06,TRF TO  Indiaforensic SERVICES I,500000.0,0.0,17781349.81000005,2018,10,6,DEBIT,500000.0,C1927581788
13621,409000438620',2018-10-06,MICRO ATM WDL FEE DT05101,0.0,510000.0,18291349.81000005,2018,10,6,CHECK_CASHING,510000.0,C1233191588
13622,409000438620',2018-10-06,MICRO ATM INC DATED 05101,0.0,1171.8,18292521.61000005,2018,10,6,CHECK_CASHING,1171.8,C1914282536
13623,409000438620',2018-10-06,MICRO ATM GST DATED 05101,0.0,234.36,18292755.97000005,2018,10,6,CHECK_CASHING,234.36,C1838584624
13624,409000438620',2018-10-06,TRF TO  Indiaforensic SERVICES I,500000.0,0.0,17792755.97000005,2018,10,6,PAYEMENT,500000.0,C2104165942
13625,409000438620',2018-10-06,AEPS INCOME DT 05-10-2018,0.0,13931.32,17806687.29000005,2018,10,6,TRANSFER,13931.32,C1477979030
13626,409000438620',2018-10-06,AEPS GST INC DT 05-10-201,0.0,2786.26,17809473.550000053,2018,10,6,CASH_IN,2786.26,C158876320
13627,409000438620',2018-10-06,AEPS ACQ CR ADJ FEES 0510,1056.69,0.0,17808416.86000005,2018,10,6,CASH_OUT,1056.69,C2040603986
13628,409000438620',2018-10-06,MICRO ATM WDL FEE DT06101,0.0,404800.0,18213216.86000005,2018,10,6,TRANSFER,404800.0,C2145942542
13629,409000438620',2018-10-06,MICRO ATM INC DATED 06101,0.0,970.92,18214187.780000053,2018,10,6,CASH_IN,970.92,C11003494
13630,409000438620',2018-10-06,MICRO ATM GST DATED 06101,0.0,194.18,18214381.960000053,2018,10,6,CHECK_CASHING,194.18,C1679546686
13631,409000438620',2018-10-08,Indiaforensic AEPS NPCI WDL SET,0.0,5377500.0,23591881.96000005,2018,10,8,CASH_IN,5377500.0,C935001848
13632,409000438620',2018-10-08,Indiaforensic AEPS NPCI WDL SET,0.0,3065500.0,26657381.96000005,2018,10,8,TRANSFER,3065500.0,C313124964
13633,409000438620',2018-10-08,TRF TO  Indiaforensic SERVICES I,8900000.0,0.0,17757381.960000053,2018,10,8,CASH_OUT,8900000.0,C976133979
13634,409000438620',2018-10-08,MICRO ATM WDL FEE DT06101,0.0,533800.0,18291181.960000053,2018,10,8,TRANSFER,533800.0,C1685837139
13635,409000438620',2018-10-08,MICRO ATM INC DATED 06101,0.0,1205.64,18292387.600000054,2018,10,8,TRANSFER,1205.64,C271588719
13636,409000438620',2018-10-08,MICRO ATM GST DATED 06101,0.0,241.13,18292628.730000053,2018,10,8,CHECK_CASHING,241.13,C710481910
13637,409000438620',2018-10-08,MICRO ATM WDL FEE DT07101,0.0,967900.0,19260528.730000053,2018,10,8,CHECK_CASHING,967900.0,C1887692104
13638,409000438620',2018-10-08,MICRO ATM INC DATED 07101,0.0,2106.36,19262635.09000005,2018,10,8,CHECK_CASHING,2106.36,C1515704208
13639,409000438620',2018-10-08,MICRO ATM GST DATED 07101,0.0,421.27,19263056.36000005,2018,10,8,CASH_IN,421.27,C893038039
13640,409000438620',2018-10-08,MICRO ATM WDL FEE DT08101,0.0,491800.0,19754856.36000005,2018,10,8,CHECK_CASHING,491800.0,C639015907
13641,409000438620',2018-10-08,MICRO ATM INC DATED 08101,0.0,1075.68,19755932.04000005,2018,10,8,CHECK_CASHING,1075.68,C1868787171
13642,409000438620',2018-10-08,MICRO ATM GST DATED 08101,0.0,215.14,19756147.18000005,2018,10,8,TRANSFER,215.14,C311662903
13643,409000438620',2018-10-08,TRF TO  Indiaforensic SERVICES I,1000000.0,0.0,18756147.18000005,2018,10,8,CASH_OUT,1000000.0,C1688209895
13644,409000438620',2018-10-08,NPCI SETELEMENT DIFF_0710,0.0,7500.0,18763647.18000005,2018,10,8,CASH_IN,7500.0,C1956871313
13645,409000438620',2018-10-08,AEPS INCOME DT 06-10-2018,0.0,14157.31,18777804.49000005,2018,10,8,CASH_IN,14157.31,C1554565380
13646,409000438620',2018-10-08,AEPS GST INC DT 06-10-201,0.0,2831.46,18780635.95000005,2018,10,8,CASH_IN,2831.46,M437693994
13647,409000438620',2018-10-08,AEPS INCOME DT 07-10-2018,0.0,8091.25,18788727.20000005,2018,10,8,CASH_IN,8091.25,C1651945012
13648,409000438620',2018-10-08,AEPS GST INC DT 07-10-201,0.0,1618.25,18790345.45000005,2018,10,8,CHECK_CASHING,1618.25,C973641248
13649,409000438620',2018-10-08,AEPS ACQUIRING ADJ FEES 0,17.7,0.0,18790327.75000005,2018,10,8,DEBIT,17.7,C1689840534
13650,409000438620',2018-10-08,AEPS ACQUIRING ADJ FEES 0,35.4,0.0,18790292.350000054,2018,10,8,DEBIT,35.4,M1430208795
13651,409000438620',2018-10-08,AEPS ACQ REP ADJ FEES 061,0.0,35.4,18790327.75000005,2018,10,8,TRANSFER,35.4,M977913176
13652,409000438620',2018-10-09,TRF TO  Indiaforensic SERVICES I,1000000.0,0.0,17790327.750000052,2018,10,9,CASH_OUT,1000000.0,C316486913
13653,409000438620',2018-10-09,Indiaforensic AEPS NPCI WDL SET,0.0,5273800.0,23064127.75000005,2018,10,9,CHECK_CASHING,5273800.0,M1163635407
13654,409000438620',2018-10-09,MAW/502964XXXXXX6016/Akol,0.0,2000.0,23066127.75000005,2018,10,9,CHECK_CASHING,2000.0,M1943756492
13655,409000438620',2018-10-09,TRF TO  Indiaforensic SERVICES I,5000000.0,0.0,18066127.75000005,2018,10,9,CHECK_WITHDRAWAL,5000000.0,M1137843904
13656,409000438620',2018-10-09,MICRO ATM WDL FEE DT08101,0.0,564900.0,18631027.75000005,2018,10,9,TRANSFER,564900.0,M1030551264
13657,409000438620',2018-10-09,MICRO ATM INC DATED 08101,0.0,1359.36,18632387.11000005,2018,10,9,CASH_IN,1359.36,C1456465598
13658,409000438620',2018-10-09,MICRO ATM GST DATED 08101,0.0,271.87,18632658.980000053,2018,10,9,CASH_IN,271.87,C1137422246
13659,409000438620',2018-10-09,TRF TO  Indiaforensic SERVICES I,900000.0,0.0,17732658.980000053,2018,10,9,CHECK_WITHDRAWAL,900000.0,M48946225
13660,409000438620',2018-10-09,MICRO ATM WDL FEE DT09101,0.0,434000.0,18166658.980000053,2018,10,9,CASH_IN,434000.0,C490150701
13661,409000438620',2018-10-09,MICRO ATM INC DATED 09101,0.0,1017.72,18167676.70000005,2018,10,9,CHECK_CASHING,1017.72,C405881980
13662,409000438620',2018-10-09,MICRO ATM GST DATED 09101,0.0,203.54,18167880.24000005,2018,10,9,TRANSFER,203.54,C1808652004
13663,409000438620',2018-10-09,AEPS INCOME DT 10-08-2018,0.0,13962.09,18181842.33000005,2018,10,9,TRANSFER,13962.09,C985934102
13664,409000438620',2018-10-09,AEPS GST INC DT 10-08-201,0.0,2792.42,18184634.75000005,2018,10,9,CHECK_CASHING,2792.42,M1994844299
13665,409000438620',2018-10-09,AEPS ACQ REP ADJ FEES 081,0.0,8.85,18184643.600000054,2018,10,9,TRANSFER,8.85,C1834186423
13666,409000438620',2018-10-10,Indiaforensic AEPS NPCI WDL SET,0.0,4882500.0,23067143.60000005,2018,10,10,CASH_IN,4882500.0,C906718881
13667,409000438620',2018-10-10,TRF TO  Indiaforensic SERVICES I,5400000.0,0.0,17667143.600000054,2018,10,10,CHECK_WITHDRAWAL,5400000.0,M97716324
13668,409000438620',2018-10-10,NPCI SETELEMENT DIFF_0710,7500.0,0.0,17659643.600000054,2018,10,10,DEBIT,7500.0,M1663174094
13669,409000438620',2018-10-10,NPCI SETELEMENT DIFF_0910,0.0,10000.0,17669643.600000054,2018,10,10,CASH_IN,10000.0,M986536349
13670,409000438620',2018-10-10,MICRO ATM WDL FEE DT09101,0.0,655200.0,18324843.600000054,2018,10,10,TRANSFER,655200.0,C1334973394
13671,409000438620',2018-10-10,MICRO ATM INC DATED 09101,0.0,1529.28,18326372.88000005,2018,10,10,TRANSFER,1529.28,M1227133289
13672,409000438620',2018-10-10,MICRO ATM GST DATED 09101,0.0,305.86,18326678.740000054,2018,10,10,CHECK_CASHING,305.86,M385470988
13673,409000438620',2018-10-10,MICRO ATM WDL FEE DT10101,0.0,319600.0,18646278.740000054,2018,10,10,CASH_IN,319600.0,M2081937361
13674,409000438620',2018-10-10,MICRO ATM INC DATED 10101,0.0,810.0,18647088.740000054,2018,10,10,CHECK_CASHING,810.0,M337681470
13675,409000438620',2018-10-10,MICRO ATM GST DATED 10101,0.0,162.0,18647250.740000054,2018,10,10,TRANSFER,162.0,M1782106398
13676,409000438620',2018-10-10,TRF TO  Indiaforensic SERVICES I,600000.0,0.0,18047250.740000054,2018,10,10,PAYEMENT,600000.0,M1011761988
13677,409000438620',2018-10-10,AEPS INCOME DT 10-09-2018,0.0,12997.22,18060247.960000053,2018,10,10,TRANSFER,12997.22,M556036405
13678,409000438620',2018-10-10,AEPS GST INC DT 10-09-201,0.0,2599.44,18062847.40000005,2018,10,10,CHECK_CASHING,2599.44,M1009671350
13679,409000438620',2018-10-10,AEPS ACQUIRING ADJ FEES 0,35.4,0.0,18062812.000000056,2018,10,10,CHECK_WITHDRAWAL,35.4,M1928877497
13680,409000438620',2018-10-11,AEPS PAY Indiaforensic 0510,0.0,498.12,18063310.120000053,2018,10,11,CHECK_CASHING,498.12,M1832267584
13681,409000438620',2018-10-11,MAW/502964XXXXXX0839/NAGA,0.0,900.0,18064210.120000053,2018,10,11,TRANSFER,900.0,M347571392
13682,409000438620',2018-10-11,Indiaforensic AEPS NPCI WDL SET,0.0,4897200.0,22961410.12000005,2018,10,11,TRANSFER,4897200.0,M1942801618
13683,409000438620',2018-10-11,CR827711251567/RMCPL24821/0,10000.0,0.0,22951410.12000005,2018,10,11,CASH_OUT,10000.0,M1834116740
13684,409000438620',2018-10-11,CR827711251581/RMCPL19766/0,500.0,0.0,22950910.12000005,2018,10,11,CASH_OUT,500.0,M841555342
13685,409000438620',2018-10-11,CR827711251577/RMCPL19527/0,2000.0,0.0,22948910.12000005,2018,10,11,CHECK_WITHDRAWAL,2000.0,M1377770871
13686,409000438620',2018-10-11,CR827711245132/RMCPL23991/0,5500.0,0.0,22943410.12000005,2018,10,11,PAYEMENT,5500.0,M945402246
13687,409000438620',2018-10-11,CR827711245149/RMCPL17696/0,1000.0,0.0,22942410.12000005,2018,10,11,DEBIT,1000.0,M122958939
13688,409000438620',2018-10-11,CR827711245271/RMCPL12805/0,1000.0,0.0,22941410.12000005,2018,10,11,PAYEMENT,1000.0,C670244241
13689,409000438620',2018-10-11,CR827711245037/RMCPL20518/0,5000.0,0.0,22936410.12000005,2018,10,11,DEBIT,5000.0,M2115789674
13690,409000438620',2018-10-11,CR827711237290/RMCPL21549/0,10000.0,0.0,22926410.12000005,2018,10,11,CHECK_WITHDRAWAL,10000.0,M1697295436
13691,409000438620',2018-10-11,CR827711237300/RMCPL09152/0,700.0,0.0,22925710.12000005,2018,10,11,CASH_OUT,700.0,M852791174
13692,409000438620',2018-10-11,CR827711250546/RMCPL12354/0,2000.0,0.0,22923710.12000005,2018,10,11,DEBIT,2000.0,M963372774
13693,409000438620',2018-10-11,CR827711251039/RMCPL14829/0,6000.0,0.0,22917710.12000005,2018,10,11,CHECK_WITHDRAWAL,6000.0,M1966099259
13694,409000438620',2018-10-11,CR827711251030/RMCPL20491/0,500.0,0.0,22917210.12000005,2018,10,11,DEBIT,500.0,M26319327
13695,409000438620',2018-10-11,CR827711251026/RMCPL12354/0,2000.0,0.0,22915210.12000005,2018,10,11,DEBIT,2000.0,M1737696383
13696,409000438620',2018-10-11,CR827711243143/RMCPL26120/0,800.0,0.0,22914410.12000005,2018,10,11,CHECK_WITHDRAWAL,800.0,M1437401449
13697,409000438620',2018-10-11,CR827711252012/RMCPL15613/0,1000.0,0.0,22913410.12000005,2018,10,11,CASH_OUT,1000.0,M1433822642
13698,409000438620',2018-10-11,CR827711251660/RMCPL27211/0,1000.0,0.0,22912410.12000005,2018,10,11,DEBIT,1000.0,M1234514817
13699,409000438620',2018-10-11,CR827711251777/RMCPL14829/0,2000.0,0.0,22910410.12000005,2018,10,11,CASH_OUT,2000.0,M1150871402
13700,409000438620',2018-10-11,CR827711252322/RMCPL22250/0,2000.0,0.0,22908410.12000005,2018,10,11,PAYEMENT,2000.0,M653039729
13701,409000438620',2018-10-11,CR827711241718/RMCPL23533/0,500.0,0.0,22907910.12000005,2018,10,11,DEBIT,500.0,C1689262323
13702,409000438620',2018-10-11,CR827711241717/RMCPL14643/0,2000.0,0.0,22905910.12000005,2018,10,11,CHECK_WITHDRAWAL,2000.0,C674913323
13703,409000438620',2018-10-11,CR827711242199/RMCPL18049/0,10000.0,0.0,22895910.12000005,2018,10,11,PAYEMENT,10000.0,M68786983
13704,409000438620',2018-10-11,CR827711242261/RMCPL15112/0,1000.0,0.0,22894910.12000005,2018,10,11,CHECK_WITHDRAWAL,1000.0,C423580937
13705,409000438620',2018-10-11,CR827711252340/RMCPL19079/0,900.0,0.0,22894010.12000005,2018,10,11,CHECK_WITHDRAWAL,900.0,C1246297699
13706,409000438620',2018-10-11,CR827717323017/RMCPL19959/0,500.0,0.0,22893510.12000005,2018,10,11,DEBIT,500.0,M743042813
13707,409000438620',2018-10-11,CR827717331318/RMCPL23157/0,1000.0,0.0,22892510.12000005,2018,10,11,CHECK_WITHDRAWAL,1000.0,M1785079892
13708,409000438620',2018-10-11,CR827711248498/RMCPL21549/0,2000.0,0.0,22890510.12000005,2018,10,11,PAYEMENT,2000.0,M1629346499
13709,409000438620',2018-10-11,CR827711248568/RMCPL14382/0,1200.0,0.0,22889310.12000005,2018,10,11,DEBIT,1200.0,M949433061
13710,409000438620',2018-10-11,CR827711248924/RMCPL24117/0,1000.0,0.0,22888310.12000005,2018,10,11,DEBIT,1000.0,M847579868
13711,409000438620',2018-10-11,CR827711248563/RMCPL20143/0,2000.0,0.0,22886310.12000005,2018,10,11,CHECK_WITHDRAWAL,2000.0,C653593128
13712,409000438620',2018-10-11,CR827711248932/RMCPL27346/0,2400.0,0.0,22883910.12000005,2018,10,11,PAYEMENT,2400.0,M554602748
13713,409000438620',2018-10-11,CR827711248560/RMCPL20518/0,1300.0,0.0,22882610.12000005,2018,10,11,CASH_OUT,1300.0,M1760281069
13714,409000438620',2018-10-11,CR827711249108/RMCPL19146/0,500.0,0.0,22882110.12000005,2018,10,11,CHECK_WITHDRAWAL,500.0,M1741792175
13715,409000438620',2018-10-11,CR827711249333/RMCPL22507/0,3000.0,0.0,22879110.12000005,2018,10,11,CHECK_WITHDRAWAL,3000.0,M1462575904
13716,409000438620',2018-10-11,CR827711249480/RMCPL22866/0,1000.0,0.0,22878110.12000005,2018,10,11,CHECK_WITHDRAWAL,1000.0,M1698504060
13717,409000438620',2018-10-11,CR827711249474/RMCPL20143/0,2000.0,0.0,22876110.12000005,2018,10,11,PAYEMENT,2000.0,M1094733392
13718,409000438620',2018-10-11,CR827711249749/RMCPL20587/0,2000.0,0.0,22874110.12000005,2018,10,11,DEBIT,2000.0,C1573641401
13719,409000438620',2018-10-11,CR827712253388/RMCPL11151/0,500.0,0.0,22873610.12000005,2018,10,11,PAYEMENT,500.0,M911901382
13720,409000438620',2018-10-11,CR827712253324/RMCPL23031/0,500.0,0.0,22873110.12000005,2018,10,11,DEBIT,500.0,M2046721719
13721,409000438620',2018-10-11,CR827712253877/RMCPL20245/0,5000.0,0.0,22868110.12000005,2018,10,11,CHECK_WITHDRAWAL,5000.0,M1136685930
13722,409000438620',2018-10-11,CR827712253870/RMCPL25271/0,500.0,0.0,22867610.12000005,2018,10,11,PAYEMENT,500.0,C208341157
13723,409000438620',2018-10-11,CR827712254403/RMCPL19941/0,2500.0,0.0,22865110.12000005,2018,10,11,CHECK_WITHDRAWAL,2500.0,M854761186
13724,409000438620',2018-10-11,CR827712254329/RMCPL13815/0,4000.0,0.0,22861110.12000005,2018,10,11,PAYEMENT,4000.0,C665576141
13725,409000438620',2018-10-11,CR827712254721/RMCPL19146/0,700.0,0.0,22860410.12000005,2018,10,11,CASH_OUT,700.0,C748014372
13726,409000438620',2018-10-11,CR827712257212/RMCPL23244/0,1000.0,0.0,22859410.12000005,2018,10,11,DEBIT,1000.0,M1346975381
13727,409000438620',2018-10-11,CR827712257107/RMCPL11131/0,1000.0,0.0,22858410.12000005,2018,10,11,CASH_OUT,1000.0,M879731647
13728,409000438620',2018-10-11,CR827712260631/RMCPL25277/0,500.0,0.0,22857910.12000005,2018,10,11,CASH_OUT,500.0,M240854249
13729,409000438620',2018-10-11,CR827712260572/RMCPL20311/0,2000.0,0.0,22855910.12000005,2018,10,11,DEBIT,2000.0,C1778300121
13730,409000438620',2018-10-11,CR827712260640/RMCPL23562/0,500.0,0.0,22855410.12000005,2018,10,11,DEBIT,500.0,C2112142735
13731,409000438620',2018-10-11,CR827712260621/RMCPL27159/0,2000.0,0.0,22853410.12000005,2018,10,11,CHECK_WITHDRAWAL,2000.0,M1153672386
13732,409000438620',2018-10-11,CR827712260637/RMCPL15535/0,2000.0,0.0,22851410.12000005,2018,10,11,CHECK_WITHDRAWAL,2000.0,C571435580
13733,409000438620',2018-10-11,CR827712260624/RMCPL18671/0,10000.0,0.0,22841410.12000005,2018,10,11,CASH_OUT,10000.0,C1532153384
13734,409000438620',2018-10-11,CR827712260648/RMCPL09523/0,3000.0,0.0,22838410.12000005,2018,10,11,DEBIT,3000.0,M1529031561
13735,409000438620',2018-10-11,CR827712260658/RMCPL17534/0,10000.0,0.0,22828410.12000005,2018,10,11,DEBIT,10000.0,C1643855278
13736,409000438620',2018-10-11,CR827712253232/RMCPL09612/0,1500.0,0.0,22826910.12000005,2018,10,11,CASH_OUT,1500.0,M1551554679
13737,409000438620',2018-10-11,CR827712253258/RMCPL26216/0,6000.0,0.0,22820910.12000005,2018,10,11,DEBIT,6000.0,M1817495451
13738,409000438620',2018-10-11,CR827711243055/RMCPL25199/0,1000.0,0.0,22819910.12000005,2018,10,11,CHECK_WITHDRAWAL,1000.0,M253817088
13739,409000438620',2018-10-11,CR827711243077/RMCPL18596/0,500.0,0.0,22819410.12000005,2018,10,11,CASH_OUT,500.0,C363475076
13740,409000438620',2018-10-11,CR827711245069/RMCPL09726/0,5000.0,0.0,22814410.12000005,2018,10,11,DEBIT,5000.0,M2035759196
13741,409000438620',2018-10-11,CR827816550310/RMCPL22286/0,500.0,0.0,22813910.12000005,2018,10,11,DEBIT,500.0,M639271496
13742,409000438620',2018-10-11,CR827816547296/RMCPL21728/0,500.0,0.0,22813410.12000005,2018,10,11,CASH_OUT,500.0,M1758132212
13743,409000438620',2018-10-11,CR827816551052/RMCPL24250/0,500.0,0.0,22812910.12000005,2018,10,11,CHECK_WITHDRAWAL,500.0,M1350169062
13744,409000438620',2018-10-11,CR827814528982/RMCPL19108/0,5000.0,0.0,22807910.12000005,2018,10,11,CASH_OUT,5000.0,M981633575
13745,409000438620',2018-10-11,CR827814527010/RMCPL23228/0,1500.0,0.0,22806410.12000005,2018,10,11,DEBIT,1500.0,M514498459
13746,409000438620',2018-10-11,CR827814528027/RMCPL21381/0,2500.0,0.0,22803910.12000005,2018,10,11,DEBIT,2500.0,M1889419114
13747,409000438620',2018-10-11,CR827811476742/RMCPL19108/0,700.0,0.0,22803210.12000005,2018,10,11,PAYEMENT,700.0,C1395746279
13748,409000438620',2018-10-11,CR827811476795/RMCPL21454/0,10000.0,0.0,22793210.12000005,2018,10,11,CASH_OUT,10000.0,M1654108420
13749,409000438620',2018-10-11,MICROATM_DIFF_101018,0.0,10000.0,22803210.12000005,2018,10,11,CASH_IN,10000.0,C75629578
13750,409000438620',2018-10-11,TRF TO  Indiaforensic SERVICES I,5000000.0,0.0,17803210.120000053,2018,10,11,CASH_OUT,5000000.0,M1235693013
13751,409000438620',2018-10-11,MAW/502964XXXXXX8983/NAGA,0.0,1000.0,17804210.120000053,2018,10,11,CASH_IN,1000.0,M1750130372
13752,409000438620',2018-10-11,MICRO ATM WDL FEE DT10101,0.0,470000.0,18274210.120000053,2018,10,11,TRANSFER,470000.0,M418591730
13753,409000438620',2018-10-11,MICRO ATM INC DATED 10101,0.0,1128.24,18275338.36000005,2018,10,11,TRANSFER,1128.24,M1562661077
13754,409000438620',2018-10-11,MICRO ATM GST DATED 10101,0.0,225.65,18275564.010000054,2018,10,11,CHECK_CASHING,225.65,M1739451881
13755,409000438620',2018-10-11,TRF TO  Indiaforensic SERVICES I,600000.0,0.0,17675564.010000054,2018,10,11,CASH_OUT,600000.0,M1262172961
13756,409000438620',2018-10-11,MICRO ATM WDL FEE DT11101,0.0,343700.0,18019264.010000054,2018,10,11,TRANSFER,343700.0,C1728766751
13757,409000438620',2018-10-11,MICRO ATM INC DATED 11101,0.0,755.28,18020019.29000005,2018,10,11,CHECK_CASHING,755.28,M595125434
13758,409000438620',2018-10-11,MICRO ATM GST DATED 11101,0.0,151.06,18020170.350000054,2018,10,11,CHECK_CASHING,151.06,M1691241233
13759,409000438620',2018-10-11,AEPS INCOME DT 10-10-2018,0.0,12684.07,18032854.420000054,2018,10,11,TRANSFER,12684.07,M238479627
13760,409000438620',2018-10-11,AEPS GST INC DT 10-10-201,0.0,2536.81,18035391.230000053,2018,10,11,TRANSFER,2536.81,M1749040393
13761,409000438620',2018-10-11,AEPS ACQ CR ADJ FEES 1010,641.33,0.0,18034749.90000005,2018,10,11,CHECK_WITHDRAWAL,641.33,M1198570500
13762,409000438620',2018-10-11,AEPS ACQ REP ADJ FEES 101,0.0,53.1,18034803.000000056,2018,10,11,CHECK_CASHING,53.1,M1395976500
13763,409000438620',2018-10-11,AEPS PAY Indiaforensic 1010,0.0,99.64,18034902.640000056,2018,10,11,CHECK_CASHING,99.64,M1417123274
13764,409000438620',2018-10-12,MAW/502964XXXXXX0699/Karu,0.0,1800.0,18036702.640000056,2018,10,12,CASH_IN,1800.0,M855662045
13765,409000438620',2018-10-12,Indiaforensic AEPS NPCI WDL SET,0.0,4610700.0,22647402.640000056,2018,10,12,TRANSFER,4610700.0,C1964947881
13766,409000438620',2018-10-12,CR828010944194/RMCPL25301/0,500.0,0.0,22646902.640000056,2018,10,12,CHECK_WITHDRAWAL,500.0,M1836970545
13767,409000438620',2018-10-12,CR828017036942/RMCPL00225/0,10000.0,0.0,22636902.640000056,2018,10,12,PAYEMENT,10000.0,M1228713451
13768,409000438620',2018-10-12,CR828017036928/RMCPL27464/0,2000.0,0.0,22634902.640000056,2018,10,12,CHECK_WITHDRAWAL,2000.0,M1047845407
13769,409000438620',2018-10-12,CR827909695194/RMCPL27083/0,700.0,0.0,22634202.640000056,2018,10,12,PAYEMENT,700.0,C1300519073
13770,409000438620',2018-10-12,CR827916795400/RMCPL20420/0,500.0,0.0,22633702.640000056,2018,10,12,DEBIT,500.0,M904779910
13771,409000438620',2018-10-12,CR827911720308/RMCPL23821/0,10000.0,0.0,22623702.640000056,2018,10,12,DEBIT,10000.0,M415055963
13772,409000438620',2018-10-12,CR828212450385/RMCPL15290/0,1200.0,0.0,22622502.640000056,2018,10,12,CASH_OUT,1200.0,M667600971
13773,409000438620',2018-10-12,CR828217516610/RMCPL25883/0,2400.0,0.0,22620102.640000056,2018,10,12,PAYEMENT,2400.0,M1915818512
13774,409000438620',2018-10-12,CR828214467604/RMCPL00225/0,1500.0,0.0,22618602.640000056,2018,10,12,DEBIT,1500.0,M1073284841
13775,409000438620',2018-10-12,CR828216492973/RMCPL24532/0,3300.0,0.0,22615302.640000056,2018,10,12,DEBIT,3300.0,C1823014131
13776,409000438620',2018-10-12,CR828117280324/RMCPL18136/0,1000.0,0.0,22614302.640000056,2018,10,12,CHECK_WITHDRAWAL,1000.0,C1728766751
13777,409000438620',2018-10-12,TRF TO  Indiaforensic SERVICES I,4900000.0,0.0,17714302.640000056,2018,10,12,CHECK_WITHDRAWAL,4900000.0,C1181708889
13778,409000438620',2018-10-12,MAW/502964XXXXXX4259/Karu,0.0,2000.0,17716302.640000056,2018,10,12,TRANSFER,2000.0,M329849858
13779,409000438620',2018-10-12,MAW/502964XXXXXX7502/Akol,0.0,1000.0,17717302.640000056,2018,10,12,CASH_IN,1000.0,C1564931235
13780,409000438620',2018-10-12,MAW/502964XXXXXX1997/NAGA,0.0,1200.0,17718502.640000056,2018,10,12,CASH_IN,1200.0,M93219136
13781,409000438620',2018-10-12,MICRO ATM WDL FEE DT11101,0.0,543700.0,18262202.640000056,2018,10,12,CHECK_CASHING,543700.0,M2070406670
13782,409000438620',2018-10-12,MICRO ATM INC DATED 11101,0.0,1203.48,18263406.120000053,2018,10,12,CASH_IN,1203.48,M490930210
13783,409000438620',2018-10-12,MICRO ATM GST DATED 11101,0.0,240.7,18263646.820000056,2018,10,12,CASH_IN,240.7,M1721002361
13784,409000438620',2018-10-12,AEPS INCOME DT 10-11-2018,0.0,11805.69,18275452.510000054,2018,10,12,CASH_IN,11805.69,C619120762
13785,409000438620',2018-10-12,AEPS GST INC DT 10-11-201,0.0,2361.14,18277813.65000005,2018,10,12,CASH_IN,2361.14,M440015705
13786,409000438620',2018-10-12,TRF TO  Indiaforensic SERVICES I,600000.0,0.0,17677813.650000058,2018,10,12,PAYEMENT,600000.0,M1608432859
13787,409000438620',2018-10-12,AEPS ACQ CR ADJ FEES 1110,110.92,0.0,17677702.730000056,2018,10,12,CHECK_WITHDRAWAL,110.92,M719539498
13788,409000438620',2018-10-12,MICRO ATM WDL FEE DT12101,0.0,382200.0,18059902.730000056,2018,10,12,TRANSFER,382200.0,C1210180003
13789,409000438620',2018-10-12,MICRO ATM INC DATED 12101,0.0,967.32,18060870.050000057,2018,10,12,CHECK_CASHING,967.32,M2001512216
13790,409000438620',2018-10-12,MICRO ATM GST DATED 12101,0.0,193.46,18061063.510000054,2018,10,12,CASH_IN,193.46,M2040979686
13791,409000438620',2018-10-12,NPCI SETELEMENT DIFF_1110,0.0,6000.0,18067063.510000054,2018,10,12,CASH_IN,6000.0,M1831413362
13792,409000438620',2018-10-13,MAW/502964XXXXXX3514/NAGA,0.0,1200.0,18068263.510000054,2018,10,13,TRANSFER,1200.0,M1437652818
13793,409000438620',2018-10-14,MAW/502964XXXXXX9031/NAGA,0.0,900.0,18069163.510000054,2018,10,14,CHECK_CASHING,900.0,M1997601211
13794,409000438620',2018-10-15,Indiaforensic AEPS NPCI WDL SET,0.0,4946700.0,23015863.51000005,2018,10,15,CASH_IN,4946700.0,C1541385794
13795,409000438620',2018-10-15,TRF TO  Indiaforensic SERVICES I,5300000.0,0.0,17715863.510000058,2018,10,15,DEBIT,5300000.0,M1672463328
13796,409000438620',2018-10-15,Indiaforensic AEPS NPCI WDL SET,0.0,4262800.0,21978663.510000054,2018,10,15,CASH_IN,4262800.0,M141610465
13797,409000438620',2018-10-15,MAW/502964XXXXXX2797/Karu,0.0,1700.0,21980363.510000054,2018,10,15,TRANSFER,1700.0,M395744711
13798,409000438620',2018-10-15,MAW/502964XXXXXX4795/Karu,0.0,1700.0,21982063.510000054,2018,10,15,TRANSFER,1700.0,M455024356
13799,409000438620',2018-10-15,MAW/502964XXXXXX6003/Karu,0.0,1700.0,21983763.510000054,2018,10,15,TRANSFER,1700.0,M1834445032
13800,409000438620',2018-10-15,MAW/502964XXXXXX0616/Karu,0.0,1700.0,21985463.510000054,2018,10,15,CASH_IN,1700.0,M1828864502
13801,409000438620',2018-10-15,MAW/502964XXXXXX8907/Karu,0.0,1700.0,21987163.510000054,2018,10,15,CHECK_CASHING,1700.0,M310623993
13802,409000438620',2018-10-15,CR828311672209/RMCPL12805/1,1000.0,0.0,21986163.510000054,2018,10,15,CHECK_WITHDRAWAL,1000.0,M789416610
13803,409000438620',2018-10-15,CR828314716251/RMCPL00928/1,500.0,0.0,21985663.510000054,2018,10,15,CASH_OUT,500.0,M1210987265
13804,409000438620',2018-10-15,CR828312681787/RMCPL19793/1,4000.0,0.0,21981663.510000054,2018,10,15,PAYEMENT,4000.0,C115885991
13805,409000438620',2018-10-15,CR828318764591/RMCPL11793/1,4000.0,0.0,21977663.510000054,2018,10,15,CASH_OUT,4000.0,M1324634404
13806,409000438620',2018-10-15,Indiaforensic AEPS NPCI WDL SET,0.0,2821100.0,24798763.51000005,2018,10,15,CASH_IN,2821100.0,C1954751748
13807,409000438620',2018-10-15,TRF TO  Indiaforensic SERVICES I,3000000.0,0.0,21798763.510000054,2018,10,15,DEBIT,3000000.0,M1779378545
13808,409000438620',2018-10-15,TRF TO  Indiaforensic SERVICES I,4000000.0,0.0,17798763.510000058,2018,10,15,DEBIT,4000000.0,M794998947
13809,409000438620',2018-10-15,NPCI SETELEMENT DIFF_1210,0.0,5000.0,17803763.510000058,2018,10,15,TRANSFER,5000.0,M769267147
13810,409000438620',2018-10-15,MICRO ATM WDL FEE DT15101,0.0,525200.0,18328963.510000054,2018,10,15,TRANSFER,525200.0,M1626165592
13811,409000438620',2018-10-15,MICRO ATM INC DATED 15101,0.0,1333.8,18330297.31000006,2018,10,15,CASH_IN,1333.8,M1275524767
13812,409000438620',2018-10-15,MICRO ATM GST DATED 15101,0.0,266.76,18330564.07000006,2018,10,15,CHECK_CASHING,266.76,M514586286
13813,409000438620',2018-10-15,MICRO ATM WDL FEE DT12101,0.0,633900.0,18964464.07000006,2018,10,15,CHECK_CASHING,633900.0,M720079999
13814,409000438620',2018-10-15,MICRO ATM INC DATED 12101,0.0,1396.44,18965860.51000006,2018,10,15,TRANSFER,1396.44,C70895366
13815,409000438620',2018-10-15,MICRO ATM GST DATED 12101,0.0,279.29,18966139.80000006,2018,10,15,CASH_IN,279.29,C1060041730
13816,409000438620',2018-10-15,MICRO ATM WDL FEE DT13101,0.0,1075300.0,20041439.80000006,2018,10,15,CHECK_CASHING,1075300.0,C861720625
13817,409000438620',2018-10-15,MICRO ATM INC DATED 13101,0.0,2415.24,20043855.04000006,2018,10,15,TRANSFER,2415.24,C798678484
13818,409000438620',2018-10-15,MICRO ATM GST DATED 13101,0.0,483.05,20044338.09000006,2018,10,15,TRANSFER,483.05,C1991274064
13819,409000438620',2018-10-15,MICRO ATM WDL FEE DT14101,0.0,1016500.0,21060838.09000006,2018,10,15,CHECK_CASHING,1016500.0,C1554540309
13820,409000438620',2018-10-15,MICRO ATM INC DATED 14101,0.0,2486.52,21063324.61000006,2018,10,15,CHECK_CASHING,2486.52,C1982828534
13821,409000438620',2018-10-15,MICRO ATM GST DATED 14101,0.0,497.3,21063821.91000006,2018,10,15,CASH_IN,497.3,C158876320
13822,409000438620',2018-10-15,TRF TO  Indiaforensic SERVICES I,3000000.0,0.0,18063821.91000006,2018,10,15,DEBIT,3000000.0,C1394526584
13823,409000438620',2018-10-15,AEPS INCOME DT 10-12-2018,0.0,13097.03,18076918.94000006,2018,10,15,TRANSFER,13097.03,C800288141
13824,409000438620',2018-10-15,AEPS GST INC DT 10-12-201,0.0,2619.41,18079538.35000006,2018,10,15,TRANSFER,2619.41,C1671386208
13825,409000438620',2018-10-15,AEPS INCOME DT 10-13-2018,0.0,11285.01,18090823.360000066,2018,10,15,CHECK_CASHING,11285.01,C1181708889
13826,409000438620',2018-10-15,AEPS GST INC DT 10-13-201,0.0,2257.0,18093080.360000066,2018,10,15,CHECK_CASHING,2257.0,C988138425
13827,409000438620',2018-10-15,AEPS INCOME DT 10-14-2018,0.0,7680.53,18100760.890000064,2018,10,15,TRANSFER,7680.53,C611621587
13828,409000438620',2018-10-15,AEPS GST INC DT 10-14-201,0.0,1536.11,18102297.000000063,2018,10,15,CHECK_CASHING,1536.11,C128870695
13829,409000438620',2018-10-15,AEPS ACQUIRING ADJ FEES 1,17.7,0.0,18102279.300000064,2018,10,15,DEBIT,17.7,M1152907979
13830,409000438620',2018-10-15,AEPS ACQ CR ADJ FEES 1210,44.25,0.0,18102235.050000064,2018,10,15,PAYEMENT,44.25,C1195378184
13831,409000438620',2018-10-15,AEPS ACQ REP ADJ FEES 121,0.0,17.7,18102252.750000063,2018,10,15,CASH_IN,17.7,M1128837480
13832,409000438620',2018-10-15,AEPS PAY Indiaforensic 1310,0.0,398.87,18102651.620000064,2018,10,15,TRANSFER,398.87,M1141714120
13833,409000438620',2018-10-16,MAW/502964XXXXXX8587/NAGA,0.0,900.0,18103551.620000064,2018,10,16,CASH_IN,900.0,M1784108277
13834,409000438620',2018-10-16,Indiaforensic AEPS NPCI WDL SET,0.0,4309800.0,22413351.620000064,2018,10,16,CASH_IN,4309800.0,C1725548614
13835,409000438620',2018-10-16,CR828409879832/RMCPL21726/1,500.0,0.0,22412851.620000064,2018,10,16,PAYEMENT,500.0,M319370900
13836,409000438620',2018-10-16,CR828412923728/RMCPL10937/1,500.0,0.0,22412351.620000064,2018,10,16,PAYEMENT,500.0,M1844265214
13837,409000438620',2018-10-16,CR828417992743/RMCPL12772/1,500.0,0.0,22411851.620000064,2018,10,16,CASH_OUT,500.0,M74014779
13838,409000438620',2018-10-16,CR828413946715/RMCPL09592/1,10000.0,0.0,22401851.620000064,2018,10,16,PAYEMENT,10000.0,C907892387
13839,409000438620',2018-10-16,TRF TO  Indiaforensic SERVICES I,4600000.0,0.0,17801851.620000064,2018,10,16,PAYEMENT,4600000.0,M633673177
13840,409000438620',2018-10-16,MAW/502964XXXXXX0486/NAGA,0.0,900.0,17802751.620000064,2018,10,16,TRANSFER,900.0,M171651946
13841,409000438620',2018-10-16,MAW/502964XXXXXX8117/NAGA,0.0,600.0,17803351.620000064,2018,10,16,CHECK_CASHING,600.0,M173603238
13842,409000438620',2018-10-16,NPCI SETELEMENT DIFF_1410,0.0,1600.0,17804951.620000064,2018,10,16,TRANSFER,1600.0,M624593182
13843,409000438620',2018-10-16,MICRO ATM WDL FEE DT15101,0.0,826800.0,18631751.620000064,2018,10,16,CASH_IN,826800.0,M500426853
13844,409000438620',2018-10-16,MICRO ATM INC DATED 15101,0.0,2061.36,18633812.980000064,2018,10,16,TRANSFER,2061.36,M1350778722
13845,409000438620',2018-10-16,MICRO ATM GST DATED 15101,0.0,412.27,18634225.250000063,2018,10,16,CASH_IN,412.27,M1609036676
13846,409000438620',2018-10-16,AEPS INCOME DT 10-15-2018,0.0,11465.65,18645690.90000006,2018,10,16,CASH_IN,11465.65,M913816048
13847,409000438620',2018-10-16,AEPS GST INC DT 10-15-201,0.0,2293.13,18647984.03000006,2018,10,16,CHECK_CASHING,2293.13,M640511728
13848,409000438620',2018-10-16,AEPS ACQ CR ADJ FEES 1510,26.55,0.0,18647957.48000006,2018,10,16,CHECK_WITHDRAWAL,26.55,M1696260901
13849,409000438620',2018-10-16,MICRO ATM WDL FEE DT16101,0.0,583800.0,19231757.48000006,2018,10,16,TRANSFER,583800.0,M1488505354
13850,409000438620',2018-10-16,MICRO ATM INC DATED 16101,0.0,1371.6,19233129.08000006,2018,10,16,CHECK_CASHING,1371.6,M1333588308
13851,409000438620',2018-10-16,MICRO ATM GST DATED 16101,0.0,274.32,19233403.40000006,2018,10,16,TRANSFER,274.32,M1068380229
13852,409000438620',2018-10-16,TRF TO  Indiaforensic SERVICES I,600000.0,0.0,18633403.40000006,2018,10,16,CHECK_WITHDRAWAL,600000.0,M60376816
13853,409000438620',2018-10-16,TRF TO  Indiaforensic SERVICES I,900000.0,0.0,17733403.40000006,2018,10,16,DEBIT,900000.0,M787953412
13854,409000438620',2018-10-17,CB827711242705/RMCPL22522/0,3000.0,0.0,17730403.40000006,2018,10,17,DEBIT,3000.0,C1354952534
13855,409000438620',2018-10-17,Indiaforensic AEPS NPCI WDL SET,0.0,4545300.0,22275703.40000006,2018,10,17,CHECK_CASHING,4545300.0,M994051277
13856,409000438620',2018-10-17,CR828609360769/RMCPL19422/1,1000.0,0.0,22274703.40000006,2018,10,17,PAYEMENT,1000.0,C1874451126
13857,409000438620',2018-10-17,CR828616455674/RMCPL12858/1,10000.0,0.0,22264703.40000006,2018,10,17,PAYEMENT,10000.0,M1593184149
13858,409000438620',2018-10-17,CR828616455583/RMCPL22756/1,1600.0,0.0,22263103.40000006,2018,10,17,CHECK_WITHDRAWAL,1600.0,M184560642
13859,409000438620',2018-10-17,CR828610374687/RMCPL12952/1,5000.0,0.0,22258103.40000006,2018,10,17,PAYEMENT,5000.0,M549492098
13860,409000438620',2018-10-17,CR828612406662/RMCPL25190/1,10000.0,0.0,22248103.40000006,2018,10,17,CASH_OUT,10000.0,M399203492
13861,409000438620',2018-10-17,CR828511149943/RMCPL24195/1,1800.0,0.0,22246303.40000006,2018,10,17,CHECK_WITHDRAWAL,1800.0,M1481049790
13862,409000438620',2018-10-17,CR828511149965/RMCPL19037/1,1000.0,0.0,22245303.40000006,2018,10,17,CASH_OUT,1000.0,M9018638
13863,409000438620',2018-10-17,MAW/502964XXXXXX6900/Karu,0.0,1900.0,22247203.40000006,2018,10,17,CASH_IN,1900.0,M1662433071
13864,409000438620',2018-10-17,MAW/502964XXXXXX3012/Karu,0.0,1700.0,22248903.40000006,2018,10,17,TRANSFER,1700.0,M880410577
13865,409000438620',2018-10-17,MICRO ATM WDL FEE DT16101,0.0,792000.0,23040903.40000006,2018,10,17,CASH_IN,792000.0,M1077841146
13866,409000438620',2018-10-17,MICRO ATM INC DATED 16101,0.0,1848.6,23042752.000000063,2018,10,17,CASH_IN,1848.6,M1621946021
13867,409000438620',2018-10-17,MICRO ATM GST DATED 16101,0.0,369.72,23043121.720000066,2018,10,17,CASH_IN,369.72,M2111414668
13868,409000438620',2018-10-17,TRF TO  Indiaforensic SERVICES I,4400000.0,0.0,18643121.720000066,2018,10,17,CASH_OUT,4400000.0,C2072865894
13869,409000438620',2018-10-17,AEPS PAY Indiaforensic 1510,0.0,99.64,18643221.360000066,2018,10,17,CASH_IN,99.64,C1014923261
13870,409000438620',2018-10-17,AEPS INCOME DT 10-16-2018,0.0,11855.19,18655076.550000064,2018,10,17,CASH_IN,11855.19,C1826334428
13871,409000438620',2018-10-17,AEPS GST INC DT 10-16-201,0.0,2371.04,18657447.590000063,2018,10,17,CASH_IN,2371.04,M363019648
13872,409000438620',2018-10-17,TRF TO  Indiaforensic SERVICES I,900000.0,0.0,17757447.590000063,2018,10,17,PAYEMENT,900000.0,M2031405228
13873,409000438620',2018-10-17,AEPS ACQ CR ADJ FEES 1610,84.96,0.0,17757362.630000062,2018,10,17,CASH_OUT,84.96,C748014372
13874,409000438620',2018-10-17,MICRO ATM WDL FEE DT17101,0.0,670300.0,18427662.630000066,2018,10,17,CASH_IN,670300.0,M664483699
13875,409000438620',2018-10-17,MICRO ATM INC DATED 17101,0.0,1611.36,18429273.99000006,2018,10,17,TRANSFER,1611.36,M202237641
13876,409000438620',2018-10-17,MICRO ATM GST DATED 17101,0.0,322.27,18429596.26000006,2018,10,17,TRANSFER,322.27,C757003004
13877,409000438620',2018-10-17,TRF TO  Indiaforensic SERVICES I,700000.0,0.0,17729596.26000006,2018,10,17,CHECK_WITHDRAWAL,700000.0,M1204775681
13878,409000438620',2018-10-18,Indiaforensic AEPS NPCI WDL SET,0.0,4532000.0,22261596.26000006,2018,10,18,CASH_IN,4532000.0,M2110519269
13879,409000438620',2018-10-18,AEPS INCOME DT 10-17-2018,0.0,12456.86,22274053.12000006,2018,10,18,CASH_IN,12456.86,M309965122
13880,409000438620',2018-10-18,AEPS GST INC DT 10-17-201,0.0,2491.37,22276544.49000006,2018,10,18,CASH_IN,2491.37,M722973854
13881,409000438620',2018-10-18,AEPS ACQ REP ADJ FEES 171,0.0,17.7,22276562.19000006,2018,10,18,TRANSFER,17.7,C118648358
13882,409000438620',2018-10-18,TRF TO  Indiaforensic SERVICES I,4600000.0,0.0,17676562.19000006,2018,10,18,DEBIT,4600000.0,C872592585
13883,409000438620',2018-10-18,MAW/502964XXXXXX0270/NAGA,0.0,1700.0,17678262.19000006,2018,10,18,TRANSFER,1700.0,M1606649860
13884,409000438620',2018-10-19,MAW/502964XXXXXX0296/NAGA,0.0,1700.0,17679962.19000006,2018,10,19,CASH_IN,1700.0,M1657964719
13885,409000438620',2018-10-19,MAW/502964XXXXXX0821/NAGA,0.0,500.0,17680462.19000006,2018,10,19,CASH_IN,500.0,C1369695156
13886,409000438620',2018-10-19,Indiaforensic AEPS NPCI WDL SET,0.0,3405300.0,21085762.19000006,2018,10,19,TRANSFER,3405300.0,C1401721023
13887,409000438620',2018-10-19,MAW/502964XXXXXX0502/NAGA,0.0,1400.0,21087162.19000006,2018,10,19,CASH_IN,1400.0,C884262954
13888,409000438620',2018-10-19,MAW/502964XXXXXX9796/NAGA,0.0,1300.0,21088462.19000006,2018,10,19,TRANSFER,1300.0,C294900736
13889,409000438620',2018-10-19,AEPS INCOME DT 10-18-2018,0.0,9439.22,21097901.41000006,2018,10,19,CASH_IN,9439.22,M945565843
13890,409000438620',2018-10-19,AEPS GST INC DT 10-18-201,0.0,1887.84,21099789.25000006,2018,10,19,CASH_IN,1887.84,M1165368024
13891,409000438620',2018-10-19,AEPS PAY Indiaforensic 1810,0.0,1058.48,21100847.73000006,2018,10,19,CHECK_CASHING,1058.48,M1971037148
13892,409000438620',2018-10-19,AEPS PAY Indiaforensic 1710,0.0,299.23,21101146.96000006,2018,10,19,TRANSFER,299.23,M1437920189
13893,409000438620',2018-10-19,MICRO ATM WDL FEE DT17101,0.0,735800.0,21836946.96000006,2018,10,19,CASH_IN,735800.0,M122293642
13894,409000438620',2018-10-19,MICRO ATM INC DATED 17101,0.0,1822.32,21838769.28000006,2018,10,19,CHECK_CASHING,1822.32,M1496425222
13895,409000438620',2018-10-19,MICRO ATM GST DATED 17101,0.0,364.46,21839133.74000006,2018,10,19,TRANSFER,364.46,M413576446
13896,409000438620',2018-10-19,MICRO ATM WDL FEE DT18101,0.0,658400.0,22497533.74000006,2018,10,19,CHECK_CASHING,658400.0,C990355670
13897,409000438620',2018-10-19,MICRO ATM INC DATED 18101,0.0,1618.92,22499152.660000063,2018,10,19,CASH_IN,1618.92,M1153302684
13898,409000438620',2018-10-19,MICRO ATM GST DATED 18101,0.0,323.78,22499476.440000065,2018,10,19,CASH_IN,323.78,M377912543
13899,409000438620',2018-10-19,MICRO ATM WDL FEE DT18101,0.0,618600.0,23118076.440000065,2018,10,19,TRANSFER,618600.0,M1689095314
13900,409000438620',2018-10-19,MICRO ATM INC DATED 18101,0.0,1360.44,23119436.880000066,2018,10,19,CASH_IN,1360.44,M1021990173
13901,409000438620',2018-10-19,MICRO ATM GST DATED 18101,0.0,272.09,23119708.970000066,2018,10,19,CASH_IN,272.09,M2048999860
13902,409000438620',2018-10-19,TFR TO 1196428  Indiaforensic SE,3000000.0,0.0,20119708.970000066,2018,10,19,CHECK_WITHDRAWAL,3000000.0,M1893016790
13903,409000438620',2018-10-19,MICRO ATM WDL FEE DT19101,0.0,540400.0,20660108.970000066,2018,10,19,CHECK_CASHING,540400.0,M1993113223
13904,409000438620',2018-10-19,MICRO ATM INC DATED 19101,0.0,1123.92,20661232.890000068,2018,10,19,TRANSFER,1123.92,M2139762545
13905,409000438620',2018-10-19,MICRO ATM GST DATED 19101,0.0,224.78,20661457.67000007,2018,10,19,CASH_IN,224.78,M1764555378
13906,409000438620',2018-10-20,MAW/502964XXXXXX1963/NAGA,0.0,300.0,20661757.67000007,2018,10,20,TRANSFER,300.0,M1670388651
13907,409000438620',2018-10-20,Indiaforensic AEPS NPCI WDL SET,0.0,3363700.0,24025457.67000007,2018,10,20,CASH_IN,3363700.0,M491375510
13908,409000438620',2018-10-20,CR828815899935/RMCPL17167/1,5000.0,0.0,24020457.67000007,2018,10,20,CHECK_WITHDRAWAL,5000.0,C97730845
13909,409000438620',2018-10-20,CR828815900027/RMCPL26216/1,2000.0,0.0,24018457.67000007,2018,10,20,CASH_OUT,2000.0,C189963646
13910,409000438620',2018-10-20,CR828812852337/RMCPL07044/1,3000.0,0.0,24015457.67000007,2018,10,20,CASH_OUT,3000.0,M1274114436
13911,409000438620',2018-10-20,CR828812852283/RMCPL23966/1,4500.0,0.0,24010957.67000007,2018,10,20,CASH_OUT,4500.0,M1477528560
13912,409000438620',2018-10-20,CR828812852304/RMCPL15535/1,8000.0,0.0,24002957.67000007,2018,10,20,CHECK_WITHDRAWAL,8000.0,C904383922
13913,409000438620',2018-10-20,CR828812852272/RMCPL18061/1,1000.0,0.0,24001957.67000007,2018,10,20,DEBIT,1000.0,C423580937
13914,409000438620',2018-10-20,CR828812852291/RMCPL22431/1,2000.0,0.0,23999957.67000007,2018,10,20,CASH_OUT,2000.0,C453211571
13915,409000438620',2018-10-20,CR828813874844/RMCPL11131/1,500.0,0.0,23999457.67000007,2018,10,20,CASH_OUT,500.0,C1040847151
13916,409000438620',2018-10-20,CR828816902833/RMCPL09592/1,3500.0,0.0,23995957.67000007,2018,10,20,CHECK_WITHDRAWAL,3500.0,C1609562230
13917,409000438620',2018-10-20,CR828816903323/RMCPL22310/1,1000.0,0.0,23994957.67000007,2018,10,20,PAYEMENT,1000.0,C716083600
13918,409000438620',2018-10-20,CR828816914222/RMCPL11793/1,7000.0,0.0,23987957.67000007,2018,10,20,CASH_OUT,7000.0,C1013700132
13919,409000438620',2018-10-20,CR828816903494/RMCPL17359/1,1000.0,0.0,23986957.67000007,2018,10,20,CASH_OUT,1000.0,C1255024717
13920,409000438620',2018-10-20,CR828812850777/RMCPL17167/1,500.0,0.0,23986457.67000007,2018,10,20,CHECK_WITHDRAWAL,500.0,C1870252780
13921,409000438620',2018-10-20,CR828818947142/RMCPL15254/1,500.0,0.0,23985957.67000007,2018,10,20,CHECK_WITHDRAWAL,500.0,C1220897602
13922,409000438620',2018-10-20,CR828818947118/RMCPL23653/1,500.0,0.0,23985457.67000007,2018,10,20,CASH_OUT,500.0,C1870252780
13923,409000438620',2018-10-20,CR828818947202/RMCPL15670/1,500.0,0.0,23984957.67000007,2018,10,20,CHECK_WITHDRAWAL,500.0,C1065997164
13924,409000438620',2018-10-20,CR828816902623/RMCPL29325/1,2000.0,0.0,23982957.67000007,2018,10,20,PAYEMENT,2000.0,C439078113
13925,409000438620',2018-10-20,CR828816902613/RMCPL09612/1,500.0,0.0,23982457.67000007,2018,10,20,PAYEMENT,500.0,C1982828534
13926,409000438620',2018-10-20,CR828816902683/RMCPL11151/1,700.0,0.0,23981757.67000007,2018,10,20,DEBIT,700.0,C1475395523
13927,409000438620',2018-10-20,CR828815899130/RMCPL11131/1,500.0,0.0,23981257.67000007,2018,10,20,CHECK_WITHDRAWAL,500.0,C1635341595
13928,409000438620',2018-10-20,CR828815899072/RMCPL15254/1,1000.0,0.0,23980257.67000007,2018,10,20,DEBIT,1000.0,C935808590
13929,409000438620',2018-10-20,CR828815899114/RMCPL20068/1,1200.0,0.0,23979057.67000007,2018,10,20,CASH_OUT,1200.0,C214774813
13930,409000438620',2018-10-20,CR828815899617/RMCPL09592/1,1000.0,0.0,23978057.67000007,2018,10,20,CASH_OUT,1000.0,C1851192788
13931,409000438620',2018-10-20,CR828815899953/RMCPL15510/1,6000.0,0.0,23972057.67000007,2018,10,20,DEBIT,6000.0,M860090843
13932,409000438620',2018-10-20,CR829015369926/RMCPL21218/1,4000.0,0.0,23968057.67000007,2018,10,20,PAYEMENT,4000.0,M403831180
13933,409000438620',2018-10-20,CR829010308972/RMCPL21381/1,2000.0,0.0,23966057.67000007,2018,10,20,CHECK_WITHDRAWAL,2000.0,M1979106942
13934,409000438620',2018-10-20,CR829010308898/RMCPL20241/1,1000.0,0.0,23965057.67000007,2018,10,20,PAYEMENT,1000.0,C892686452
13935,409000438620',2018-10-20,TRF TO  Indiaforensic SERVICES I,1000000.0,0.0,22965057.67000007,2018,10,20,CHECK_WITHDRAWAL,1000000.0,M2057000626
13936,409000438620',2018-10-20,TRF TO  Indiaforensic SERVICES I,1000000.0,0.0,21965057.67000007,2018,10,20,PAYEMENT,1000000.0,M1757283448
13937,409000438620',2018-10-20,TRF TO  Indiaforensic SERVICES I,1000000.0,0.0,20965057.67000007,2018,10,20,PAYEMENT,1000000.0,M1555117379
13938,409000438620',2018-10-20,NPCI SETELEMENT DIFF_1910,0.0,1000.0,20966057.67000007,2018,10,20,CASH_IN,1000.0,M279464999
13939,409000438620',2018-10-20,TRF TO  Indiaforensic SERVICES I,2000000.0,0.0,18966057.67000007,2018,10,20,CASH_OUT,2000000.0,M1196299006
13940,409000438620',2018-10-20,TRF TO  Indiaforensic SERVICES I,1000000.0,0.0,17966057.67000007,2018,10,20,PAYEMENT,1000000.0,M1966919370
13941,409000438620',2018-10-20,MICRO ATM WDL FEE DT19101,0.0,174200.0,18140257.67000007,2018,10,20,CHECK_CASHING,174200.0,C408304912
13942,409000438620',2018-10-20,MICRO ATM INC DATED 19101,0.0,387.0,18140644.67000007,2018,10,20,TRANSFER,387.0,M1308098072
13943,409000438620',2018-10-20,MICRO ATM GST DATED 19101,0.0,77.4,18140722.070000067,2018,10,20,CASH_IN,77.4,M1914678708
13944,409000438620',2018-10-20,AEPS PAY Indiaforensic 1910,0.0,499.4,18141221.470000066,2018,10,20,TRANSFER,499.4,M1783432149
13945,409000438620',2018-10-20,AEPS INCOME DT 10-19-2018,0.0,9124.69,18150346.160000067,2018,10,20,TRANSFER,9124.69,M1252981710
13946,409000438620',2018-10-20,AEPS GST INC DT 10-19-201,0.0,1824.94,18152171.10000007,2018,10,20,CASH_IN,1824.94,M298940152
13947,409000438620',2018-10-20,AEPS ACQCR ADJ FEES 19101,256.06,0.0,18151915.04000007,2018,10,20,CHECK_WITHDRAWAL,256.06,C814900611
13948,409000438620',2018-10-20,MICRO ATM WDL FEE DT20101,0.0,447400.0,18599315.04000007,2018,10,20,TRANSFER,447400.0,M1652589261
13949,409000438620',2018-10-20,MICRO ATM INC DATED 20101,0.0,979.56,18600294.60000007,2018,10,20,CHECK_CASHING,979.56,M1573600842
13950,409000438620',2018-10-20,MICRO ATM GST DATED 20101,0.0,195.91,18600490.51000007,2018,10,20,TRANSFER,195.91,M1283526188
13951,409000438620',2018-10-22,MAW/502964XXXXXX2291/Karu,0.0,700.0,18601190.51000007,2018,10,22,CASH_IN,700.0,M1387042399
13952,409000438620',2018-10-22,Indiaforensic AEPS NPCI WDL SET,0.0,3400700.0,22001890.51000007,2018,10,22,CASH_IN,3400700.0,M938608826
13953,409000438620',2018-10-22,Indiaforensic AEPS NPCI WDL SET,0.0,2355300.0,24357190.51000007,2018,10,22,CHECK_CASHING,2355300.0,M1498328115
13954,409000438620',2018-10-22,TRF TO  Indiaforensic SERVICES I,5000000.0,0.0,19357190.51000007,2018,10,22,DEBIT,5000000.0,M966480161
13955,409000438620',2018-10-22,TRF TO  Indiaforensic SERVICES I,1000000.0,0.0,18357190.51000007,2018,10,22,CASH_OUT,1000000.0,C1450828900
13956,409000438620',2018-10-22,TRF TO  Indiaforensic SERVICES I,500000.0,0.0,17857190.51000007,2018,10,22,DEBIT,500000.0,M185129701
13957,409000438620',2018-10-22,MICRO ATM WDL FEE DT21101,0.0,1351700.0,19208890.51000007,2018,10,22,TRANSFER,1351700.0,M1352147528
13958,409000438620',2018-10-22,MICRO ATM INC DATED 21101,0.0,2840.4,19211730.910000067,2018,10,22,CASH_IN,2840.4,C557041912
13959,409000438620',2018-10-22,MICRO ATM GST DATED 21101,0.0,568.08,19212298.990000065,2018,10,22,CASH_IN,568.08,M893293020
13960,409000438620',2018-10-22,MICRO ATM WDL FEE DT22101,0.0,551800.0,19764098.990000065,2018,10,22,TRANSFER,551800.0,M1306906931
13961,409000438620',2018-10-22,MICRO ATM INC DATED 22101,0.0,1300.68,19765399.670000065,2018,10,22,CHECK_CASHING,1300.68,M967767224
13962,409000438620',2018-10-22,MICRO ATM GST DATED 22101,0.0,260.14,19765659.810000066,2018,10,22,CHECK_CASHING,260.14,M1433528462
13963,409000438620',2018-10-22,AEPS PAY Indiaforensic 2010,0.0,99.64,19765759.450000066,2018,10,22,TRANSFER,99.64,M448397927
13964,409000438620',2018-10-22,AEPS PAY Indiaforensic 2110,0.0,199.58,19765959.030000065,2018,10,22,CASH_IN,199.58,M3277781
13965,409000438620',2018-10-22,TRF TO  Indiaforensic SERVICES I,1500000.0,0.0,18265959.030000065,2018,10,22,DEBIT,1500000.0,M1740134102
13966,409000438620',2018-10-22,AEPS INCOME DT 10-20-2018,0.0,9437.2,18275396.230000064,2018,10,22,TRANSFER,9437.2,C824197891
13967,409000438620',2018-10-22,AEPS GST INC DT 10-20-201,0.0,1887.44,18277283.670000065,2018,10,22,CASH_IN,1887.44,M871088597
13968,409000438620',2018-10-22,AEPS INCOME DT 10-21-2018,0.0,6509.4,18283793.070000064,2018,10,22,CASH_IN,6509.4,M812522402
13969,409000438620',2018-10-22,AEPS GST INC DT 10-21-201,0.0,1301.88,18285094.950000066,2018,10,22,CASH_IN,1301.88,M258701657
13970,409000438620',2018-10-22,AEPS ACQUIRING ADJ FEES 2,23.6,0.0,18285071.35000006,2018,10,22,CHECK_WITHDRAWAL,23.6,C97730845
13971,409000438620',2018-10-22,TRF TO  Indiaforensic SERVICES I,500000.0,0.0,17785071.35000006,2018,10,22,DEBIT,500000.0,M635438204
13972,409000438620',2018-10-22,MICRO ATM WDL FEE DT20101,0.0,584400.0,18369471.35000006,2018,10,22,CHECK_CASHING,584400.0,M1813423098
13973,409000438620',2018-10-22,MICRO ATM INC DATED 20101,0.0,1258.92,18370730.270000067,2018,10,22,CASH_IN,1258.92,M159394830
13974,409000438620',2018-10-22,MICRO ATM GST DATED 20101,0.0,251.78,18370982.050000064,2018,10,22,TRANSFER,251.78,M161290710
13975,409000438620',2018-10-23,Indiaforensic AEPS NPCI WDL SET,0.0,4575100.0,22946082.050000064,2018,10,23,CASH_IN,4575100.0,M494890689
13976,409000438620',2018-10-23,AEPS ACQ CR829217854200/R,600.0,0.0,22945482.050000064,2018,10,23,CHECK_WITHDRAWAL,600.0,M1198607830
13977,409000438620',2018-10-23,AEPS ACQ CR829211771491/R,5000.0,0.0,22940482.050000064,2018,10,23,DEBIT,5000.0,C1991252420
13978,409000438620',2018-10-23,AEPS ACQ CR829111561309/R,2000.0,0.0,22938482.050000064,2018,10,23,PAYEMENT,2000.0,M826313713
13979,409000438620',2018-10-23,AEPS ACQ CR829113586407/R,500.0,0.0,22937982.050000064,2018,10,23,DEBIT,500.0,M1946738978
13980,409000438620',2018-10-23,TRF TO  Indiaforensic SERVICES I,5200000.0,0.0,17737982.050000064,2018,10,23,DEBIT,5200000.0,M1423639169
13981,409000438620',2018-10-23,MICRO ATM WDL FEE DT22101,0.0,806200.0,18544182.050000064,2018,10,23,CHECK_CASHING,806200.0,M149683647
13982,409000438620',2018-10-23,MICRO ATM INC DATED 22101,0.0,1871.64,18546053.690000065,2018,10,23,CHECK_CASHING,1871.64,M1830960306
13983,409000438620',2018-10-23,MICRO ATM GST DATED 22101,0.0,374.33,18546428.020000067,2018,10,23,CASH_IN,374.33,M1233754706
13984,409000438620',2018-10-23,NPCI_SETT_DIFF_221018,0.0,3000.0,18549428.020000067,2018,10,23,TRANSFER,3000.0,C824197891
13985,409000438620',2018-10-23,TRF TO  Indiaforensic SERVICES I,800000.0,0.0,17749428.020000067,2018,10,23,CHECK_WITHDRAWAL,800000.0,M21391379
13986,409000438620',2018-10-23,AEPS INCOME DT 10-22-2018,0.0,12013.53,17761441.550000064,2018,10,23,CHECK_CASHING,12013.53,M1465410948
13987,409000438620',2018-10-23,AEPS GST INC DT 10-22-201,0.0,2402.71,17763844.260000065,2018,10,23,TRANSFER,2402.71,M290431579
13988,409000438620',2018-10-23,AEPS ACQ CR ADJ FEES 2210,35.95,0.0,17763808.310000066,2018,10,23,DEBIT,35.95,C1673971173
13989,409000438620',2018-10-23,MICRO ATM WDL FEE DT23101,0.0,340300.0,18104108.310000066,2018,10,23,TRANSFER,340300.0,M960324818
13990,409000438620',2018-10-23,MICRO ATM INC DATED 23101,0.0,892.08,18105000.390000064,2018,10,23,CASH_IN,892.08,C849038219
13991,409000438620',2018-10-23,MICRO ATM GST DATED 23101,0.0,178.42,18105178.810000066,2018,10,23,TRANSFER,178.42,M1076037183
13992,409000438620',2018-10-24,Indiaforensic AEPS NPCI WDL SET,0.0,4185100.0,22290278.810000066,2018,10,24,CHECK_CASHING,4185100.0,M636992880
13993,409000438620',2018-10-24,CR829312010258/RMCPL17167/2,5000.0,0.0,22285278.810000066,2018,10,24,CASH_OUT,5000.0,M1624949878
13994,409000438620',2018-10-24,TRF TO  Indiaforensic SERVICES I,4600000.0,0.0,17685278.810000066,2018,10,24,CASH_OUT,4600000.0,M1031345803
13995,409000438620',2018-10-24,NPCI_SETT_DIFF_231018,0.0,2000.0,17687278.810000066,2018,10,24,CASH_IN,2000.0,C189963646
13996,409000438620',2018-10-24,MICRO ATM WDL FEE DT23101,0.0,448100.0,18135378.810000066,2018,10,24,CHECK_CASHING,448100.0,M2118675919
13997,409000438620',2018-10-24,MICRO ATM INC DATED 23101,0.0,1073.16,18136451.970000066,2018,10,24,TRANSFER,1073.16,M1693375200
13998,409000438620',2018-10-24,MICRO ATM GST DATED 23101,0.0,214.63,18136666.600000065,2018,10,24,CHECK_CASHING,214.63,M2088911339
13999,409000438620',2018-10-24,AEPS INCOME DT 10-23-2018,0.0,11181.27,18147847.870000064,2018,10,24,CASH_IN,11181.27,M1650177125
14000,409000438620',2018-10-24,AEPS GST INC DT 10-23-201,0.0,2236.25,18150084.120000064,2018,10,24,CHECK_CASHING,2236.25,M108728999
14001,409000438620',2018-10-24,AEPS ACQUIRING ADJ FEES 2,11.8,0.0,18150072.320000064,2018,10,24,DEBIT,11.8,M1274315527
14002,409000438620',2018-10-24,AEPS ACQ CR ADJ FEES 2310,17.7,0.0,18150054.620000064,2018,10,24,CASH_OUT,17.7,M959097834
14003,409000438620',2018-10-24,TRF TO  Indiaforensic SERVICES I,400000.0,0.0,17750054.620000064,2018,10,24,PAYEMENT,400000.0,M1027223781
14004,409000438620',2018-10-24,MICRO ATM WDL FEE DT24101,0.0,349500.0,18099554.620000064,2018,10,24,TRANSFER,349500.0,C1284149862
14005,409000438620',2018-10-24,MICRO ATM INC DATED 24101,0.0,868.68,18100423.300000064,2018,10,24,CASH_IN,868.68,M2094607620
14006,409000438620',2018-10-24,MICRO ATM GST DATED 24101,0.0,173.74,18100597.040000066,2018,10,24,CHECK_CASHING,173.74,C1459693562
14007,409000438620',2018-10-25,AEPS PAY Indiaforensic 2310,0.0,798.94,18101395.980000064,2018,10,25,CASH_IN,798.94,M818475287
14008,409000438620',2018-10-25,Indiaforensic AEPS NPCI WDL SET,0.0,3534500.0,21635895.980000064,2018,10,25,TRANSFER,3534500.0,C33574809
14009,409000438620',2018-10-25,TRF TO  Indiaforensic SERVICES I,3900000.0,0.0,17735895.980000064,2018,10,25,CASH_OUT,3900000.0,C79467401
14010,409000438620',2018-10-25,AEPS PAY Indiaforensic 2410,0.0,100.64,17735996.620000064,2018,10,25,CHECK_CASHING,100.64,C540629758
14011,409000438620',2018-10-25,MICRO ATM WDL FEE DT25101,0.0,315600.0,18051596.620000064,2018,10,25,CASH_IN,315600.0,M1233147305
14012,409000438620',2018-10-25,MICRO ATM INC DATED 25101,0.0,802.08,18052398.700000066,2018,10,25,CASH_IN,802.08,C1847521348
14013,409000438620',2018-10-25,MICRO ATM GST DATED 25101,0.0,160.42,18052559.120000064,2018,10,25,TRANSFER,160.42,M212870051
14014,409000438620',2018-10-25,AEPS INCOME DT 10-24-2018,0.0,9573.35,18062132.470000066,2018,10,25,CHECK_CASHING,9573.35,M1506022540
14015,409000438620',2018-10-25,AEPS GST INC DT 10-24-201,0.0,1914.67,18064047.140000068,2018,10,25,CHECK_CASHING,1914.67,C1740764606
14016,409000438620',2018-10-25,MICRO ATM WDL FEE DT24101,0.0,485400.0,18549447.140000068,2018,10,25,CASH_IN,485400.0,M2118642581
14017,409000438620',2018-10-25,MICRO ATM INC DATED 24101,0.0,1119.96,18550567.10000007,2018,10,25,TRANSFER,1119.96,M314095560
14018,409000438620',2018-10-25,MICRO ATM GST DATED 24101,0.0,223.99,18550791.090000067,2018,10,25,CASH_IN,223.99,M1327349011
14019,409000438620',2018-10-25,TRF TO  Indiaforensic SERVICES I,400000.0,0.0,18150791.090000067,2018,10,25,CASH_OUT,400000.0,C518953848
14020,409000438620',2018-10-26,Indiaforensic AEPS NPCI WDL SET,0.0,3530700.0,21681491.090000067,2018,10,26,TRANSFER,3530700.0,M1504814937
14021,409000438620',2018-10-26,CR829611694306/RMCPL11776/2,3500.0,0.0,21677991.090000067,2018,10,26,DEBIT,3500.0,C1429623854
14022,409000438620',2018-10-26,CR829611694329/RMCPL27488/2,2000.0,0.0,21675991.090000067,2018,10,26,CASH_OUT,2000.0,M593081598
14023,409000438620',2018-10-26,CR829611695242/RMCPL22963/2,1000.0,0.0,21674991.090000067,2018,10,26,DEBIT,1000.0,C1825389809
14024,409000438620',2018-10-26,CR829611695338/RMCPL23821/2,2000.0,0.0,21672991.090000067,2018,10,26,CASH_OUT,2000.0,M2069836478
14025,409000438620',2018-10-26,CR829616794851/RMCPL22278/2,1000.0,0.0,21671991.090000067,2018,10,26,PAYEMENT,1000.0,M1353316905
14026,409000438620',2018-10-26,MAW/502964XXXXXX2908/NAGA,0.0,1700.0,21673691.090000067,2018,10,26,TRANSFER,1700.0,C1730964371
14027,409000438620',2018-10-26,MAW/502964XXXXXX7298/NAGA,0.0,1700.0,21675391.090000067,2018,10,26,CASH_IN,1700.0,C329829198
14028,409000438620',2018-10-26,TRF TO  Indiaforensic SERVICES I,4000000.0,0.0,17675391.090000067,2018,10,26,CASH_OUT,4000000.0,C1052170153
14029,409000438620',2018-10-26,MICRO ATM WDL FEE DT25101,0.0,600700.0,18276091.090000067,2018,10,26,CHECK_CASHING,600700.0,C1778300121
14030,409000438620',2018-10-26,MICRO ATM INC DATED 25101,0.0,1510.2,18277601.290000066,2018,10,26,TRANSFER,1510.2,C1452722471
14031,409000438620',2018-10-26,MICRO ATM GST DATED 25101,0.0,302.04,18277903.330000065,2018,10,26,TRANSFER,302.04,C99509209
14032,409000438620',2018-10-26,MAW/502964XXXXXX8690/NAGA,0.0,1700.0,18279603.330000065,2018,10,26,TRANSFER,1700.0,C1269336757
14033,409000438620',2018-10-26,MAW/502964XXXXXX6850/NAGA,0.0,1700.0,18281303.330000065,2018,10,26,CHECK_CASHING,1700.0,C323302928
14034,409000438620',2018-10-26,MICRO ATM WDL FEE DT26101,0.0,265800.0,18547103.330000065,2018,10,26,CASH_IN,265800.0,C875917495
14035,409000438620',2018-10-26,MICRO ATM INC DATED 26101,0.0,676.8,18547780.130000066,2018,10,26,TRANSFER,676.8,M451291617
14036,409000438620',2018-10-26,MICRO ATM GST DATED 26101,0.0,135.36,18547915.490000065,2018,10,26,CASH_IN,135.36,C911380925
14037,409000438620',2018-10-26,AEPS INCOME DT 10-25-2018,0.0,9467.25,18557382.740000065,2018,10,26,TRANSFER,9467.25,C736709391
14038,409000438620',2018-10-26,AEPS GST INC DT 10-25-201,0.0,1893.45,18559276.190000065,2018,10,26,CHECK_CASHING,1893.45,C653745564
14039,409000438620',2018-10-26,AEPS ACQ CR ADJ FEES 2510,53.1,0.0,18559223.090000063,2018,10,26,DEBIT,53.1,C577924039
14040,409000438620',2018-10-26,AEPS ACQ REP ADJ FEES 251,0.0,23.6,18559246.690000065,2018,10,26,CHECK_CASHING,23.6,M1527292961
14041,409000438620',2018-10-26,TRF TO  Indiaforensic SERVICES I,800000.0,0.0,17759246.690000065,2018,10,26,PAYEMENT,800000.0,C1013700132
14042,409000438620',2018-10-27,MAW/502964XXXXXX8561/Ujja,0.0,2000.0,17761246.690000065,2018,10,27,CHECK_CASHING,2000.0,C1626288305
14043,409000438620',2018-10-27,MAW/502964XXXXXX8561/Ujja,0.0,1500.0,17762746.690000065,2018,10,27,TRANSFER,1500.0,M1753385035
14044,409000438620',2018-10-27,MAW/502964XXXXXX2138/NAGA,0.0,1700.0,17764446.690000065,2018,10,27,CASH_IN,1700.0,C1616972331
14045,409000438620',2018-10-27,MAW/502964XXXXXX7563/NAGA,0.0,1700.0,17766146.690000065,2018,10,27,CHECK_CASHING,1700.0,M63578078
14046,409000438620',2018-10-29,Indiaforensic AEPS NPCI WDL SET,0.0,3776600.0,21542746.690000065,2018,10,29,CASH_IN,3776600.0,C323761934
14047,409000438620',2018-10-29,Indiaforensic AEPS NPCI WDL SET,0.0,3401900.0,24944646.690000065,2018,10,29,TRANSFER,3401900.0,M1058760957
14048,409000438620',2018-10-29,Indiaforensic AEPS NPCI WDL SET,0.0,1941600.0,26886246.690000065,2018,10,29,TRANSFER,1941600.0,C30516998
14049,409000438620',2018-10-29,CR829713053791/RMCPL21038/2,500.0,0.0,26885746.690000065,2018,10,29,CHECK_WITHDRAWAL,500.0,C1856036778
14050,409000438620',2018-10-29,TRF TO  Indiaforensic SERVICES I,9200000.0,0.0,17685746.690000065,2018,10,29,DEBIT,9200000.0,C991505714
14051,409000438620',2018-10-29,MICRO ATM WDL FEE DT26101,0.0,835400.0,18521146.690000065,2018,10,29,CASH_IN,835400.0,C1327907419
14052,409000438620',2018-10-29,MICRO ATM INC DATED 26101,0.0,1638.36,18522785.050000064,2018,10,29,CHECK_CASHING,1638.36,C1034584766
14053,409000438620',2018-10-29,MICRO ATM GST DATED 26101,0.0,327.67,18523112.720000066,2018,10,29,CASH_IN,327.67,C1303868418
14054,409000438620',2018-10-29,MICRO ATM WDL FEE DT27101,0.0,915000.0,19438112.720000066,2018,10,29,CASH_IN,915000.0,C1321139761
14055,409000438620',2018-10-29,MICRO ATM INC DATED 27101,0.0,2082.96,19440195.680000067,2018,10,29,CASH_IN,2082.96,C977993101
14056,409000438620',2018-10-29,MICRO ATM GST DATED 27101,0.0,416.59,19440612.270000067,2018,10,29,CHECK_CASHING,416.59,C248609774
14057,409000438620',2018-10-29,MICRO ATM WDL FEE DT28101,0.0,848100.0,20288712.270000067,2018,10,29,TRANSFER,848100.0,C667504652
14058,409000438620',2018-10-29,MICRO ATM INC DATED 28101,0.0,1997.28,20290709.550000068,2018,10,29,CASH_IN,1997.28,C2100990049
14059,409000438620',2018-10-29,MICRO ATM GST DATED 28101,0.0,399.46,20291109.01000007,2018,10,29,CHECK_CASHING,399.46,C1424731356
14060,409000438620',2018-10-29,TRF TO  Indiaforensic SERVICES I,800000.0,0.0,19491109.01000007,2018,10,29,DEBIT,800000.0,C1076835071
14061,409000438620',2018-10-29,AEPS PAY Indiaforensic 2610,0.0,322.51,19491431.52000007,2018,10,29,TRANSFER,322.51,C1849933855
14062,409000438620',2018-10-29,MICRO ATM WDL FEE DT29101,0.0,409700.0,19901131.52000007,2018,10,29,CHECK_CASHING,409700.0,C437747500
14063,409000438620',2018-10-29,MICRO ATM INC DATED 29101,0.0,927.0,19902058.52000007,2018,10,29,CASH_IN,927.0,C2127862399
14064,409000438620',2018-10-29,MICRO ATM GST DATED 29101,0.0,185.4,19902243.92000007,2018,10,29,CASH_IN,185.4,C1870107004
14065,409000438620',2018-10-29,NPCI SETELEMENT DIFF_2610,0.0,3000.0,19905243.92000007,2018,10,29,CASH_IN,3000.0,C1427398085
14066,409000438620',2018-10-29,AEPS INCOME DT 10-28-2018,0.0,5296.37,19910540.29000007,2018,10,29,CHECK_CASHING,5296.37,C1178471274
14067,409000438620',2018-10-29,AEPS GST INC DT 10-28-201,0.0,1059.27,19911599.56000007,2018,10,29,CASH_IN,1059.27,C1379289710
14068,409000438620',2018-10-29,AEPS INCOME DT 10-27-2018,0.0,9253.78,19920853.34000007,2018,10,29,CASH_IN,9253.78,C1435804085
14069,409000438620',2018-10-29,AEPS GST INC DT 10-27-201,0.0,1850.76,19922704.100000072,2018,10,29,CASH_IN,1850.76,M1215631518
14070,409000438620',2018-10-29,AEPS INCOME DT 10-28-2018,0.0,5296.37,19928000.470000073,2018,10,29,CHECK_CASHING,5296.37,M596287936
14071,409000438620',2018-10-29,AEPS GST INC DT 10-28-201,0.0,1059.27,19929059.74000008,2018,10,29,CASH_IN,1059.27,M413188388
14072,409000438620',2018-10-29,AEPS ACQUIRING ADJ FEES 2,17.7,0.0,19929042.040000074,2018,10,29,PAYEMENT,17.7,M1282927444
14073,409000438620',2018-10-29,AEPS ACQ CR ADJ FEES 2610,2.95,0.0,19929039.090000074,2018,10,29,DEBIT,2.95,M612223269
14074,409000438620',2018-10-29,AEPS ACQ REP ADJ FEES 261,0.0,11.8,19929050.890000075,2018,10,29,CASH_IN,11.8,C1031639563
14075,409000438620',2018-10-30,TRF TO  Indiaforensic SERVICES I,2000000.0,0.0,17929050.890000075,2018,10,30,DEBIT,2000000.0,M761805613
14076,409000438620',2018-10-30,Indiaforensic AEPS NPCI WDL SET,0.0,2707300.0,20636350.890000075,2018,10,30,TRANSFER,2707300.0,M1756320522
14077,409000438620',2018-10-30,TRF TO  Indiaforensic SERVICES I,2900000.0,0.0,17736350.890000075,2018,10,30,DEBIT,2900000.0,M194339335
14078,409000438620',2018-10-30,MICRO ATM WDL FEE DT29101,0.0,518100.0,18254450.890000075,2018,10,30,CHECK_CASHING,518100.0,M1236061074
14079,409000438620',2018-10-30,MICRO ATM INC DATED 29101,0.0,1211.4,18255662.290000074,2018,10,30,CHECK_CASHING,1211.4,M1250308146
14080,409000438620',2018-10-30,MICRO ATM GST DATED 29101,0.0,242.28,18255904.570000075,2018,10,30,CASH_IN,242.28,M1910739874
14081,409000438620',2018-10-30,AEPS PAY Indiaforensic 2910,0.0,389.46,18256294.03000008,2018,10,30,TRANSFER,389.46,M2144907913
14082,409000438620',2018-10-30,MAW/502964XXXXXX8534/NAGA,0.0,1700.0,18257994.03000008,2018,10,30,CASH_IN,1700.0,M768977588
14083,409000438620',2018-10-30,MICRO ATM WDL FEE DT30101,0.0,443900.0,18701894.03000008,2018,10,30,TRANSFER,443900.0,C2096057945
14084,409000438620',2018-10-30,MICRO ATM INC DATED 30101,0.0,1144.8,18703038.83000008,2018,10,30,TRANSFER,1144.8,M1095202555
14085,409000438620',2018-10-30,MICRO ATM GST DATED 30101,0.0,228.96,18703267.79000008,2018,10,30,TRANSFER,228.96,C903028779
14086,409000438620',2018-10-30,TRF TO  Indiaforensic SERVICES I,500000.0,0.0,18203267.79000008,2018,10,30,PAYEMENT,500000.0,M1308915611
14087,409000438620',2018-10-30,AEPS INCOME DT 10-29-2018,0.0,7062.81,18210330.60000008,2018,10,30,CHECK_CASHING,7062.81,M1251237486
14088,409000438620',2018-10-30,AEPS GST INC DT 10-29-201,0.0,1412.56,18211743.160000075,2018,10,30,CASH_IN,1412.56,M1994063118
14089,409000438620',2018-10-30,AEPS ACQUIRING ADJ FEES 2,23.6,0.0,18211719.560000073,2018,10,30,DEBIT,23.6,C703957828
14090,409000438620',2018-10-30,TRF TO  Indiaforensic SERVICES I,500000.0,0.0,17711719.560000073,2018,10,30,DEBIT,500000.0,C2116802101
14091,409000438620',2018-10-31,Indiaforensic AEPS NPCI WDL SET,0.0,3197500.0,20909219.560000073,2018,10,31,CASH_IN,3197500.0,M506209748
14092,409000438620',2018-10-31,CR829807190201/RMCPL23087/2,1000.0,0.0,20908219.560000073,2018,10,31,PAYEMENT,1000.0,C300836639
14093,409000438620',2018-10-31,CR829817299129/RMCPL14928/2,500.0,0.0,20907719.560000073,2018,10,31,CHECK_WITHDRAWAL,500.0,C755355682
14094,409000438620',2018-10-31,CR829816296206/RMCPL16567/2,1000.0,0.0,20906719.560000073,2018,10,31,DEBIT,1000.0,M816106367
14095,409000438620',2018-10-31,CR829811229575/RMCPL19120/2,3000.0,0.0,20903719.560000073,2018,10,31,PAYEMENT,3000.0,M27138712
14096,409000438620',2018-10-31,MICRO ATM WDL FEE DT30101,0.0,575900.0,21479619.560000073,2018,10,31,CASH_IN,575900.0,C1219248641
14097,409000438620',2018-10-31,MICRO ATM INC DATED 30101,0.0,1304.64,21480924.200000074,2018,10,31,TRANSFER,1304.64,M1472181959
14098,409000438620',2018-10-31,MICRO ATM GST DATED 30101,0.0,260.93,21481185.130000073,2018,10,31,CASH_IN,260.93,C2029310301
14099,409000438620',2018-10-31,TRF TO  Indiaforensic SERVICES I,3200000.0,0.0,18281185.130000073,2018,10,31,CHECK_WITHDRAWAL,3200000.0,C1730752455
14100,409000438620',2018-10-31,AEPS PAY Indiaforensic 3010,0.0,219.57,18281404.700000074,2018,10,31,TRANSFER,219.57,C1951379728
14101,409000438620',2018-10-31,AEPS INCOME DT 10-30-2018,0.0,7889.27,18289293.970000073,2018,10,31,CHECK_CASHING,7889.27,M1393603109
14102,409000438620',2018-10-31,AEPS GST INC DT 10-30-201,0.0,1577.85,18290871.820000075,2018,10,31,CASH_IN,1577.85,M378546236
14103,409000438620',2018-10-31,AEPS INCOME DT 10-26-2018,0.0,10005.82,18300877.640000075,2018,10,31,TRANSFER,10005.82,M402331978
14104,409000438620',2018-10-31,AEPS GST INC DT 10-26-201,0.0,2001.16,18302878.800000075,2018,10,31,CHECK_CASHING,2001.16,C614438306
14105,409000438620',2018-10-31,REV AEPS INC DT 28-10-201,5296.37,0.0,18297582.430000074,2018,10,31,PAYEMENT,5296.37,C728526866
14106,409000438620',2018-10-31,REV AEPS GST INC DT 28101,1059.27,0.0,18296523.160000075,2018,10,31,DEBIT,1059.27,M1920137262
14107,409000438620',2018-10-31,AEPS ACQ CR ADJ FEES 3010,32.45,0.0,18296490.710000075,2018,10,31,CHECK_WITHDRAWAL,32.45,M1440170654
14108,409000438620',2018-10-31,MICRO ATM WDL FEE DT31101,0.0,278200.0,18574690.710000075,2018,10,31,CASH_IN,278200.0,C539058198
14109,409000438620',2018-10-31,MICRO ATM INC DATED 31101,0.0,652.32,18575343.03000008,2018,10,31,CASH_IN,652.32,M385538136
14110,409000438620',2018-10-31,MICRO ATM GST DATED 31101,0.0,130.46,18575473.49000008,2018,10,31,CASH_IN,130.46,C1128830640
14111,409000438620',2018-10-31,TRF TO  Indiaforensic SERVICES I,900000.0,0.0,17675473.490000077,2018,10,31,DEBIT,900000.0,C257999182
14112,409000438620',2018-11-01,Indiaforensic AEPS NPCI WDL SET,0.0,2956100.0,20631573.49000008,2018,11,1,CASH_IN,2956100.0,C1255024717
14113,409000438620',2018-11-01,TRF TO  Indiaforensic SERVICES I,2900000.0,0.0,17731573.490000077,2018,11,1,CASH_OUT,2900000.0,C1359484306
14114,409000438620',2018-11-01,MICRO ATM WDL FEE DT31101,0.0,500300.0,18231873.49000008,2018,11,1,CHECK_CASHING,500300.0,C451111351
14115,409000438620',2018-11-01,MICRO ATM INC DATED 31101,0.0,1154.88,18233028.37000008,2018,11,1,CASH_IN,1154.88,C1060041730
14116,409000438620',2018-11-01,MICRO ATM GST DATED 31101,0.0,230.98,18233259.35000008,2018,11,1,CHECK_CASHING,230.98,C214774813
14117,409000438620',2018-11-01,AEPS INCOME DT 10-31-2018,0.0,7515.92,18240775.27000008,2018,11,1,TRANSFER,7515.92,C1369695156
14118,409000438620',2018-11-01,AEPS GST INC DT 10-31-201,0.0,1503.18,18242278.45000008,2018,11,1,TRANSFER,1503.18,C1231842708
14119,409000438620',2018-11-01,AEPS ACQ REP ADJ FEES 311,0.0,17.7,18242296.15000008,2018,11,1,TRANSFER,17.7,C1778801068
14120,409000438620',2018-11-01,AEPS PAY Indiaforensic 3110,0.0,499.4,18242795.550000075,2018,11,1,CASH_IN,499.4,C1373467808
14121,409000438620',2018-11-01,TRF TO  Indiaforensic SERVICES I,500000.0,0.0,17742795.550000075,2018,11,1,CHECK_WITHDRAWAL,500000.0,C2120528456
14122,409000438620',2018-11-01,MICRO ATM WDL FEE DT01111,0.0,425900.0,18168695.550000075,2018,11,1,TRANSFER,425900.0,C1065997164
14123,409000438620',2018-11-01,MICRO ATM INC DATED 01111,0.0,973.08,18169668.630000073,2018,11,1,CASH_IN,973.08,C1103621993
14124,409000438620',2018-11-01,MICRO ATM GST DATED 01111,0.0,194.62,18169863.250000075,2018,11,1,CHECK_CASHING,194.62,C875761527
14125,409000438620',2018-11-02,MAW/502964XXXXXX0502/NAGA,0.0,900.0,18170763.250000075,2018,11,2,CHECK_CASHING,900.0,C158876320
14126,409000438620',2018-11-02,Indiaforensic AEPS NPCI WDL SET,0.0,3012900.0,21183663.250000075,2018,11,2,CASH_IN,3012900.0,C1145835418
14127,409000438620',2018-11-02,TRF TO  Indiaforensic SERVICES I,3500000.0,0.0,17683663.250000075,2018,11,2,DEBIT,3500000.0,C2083562754
14128,409000438620',2018-11-02,MICRO ATM WDL FEE DT01111,0.0,520500.0,18204163.250000075,2018,11,2,CASH_IN,520500.0,C755583709
14129,409000438620',2018-11-02,MICRO ATM INC DATED 01111,0.0,1145.52,18205308.770000074,2018,11,2,CASH_IN,1145.52,M1027811708
14130,409000438620',2018-11-02,MICRO ATM GST DATED 01111,0.0,229.1,18205537.87000008,2018,11,2,CASH_IN,229.1,C641009714
14131,409000438620',2018-11-02,CR830017727003/RMCPL21565/2,2000.0,0.0,18203537.87000008,2018,11,2,CHECK_WITHDRAWAL,2000.0,M1040354359
14132,409000438620',2018-11-02,CR830007599383/RMCPL29003/2,2100.0,0.0,18201437.87000008,2018,11,2,CHECK_WITHDRAWAL,2100.0,M2119209199
14133,409000438620',2018-11-02,CR829909413388/RMCPL25068/2,10000.0,0.0,18191437.87000008,2018,11,2,CHECK_WITHDRAWAL,10000.0,M958613130
14134,409000438620',2018-11-02,CR829912452158/RMCPL21642/2,500.0,0.0,18190937.87000008,2018,11,2,DEBIT,500.0,C1491679067
14135,409000438620',2018-11-02,CR829911434417/RMCPL20759/2,1500.0,0.0,18189437.87000008,2018,11,2,DEBIT,1500.0,M1747747251
14136,409000438620',2018-11-02,CR830217112486/RMCPL15513/2,800.0,0.0,18188637.87000008,2018,11,2,CASH_OUT,800.0,C2028191421
14137,409000438620',2018-11-02,CR830212050312/RMCPL20307/2,500.0,0.0,18188137.87000008,2018,11,2,CASH_OUT,500.0,C189963646
14138,409000438620',2018-11-02,CR830216099657/RMCPL22032/2,3000.0,0.0,18185137.87000008,2018,11,2,CHECK_WITHDRAWAL,3000.0,C295081230
14139,409000438620',2018-11-02,CR830212049066/RMCPL16592/2,500.0,0.0,18184637.87000008,2018,11,2,DEBIT,500.0,M1541188642
14140,409000438620',2018-11-02,CR830212049177/RMCPL02155/2,4700.0,0.0,18179937.87000008,2018,11,2,PAYEMENT,4700.0,M1028632942
14141,409000438620',2018-11-02,CR830212048992/RMCPL12966/2,500.0,0.0,18179437.87000008,2018,11,2,PAYEMENT,500.0,M1132223013
14142,409000438620',2018-11-02,CR830212050253/RMCPL07044/2,500.0,0.0,18178937.87000008,2018,11,2,CASH_OUT,500.0,C1220911229
14143,409000438620',2018-11-02,CR830209999384/RMCPL23002/2,3000.0,0.0,18175937.87000008,2018,11,2,PAYEMENT,3000.0,C715819458
14144,409000438620',2018-11-02,MAW/502964XXXXXX1001/NAGA,0.0,900.0,18176837.87000008,2018,11,2,TRANSFER,900.0,C591862575
14145,409000438620',2018-11-02,AEPS INCOME DT 11-01-2018,0.0,7218.44,18184056.31000008,2018,11,2,TRANSFER,7218.44,C1671179293
14146,409000438620',2018-11-02,AEPS GST INC DT 11-01-201,0.0,1443.69,18185500.00000008,2018,11,2,CASH_IN,1443.69,C1289453529
14147,409000438620',2018-11-02,AEPS ACQ CR ADJ FEES 0111,123.31,0.0,18185376.69000008,2018,11,2,DEBIT,123.31,C1234776885
14148,409000438620',2018-11-02,AEPS ACQ REP ADJ FEES 011,0.0,23.6,18185400.29000008,2018,11,2,TRANSFER,23.6,C1034382650
14149,409000438620',2018-11-02,MICRO ATM WDL FEE DT02111,0.0,283900.0,18469300.29000008,2018,11,2,CASH_IN,283900.0,C1447218435
14150,409000438620',2018-11-02,MICRO ATM INC DATED 02111,0.0,703.8,18470004.09000008,2018,11,2,CHECK_CASHING,703.8,C1311325237
14151,409000438620',2018-11-02,MICRO ATM GST DATED 02111,0.0,140.76,18470144.850000083,2018,11,2,TRANSFER,140.76,C1621383518
14152,409000438620',2018-11-02,TRF TO  Indiaforensic SERVICES I,500000.0,0.0,17970144.850000083,2018,11,2,PAYEMENT,500000.0,C219543946
14153,409000438620',2018-11-03,Indiaforensic AEPS NPCI WDL SET,0.0,3024200.0,20994344.850000083,2018,11,3,CHECK_CASHING,3024200.0,C1321139761
14154,409000438620',2018-11-03,TRF TO  Indiaforensic SERVICES I,3000000.0,0.0,17994344.850000083,2018,11,3,CASH_OUT,3000000.0,C1641587857
14155,409000438620',2018-11-03,MICRO ATM WDL FEE DT02111,0.0,799200.0,18793544.850000083,2018,11,3,TRANSFER,799200.0,C1930186237
14156,409000438620',2018-11-03,MICRO ATM INC DATED 02111,0.0,1554.12,18795098.970000084,2018,11,3,CASH_IN,1554.12,C667346055
14157,409000438620',2018-11-03,MICRO ATM GST DATED 02111,0.0,310.82,18795409.790000085,2018,11,3,CASH_IN,310.82,C1195378184
14158,409000438620',2018-11-03,MAW/502964XXXXXX2169/NAGA,0.0,900.0,18796309.790000085,2018,11,3,CHECK_CASHING,900.0,C71555810
14159,409000438620',2018-11-03,AEPS INCOME DT 11-02-2018,0.0,7490.12,18803799.910000086,2018,11,3,CASH_IN,7490.12,C33712880
14160,409000438620',2018-11-03,AEPS GST INC DT 11-02-201,0.0,1498.02,18805297.930000085,2018,11,3,TRANSFER,1498.02,C1439007204
14161,409000438620',2018-11-03,AEPS ACQ CR ADJ FEES 0211,106.79,0.0,18805191.140000086,2018,11,3,PAYEMENT,106.79,C916869225
14162,409000438620',2018-11-03,CR830312262927RMCPL18434301,3000.0,0.0,18802191.140000086,2018,11,3,CHECK_WITHDRAWAL,3000.0,C1536044711
14163,409000438620',2018-11-03,CR830312262983RMCPL15477301,1000.0,0.0,18801191.140000086,2018,11,3,DEBIT,1000.0,C505973878
14164,409000438620',2018-11-03,CR830312262843RMCPL22143301,3000.0,0.0,18798191.140000086,2018,11,3,DEBIT,3000.0,C1979563377
14165,409000438620',2018-11-03,CR830311253769RMCPL11019301,2000.0,0.0,18796191.140000086,2018,11,3,DEBIT,2000.0,C1003872245
14166,409000438620',2018-11-03,CR830311260409RMCPL18599301,1000.0,0.0,18795191.140000086,2018,11,3,PAYEMENT,1000.0,C339082934
14167,409000438620',2018-11-03,CR830313282107RMCPL21161301,2100.0,0.0,18793091.140000086,2018,11,3,DEBIT,2100.0,C2019224489
14168,409000438620',2018-11-03,CR830417548808RMCPL16714311,2000.0,0.0,18791091.140000086,2018,11,3,CHECK_WITHDRAWAL,2000.0,C1570556626
14169,409000438620',2018-11-03,CR830408427495RMCPL28997311,3000.0,0.0,18788091.140000086,2018,11,3,DEBIT,3000.0,C1543005080
14170,409000438620',2018-11-03,CR830414512216RMCPL27488311,1000.0,0.0,18787091.140000086,2018,11,3,DEBIT,1000.0,C1249547869
14171,409000438620',2018-11-03,TRF TO  Indiaforensic SERVICES I,1000000.0,0.0,17787091.140000086,2018,11,3,PAYEMENT,1000000.0,C1434590943
14172,409000438620',2018-11-03,MAW/502964XXXXXX1773/NAGA,0.0,1000.0,17788091.140000086,2018,11,3,CASH_IN,1000.0,C526035976
14173,409000438620',2018-11-03,MICRO ATM WDL FEE DT03111,0.0,540400.0,18328491.140000086,2018,11,3,CASH_IN,540400.0,C185503802
14174,409000438620',2018-11-03,MICRO ATM INC DATED 03111,0.0,1093.32,18329584.460000087,2018,11,3,CASH_IN,1093.32,M1300963698
14175,409000438620',2018-11-03,MICRO ATM GST DATED 03111,0.0,218.66,18329803.120000087,2018,11,3,TRANSFER,218.66,M922856815
14176,409000438620',2018-11-04,MAW/502964XXXXXX0270/NAGA,0.0,900.0,18330703.120000087,2018,11,4,TRANSFER,900.0,C1674899618
14177,409000438620',2018-11-04,MAW/502964XXXXXX6122/NAGA,0.0,1600.0,18332303.120000087,2018,11,4,CHECK_CASHING,1600.0,C1315912968
14178,409000438620',2018-11-05,MAW/502964XXXXXX9739/NAGA,0.0,1300.0,18333603.120000087,2018,11,5,CHECK_CASHING,1300.0,M1191839372
14179,409000438620',2018-11-05,Indiaforensic AEPS NPCI WDL SET,0.0,3505900.0,21839503.120000087,2018,11,5,CASH_IN,3505900.0,M1915922279
14180,409000438620',2018-11-05,Indiaforensic AEPS NPCI WDL SET,0.0,2360100.0,24199603.12000009,2018,11,5,CASH_IN,2360100.0,C1057152052
14181,409000438620',2018-11-05,CR830518780627/RMCPL23891/0,500.0,0.0,24199103.12000009,2018,11,5,PAYEMENT,500.0,C724821526
14182,409000438620',2018-11-05,CR830516756700/RMCPL17591/0,5000.0,0.0,24194103.12000009,2018,11,5,CHECK_WITHDRAWAL,5000.0,C1923206317
14183,409000438620',2018-11-05,CR830516756730/RMCPL29723/0,6000.0,0.0,24188103.12000009,2018,11,5,DEBIT,6000.0,M878737882
14184,409000438620',2018-11-05,CR830516756712/RMCPL25138/0,1100.0,0.0,24187003.12000009,2018,11,5,DEBIT,1100.0,C1217400138
14185,409000438620',2018-11-05,CR830518780594/RMCPL09484/0,1400.0,0.0,24185603.12000009,2018,11,5,DEBIT,1400.0,C473344802
14186,409000438620',2018-11-05,CR830518781732/RMCPL24703/0,5500.0,0.0,24180103.12000009,2018,11,5,PAYEMENT,5500.0,M934472884
14187,409000438620',2018-11-05,CR830514734026/RMCPL28670/0,1000.0,0.0,24179103.12000009,2018,11,5,PAYEMENT,1000.0,C173783788
14188,409000438620',2018-11-05,CR830514735124/RMCPL20491/0,1000.0,0.0,24178103.12000009,2018,11,5,PAYEMENT,1000.0,C719119378
14189,409000438620',2018-11-05,CR830512709808/RMCPL18859/0,500.0,0.0,24177603.12000009,2018,11,5,DEBIT,500.0,M311231872
14190,409000438620',2018-11-05,CR830512709864/RMCPL23228/0,1100.0,0.0,24176503.12000009,2018,11,5,CASH_OUT,1100.0,M1784265712
14191,409000438620',2018-11-05,CR830512709841/RMCPL13136/0,500.0,0.0,24176003.12000009,2018,11,5,DEBIT,500.0,M1994365097
14192,409000438620',2018-11-05,CR829911437710/RMCPL28373/2,323.0,0.0,24175680.12000009,2018,11,5,DEBIT,323.0,C248609774
14193,409000438620',2018-11-05,CR829113579525/RMCPL25130/1,280.0,0.0,24175400.12000009,2018,11,5,PAYEMENT,280.0,C1099892020
14194,409000438620',2018-11-05,TRF TO  Indiaforensic SERVICES I,6500000.0,0.0,17675400.120000087,2018,11,5,CASH_OUT,6500000.0,C1553217607
14195,409000438620',2018-11-05,MICRO ATM INC DATED 03111,0.0,1276.2,17676676.320000086,2018,11,5,CHECK_CASHING,1276.2,C1554622120
14196,409000438620',2018-11-05,MICRO ATM GST DATED 03111,0.0,255.24,17676931.560000084,2018,11,5,CHECK_CASHING,255.24,C1751073738
14197,409000438620',2018-11-05,MICRO ATM INC DATED 04111,0.0,2714.4,17679645.960000087,2018,11,5,CASH_IN,2714.4,C1608433267
14198,409000438620',2018-11-05,MICRO ATM GST DATED 04111,0.0,542.88,17680188.84000008,2018,11,5,CASH_IN,542.88,M999619421
14199,409000438620',2018-11-05,MICRO ATM WDL FEE DT03111,0.0,621000.0,18301188.84000008,2018,11,5,CHECK_CASHING,621000.0,M1737456273
14200,409000438620',2018-11-05,MICRO ATM WDL FEE DT04111,0.0,1202200.0,19503388.84000008,2018,11,5,TRANSFER,1202200.0,C705480294
14201,409000438620',2018-11-05,MICRO ATM WDL FEE DT05111,0.0,607900.0,20111288.84000008,2018,11,5,CHECK_CASHING,607900.0,C1554540309
14202,409000438620',2018-11-05,MICRO ATM INC DATED 05111,0.0,1394.28,20112683.120000087,2018,11,5,CHECK_CASHING,1394.28,C2036368507
14203,409000438620',2018-11-05,MICRO ATM GST DATED 05111,0.0,278.86,20112961.98000008,2018,11,5,CASH_IN,278.86,C1754042702
14204,409000438620',2018-11-05,AEPS INCOME DT 11-03-2018,0.0,8894.75,20121856.73000008,2018,11,5,CHECK_CASHING,8894.75,M405986115
14205,409000438620',2018-11-05,AEPS GST INC DT 11-03-201,0.0,1778.95,20123635.68000008,2018,11,5,TRANSFER,1778.95,C1738994372
14206,409000438620',2018-11-05,AEPS INCOME DT 11-04-2018,0.0,6027.34,20129663.02000008,2018,11,5,CHECK_CASHING,6027.34,C1202306289
14207,409000438620',2018-11-05,AEPS GST INC DT 11-04-201,0.0,1205.47,20130868.49000008,2018,11,5,TRANSFER,1205.47,C8290162
14208,409000438620',2018-11-05,AEPS ACQ CR ADJ FEES 0311,94.63,0.0,20130773.86000008,2018,11,5,PAYEMENT,94.63,M922029807
14209,409000438620',2018-11-05,TRF TO  Indiaforensic SERVICES I,2400000.0,0.0,17730773.86000008,2018,11,5,DEBIT,2400000.0,M1514730113
14210,409000438620',2018-11-05,NPCI SETELEMENT DIFF_0311,0.0,800.0,17731573.86000008,2018,11,5,CHECK_CASHING,800.0,C478124129
14211,409000438620',2018-11-05,NPCI SETELEMENT DIFF_0411,0.0,4000.0,17735573.86000008,2018,11,5,TRANSFER,4000.0,C1774531247
14212,409000438620',2018-11-06,Indiaforensic AEPS NPCI WDL SET,0.0,3972400.0,21707973.86000008,2018,11,6,CASH_IN,3972400.0,C790798176
14213,409000438620',2018-11-06,TRF TO  Indiaforensic SERVICES I,4000000.0,0.0,17707973.86000008,2018,11,6,CASH_OUT,4000000.0,M325383786
14214,409000438620',2018-11-06,AEPS PAY Indiaforensic 0411,0.0,599.06,17708572.92000008,2018,11,6,CASH_IN,599.06,M1279004879
14215,409000438620',2018-11-06,MICRO ATM WDL FEE DT05111,0.0,1161500.0,18870072.92000008,2018,11,6,CHECK_CASHING,1161500.0,M451161086
14216,409000438620',2018-11-06,MICRO ATM INC DATED 05111,0.0,2462.76,18872535.68000008,2018,11,6,CHECK_CASHING,2462.76,C93166806
14217,409000438620',2018-11-06,MICRO ATM GST DATED 05111,0.0,492.55,18873028.23000008,2018,11,6,TRANSFER,492.55,M1705266570
14218,409000438620',2018-11-06,AEPS INCOME DT 11-05-2018,0.0,9472.39,18882500.620000087,2018,11,6,CASH_IN,9472.39,C363377192
14219,409000438620',2018-11-06,AEPS GST INC DT 11-05-201,0.0,1894.48,18884395.100000083,2018,11,6,TRANSFER,1894.48,M1147159485
14220,409000438620',2018-11-06,AEPS ACQUIRING ADJ FEES 0,17.7,0.0,18884377.400000084,2018,11,6,CASH_OUT,17.7,C1677727024
14221,409000438620',2018-11-06,MICRO ATM WDL FEE DT06111,0.0,646800.0,19531177.400000084,2018,11,6,CHECK_CASHING,646800.0,M2139799663
14222,409000438620',2018-11-06,MICRO ATM INC DATED 06111,0.0,1513.08,19532690.48000008,2018,11,6,CHECK_CASHING,1513.08,M1179953846
14223,409000438620',2018-11-06,MICRO ATM GST DATED 06111,0.0,302.62,19532993.100000083,2018,11,6,TRANSFER,302.62,M1963720212
14224,409000438620',2018-11-06,NPCI SETELEMENT DIFF_0511,0.0,5000.0,19537993.100000083,2018,11,6,CASH_IN,5000.0,M656787264
14225,409000438620',2018-11-07,Indiaforensic AEPS NPCI WDL SET,0.0,3520100.0,23058093.100000083,2018,11,7,CASH_IN,3520100.0,C1292838001
14226,409000438620',2018-11-07,CR830611895062/RMCPL14880/0,2000.0,0.0,23056093.100000083,2018,11,7,DEBIT,2000.0,M1969327638
14227,409000438620',2018-11-07,MAW/502964XXXXXX1833/NAGA,0.0,200.0,23056293.100000083,2018,11,7,CASH_IN,200.0,M679315243
14228,409000438620',2018-11-07,AEPS INCOME DT 11-06-2018,0.0,9048.05,23065341.150000084,2018,11,7,TRANSFER,9048.05,M577135043
14229,409000438620',2018-11-07,AEPS GST INC DT 11-06-201,0.0,1809.61,23067150.760000084,2018,11,7,CHECK_CASHING,1809.61,M546731124
14230,409000438620',2018-11-07,AEPS ACQ CR ADJ FEES 0611,11.8,0.0,23067138.96000009,2018,11,7,CHECK_WITHDRAWAL,11.8,M409261920
14231,409000438620',2018-11-08,CB830715173100/RMCPL09602/0,5000.0,0.0,23062138.96000009,2018,11,8,CASH_OUT,5000.0,M1478447450
14232,409000438620',2018-11-08,Indiaforensic AEPS NPCI WDL SET,0.0,2434600.0,25496738.96000009,2018,11,8,TRANSFER,2434600.0,M29091955
14233,409000438620',2018-11-08,AEPS INCOME DT 07-11-2018,0.0,6484.75,25503223.71000009,2018,11,8,CHECK_CASHING,6484.75,M637487146
14234,409000438620',2018-11-08,AEPS GST INC DT 07-11-201,0.0,1296.95,25504520.66000008,2018,11,8,CHECK_CASHING,1296.95,C745740822
14235,409000438620',2018-11-08,AEPS ACQ CR ADJ FEES 0711,17.7,0.0,25504502.96000009,2018,11,8,CHECK_WITHDRAWAL,17.7,C586396179
14236,409000438620',2018-11-08,TRF TO  Indiaforensic SERVICES I,5000000.0,0.0,20504502.960000087,2018,11,8,CHECK_WITHDRAWAL,5000000.0,M157170579
14237,409000438620',2018-11-08,TRF TO  Indiaforensic SERVICES I,2800000.0,0.0,17704502.960000087,2018,11,8,DEBIT,2800000.0,M1671390276
14238,409000438620',2018-11-09,MICRO ATM WDL FEE DT06111,0.0,1018100.0,18722602.960000087,2018,11,9,CHECK_CASHING,1018100.0,C1635341595
14239,409000438620',2018-11-09,MICRO ATM WDL FEE DT07111,0.0,809400.0,19532002.960000087,2018,11,9,CHECK_CASHING,809400.0,C1027992087
14240,409000438620',2018-11-09,MICRO ATM WDL FEE DT07111,0.0,1040900.0,20572902.960000087,2018,11,9,TRANSFER,1040900.0,C922871524
14241,409000438620',2018-11-09,MICRO ATM WDL FEE DT08111,0.0,346200.0,20919102.960000087,2018,11,9,CASH_IN,346200.0,M828869162
14242,409000438620',2018-11-09,MICRO ATM WDL FEE DT08111,0.0,818100.0,21737202.960000087,2018,11,9,TRANSFER,818100.0,M1309313968
14243,409000438620',2018-11-09,CB830718224333/RMCPL05050/0,5100.0,0.0,21732102.960000087,2018,11,9,CHECK_WITHDRAWAL,5100.0,C1292445663
14244,409000438620',2018-11-09,Indiaforensic AEPS NPCI WDL SET,0.0,1976700.0,23708802.96000009,2018,11,9,TRANSFER,1976700.0,M2001030591
14245,409000438620',2018-11-09,TRF TO  Indiaforensic SERVICES I,3000000.0,0.0,20708802.960000087,2018,11,9,PAYEMENT,3000000.0,M1222093409
14246,409000438620',2018-11-09,TRF TO  Indiaforensic SERVICES I,3000000.0,0.0,17708802.960000087,2018,11,9,CHECK_WITHDRAWAL,3000000.0,C2036926986
14247,409000438620',2018-11-09,NPCI SETELEMENT DIFF_0611,0.0,15000.0,17723802.960000087,2018,11,9,TRANSFER,15000.0,C1352463225
14248,409000438620',2018-11-09,MICRO ATM INC DATED 06111,0.0,2213.64,17726016.600000083,2018,11,9,TRANSFER,2213.64,C635371680
14249,409000438620',2018-11-09,MICRO ATM GST DATED 06111,0.0,442.73,17726459.330000084,2018,11,9,CHECK_CASHING,442.73,C423580937
14250,409000438620',2018-11-09,AEPS INCOME DT 11-08-2018,0.0,5252.28,17731711.610000085,2018,11,9,TRANSFER,5252.28,C1424731356
14251,409000438620',2018-11-09,AEPS GST INC DT 11-08-201,0.0,1050.46,17732762.070000086,2018,11,9,TRANSFER,1050.46,M757115596
14252,409000438620',2018-11-09,MICRO ATM INC DATED 07111,0.0,1863.0,17734625.070000086,2018,11,9,TRANSFER,1863.0,C1947645280
14253,409000438620',2018-11-09,MICRO ATM GST DATED 07111,0.0,372.6,17734997.670000087,2018,11,9,TRANSFER,372.6,M444777909
14254,409000438620',2018-11-09,MICRO ATM INC DATED 07111,0.0,2331.72,17737329.390000086,2018,11,9,CHECK_CASHING,2331.72,M512659225
14255,409000438620',2018-11-09,MICRO ATM GST DATED 07111,0.0,466.34,17737795.730000086,2018,11,9,CASH_IN,466.34,C2127862399
14256,409000438620',2018-11-09,MICRO ATM INC DATED 08111,0.0,859.32,17738655.050000086,2018,11,9,TRANSFER,859.32,C556812393
14257,409000438620',2018-11-09,MICRO ATM GST DATED 08111,0.0,171.86,17738826.910000086,2018,11,9,CHECK_CASHING,171.86,C997588432
14258,409000438620',2018-11-09,MICRO ATM INC DATED 08111,0.0,1780.56,17740607.470000084,2018,11,9,CHECK_CASHING,1780.56,C1996526533
14259,409000438620',2018-11-09,MICRO ATM GST DATED 08111,0.0,356.11,17740963.580000084,2018,11,9,CASH_IN,356.11,C875917495
14260,409000438620',2018-11-09,MICRO ATM WDL FEE DT09111,0.0,50500.0,17791463.580000084,2018,11,9,TRANSFER,50500.0,M1829230355
14261,409000438620',2018-11-09,MICRO ATM INC DATED 09111,0.0,91.8,17791555.380000085,2018,11,9,CASH_IN,91.8,M764982150
14262,409000438620',2018-11-09,MICRO ATM GST DATED 09111,0.0,18.36,17791573.740000084,2018,11,9,CASH_IN,18.36,M44917682
14263,409000438620',2018-11-09,AEPS PAY Indiaforensic 0611,0.0,1998.52,17793572.260000084,2018,11,9,CASH_IN,1998.52,M1702576459
14264,409000438620',2018-11-10,MAW/502964XXXXXX1948/NAGA,0.0,1000.0,17794572.260000084,2018,11,10,CASH_IN,1000.0,M1374728015
14265,409000438620',2018-11-12,Indiaforensic AEPS NPCI WDL SET,0.0,2120100.0,19914672.260000084,2018,11,12,TRANSFER,2120100.0,C1909597726
14266,409000438620',2018-11-12,Indiaforensic AEPS NPCI WDL SET,0.0,1734000.0,21648672.260000084,2018,11,12,TRANSFER,1734000.0,M715331385
14267,409000438620',2018-11-12,Indiaforensic AEPS NPCI WDL SET,0.0,2335200.0,23983872.260000084,2018,11,12,CHECK_CASHING,2335200.0,C1653844940
14268,409000438620',2018-11-12,MAW/502964XXXXXX1997/NAGA,0.0,500.0,23984372.260000084,2018,11,12,TRANSFER,500.0,M845101574
14269,409000438620',2018-11-12,TRF TO  Indiaforensic SERVICES I,4000000.0,0.0,19984372.260000084,2018,11,12,DEBIT,4000000.0,C1245442940
14270,409000438620',2018-11-12,TRF TO  Indiaforensic SERVICES I,2000000.0,0.0,17984372.260000084,2018,11,12,CASH_OUT,2000000.0,M826221953
14271,409000438620',2018-11-12,MICRO ATM WDL FEE DT09111,0.0,429800.0,18414172.260000084,2018,11,12,TRANSFER,429800.0,C185353840
14272,409000438620',2018-11-12,MICRO ATM INC DATED 09111,0.0,804.6,18414976.860000085,2018,11,12,CHECK_CASHING,804.6,C1839337592
14273,409000438620',2018-11-12,MICRO ATM GST DATED 09111,0.0,160.92,18415137.780000087,2018,11,12,CHECK_CASHING,160.92,M297648083
14274,409000438620',2018-11-12,MICRO ATM WDL FEE DT10111,0.0,1809600.0,20224737.780000087,2018,11,12,CASH_IN,1809600.0,M34185415
14275,409000438620',2018-11-12,MICRO ATM INC DATED 10111,0.0,3928.68,20228666.460000087,2018,11,12,CHECK_CASHING,3928.68,C1813913953
14276,409000438620',2018-11-12,MICRO ATM GST DATED 10111,0.0,785.74,20229452.200000085,2018,11,12,TRANSFER,785.74,C1691655733
14277,409000438620',2018-11-12,MICRO ATM WDL FEE DT11111,0.0,1506900.0,21736352.200000085,2018,11,12,CASH_IN,1506900.0,C106347918
14278,409000438620',2018-11-12,MICRO ATM INC DATED 11111,0.0,3426.84,21739779.040000085,2018,11,12,CHECK_CASHING,3426.84,M634225415
14279,409000438620',2018-11-12,MICRO ATM GST DATED 11111,0.0,685.37,21740464.410000086,2018,11,12,CHECK_CASHING,685.37,C1287328228
14280,409000438620',2018-11-12,MICRO ATM WDL FEE DT12111,0.0,612200.0,22352664.410000086,2018,11,12,CASH_IN,612200.0,M109323569
14281,409000438620',2018-11-12,MICRO ATM INC DATED 12111,0.0,1369.08,22354033.490000084,2018,11,12,CASH_IN,1369.08,C1174545131
14282,409000438620',2018-11-12,MICRO ATM GST DATED 12111,0.0,273.82,22354307.310000084,2018,11,12,CASH_IN,273.82,M537498143
14283,409000438620',2018-11-12,AEPS INCOME DT 11-09-2018,0.0,5947.73,22360255.040000085,2018,11,12,CASH_IN,5947.73,C2086207545
14284,409000438620',2018-11-12,AEPS GST INC DT 11-09-201,0.0,1189.55,22361444.59000009,2018,11,12,TRANSFER,1189.55,C1377231932
14285,409000438620',2018-11-12,AEPS INCOME DT 11-10-2018,0.0,6000.3,22367444.890000086,2018,11,12,TRANSFER,6000.3,M921549721
14286,409000438620',2018-11-12,AEPS GST INC DT 11-10-201,0.0,1200.06,22368644.950000085,2018,11,12,CASH_IN,1200.06,M1088225011
14287,409000438620',2018-11-12,AEPS INCOME DT 11-11-2018,0.0,4595.75,22373240.700000085,2018,11,12,CASH_IN,4595.75,M53186846
14288,409000438620',2018-11-12,AEPS GST INC DT 11-11-201,0.0,919.15,22374159.850000083,2018,11,12,TRANSFER,919.15,M18999287
14289,409000438620',2018-11-12,AEPS ACQUIRING ADJ FEES 0,5.9,0.0,22374153.950000085,2018,11,12,CASH_OUT,5.9,M135106838
14290,409000438620',2018-11-12,TRF TO  Indiaforensic SERVICES I,4000000.0,0.0,18374153.950000085,2018,11,12,PAYEMENT,4000000.0,M1292769261
14291,409000438620',2018-11-13,Indiaforensic AEPS NPCI WDL SET,0.0,2752700.0,21126853.950000085,2018,11,13,CHECK_CASHING,2752700.0,M1947169936
14292,409000438620',2018-11-13,CR831115053900/RMCPL14542/0,10000.0,0.0,21116853.950000085,2018,11,13,PAYEMENT,10000.0,M2019405169
14293,409000438620',2018-11-13,CR831008738667/RMCPL29740/0,500.0,0.0,21116353.950000085,2018,11,13,PAYEMENT,500.0,M300189678
14294,409000438620',2018-11-13,CR831015833558/RMCPL19318/0,500.0,0.0,21115853.950000085,2018,11,13,CHECK_WITHDRAWAL,500.0,M1250043160
14295,409000438620',2018-11-13,CR831015837159/RMCPL20307/0,2000.0,0.0,21113853.950000085,2018,11,13,PAYEMENT,2000.0,M1743674136
14296,409000438620',2018-11-13,CR830916625302/RMCPL09612/0,10000.0,0.0,21103853.950000085,2018,11,13,PAYEMENT,10000.0,M1787113459
14297,409000438620',2018-11-13,CR830916625301/RMCPL15656/0,1000.0,0.0,21102853.950000085,2018,11,13,CHECK_WITHDRAWAL,1000.0,M773658611
14298,409000438620',2018-11-13,CR830914605380/RMCPL09612/0,1100.0,0.0,21101753.950000085,2018,11,13,DEBIT,1100.0,M2138270635
14299,409000438620',2018-11-13,TRF TO  Indiaforensic SERVICES I,3000000.0,0.0,18101753.950000085,2018,11,13,DEBIT,3000000.0,C1218365329
14300,409000438620',2018-11-13,MAW/502964XXXXXX0102/Vals,0.0,1000.0,18102753.950000085,2018,11,13,CASH_IN,1000.0,C1948471365
14301,409000438620',2018-11-13,MICRO ATM WDL FEE DT12111,0.0,1140600.0,19243353.950000085,2018,11,13,CASH_IN,1140600.0,C619120762
14302,409000438620',2018-11-13,MICRO ATM INC DATED 12111,0.0,2555.28,19245909.230000086,2018,11,13,CHECK_CASHING,2555.28,M315627977
14303,409000438620',2018-11-13,MICRO ATM GST DATED 12111,0.0,511.06,19246420.290000085,2018,11,13,CASH_IN,511.06,M486779597
14304,409000438620',2018-11-13,AEPS PAY Indiaforensic 1011,0.0,398.46,19246818.750000086,2018,11,13,TRANSFER,398.46,M1060390066
14305,409000438620',2018-11-13,TRF TO  Indiaforensic SERVICES I,1500000.0,0.0,17746818.750000086,2018,11,13,CHECK_WITHDRAWAL,1500000.0,M548110697
14306,409000438620',2018-11-13,AEPS INCOME DT 11-12-2018,0.0,7359.35,17754178.100000087,2018,11,13,CHECK_CASHING,7359.35,M1342632768
14307,409000438620',2018-11-13,AEPS GST INC DT 11-12-201,0.0,1471.87,17755649.97000009,2018,11,13,CHECK_CASHING,1471.87,M2087139284
14308,409000438620',2018-11-13,AEPS ACQ CR ADJ FEES 1211,65.49,0.0,17755584.48000009,2018,11,13,CHECK_WITHDRAWAL,65.49,M133573226
14309,409000438620',2018-11-13,AEPS PAY Indiaforensic 1211,0.0,118.63,17755703.11000009,2018,11,13,CASH_IN,118.63,M418935262
14310,409000438620',2018-11-13,MICRO ATM WDL FEE DT13111,0.0,181100.0,17936803.11000009,2018,11,13,TRANSFER,181100.0,M614622550
14311,409000438620',2018-11-13,MICRO ATM INC DATED 13111,0.0,399.96,17937203.07000009,2018,11,13,CHECK_CASHING,399.96,M62317715
14312,409000438620',2018-11-13,MICRO ATM GST DATED 13111,0.0,79.99,17937283.060000088,2018,11,13,CHECK_CASHING,79.99,M736584533
14313,409000438620',2018-11-13,MAW/502964XXXXXX1213/NAGA,0.0,2500.0,17939783.060000088,2018,11,13,CASH_IN,2500.0,C58091972
14314,409000438620',2018-11-14,Indiaforensic AEPS NPCI WDL SET,0.0,2403900.0,20343683.060000088,2018,11,14,CHECK_CASHING,2403900.0,M1114854517
14315,409000438620',2018-11-14,TRF TO  Indiaforensic SERVICES I,2600000.0,0.0,17743683.060000088,2018,11,14,CHECK_WITHDRAWAL,2600000.0,M721779083
14316,409000438620',2018-11-14,MAW/502964XXXXXX2094/NAGA,0.0,1000.0,17744683.060000088,2018,11,14,CASH_IN,1000.0,M158269968
14317,409000438620',2018-11-14,MICRO ATM WDL FEE DT13111,0.0,362900.0,18107583.060000088,2018,11,14,CASH_IN,362900.0,M676099952
14318,409000438620',2018-11-14,MICRO ATM INC DATED 13111,0.0,690.84,18108273.900000088,2018,11,14,CHECK_CASHING,690.84,C473485349
14319,409000438620',2018-11-14,MICRO ATM GST DATED 13111,0.0,138.17,18108412.07000009,2018,11,14,TRANSFER,138.17,M893376115
14320,409000438620',2018-11-14,AEPS PAY Indiaforensic 1311,0.0,497.12,18108909.19000009,2018,11,14,CHECK_CASHING,497.12,M200435583
14321,409000438620',2018-11-14,MICRO ATM WDL FEE DT14111,0.0,468400.0,18577309.19000009,2018,11,14,CHECK_CASHING,468400.0,M861975647
14322,409000438620',2018-11-14,MICRO ATM INC DATED 14111,0.0,1074.24,18578383.43000009,2018,11,14,CASH_IN,1074.24,M1263548328
14323,409000438620',2018-11-14,MICRO ATM GST DATED 14111,0.0,214.85,18578598.28000009,2018,11,14,CHECK_CASHING,214.85,M1049302241
14324,409000438620',2018-11-14,AEPS INCOME DT 11-13-2018,0.0,6053.47,18584651.75000009,2018,11,14,CHECK_CASHING,6053.47,M741144125
14325,409000438620',2018-11-14,AEPS GST INC DT 11-13-201,0.0,1210.69,18585862.44000009,2018,11,14,CASH_IN,1210.69,M1051888468
14326,409000438620',2018-11-14,AEPS ACQ REP ADJ FEES 131,0.0,5.9,18585868.34000009,2018,11,14,TRANSFER,5.9,C824009085
14327,409000438620',2018-11-14,TRF TO  Indiaforensic SERVICES I,400000.0,0.0,18185868.34000009,2018,11,14,PAYEMENT,400000.0,M1429408166
14328,409000438620',2018-11-15,CR831312419569/RMCPL20001/0,10000.0,0.0,18175868.34000009,2018,11,15,PAYEMENT,10000.0,C158876320
14329,409000438620',2018-11-15,CR831614051575/RMCPL24591/1,9200.0,0.0,18166668.34000009,2018,11,15,DEBIT,9200.0,M4358716
14330,409000438620',2018-11-15,Indiaforensic AEPS NPCI WDL SET,0.0,2410200.0,20576868.34000009,2018,11,15,CHECK_CASHING,2410200.0,C340368210
14331,409000438620',2018-11-15,MAW/502964XXXXXX8117/NAGA,0.0,1400.0,20578268.34000009,2018,11,15,TRANSFER,1400.0,M992781916
14332,409000438620',2018-11-15,TRF TO  Indiaforensic SERVICES I,500000.0,0.0,20078268.34000009,2018,11,15,CASH_OUT,500000.0,C623476050
14333,409000438620',2018-11-15,MICRO ATM WDL FEE DT14111,0.0,818500.0,20896768.34000009,2018,11,15,CASH_IN,818500.0,M1075351526
14334,409000438620',2018-11-15,MICRO ATM INC DATED 14111,0.0,1729.8,20898498.14000009,2018,11,15,TRANSFER,1729.8,C256902273
14335,409000438620',2018-11-15,MICRO ATM GST DATED 14111,0.0,345.96,20898844.10000009,2018,11,15,TRANSFER,345.96,C1058664855
14336,409000438620',2018-11-15,TRF TO  Indiaforensic SERVICES I,2400000.0,0.0,18498844.10000009,2018,11,15,CHECK_WITHDRAWAL,2400000.0,M599468153
14337,409000438620',2018-11-15,AEPS PAY Indiaforensic 1411,0.0,99.64,18498943.74000009,2018,11,15,CHECK_CASHING,99.64,C2047373618
14338,409000438620',2018-11-15,AEPS INCOME DT 11-14-2018,0.0,6276.71,18505220.45000009,2018,11,15,CHECK_CASHING,6276.71,C2078448324
14339,409000438620',2018-11-15,AEPS GST INC DT 11-14-201,0.0,1255.34,18506475.79000009,2018,11,15,CASH_IN,1255.34,M336168316
14340,409000438620',2018-11-15,AEPS ACQ CR ADJ FEES 1411,35.4,0.0,18506440.390000094,2018,11,15,CASH_OUT,35.4,M1851290163
14341,409000438620',2018-11-15,TRF TO  Indiaforensic SERVICES I,800000.0,0.0,17706440.390000094,2018,11,15,CASH_OUT,800000.0,M68815337
14342,409000438620',2018-11-16,Indiaforensic AEPS NPCI WDL SET,0.0,2688600.0,20395040.390000094,2018,11,16,CASH_IN,2688600.0,M1243716589
14343,409000438620',2018-11-16,TRF TO  Indiaforensic SERVICES I,2700000.0,0.0,17695040.390000094,2018,11,16,CASH_OUT,2700000.0,C2030151083
14344,409000438620',2018-11-16,MICRO ATM WDL FEE DT15111,0.0,301100.0,17996140.390000094,2018,11,16,CHECK_CASHING,301100.0,C1635207173
14345,409000438620',2018-11-16,MICRO ATM INC DATED 15111,0.0,682.56,17996822.950000092,2018,11,16,CASH_IN,682.56,M1277483421
14346,409000438620',2018-11-16,MICRO ATM GST DATED 15111,0.0,136.51,17996959.460000094,2018,11,16,CHECK_CASHING,136.51,M281549113
14347,409000438620',2018-11-16,MAW/502964XXXXXX2128/NAGA,0.0,1100.0,17998059.460000094,2018,11,16,CHECK_CASHING,1100.0,M378845707
14348,409000438620',2018-11-16,AEPS INCOME DT 11-15-2018,0.0,6871.85,18004931.310000096,2018,11,16,CHECK_CASHING,6871.85,M505781805
14349,409000438620',2018-11-16,AEPS GST INC DT 11-15-201,0.0,1374.37,18006305.680000097,2018,11,16,TRANSFER,1374.37,M1659540162
14350,409000438620',2018-11-16,AEPS PAY Indiaforensic 1511,0.0,99.64,18006405.320000093,2018,11,16,CHECK_CASHING,99.64,M1017970329
14351,409000438620',2018-11-16,MICRO ATM WDL FEE DT16111,0.0,420400.0,18426805.320000093,2018,11,16,CASH_IN,420400.0,M842237093
14352,409000438620',2018-11-16,MICRO ATM INC DATED 16111,0.0,900.0,18427705.320000093,2018,11,16,CHECK_CASHING,900.0,M835633691
14353,409000438620',2018-11-16,MICRO ATM GST DATED 16111,0.0,180.0,18427885.320000093,2018,11,16,CASH_IN,180.0,C1832580921
14354,409000438620',2018-11-16,TRF TO  Indiaforensic SERVICES I,700000.0,0.0,17727885.320000093,2018,11,16,PAYEMENT,700000.0,C367746789
14355,409000438620',2018-11-17,Indiaforensic AEPS NPCI WDL SET,0.0,2210800.0,19938685.320000093,2018,11,17,CHECK_CASHING,2210800.0,M282046195
14356,409000438620',2018-11-17,CR831817528988/RMCPL12459/1,500.0,0.0,19938185.320000093,2018,11,17,CASH_OUT,500.0,M2075290111
14357,409000438620',2018-11-17,CR831817528905/RMCPL25009/1,3000.0,0.0,19935185.320000093,2018,11,17,PAYEMENT,3000.0,M1918209284
14358,409000438620',2018-11-17,CR831818546157/RMCPL24117/1,3000.0,0.0,19932185.320000093,2018,11,17,DEBIT,3000.0,M900376031
14359,409000438620',2018-11-17,CR831912667485/RMCPL27340/1,100.0,0.0,19932085.320000093,2018,11,17,CHECK_WITHDRAWAL,100.0,M1951907756
14360,409000438620',2018-11-17,CR831419726103/RMCPL27159/1,399.0,0.0,19931686.320000093,2018,11,17,DEBIT,399.0,M935309099
14361,409000438620',2018-11-17,TRF TO  Indiaforensic SERVICES I,2000000.0,0.0,17931686.320000093,2018,11,17,CASH_OUT,2000000.0,M1966186452
14362,409000438620',2018-11-17,MICRO ATM WDL FEE DT16111,0.0,420600.0,18352286.320000093,2018,11,17,TRANSFER,420600.0,C1315912968
14363,409000438620',2018-11-17,MICRO ATM INC DATED 16111,0.0,963.36,18353249.680000097,2018,11,17,CASH_IN,963.36,C954723689
14364,409000438620',2018-11-17,MICRO ATM GST DATED 16111,0.0,192.67,18353442.350000106,2018,11,17,CHECK_CASHING,192.67,C1453128758
14365,409000438620',2018-11-17,AEPS INCOME DT 16-11-2018,0.0,5414.18,18358856.530000094,2018,11,17,TRANSFER,5414.18,C1286084959
14366,409000438620',2018-11-17,AEPS GST INC DT 16-11-201,0.0,1082.84,18359939.370000094,2018,11,17,CASH_IN,1082.84,C1531333864
14367,409000438620',2018-11-17,MICRO ATM WDL FEE DT17111,0.0,417000.0,18776939.370000094,2018,11,17,TRANSFER,417000.0,C2083562754
14368,409000438620',2018-11-17,MICRO ATM INC DATED 17111,0.0,991.8,18777931.170000106,2018,11,17,CASH_IN,991.8,C715819458
14369,409000438620',2018-11-17,MICRO ATM GST DATED 17111,0.0,198.36,18778129.530000094,2018,11,17,CASH_IN,198.36,C1570845844
14370,409000438620',2018-11-17,AEPS ACQ CR ADJ FEES 1611,38.05,0.0,18778091.480000094,2018,11,17,PAYEMENT,38.05,C1562773081
14371,409000438620',2018-11-17,TRF TO  Indiaforensic SERVICES I,500000.0,0.0,18278091.480000094,2018,11,17,CHECK_WITHDRAWAL,500000.0,C1300519073
14372,409000438620',2018-11-17,TRF TO  Indiaforensic SERVICES I,500000.0,0.0,17778091.480000094,2018,11,17,CHECK_WITHDRAWAL,500000.0,C1753128715
14373,409000438620',2018-11-18,MAW/502964XXXXXX9031/NAGA,0.0,200.0,17778291.480000094,2018,11,18,CHECK_CASHING,200.0,C1487669283
14374,409000438620',2018-11-19,Indiaforensic AEPS NPCI WDL SET,0.0,1964900.0,19743191.480000094,2018,11,19,CHECK_CASHING,1964900.0,C1570076320
14375,409000438620',2018-11-19,Indiaforensic AEPS NPCI WDL SET,0.0,1311700.0,21054891.480000094,2018,11,19,TRANSFER,1311700.0,C2129901484
14376,409000438620',2018-11-19,MAW/502964XXXXXX0502/NAGA,0.0,1900.0,21056791.480000094,2018,11,19,CASH_IN,1900.0,C1286084959
14377,409000438620',2018-11-19,TRF TO  Indiaforensic SERVICES I,2000000.0,0.0,19056791.480000094,2018,11,19,CASH_OUT,2000000.0,C1339765646
14378,409000438620',2018-11-19,TRF TO  Indiaforensic SERVICES I,1000000.0,0.0,18056791.480000094,2018,11,19,PAYEMENT,1000000.0,C465257140
14379,409000438620',2018-11-19,MAW/502964XXXXXX1757/NAGA,0.0,1400.0,18058191.480000094,2018,11,19,CHECK_CASHING,1400.0,M304845770
14380,409000438620',2018-11-19,AEPS INCOME DT 17-11-2018,0.0,5195.51,18063386.9900001,2018,11,19,TRANSFER,5195.51,C1970362900
14381,409000438620',2018-11-19,AEPS GST INC DT 17-11-201,0.0,1039.1,18064426.0900001,2018,11,19,CHECK_CASHING,1039.1,M403331570
14382,409000438620',2018-11-19,AEPS INCOME DT 18-11-2018,0.0,3586.1,18068012.190000106,2018,11,19,TRANSFER,3586.1,M1814241241
14383,409000438620',2018-11-19,AEPS GST INC DT 18-11-201,0.0,717.22,18068729.4100001,2018,11,19,CASH_IN,717.22,C1360767589
14384,409000438620',2018-11-19,AEPS PAY Indiaforensic 1711,0.0,198.58,18068927.9900001,2018,11,19,CHECK_CASHING,198.58,C801142660
14385,409000438620',2018-11-19,AEPS PAY Indiaforensic 1811,0.0,566.78,18069494.7700001,2018,11,19,TRANSFER,566.78,C1059781259
14386,409000438620',2018-11-19,MICRO ATM WDL FEE DT17111,0.0,601600.0,18671094.7700001,2018,11,19,CASH_IN,601600.0,C1333404258
14387,409000438620',2018-11-19,MICRO ATM INC DATED 17111,0.0,1332.36,18672427.1300001,2018,11,19,CASH_IN,1332.36,C2096057945
14388,409000438620',2018-11-19,MICRO ATM GST DATED 17111,0.0,266.47,18672693.600000106,2018,11,19,CHECK_CASHING,266.47,M1904341676
14389,409000438620',2018-11-19,MICRO ATM WDL FEE DT18111,0.0,965100.0,19637793.600000106,2018,11,19,CHECK_CASHING,965100.0,M170362945
14390,409000438620',2018-11-19,MICRO ATM INC DATED 18111,0.0,2026.08,19639819.680000097,2018,11,19,CHECK_CASHING,2026.08,M171967643
14391,409000438620',2018-11-19,MICRO ATM GST DATED 18111,0.0,405.22,19640224.90000009,2018,11,19,CASH_IN,405.22,M1767222317
14392,409000438620',2018-11-19,MICRO ATM WDL FEE DT19111,0.0,459500.0,20099724.90000009,2018,11,19,CASH_IN,459500.0,M1129371467
14393,409000438620',2018-11-19,MICRO ATM INC DATED 19111,0.0,1042.2,20100767.10000009,2018,11,19,CHECK_CASHING,1042.2,M1784389299
14394,409000438620',2018-11-19,MICRO ATM GST DATED 19111,0.0,208.44,20100975.540000096,2018,11,19,CASH_IN,208.44,M365026740
14395,409000438620',2018-11-19,TRF TO  Indiaforensic SERVICES I,2000000.0,0.0,18100975.540000096,2018,11,19,CASH_OUT,2000000.0,M1457233709
14396,409000438620',2018-11-20,MAW/502964XXXXXX3464/NAGA,0.0,1700.0,18102675.540000096,2018,11,20,CHECK_CASHING,1700.0,M1748266360
14397,409000438620',2018-11-20,Indiaforensic AEPS NPCI WDL SET,0.0,1844500.0,19947175.540000096,2018,11,20,TRANSFER,1844500.0,C964931693
14398,409000438620',2018-11-20,CB832010861463/RMCPL22055/1,500.0,0.0,19946675.540000096,2018,11,20,PAYEMENT,500.0,C701692548
14399,409000438620',2018-11-20,TRF TO Indiaforensic SERVICES IN,2200000.0,0.0,17746675.540000096,2018,11,20,PAYEMENT,2200000.0,M974209876
14400,409000438620',2018-11-20,MICRO ATM WDL FEE DT19111,0.0,493300.0,18239975.540000096,2018,11,20,TRANSFER,493300.0,C343534938
14401,409000438620',2018-11-20,MICRO ATM INC DATED 19111,0.0,1206.72,18241182.26000009,2018,11,20,CHECK_CASHING,1206.72,C1852606548
14402,409000438620',2018-11-20,MICRO ATM GST DATED 19111,0.0,241.34,18241423.60000009,2018,11,20,CASH_IN,241.34,M441827240
14403,409000438620',2018-11-20,NPCI_SETT_DIFF_191118,0.0,2000.0,18243423.60000009,2018,11,20,TRANSFER,2000.0,M329876656
14404,409000438620',2018-11-20,MICRO ATM WDL FEE DT20111,0.0,318400.0,18561823.60000009,2018,11,20,TRANSFER,318400.0,C58642425
14405,409000438620',2018-11-20,MICRO ATM INC DATED 20111,0.0,591.12,18562414.720000096,2018,11,20,CASH_IN,591.12,C408304912
14406,409000438620',2018-11-20,MICRO ATM GST DATED 20111,0.0,118.22,18562532.94000009,2018,11,20,CHECK_CASHING,118.22,C2029885969
14407,409000438620',2018-11-20,AEPS INCOME DT 19-11-2018,0.0,4638.4,18567171.340000093,2018,11,20,TRANSFER,4638.4,C1978557426
14408,409000438620',2018-11-20,AEPS GST INC DT 19-11-201,0.0,927.68,18568099.020000093,2018,11,20,CHECK_CASHING,927.68,C1231842708
14409,409000438620',2018-11-20,AEPS ACQ CR ADJ FEES 1911,2.95,0.0,18568096.070000093,2018,11,20,DEBIT,2.95,C2118255842
14410,409000438620',2018-11-21,Indiaforensic AEPS NPCI WDL SET,0.0,1895600.0,20463696.070000093,2018,11,21,TRANSFER,1895600.0,C1181708889
14411,409000438620',2018-11-21,AEPS INCOME DT 20-11-2018,0.0,4739.79,20468435.860000093,2018,11,21,CASH_IN,4739.79,C367746789
14412,409000438620',2018-11-21,AEPS GST INC DT 20-11-201,0.0,947.96,20469383.820000093,2018,11,21,TRANSFER,947.96,C1615804266
14413,409000438620',2018-11-21,FUND TRF TO  Indiaforensic SERVI,500000.0,0.0,19969383.820000093,2018,11,21,CASH_OUT,500000.0,C1589477624
14414,409000438620',2018-11-21,FUND TRF TO  Indiaforensic SERVI,2000000.0,0.0,17969383.820000093,2018,11,21,CASH_OUT,2000000.0,C1757252775
14415,409000438620',2018-11-21,MAW/502964XXXXXX9820/NAGA,0.0,1800.0,17971183.820000093,2018,11,21,CHECK_CASHING,1800.0,C1493103616
14416,409000438620',2018-11-22,Indiaforensic AEPS NPCI WDL SET,0.0,2048600.0,20019783.820000093,2018,11,22,TRANSFER,2048600.0,C12793273
14417,409000438620',2018-11-22,TRF TO  Indiaforensic SERVICES I,2300000.0,0.0,17719783.820000093,2018,11,22,DEBIT,2300000.0,C789195255
14418,409000438620',2018-11-22,AEPS PAY Indiaforensic 2011,0.0,298.23,17720082.050000094,2018,11,22,CHECK_CASHING,298.23,C815905200
14419,409000438620',2018-11-22,AEPS PAY Indiaforensic 2111,0.0,649.02,17720731.070000093,2018,11,22,CHECK_CASHING,649.02,C1825634724
14420,409000438620',2018-11-22,MICRO ATM WDL FEE DT20111,0.0,400000.0,18120731.070000093,2018,11,22,TRANSFER,400000.0,C424954008
14421,409000438620',2018-11-22,MICRO ATM INC DATED 20111,0.0,872.64,18121603.710000094,2018,11,22,CASH_IN,872.64,C1009195400
14422,409000438620',2018-11-22,MICRO ATM GST DATED 20111,0.0,174.53,18121778.24000009,2018,11,22,CHECK_CASHING,174.53,C1549086472
14423,409000438620',2018-11-22,MICRO ATM WDL FEE DT21111,0.0,303900.0,18425678.24000009,2018,11,22,CASH_IN,303900.0,C1358790036
14424,409000438620',2018-11-22,MICRO ATM INC DATED 21111,0.0,691.56,18426369.800000094,2018,11,22,CHECK_CASHING,691.56,C1031639563
14425,409000438620',2018-11-22,MICRO ATM GST DATED 21111,0.0,138.31,18426508.110000093,2018,11,22,CHECK_CASHING,138.31,C125722707
14426,409000438620',2018-11-22,MICRO ATM WDL FEE DT21111,0.0,449500.0,18876008.110000093,2018,11,22,TRANSFER,449500.0,C1316560467
14427,409000438620',2018-11-22,MICRO ATM INC DATED 21111,0.0,966.96,18876975.070000093,2018,11,22,CASH_IN,966.96,C1782113663
14428,409000438620',2018-11-22,MICRO ATM GST DATED 21111,0.0,193.39,18877168.460000094,2018,11,22,CASH_IN,193.39,C753265257
14429,409000438620',2018-11-22,AEPS INCOME DT 21-11-2018,0.0,5324.45,18882492.910000093,2018,11,22,CHECK_CASHING,5324.45,C1058921154
14430,409000438620',2018-11-22,AEPS GST INC DT 21-11-201,0.0,1064.89,18883557.800000094,2018,11,22,CHECK_CASHING,1064.89,M817887797
14431,409000438620',2018-11-22,MICRO ATM WDL FEE DT22111,0.0,377100.0,19260657.800000094,2018,11,22,TRANSFER,377100.0,C727209127
14432,409000438620',2018-11-22,MICRO ATM INC DATED 22111,0.0,795.6,19261453.40000009,2018,11,22,TRANSFER,795.6,M1044906440
14433,409000438620',2018-11-22,MICRO ATM GST DATED 22111,0.0,159.12,19261612.520000096,2018,11,22,CHECK_CASHING,159.12,M1009889405
14434,409000438620',2018-11-22,TRF TO  Indiaforensic SERVICES I,700000.0,0.0,18561612.520000096,2018,11,22,PAYEMENT,700000.0,M399780016
14435,409000438620',2018-11-22,NPCI_SETT_DIFF_211118,0.0,500.0,18562112.520000096,2018,11,22,TRANSFER,500.0,M517305833
14436,409000438620',2018-11-22,TRF TO  Indiaforensic SERVICES I,500000.0,0.0,18062112.520000096,2018,11,22,PAYEMENT,500000.0,M545666041
14437,409000438620',2018-11-23,Indiaforensic AEPS NPCI WDL SET,0.0,1735200.0,19797312.520000096,2018,11,23,CASH_IN,1735200.0,M248892114
14438,409000438620',2018-11-23,CR832412702280/RMCPL23968/2,2000.0,0.0,19795312.520000096,2018,11,23,DEBIT,2000.0,M27487002
14439,409000438620',2018-11-23,CR832311469065/RMCPL26200/1,1000.0,0.0,19794312.520000096,2018,11,23,PAYEMENT,1000.0,C185196393
14440,409000438620',2018-11-23,CR832310453101/RMCPL20722/1,2500.0,0.0,19791812.520000096,2018,11,23,CASH_OUT,2500.0,C1649686970
14441,409000438620',2018-11-23,AEPS INCOME DT 11-22-2018,0.0,4373.11,19796185.630000096,2018,11,23,CASH_IN,4373.11,M418913785
14442,409000438620',2018-11-23,AEPS GST INC DT 11-22-201,0.0,874.62,19797060.250000097,2018,11,23,TRANSFER,874.62,C577924039
14443,409000438620',2018-11-23,AEPS ACQ CR ADJ FEES 2211,32.45,0.0,19797027.800000094,2018,11,23,DEBIT,32.45,M1853776059
14444,409000438620',2018-11-23,MAW/502964XXXXXX0296/NAGA,0.0,400.0,19797427.800000094,2018,11,23,CHECK_CASHING,400.0,C151400576
14445,409000438620',2018-11-26,Indiaforensic AEPS NPCI WDL SET,0.0,1794800.0,21592227.800000094,2018,11,26,TRANSFER,1794800.0,C719119378
14446,409000438620',2018-11-26,Indiaforensic AEPS NPCI WDL SET,0.0,1855800.0,23448027.80000009,2018,11,26,CASH_IN,1855800.0,C121523915
14447,409000438620',2018-11-26,Indiaforensic AEPS NPCI WDL SET,0.0,1031800.0,24479827.80000009,2018,11,26,CHECK_CASHING,1031800.0,M847226474
14448,409000438620',2018-11-26,TRF TO  Indiaforensic SERVICES I,6800000.0,0.0,17679827.800000098,2018,11,26,DEBIT,6800000.0,C861958315
14449,409000438620',2018-11-26,MICRO ATM WDL FEE DT22111,0.0,398200.0,18078027.800000094,2018,11,26,CHECK_CASHING,398200.0,C1782704802
14450,409000438620',2018-11-26,MICRO ATM INC DATED 22111,0.0,884.16,18078911.960000094,2018,11,26,TRANSFER,884.16,M1676071452
14451,409000438620',2018-11-26,MICRO ATM GST DATED 22111,0.0,176.83,18079088.790000096,2018,11,26,TRANSFER,176.83,M408914073
14452,409000438620',2018-11-26,MICRO ATM WDL FEE DT23111,0.0,298600.0,18377688.790000096,2018,11,26,TRANSFER,298600.0,C1883840933
14453,409000438620',2018-11-26,MICRO ATM INC DATED 23111,0.0,588.6,18378277.390000094,2018,11,26,CHECK_CASHING,588.6,M2011228831
14454,409000438620',2018-11-26,MICRO ATM GST DATED 23111,0.0,117.72,18378395.110000096,2018,11,26,CASH_IN,117.72,C2131465140
14455,409000438620',2018-11-26,MICRO ATM WDL FEE DT23111,0.0,510800.0,18889195.110000096,2018,11,26,TRANSFER,510800.0,C899344442
14456,409000438620',2018-11-26,MICRO ATM INC DATED 23111,0.0,1071.36,18890266.470000096,2018,11,26,TRANSFER,1071.36,C1410669831
14457,409000438620',2018-11-26,MICRO ATM GST DATED 23111,0.0,214.27,18890480.74000009,2018,11,26,CHECK_CASHING,214.27,M1116071598
14458,409000438620',2018-11-26,AEPS PAY Indiaforensic 2211,0.0,99.64,18890580.380000096,2018,11,26,CHECK_CASHING,99.64,C885951223
14459,409000438620',2018-11-26,NPCI_SETT_DIFF_251118,0.0,700.0,18891280.380000096,2018,11,26,CASH_IN,700.0,M980027657
14460,409000438620',2018-11-26,AEPS INCOME DT 24-11-2018,0.0,4406.18,18895686.560000096,2018,11,26,TRANSFER,4406.18,C1060563153
14461,409000438620',2018-11-26,AEPS GST INC DT 24-11-201,0.0,881.24,18896567.800000094,2018,11,26,CASH_IN,881.24,C88296936
14462,409000438620',2018-11-26,AEPS INCOME DT 23-11-2018,0.0,4439.71,18901007.51000009,2018,11,26,CASH_IN,4439.71,C1089177065
14463,409000438620',2018-11-26,AEPS GST INC DT 23-11-201,0.0,887.94,18901895.450000096,2018,11,26,CHECK_CASHING,887.94,C142211154
14464,409000438620',2018-11-26,AEPS INCOME DT 25-11-2018,0.0,2505.3,18904400.750000097,2018,11,26,TRANSFER,2505.3,C2094777811
14465,409000438620',2018-11-26,AEPS GST INC DT 25-11-201,0.0,501.06,18904901.810000096,2018,11,26,CHECK_CASHING,501.06,M1012688086
14466,409000438620',2018-11-26,MICRO ATM WDL FEE DT24111,0.0,1504500.0,20409401.810000096,2018,11,26,CASH_IN,1504500.0,M62146645
14467,409000438620',2018-11-26,MICRO ATM INC DATED 24111,0.0,2821.32,20412223.130000096,2018,11,26,CASH_IN,2821.32,M2028506071
14468,409000438620',2018-11-26,MICRO ATM GST DATED 24111,0.0,564.26,20412787.390000094,2018,11,26,CASH_IN,564.26,M473513578
14469,409000438620',2018-11-26,MICRO ATM WDL FEE DT25111,0.0,1848700.0,22261487.390000094,2018,11,26,CASH_IN,1848700.0,M1857664802
14470,409000438620',2018-11-26,MICRO ATM INC DATED 25111,0.0,3545.28,22265032.670000106,2018,11,26,CHECK_CASHING,3545.28,M2004857056
14471,409000438620',2018-11-26,MICRO ATM GST DATED 25111,0.0,709.06,22265741.730000094,2018,11,26,CASH_IN,709.06,C1486249495
14472,409000438620',2018-11-26,AEPS PAY Indiaforensic 2411,0.0,99.64,22265841.370000094,2018,11,26,CHECK_CASHING,99.64,M1034417982
14473,409000438620',2018-11-26,AEPS PAY Indiaforensic 2511,0.0,2997.93,22268839.300000094,2018,11,26,CHECK_CASHING,2997.93,C1682576062
14474,409000438620',2018-11-26,MICRO ATM WDL FEE DT26111,0.0,458800.0,22727639.30000009,2018,11,26,CHECK_CASHING,458800.0,C1354952534
14475,409000438620',2018-11-26,MICRO ATM INC DATED 26111,0.0,814.68,22728453.98000009,2018,11,26,CASH_IN,814.68,M198500322
14476,409000438620',2018-11-26,MICRO ATM GST DATED 26111,0.0,162.94,22728616.920000106,2018,11,26,CHECK_CASHING,162.94,M1627040914
14477,409000438620',2018-11-26,TRF TO  Indiaforensic SERVICES I,3400000.0,0.0,19328616.920000106,2018,11,26,CASH_OUT,3400000.0,M38068589
14478,409000438620',2018-11-26,TRF TO  Indiaforensic SERVICES I,1200000.0,0.0,18128616.920000106,2018,11,26,CASH_OUT,1200000.0,M1340296605
14479,409000438620',2018-11-27,Indiaforensic AEPS NPCI WDL SET,0.0,1860300.0,19988916.920000106,2018,11,27,CASH_IN,1860300.0,M1433471854
14480,409000438620',2018-11-27,CR832611095003/RMCPL20722/2,2000.0,0.0,19986916.920000106,2018,11,27,PAYEMENT,2000.0,M1037917490
14481,409000438620',2018-11-27,CR832611094944/RMCPL21595/2,800.0,0.0,19986116.920000106,2018,11,27,DEBIT,800.0,M1317246320
14482,409000438620',2018-11-27,CR832612111054/RMCPL20307/2,6000.0,0.0,19980116.920000106,2018,11,27,DEBIT,6000.0,M1248074575
14483,409000438620',2018-11-27,TRF TO  Indiaforensic SERVICES I,2300000.0,0.0,17680116.920000102,2018,11,27,DEBIT,2300000.0,M770665105
14484,409000438620',2018-11-27,ACQ CB 4592000001871736 1,9000.0,0.0,17671116.920000102,2018,11,27,CHECK_WITHDRAWAL,9000.0,M1695997193
14485,409000438620',2018-11-27,ACQ CB 6070606000153409 6,2500.0,0.0,17668616.920000102,2018,11,27,CHECK_WITHDRAWAL,2500.0,C1934837365
14486,409000438620',2018-11-27,ACQ CB 6070936085442470 8,1000.0,0.0,17667616.920000102,2018,11,27,CHECK_WITHDRAWAL,1000.0,C1280512370
14487,409000438620',2018-11-27,MICRO ATM WDL FEE DT26111,0.0,894900.0,18562516.920000106,2018,11,27,CASH_IN,894900.0,M704999142
14488,409000438620',2018-11-27,MICRO ATM INC DATED 26111,0.0,1514.52,18564031.440000106,2018,11,27,TRANSFER,1514.52,M380583742
14489,409000438620',2018-11-27,MICRO ATM GST DATED 26111,0.0,302.9,18564334.340000097,2018,11,27,CASH_IN,302.9,C1017980078
14490,409000438620',2018-11-27,AEPS INCOME DT 26-11-2018,0.0,4503.22,18568837.560000096,2018,11,27,TRANSFER,4503.22,M361452948
14491,409000438620',2018-11-27,AEPS GST INC DT 26-11-201,0.0,900.64,18569738.200000096,2018,11,27,CHECK_CASHING,900.64,M884872785
14492,409000438620',2018-11-27,MICRO ATM WDL FEE DT27111,0.0,283400.0,18853138.200000096,2018,11,27,CHECK_CASHING,283400.0,C693147508
14493,409000438620',2018-11-27,MICRO ATM INC DATED 27111,0.0,624.96,18853763.160000093,2018,11,27,CASH_IN,624.96,M1095999207
14494,409000438620',2018-11-27,MICRO ATM GST DATED 27111,0.0,124.99,18853888.15000009,2018,11,27,CHECK_CASHING,124.99,M2022415879
14495,409000438620',2018-11-27,AEPS ACQ CR ADJ FEES 2611,34.22,0.0,18853853.930000097,2018,11,27,PAYEMENT,34.22,M1366443797
14496,409000438620',2018-11-27,TRF TO  Indiaforensic SERVICES I,1100000.0,0.0,17753853.930000097,2018,11,27,CASH_OUT,1100000.0,M684408350
14497,409000438620',2018-11-28,Indiaforensic AEPS NPCI WDL SET,0.0,1604700.0,19358553.930000097,2018,11,28,TRANSFER,1604700.0,C221632586
14498,409000438620',2018-11-28,MICRO ATM WDL FEE DT27111,0.0,579500.0,19938053.930000097,2018,11,28,TRANSFER,579500.0,C33837320
14499,409000438620',2018-11-28,MICRO ATM INC DATED 27111,0.0,1094.76,19939148.690000106,2018,11,28,CASH_IN,1094.76,C1859795678
14500,409000438620',2018-11-28,MICRO ATM GST DATED 27111,0.0,218.95,19939367.640000094,2018,11,28,CHECK_CASHING,218.95,M516278495
14501,409000438620',2018-11-28,TRF TO  Indiaforensic SERVICES I,2000000.0,0.0,17939367.640000094,2018,11,28,CASH_OUT,2000000.0,C1469084143
14502,409000438620',2018-11-28,AEPS PAY Indiaforensic 2711,0.0,298.93,17939666.570000093,2018,11,28,TRANSFER,298.93,M1340027439
14503,409000438620',2018-11-28,MICRO ATM WDL FEE DT28111,0.0,305900.0,18245566.570000093,2018,11,28,CHECK_CASHING,305900.0,C157316544
14504,409000438620',2018-11-28,MICRO ATM INC DATED 28111,0.0,632.88,18246199.450000096,2018,11,28,CASH_IN,632.88,M793786399
14505,409000438620',2018-11-28,MICRO ATM GST DATED 28111,0.0,126.58,18246326.030000094,2018,11,28,CASH_IN,126.58,M35575758
14506,409000438620',2018-11-28,AEPS INCOME DT 27-11-2018,0.0,3847.93,18250173.960000094,2018,11,28,TRANSFER,3847.93,C1849941462
14507,409000438620',2018-11-28,AEPS GST INC DT 27-11-201,0.0,769.59,18250943.550000094,2018,11,28,CHECK_CASHING,769.59,M857625325
14508,409000438620',2018-11-28,ACQ CB 6075320177393914 1,6500.0,0.0,18244443.550000094,2018,11,28,CASH_OUT,6500.0,M1621572456
14509,409000438620',2018-11-28,ACQ CB 5272530000910584 7,8500.0,0.0,18235943.550000094,2018,11,28,CASH_OUT,8500.0,C1419794148
14510,409000438620',2018-11-28,TRF TO  Indiaforensic SERVICES I,500000.0,0.0,17735943.550000094,2018,11,28,CHECK_WITHDRAWAL,500000.0,M1340311340
14511,409000438620',2018-11-29,Indiaforensic AEPS NPCI WDL SET,0.0,1440900.0,19176843.550000094,2018,11,29,CHECK_CASHING,1440900.0,M1375211559
14512,409000438620',2018-11-29,CR832918874554/RMCPL22659/2,3000.0,0.0,19173843.550000094,2018,11,29,PAYEMENT,3000.0,M1099305828
14513,409000438620',2018-11-29,CR833012031551/RMCPL23018/2,1500.0,0.0,19172343.550000094,2018,11,29,PAYEMENT,1500.0,M1917083500
14514,409000438620',2018-11-29,TRF TO  Indiaforensic SERVICES I,1500000.0,0.0,17672343.550000094,2018,11,29,PAYEMENT,1500000.0,M1747667177
14515,409000438620',2018-11-29,AEPS PAY Indiaforensic 2811,0.0,9993.8,17682337.350000095,2018,11,29,TRANSFER,9993.8,M1006356201
14516,409000438620',2018-11-29,MICRO ATM WDL FEE DT28111,0.0,421000.0,18103337.35000009,2018,11,29,CHECK_CASHING,421000.0,M736890890
14517,409000438620',2018-11-29,MICRO ATM INC DATED 28111,0.0,842.76,18104180.110000096,2018,11,29,CASH_IN,842.76,M122063374
14518,409000438620',2018-11-29,MICRO ATM GST DATED 28111,0.0,168.55,18104348.660000093,2018,11,29,CHECK_CASHING,168.55,C219771880
14519,409000438620',2018-11-29,AEPS INCOME DT 28-11-2018,0.0,3756.46,18108105.120000094,2018,11,29,TRANSFER,3756.46,M1526009370
14520,409000438620',2018-11-29,AEPS GST INC DT 28-11-201,0.0,751.29,18108856.410000093,2018,11,29,CHECK_CASHING,751.29,C1114260225
14521,409000438620',2018-11-29,MICRO ATM WDL FEE DT29111,0.0,275000.0,18383856.410000093,2018,11,29,TRANSFER,275000.0,M459988247
14522,409000438620',2018-11-29,MICRO ATM INC DATED 29111,0.0,566.64,18384423.050000094,2018,11,29,TRANSFER,566.64,C90486891
14523,409000438620',2018-11-29,MICRO ATM GST DATED 29111,0.0,113.33,18384536.380000096,2018,11,29,CASH_IN,113.33,C1320515149
14524,409000438620',2018-11-29,AEPS ACQ CR ADJ FEES 2811,26.55,0.0,18384509.83000009,2018,11,29,CASH_OUT,26.55,C2040657244
14525,409000438620',2018-11-29,TRF TO  Indiaforensic SERVICES I,700000.0,0.0,17684509.830000095,2018,11,29,PAYEMENT,700000.0,M1030120916
14526,409000438620',2018-11-30,Indiaforensic AEPS NPCI WDL SET,0.0,1618400.0,19302909.83000009,2018,11,30,CASH_IN,1618400.0,M1516744681
14527,409000438620',2018-11-30,AEPS PAY Indiaforensic 2911,0.0,999.11,19303908.94000009,2018,11,30,TRANSFER,999.11,C33524623
14528,409000438620',2018-11-30,TRF TO  Indiaforensic SERVICES I,1600000.0,0.0,17703908.940000094,2018,11,30,CHECK_WITHDRAWAL,1600000.0,M1298035508
14529,409000438620',2018-11-30,MICRO ATM WDL FEE DT29111,0.0,310800.0,18014708.94000009,2018,11,30,CHECK_CASHING,310800.0,M1000084562
14530,409000438620',2018-11-30,MICRO ATM INC DATED 29111,0.0,722.88,18015431.820000093,2018,11,30,TRANSFER,722.88,M775386766
14531,409000438620',2018-11-30,MICRO ATM GST DATED 29111,0.0,144.58,18015576.40000009,2018,11,30,CHECK_CASHING,144.58,C515132998
14532,409000438620',2018-11-30,MICRO ATM WDL FEE DT30111,0.0,350300.0,18365876.40000009,2018,11,30,CHECK_CASHING,350300.0,C1359484306
14533,409000438620',2018-11-30,MICRO ATM INC DATED 30111,0.0,581.04,18366457.44000009,2018,11,30,TRANSFER,581.04,M625048700
14534,409000438620',2018-11-30,MICRO ATM GST DATED 30111,0.0,116.21,18366573.65000009,2018,11,30,TRANSFER,116.21,C847761155
14535,409000438620',2018-11-30,AEPS INCOME DT 29-11-2018,0.0,4169.23,18370742.88000009,2018,11,30,TRANSFER,4169.23,M1554736215
14536,409000438620',2018-11-30,AEPS GST INC DT 29-11-201,0.0,833.85,18371576.730000094,2018,11,30,TRANSFER,833.85,C456538529
14537,409000438620',2018-11-30,TRF TO  Indiaforensic SERVICES I,700000.0,0.0,17671576.730000094,2018,11,30,PAYEMENT,700000.0,C1636786811
14538,409000438620',2018-12-01,MAW/502964XXXXXX0486/NAGA,0.0,1000.0,17672576.730000094,2018,12,1,TRANSFER,1000.0,C766681183
14539,409000438620',2018-12-01,Indiaforensic AEPS NPCI WDL SET,0.0,1690700.0,19363276.730000094,2018,12,1,CHECK_CASHING,1690700.0,M55646850
14540,409000438620',2018-12-01,CR833114309116/RMCPL18983/2,500.0,0.0,19362776.730000094,2018,12,1,PAYEMENT,500.0,C2003714184
14541,409000438620',2018-12-01,CR833110249727/RMCPL16457/2,500.0,0.0,19362276.730000094,2018,12,1,CASH_OUT,500.0,C471003380
14542,409000438620',2018-12-01,NPCI_SETT_DIFF_301118,0.0,5000.0,19367276.730000094,2018,12,1,CHECK_CASHING,5000.0,C2104652067
14543,409000438620',2018-12-01,TRF TO  Indiaforensic SERVICES I,1000000.0,0.0,18367276.730000094,2018,12,1,PAYEMENT,1000000.0,C2141994208
14544,409000438620',2018-12-01,AEPS INCOME DT 30-11-2018,0.0,4283.02,18371559.750000093,2018,12,1,CHECK_CASHING,4283.02,C1220897602
14545,409000438620',2018-12-01,AEPS GST INC DT 30-11-201,0.0,856.6,18372416.35000009,2018,12,1,TRANSFER,856.6,C611621587
14546,409000438620',2018-12-01,AEPS ACQ CR ADJ FEES 3011,5.9,0.0,18372410.450000096,2018,12,1,CHECK_WITHDRAWAL,5.9,C1760872167
14547,409000438620',2018-12-01,MICRO ATM WDL FEE DT30111,0.0,556500.0,18928910.450000096,2018,12,1,CASH_IN,556500.0,C508000580
14548,409000438620',2018-12-01,MICRO ATM INC DATED 30111,0.0,1090.8,18930001.250000097,2018,12,1,CASH_IN,1090.8,C128870695
14549,409000438620',2018-12-01,MICRO ATM GST DATED 30111,0.0,218.16,18930219.410000093,2018,12,1,CHECK_CASHING,218.16,C2086207545
14550,409000438620',2018-12-01,MICRO ATM WDL FEE DT01121,0.0,271900.0,19202119.410000093,2018,12,1,CASH_IN,271900.0,C1262016786
14551,409000438620',2018-12-01,MICRO ATM INC DATED 01121,0.0,533.52,19202652.930000097,2018,12,1,TRANSFER,533.52,C781231070
14552,409000438620',2018-12-01,MICRO ATM GST DATED 01121,0.0,106.7,19202759.630000096,2018,12,1,CHECK_CASHING,106.7,M1548056691
14553,409000438620',2018-12-03,Indiaforensic AEPS NPCI WDL SET,0.0,1802800.0,21005559.630000096,2018,12,3,CHECK_CASHING,1802800.0,C1095446005
14554,409000438620',2018-12-03,Indiaforensic AEPS NPCI WDL SET,0.0,849900.0,21855459.630000096,2018,12,3,TRANSFER,849900.0,M169055344
14555,409000438620',2018-12-03,MAW/502964XXXXXX0502/NAGA,0.0,700.0,21856159.630000096,2018,12,3,TRANSFER,700.0,M445582107
14556,409000438620',2018-12-03,TRF TO  Indiaforensic SERVICES I,4100000.0,0.0,17756159.630000096,2018,12,3,CASH_OUT,4100000.0,M1090343725
14557,409000438620',2018-12-03,MICRO ATM WDL FEE DT01121,0.0,561700.0,18317859.630000096,2018,12,3,CHECK_CASHING,561700.0,M1222467309
14558,409000438620',2018-12-03,MICRO ATM INC DATED 01121,0.0,998.28,18318857.910000093,2018,12,3,TRANSFER,998.28,M1806551715
14559,409000438620',2018-12-03,MICRO ATM GST DATED 01121,0.0,199.66,18319057.570000093,2018,12,3,TRANSFER,199.66,C295081230
14560,409000438620',2018-12-03,MICRO ATM WDL FEE DT02121,0.0,1057300.0,19376357.570000093,2018,12,3,CASH_IN,1057300.0,M2089552359
14561,409000438620',2018-12-03,MICRO ATM INC DATED 02121,0.0,2221.2,19378578.770000096,2018,12,3,CHECK_CASHING,2221.2,M1221586907
14562,409000438620',2018-12-03,MICRO ATM GST DATED 02121,0.0,444.24,19379023.01000009,2018,12,3,TRANSFER,444.24,C929266212
14563,409000438620',2018-12-03,AEPS PAY Indiaforensic 0212,0.0,318.22,19379341.230000094,2018,12,3,TRANSFER,318.22,M2009085915
14564,409000438620',2018-12-03,NPCI SETELEMENT DIFF_0212,0.0,7500.0,19386841.230000094,2018,12,3,TRANSFER,7500.0,C380928130
14565,409000438620',2018-12-03,MICRO ATM WDL FEE DT03121,0.0,412000.0,19798841.230000094,2018,12,3,TRANSFER,412000.0,M603445758
14566,409000438620',2018-12-03,MICRO ATM INC DATED 03121,0.0,815.76,19799656.99000009,2018,12,3,CASH_IN,815.76,M548550915
14567,409000438620',2018-12-03,MICRO ATM GST DATED 03121,0.0,163.15,19799820.140000094,2018,12,3,CASH_IN,163.15,M2112616964
14568,409000438620',2018-12-03,TRF TO  Indiaforensic SERVICES I,1700000.0,0.0,18099820.140000094,2018,12,3,PAYEMENT,1700000.0,M1662374536
14569,409000438620',2018-12-03,AEPS INCOME DT 01-12-2018,0.0,4363.47,18104183.610000093,2018,12,3,TRANSFER,4363.47,C1161865950
14570,409000438620',2018-12-03,AEPS GST INC DT 01-12-201,0.0,872.69,18105056.300000094,2018,12,3,CHECK_CASHING,872.69,C668849042
14571,409000438620',2018-12-03,AEPS INCOME DT 02-12-2018,0.0,2312.73,18107369.030000094,2018,12,3,CHECK_CASHING,2312.73,M1036008427
14572,409000438620',2018-12-03,AEPS GST INC DT 02-12-201,0.0,462.55,18107831.58000009,2018,12,3,CHECK_CASHING,462.55,M1347332959
14573,409000438620',2018-12-03,TRF TO  Indiaforensic SERVICES I,400000.0,0.0,17707831.580000095,2018,12,3,PAYEMENT,400000.0,C1220897602
14574,409000438620',2018-12-04,Indiaforensic AEPS NPCI WDL SET,0.0,1325300.0,19033131.58000009,2018,12,4,TRANSFER,1325300.0,M1365953906
14575,409000438620',2018-12-04,MAW/502964XXXXXX9796/NAGA,0.0,200.0,19033331.58000009,2018,12,4,TRANSFER,200.0,C748241311
14576,409000438620',2018-12-04,TRF TO  Indiaforensic SERVICES I,1300000.0,0.0,17733331.580000095,2018,12,4,PAYEMENT,1300000.0,M1408917055
14577,409000438620',2018-12-04,MICRO ATM WDL FEE DT03121,0.0,589900.0,18323231.58000009,2018,12,4,TRANSFER,589900.0,C119355254
14578,409000438620',2018-12-04,MICRO ATM INC DATED 03121,0.0,1119.24,18324350.820000093,2018,12,4,CASH_IN,1119.24,M829190748
14579,409000438620',2018-12-04,MICRO ATM GST DATED 03121,0.0,223.85,18324574.67000009,2018,12,4,CHECK_CASHING,223.85,M74285291
14580,409000438620',2018-12-04,TRF TO  Indiaforensic SERVICES I,600000.0,0.0,17724574.670000095,2018,12,4,CASH_OUT,600000.0,M1078420933
14581,409000438620',2018-12-04,MICRO ATM WDL FEE DT04121,0.0,471900.0,18196474.67000009,2018,12,4,TRANSFER,471900.0,M778725186
14582,409000438620',2018-12-04,MICRO ATM INC DATED 04121,0.0,843.12,18197317.790000096,2018,12,4,TRANSFER,843.12,C1749476584
14583,409000438620',2018-12-04,MICRO ATM GST DATED 04121,0.0,168.62,18197486.410000093,2018,12,4,TRANSFER,168.62,C2043257128
14584,409000438620',2018-12-04,AEPS INCOME DT 03-12-2018,0.0,3289.55,18200775.960000094,2018,12,4,TRANSFER,3289.55,M1647042524
14585,409000438620',2018-12-04,AEPS GST INC DT 03-12-201,0.0,657.91,18201433.870000094,2018,12,4,TRANSFER,657.91,C413046895
14586,409000438620',2018-12-04,AEPS PAY Indiaforensic 0312,0.0,5695.46,18207129.330000106,2018,12,4,CASH_IN,5695.46,M551883889
14587,409000438620',2018-12-05,Indiaforensic AEPS NPCI WDL SET,0.0,1349000.0,19556129.330000106,2018,12,5,CASH_IN,1349000.0,C1201057368
14588,409000438620',2018-12-05,TRF TO  Indiaforensic SERVICES I,1800000.0,0.0,17756129.330000106,2018,12,5,CHECK_WITHDRAWAL,1800000.0,M823002953
14589,409000438620',2018-12-05,PEN 6070935006380173 6807,2300.0,0.0,17753829.330000106,2018,12,5,PAYEMENT,2300.0,C715819458
14590,409000438620',2018-12-05,PRE ACC 6070935006380173,10000.0,0.0,17743829.330000106,2018,12,5,DEBIT,10000.0,C1838584624
14591,409000438620',2018-12-05,MICRO ATM WDL FEE DT04121,0.0,509200.0,18253029.330000106,2018,12,5,CHECK_CASHING,509200.0,C2096057945
14592,409000438620',2018-12-05,MICRO ATM INC DATED 04121,0.0,975.6,18254004.9300001,2018,12,5,CHECK_CASHING,975.6,C413177525
14593,409000438620',2018-12-05,MICRO ATM GST DATED 04121,0.0,195.12,18254200.0500001,2018,12,5,CASH_IN,195.12,C1797686173
14594,409000438620',2018-12-05,AEPS PAY Indiaforensic 0412,0.0,99.64,18254299.690000106,2018,12,5,CHECK_CASHING,99.64,C453211571
14595,409000438620',2018-12-05,AEPS INCOME DT 04-12-2018,0.0,3260.27,18257559.9600001,2018,12,5,CHECK_CASHING,3260.27,C1220911229
14596,409000438620',2018-12-05,AEPS GST INC DT 04-12-201,0.0,652.05,18258212.010000106,2018,12,5,CASH_IN,652.05,C1419794148
14597,409000438620',2018-12-05,MICRO ATM WDL FEE DT05121,0.0,296200.0,18554412.010000106,2018,12,5,CASH_IN,296200.0,C720759478
14598,409000438620',2018-12-05,MICRO ATM INC DATED 05121,0.0,507.96,18554919.970000107,2018,12,5,CASH_IN,507.96,C423580937
14599,409000438620',2018-12-05,MICRO ATM GST DATED 05121,0.0,101.59,18555021.560000107,2018,12,5,CASH_IN,101.59,C1730752455
14600,409000438620',2018-12-05,TRF TO  Indiaforensic SERVICES I,800000.0,0.0,17755021.560000107,2018,12,5,DEBIT,800000.0,C237988421
14601,409000438620',2018-12-06,Indiaforensic AEPS NPCI WDL SET,0.0,1425700.0,19180721.560000107,2018,12,6,CASH_IN,1425700.0,C2017484544
14602,409000438620',2018-12-06,CR832113073938/RMCPL28013/1,199.0,0.0,19180522.560000107,2018,12,6,CASH_OUT,199.0,C954723689
14603,409000438620',2018-12-06,CR832217329380/RMCPL25130/1,210.0,0.0,19180312.560000107,2018,12,6,CASH_OUT,210.0,C97730845
14604,409000438620',2018-12-06,CR832517966150/RMCPL29319/2,500.0,0.0,19179812.560000107,2018,12,6,DEBIT,500.0,C1075238398
14605,409000438620',2018-12-06,CR833120394407/RMCPL27997/2,100.0,0.0,19179712.560000107,2018,12,6,CHECK_WITHDRAWAL,100.0,C623476050
14606,409000438620',2018-12-06,CR833120394873/RMCPL27997/2,100.0,0.0,19179612.560000107,2018,12,6,CHECK_WITHDRAWAL,100.0,C347696158
14607,409000438620',2018-12-06,TRF TO  Indiaforensic SERVICES I,1500000.0,0.0,17679612.560000107,2018,12,6,PAYEMENT,1500000.0,C1538264524
14608,409000438620',2018-12-06,AEPS INCOME DT 05-12-2018,0.0,3810.27,17683422.830000106,2018,12,6,CASH_IN,3810.27,C473344802
14609,409000438620',2018-12-06,AEPS GST INC DT 05-12-201,0.0,762.05,17684184.880000103,2018,12,6,CHECK_CASHING,762.05,C2089016471
14610,409000438620',2018-12-06,AEPS ACQ REP ADJ FEES 051,0.0,0.67,17684185.550000105,2018,12,6,TRANSFER,0.67,C1076835071
14611,409000438620',2018-12-06,MICRO ATM WDL FEE DT05121,0.0,359000.0,18043185.550000105,2018,12,6,TRANSFER,359000.0,C1475395523
14612,409000438620',2018-12-06,MICRO ATM INC DATED 05121,0.0,758.88,18043944.430000104,2018,12,6,CHECK_CASHING,758.88,C1337741679
14613,409000438620',2018-12-06,MICRO ATM GST DATED 05121,0.0,151.78,18044096.210000105,2018,12,6,CASH_IN,151.78,C1832580921
14614,409000438620',2018-12-06,MICRO ATM WDL FEE DT06121,0.0,272900.0,18316996.210000105,2018,12,6,TRANSFER,272900.0,C505973878
14615,409000438620',2018-12-06,MICRO ATM INC DATED 06121,0.0,502.2,18317498.410000104,2018,12,6,TRANSFER,502.2,C450960851
14616,409000438620',2018-12-06,MICRO ATM GST DATED 06121,0.0,100.44,18317598.850000106,2018,12,6,TRANSFER,100.44,C259915853
14617,409000438620',2018-12-07,MAW/502964XXXXXX9796/NAGA,0.0,1000.0,18318598.850000106,2018,12,7,TRANSFER,1000.0,C674913323
14618,409000438620',2018-12-07,Indiaforensic AEPS NPCI WDL SET,0.0,1328700.0,19647298.850000106,2018,12,7,CASH_IN,1328700.0,C478793413
14619,409000438620',2018-12-07,MAW/502964XXXXXX7050/NAGA,0.0,1200.0,19648498.850000106,2018,12,7,CHECK_CASHING,1200.0,C173783788
14620,409000438620',2018-12-07,MAW/502964XXXXXX7068/NAGA,0.0,1200.0,19649698.850000106,2018,12,7,TRANSFER,1200.0,C991505714
14621,409000438620',2018-12-07,MAW/502964XXXXXX8155/NAGA,0.0,1200.0,19650898.850000106,2018,12,7,CHECK_CASHING,1200.0,C97730845
14622,409000438620',2018-12-07,TRF TO  Indiaforensic SERVICES I,1900000.0,0.0,17750898.850000106,2018,12,7,PAYEMENT,1900000.0,C1089177065
14623,409000438620',2018-12-07,AEPS PAY Indiaforensic 0612,0.0,199.58,17751098.430000104,2018,12,7,CASH_IN,199.58,C36856762
14624,409000438620',2018-12-07,MICRO ATM WDL FEE DT06121,0.0,387700.0,18138798.430000104,2018,12,7,CASH_IN,387700.0,C1089993541
14625,409000438620',2018-12-07,MICRO ATM INC DATED 06121,0.0,774.72,18139573.150000107,2018,12,7,CASH_IN,774.72,C33524623
14626,409000438620',2018-12-07,MICRO ATM GST DATED 06121,0.0,154.94,18139728.090000104,2018,12,7,CHECK_CASHING,154.94,C579802590
14627,409000438620',2018-12-07,AEPS INCOME DT 12-06-2018,0.0,3403.27,18143131.360000104,2018,12,7,CHECK_CASHING,3403.27,C2063763486
14628,409000438620',2018-12-07,AEPS GST DT 12-06-2018 RO,0.0,680.65,18143812.010000106,2018,12,7,CHECK_CASHING,680.65,C2086207545
14629,409000438620',2018-12-07,MICRO ATM WDL FEE DT07121,0.0,313500.0,18457312.010000106,2018,12,7,CHECK_CASHING,313500.0,M595330956
14630,409000438620',2018-12-07,MICRO ATM INC DATED 07121,0.0,568.44,18457880.450000104,2018,12,7,CASH_IN,568.44,M2085258187
14631,409000438620',2018-12-07,MICRO ATM GST DATED 07121,0.0,113.69,18457994.140000105,2018,12,7,CASH_IN,113.69,M1013061691
14632,409000438620',2018-12-08,MAW/502964XXXXXX3464/NAGA,0.0,900.0,18458894.140000105,2018,12,8,CASH_IN,900.0,M2071559356
14633,409000438620',2018-12-10,Indiaforensic AEPS NPCI WDL SET,0.0,1220600.0,19679494.140000105,2018,12,10,TRANSFER,1220600.0,M568369641
14634,409000438620',2018-12-10,Indiaforensic AEPS NPCI WDL SET,0.0,1349600.0,21029094.140000105,2018,12,10,TRANSFER,1349600.0,M1845197850
14635,409000438620',2018-12-10,CR833811008170/RMCPL22655/4,900.0,0.0,21028194.140000105,2018,12,10,DEBIT,900.0,M976305662
14636,409000438620',2018-12-10,CR833710717768/RMCPL16869/3,3000.0,0.0,21025194.140000105,2018,12,10,CHECK_WITHDRAWAL,3000.0,M1779501822
14637,409000438620',2018-12-10,Indiaforensic AEPS NPCI WDL SET,0.0,791000.0,21816194.140000105,2018,12,10,TRANSFER,791000.0,M369658674
14638,409000438620',2018-12-10,TRF TO  Indiaforensic SERVICES I,4000000.0,0.0,17816194.140000105,2018,12,10,PAYEMENT,4000000.0,M1293935617
14639,409000438620',2018-12-10,MICRO ATM WDL FEE DT07121,0.0,460600.0,18276794.140000105,2018,12,10,CHECK_CASHING,460600.0,M378887120
14640,409000438620',2018-12-10,MICRO ATM INC DATED 07121,0.0,867.96,18277662.100000106,2018,12,10,CASH_IN,867.96,M1371115302
14641,409000438620',2018-12-10,MICRO ATM GST DATED 07121,0.0,173.59,18277835.690000106,2018,12,10,TRANSFER,173.59,M434576658
14642,409000438620',2018-12-10,MICRO ATM WDL FEE DT08121,0.0,1180700.0,19458535.690000106,2018,12,10,CASH_IN,1180700.0,M1170895776
14643,409000438620',2018-12-10,MICRO ATM INC DATED 08121,0.0,2292.12,19460827.810000107,2018,12,10,TRANSFER,2292.12,M1167649130
14644,409000438620',2018-12-10,MICRO ATM GST DATED 08121,0.0,458.42,19461286.23000011,2018,12,10,CHECK_CASHING,458.42,M857153604
14645,409000438620',2018-12-10,MICRO ATM WDL FEE DT09121,0.0,874300.0,20335586.23000011,2018,12,10,TRANSFER,874300.0,M1721508464
14646,409000438620',2018-12-10,MICRO ATM INC DATED 09121,0.0,1829.16,20337415.39000011,2018,12,10,CASH_IN,1829.16,M2042731097
14647,409000438620',2018-12-10,MICRO ATM GST DATED 09121,0.0,365.83,20337781.220000107,2018,12,10,CASH_IN,365.83,M1890307705
14648,409000438620',2018-12-10,NPCI SETELEMENT DIFF_0812,0.0,1000.0,20338781.220000107,2018,12,10,TRANSFER,1000.0,M35617759
14649,409000438620',2018-12-10,NPCI SETELEMENT DIFF_0912,0.0,10000.0,20348781.220000107,2018,12,10,CHECK_CASHING,10000.0,M1153987838
14650,409000438620',2018-12-10,AEPS INC DT 07-12-2018 RO,0.0,3139.1,20351920.32000011,2018,12,10,CHECK_CASHING,3139.1,M51811753
14651,409000438620',2018-12-10,AEPS GST INC DT 07-12-201,0.0,627.82,20352548.14000011,2018,12,10,CHECK_CASHING,627.82,M459373281
14652,409000438620',2018-12-10,AEPS INC DT 08-12-2018 RO,0.0,3455.31,20356003.450000107,2018,12,10,CASH_IN,3455.31,C1565462485
14653,409000438620',2018-12-10,AEPS GST INC DT 08-12-201,0.0,691.06,20356694.510000106,2018,12,10,CHECK_CASHING,691.06,C1744423762
14654,409000438620',2018-12-10,AEPS INC DT 09-12-2018 RO,0.0,1939.69,20358634.200000107,2018,12,10,CHECK_CASHING,1939.69,M1617279923
14655,409000438620',2018-12-10,AEPS GST INC DT 09-12-201,0.0,387.94,20359022.14000011,2018,12,10,CHECK_CASHING,387.94,M882463693
14656,409000438620',2018-12-10,AEPS ACQ CR ADJ FEES 0712,23.01,0.0,20358999.130000107,2018,12,10,DEBIT,23.01,M315473568
14657,409000438620',2018-12-10,MICRO ATM WDL FEE DT10121,0.0,378600.0,20737599.130000107,2018,12,10,TRANSFER,378600.0,C1371191175
14658,409000438620',2018-12-10,MICRO ATM INC DATED 10121,0.0,747.36,20738346.490000106,2018,12,10,CHECK_CASHING,747.36,C1892922524
14659,409000438620',2018-12-10,MICRO ATM GST DATED 10121,0.0,149.47,20738495.960000105,2018,12,10,CHECK_CASHING,149.47,C1313534832
14660,409000438620',2018-12-10,AEPS PAY Indiaforensic 0712,0.0,999.11,20739495.070000105,2018,12,10,CASH_IN,999.11,M970407658
14661,409000438620',2018-12-11,Indiaforensic AEPS NPCI WDL SET,0.0,1434900.0,22174395.070000105,2018,12,11,TRANSFER,1434900.0,C1761353343
14662,409000438620',2018-12-11,TRF TO  Indiaforensic SERVICES I,4500000.0,0.0,17674395.070000105,2018,12,11,DEBIT,4500000.0,M336064732
14663,409000438620',2018-12-11,AEPS PAY Indiaforensic 1012,0.0,279.53,17674674.600000106,2018,12,11,CASH_IN,279.53,C623476050
14664,409000438620',2018-12-11,MICRO ATM WDL FEE DT10121,0.0,663500.0,18338174.600000106,2018,12,11,TRANSFER,663500.0,C1979001148
14665,409000438620',2018-12-11,MICRO ATM INC DATED 10121,0.0,1223.64,18339398.240000106,2018,12,11,TRANSFER,1223.64,M1261929991
14666,409000438620',2018-12-11,MICRO ATM GST DATED 10121,0.0,244.73,18339642.970000107,2018,12,11,CASH_IN,244.73,M2055259571
14667,409000438620',2018-12-11,AEPS INC DT 12-10-2018 RO,0.0,3525.74,18343168.710000105,2018,12,11,CHECK_CASHING,3525.74,C971899805
14668,409000438620',2018-12-11,AEPS GST INC DT 12-10-201,0.0,705.15,18343873.860000104,2018,12,11,TRANSFER,705.15,M510211704
14669,409000438620',2018-12-11,MICRO ATM WDL FEE DT11121,0.0,255100.0,18598973.860000104,2018,12,11,CHECK_CASHING,255100.0,C1444624884
14670,409000438620',2018-12-11,MICRO ATM INC DATED 11121,0.0,470.16,18599444.020000104,2018,12,11,TRANSFER,470.16,M277194882
14671,409000438620',2018-12-11,MICRO ATM GST DATED 11121,0.0,94.03,18599538.050000105,2018,12,11,CASH_IN,94.03,M1673396667
14672,409000438620',2018-12-12,Indiaforensic AEPS NPCI WDL SET,0.0,1124700.0,19724238.050000105,2018,12,12,CASH_IN,1124700.0,C2078250226
14673,409000438620',2018-12-12,TRF TO  Indiaforensic SERVICES I,900000.0,0.0,18824238.050000105,2018,12,12,CHECK_WITHDRAWAL,900000.0,C2115178036
14674,409000438620',2018-12-12,TRF TO  Indiaforensic SERVICES I,1100000.0,0.0,17724238.050000105,2018,12,12,CHECK_WITHDRAWAL,1100000.0,M1654963180
14675,409000438620',2018-12-12,MICRO ATM WDL FEE DT11121,0.0,592900.0,18317138.050000105,2018,12,12,TRANSFER,592900.0,C1852790850
14676,409000438620',2018-12-12,MICRO ATM INC DATED 11121,0.0,1062.72,18318200.770000104,2018,12,12,TRANSFER,1062.72,M1806629442
14677,409000438620',2018-12-12,MICRO ATM GST DATED 11121,0.0,212.54,18318413.310000107,2018,12,12,CASH_IN,212.54,M1374346773
14678,409000438620',2018-12-12,MICRO ATM WDL FEE DT12121,0.0,293400.0,18611813.310000107,2018,12,12,CASH_IN,293400.0,C997608398
14679,409000438620',2018-12-12,MICRO ATM INC DATED 12121,0.0,512.28,18612325.590000104,2018,12,12,CASH_IN,512.28,M1258145195
14680,409000438620',2018-12-12,MICRO ATM GST DATED 12121,0.0,102.46,18612428.050000105,2018,12,12,CHECK_CASHING,102.46,M1755493262
14681,409000438620',2018-12-12,AEPS INC DT 12-11-2018 RO,0.0,2972.84,18615400.890000105,2018,12,12,TRANSFER,2972.84,M1907432923
14682,409000438620',2018-12-12,AEPS GST INC DT 12-11-201,0.0,594.57,18615995.460000105,2018,12,12,CASH_IN,594.57,C352202338
14683,409000438620',2018-12-13,Indiaforensic AEPS NPCI WDL SET,0.0,1374700.0,19990695.460000105,2018,12,13,CASH_IN,1374700.0,C1251991550
14684,409000438620',2018-12-13,CR834316186581/RMCPL18136/0,1000.0,0.0,19989695.460000105,2018,12,13,CASH_OUT,1000.0,M1116763592
14685,409000438620',2018-12-13,CR834210864650/RMCPL20143/0,2500.0,0.0,19987195.460000105,2018,12,13,DEBIT,2500.0,M543356394
14686,409000438620',2018-12-13,CR834209862383/RMCPL11457/0,1300.0,0.0,19985895.460000105,2018,12,13,PAYEMENT,1300.0,C985934102
14687,409000438620',2018-12-13,CR834212903897/RMCPL27291/0,2600.0,0.0,19983295.460000105,2018,12,13,CHECK_WITHDRAWAL,2600.0,M2130031015
14688,409000438620',2018-12-13,TRF TO  Indiaforensic SERVICES I,2300000.0,0.0,17683295.460000105,2018,12,13,CASH_OUT,2300000.0,M235149619
14689,409000438620',2018-12-13,MICRO ATM WDL FEE DT12121,0.0,393900.0,18077195.460000105,2018,12,13,TRANSFER,393900.0,M596726782
14690,409000438620',2018-12-13,MICRO ATM INC DATED 12121,0.0,828.72,18078024.180000104,2018,12,13,CHECK_CASHING,828.72,M989581821
14691,409000438620',2018-12-13,MICRO ATM GST DATED 12121,0.0,165.74,18078189.920000106,2018,12,13,TRANSFER,165.74,M908402780
14692,409000438620',2018-12-13,MAW/502964XXXXXX8587/NAGA,0.0,800.0,18078989.920000106,2018,12,13,CHECK_CASHING,800.0,C917768476
14693,409000438620',2018-12-13,AEPS INC DT 12-12-2018 RO,0.0,3292.17,18082282.090000104,2018,12,13,TRANSFER,3292.17,M159190298
14694,409000438620',2018-12-13,AEPS GST INC DT 12-12-201,0.0,658.43,18082940.520000104,2018,12,13,CASH_IN,658.43,M1775526061
14695,409000438620',2018-12-13,AEPS ACQ CR ADJ FEES 1212,43.66,0.0,18082896.860000104,2018,12,13,DEBIT,43.66,C818570949
14696,409000438620',2018-12-13,AEPS PAY Indiaforensic 1212,0.0,797.23,18083694.090000104,2018,12,13,CASH_IN,797.23,M678322895
14697,409000438620',2018-12-13,MICRO ATM WDL FEE DT13121,0.0,184500.0,18268194.090000104,2018,12,13,CASH_IN,184500.0,M1317768552
14698,409000438620',2018-12-13,MICRO ATM INC DATED 13121,0.0,408.6,18268602.690000106,2018,12,13,CHECK_CASHING,408.6,M2127813013
14699,409000438620',2018-12-13,MICRO ATM GST DATED 13121,0.0,81.72,18268684.410000104,2018,12,13,TRANSFER,81.72,M602434856
14700,409000438620',2018-12-14,Indiaforensic AEPS NPCI WDL SET,0.0,1174500.0,19443184.410000104,2018,12,14,CHECK_CASHING,1174500.0,M1664669560
14701,409000438620',2018-12-14,TRF T  Indiaforensic SERVICES IN,1700000.0,0.0,17743184.410000104,2018,12,14,CHECK_WITHDRAWAL,1700000.0,M1612021404
14702,409000438620',2018-12-14,MICRO ATM WDL FEE DT13121,0.0,366800.0,18109984.410000104,2018,12,14,TRANSFER,366800.0,M2072345800
14703,409000438620',2018-12-14,MICRO ATM INC DATED 13121,0.0,753.48,18110737.890000105,2018,12,14,CHECK_CASHING,753.48,M384376175
14704,409000438620',2018-12-14,MICRO ATM GST DATED 13121,0.0,150.7,18110888.590000104,2018,12,14,TRANSFER,150.7,M119736764
14705,409000438620',2018-12-14,AEPS INC DT 12-13-2018 RO,0.0,2896.42,18113785.010000106,2018,12,14,CASH_IN,2896.42,M523512571
14706,409000438620',2018-12-14,AEPS GST INC DT 12-13-201,0.0,579.28,18114364.290000107,2018,12,14,TRANSFER,579.28,M1441124028
14707,409000438620',2018-12-14,TRF TO  Indiaforensic SERVICES I,400000.0,0.0,17714364.290000107,2018,12,14,CASH_OUT,400000.0,M1761426612
14708,409000438620',2018-12-14,MICRO ATM WDL FEE DT14121,0.0,462600.0,18176964.290000107,2018,12,14,TRANSFER,462600.0,M2079266458
14709,409000438620',2018-12-14,MICRO ATM INC DATED 14121,0.0,842.04,18177806.330000106,2018,12,14,CASH_IN,842.04,C2102549317
14710,409000438620',2018-12-14,MICRO ATM GST DATED 14121,0.0,168.41,18177974.740000106,2018,12,14,CASH_IN,168.41,M207574410
14711,409000438620',2018-12-15,MAW/502964XXXXXX8117/NAGA,0.0,700.0,18178674.740000106,2018,12,15,CASH_IN,700.0,C1477979030
14712,409000438620',2018-12-15,Indiaforensic AEPS NPCI WDL SET,0.0,1231400.0,19410074.740000106,2018,12,15,TRANSFER,1231400.0,M1113205371
14713,409000438620',2018-12-15,TRF TO  Indiaforensic SERVICES I,1000000.0,0.0,18410074.740000106,2018,12,15,CASH_OUT,1000000.0,M94613064
14714,409000438620',2018-12-15,AEPS PAY Indiaforensic 1412,0.0,399.17,18410473.91000011,2018,12,15,CASH_IN,399.17,C1508456612
14715,409000438620',2018-12-15,MICRO ATM WDL FEE DT14121,0.0,386900.0,18797373.91000011,2018,12,15,TRANSFER,386900.0,M598206741
14716,409000438620',2018-12-15,MICRO ATM INC DATED 14121,0.0,819.0,18798192.91000011,2018,12,15,CHECK_CASHING,819.0,M793005552
14717,409000438620',2018-12-15,MICRO ATM GST DATED 14121,0.0,163.8,18798356.71000011,2018,12,15,CASH_IN,163.8,C225852166
14718,409000438620',2018-12-15,CB 4598459009265230 2067,5000.0,0.0,18793356.71000011,2018,12,15,DEBIT,5000.0,M785442761
14719,409000438620',2018-12-15,AEPS INC DT 12-14-2018 RO,0.0,3075.24,18796431.950000107,2018,12,15,CHECK_CASHING,3075.24,C1876351111
14720,409000438620',2018-12-15,AEPS GST INC DT 12-14-201,0.0,615.05,18797047.000000108,2018,12,15,TRANSFER,615.05,C716083600
14721,409000438620',2018-12-15,TRF TO  Indiaforensic SERVICES I,1000000.0,0.0,17797047.000000108,2018,12,15,DEBIT,1000000.0,M198063885
14722,409000438620',2018-12-15,MICRO ATM WDL FEE DT15121,0.0,311200.0,18108247.000000108,2018,12,15,CASH_IN,311200.0,C1305075214
14723,409000438620',2018-12-15,MICRO ATM INC DATED 15121,0.0,561.96,18108808.96000011,2018,12,15,TRANSFER,561.96,M1547756440
14724,409000438620',2018-12-15,MICRO ATM GST DATED 15121,0.0,112.39,18108921.35000011,2018,12,15,TRANSFER,112.39,C1282788025
14725,409000438620',2018-12-17,Indiaforensic AEPS NPCI WDL SET,0.0,947000.0,19055921.35000011,2018,12,17,TRANSFER,947000.0,C404775810
14726,409000438620',2018-12-17,Indiaforensic AEPS NPCI WDL SET,0.0,614600.0,19670521.35000011,2018,12,17,TRANSFER,614600.0,M181914700
14727,409000438620',2018-12-17,CR834510590954/RMCPL26772/1,1500.0,0.0,19669021.35000011,2018,12,17,CHECK_WITHDRAWAL,1500.0,C1857357520
14728,409000438620',2018-12-17,MICRO ATM WDL FEE DT15121,0.0,433800.0,20102821.35000011,2018,12,17,CHECK_CASHING,433800.0,M1758471427
14729,409000438620',2018-12-17,MICRO ATM INC DATED 15121,0.0,870.84,20103692.19000011,2018,12,17,CASH_IN,870.84,M403725588
14730,409000438620',2018-12-17,MICRO ATM GST DATED 15121,0.0,174.17,20103866.36000011,2018,12,17,CASH_IN,174.17,M513338952
14731,409000438620',2018-12-17,TRF TO  Indiaforensic SERVICES I,2000000.0,0.0,18103866.36000011,2018,12,17,CHECK_WITHDRAWAL,2000000.0,M1374770704
14732,409000438620',2018-12-17,MICRO ATM WDL FEE DT16121,0.0,591500.0,18695366.36000011,2018,12,17,CHECK_CASHING,591500.0,M920235327
14733,409000438620',2018-12-17,MICRO ATM INC DATED 16121,0.0,1341.0,18696707.36000011,2018,12,17,CHECK_CASHING,1341.0,C1750665229
14734,409000438620',2018-12-17,MICRO ATM GST DATED 16121,0.0,268.2,18696975.56000011,2018,12,17,TRANSFER,268.2,M78048568
14735,409000438620',2018-12-17,TRF TO  Indiaforensic SERVICES I,1000000.0,0.0,17696975.56000011,2018,12,17,DEBIT,1000000.0,C957388291
14736,409000438620',2018-12-17,AEPS PAY Indiaforensic 1512,0.0,999.11,17697974.67000011,2018,12,17,CASH_IN,999.11,M1881254670
14737,409000438620',2018-12-17,AEPS PAY Indiaforensic 1612,0.0,99.64,17698074.31000011,2018,12,17,TRANSFER,99.64,M1424088218
14738,409000438620',2018-12-17,MICRO ATM WDL FEE DT17121,0.0,325800.0,18023874.31000011,2018,12,17,CASH_IN,325800.0,M65565171
14739,409000438620',2018-12-17,MICRO ATM INC DATED 17121,0.0,646.92,18024521.230000112,2018,12,17,TRANSFER,646.92,C1144318801
14740,409000438620',2018-12-17,MICRO ATM GST DATED 17121,0.0,129.38,18024650.61000011,2018,12,17,CHECK_CASHING,129.38,M1751692812
14741,409000438620',2018-12-17,AEPS INC DT 12-15-2018 RO,0.0,2448.6,18027099.21000012,2018,12,17,CHECK_CASHING,2448.6,M599332455
14742,409000438620',2018-12-17,AEPS GST INC DT 12-15-201,0.0,489.72,18027588.93000011,2018,12,17,CHECK_CASHING,489.72,C1483338079
14743,409000438620',2018-12-17,AEPS INC DT 16-12-2018 RO,0.0,1719.7,18029308.63000011,2018,12,17,CHECK_CASHING,1719.7,C2034460325
14744,409000438620',2018-12-17,AEPS GST INC DT 16-12-201,0.0,343.94,18029652.570000112,2018,12,17,CASH_IN,343.94,C1797686173
14745,409000438620',2018-12-17,AEPS ACQ CR ADJ FEES 1512,8.8,0.0,18029643.77000011,2018,12,17,DEBIT,8.8,C914293025
14746,409000438620',2018-12-18,MAW/502964XXXXXX0270/NAGA,0.0,1800.0,18031443.77000011,2018,12,18,TRANSFER,1800.0,C1643855278
14747,409000438620',2018-12-18,MAW/502964XXXXXX4423/NAGA,0.0,3200.0,18034643.77000011,2018,12,18,CASH_IN,3200.0,C1429623854
14748,409000438620',2018-12-18,Indiaforensic AEPS NPCI WDL SET,0.0,1127100.0,19161743.77000011,2018,12,18,CHECK_CASHING,1127100.0,C566698125
14749,409000438620',2018-12-18,TRF TO  Indiaforensic SERVICES I,1000000.0,0.0,18161743.77000011,2018,12,18,CASH_OUT,1000000.0,C1452722471
14750,409000438620',2018-12-18,TRF TO  Indiaforensic SERVICES I,500000.0,0.0,17661743.77000011,2018,12,18,CHECK_WITHDRAWAL,500000.0,C85102332
14751,409000438620',2018-12-18,AEPS INCOME DT 17-12-2018,0.0,2899.86,17664643.63000011,2018,12,18,TRANSFER,2899.86,C814900611
14752,409000438620',2018-12-18,AEPS GST INC DT 17-12-201,0.0,579.97,17665223.60000011,2018,12,18,CASH_IN,579.97,C1859795678
14753,409000438620',2018-12-18,MICRO ATM WDL FEE DT17121,0.0,304000.0,17969223.60000011,2018,12,18,CASH_IN,304000.0,C1725548614
14754,409000438620',2018-12-18,MICRO ATM INC DATED 17121,0.0,671.04,17969894.64000011,2018,12,18,CHECK_CASHING,671.04,C416519915
14755,409000438620',2018-12-18,MICRO ATM GST DATED 17121,0.0,134.21,17970028.85000011,2018,12,18,CASH_IN,134.21,C1311325237
14756,409000438620',2018-12-18,MICRO ATM WDL FEE DT18121,0.0,209400.0,18179428.85000011,2018,12,18,CASH_IN,209400.0,C863811613
14757,409000438620',2018-12-18,MICRO ATM INC DATED 18121,0.0,473.4,18179902.250000108,2018,12,18,CHECK_CASHING,473.4,C2109470512
14758,409000438620',2018-12-18,MICRO ATM GST DATED 18121,0.0,94.68,18179996.930000108,2018,12,18,TRANSFER,94.68,C1149273771
14759,409000438620',2018-12-19,Indiaforensic AEPS NPCI WDL SET,0.0,1148400.0,19328396.930000108,2018,12,19,CASH_IN,1148400.0,C1060041730
14760,409000438620',2018-12-19,CR834912538877/RMCPL18749/1,1000.0,0.0,19327396.930000108,2018,12,19,PAYEMENT,1000.0,C177457290
14761,409000438620',2018-12-19,MAW/502964XXXXXX0502/NAGA,0.0,700.0,19328096.930000108,2018,12,19,TRANSFER,700.0,C2006081398
14762,409000438620',2018-12-19,TRF TO  Indiaforensic SERVICES I,1600000.0,0.0,17728096.930000108,2018,12,19,CHECK_WITHDRAWAL,1600000.0,C1219248641
14763,409000438620',2018-12-19,MICRO ATM WDL FEE DT18121,0.0,328500.0,18056596.930000108,2018,12,19,TRANSFER,328500.0,C175291188
14764,409000438620',2018-12-19,MICRO ATM INC DATED 18121,0.0,752.4,18057349.330000106,2018,12,19,CASH_IN,752.4,C1717547480
14765,409000438620',2018-12-19,MICRO ATM GST DATED 18121,0.0,150.48,18057499.810000107,2018,12,19,TRANSFER,150.48,C33524623
14766,409000438620',2018-12-19,MAW/502964XXXXXX0296/NAGA,0.0,600.0,18058099.810000107,2018,12,19,CHECK_CASHING,600.0,C2128665553
14767,409000438620',2018-12-19,AEPS INC DT 12-18-2018 RO,0.0,3002.09,18061101.900000107,2018,12,19,CHECK_CASHING,3002.09,C570588770
14768,409000438620',2018-12-19,AEPS GST INC DT 12-18-201,0.0,600.42,18061702.32000011,2018,12,19,TRANSFER,600.42,C2008647667
14769,409000438620',2018-12-19,AEPS ACQ CR ADJ FEES 1712,5.9,0.0,18061696.42000011,2018,12,19,DEBIT,5.9,M16883220
14770,409000438620',2018-12-19,MICRO ATM WDL FEE DT19121,0.0,233200.0,18294896.42000011,2018,12,19,CHECK_CASHING,233200.0,M333380305
14771,409000438620',2018-12-19,MICRO ATM INC DATED 19121,0.0,506.88,18295403.30000011,2018,12,19,CASH_IN,506.88,M602001823
14772,409000438620',2018-12-19,MICRO ATM GST DATED 19121,0.0,101.38,18295504.680000108,2018,12,19,TRANSFER,101.38,C769342184
14773,409000438620',2018-12-20,Indiaforensic AEPS NPCI WDL SET,0.0,887600.0,19183104.680000108,2018,12,20,TRANSFER,887600.0,M1817186271
14774,409000438620',2018-12-20,TRF TO  Indiaforensic SERVICES I,1000000.0,0.0,18183104.680000108,2018,12,20,PAYEMENT,1000000.0,M1864835865
14775,409000438620',2018-12-20,TRF TO  Indiaforensic SERVICES I,500000.0,0.0,17683104.680000108,2018,12,20,PAYEMENT,500000.0,M715302630
14776,409000438620',2018-12-20,AEPS PAY Indiaforensic 1912,0.0,63460.17,17746564.85000011,2018,12,20,CASH_IN,63460.17,M1060078549
14777,409000438620',2018-12-20,MICRO ATM WDL FEE DT19121,0.0,495500.0,18242064.85000011,2018,12,20,CHECK_CASHING,495500.0,M1167603571
14778,409000438620',2018-12-20,MICRO ATM INC DATED 19121,0.0,852.12,18242916.97000011,2018,12,20,CHECK_CASHING,852.12,C48444237
14779,409000438620',2018-12-20,MICRO ATM GST DATED 19121,0.0,170.42,18243087.390000112,2018,12,20,TRANSFER,170.42,C1067155425
14780,409000438620',2018-12-20,AEPS INC DT 19-12-2018 RO,0.0,2372.43,18245459.820000112,2018,12,20,TRANSFER,2372.43,M847509683
14781,409000438620',2018-12-20,AEPS GST INC DT 19-12-201,0.0,474.49,18245934.31000011,2018,12,20,CHECK_CASHING,474.49,M1634462969
14782,409000438620',2018-12-20,TRF TO  Indiaforensic SERVICES I,500000.0,0.0,17745934.31000011,2018,12,20,PAYEMENT,500000.0,C566698125
14783,409000438620',2018-12-21,Indiaforensic AEPS NPCI WDL SET,0.0,831000.0,18576934.31000011,2018,12,21,TRANSFER,831000.0,C1459757869
14784,409000438620',2018-12-21,TRF TO  Indiaforensic SERVICES I,900000.0,0.0,17676934.31000011,2018,12,21,PAYEMENT,900000.0,M527305679
14785,409000438620',2018-12-21,AEPS PAY Indiaforensic 2012,0.0,62060.11,17738994.42000011,2018,12,21,TRANSFER,62060.11,C1505217516
14786,409000438620',2018-12-21,ATW/536799XXXXXX9514/Indfor*,0.0,500.0,17739494.42000011,2018,12,21,CHECK_CASHING,500.0,C408304912
14787,409000438620',2018-12-21,MICRO ATM WDL FEE DT20121,0.0,95500.0,17834994.42000011,2018,12,21,CASH_IN,95500.0,C1251991550
14788,409000438620',2018-12-21,MICRO ATM INC DATED 20121,0.0,239.04,17835233.46000011,2018,12,21,CHECK_CASHING,239.04,C1556875182
14789,409000438620',2018-12-21,MICRO ATM GST DATED 20121,0.0,47.81,17835281.270000108,2018,12,21,CHECK_CASHING,47.81,C1847521348
14790,409000438620',2018-12-21,AEPS INC DT 20-12-2018 RO,0.0,2044.89,17837326.16000011,2018,12,21,CHECK_CASHING,2044.89,C1317731757
14791,409000438620',2018-12-21,AEPS GST INC DT 20-12-201,0.0,408.98,17837735.14000011,2018,12,21,CASH_IN,408.98,C580441921
14792,409000438620',2018-12-21,MICRO ATM WDL FEE DT20121,0.0,204100.0,18041835.14000011,2018,12,21,TRANSFER,204100.0,C1987564320
14793,409000438620',2018-12-21,MICRO ATM INC DATED 20121,0.0,385.56,18042220.700000107,2018,12,21,CHECK_CASHING,385.56,C1440325059
14794,409000438620',2018-12-21,MICRO ATM GST DATED 20121,0.0,77.11,18042297.810000107,2018,12,21,CHECK_CASHING,77.11,C74288440
14795,409000438620',2018-12-24,Indiaforensic AEPS NPCI WDL SET,0.0,1160300.0,19202597.810000107,2018,12,24,CHECK_CASHING,1160300.0,C170899621
14796,409000438620',2018-12-24,Indiaforensic AEPS NPCI WDL SET,0.0,875000.0,20077597.810000107,2018,12,24,CASH_IN,875000.0,C1781062023
14797,409000438620',2018-12-24,Indiaforensic AEPS NPCI WDL SET,0.0,575200.0,20652797.810000107,2018,12,24,CHECK_CASHING,575200.0,C1556875182
14798,409000438620',2018-12-24,TRF TO  Indiaforensic SERVICES I,1000000.0,0.0,19652797.810000107,2018,12,24,CASH_OUT,1000000.0,C1060041730
14799,409000438620',2018-12-24,TRF TO  Indiaforensic SERVICES I,500000.0,0.0,19152797.810000107,2018,12,24,CASH_OUT,500000.0,C1870252780
14800,409000438620',2018-12-24,MAW/502964XXXXXX7574/NAGA,0.0,1000.0,19153797.810000107,2018,12,24,TRANSFER,1000.0,C1491676195
14801,409000438620',2018-12-24,AEPS PAY Indiaforensic 2212,0.0,589.42,19154387.23000011,2018,12,24,TRANSFER,589.42,C470217116
14802,409000438620',2018-12-24,TRF TO  Indiaforensic SERVICES I,500000.0,0.0,18654387.23000011,2018,12,24,PAYEMENT,500000.0,C778559237
14803,409000438620',2018-12-24,TRF TO  Indiaforensic SERVICES I,500000.0,0.0,18154387.23000011,2018,12,24,PAYEMENT,500000.0,C232834050
14804,409000438620',2018-12-24,MICRO ATM WDL FEE DT21121,0.0,489800.0,18644187.23000011,2018,12,24,CHECK_CASHING,489800.0,C1079554968
14805,409000438620',2018-12-24,MICRO ATM INC DATED 21121,0.0,910.44,18645097.67000011,2018,12,24,CHECK_CASHING,910.44,C1247600089
14806,409000438620',2018-12-24,MICRO ATM GST DATED 21121,0.0,182.09,18645279.76000011,2018,12,24,CHECK_CASHING,182.09,C1489275794
14807,409000438620',2018-12-24,MICRO ATM WDL FEE DT20121,0.0,242000.0,18887279.76000011,2018,12,24,TRANSFER,242000.0,M730986072
14808,409000438620',2018-12-24,MICRO ATM INC DATED 20121,0.0,457.2,18887736.96000011,2018,12,24,CASH_IN,457.2,M1604528884
14809,409000438620',2018-12-24,MICRO ATM GST DATED 20121,0.0,91.44,18887828.40000011,2018,12,24,TRANSFER,91.44,C1101441872
14810,409000438620',2018-12-24,MICRO ATM WDL FEE DT22121,0.0,738300.0,19626128.40000011,2018,12,24,TRANSFER,738300.0,M597906593
14811,409000438620',2018-12-24,MICRO ATM INC DATED 22121,0.0,1358.28,19627486.68000011,2018,12,24,CASH_IN,1358.28,C1085252849
14812,409000438620',2018-12-24,MICRO ATM GST DATED 22121,0.0,271.66,19627758.34000011,2018,12,24,TRANSFER,271.66,M2036838695
14813,409000438620',2018-12-24,MICRO ATM WDL FEE DT23121,0.0,331400.0,19959158.34000011,2018,12,24,CASH_IN,331400.0,C699539366
14814,409000438620',2018-12-24,MICRO ATM INC DATED 23121,0.0,770.76,19959929.100000113,2018,12,24,TRANSFER,770.76,M1285855580
14815,409000438620',2018-12-24,MICRO ATM GST DATED 23121,0.0,154.15,19960083.25000011,2018,12,24,TRANSFER,154.15,M267804101
14816,409000438620',2018-12-24,AEPS INC DT 12-21-2018 RO,0.0,2907.21,19962990.46000012,2018,12,24,TRANSFER,2907.21,M1224642639
14817,409000438620',2018-12-24,AEPS GST INC DT 12-21-201,0.0,581.44,19963571.900000114,2018,12,24,CHECK_CASHING,581.44,M168886455
14818,409000438620',2018-12-24,AEPS INC DT 12-22-2018 RO,0.0,2096.51,19965668.41000012,2018,12,24,CASH_IN,2096.51,M1381417054
14819,409000438620',2018-12-24,AEPS GST INC DT 12-22-201,0.0,419.3,19966087.71000012,2018,12,24,TRANSFER,419.3,C1105527690
14820,409000438620',2018-12-24,AEPS INC DT 12-23-2018 RO,0.0,1483.17,19967570.88000012,2018,12,24,CASH_IN,1483.17,M406597873
14821,409000438620',2018-12-24,AEPS GST INC DT 12-23-201,0.0,296.63,19967867.51000012,2018,12,24,CHECK_CASHING,296.63,C1189106564
14822,409000438620',2018-12-25,MAW/502964XXXXXX0202/NAGA,0.0,1200.0,19969067.51000012,2018,12,25,CASH_IN,1200.0,C1061838943
14823,409000438620',2018-12-26,TRF TO  Indiaforensic SERVICES I,2000000.0,0.0,17969067.510000113,2018,12,26,DEBIT,2000000.0,C141213117
14824,409000438620',2018-12-26,Indiaforensic AEPS NPCI WDL SET,0.0,991000.0,18960067.51000012,2018,12,26,CASH_IN,991000.0,C1134266682
14825,409000438620',2018-12-26,Indiaforensic AEPS NPCI WDL SET,0.0,963000.0,19923067.51000012,2018,12,26,CHECK_CASHING,963000.0,C1387210478
14826,409000438620',2018-12-26,MAW/502964XXXXXX8975/NAGA,0.0,1800.0,19924867.51000012,2018,12,26,TRANSFER,1800.0,M661707629
14827,409000438620',2018-12-26,TRF TO  Indiaforensic SERVICES I,2000000.0,0.0,17924867.510000113,2018,12,26,CHECK_WITHDRAWAL,2000000.0,M1287610852
14828,409000438620',2018-12-26,AEPS PAY Indiaforensic 2512,0.0,499.4,17925366.910000116,2018,12,26,CHECK_CASHING,499.4,M924598510
14829,409000438620',2018-12-26,AEPS INC DT 12-24-2018 RO,0.0,2495.39,17927862.300000116,2018,12,26,CASH_IN,2495.39,C1302931951
14830,409000438620',2018-12-26,AEPS GST INC DT 12-24-201,0.0,499.08,17928361.380000114,2018,12,26,CASH_IN,499.08,M1162766641
14831,409000438620',2018-12-26,MICRO ATM WDL FEE DT24121,0.0,258900.0,18187261.380000114,2018,12,26,CASH_IN,258900.0,C1414803985
14832,409000438620',2018-12-26,MICRO ATM INC DATED 24121,0.0,595.44,18187856.82000012,2018,12,26,TRANSFER,595.44,M408189707
14833,409000438620',2018-12-26,MICRO ATM GST DATED 24121,0.0,119.09,18187975.91000012,2018,12,26,CASH_IN,119.09,M1017459489
14834,409000438620',2018-12-26,MICRO ATM WDL FEE DT25121,0.0,428100.0,18616075.91000012,2018,12,26,CASH_IN,428100.0,M83767384
14835,409000438620',2018-12-26,MICRO ATM INC DATED 25121,0.0,957.6,18617033.51000012,2018,12,26,CASH_IN,957.6,M331784903
14836,409000438620',2018-12-26,MICRO ATM GST DATED 25121,0.0,191.52,18617225.03000012,2018,12,26,CHECK_CASHING,191.52,M355565001
14837,409000438620',2018-12-26,AEPS INC DT 12-25-2018 RO,0.0,2254.31,18619479.340000115,2018,12,26,CHECK_CASHING,2254.31,M1224465110
14838,409000438620',2018-12-26,AEPS GST INC DT 12-25-201,0.0,450.86,18619930.200000115,2018,12,26,TRANSFER,450.86,M1900984959
14839,409000438620',2018-12-26,MICRO ATM WDL FEE DT20121,0.0,128800.0,18748730.200000115,2018,12,26,CHECK_CASHING,128800.0,M1695602456
14840,409000438620',2018-12-26,MICRO ATM INC DATED 20121,0.0,259.56,18748989.760000113,2018,12,26,CASH_IN,259.56,M1962451764
14841,409000438620',2018-12-26,MICRO ATM GST DATED 20121,0.0,51.91,18749041.670000114,2018,12,26,CHECK_CASHING,51.91,M943804946
14842,409000438620',2018-12-27,Indiaforensic AEPS NPCI WDL SET,0.0,919500.0,19668541.670000114,2018,12,27,CASH_IN,919500.0,M1914410011
14843,409000438620',2018-12-27,TRF TO  Indiaforensic SERVICES I,2000000.0,0.0,17668541.670000114,2018,12,27,PAYEMENT,2000000.0,M1288518055
14844,409000438620',2018-12-27,AEPS PAY Indiaforensic 2612,0.0,299.52,17668841.190000113,2018,12,27,CHECK_CASHING,299.52,M2063147639
14845,409000438620',2018-12-27,MICRO ATM WDL FEE DT26121,0.0,364000.0,18032841.19000012,2018,12,27,CASH_IN,364000.0,M1347425447
14846,409000438620',2018-12-27,MICRO ATM INC DATED 26121,0.0,734.04,18033575.230000112,2018,12,27,CHECK_CASHING,734.04,M1370113156
14847,409000438620',2018-12-27,MICRO ATM GST DATED 26121,0.0,146.81,18033722.04000011,2018,12,27,CHECK_CASHING,146.81,M1559907693
14848,409000438620',2018-12-27,AEPS INC DT 26-12-2018 RO,0.0,2226.71,18035948.75000011,2018,12,27,TRANSFER,2226.71,M608045763
14849,409000438620',2018-12-27,AEPS GST INC DT 26-12-201,0.0,445.34,18036394.09000011,2018,12,27,TRANSFER,445.34,M1520773515
14850,409000438620',2018-12-27,MICRO ATM WDL FEE DT20121,0.0,170700.0,18207094.09000011,2018,12,27,TRANSFER,170700.0,M917773782
14851,409000438620',2018-12-27,MICRO ATM INC DATED 20121,0.0,313.92,18207408.010000113,2018,12,27,TRANSFER,313.92,M1169039951
14852,409000438620',2018-12-27,MICRO ATM GST DATED 20121,0.0,62.78,18207470.790000115,2018,12,27,TRANSFER,62.78,M1922160775
14853,409000438620',2018-12-28,FDRL/INTERNAL FUND TRANSFE,500000.0,0.0,17707470.790000115,2018,12,28,PAYEMENT,500000.0,M1432215469
14854,409000438620',2018-12-28,MAW/502964XXXXXX2167/NAGA,0.0,200.0,17707670.790000115,2018,12,28,TRANSFER,200.0,M616539807
14855,409000438620',2018-12-28,Indiaforensic AEPS NPCI WDL SET,0.0,892000.0,18599670.790000115,2018,12,28,TRANSFER,892000.0,M1461056564
14856,409000438620',2018-12-28,CR835312497192/RMCPL28497/1,10000.0,0.0,18589670.790000115,2018,12,28,PAYEMENT,10000.0,M1719575888
14857,409000438620',2018-12-28,CR835414765623/RMCPL28497/2,5000.0,0.0,18584670.790000115,2018,12,28,PAYEMENT,5000.0,M97692517
14858,409000438620',2018-12-28,MICRO ATM WDL FEE DT27121,0.0,303500.0,18888170.790000115,2018,12,28,TRANSFER,303500.0,C1810730392
14859,409000438620',2018-12-28,MICRO ATM INC DATED 27121,0.0,705.6,18888876.39000012,2018,12,28,TRANSFER,705.6,M1164625699
14860,409000438620',2018-12-28,MICRO ATM GST DATED 27121,0.0,141.12,18889017.51000012,2018,12,28,CHECK_CASHING,141.12,M1202160289
14861,409000438620',2018-12-28,FDRL/INTERNAL FUND TRANSFE,1000000.0,0.0,17889017.510000113,2018,12,28,CHECK_WITHDRAWAL,1000000.0,C789014007
14862,409000438620',2018-12-28,AEPS PAY Indiaforensic 2712,0.0,3497.34,17892514.850000113,2018,12,28,CASH_IN,3497.34,C2034460325
14863,409000438620',2018-12-28,AEPS INC DT 27-12-2018 RO,0.0,2315.85,17894830.70000012,2018,12,28,TRANSFER,2315.85,C2040656033
14864,409000438620',2018-12-28,AEPS GST INC DT 27-12-201,0.0,463.17,17895293.87000012,2018,12,28,CASH_IN,463.17,C1894575391
14865,409000438620',2018-12-28,AEPS ACQ REP ADJ FEES 271,0.0,8.85,17895302.72000012,2018,12,28,CHECK_CASHING,8.85,C256417920
14866,409000438620',2018-12-28,MICRO ATM WDL FEE DT28121,0.0,232100.0,18127402.72000012,2018,12,28,CHECK_CASHING,232100.0,M43330070
14867,409000438620',2018-12-28,MICRO ATM INC DATED 28121,0.0,471.96,18127874.680000126,2018,12,28,CHECK_CASHING,471.96,M476925748
14868,409000438620',2018-12-28,MICRO ATM GST DATED 28121,0.0,94.39,18127969.070000123,2018,12,28,CHECK_CASHING,94.39,C1270516
14869,409000438620',2018-12-29,MICRO ATM WDL FEE DT28121,0.0,221300.0,18349269.070000123,2018,12,29,CASH_IN,221300.0,C1104197405
14870,409000438620',2018-12-29,MICRO ATM INC DATED 28121,0.0,525.24,18349794.31000012,2018,12,29,TRANSFER,525.24,M166910212
14871,409000438620',2018-12-29,MICRO ATM GST DATED 28121,0.0,105.05,18349899.36000012,2018,12,29,CHECK_CASHING,105.05,M1344285844
14872,409000438620',2018-12-29,Indiaforensic AEPS NPCI WDL SET,0.0,850500.0,19200399.36000012,2018,12,29,CASH_IN,850500.0,M822267089
14873,409000438620',2018-12-29,CR836010126401/RMCPL26349/2,3500.0,0.0,19196899.36000012,2018,12,29,DEBIT,3500.0,M1560563662
14874,409000438620',2018-12-29,CR835810650254/RMCPL09590/2,3000.0,0.0,19193899.36000012,2018,12,29,DEBIT,3000.0,M1814124341
14875,409000438620',2018-12-29,CR835510955335/RMCPL28497/2,1000.0,0.0,19192899.36000012,2018,12,29,CHECK_WITHDRAWAL,1000.0,M319260594
14876,409000438620',2018-12-29,FDRL/INTERNAL FUND TRANSFE,1000000.0,0.0,18192899.36000012,2018,12,29,PAYEMENT,1000000.0,M766894499
14877,409000438620',2018-12-29,FDRL/INTERNAL FUND TRANSFE,500000.0,0.0,17692899.360000122,2018,12,29,DEBIT,500000.0,M2015815874
14878,409000438620',2018-12-29,AEPS INC DT 28-12-2018 RO,0.0,2109.32,17695008.680000126,2018,12,29,CASH_IN,2109.32,M1840813923
14879,409000438620',2018-12-29,AEPS GST INC DT 28-12-201,0.0,421.86,17695430.540000122,2018,12,29,CASH_IN,421.86,C2006081398
14880,409000438620',2018-12-29,AEPS ACQ CR ADJ FEES 2812,41.3,0.0,17695389.24000012,2018,12,29,PAYEMENT,41.3,M313842711
14881,409000438620',2018-12-29,MICRO ATM WDL FEE DT29121,0.0,226100.0,17921489.24000012,2018,12,29,CASH_IN,226100.0,C458582664
14882,409000438620',2018-12-29,MICRO ATM INC DATED 29121,0.0,461.16,17921950.40000012,2018,12,29,TRANSFER,461.16,C2089779261
14883,409000438620',2018-12-29,MICRO ATM GST DATED 29121,0.0,92.23,17922042.630000122,2018,12,29,CHECK_CASHING,92.23,C1260889084
14884,409000438620',2018-12-31,Indiaforensic AEPS NPCI WDL SET,0.0,791500.0,18713542.63000012,2018,12,31,CASH_IN,791500.0,C2109097173
14885,409000438620',2018-12-31,Indiaforensic AEPS NPCI WDL SET,0.0,410100.0,19123642.63000012,2018,12,31,CASH_IN,410100.0,C380928130
14886,409000438620',2018-12-31,FDRL/INTERNAL FUND TRANSFE,1000000.0,0.0,18123642.63000012,2018,12,31,DEBIT,1000000.0,C1095666481
14887,409000438620',2018-12-31,MICRO ATM WDL FEE DT29121,0.0,302400.0,18426042.63000012,2018,12,31,TRANSFER,302400.0,C1838584624
14888,409000438620',2018-12-31,MICRO ATM INC DATED 29121,0.0,680.04,18426722.67000012,2018,12,31,TRANSFER,680.04,C1722141669
14889,409000438620',2018-12-31,MICRO ATM GST DATED 29121,0.0,136.01,18426858.680000126,2018,12,31,TRANSFER,136.01,C2006081398
14890,409000438620',2018-12-31,MICRO ATM WDL FEE DT30121,0.0,362400.0,18789258.680000126,2018,12,31,CHECK_CASHING,362400.0,C465499079
14891,409000438620',2018-12-31,MICRO ATM INC DATED 30121,0.0,806.04,18790064.72000012,2018,12,31,TRANSFER,806.04,C1220911229
14892,409000438620',2018-12-31,MICRO ATM GST DATED 30121,0.0,161.21,18790225.930000126,2018,12,31,CASH_IN,161.21,C678308721
14893,409000438620',2018-12-31,FDRL/INTERNAL FUND TRANSFE,1000000.0,0.0,17790225.930000126,2018,12,31,CASH_OUT,1000000.0,C8290162
14894,409000438620',2018-12-31,AEPS INC DT 12-29-2018 RO,0.0,1950.08,17792176.01000012,2018,12,31,CASH_IN,1950.08,C1570076320
14895,409000438620',2018-12-31,AEPS GST INC DT 12-29-201,0.0,390.02,17792566.03000012,2018,12,31,CASH_IN,390.02,C127252077
14896,409000438620',2018-12-31,MICRO ATM WDL FEE DT31121,0.0,218100.0,18010666.03000012,2018,12,31,TRANSFER,218100.0,C1526542158
14897,409000438620',2018-12-31,MICRO ATM INC DATED 31121,0.0,455.76,18011121.790000122,2018,12,31,CHECK_CASHING,455.76,C2141994208
14898,409000438620',2018-12-31,MICRO ATM GST DATED 31121,0.0,91.15,18011212.94000012,2018,12,31,TRANSFER,91.15,C1532153384
14899,409000438620',2018-12-31,AEPS INC DT 12-30-2018 RO,0.0,1145.23,18012358.17000012,2018,12,31,CHECK_CASHING,1145.23,C476402209
14900,409000438620',2018-12-31,AEPS GST INC DT 12-30-201,0.0,229.05,18012587.22000012,2018,12,31,CHECK_CASHING,229.05,C1962165946
14901,1196711',2018-01-01,NEFT/N001180443481243/PAY,0.0,7883.91,,2018,1,1,CHECK_CASHING,7883.91,C554025243
14902,1196711',2018-01-02,NEFT/N002180444386581/PAY,0.0,3360.77,,2018,1,2,CASH_IN,3360.77,C1907159141
14903,1196711',2018-01-02,NEFT/SBIN218002272415/Indfor,0.0,4300000.0,,2018,1,2,TRANSFER,4300000.0,M1983320532
14904,1196711',2018-01-03,NEFT/N003180445237536/PAY,0.0,12342.7,,2018,1,3,TRANSFER,12342.7,C748241311
14905,1196711',2018-01-03,TRF TO  Indiaforensic SERVICES I,800000.0,0.0,,2018,1,3,CASH_OUT,800000.0,M738327740
14906,1196711',2018-01-04,NEFT/N004180446213783/PAY,0.0,20878.05,,2018,1,4,CASH_IN,20878.05,M2030617072
14907,1196711',2018-01-05,NEFT/N005180447306780/PAY,0.0,7837.95,,2018,1,5,CASH_IN,7837.95,M1757536605
14908,1196711',2018-01-06,NEFT/N006180448097042/PAY,0.0,14396.89,,2018,1,6,CHECK_CASHING,14396.89,M38860857
14909,1196711',2018-01-07,RF For 709003590272,0.0,25313.65,,2018,1,7,CASH_IN,25313.65,M512085863
14910,1196711',2018-01-08,NEFT/N008180449147775/PAY,0.0,31339.75,,2018,1,8,TRANSFER,31339.75,M1665683905
14911,1196711',2018-01-09,NEFT/N009180450143577/PAY,0.0,408.65,,2018,1,9,TRANSFER,408.65,M1645106500
14912,1196711',2018-01-10,NEFT/N010180451057819/PAY,0.0,16407.88,,2018,1,10,TRANSFER,16407.88,M1112834588
14913,1196711',2018-01-11,NEFT/N011180452001889/PAY,0.0,39516.76,,2018,1,11,CASH_IN,39516.76,M46406547
14914,1196711',2018-01-11,TRF TO  Indiaforensic SERVICES I,200000.0,0.0,,2018,1,11,CHECK_WITHDRAWAL,200000.0,M522264438
14915,1196711',2018-01-12,NEFT/N012180452890507/PAY,0.0,47453.7,,2018,1,12,TRANSFER,47453.7,M699926966
14916,1196711',2018-01-15,NEFT/N015180453832942/PAY,0.0,33334.52,,2018,1,15,TRANSFER,33334.52,M1588049067
14917,1196711',2018-01-16,NEFT/N016180454543484/PAY,0.0,17066.57,,2018,1,16,CASH_IN,17066.57,M683197617
14918,1196711',2018-01-17,NEFT/N017180455201553/PAY,0.0,25860.03,,2018,1,17,TRANSFER,25860.03,M1424896511
14919,1196711',2018-01-18,NEFT/N018180455925341/PAY,0.0,15669.6,,2018,1,18,TRANSFER,15669.6,M1599610096
14920,1196711',2018-01-19,NEFT/N019180456659670/PAY,0.0,12946.57,,2018,1,19,TRANSFER,12946.57,M856713663
14921,1196711',2018-01-20,NEFT/N020180457208772/PAY,0.0,34405.7,,2018,1,20,CASH_IN,34405.7,M1135459987
14922,1196711',2018-01-22,NEFT/N022180457905922/PAY,0.0,42878.83,,2018,1,22,TRANSFER,42878.83,C1448348248
14923,1196711',2018-01-23,NEFT/N023180458628609/PAY,0.0,45073.47,,2018,1,23,TRANSFER,45073.47,C909295153
14924,1196711',2018-01-24,NEFT/N024180459263759/PAY,0.0,15775.54,,2018,1,24,CASH_IN,15775.54,C93166806
14925,1196711',2018-01-25,Loan Recovery For90900004,336180.63,0.0,,2018,1,25,CHECK_WITHDRAWAL,336180.63,C35126588
14926,1196711',2018-01-25,RTGS/SBINH18025014906/Indfor,0.0,5000000.0,,2018,1,25,CASH_IN,5000000.0,C769342184
14927,1196711',2018-01-25,Payments For : 9090000492,310217.37,0.0,,2018,1,25,CHECK_WITHDRAWAL,310217.37,C885951223
14928,1196711',2018-01-25,Payments For : 9090000495,3287671.0,0.0,,2018,1,25,CASH_OUT,3287671.0,C515132998
14929,1196711',2018-01-25,Payments For : 9090000495,628945.0,0.0,,2018,1,25,PAYEMENT,628945.0,C265108079
14930,1196711',2018-01-25,NEFT/N025180460235330/PAY,0.0,5904.71,,2018,1,25,TRANSFER,5904.71,C97730845
14931,1196711',2018-01-29,NEFT/N029180461347016/PAY,0.0,15088.47,,2018,1,29,TRANSFER,15088.47,C1094528209
14932,1196711',2018-01-29,NEFT/N029180461405038/PAY,0.0,3069.86,,2018,1,29,CHECK_CASHING,3069.86,C667504652
14933,1196711',2018-01-30,NEFT/N030180462441119/PAY,0.0,196.5,,2018,1,30,TRANSFER,196.5,C1727565779
14934,1196711',2018-01-31,Loan Recovery For90900005,789041.0,0.0,,2018,1,31,PAYEMENT,789041.0,M1305259765
14935,1196711',2018-01-31,Loan Recovery For90900005,8385.17,0.0,,2018,1,31,DEBIT,8385.17,C1601702534
14936,1196711',2018-01-31,NEFT/N031180463730303/PAY,0.0,5849.42,,2018,1,31,CHECK_CASHING,5849.42,M1934117158
14937,1196711',2018-01-31,Loan Recovery For90900005,5849.42,0.0,,2018,1,31,CASH_OUT,5849.42,M1112879561
14938,1196711',2018-01-31,1196711:Int.Coll:01-01-20,4185770.0,0.0,,2018,1,31,PAYEMENT,4185770.0,M1169587470
14939,1196711',2018-02-02,NEFT/N033180466349422/PAY,0.0,18704.92,,2018,2,2,CHECK_CASHING,18704.92,C361268035
14940,1196711',2018-02-03,NEFT/N034180467168586/PAY,0.0,8911.55,,2018,2,3,CHECK_CASHING,8911.55,M1854969226
14941,1196711',2018-02-05,NEFT/N036180468385937/PAY,0.0,36246.03,,2018,2,5,CASH_IN,36246.03,C2116873183
14942,1196711',2018-02-06,NEFT/N037180469338216/PAY,0.0,16861.2,,2018,2,6,CHECK_CASHING,16861.2,M1991420316
14943,1196711',2018-02-07,NEFT/N038180470409985/PAY,0.0,21643.63,,2018,2,7,CASH_IN,21643.63,M1113078977
14944,1196711',2018-02-08,NEFT/N039180471421271/PAY,0.0,7933.05,,2018,2,8,CHECK_CASHING,7933.05,M1749590931
14945,1196711',2018-02-09,NEFT/N040180472430537/PAY,0.0,79919.7,,2018,2,9,CHECK_CASHING,79919.7,M1440734416
14946,1196711',2018-02-09,FDRL/INTERNAL FUND TRANSFE,0.0,2000000.0,,2018,2,9,TRANSFER,2000000.0,M1534668362
14947,1196711',2018-02-09,FDRL/INTERNAL FUND TRANSFE,0.0,3000000.0,,2018,2,9,TRANSFER,3000000.0,C1373172466
14948,1196711',2018-02-09,Loan Recovery For90900005,136712.41,0.0,,2018,2,9,CASH_OUT,136712.41,C542766981
14949,1196711',2018-02-09,Loan Recovery For90900005,155135.0,0.0,,2018,2,9,CHECK_WITHDRAWAL,155135.0,M1379799035
14950,1196711',2018-02-12,NEFT/N043180473903939/PAY,0.0,71308.19,,2018,2,12,TRANSFER,71308.19,C1921483039
14951,1196711',2018-02-14,NEFT/N045180475238428/PAY,0.0,20474.8,,2018,2,14,CASH_IN,20474.8,C1734719138
14952,1196711',2018-02-15,NEFT/N046180476018808/PAY,0.0,17552.0,,2018,2,15,CHECK_CASHING,17552.0,C179481608
14953,1196711',2018-02-16,NEFT/N047180476746546/PAY,0.0,7834.8,,2018,2,16,CHECK_CASHING,7834.8,C2006081398
14954,1196711',2018-02-16,TRF FROM  Indiaforensic SERVICES,0.0,5000000.0,,2018,2,16,CHECK_CASHING,5000000.0,M981018779
14955,1196711',2018-02-16,TRF FROM  Indiaforensic SERVICES,0.0,15000000.0,,2018,2,16,CASH_IN,15000000.0,M67401769
14956,1196711',2018-02-16,TRF FROM  Indiaforensic SERVICES,0.0,15000000.0,,2018,2,16,TRANSFER,15000000.0,C919978702
14957,1196711',2018-02-16,NEFT/FDRL392043290/Indiaforensic,0.0,3000000.0,,2018,2,16,CHECK_CASHING,3000000.0,M2129215194
14958,1196711',2018-02-16,TRF FROM  Indiaforensic SERVICES,0.0,15000000.0,,2018,2,16,CASH_IN,15000000.0,M528515419
14959,1196711',2018-02-16,FDRL/INTERNAL FUND TRANSFE,3000000.0,0.0,,2018,2,16,PAYEMENT,3000000.0,C748014372
14960,1196711',2018-02-17,NEFT/N048180477331538/PAY,0.0,4511.37,,2018,2,17,CASH_IN,4511.37,M1828506930
14961,1196711',2018-02-20,NEFT/N051180478671757/PAY,0.0,80723.91,,2018,2,20,TRANSFER,80723.91,C68113386
14962,1196711',2018-02-21,NEFT/N052180479290346/PAY,0.0,16670.9,,2018,2,21,TRANSFER,16670.9,C1781090157
14963,1196711',2018-02-22,RTGS/ICICH18053220882/Indfor,0.0,3000000.0,,2018,2,22,TRANSFER,3000000.0,C2025644484
14964,1196711',2018-02-22,FDRL/INTERNAL FUND TRANSFE,3000000.0,0.0,,2018,2,22,PAYEMENT,3000000.0,C1899073220
14965,1196711',2018-02-22,NEFT/N053180480007310/PAY,0.0,5892.4,,2018,2,22,TRANSFER,5892.4,C154319946
14966,1196711',2018-02-23,Loan Recovery For90900005,50937571.04,0.0,,2018,2,23,CASH_OUT,50937571.04,M1826827970
14967,1196711',2018-02-23,RTGS/ICICH18054366350/Indfor,0.0,3000000.0,,2018,2,23,CHECK_CASHING,3000000.0,C749672494
14968,1196711',2018-02-23,NEFT/N054180480753977/PAY,0.0,6287.5,,2018,2,23,CASH_IN,6287.5,M303907663
14969,1196711',2018-02-23,Loan Recovery For90900005,3006287.5,0.0,,2018,2,23,CHECK_WITHDRAWAL,3006287.5,M1914705297
14970,1196711',2018-02-26,RTGS/ICICH18057523664/Indfor,0.0,3000000.0,,2018,2,26,CASH_IN,3000000.0,M1735936170
14971,1196711',2018-02-26,Loan Payment Reversal For,0.0,3006287.5,,2018,2,26,TRANSFER,3006287.5,M497326120
14972,1196711',2018-02-26,Loan Payment Reversal For,0.0,50937571.04,,2018,2,26,CHECK_CASHING,50937571.04,M480673968
14973,1196711',2018-02-26,Payments For : 9090000506,3024658.0,0.0,,2018,2,26,PAYEMENT,3024658.0,M515713563
14974,1196711',2018-02-26,Payments For : 9090000506,578696.0,0.0,,2018,2,26,CHECK_WITHDRAWAL,578696.0,M2060825992
14975,1196711',2018-02-26,Payments For : 9090000505,594763.0,0.0,,2018,2,26,DEBIT,594763.0,M647888311
14976,1196711',2018-02-26,NEFT/N057180481974225/PAY,0.0,101929.99,,2018,2,26,TRANSFER,101929.99,M1403837550
14977,1196711',2018-02-26,TRF TO  Indiaforensic SERVICES I,2700000.0,0.0,,2018,2,26,CASH_OUT,2700000.0,M1958688815
14978,1196711',2018-02-26,Loan Recovery For90900005,50147671.53,0.0,,2018,2,26,PAYEMENT,50147671.53,M1465194484
14979,1196711',2018-02-27,Loan Payment Reversal For,0.0,50147671.53,,2018,2,27,CHECK_CASHING,50147671.53,M1467916079
14980,1196711',2018-02-27,INT/WCDL/909000050599/909,660986.0,0.0,,2018,2,27,DEBIT,660986.0,M890948945
14981,1196711',2018-02-27,NEFT/N058180482759167/PAY,0.0,5888.21,,2018,2,27,TRANSFER,5888.21,M559174743
14982,1196711',2018-02-28,Loan Recovery For90900005,51712.0,0.0,,2018,2,28,CHECK_WITHDRAWAL,51712.0,M1957995471
14983,1196711',2018-02-28,Loan Recovery For90900005,263014.0,0.0,,2018,2,28,DEBIT,263014.0,M1955873763
14984,1196711',2018-02-28,Loan Recovery For90900005,50316.0,0.0,,2018,2,28,PAYEMENT,50316.0,M239230273
14985,1196711',2018-02-28,NEFT/N059180484122607/PAY,0.0,23045.34,,2018,2,28,CHECK_CASHING,23045.34,M624830750
14986,1196711',2018-02-28,1196711:Int.Coll:01-02-20,3613279.0,0.0,,2018,2,28,CASH_OUT,3613279.0,M798520669
14987,1196711',2018-03-01,NEFT/N060180485916851/PAY,0.0,29246.2,,2018,3,1,TRANSFER,29246.2,M394997233
14988,1196711',2018-03-01,NEFT/FDRL392043298/Indiaforensic,0.0,3000000.0,,2018,3,1,TRANSFER,3000000.0,M744438546
14989,1196711',2018-03-03,RTGS/ICICH18062413812/Indfor,0.0,3000000.0,,2018,3,3,CHECK_CASHING,3000000.0,M1837208185
14990,1196711',2018-03-03,NEFT/N062180487306072/PAY,0.0,31407.82,,2018,3,3,TRANSFER,31407.82,C1146577120
14991,1196711',2018-03-05,RTGS/ICICH18064445411/Indfor,0.0,3000000.0,,2018,3,5,TRANSFER,3000000.0,C1345969688
14992,1196711',2018-03-05,FDRL/INTERNAL FUND TRANSFE,2000000.0,0.0,,2018,3,5,CASH_OUT,2000000.0,M1759976906
14993,1196711',2018-03-05,FDRL/INTERNAL FUND TRANSFE,2000000.0,0.0,,2018,3,5,CASH_OUT,2000000.0,C1100871710
14994,1196711',2018-03-05,NEFT/N064180488050601/PAY,0.0,98.23,,2018,3,5,CASH_IN,98.23,M128775696
14995,1196711',2018-03-05,NEFT/N064180488464700/PAY,0.0,2014.15,,2018,3,5,TRANSFER,2014.15,C191614132
14996,1196711',2018-03-05,NEFT/FDRL392042856/Indiaforensic,0.0,3000000.0,,2018,3,5,CHECK_CASHING,3000000.0,M902010316
14997,1196711',2018-03-05,NEFT/FDRL392043292/Indiaforensic,0.0,3000000.0,,2018,3,5,TRANSFER,3000000.0,M799225701
14998,1196711',2018-03-06,FDRL/INTERNAL FUND TRANSFE,2000000.0,0.0,,2018,3,6,CASH_OUT,2000000.0,M1702039888
14999,1196711',2018-03-06,FDRL/INTERNAL FUND TRANSFE,2000000.0,0.0,,2018,3,6,DEBIT,2000000.0,C1336996537
15000,1196711',2018-03-06,FDRL/INTERNAL FUND TRANSFE,2000000.0,0.0,,2018,3,6,CHECK_WITHDRAWAL,2000000.0,M155212461
15001,1196711',2018-03-06,RF For 709003585308,0.0,6973.66,,2018,3,6,CHECK_CASHING,6973.66,M1271506146
15002,1196711',2018-03-06,RTGS/ICICH18065638876/Indfor,0.0,3000000.0,,2018,3,6,CHECK_CASHING,3000000.0,M960936344
15003,1196711',2018-03-06,FDRL/INTERNAL FUND TRANSFE,3000000.0,0.0,,2018,3,6,PAYEMENT,3000000.0,M1789211704
15004,1196711',2018-03-06,NEFT/N065180489541496/PAY,0.0,20063.95,,2018,3,6,CASH_IN,20063.95,M348863264
15005,1196711',2018-03-07,NEFT/N066180490548965/PAY,0.0,9026.35,,2018,3,7,CASH_IN,9026.35,M1348027050
15006,1196711',2018-03-08,NEFT/N067180491489773/PAY,0.0,4942.5,,2018,3,8,CASH_IN,4942.5,C1672788422
15007,1196711',2018-03-09,NEFT/N068180492580748/PAY,0.0,787.54,,2018,3,9,CHECK_CASHING,787.54,C1186256103
15008,1196711',2018-03-12,NEFT/N071180493964999/PAY,0.0,29931.26,,2018,3,12,CHECK_CASHING,29931.26,C47249488
15009,1196711',2018-03-13,RTGS/ICICH18072566658/Indfor,0.0,3000000.0,,2018,3,13,CASH_IN,3000000.0,M1463177359
15010,1196711',2018-03-13,FDRL/INTERNAL FUND TRANSFE,3000000.0,0.0,,2018,3,13,PAYEMENT,3000000.0,M1974955634
15011,1196711',2018-03-13,NEFT/N072180494866530/PAY,0.0,18895.44,,2018,3,13,CHECK_CASHING,18895.44,M1855550791
15012,1196711',2018-03-14,TRF TO  Indiaforensic SERVICES I,600000.0,0.0,,2018,3,14,DEBIT,600000.0,M1163160628
15013,1196711',2018-03-14,NEFT/N073180495734867/PAY,0.0,10530.0,,2018,3,14,TRANSFER,10530.0,M478445849
15014,1196711',2018-03-15,NEFT/N074180496544269/PAY,0.0,20320.8,,2018,3,15,TRANSFER,20320.8,M55494734
15015,1196711',2018-03-16,NEFT/N075180497339658/PAY,0.0,11.99,,2018,3,16,CASH_IN,11.99,C1796647535
15016,1196711',2018-03-17,RTGS/ICICH18076403110/Indfor,0.0,3000000.0,,2018,3,17,TRANSFER,3000000.0,C2146399713
15017,1196711',2018-03-17,FDRL/INTERNAL FUND TRANSFE,3000000.0,0.0,,2018,3,17,PAYEMENT,3000000.0,M1812430569
15018,1196711',2018-03-19,RTGS/ICICH18078578726/Indfor,0.0,3000000.0,,2018,3,19,TRANSFER,3000000.0,M1923754932
15019,1196711',2018-03-19,FDRL/INTERNAL FUND TRANSFE,3000000.0,0.0,,2018,3,19,PAYEMENT,3000000.0,M1255509609
15020,1196711',2018-03-19,NEFT/N078180498883627/PAY,0.0,92853.24,,2018,3,19,TRANSFER,92853.24,M2112782203
15021,1196711',2018-03-20,NEFT/N079180499879493/PAY,0.0,51218.65,,2018,3,20,CASH_IN,51218.65,C1909597726
15022,1196711',2018-03-21,RTGS/ICICH18080785130/Indfor,0.0,3000000.0,,2018,3,21,CASH_IN,3000000.0,M444285857
15023,1196711',2018-03-21,FDRL/INTERNAL FUND TRANSFE,3000000.0,0.0,,2018,3,21,DEBIT,3000000.0,M948522114
15024,1196711',2018-03-21,NEFT/N080180500599242/PAY,0.0,98.25,,2018,3,21,CASH_IN,98.25,M823410011
15025,1196711',2018-03-22,RTGS/UTIBH18081632864/Indfor,0.0,5000000.0,,2018,3,22,CHECK_CASHING,5000000.0,M1349098937
15026,1196711',2018-03-22,FDRL/INTERNAL FUND TRANSFE,3000000.0,0.0,,2018,3,22,CHECK_WITHDRAWAL,3000000.0,M564165122
15027,1196711',2018-03-22,FDRL/INTERNAL FUND TRANSFE,2000000.0,0.0,,2018,3,22,CHECK_WITHDRAWAL,2000000.0,M773647955
15028,1196711',2018-03-22,NEFT/N081180501354566/PAY,0.0,8553.51,,2018,3,22,TRANSFER,8553.51,M1316897063
15029,1196711',2018-03-23,NEFT/N082180502076868/PAY,0.0,21154.95,,2018,3,23,CASH_IN,21154.95,M335663575
15030,1196711',2018-03-26,NEFT/FDRL392042865/Indiaforensic,0.0,3000000.0,,2018,3,26,CASH_IN,3000000.0,M652132999
15031,1196711',2018-03-26,NEFT/N085180503391694/PAY,0.0,23860.95,,2018,3,26,CASH_IN,23860.95,M1460957046
15032,1196711',2018-03-26,FDRL/INTERNAL FUND TRANSFE,3000000.0,0.0,,2018,3,26,CASH_OUT,3000000.0,M869513100
15033,1196711',2018-03-27,RTGS/ICICH18086733501/Indfor,0.0,10000000.0,,2018,3,27,CASH_IN,10000000.0,M101403957
15034,1196711',2018-03-27,FDRL/INTERNAL FUND TRANSFE,3000000.0,0.0,,2018,3,27,CASH_OUT,3000000.0,M124792394
15035,1196711',2018-03-27,FDRL/INTERNAL FUND TRANSFE,3000000.0,0.0,,2018,3,27,DEBIT,3000000.0,M775240424
15036,1196711',2018-03-27,FDRL/INTERNAL FUND TRANSFE,3000000.0,0.0,,2018,3,27,CASH_OUT,3000000.0,M222056817
15037,1196711',2018-03-27,RTGS/ICICH18086733451/Indfor,0.0,15000000.0,,2018,3,27,CASH_IN,15000000.0,M635840278
15038,1196711',2018-03-27,RTGS/ICICH18086733461/Indfor,0.0,15000000.0,,2018,3,27,CASH_IN,15000000.0,M2962930
15039,1196711',2018-03-27,FDRL/INTERNAL FUND TRANSFE,3000000.0,0.0,,2018,3,27,CASH_OUT,3000000.0,M721763664
15040,1196711',2018-03-27,FDRL/INTERNAL FUND TRANSFE,2000000.0,0.0,,2018,3,27,PAYEMENT,2000000.0,M124466405
15041,1196711',2018-03-27,FDRL/INTERNAL FUND TRANSFE,3000000.0,0.0,,2018,3,27,PAYEMENT,3000000.0,M1091865345
15042,1196711',2018-03-27,FDRL/INTERNAL FUND TRANSFE,3000000.0,0.0,,2018,3,27,CASH_OUT,3000000.0,M1897638855
15043,1196711',2018-03-27,FDRL/INTERNAL FUND TRANSFE,3000000.0,0.0,,2018,3,27,CHECK_WITHDRAWAL,3000000.0,C1750956965
15044,1196711',2018-03-27,FDRL/INTERNAL FUND TRANSFE,3000000.0,0.0,,2018,3,27,CHECK_WITHDRAWAL,3000000.0,C549269634
15045,1196711',2018-03-27,FDRL/INTERNAL FUND TRANSFE,3000000.0,0.0,,2018,3,27,PAYEMENT,3000000.0,C549277650
15046,1196711',2018-03-27,FDRL/INTERNAL FUND TRANSFE,2000000.0,0.0,,2018,3,27,CASH_OUT,2000000.0,C545824
15047,1196711',2018-03-27,FDRL/INTERNAL FUND TRANSFE,3000000.0,0.0,,2018,3,27,DEBIT,3000000.0,M2050654105
15048,1196711',2018-03-27,FDRL/INTERNAL FUND TRANSFE,3000000.0,0.0,,2018,3,27,PAYEMENT,3000000.0,M419360457
15049,1196711',2018-03-27,FDRL/INTERNAL FUND TRANSFE,3000000.0,0.0,,2018,3,27,CHECK_WITHDRAWAL,3000000.0,C931548023
15050,1196711',2018-03-27,NEFT/N086180504339221/PAY,0.0,662.72,,2018,3,27,CHECK_CASHING,662.72,C1039162432
15051,1196711',2018-03-28,Loan Recovery For90900005,50319950.24,0.0,,2018,3,28,DEBIT,50319950.24,M2027724297
15052,1196711',2018-03-28,NEFT/N087180505559576/PAY,0.0,46912.43,,2018,3,28,TRANSFER,46912.43,C18928637
15053,1196711',2018-03-28,Loan Recovery For90900005,46912.43,0.0,,2018,3,28,CHECK_WITHDRAWAL,46912.43,M1612047235
15054,1196711',2018-03-31,NEFT/N090180508953903/PAY,0.0,27444.86,,2018,3,31,CASH_IN,27444.86,C1482944403
15055,1196711',2018-03-31,Loan Payment Reversal For,0.0,46912.43,,2018,3,31,CHECK_CASHING,46912.43,M934121062
15056,1196711',2018-03-31,Loan Payment Reversal For,0.0,50319950.24,,2018,3,31,TRANSFER,50319950.24,M749735773
15057,1196711',2018-03-31,WCDL ROLLOVER INTEREST  C,5772401.0,0.0,,2018,3,31,DEBIT,5772401.0,M875913646
15058,1196711',2018-03-31,1196711:Int.Coll:01-03-20,3763905.0,0.0,,2018,3,31,DEBIT,3763905.0,M994854574
15059,1196711',2018-04-03,NEFT/N093180510707517/PAY,0.0,49326.03,,2018,4,3,TRANSFER,49326.03,M1263545066
15060,1196711',2018-04-04,NEFT/N094180511834482/PAY,0.0,2592.41,,2018,4,4,TRANSFER,2592.41,M1456597478
15061,1196711',2018-04-05,NEFT/N095180513057501/PAY,0.0,46461.68,,2018,4,5,TRANSFER,46461.68,M1883890038
15062,1196711',2018-04-06,NEFT/N096180514016641/PAY,0.0,32759.83,,2018,4,6,CHECK_CASHING,32759.83,C33574809
15063,1196711',2018-04-07,NEFT/N097180514971106/PAY,0.0,97612.95,,2018,4,7,TRANSFER,97612.95,C1247051677
15064,1196711',2018-04-09,NEFT/N099180516139576/PAY,0.0,51388.06,,2018,4,9,CHECK_CASHING,51388.06,C627675433
15065,1196711',2018-04-10,NEFT/N100180517126285/PAY,0.0,5329.44,,2018,4,10,TRANSFER,5329.44,C1234363215
15066,1196711',2018-04-11,NEFT/N101180517990273/PAY,0.0,2561.88,,2018,4,11,TRANSFER,2561.88,M1762921286
15067,1196711',2018-04-12,NEFT/N102180518803738/PAY,0.0,85253.65,,2018,4,12,CASH_IN,85253.65,M1041430375
15068,1196711',2018-04-13,NEFT/N103180519655620/PAY,0.0,19353.81,,2018,4,13,CASH_IN,19353.81,C1917485266
15069,1196711',2018-04-16,NEFT/N106180520863690/PAY,0.0,150920.22,,2018,4,16,CHECK_CASHING,150920.22,C1552431935
15070,1196711',2018-04-17,NEFT/N107180521719317/PAY,0.0,34283.89,,2018,4,17,CASH_IN,34283.89,M918081502
15071,1196711',2018-04-18,NEFT/N108180522413969/PAY,0.0,42660.69,,2018,4,18,CHECK_CASHING,42660.69,M1153319888
15072,1196711',2018-04-19,NEFT/N109180523071413/PAY,0.0,51231.25,,2018,4,19,TRANSFER,51231.25,C2067466390
15073,1196711',2018-04-20,NEFT/N110180523793734/PAY,0.0,47209.23,,2018,4,20,CHECK_CASHING,47209.23,C1379289710
15074,1196711',2018-04-21,NEFT/N111180524381534/PAY,0.0,13976.06,,2018,4,21,CASH_IN,13976.06,M668528990
15075,1196711',2018-04-23,RTGS/UTIBH18113647041/Indfor,0.0,8500000.0,,2018,4,23,CHECK_CASHING,8500000.0,C1861188339
15076,1196711',2018-04-23,NEFT/N113180525147638/PAY,0.0,40769.49,,2018,4,23,CHECK_CASHING,40769.49,C2058204648
15077,1196711',2018-04-23,FDRL/INTERNAL FUND TRANSFE,0.0,2000000.0,,2018,4,23,CHECK_CASHING,2000000.0,C1697258007
15078,1196711',2018-04-24,TRF TO  Indiaforensic SERVICES I,1500000.0,0.0,,2018,4,24,PAYEMENT,1500000.0,M327811322
15079,1196711',2018-04-24,NEFT/N114180525874458/PAY,0.0,16855.51,,2018,4,24,CASH_IN,16855.51,M823036788
15080,1196711',2018-04-25,NEFT/N115180526533059/PAY,0.0,10892.73,,2018,4,25,CASH_IN,10892.73,M100596785
15081,1196711',2018-04-26,NEFT/N116180527275615/PAY,0.0,63204.98,,2018,4,26,CHECK_CASHING,63204.98,C998351292
15082,1196711',2018-04-26,TRF FROM  Indiaforensic SERVICES,0.0,500000.0,,2018,4,26,CHECK_CASHING,500000.0,M1284252295
15083,1196711',2018-04-27,Loan Recovery For90900005,222645.32,0.0,,2018,4,27,DEBIT,222645.32,M2136630818
15084,1196711',2018-04-27,NEFT/N117180528145008/PAY,0.0,24827.91,,2018,4,27,CASH_IN,24827.91,M1438274252
15085,1196711',2018-04-27,NEFT/AXIC181172299111/Indfor,0.0,1500000.0,,2018,4,27,TRANSFER,1500000.0,C1474346966
15086,1196711',2018-04-27,NEFT/AXIC181172299326/Indfor,0.0,6000000.0,,2018,4,27,CASH_IN,6000000.0,M1264144803
15087,1196711',2018-04-30,Loan Recovery For90900005,394521.0,0.0,,2018,4,30,CASH_OUT,394521.0,C1174600239
15088,1196711',2018-04-30,Loan Recovery For90900005,153041.0,0.0,,2018,4,30,CASH_OUT,153041.0,M1487557209
15089,1196711',2018-04-30,1196711:Int.Coll:01-04-20,3688497.0,0.0,,2018,4,30,CASH_OUT,3688497.0,C450960851
15090,1196711',2018-05-02,NEFT/N122180531683281/PAY,0.0,72061.51,,2018,5,2,CASH_IN,72061.51,C1096283470
15091,1196711',2018-05-02,NEFT/N122180531904129/PAY,0.0,25471.98,,2018,5,2,CHECK_CASHING,25471.98,M966734782
15092,1196711',2018-05-02,NEFT/AXIC181223594275/Indfor,0.0,15000000.0,,2018,5,2,CASH_IN,15000000.0,C1347342392
15093,1196711',2018-05-02,NEFT/AXIC181223594324/Indfor,0.0,5000000.0,,2018,5,2,CASH_IN,5000000.0,M1426868351
15094,1196711',2018-05-02,TRF FROM  Indiaforensic SERVICES,0.0,15000000.0,,2018,5,2,TRANSFER,15000000.0,M460637991
15095,1196711',2018-05-02,TRF FROM  Indiaforensic SERVICES,0.0,6700000.0,,2018,5,2,TRANSFER,6700000.0,C1760872167
15096,1196711',2018-05-02,FDRL/INTERNAL FUND TRANSFE,0.0,3000000.0,,2018,5,2,CHECK_CASHING,3000000.0,C30516998
15097,1196711',2018-05-02,FDRL/INTERNAL FUND TRANSFE,0.0,3000000.0,,2018,5,2,CHECK_CASHING,3000000.0,M1315507145
15098,1196711',2018-05-02,FDRL/INTERNAL FUND TRANSFE,0.0,3000000.0,,2018,5,2,CHECK_CASHING,3000000.0,M1052437700
15099,1196711',2018-05-03,NEFT/N123180533049385/PAY,0.0,58203.17,,2018,5,3,CASH_IN,58203.17,M110562008
15100,1196711',2018-05-04,NEFT/N124180533966007/PAY,0.0,22094.0,,2018,5,4,CHECK_CASHING,22094.0,M1030054228
15101,1196711',2018-05-05,NEFT/N125180534914122/PAY,0.0,26641.5,,2018,5,5,CASH_IN,26641.5,C482950564
15102,1196711',2018-05-05,FDRL/INTERNAL FUND TRANSFE,2000000.0,0.0,,2018,5,5,PAYEMENT,2000000.0,C1649449847
15103,1196711',2018-05-07,NEFT/N127180536065675/PAY,0.0,53026.88,,2018,5,7,CASH_IN,53026.88,M1901922257
15104,1196711',2018-05-08,NEFT/N128180537085724/PAY,0.0,66865.03,,2018,5,8,CHECK_CASHING,66865.03,M934426422
15105,1196711',2018-05-09,NEFT/N129180538009444/PAY,0.0,73109.77,,2018,5,9,TRANSFER,73109.77,M1812168612
15106,1196711',2018-05-10,NEFT/N130180539019299/PAY,0.0,68611.11,,2018,5,10,TRANSFER,68611.11,M172783967
15107,1196711',2018-05-11,NEFT/N131180539931950/PAY,0.0,16536.17,,2018,5,11,CASH_IN,16536.17,M1148185073
15108,1196711',2018-05-14,NEFT/N134180541164474/PAY,0.0,94418.97,,2018,5,14,CHECK_CASHING,94418.97,M247556293
15109,1196711',2018-05-15,NEFT/N135180541950046/PAY,0.0,56170.65,,2018,5,15,CASH_IN,56170.65,M885965439
15110,1196711',2018-05-15,TRF TO  Indiaforensic SERVICES I,1100000.0,0.0,,2018,5,15,CASH_OUT,1100000.0,M636036483
15111,1196711',2018-05-16,NEFT/N136180542699704/PAY,0.0,40685.12,,2018,5,16,TRANSFER,40685.12,M1150335365
15112,1196711',2018-05-16,Repayment credit [7090025,0.0,1146829.53,,2018,5,16,CHECK_CASHING,1146829.53,C1149788645
15113,1196711',2018-05-16,Repayment credit [7090026,0.0,567944.6,,2018,5,16,CHECK_CASHING,567944.6,M723392590
15114,1196711',2018-05-16,Repayment credit [7090030,0.0,111735.14,,2018,5,16,CHECK_CASHING,111735.14,M1938495631
15115,1196711',2018-05-16,Int:6637.00 and TAX:0.,0.0,6637.0,,2018,5,16,CHECK_CASHING,6637.0,C31639297
15116,1196711',2018-05-16,Repayment credit [7090017,0.0,150000.0,,2018,5,16,TRANSFER,150000.0,M1720061448
15117,1196711',2018-05-16,Repayment credit [7090027,0.0,113480.95,,2018,5,16,TRANSFER,113480.95,M960158519
15118,1196711',2018-05-16,Repayment credit [7090028,0.0,1694993.08,,2018,5,16,CHECK_CASHING,1694993.08,M2102070514
15119,1196711',2018-05-16,Repayment credit [7090027,0.0,113340.48,,2018,5,16,TRANSFER,113340.48,M1309673886
15120,1196711',2018-05-16,Repayment credit [7090035,0.0,215520.36,,2018,5,16,CASH_IN,215520.36,M495627026
15121,1196711',2018-05-16,Repayment credit [7090035,0.0,101167.0,,2018,5,16,CASH_IN,101167.0,C662267010
15122,1196711',2018-05-16,FDRL/INTERNAL FUND TRANSFE,2000000.0,0.0,,2018,5,16,CASH_OUT,2000000.0,M921579066
15123,1196711',2018-05-16,FDRL/INTERNAL FUND TRANSFE,2000000.0,0.0,,2018,5,16,DEBIT,2000000.0,M1174430969
15124,1196711',2018-05-17,NEFT/N137180543446722/PAY,0.0,3964.6,,2018,5,17,CASH_IN,3964.6,C976133979
15125,1196711',2018-05-18,NEFT/N138180544303588/PAY,0.0,23787.6,,2018,5,18,CASH_IN,23787.6,C638590716
15126,1196711',2018-05-19,FDRL/INTERNAL FUND TRANSFE,2000000.0,0.0,,2018,5,19,CASH_OUT,2000000.0,M2136352717
15127,1196711',2018-05-19,NEFT/N139180544797375/PAY,0.0,24048.99,,2018,5,19,TRANSFER,24048.99,C1467301185
15128,1196711',2018-05-21,NEFT/N141180545549022/PAY,0.0,4354.04,,2018,5,21,CASH_IN,4354.04,M1691680230
15129,1196711',2018-05-22,FDRL/INTERNAL FUND TRANSFE,2000000.0,0.0,,2018,5,22,DEBIT,2000000.0,C1963862935
15130,1196711',2018-05-22,NEFT/N142180546332910/PAY,0.0,31716.8,,2018,5,22,CASH_IN,31716.8,C119206855
15131,1196711',2018-05-23,FDRL/INTERNAL FUND TRANSFE,0.0,2000000.0,,2018,5,23,CASH_IN,2000000.0,C288106800
15132,1196711',2018-05-23,NEFT/N143180547028529/PAY,0.0,48047.91,,2018,5,23,CASH_IN,48047.91,C691636444
15133,1196711',2018-05-24,NEFT/N144180547786133/PAY,0.0,58507.95,,2018,5,24,TRANSFER,58507.95,C662736689
15134,1196711',2018-05-25,Loan Recovery For90900005,47778740.8,0.0,,2018,5,25,DEBIT,47778740.8,C191614132
15135,1196711',2018-05-25,NEFT/N145180548459932/PAY,0.0,49508.25,,2018,5,25,CASH_IN,49508.25,C518953848
15136,1196711',2018-05-25,Loan Recovery For90900005,49508.25,0.0,,2018,5,25,CHECK_WITHDRAWAL,49508.25,M1691012769
15137,1196711',2018-05-29,NEFT/N149180549736709/PAY,0.0,126649.95,,2018,5,29,CASH_IN,126649.95,M361228710
15138,1196711',2018-05-29,NEFT/N149180550483539/PAY,0.0,70679.05,,2018,5,29,CHECK_CASHING,70679.05,M1666506071
15139,1196711',2018-05-29,Loan Recovery For90900005,197329.0,0.0,,2018,5,29,PAYEMENT,197329.0,C1891412311
15140,1196711',2018-05-30,NEFT/N150180551374347/PAY,0.0,36331.54,,2018,5,30,CASH_IN,36331.54,M700017632
15141,1196711',2018-05-30,Loan Recovery For90900005,36331.54,0.0,,2018,5,30,CASH_OUT,36331.54,M382044033
15142,1196711',2018-05-31,NEFT/N151180552362570/PAY,0.0,62738.92,,2018,5,31,CHECK_CASHING,62738.92,M604560365
15143,1196711',2018-05-31,Loan Recovery For90900005,62738.92,0.0,,2018,5,31,PAYEMENT,62738.92,C1328839342
15144,1196711',2018-05-31,1196711:Int.Coll:01-05-20,3498151.0,0.0,,2018,5,31,DEBIT,3498151.0,C1685697739
15145,1196711',2018-06-01,Repayment credit [7090017,0.0,94430.0,,2018,6,1,TRANSFER,94430.0,C323287038
15146,1196711',2018-06-01,Repayment credit [7090017,0.0,94431.0,,2018,6,1,CHECK_CASHING,94431.0,M434852496
15147,1196711',2018-06-01,Repayment credit [7090017,0.0,104917.0,,2018,6,1,TRANSFER,104917.0,C1060041730
15148,1196711',2018-06-01,Repayment credit [7090026,0.0,342922.71,,2018,6,1,CASH_IN,342922.71,C1688209895
15149,1196711',2018-06-01,Repayment credit [7090028,0.0,22541.31,,2018,6,1,CASH_IN,22541.31,C1505755152
15150,1196711',2018-06-01,Repayment credit [7090035,0.0,459563.0,,2018,6,1,CASH_IN,459563.0,M1248699341
15151,1196711',2018-06-01,NEFT/N152180553819072/PAY,0.0,63462.86,,2018,6,1,CHECK_CASHING,63462.86,C2043257128
15152,1196711',2018-06-02,NEFT/N153180554698678/PAY,0.0,44332.78,,2018,6,2,TRANSFER,44332.78,M132822676
15153,1196711',2018-06-04,NEFT/N155180555862355/PAY,0.0,114287.73,,2018,6,4,CHECK_CASHING,114287.73,M475601084
15154,1196711',2018-06-04,FDRL/INTERNAL FUND TRANSFE,0.0,2000000.0,,2018,6,4,CASH_IN,2000000.0,M1741376873
15155,1196711',2018-06-05,NEFT/N156180556829582/PAY,0.0,31568.55,,2018,6,5,TRANSFER,31568.55,M1662949415
15156,1196711',2018-06-06,NEFT/N157180557807486/PAY,0.0,30026.45,,2018,6,6,CASH_IN,30026.45,M1406401193
15157,1196711',2018-06-07,NEFT/N158180558876124/PAY,0.0,47684.89,,2018,6,7,TRANSFER,47684.89,M1150887301
15158,1196711',2018-06-08,NEFT/N159180560077230/PAY,0.0,19500.6,,2018,6,8,CASH_IN,19500.6,M345079352
15159,1196711',2018-06-11,NEFT/N162180561550621/PAY,0.0,80628.36,,2018,6,11,CHECK_CASHING,80628.36,M1084366825
15160,1196711',2018-06-11,Loan Recovery For90900005,52146.24,0.0,,2018,6,11,CHECK_WITHDRAWAL,52146.24,M1493762588
15161,1196711',2018-06-12,NEFT/N163180562475040/PAY,0.0,87946.47,,2018,6,12,TRANSFER,87946.47,M300992832
15162,1196711',2018-06-12,Loan Recovery For90900005,87946.47,0.0,,2018,6,12,CHECK_WITHDRAWAL,87946.47,M1893502106
15163,1196711',2018-06-13,NEFT/N164180563413416/PAY,0.0,35201.85,,2018,6,13,CASH_IN,35201.85,M1216154208
15164,1196711',2018-06-13,Loan Recovery For90900005,35201.85,0.0,,2018,6,13,PAYEMENT,35201.85,M505279290
15165,1196711',2018-06-14,NEFT/N165180564296124/PAY,0.0,34359.05,,2018,6,14,CASH_IN,34359.05,M1653597866
15166,1196711',2018-06-14,Loan Recovery For90900005,34359.05,0.0,,2018,6,14,DEBIT,34359.05,C577628476
15167,1196711',2018-06-15,NEFT/N166180565048534/PAY,0.0,30028.79,,2018,6,15,TRANSFER,30028.79,C458582664
15168,1196711',2018-06-15,Loan Recovery For90900005,30028.79,0.0,,2018,6,15,CHECK_WITHDRAWAL,30028.79,M1078102490
15169,1196711',2018-06-19,NEFT/N170180566153952/PAY,0.0,87794.4,,2018,6,19,CASH_IN,87794.4,M473156117
15170,1196711',2018-06-19,NEFT/N170180566785058/PAY,0.0,16366.33,,2018,6,19,CHECK_CASHING,16366.33,M957143326
15171,1196711',2018-06-19,Loan Recovery For90900005,104160.73,0.0,,2018,6,19,CHECK_WITHDRAWAL,104160.73,C1938612885
15172,1196711',2018-06-20,NEFT/N171180567462208/PAY,0.0,17549.12,,2018,6,20,TRANSFER,17549.12,C1271612900
15173,1196711',2018-06-21,NEFT/N172180568287474/PAY,0.0,8646.76,,2018,6,21,CASH_IN,8646.76,C1772797104
15174,1196711',2018-06-22,NEFT/N173180569043805/PAY,0.0,14337.28,,2018,6,22,CASH_IN,14337.28,M241566847
15175,1196711',2018-06-25,NEFT/N176180570095803/PAY,0.0,189280.98,,2018,6,25,CHECK_CASHING,189280.98,M1624773236
15176,1196711',2018-06-26,NEFT/N177180570791698/PAY,0.0,137252.04,,2018,6,26,CHECK_CASHING,137252.04,C1172716014
15177,1196711',2018-06-26,NEFT/AXIC181770399096/Indfor,0.0,2400000.0,,2018,6,26,TRANSFER,2400000.0,C662045021
15178,1196711',2018-06-26,TRF FROM  Indiaforensic SERVICES,0.0,7600000.0,,2018,6,26,CHECK_CASHING,7600000.0,M1145404493
15179,1196711',2018-06-26,NEFT/SBIN518177711369/Indfor,0.0,1000000.0,,2018,6,26,TRANSFER,1000000.0,M661231346
15180,1196711',2018-06-26,TRF FROM  Indiaforensic SERVICES,0.0,1800000.0,,2018,6,26,CASH_IN,1800000.0,M1490532562
15181,1196711',2018-06-26,909000055389 - Payoff Sou,459447546.36,0.0,,2018,6,26,DEBIT,459447546.36,M26012554
15182,1196711',2018-06-26,Loan Recovery For90900005,1719519.82,0.0,,2018,6,26,CASH_OUT,1719519.82,M725840434
15183,1196711',2018-06-27,NEFT/N178180571497162/PAY,0.0,50483.53,,2018,6,27,CASH_IN,50483.53,M1855861537
15184,1196711',2018-06-27,TRF FROM  Indiaforensic SERVICES,0.0,2000000.0,,2018,6,27,CASH_IN,2000000.0,C732929236
15185,1196711',2018-06-28,RTGS/SBINH18179008308/Indfor,0.0,1400000.0,,2018,6,28,CHECK_CASHING,1400000.0,M1610943718
15186,1196711',2018-06-28,RTGS/UTIBH18179623788/Indfor,0.0,400000.0,,2018,6,28,TRANSFER,400000.0,M150863754
15187,1196711',2018-06-28,RTGS/SBINH18179012051/Indfor,0.0,1200000.0,,2018,6,28,CASH_IN,1200000.0,C1742312978
15188,1196711',2018-06-28,Loan Payment Reversal For,0.0,1719519.82,,2018,6,28,CASH_IN,1719519.82,C1647809929
15189,1196711',2018-06-28,WCDL ROLLOVER INTEREST  C,3366470.0,0.0,,2018,6,28,PAYEMENT,3366470.0,M1742927928
15190,1196711',2018-06-28,NEFT/N179180572441738/PAY,0.0,34715.05,,2018,6,28,CASH_IN,34715.05,M2105194121
15191,1196711',2018-06-29,NEFT/N180180573612092/PAY,0.0,116391.41,,2018,6,29,CHECK_CASHING,116391.41,C1487669283
15192,1196711',2018-06-30,Loan Recovery For90900005,102027.0,0.0,,2018,6,30,CASH_OUT,102027.0,M104214568
15193,1196711',2018-06-30,NEFT/N181180574597389/PAY,0.0,39408.54,,2018,6,30,CASH_IN,39408.54,C1871293699
15194,1196711',2018-06-30,1196711:Int.Coll:01-06-20,4248825.0,0.0,,2018,6,30,CHECK_WITHDRAWAL,4248825.0,M1181531093
15195,1196711',2018-07-02,NEFT/N183180576243939/PAY,0.0,132197.68,,2018,7,2,CHECK_CASHING,132197.68,C1117816135
15196,1196711',2018-07-03,NEFT/N184180577180985/PAY,0.0,52691.2,,2018,7,3,CASH_IN,52691.2,C1639464943
15197,1196711',2018-07-04,NEFT/N185180578181143/PAY,0.0,52251.71,,2018,7,4,CHECK_CASHING,52251.71,C1781090157
15198,1196711',2018-07-05,NEFT/N186180579251236/PAY,0.0,55622.27,,2018,7,5,CASH_IN,55622.27,M762350741
15199,1196711',2018-07-06,TRF TO  Indiaforensic SERVICES I,5000000.0,0.0,,2018,7,6,CHECK_WITHDRAWAL,5000000.0,M904572440
15200,1196711',2018-07-06,NEFT/N187180580232703/PAY,0.0,55236.67,,2018,7,6,TRANSFER,55236.67,C1695946783
15201,1196711',2018-07-06,TRF TO  Indiaforensic SERVICES I,6400000.0,0.0,,2018,7,6,PAYEMENT,6400000.0,C1414763289
15202,1196711',2018-07-07,NEFT/N188180581177093/PAY,0.0,45526.13,,2018,7,7,TRANSFER,45526.13,M1052117624
15203,1196711',2018-07-09,NEFT/N190180582267180/PAY,0.0,7441.81,,2018,7,9,CHECK_CASHING,7441.81,M2116117496
15204,1196711',2018-07-10,NEFT/N191180583186100/PAY,0.0,54121.5,,2018,7,10,CHECK_CASHING,54121.5,M1225909483
15205,1196711',2018-07-11,NEFT/N192180584300020/PAY,0.0,25322.35,,2018,7,11,CASH_IN,25322.35,C1469682037
15206,1196711',2018-07-12,NEFT/N193180585178528/PAY,0.0,23107.52,,2018,7,12,CHECK_CASHING,23107.52,C843774579
15207,1196711',2018-07-13,FDRL/INTERNAL FUND TRANSFE,0.0,3000000.0,,2018,7,13,TRANSFER,3000000.0,M230973673
15208,1196711',2018-07-13,RTGS/SBINH18194063160/Indfor,0.0,700000.0,,2018,7,13,CASH_IN,700000.0,C1948471365
15209,1196711',2018-07-13,NEFT/N194180586042171/PAY,0.0,32293.91,,2018,7,13,TRANSFER,32293.91,M1218787317
15210,1196711',2018-07-16,NEFT/N197180587312033/PAY,0.0,183268.25,,2018,7,16,TRANSFER,183268.25,M1499503896
15211,1196711',2018-07-17,NEFT/N198180588052575/PAY,0.0,158233.01,,2018,7,17,TRANSFER,158233.01,C783286238
15212,1196711',2018-07-18,NEFT/N199180588860126/PAY,0.0,41284.45,,2018,7,18,CASH_IN,41284.45,M626042428
15213,1196711',2018-07-19,NEFT/N200180589706160/PAY,0.0,34697.36,,2018,7,19,CHECK_CASHING,34697.36,M1208202676
15214,1196711',2018-07-20,RF For 709001747807,0.0,443552.0,,2018,7,20,CHECK_CASHING,443552.0,C649699940
15215,1196711',2018-07-20,NEFT/N201180590362733/PAY,0.0,40976.68,,2018,7,20,TRANSFER,40976.68,C1564588329
15216,1196711',2018-07-21,NEFT/N202180591039434/PAY,0.0,53229.44,,2018,7,21,CASH_IN,53229.44,C2040603986
15217,1196711',2018-07-21,709004012162 : Closure Pr,0.0,14988093.0,,2018,7,21,CASH_IN,14988093.0,M1104200204
15218,1196711',2018-07-21,Repayment credit [7090038,0.0,5023579.0,,2018,7,21,CHECK_CASHING,5023579.0,C8290162
15219,1196711',2018-07-21,FDRL/INTERNAL FUND TRANSFE,2000000.0,0.0,,2018,7,21,CASH_OUT,2000000.0,M1112597751
15220,1196711',2018-07-21,FDRL/INTERNAL FUND TRANSFE,3000000.0,0.0,,2018,7,21,PAYEMENT,3000000.0,C349421288
15221,1196711',2018-07-21,FDRL/INTERNAL FUND TRANSFE,2000000.0,0.0,,2018,7,21,PAYEMENT,2000000.0,M336458181
15222,1196711',2018-07-23,NEFT/N204180591759499/PAY,0.0,83242.57,,2018,7,23,CHECK_CASHING,83242.57,C808875552
15223,1196711',2018-07-23,TRF TO  Indiaforensic SERVICES I,600000.0,0.0,,2018,7,23,DEBIT,600000.0,M1096552547
15224,1196711',2018-07-24,NEFT/N205180592468135/PAY,0.0,122755.6,,2018,7,24,CHECK_CASHING,122755.6,M359865679
15225,1196711',2018-07-25,NEFT/N206180593249357/PAY,0.0,95508.33,,2018,7,25,TRANSFER,95508.33,M1406525961
15226,1196711',2018-07-26,NEFT/N207180593927092/PAY,0.0,122608.99,,2018,7,26,CHECK_CASHING,122608.99,M1190091152
15227,1196711',2018-07-27,Loan Recovery For90900005,370037.78,0.0,,2018,7,27,CHECK_WITHDRAWAL,370037.78,M294601340
15228,1196711',2018-07-27,NEFT/N208180594784758/PAY,0.0,15034.13,,2018,7,27,TRANSFER,15034.13,M1000026917
15229,1196711',2018-07-27,IMPS 820819356942 FROM OX,0.0,200000.0,,2018,7,27,TRANSFER,200000.0,M210095095
15230,1196711',2018-07-27,IMPS 820819356973 FROM OX,0.0,200000.0,,2018,7,27,CASH_IN,200000.0,M1334589377
15231,1196711',2018-07-27,IMPS 820819356999 FROM OX,0.0,200000.0,,2018,7,27,CHECK_CASHING,200000.0,M490274122
15232,1196711',2018-07-27,IMPS 820819357037 FROM OX,0.0,200000.0,,2018,7,27,TRANSFER,200000.0,M2145285202
15233,1196711',2018-07-27,IMPS 820819357072 FROM OX,0.0,200000.0,,2018,7,27,CASH_IN,200000.0,M405944028
15234,1196711',2018-07-27,IMPS 820819357100 FROM OX,0.0,200000.0,,2018,7,27,TRANSFER,200000.0,M1449044862
15235,1196711',2018-07-27,IMPS 820819357146 FROM OX,0.0,200000.0,,2018,7,27,TRANSFER,200000.0,M1332902717
15236,1196711',2018-07-27,IMPS 820819357172 FROM OX,0.0,200000.0,,2018,7,27,CHECK_CASHING,200000.0,M1200954029
15237,1196711',2018-07-27,IMPS 820819357199 FROM OX,0.0,200000.0,,2018,7,27,TRANSFER,200000.0,M615359715
15238,1196711',2018-07-27,IMPS 820819357741 FROM OX,0.0,200000.0,,2018,7,27,TRANSFER,200000.0,C1219161283
15239,1196711',2018-07-27,FDRL/INTERNAL FUND TRANSFE,2000000.0,0.0,,2018,7,27,PAYEMENT,2000000.0,M425928463
15240,1196711',2018-07-27,Repayment credit [7090038,0.0,10484981.0,,2018,7,27,CASH_IN,10484981.0,M218303955
15241,1196711',2018-07-27,TRF TO  Indiaforensic SERVICES I,9000000.0,0.0,,2018,7,27,PAYEMENT,9000000.0,M1175328696
15242,1196711',2018-07-27,Loan Recovery For90900005,1500015.13,0.0,,2018,7,27,PAYEMENT,1500015.13,M51721324
15243,1196711',2018-07-30,NEFT/N211180596086651/PAY,0.0,176384.08,,2018,7,30,TRANSFER,176384.08,M1534216822
15244,1196711',2018-07-30,Loan Recovery For90900005,176384.08,0.0,,2018,7,30,DEBIT,176384.08,C1453795463
15245,1196711',2018-07-31,NEFT/N212180597438998/PAY,0.0,46497.61,,2018,7,31,CHECK_CASHING,46497.61,C1665979484
15246,1196711',2018-07-31,Loan Recovery For90900005,46497.61,0.0,,2018,7,31,CHECK_WITHDRAWAL,46497.61,C54617902
15247,1196711',2018-07-31,1196711:Int.Coll:01-07-20,7530283.0,0.0,,2018,7,31,PAYEMENT,7530283.0,C424743902
15248,1196711',2018-08-01,NEFT/N213180598970275/PAY,0.0,24419.61,,2018,8,1,CHECK_CASHING,24419.61,C1477641326
15249,1196711',2018-08-02,NEFT/N214180600088605/PAY,0.0,44440.99,,2018,8,2,CHECK_CASHING,44440.99,C464246030
15250,1196711',2018-08-03,NEFT/N215180601025953/PAY,0.0,11049.22,,2018,8,3,TRANSFER,11049.22,M1449101293
15251,1196711',2018-08-04,NEFT/N216180601922855/PAY,0.0,33272.83,,2018,8,4,TRANSFER,33272.83,M1375446296
15252,1196711',2018-08-06,NEFT/N218180603026963/PAY,0.0,81675.63,,2018,8,6,CASH_IN,81675.63,M67674335
15253,1196711',2018-08-07,NEFT/N219180604131446/PAY,0.0,28308.86,,2018,8,7,CASH_IN,28308.86,M430078412
15254,1196711',2018-08-08,NEFT/N220180605239697/PAY,0.0,67844.62,,2018,8,8,CASH_IN,67844.62,M1732262057
15255,1196711',2018-08-09,NEFT/N221180606200317/PAY,0.0,103011.42,,2018,8,9,CASH_IN,103011.42,M382237346
15256,1196711',2018-08-10,NEFT/N222180607266602/PAY,0.0,19741.93,,2018,8,10,CHECK_CASHING,19741.93,M758042150
15257,1196711',2018-08-13,NEFT/N225180608756388/PAY,0.0,64113.62,,2018,8,13,TRANSFER,64113.62,M339992852
15258,1196711',2018-08-14,NEFT/N226180609859080/PAY,0.0,43222.25,,2018,8,14,TRANSFER,43222.25,M1832656647
15259,1196711',2018-08-16,NEFT/N228180610920599/PAY,0.0,37933.1,,2018,8,16,TRANSFER,37933.1,M2065505397
15260,1196711',2018-08-18,NEFT/N230180612207650/PAY,0.0,13124.7,,2018,8,18,CASH_IN,13124.7,M98558276
15261,1196711',2018-08-20,NEFT/N232180613082004/PAY,0.0,19015.54,,2018,8,20,CASH_IN,19015.54,M246834286
15262,1196711',2018-08-21,NEFT/N233180614090443/PAY,0.0,27932.85,,2018,8,21,TRANSFER,27932.85,M1286396344
15263,1196711',2018-08-23,NEFT/N235180615208323/PAY,0.0,18582.57,,2018,8,23,TRANSFER,18582.57,M896761429
15264,1196711',2018-08-23,FDRL/INTERNAL FUND TRANSFE,0.0,2000000.0,,2018,8,23,CHECK_CASHING,2000000.0,M927759396
15265,1196711',2018-08-23,TRF FROM  Indiaforensic SERVICES,0.0,2000000.0,,2018,8,23,TRANSFER,2000000.0,M1310639522
15266,1196711',2018-08-24,NEFT/N236180615956395/PAY,0.0,262.9,,2018,8,24,TRANSFER,262.9,M1073488243
15267,1196711',2018-08-27,TRF FRM  Indiaforensic SERVICES,0.0,3000000.0,,2018,8,27,TRANSFER,3000000.0,C843774579
15268,1196711',2018-08-27,Loan Recovery For90900005,1607669.64,0.0,,2018,8,27,DEBIT,1607669.64,C2141994208
15269,1196711',2018-08-29,NEFT/N241180618785271/PAY,0.0,5145.49,,2018,8,29,CHECK_CASHING,5145.49,M1893273985
15270,1196711',2018-08-29,Loan Recovery For90900005,5145.49,0.0,,2018,8,29,CASH_OUT,5145.49,C1001367899
15271,1196711',2018-08-31,NEFT/N243180621183172/PAY,0.0,38119.78,,2018,8,31,CASH_IN,38119.78,M1004384293
15272,1196711',2018-08-31,Loan Recovery For90900005,38119.78,0.0,,2018,8,31,DEBIT,38119.78,C25136566
15273,1196711',2018-08-31,1196711:Int.Coll:01-08-20,7660139.0,0.0,,2018,8,31,PAYEMENT,7660139.0,C28125426
15274,1196711',2018-09-01,NEFT/N244180622570659/PAY,0.0,3146.6,,2018,9,1,CHECK_CASHING,3146.6,C1292435170
15275,1196711',2018-09-03,NEFT/N246180623521563/PAY,0.0,4444.5,,2018,9,3,CASH_IN,4444.5,M186361435
15276,1196711',2018-09-05,NEFT/N248180625636773/PAY,0.0,3854.65,,2018,9,5,TRANSFER,3854.65,C2061354468
15277,1196711',2018-09-06,NEFT/N249180626733360/PAY,0.0,3133.92,,2018,9,6,CHECK_CASHING,3133.92,C1134266682
15278,1196711',2018-09-07,NEFT/N250180628000294/PAY,0.0,19623.2,,2018,9,7,TRANSFER,19623.2,M7400802
15279,1196711',2018-09-11,NEFT/N254180630671583/PAY,0.0,18223.12,,2018,9,11,CASH_IN,18223.12,C1068824137
15280,1196711',2018-09-12,NEFT/N255180631699501/PAY,0.0,21955.81,,2018,9,12,CASH_IN,21955.81,M618990452
15281,1196711',2018-09-14,NEFT/N257180633020343/PAY,0.0,8418.24,,2018,9,14,CASH_IN,8418.24,C2102549317
15282,1196711',2018-09-14,TRF FRM  Indiaforensic SERVICES,0.0,3000000.0,,2018,9,14,CHECK_CASHING,3000000.0,C818570949
15283,1196711',2018-09-15,NEFT/N258180633632507/PAY,0.0,491.25,,2018,9,15,CASH_IN,491.25,M1123111501
15284,1196711',2018-09-17,RTGS/SBINH18260007921/Indfor,0.0,4600000.0,,2018,9,17,CASH_IN,4600000.0,M771229611
15285,1196711',2018-09-17,Loan Recovery For90900005,23152.29,0.0,,2018,9,17,DEBIT,23152.29,C1337741679
15286,1196711',2018-09-19,NEFT/N262180636011565/PAY,0.0,10.81,,2018,9,19,TRANSFER,10.81,M1652759190
15287,1196711',2018-09-19,Loan Recovery For90900005,10.81,0.0,,2018,9,19,CASH_OUT,10.81,M525129514
15288,1196711',2018-09-21,NEFT/N264180637531148/PAY,0.0,982.5,,2018,9,21,CHECK_CASHING,982.5,M1728909076
15289,1196711',2018-09-21,Loan Recovery For90900005,982.5,0.0,,2018,9,21,CHECK_WITHDRAWAL,982.5,C1954751748
15290,1196711',2018-09-24,FDRL/INTERNAL FUND TRANSFE,0.0,5000000.0,,2018,9,24,CHECK_CASHING,5000000.0,M1471059402
15291,1196711',2018-09-24,FDRL/INTERNAL FUND TRANSFE,0.0,5000000.0,,2018,9,24,CHECK_CASHING,5000000.0,C91875495
15292,1196711',2018-09-24,FDRL/INTERNAL FUND TRANSFE,0.0,5000000.0,,2018,9,24,TRANSFER,5000000.0,C99275333
15293,1196711',2018-09-24,RTGS/SBINH18267053737/Indfor,0.0,10500000.0,,2018,9,24,TRANSFER,10500000.0,C1241827956
15294,1196711',2018-09-24,Payments For : 9090000577,25500000.0,0.0,,2018,9,24,DEBIT,25500000.0,C323302928
15295,1196711',2018-09-24,Payments For : 9090000577,10000000.0,0.0,,2018,9,24,PAYEMENT,10000000.0,M385721073
15296,1196711',2018-09-24,NEFT/N267180638607783/PAY,0.0,14789.5,,2018,9,24,CHECK_CASHING,14789.5,C1482979717
15297,1196711',2018-09-24,Loan Recovery For90900005,15014789.5,0.0,,2018,9,24,DEBIT,15014789.5,C339099861
15298,1196711',2018-09-25,FDRL/INTERNAL FUND TRANSFE,0.0,5000000.0,,2018,9,25,TRANSFER,5000000.0,M1577294668
15299,1196711',2018-09-25,FDRL/INTERNAL FUND TRANSFE,0.0,5000000.0,,2018,9,25,CHECK_CASHING,5000000.0,C2119123648
15300,1196711',2018-09-25,Payments For : 9090000577,10000000.0,0.0,,2018,9,25,CASH_OUT,10000000.0,C181917476
15301,1196711',2018-09-25,NEFT/N268180639429276/PAY,0.0,3834.8,,2018,9,25,TRANSFER,3834.8,M640617224
15302,1196711',2018-09-25,INTERCHANGE VISA JAN 2018,0.0,114763.01,,2018,9,25,CASH_IN,114763.01,C1019449674
15303,1196711',2018-09-25,INTERCHANGE VISA FEB 2018,0.0,126086.6,,2018,9,25,TRANSFER,126086.6,M209588135
15304,1196711',2018-09-25,INTERCHANGE VISA MAR 2018,0.0,9560.15,,2018,9,25,CHECK_CASHING,9560.15,C2126856079
15305,1196711',2018-09-25,INTERCHANGE VISA APR 2018,0.0,1799.2,,2018,9,25,CASH_IN,1799.2,C914293025
15306,1196711',2018-09-25,INTERCHANGE VISA MAY 2018,0.0,382.36,,2018,9,25,CHECK_CASHING,382.36,M730347137
15307,1196711',2018-09-25,INTERCHANGE VISA JUL 2017,0.0,142026.25,,2018,9,25,CASH_IN,142026.25,M600045899
15308,1196711',2018-09-25,INTERCHANGE VISA JUL 2017,0.0,25564.79,,2018,9,25,CASH_IN,25564.79,M650782336
15309,1196711',2018-09-25,INTERCHANGE VISA AUG 2017,0.0,179723.13,,2018,9,25,CASH_IN,179723.13,C464094472
15310,1196711',2018-09-25,INTERCHANGE VISA AUG 2017,0.0,32350.1,,2018,9,25,CASH_IN,32350.1,C1203094087
15311,1196711',2018-09-25,INTERCHANGE VISA SEP 2017,0.0,244545.09,,2018,9,25,TRANSFER,244545.09,M941243764
15312,1196711',2018-09-25,INTERCHANGE VISA OCT 2017,0.0,340078.17,,2018,9,25,TRANSFER,340078.17,C804836251
15313,1196711',2018-09-25,INTERCHANGE VISA NOV 2017,0.0,967624.57,,2018,9,25,CASH_IN,967624.57,C2103065350
15314,1196711',2018-09-25,INTERCHANGE VISA DEC 2017,0.0,360728.46,,2018,9,25,CHECK_CASHING,360728.46,M278750154
15315,1196711',2018-09-25,INTRCHG VISA FRMOCT15TOJU,0.0,3310722.72,,2018,9,25,TRANSFER,3310722.72,M287759079
15316,1196711',2018-09-25,CREDIT NOTE ENTRY OX1819C,1360.68,0.0,,2018,9,25,PAYEMENT,1360.68,M998964671
15317,1196711',2018-09-25,CREDIT NOTE ENTRY OX1819C,272.14,0.0,,2018,9,25,PAYEMENT,272.14,M1734534618
15318,1196711',2018-09-25,Loan Recovery For90900005,5858156.58,0.0,,2018,9,25,DEBIT,5858156.58,M1499676908
15319,1196711',2018-09-26,TRF FROM  Indiaforensic SERVICES,0.0,5800000.0,,2018,9,26,CASH_IN,5800000.0,M1325060488
15320,1196711',2018-09-26,Indiaforensic AEPS NPCI WDL SET,0.0,7393800.0,,2018,9,26,TRANSFER,7393800.0,M2045126852
15321,1196711',2018-09-26,Payments For : 9090000577,5800000.0,0.0,,2018,9,26,CHECK_WITHDRAWAL,5800000.0,M1782096467
15322,1196711',2018-09-26,Payments For : 9090000577,7393800.0,0.0,,2018,9,26,PAYEMENT,7393800.0,M335215617
15323,1196711',2018-09-26,NEFT/N269180640316955/PAY,0.0,13528.32,,2018,9,26,TRANSFER,13528.32,M2092020026
15324,1196711',2018-09-26,Loan Recovery For90900005,13528.32,0.0,,2018,9,26,PAYEMENT,13528.32,M1909001971
15325,1196711',2018-09-27,Indiaforensic AEPS NPCI WDL SET,0.0,7003500.0,,2018,9,27,CASH_IN,7003500.0,M1989912413
15326,1196711',2018-09-27,Payments For : 9090000577,7003500.0,0.0,,2018,9,27,CHECK_WITHDRAWAL,7003500.0,M1161067023
15327,1196711',2018-09-27,NEFT/N270180641082393/PAY,0.0,12320.71,,2018,9,27,CASH_IN,12320.71,M2114665849
15328,1196711',2018-09-27,Loan Recovery For90900005,12320.71,0.0,,2018,9,27,PAYEMENT,12320.71,M2117314162
15329,1196711',2018-09-28,Indiaforensic AEPS NPCI WDL SET,0.0,6823200.0,,2018,9,28,CASH_IN,6823200.0,M48297670
15330,1196711',2018-09-28,909000057710 - Payoff Sou,1743180.58,0.0,,2018,9,28,PAYEMENT,1743180.58,M1941697335
15331,1196711',2018-09-28,NEFT/N271180642290173/PAY,0.0,22035.6,,2018,9,28,TRANSFER,22035.6,M1827336078
15332,1196711',2018-09-28,TRF TO  Indiaforensic SERVICES I,1000000.0,0.0,,2018,9,28,DEBIT,1000000.0,M382826571
15333,1196711',2018-09-29,NEFT/N272180643516652/PAY,0.0,10567.5,,2018,9,29,TRANSFER,10567.5,M267580296
15334,1196711',2018-09-30,1196711:Int.Coll:01-09-20,7406095.0,0.0,,2018,9,30,DEBIT,7406095.0,M1347568188
15335,1196711',2018-10-04,FDRL/INTERNAL FUND TRANSFE,0.0,5000000.0,,2018,10,4,CASH_IN,5000000.0,M55629191
15336,1196711',2018-10-05,Repayment credit [7090030,0.0,90905785.47,,2018,10,5,CHECK_CASHING,90905785.47,C1110618954
15337,1196711',2018-10-05,TRF FROM  Indiaforensic SERVICES,0.0,2500000.0,,2018,10,5,CASH_IN,2500000.0,M1144462420
15338,1196711',2018-10-05,TRF FOR FD,90905785.47,0.0,,2018,10,5,CASH_OUT,90905785.47,C430297016
15339,1196711',2018-10-06,NEFT/N279180649920018/PAY,0.0,24306.39,,2018,10,6,CHECK_CASHING,24306.39,M212029700
15340,1196711',2018-10-08,NEFT/N281180651087621/PAY,0.0,6392.05,,2018,10,8,CASH_IN,6392.05,C524804429
15341,1196711',2018-10-09,NEFT/N282180652088704/PAY,0.0,3917.4,,2018,10,9,CASH_IN,3917.4,M1106531151
15342,1196711',2018-10-10,NEFT/N283180653297538/PAY,0.0,1916.51,,2018,10,10,TRANSFER,1916.51,C1931283804
15343,1196711',2018-10-11,Repayment credit [7090017,0.0,1518419.0,,2018,10,11,CHECK_CASHING,1518419.0,C1626759869
15344,1196711',2018-10-11,Repayment credit [7090017,0.0,2741949.0,,2018,10,11,CASH_IN,2741949.0,C323302928
15345,1196711',2018-10-11,Repayment credit [7090017,0.0,2831698.0,,2018,10,11,CASH_IN,2831698.0,C90486891
15346,1196711',2018-10-11,TRF TO  Indiaforensic SERVICES I,7200000.0,0.0,,2018,10,11,DEBIT,7200000.0,C391734039
15347,1196711',2018-10-15,NEFT/N288180656712637/PAY,0.0,15669.6,,2018,10,15,TRANSFER,15669.6,C1233454027
15348,1196711',2018-10-17,NEFT/N290180658503186/PAY,0.0,9647.23,,2018,10,17,TRANSFER,9647.23,C1446521801
15349,1196711',2018-10-19,NEFT/N292180659365688/PAY,0.0,31536.7,,2018,10,19,CASH_IN,31536.7,C1839337592
15350,1196711',2018-10-22,NEFT/N295180660756686/PAY,0.0,2100.57,,2018,10,22,CASH_IN,2100.57,C935808590
15351,1196711',2018-10-23,NEFT/N296180661526703/PAY,0.0,3917.4,,2018,10,23,CASH_IN,3917.4,C1938348365
15352,1196711',2018-10-24,NEFT/N297180662366983/PAY,0.0,882.5,,2018,10,24,CHECK_CASHING,882.5,C1207946845
15353,1196711',2018-10-26,NEFT/N299180663995685/PAY,0.0,647.6,,2018,10,26,CHECK_CASHING,647.6,C1394526584
15354,1196711',2018-10-29,NEFT/N302180665242774/PAY,0.0,86.38,,2018,10,29,CHECK_CASHING,86.38,C2127862399
15355,1196711',2018-10-30,NEFT/N303180666217073/PAY,0.0,19782.37,,2018,10,30,TRANSFER,19782.37,C1320515149
15356,1196711',2018-10-31,TRF FROM  Indiaforensic SERVICES,0.0,354000000.0,,2018,10,31,TRANSFER,354000000.0,C539486713
15357,1196711',2018-10-31,NEFT/N304180667607059/PAY,0.0,13725.1,,2018,10,31,CASH_IN,13725.1,C1495761010
15358,1196711',2018-10-31,1196711:Int.Coll:01-10-20,7497190.0,0.0,,2018,10,31,CASH_OUT,7497190.0,C1359484306
15359,1196711',2018-11-01,NEFT/N305180669161833/PAY,0.0,38.95,,2018,11,1,CHECK_CASHING,38.95,C1235151206
15360,1196711',2018-11-02,NEFT/N306180670636622/PAY,0.0,3930.28,,2018,11,2,TRANSFER,3930.28,C1218365329
15361,1196711',2018-11-03,NEFT/N307180671819761/PAY,0.0,14300.47,,2018,11,3,TRANSFER,14300.47,C208427878
15362,1196711',2018-11-05,NEFT/N309180673804862/PAY,0.0,16149.17,,2018,11,5,CASH_IN,16149.17,C58642425
15363,1196711',2018-11-06,TRF FROM  Indiaforensic SERVICES,0.0,2000000.0,,2018,11,6,CHECK_CASHING,2000000.0,C1395746279
15364,1196711',2018-11-06,NEFT/N310180674929131/PAY,0.0,13094.98,,2018,11,6,TRANSFER,13094.98,C237988421
15365,1196711',2018-11-09,NEFT/N313180676755589/PAY,0.0,1410.97,,2018,11,9,CASH_IN,1410.97,C1947645280
15366,1196711',2018-11-13,NEFT/N317180678862259/PAY,0.0,26.06,,2018,11,13,CASH_IN,26.06,C1892922524
15367,1196711',2018-11-13,NEFT/SBIN918317490030/Indfor,0.0,1300000.0,,2018,11,13,TRANSFER,1300000.0,C1127705091
15368,1196711',2018-11-15,TRF FROM  Indiaforensic SERVICES,0.0,2000000.0,,2018,11,15,TRANSFER,2000000.0,C1100767002
15369,1196711',2018-11-15,NEFT/N319180680651555/PAY,0.0,2184.1,,2018,11,15,TRANSFER,2184.1,C978740207
15370,1196711',2018-11-16,TRF FROM  Indiaforensic SERVICES,0.0,1000000.0,,2018,11,16,TRANSFER,1000000.0,C1533182537
15371,1196711',2018-11-22,TRF FROM  Indiaforensic SERVICES,0.0,2000000.0,,2018,11,22,CHECK_CASHING,2000000.0,C1978557426
15372,1196711',2018-11-30,1196711:Int.Coll:01-11-20,4515687.0,0.0,,2018,11,30,PAYEMENT,4515687.0,C623476050
15373,1196711',2018-12-12,FDRL/INTERNAL FUND TRANSFE,0.0,1000000.0,,2018,12,12,CASH_IN,1000000.0,C674913323
15374,1196711',2018-12-14,FDRL/INTERNAL FUND TRANSFE,0.0,1000000.0,,2018,12,14,CASH_IN,1000000.0,C1749476584
15375,1196711',2018-12-14,FDRL/INTERNAL FUND TRANSFE,0.0,1000000.0,,2018,12,14,CASH_IN,1000000.0,C453211571
15376,1196711',2018-12-15,IMPS 834922115959 FROM OX,0.0,200000.0,,2018,12,15,CHECK_CASHING,200000.0,C9916873
15377,1196711',2018-12-15,IMPS 834922115978 FROM OX,0.0,200000.0,,2018,12,15,CHECK_CASHING,200000.0,C1962165946
15378,1196711',2018-12-15,IMPS 834922115993 FROM OX,0.0,200000.0,,2018,12,15,CASH_IN,200000.0,C1508456612
15379,1196711',2018-12-15,IMPS 834922116011 FROM OX,0.0,200000.0,,2018,12,15,TRANSFER,200000.0,C1359484306
15380,1196711',2018-12-15,IMPS 834922116031 FROM OX,0.0,200000.0,,2018,12,15,CHECK_CASHING,200000.0,C257099532
15381,1196711',2018-12-15,IMPS 834922116045 FROM OX,0.0,200000.0,,2018,12,15,TRANSFER,200000.0,C582320549
15382,1196711',2018-12-15,IMPS 834922116284 FROM OX,0.0,200000.0,,2018,12,15,TRANSFER,200000.0,C747979499
15383,1196711',2018-12-15,IMPS 834922116298 FROM OX,0.0,200000.0,,2018,12,15,CHECK_CASHING,200000.0,C1495001462
15384,1196711',2018-12-15,IMPS 834922116312 FROM OX,0.0,200000.0,,2018,12,15,TRANSFER,200000.0,C2116802101
15385,1196711',2018-12-24,FDRL/INTERNAL FUND TRANSFE,7500000.0,0.0,,2018,12,24,CHECK_WITHDRAWAL,7500000.0,C256902273
15386,1196711',2018-12-24,FDRL/INTERNAL FUND TRANSFE,500000.0,0.0,,2018,12,24,CHECK_WITHDRAWAL,500000.0,C1564588329
15387,1196711',2018-12-24,FDRL/INTERNAL FUND TRANSFE,2000000.0,0.0,,2018,12,24,CHECK_WITHDRAWAL,2000000.0,M1713864158
15388,1196711',2018-12-24,FDRL/INTERNAL FUND TRANSFE,3000000.0,0.0,,2018,12,24,CASH_OUT,3000000.0,M1040227786
15389,1196711',2018-12-26,FDRL/INTERNAL FUND TRANSFE,2000000.0,0.0,,2018,12,26,DEBIT,2000000.0,M1067704735
15390,1196711',2018-12-31,1196711:Int.Coll:01-12-20,4681699.0,0.0,,2018,12,31,PAYEMENT,4681699.0,C551545010
15391,1196428',2018-01-01,NEFT/KKBK180018097135/Acc,0.0,5000000.0,,2018,1,1,TRANSFER,5000000.0,C506903242
15392,1196428',2018-01-01,FDRL/REAL TIME GROSS SETTL,2000000.0,0.0,,2018,1,1,DEBIT,2000000.0,M2072059657
15393,1196428',2018-01-01,FDRL/REAL TIME GROSS SETTL,2000000.0,0.0,,2018,1,1,CASH_OUT,2000000.0,C304406966
15394,1196428',2018-01-01,RTGS/HDFCH18001529675/PAY,0.0,5040000.0,,2018,1,1,CHECK_CASHING,5040000.0,C75629578
15395,1196428',2018-01-01,RTGS/HDFCH18001529703/PAY,0.0,5760000.0,,2018,1,1,CASH_IN,5760000.0,M1037398211
15396,1196428',2018-01-01,FDRL/REAL TIME GROSS SETTL,5000000.0,0.0,,2018,1,1,DEBIT,5000000.0,C2072030256
15397,1196428',2018-01-01,FDRL/REAL TIME GROSS SETTL,5000000.0,0.0,,2018,1,1,CHECK_WITHDRAWAL,5000000.0,C886888353
15398,1196428',2018-01-01,CASHDEP/VIKASMARG/TP,0.0,77000.0,,2018,1,1,CASH_IN,77000.0,C701279123
15399,1196428',2018-01-01,TRF FRM  Indiaforensic SERVICES,0.0,500000.0,,2018,1,1,TRANSFER,500000.0,C864016033
15400,1196428',2018-01-01,TRF FRM  Indiaforensic SERVICES,0.0,4000000.0,,2018,1,1,TRANSFER,4000000.0,C515442419
15401,1196428',2018-01-01,NEFT/N001180443425160/PAY,0.0,331920.67,,2018,1,1,CASH_IN,331920.67,M2127093801
15402,1196428',2018-01-01,NEFT/N001180443425213/PAY,0.0,1416105.84,,2018,1,1,CHECK_CASHING,1416105.84,C1649686970
15403,1196428',2018-01-01,NEFT/FDRL656260341/Indiaforensic,0.0,1000000.0,,2018,1,1,CHECK_CASHING,1000000.0,C701855966
15404,1196428',2018-01-01,TRF FROM  Indiaforensic SERVICES,0.0,2000000.0,,2018,1,1,CASH_IN,2000000.0,C1505217516
15405,1196428',2018-01-01,TRF TO  Indiaforensic SERVICES I,0.0,10000000.0,,2018,1,1,TRANSFER,10000000.0,M676875212
15406,1196428',2018-01-01,TRF FROM  Indiaforensic SERVICES,0.0,500000.0,,2018,1,1,TRANSFER,500000.0,C681709819
15407,1196428',2018-01-01,FDRL/INTERNAL FUND TRANSFE,9000000.0,0.0,,2018,1,1,DEBIT,9000000.0,M1025042585
15408,1196428',2018-01-01,FDRL/INTERNAL FUND TRANSFE,9000000.0,0.0,,2018,1,1,DEBIT,9000000.0,C807247901
15409,1196428',2018-01-01,FDRL/INTERNAL FUND TRANSFE,3000000.0,0.0,,2018,1,1,PAYEMENT,3000000.0,M18308448
15410,1196428',2018-01-02,CASHDEP/NOIDA/TP,0.0,51000.0,,2018,1,2,CASH_IN,51000.0,M170030714
15411,1196428',2018-01-02,IMPS 800211781457 FROM SA,0.0,75000.0,,2018,1,2,CASH_IN,75000.0,M621155607
15412,1196428',2018-01-02,RTGS/HDFCH18002601675/PAY,0.0,5360000.0,,2018,1,2,CHECK_CASHING,5360000.0,C1660095722
15413,1196428',2018-01-02,RTGS/HDFCH18002601688/PAY,0.0,3280000.0,,2018,1,2,CHECK_CASHING,3280000.0,M1571765149
15414,1196428',2018-01-02,FDRL/REAL TIME GROSS SETTL,3000000.0,0.0,,2018,1,2,DEBIT,3000000.0,C1663686815
15415,1196428',2018-01-02,FDRL/REAL TIME GROSS SETTL,5000000.0,0.0,,2018,1,2,PAYEMENT,5000000.0,M279824269
15416,1196428',2018-01-02,RTGS/BARBH18002770235/MAK,0.0,201111.0,,2018,1,2,CASH_IN,201111.0,M1570490488
15417,1196428',2018-01-02,NEFT/20384045391DC/ARTHAS,0.0,125000.0,,2018,1,2,TRANSFER,125000.0,M1063002743
15418,1196428',2018-01-02,RTGS/IDFBH18002300590/ART,0.0,10000000.0,,2018,1,2,CASH_IN,10000000.0,M1530195938
15419,1196428',2018-01-02,RTGS/IDFBH18002300593/ART,0.0,10000000.0,,2018,1,2,CASH_IN,10000000.0,C1883840933
15420,1196428',2018-01-02,RTGS/IDFBH18002300607/ART,0.0,10000000.0,,2018,1,2,CASH_IN,10000000.0,M2097586567
15421,1196428',2018-01-02,FDRL/REAL TIME GROSS SETTL,15000000.0,0.0,,2018,1,2,CHECK_WITHDRAWAL,15000000.0,C1700852615
15422,1196428',2018-01-02,FDRL/REAL TIME GROSS SETTL,1000000.0,0.0,,2018,1,2,DEBIT,1000000.0,C1457728035
15423,1196428',2018-01-02,FDRL/REAL TIME GROSS SETTL,15000000.0,0.0,,2018,1,2,PAYEMENT,15000000.0,C47249488
15424,1196428',2018-01-02,RTGS/HDFCH18002649594/PAY,0.0,2061456.88,,2018,1,2,CHECK_CASHING,2061456.88,C33524623
15425,1196428',2018-01-02,RTGS/HDFCH18002649617/PAY,0.0,1431618.96,,2018,1,2,CHECK_CASHING,1431618.96,C2133591152
15426,1196428',2018-01-02,FDRL/REAL TIME GROSS SETTL,3000000.0,0.0,,2018,1,2,PAYEMENT,3000000.0,C193864812
15427,1196428',2018-01-02,FDRL/INTERNAL FUND TRANSFE,200000.0,0.0,,2018,1,2,PAYEMENT,200000.0,C1058921154
15428,1196428',2018-01-02,FDRL/INTERNAL FUND TRANSFE,200000.0,0.0,,2018,1,2,DEBIT,200000.0,C798678484
15429,1196428',2018-01-02,Indiaforensic SERVICES INDIA PVT,0.0,2290185.0,,2018,1,2,TRANSFER,2290185.0,C769342184
15430,1196428',2018-01-02,NEFT/FDRL656260002/Indiaforensic,0.0,1000000.0,,2018,1,2,CASH_IN,1000000.0,C981198566
15431,1196428',2018-01-02,NEFT/FDRL656260343/Indiaforensic,0.0,1000000.0,,2018,1,2,CHECK_CASHING,1000000.0,C1281898359
15432,1196428',2018-01-02,NEFT/N002180444408561/PAY,0.0,225.73,,2018,1,2,CHECK_CASHING,225.73,C30013970
15433,1196428',2018-01-02,TRF FROM  Indiaforensic SERVICES,0.0,4600000.0,,2018,1,2,TRANSFER,4600000.0,C31789747
15434,1196428',2018-01-02,NEFT/KKBK180028373032/Acc,0.0,8000000.0,,2018,1,2,CHECK_CASHING,8000000.0,C93518808
15435,1196428',2018-01-02,FDRL/INTERNAL FUND TRANSFE,15000000.0,0.0,,2018,1,2,PAYEMENT,15000000.0,C2093546827
15436,1196428',2018-01-02,FDRL/INTERNAL FUND TRANSFE,2000000.0,0.0,,2018,1,2,CHECK_WITHDRAWAL,2000000.0,C976133979
15437,1196428',2018-01-03,TRF FROM  Indiaforensic SERVICES,0.0,3000000.0,,2018,1,3,CHECK_CASHING,3000000.0,C849038219
15438,1196428',2018-01-03,TRF FROM  Indiaforensic SERVICES,0.0,500000.0,,2018,1,3,TRANSFER,500000.0,C1789550256
15439,1196428',2018-01-03,RTGS/HDFCH18003695112/PAY,0.0,5040000.0,,2018,1,3,CASH_IN,5040000.0,C363475076
15440,1196428',2018-01-03,RTGS/HDFCH18003695100/PAY,0.0,4720000.0,,2018,1,3,TRANSFER,4720000.0,C2110623348
15441,1196428',2018-01-03,FDRL/INTERNAL FUND TRANSFE,500000.0,0.0,,2018,1,3,CASH_OUT,500000.0,C1161820020
15442,1196428',2018-01-03,FDRL/REAL TIME GROSS SETTL,3000000.0,0.0,,2018,1,3,PAYEMENT,3000000.0,C627675433
15443,1196428',2018-01-03,FIXED   MOBILE PTE LTD/US,0.0,629668.65,,2018,1,3,CASH_IN,629668.65,C1145835418
15444,1196428',2018-01-03,IRTT00701800278,951.7,0.0,,2018,1,3,PAYEMENT,951.7,C1778300121
15445,1196428',2018-01-03,IB:TPFT0052749061 4090004,0.0,10000.0,,2018,1,3,TRANSFER,10000.0,C1325626015
15446,1196428',2018-01-03,IRTT00701800279,1771.53,0.0,,2018,1,3,PAYEMENT,1771.53,C8733802
15447,1196428',2018-01-03,"Indiaforensic USA, INC./USD/5863",0.0,3702958.76,,2018,1,3,CASH_IN,3702958.76,C990053853
15448,1196428',2018-01-03,FDRL/REAL TIME GROSS SETTL,5000000.0,0.0,,2018,1,3,CASH_OUT,5000000.0,C218193338
15449,1196428',2018-01-03,IMPS 800316296507 FROM DA,0.0,50000.0,,2018,1,3,CHECK_CASHING,50000.0,M832073005
15450,1196428',2018-01-03,NEFT/N003180445148289/PAY,0.0,1127351.21,,2018,1,3,CASH_IN,1127351.21,M189083850
15451,1196428',2018-01-03,Indiaforensic SERVICES INDIA PVT,0.0,860758.0,,2018,1,3,TRANSFER,860758.0,C103357744
15452,1196428',2018-01-03,NEFT/N003180445141415/PAY,0.0,1063705.96,,2018,1,3,CASH_IN,1063705.96,M1942890330
15453,1196428',2018-01-03,FDRL/NATIONAL ELECTRONIC F,10000000.0,0.0,,2018,1,3,CASH_OUT,10000000.0,C2011941350
15454,1196428',2018-01-03,NEFT/AXISP18003056338/ACC,0.0,8000000.0,,2018,1,3,CASH_IN,8000000.0,C1505755152
15455,1196428',2018-01-03,NEFT/N003180445251308/PAY,0.0,164458.09,,2018,1,3,CHECK_CASHING,164458.09,M1051118371
15456,1196428',2018-01-03,NEFT/FDRL656260345/Indiaforensic,0.0,2000000.0,,2018,1,3,TRANSFER,2000000.0,M1502077581
15457,1196428',2018-01-03,TRF FROM  Indiaforensic SERVICES,0.0,800000.0,,2018,1,3,CHECK_CASHING,800000.0,M1801625172
15458,1196428',2018-01-03,TRF FROM  Indiaforensic SERVICES,0.0,13500000.0,,2018,1,3,CASH_IN,13500000.0,C360898540
15459,1196428',2018-01-03,TRF FROM  Indiaforensic SERVICES,0.0,3100000.0,,2018,1,3,TRANSFER,3100000.0,M1408738192
15460,1196428',2018-01-03,NEFT/IDFBH18003054934/ART,0.0,5000000.0,,2018,1,3,CASH_IN,5000000.0,C237594516
15461,1196428',2018-01-03,FDRL/INTERNAL FUND TRANSFE,10000000.0,0.0,,2018,1,3,DEBIT,10000000.0,M1645271006
15462,1196428',2018-01-03,FDRL/INTERNAL FUND TRANSFE,15000000.0,0.0,,2018,1,3,DEBIT,15000000.0,M1616707854
15463,1196428',2018-01-04,NEFT/N003180445377119/TEC,0.0,300000.0,,2018,1,4,CASH_IN,300000.0,C1334973394
15464,1196428',2018-01-04,FDRL/REAL TIME GROSS SETTL,10000000.0,0.0,,2018,1,4,PAYEMENT,10000000.0,M1547406846
15465,1196428',2018-01-04,RTGS/HDFCH18004772647/PAY,0.0,3520000.0,,2018,1,4,TRANSFER,3520000.0,M51814511
15466,1196428',2018-01-04,RTGS/HDFCH18004774557/PAY,0.0,5520000.0,,2018,1,4,TRANSFER,5520000.0,M1679527434
15467,1196428',2018-01-04,RTGS/BARBH18004440050/MAK,0.0,200555.0,,2018,1,4,CASH_IN,200555.0,M858729243
15468,1196428',2018-01-04,FDRL/NATIONAL ELECTRONIC F,100000.0,0.0,,2018,1,4,CASH_OUT,100000.0,M317858117
15469,1196428',2018-01-04,FDRL/NATIONAL ELECTRONIC F,200000.0,0.0,,2018,1,4,PAYEMENT,200000.0,M974232437
15470,1196428',2018-01-04,FDRL/INTERNAL FUND TRANSFE,500000.0,0.0,,2018,1,4,CASH_OUT,500000.0,M535001108
15471,1196428',2018-01-04,FDRL/INTERNAL FUND TRANSFE,500000.0,0.0,,2018,1,4,CHECK_WITHDRAWAL,500000.0,M967799453
15472,1196428',2018-01-04,FDRL/REAL TIME GROSS SETTL,5000000.0,0.0,,2018,1,4,DEBIT,5000000.0,M1704857178
15473,1196428',2018-01-04,FDRL/REAL TIME GROSS SETTL,3000000.0,0.0,,2018,1,4,DEBIT,3000000.0,M888552844
15474,1196428',2018-01-04,RTGS/ICICH18004559872/O I,0.0,1500000.0,,2018,1,4,CHECK_CASHING,1500000.0,M257269635
15475,1196428',2018-01-04,NEFT/N004180446089254/PAY,0.0,1446967.57,,2018,1,4,CASH_IN,1446967.57,C1305075214
15476,1196428',2018-01-04,NEFT/N004180446094200/PAY,0.0,1061760.64,,2018,1,4,CASH_IN,1061760.64,C1627965794
15477,1196428',2018-01-04,BEAT CSH PKP DEL GURG 550,0.0,102000.0,,2018,1,4,CHECK_CASHING,102000.0,M1559676676
15478,1196428',2018-01-04,Indiaforensic SERVICES INDIA PVT,0.0,589519.0,,2018,1,4,CASH_IN,589519.0,C741431520
15479,1196428',2018-01-04,IMPS 800416837680 FROM SA,0.0,50000.0,,2018,1,4,CHECK_CASHING,50000.0,C2143477943
15480,1196428',2018-01-04,IMPS 800416847178 FROM SA,0.0,50000.0,,2018,1,4,TRANSFER,50000.0,C638551812
15481,1196428',2018-01-04,NEFT/AXISP18004086076/ACC,0.0,4000000.0,,2018,1,4,CASH_IN,4000000.0,C1027296777
15482,1196428',2018-01-04,TRF FROM  Indiaforensic SERVICES,0.0,3700000.0,,2018,1,4,TRANSFER,3700000.0,C1554540309
15483,1196428',2018-01-04,TRF FROM  Indiaforensic SERVICES,0.0,8800000.0,,2018,1,4,CASH_IN,8800000.0,M2120427827
15484,1196428',2018-01-04,NEFT/20386950131DC/GALENA,0.0,5000000.0,,2018,1,4,TRANSFER,5000000.0,C820910648
15485,1196428',2018-01-04,BEAT CSH PKP DEL GURG 550,0.0,70000.0,,2018,1,4,CHECK_CASHING,70000.0,M415456371
15486,1196428',2018-01-04,FDRL/INTERNAL FUND TRANSFE,10000000.0,0.0,,2018,1,4,DEBIT,10000000.0,M598340030
15487,1196428',2018-01-04,FDRL/INTERNAL FUND TRANSFE,10000000.0,0.0,,2018,1,4,DEBIT,10000000.0,C345679794
15488,1196428',2018-01-04,FDRL/INTERNAL FUND TRANSFE,1000000.0,0.0,,2018,1,4,DEBIT,1000000.0,M1605050346
15489,1196428',2018-01-05,FT ZL18010564E8033B PRAVE,0.0,100000.0,,2018,1,5,CASH_IN,100000.0,C1144070975
15490,1196428',2018-01-05,FDRL/INTERNAL FUND TRANSFE,500000.0,0.0,,2018,1,5,PAYEMENT,500000.0,M639999796
15491,1196428',2018-01-05,FDRL/INTERNAL FUND TRANSFE,500000.0,0.0,,2018,1,5,DEBIT,500000.0,C343534938
15492,1196428',2018-01-05,FDRL/REAL TIME GROSS SETTL,2000000.0,0.0,,2018,1,5,CASH_OUT,2000000.0,M479872561
15493,1196428',2018-01-05,FDRL/REAL TIME GROSS SETTL,2000000.0,0.0,,2018,1,5,DEBIT,2000000.0,M61732893
15494,1196428',2018-01-05,RTGS/HDFCH18005905676/PAY,0.0,6240000.0,,2018,1,5,CASH_IN,6240000.0,C160632822
15495,1196428',2018-01-05,RTGS/HDFCH18005907530/PAY,0.0,4160000.0,,2018,1,5,CASH_IN,4160000.0,C1183266411
15496,1196428',2018-01-05,CASHDEP/NOIDA/TP,0.0,51000.0,,2018,1,5,TRANSFER,51000.0,M1328778262
15497,1196428',2018-01-05,FDRL/REAL TIME GROSS SETTL,1000000.0,0.0,,2018,1,5,CHECK_WITHDRAWAL,1000000.0,M704806959
15498,1196428',2018-01-05,FDRL/REAL TIME GROSS SETTL,5000000.0,0.0,,2018,1,5,PAYEMENT,5000000.0,C229313132
15499,1196428',2018-01-05,FDRL/REAL TIME GROSS SETTL,5000000.0,0.0,,2018,1,5,PAYEMENT,5000000.0,M325906300
15500,1196428',2018-01-05,"Indiaforensic USA, INC./USD/4283",0.0,2700035.65,,2018,1,5,CASH_IN,2700035.65,M1267748122
15501,1196428',2018-01-05,IRTT00701800520,1591.01,0.0,,2018,1,5,DEBIT,1591.01,M159739450
15502,1196428',2018-01-05,NEFT/AXISP18005050409/ACC,0.0,15000000.0,,2018,1,5,TRANSFER,15000000.0,M1702289141
15503,1196428',2018-01-05,NEFT/BARBZ18005628197/MAK,0.0,165580.0,,2018,1,5,CHECK_CASHING,165580.0,C1200612373
15504,1196428',2018-01-05,Indiaforensic SERVICES INDIA PVT,0.0,476046.0,,2018,1,5,CASH_IN,476046.0,C1840046890
15505,1196428',2018-01-05,FDRL/NATIONAL ELECTRONIC F,5000000.0,0.0,,2018,1,5,PAYEMENT,5000000.0,M1261751850
15506,1196428',2018-01-05,NEFT/FDRL656260036/Indiaforensic,0.0,3000000.0,,2018,1,5,CASH_IN,3000000.0,M1535970431
15507,1196428',2018-01-05,IMPS 800517963826 FROM SA,0.0,200000.0,,2018,1,5,CASH_IN,200000.0,M524251983
15508,1196428',2018-01-05,TRF FROM  Indiaforensic SERVICES,0.0,3200000.0,,2018,1,5,CASH_IN,3200000.0,C1406749291
15509,1196428',2018-01-05,FDRL/INTERNAL FUND TRANSFE,500000.0,0.0,,2018,1,5,CASH_OUT,500000.0,C1415645767
15510,1196428',2018-01-05,FDRL/INTERNAL FUND TRANSFE,500000.0,0.0,,2018,1,5,CASH_OUT,500000.0,M1816834020
15511,1196428',2018-01-05,NEFT/N005180447260065/PAY,0.0,1753601.31,,2018,1,5,TRANSFER,1753601.31,C1732292969
15512,1196428',2018-01-05,NEFT/N005180447260242/PAY,0.0,1059874.08,,2018,1,5,CASH_IN,1059874.08,M1739764490
15513,1196428',2018-01-05,FDRL/INTERNAL FUND TRANSFE,10000000.0,0.0,,2018,1,5,CASH_OUT,10000000.0,M1664129150
15514,1196428',2018-01-05,FDRL/INTERNAL FUND TRANSFE,10000000.0,0.0,,2018,1,5,CASH_OUT,10000000.0,M1128852062
15515,1196428',2018-01-05,FDRL/INTERNAL FUND TRANSFE,1000000.0,0.0,,2018,1,5,PAYEMENT,1000000.0,M182471589
15516,1196428',2018-01-05,TRF FROM  Indiaforensic SERVICES,0.0,3000000.0,,2018,1,5,TRANSFER,3000000.0,M1056074872
15517,1196428',2018-01-05,TRF FROM  Indiaforensic SERVICES,0.0,3000000.0,,2018,1,5,CHECK_CASHING,3000000.0,M2106622700
15518,1196428',2018-01-05,FDRL/INTERNAL FUND TRANSFE,1000000.0,0.0,,2018,1,5,DEBIT,1000000.0,M163766295
15519,1196428',2018-01-05,BEAT CSH PKP DEL GURG 550,0.0,136000.0,,2018,1,5,TRANSFER,136000.0,M802332120
15520,1196428',2018-01-06,IB:TPFT0053038731 4090004,0.0,15000.0,,2018,1,6,CHECK_CASHING,15000.0,M1676185662
15521,1196428',2018-01-06,FDRL/REAL TIME GROSS SETTL,5000000.0,0.0,,2018,1,6,DEBIT,5000000.0,M1776427379
15522,1196428',2018-01-06,RTGS/HDFCH18006988738/PAY,0.0,6160000.0,,2018,1,6,TRANSFER,6160000.0,M334173295
15523,1196428',2018-01-06,RTGS/HDFCH18006990291/PAY,0.0,4400000.0,,2018,1,6,CHECK_CASHING,4400000.0,M330490124
15524,1196428',2018-01-06,FDRL/REAL TIME GROSS SETTL,5000000.0,0.0,,2018,1,6,PAYEMENT,5000000.0,M1154845973
15525,1196428',2018-01-06,FDRL/REAL TIME GROSS SETTL,3000000.0,0.0,,2018,1,6,CHECK_WITHDRAWAL,3000000.0,M911987264
15526,1196428',2018-01-06,FDRL/REAL TIME GROSS SETTL,3000000.0,0.0,,2018,1,6,PAYEMENT,3000000.0,M1680147473
15527,1196428',2018-01-06,CASHDEP/VIKASMARG/TP,0.0,107000.0,,2018,1,6,TRANSFER,107000.0,M293659205
15528,1196428',2018-01-06,NEFT/N006180448024975/PAY,0.0,865352.44,,2018,1,6,CASH_IN,865352.44,M1432093328
15529,1196428',2018-01-06,NEFT/BARBP18006125902/MAK,0.0,102780.0,,2018,1,6,CHECK_CASHING,102780.0,M901262414
15530,1196428',2018-01-06,NEFT/N006180448029746/PAY,0.0,1592779.03,,2018,1,6,CASH_IN,1592779.03,M899962047
15531,1196428',2018-01-06,TRF FROM  Indiaforensic SERVICES,0.0,3000000.0,,2018,1,6,TRANSFER,3000000.0,M32715716
15532,1196428',2018-01-06,TRF FROM  Indiaforensic SERVICES,0.0,3000000.0,,2018,1,6,CASH_IN,3000000.0,M1510311379
15533,1196428',2018-01-06,TRF FROM  Indiaforensic SERVICES,0.0,3000000.0,,2018,1,6,TRANSFER,3000000.0,M1517206841
15534,1196428',2018-01-06,NEFT/FDRL656260035/Indiaforensic,0.0,3000000.0,,2018,1,6,TRANSFER,3000000.0,M2030024765
15535,1196428',2018-01-06,BEAT CSH PKP DEL GURG 550,0.0,21000.0,,2018,1,6,CHECK_CASHING,21000.0,M1267580132
15536,1196428',2018-01-06,FDRL/INTERNAL FUND TRANSFE,15000000.0,0.0,,2018,1,6,CHECK_WITHDRAWAL,15000000.0,C655391383
15537,1196428',2018-01-08,IMPS 800811918548 FROM SA,0.0,20000.0,,2018,1,8,TRANSFER,20000.0,C2117215775
15538,1196428',2018-01-08,IB:TPFT0053188991 4090004,0.0,10000.0,,2018,1,8,CHECK_CASHING,10000.0,C2106576360
15539,1196428',2018-01-08,RTGS/HDFCH18008067350/PAY,0.0,5840000.0,,2018,1,8,CHECK_CASHING,5840000.0,M267789972
15540,1196428',2018-01-08,RTGS/HDFCH18008067321/PAY,0.0,3360000.0,,2018,1,8,CHECK_CASHING,3360000.0,M292960678
15541,1196428',2018-01-08,IMPS 800812491431 FROM DA,0.0,50000.0,,2018,1,8,CASH_IN,50000.0,C1638372110
15542,1196428',2018-01-08,FDRL/REAL TIME GROSS SETTL,3000000.0,0.0,,2018,1,8,CHECK_WITHDRAWAL,3000000.0,C1377774115
15543,1196428',2018-01-08,FDRL/REAL TIME GROSS SETTL,3000000.0,0.0,,2018,1,8,CASH_OUT,3000000.0,M1877845145
15544,1196428',2018-01-08,FDRL/REAL TIME GROSS SETTL,3000000.0,0.0,,2018,1,8,PAYEMENT,3000000.0,M869149988
15545,1196428',2018-01-08,FDRL/INTERNAL FUND TRANSFE,200000.0,0.0,,2018,1,8,DEBIT,200000.0,M1324498984
15546,1196428',2018-01-08,FDRL/INTERNAL FUND TRANSFE,200000.0,0.0,,2018,1,8,DEBIT,200000.0,C748014372
15547,1196428',2018-01-08,NEFT/AXISP18008087388/ACC,0.0,5000000.0,,2018,1,8,CHECK_CASHING,5000000.0,M1556526073
15548,1196428',2018-01-08,Indiaforensic SERVICES INDIA PVT,0.0,1483458.0,,2018,1,8,TRANSFER,1483458.0,M1113797896
15549,1196428',2018-01-08,NEFT/N008180449025220/PAY,0.0,453472.28,,2018,1,8,TRANSFER,453472.28,M111103216
15550,1196428',2018-01-08,FDRL/NATIONAL ELECTRONIC F,5000000.0,0.0,,2018,1,8,PAYEMENT,5000000.0,M402054040
15551,1196428',2018-01-08,NEFT/20390888821DC/ARTHAS,0.0,225000.0,,2018,1,8,TRANSFER,225000.0,C1174935745
15552,1196428',2018-01-08,NEFT/N008180449024738/PAY,0.0,1886506.52,,2018,1,8,CHECK_CASHING,1886506.52,M3128155
15553,1196428',2018-01-08,FDRL/INTERNAL FUND TRANSFE,1000000.0,0.0,,2018,1,8,CASH_OUT,1000000.0,M804435874
15554,1196428',2018-01-08,TRF FROM  Indiaforensic SERVICES,0.0,3000000.0,,2018,1,8,CASH_IN,3000000.0,M22524150
15555,1196428',2018-01-08,TRF FROM  Indiaforensic SERVICES,0.0,1000000.0,,2018,1,8,TRANSFER,1000000.0,C717951588
15556,1196428',2018-01-08,TRF FROM  Indiaforensic SERVICES,0.0,500000.0,,2018,1,8,CHECK_CASHING,500000.0,M994429804
15557,1196428',2018-01-08,TRF FROM  Indiaforensic SERVICES,0.0,15000000.0,,2018,1,8,CASH_IN,15000000.0,M42960844
15558,1196428',2018-01-08,TRF FROM  Indiaforensic SERVICES,0.0,3000000.0,,2018,1,8,CASH_IN,3000000.0,M117897905
15559,1196428',2018-01-08,NEFT/FDRL656260409/Indiaforensic,0.0,3000000.0,,2018,1,8,CASH_IN,3000000.0,M919103236
15560,1196428',2018-01-08,NEFT/FDRL656260410/Indiaforensic,0.0,3000000.0,,2018,1,8,CHECK_CASHING,3000000.0,M2117556230
15561,1196428',2018-01-08,NEFT/FDRL656260411/Indiaforensic,0.0,3000000.0,,2018,1,8,CASH_IN,3000000.0,M2047174428
15562,1196428',2018-01-08,FDRL/INTERNAL FUND TRANSFE,15000000.0,0.0,,2018,1,8,DEBIT,15000000.0,M1468774738
15563,1196428',2018-01-08,FDRL/INTERNAL FUND TRANSFE,15000000.0,0.0,,2018,1,8,DEBIT,15000000.0,M266577647
15564,1196428',2018-01-08,BEAT CSH PKP DEL GURG 550,0.0,469000.0,,2018,1,8,CHECK_CASHING,469000.0,M1474343674
15565,1196428',2018-01-09,FDRL/REAL TIME GROSS SETTL,5000000.0,0.0,,2018,1,9,DEBIT,5000000.0,M1664266643
15566,1196428',2018-01-09,NEFT/20391661001DC/ARTHAS,0.0,125000.0,,2018,1,9,TRANSFER,125000.0,M842463018
15567,1196428',2018-01-09,RTGS/HDFCH18009173456/PAY,0.0,4480000.0,,2018,1,9,CHECK_CASHING,4480000.0,M284325832
15568,1196428',2018-01-09,RTGS/HDFCH18009173435/PAY,0.0,4640000.0,,2018,1,9,TRANSFER,4640000.0,M1784760424
15569,1196428',2018-01-09,FDRL/REAL TIME GROSS SETTL,5000000.0,0.0,,2018,1,9,PAYEMENT,5000000.0,M1489026763
15570,1196428',2018-01-09,FDRL/REAL TIME GROSS SETTL,2000000.0,0.0,,2018,1,9,DEBIT,2000000.0,C1800405372
15571,1196428',2018-01-09,FDRL/REAL TIME GROSS SETTL,2000000.0,0.0,,2018,1,9,PAYEMENT,2000000.0,C2071512077
15572,1196428',2018-01-09,CASHDEP/NOIDA/TP,0.0,55000.0,,2018,1,9,CASH_IN,55000.0,C1588635270
15573,1196428',2018-01-09,"Indiaforensic USA, INC./USD/6135",0.0,3877855.94,,2018,1,9,CASH_IN,3877855.94,C1495001462
15574,1196428',2018-01-09,IRTT00701800793,1803.01,0.0,,2018,1,9,CHECK_WITHDRAWAL,1803.01,M84558619
15575,1196428',2018-01-09,"Indiaforensic USA, INC./USD/4990",0.0,315368.0,,2018,1,9,CHECK_CASHING,315368.0,M113925453
15576,1196428',2018-01-09,IRTT00701800790,668.83,0.0,,2018,1,9,PAYEMENT,668.83,M645245228
15577,1196428',2018-01-09,NEFT/IDFBH18009114331/FUN,0.0,14700.0,,2018,1,9,CHECK_CASHING,14700.0,M636094317
15578,1196428',2018-01-09,NEFT/N009180449959548/PAY,0.0,1.0,,2018,1,9,TRANSFER,1.0,M1583961850
15579,1196428',2018-01-09,NEFT/N009180449943184/PAY,0.0,1137012.6,,2018,1,9,CASH_IN,1137012.6,M708029389
15580,1196428',2018-01-09,NEFT/BARBP18009967259/MAK,0.0,65555.0,,2018,1,9,TRANSFER,65555.0,M508231066
15581,1196428',2018-01-09,NEFT/N009180450185529/PAY,0.0,1.0,,2018,1,9,CHECK_CASHING,1.0,C1838491463
15582,1196428',2018-01-09,FDRL/INTERNAL FUND TRANSFE,1000000.0,0.0,,2018,1,9,DEBIT,1000000.0,M1094448975
15583,1196428',2018-01-09,FDRL/INTERNAL FUND TRANSFE,500000.0,0.0,,2018,1,9,DEBIT,500000.0,M717841651
15584,1196428',2018-01-09,TRF FROM  Indiaforensic SERVICES,0.0,15000000.0,,2018,1,9,CHECK_CASHING,15000000.0,M1954167102
15585,1196428',2018-01-09,TRF FROM  Indiaforensic SERVICES,0.0,500000.0,,2018,1,9,TRANSFER,500000.0,M1043087369
15586,1196428',2018-01-09,NEFT/FDRL656260022/Indiaforensic,0.0,2000000.0,,2018,1,9,TRANSFER,2000000.0,M1489610760
15587,1196428',2018-01-09,NEFT/FDRL656260024/Indiaforensic,0.0,2000000.0,,2018,1,9,CHECK_CASHING,2000000.0,C1556875182
15588,1196428',2018-01-09,NEFT/FDRL656260027/Indiaforensic,0.0,2000000.0,,2018,1,9,TRANSFER,2000000.0,M1109811596
15589,1196428',2018-01-09,NEFT/FDRL656260379/Indiaforensic,0.0,2000000.0,,2018,1,9,CHECK_CASHING,2000000.0,C101571284
15590,1196428',2018-01-09,BEAT CSH PKP DEL GURG 550,0.0,619500.0,,2018,1,9,CASH_IN,619500.0,M178952563
15591,1196428',2018-01-09,FDRL/INTERNAL FUND TRANSFE,5000000.0,0.0,,2018,1,9,DEBIT,5000000.0,M2081263541
15592,1196428',2018-01-09,FDRL/INTERNAL FUND TRANSFE,5000000.0,0.0,,2018,1,9,CHECK_WITHDRAWAL,5000000.0,C2078250226
15593,1196428',2018-01-09,FDRL/INTERNAL FUND TRANSFE,5000000.0,0.0,,2018,1,9,CASH_OUT,5000000.0,C1570256460
15594,1196428',2018-01-09,FDRL/INTERNAL FUND TRANSFE,5000000.0,0.0,,2018,1,9,PAYEMENT,5000000.0,M441055416
15595,1196428',2018-01-09,FDRL/INTERNAL FUND TRANSFE,5000000.0,0.0,,2018,1,9,CHECK_WITHDRAWAL,5000000.0,C2077098348
15596,1196428',2018-01-09,FDRL/INTERNAL FUND TRANSFE,3000000.0,0.0,,2018,1,9,PAYEMENT,3000000.0,C1062254208
15597,1196428',2018-01-10,TRF FROM  Indiaforensic SERVICES,0.0,3000000.0,,2018,1,10,CASH_IN,3000000.0,C1787868648
15598,1196428',2018-01-10,TRF FROM  Indiaforensic SERVICES,0.0,500000.0,,2018,1,10,CASH_IN,500000.0,C161140376
15599,1196428',2018-01-10,RTGS/HDFCH18010257286/PAY,0.0,1680000.0,,2018,1,10,TRANSFER,1680000.0,M1471351873
15600,1196428',2018-01-10,RTGS/HDFCH18010258531/PAY,0.0,4960000.0,,2018,1,10,CHECK_CASHING,4960000.0,M1328437771
15601,1196428',2018-01-10,FDRL/REAL TIME GROSS SETTL,5000000.0,0.0,,2018,1,10,CHECK_WITHDRAWAL,5000000.0,M341537411
15602,1196428',2018-01-10,FDRL/REAL TIME GROSS SETTL,5000000.0,0.0,,2018,1,10,DEBIT,5000000.0,M1367049026
15603,1196428',2018-01-10,FIXED   MOBILE PTE LTD/US,0.0,760278.21,,2018,1,10,TRANSFER,760278.21,C2029310301
15604,1196428',2018-01-10,IRTT00701800870,1069.25,0.0,,2018,1,10,CASH_OUT,1069.25,C1606699851
15605,1196428',2018-01-10,FDRL/NATIONAL ELECTRONIC F,100000.0,0.0,,2018,1,10,DEBIT,100000.0,C1103621993
15606,1196428',2018-01-10,FDRL/NATIONAL ELECTRONIC F,200000.0,0.0,,2018,1,10,DEBIT,200000.0,M34447014
15607,1196428',2018-01-10,FDRL/NATIONAL ELECTRONIC F,200000.0,0.0,,2018,1,10,CASH_OUT,200000.0,C1428675504
15608,1196428',2018-01-10,NEFT/BARBQ18010270759/MAK,0.0,140750.0,,2018,1,10,CHECK_CASHING,140750.0,M1783999682
15609,1196428',2018-01-10,NEFT/AXISP18010045427/ACC,0.0,2000000.0,,2018,1,10,CHECK_CASHING,2000000.0,C1247600089
15610,1196428',2018-01-10,FDRL/REAL TIME GROSS SETTL,2000000.0,0.0,,2018,1,10,PAYEMENT,2000000.0,M835388411
15611,1196428',2018-01-10,RTGS/IDFBH18010300855/ART,0.0,10000000.0,,2018,1,10,CASH_IN,10000000.0,C404279307
15612,1196428',2018-01-10,RTGS/IDFBH18010300858/ART,0.0,10000000.0,,2018,1,10,CASH_IN,10000000.0,C278407008
15613,1196428',2018-01-10,RTGS/IDFBH18010300873/ART,0.0,10000000.0,,2018,1,10,TRANSFER,10000000.0,M1721234210
15614,1196428',2018-01-10,FDRL/NATIONAL ELECTRONIC F,5000000.0,0.0,,2018,1,10,PAYEMENT,5000000.0,M1576908104
15615,1196428',2018-01-10,FDRL/NATIONAL ELECTRONIC F,5000000.0,0.0,,2018,1,10,DEBIT,5000000.0,M1547162536
15616,1196428',2018-01-10,Indiaforensic SERVICES INDIA PVT,0.0,1380965.0,,2018,1,10,CASH_IN,1380965.0,M1057827479
15617,1196428',2018-01-10,FDRL/NATIONAL ELECTRONIC F,10000000.0,0.0,,2018,1,10,CHECK_WITHDRAWAL,10000000.0,M1498878973
15618,1196428',2018-01-10,NEFT/FDRL656260382/Indiaforensic,0.0,2000000.0,,2018,1,10,CHECK_CASHING,2000000.0,M1420281457
15619,1196428',2018-01-10,NEFT/FDRL656260390/Indiaforensic,0.0,2000000.0,,2018,1,10,CHECK_CASHING,2000000.0,M2000558609
15620,1196428',2018-01-10,NEFT/N010180450994374/PAY,0.0,4140562.99,,2018,1,10,CHECK_CASHING,4140562.99,M1598229594
15621,1196428',2018-01-10,NEFT/N010180450977989/PAY,0.0,1246999.52,,2018,1,10,CASH_IN,1246999.52,M2001514483
15622,1196428',2018-01-10,FDRL/NATIONAL ELECTRONIC F,10000000.0,0.0,,2018,1,10,PAYEMENT,10000000.0,M1808413339
15623,1196428',2018-01-10,FDRL/NATIONAL ELECTRONIC F,5000000.0,0.0,,2018,1,10,CASH_OUT,5000000.0,M662376084
15624,1196428',2018-01-10,TRF FROM  Indiaforensic SERVICES,0.0,3800000.0,,2018,1,10,CASH_IN,3800000.0,M1462583713
15625,1196428',2018-01-10,TRF FROM  Indiaforensic SERVICES,0.0,12900000.0,,2018,1,10,CASH_IN,12900000.0,M1292178703
15626,1196428',2018-01-10,BEAT CSH PKP DEL GURG 550,0.0,410500.0,,2018,1,10,CASH_IN,410500.0,M1378894443
15627,1196428',2018-01-10,FDRL/INTERNAL FUND TRANSFE,5000000.0,0.0,,2018,1,10,DEBIT,5000000.0,M671194471
15628,1196428',2018-01-10,FDRL/INTERNAL FUND TRANSFE,5000000.0,0.0,,2018,1,10,CHECK_WITHDRAWAL,5000000.0,M2120887477
15629,1196428',2018-01-10,FDRL/INTERNAL FUND TRANSFE,5000000.0,0.0,,2018,1,10,CHECK_WITHDRAWAL,5000000.0,M1565473666
15630,1196428',2018-01-10,FDRL/INTERNAL FUND TRANSFE,5000000.0,0.0,,2018,1,10,CHECK_WITHDRAWAL,5000000.0,M336600403
15631,1196428',2018-01-10,FDRL/INTERNAL FUND TRANSFE,3000000.0,0.0,,2018,1,10,PAYEMENT,3000000.0,M1108314788
15632,1196428',2018-01-11,IB:TPFT0053513881 4090004,0.0,15000.0,,2018,1,11,TRANSFER,15000.0,M1776708407
15633,1196428',2018-01-11,RTGS/HDFCH18011352641/PAY,0.0,3760000.0,,2018,1,11,CASH_IN,3760000.0,M1886072816
15634,1196428',2018-01-11,RTGS/HDFCH18011352659/PAY,0.0,5760000.0,,2018,1,11,TRANSFER,5760000.0,M392269298
15635,1196428',2018-01-11,FDRL/REAL TIME GROSS SETTL,10000000.0,0.0,,2018,1,11,DEBIT,10000000.0,M240263357
15636,1196428',2018-01-11,NEFT/N011180451507927/TEC,0.0,300000.0,,2018,1,11,TRANSFER,300000.0,M2137827177
15637,1196428',2018-01-11,FDRL/NATIONAL ELECTRONIC F,200000.0,0.0,,2018,1,11,PAYEMENT,200000.0,M996688653
15638,1196428',2018-01-11,FDRL/NATIONAL ELECTRONIC F,200000.0,0.0,,2018,1,11,PAYEMENT,200000.0,C1829831147
15639,1196428',2018-01-11,FDRL/NATIONAL ELECTRONIC F,200000.0,0.0,,2018,1,11,CASH_OUT,200000.0,M720435458
15640,1196428',2018-01-11,NEFT/20394583741DC/ARTHAS,0.0,200000.0,,2018,1,11,TRANSFER,200000.0,M29096009
15641,1196428',2018-01-11,NEFT/FDRL656260398/Indiaforensic,0.0,3000000.0,,2018,1,11,CHECK_CASHING,3000000.0,M150995440
15642,1196428',2018-01-11,NEFT/FDRL656260399/Indiaforensic,0.0,3000000.0,,2018,1,11,CASH_IN,3000000.0,M1241251535
15643,1196428',2018-01-11,FDRL/NATIONAL ELECTRONIC F,200000.0,0.0,,2018,1,11,CHECK_WITHDRAWAL,200000.0,M1254542588
15644,1196428',2018-01-11,FDRL/NATIONAL ELECTRONIC F,200000.0,0.0,,2018,1,11,CASH_OUT,200000.0,M710538853
15645,1196428',2018-01-11,FDRL/NATIONAL ELECTRONIC F,200000.0,0.0,,2018,1,11,CHECK_WITHDRAWAL,200000.0,M399672840
15646,1196428',2018-01-11,FDRL/NATIONAL ELECTRONIC F,200000.0,0.0,,2018,1,11,PAYEMENT,200000.0,M1566931514
15647,1196428',2018-01-11,FDRL/NATIONAL ELECTRONIC F,100000.0,0.0,,2018,1,11,CHECK_WITHDRAWAL,100000.0,C1540270363
15648,1196428',2018-01-11,FDRL/NATIONAL ELECTRONIC F,100000.0,0.0,,2018,1,11,CASH_OUT,100000.0,C900425684
15649,1196428',2018-01-11,NEFT/BARBQ18011826527/MAK,0.0,140444.0,,2018,1,11,TRANSFER,140444.0,M1361294362
15650,1196428',2018-01-11,NEFT/N011180451804374/PAY,0.0,1173190.48,,2018,1,11,TRANSFER,1173190.48,C264843581
15651,1196428',2018-01-11,Indiaforensic SERVICES INDIA PVT,0.0,557301.0,,2018,1,11,TRANSFER,557301.0,M1897445965
15652,1196428',2018-01-11,NEFT/N011180451792919/PAY,0.0,1033522.56,,2018,1,11,CASH_IN,1033522.56,M345439288
15653,1196428',2018-01-11,NEFT/AXISP18011068685/ACC,0.0,2000000.0,,2018,1,11,CASH_IN,2000000.0,M2130477201
15654,1196428',2018-01-11,NEFT/IDFBH18011136177/ART,0.0,5000000.0,,2018,1,11,TRANSFER,5000000.0,M1516263359
15655,1196428',2018-01-11,FDRL/NATIONAL ELECTRONIC F,15824.0,0.0,,2018,1,11,DEBIT,15824.0,M508839235
15656,1196428',2018-01-11,FDRL/NATIONAL ELECTRONIC F,16767.0,0.0,,2018,1,11,CHECK_WITHDRAWAL,16767.0,M530611995
15657,1196428',2018-01-11,FDRL/NATIONAL ELECTRONIC F,12953.0,0.0,,2018,1,11,PAYEMENT,12953.0,C1761324386
15658,1196428',2018-01-11,FDRL/NATIONAL ELECTRONIC F,12101.0,0.0,,2018,1,11,CHECK_WITHDRAWAL,12101.0,C90486891
15659,1196428',2018-01-11,FDRL/NATIONAL ELECTRONIC F,23083.0,0.0,,2018,1,11,DEBIT,23083.0,C573200870
15660,1196428',2018-01-11,FDRL/NATIONAL ELECTRONIC F,13080.0,0.0,,2018,1,11,DEBIT,13080.0,C1825992554
15661,1196428',2018-01-11,FDRL/NATIONAL ELECTRONIC F,26435.0,0.0,,2018,1,11,PAYEMENT,26435.0,M1278682262
15662,1196428',2018-01-11,FDRL/NATIONAL ELECTRONIC F,26484.0,0.0,,2018,1,11,CHECK_WITHDRAWAL,26484.0,M2009652577
15663,1196428',2018-01-11,FDRL/NATIONAL ELECTRONIC F,29054.0,0.0,,2018,1,11,CASH_OUT,29054.0,M1504904868
15664,1196428',2018-01-11,FDRL/NATIONAL ELECTRONIC F,16880.0,0.0,,2018,1,11,CHECK_WITHDRAWAL,16880.0,C88226327
15665,1196428',2018-01-11,FDRL/NATIONAL ELECTRONIC F,21933.0,0.0,,2018,1,11,CASH_OUT,21933.0,M203497386
15666,1196428',2018-01-11,FDRL/NATIONAL ELECTRONIC F,21576.0,0.0,,2018,1,11,PAYEMENT,21576.0,M1264078907
15667,1196428',2018-01-11,FDRL/NATIONAL ELECTRONIC F,9886.0,0.0,,2018,1,11,DEBIT,9886.0,M1870838648
15668,1196428',2018-01-11,FDRL/NATIONAL ELECTRONIC F,24125.0,0.0,,2018,1,11,CHECK_WITHDRAWAL,24125.0,C1683963531
15669,1196428',2018-01-11,FDRL/NATIONAL ELECTRONIC F,25597.0,0.0,,2018,1,11,DEBIT,25597.0,M620120832
15670,1196428',2018-01-11,FDRL/NATIONAL ELECTRONIC F,20052.0,0.0,,2018,1,11,DEBIT,20052.0,M37714710
15671,1196428',2018-01-11,FDRL/NATIONAL ELECTRONIC F,8902.0,0.0,,2018,1,11,CHECK_WITHDRAWAL,8902.0,M1135370372
15672,1196428',2018-01-11,FDRL/NATIONAL ELECTRONIC F,25150.0,0.0,,2018,1,11,CASH_OUT,25150.0,C1700355047
15673,1196428',2018-01-11,FDRL/NATIONAL ELECTRONIC F,14321.0,0.0,,2018,1,11,PAYEMENT,14321.0,C1884600481
15674,1196428',2018-01-11,FDRL/NATIONAL ELECTRONIC F,21124.0,0.0,,2018,1,11,CHECK_WITHDRAWAL,21124.0,C1105527690
15675,1196428',2018-01-11,FDRL/NATIONAL ELECTRONIC F,24525.0,0.0,,2018,1,11,DEBIT,24525.0,M714819629
15676,1196428',2018-01-11,FDRL/NATIONAL ELECTRONIC F,26488.0,0.0,,2018,1,11,CASH_OUT,26488.0,M722465639
15677,1196428',2018-01-11,FDRL/NATIONAL ELECTRONIC F,24768.0,0.0,,2018,1,11,DEBIT,24768.0,C801412408
15678,1196428',2018-01-11,FDRL/NATIONAL ELECTRONIC F,28131.0,0.0,,2018,1,11,DEBIT,28131.0,M1678349105
15679,1196428',2018-01-11,FDRL/NATIONAL ELECTRONIC F,16042.0,0.0,,2018,1,11,CHECK_WITHDRAWAL,16042.0,C35534346
15680,1196428',2018-01-11,FDRL/NATIONAL ELECTRONIC F,17876.0,0.0,,2018,1,11,PAYEMENT,17876.0,C943166837
15681,1196428',2018-01-11,FDRL/NATIONAL ELECTRONIC F,10583.0,0.0,,2018,1,11,DEBIT,10583.0,M1063088470
15682,1196428',2018-01-11,FDRL/NATIONAL ELECTRONIC F,21350.0,0.0,,2018,1,11,CHECK_WITHDRAWAL,21350.0,M634480856
15683,1196428',2018-01-11,FDRL/NATIONAL ELECTRONIC F,21360.0,0.0,,2018,1,11,CHECK_WITHDRAWAL,21360.0,M1229660324
15684,1196428',2018-01-11,FDRL/NATIONAL ELECTRONIC F,12358.0,0.0,,2018,1,11,PAYEMENT,12358.0,M1995775202
15685,1196428',2018-01-11,FDRL/NATIONAL ELECTRONIC F,6626.0,0.0,,2018,1,11,CASH_OUT,6626.0,M982735022
15686,1196428',2018-01-11,FDRL/NATIONAL ELECTRONIC F,21040.0,0.0,,2018,1,11,DEBIT,21040.0,C1754722089
15687,1196428',2018-01-11,FDRL/NATIONAL ELECTRONIC F,27899.0,0.0,,2018,1,11,CASH_OUT,27899.0,M536571624
15688,1196428',2018-01-11,FDRL/NATIONAL ELECTRONIC F,24469.0,0.0,,2018,1,11,CHECK_WITHDRAWAL,24469.0,C1498878963
15689,1196428',2018-01-11,FDRL/NATIONAL ELECTRONIC F,15132.0,0.0,,2018,1,11,DEBIT,15132.0,C1962165946
15690,1196428',2018-01-11,FDRL/NATIONAL ELECTRONIC F,16288.0,0.0,,2018,1,11,PAYEMENT,16288.0,M1170462195
15691,1196428',2018-01-11,FDRL/NATIONAL ELECTRONIC F,14814.0,0.0,,2018,1,11,CASH_OUT,14814.0,C414205222
15692,1196428',2018-01-11,FDRL/NATIONAL ELECTRONIC F,26344.0,0.0,,2018,1,11,PAYEMENT,26344.0,M1229413386
15693,1196428',2018-01-11,FDRL/NATIONAL ELECTRONIC F,24249.0,0.0,,2018,1,11,CHECK_WITHDRAWAL,24249.0,M712447692
15694,1196428',2018-01-11,FDRL/NATIONAL ELECTRONIC F,25150.0,0.0,,2018,1,11,PAYEMENT,25150.0,C269902384
15695,1196428',2018-01-11,FDRL/NATIONAL ELECTRONIC F,23464.0,0.0,,2018,1,11,DEBIT,23464.0,C955097010
15696,1196428',2018-01-11,FDRL/NATIONAL ELECTRONIC F,18597.0,0.0,,2018,1,11,PAYEMENT,18597.0,C1827996167
15697,1196428',2018-01-11,FDRL/NATIONAL ELECTRONIC F,22591.0,0.0,,2018,1,11,CASH_OUT,22591.0,M30162194
15698,1196428',2018-01-11,FDRL/NATIONAL ELECTRONIC F,29380.0,0.0,,2018,1,11,CHECK_WITHDRAWAL,29380.0,C1115240385
15699,1196428',2018-01-11,FDRL/NATIONAL ELECTRONIC F,25365.0,0.0,,2018,1,11,CASH_OUT,25365.0,M1710595137
15700,1196428',2018-01-11,FDRL/NATIONAL ELECTRONIC F,13996.0,0.0,,2018,1,11,CHECK_WITHDRAWAL,13996.0,M970087106
15701,1196428',2018-01-11,FDRL/NATIONAL ELECTRONIC F,26650.0,0.0,,2018,1,11,PAYEMENT,26650.0,M561635968
15702,1196428',2018-01-11,FDRL/NATIONAL ELECTRONIC F,25096.0,0.0,,2018,1,11,CASH_OUT,25096.0,C440480434
15703,1196428',2018-01-11,FDRL/NATIONAL ELECTRONIC F,22857.0,0.0,,2018,1,11,CASH_OUT,22857.0,C46748390
15704,1196428',2018-01-11,FDRL/NATIONAL ELECTRONIC F,21753.0,0.0,,2018,1,11,PAYEMENT,21753.0,M976616410
15705,1196428',2018-01-11,FDRL/NATIONAL ELECTRONIC F,27899.0,0.0,,2018,1,11,PAYEMENT,27899.0,M1796408655
15706,1196428',2018-01-11,FDRL/NATIONAL ELECTRONIC F,22663.0,0.0,,2018,1,11,DEBIT,22663.0,M424513770
15707,1196428',2018-01-11,FDRL/NATIONAL ELECTRONIC F,28289.0,0.0,,2018,1,11,PAYEMENT,28289.0,M1867357103
15708,1196428',2018-01-11,FDRL/NATIONAL ELECTRONIC F,20856.0,0.0,,2018,1,11,PAYEMENT,20856.0,M215680372
15709,1196428',2018-01-11,FDRL/NATIONAL ELECTRONIC F,13029.0,0.0,,2018,1,11,CASH_OUT,13029.0,M764256713
15710,1196428',2018-01-11,FDRL/NATIONAL ELECTRONIC F,22249.0,0.0,,2018,1,11,PAYEMENT,22249.0,M538413261
15711,1196428',2018-01-11,FDRL/NATIONAL ELECTRONIC F,20016.0,0.0,,2018,1,11,PAYEMENT,20016.0,M942160595
15712,1196428',2018-01-11,FDRL/NATIONAL ELECTRONIC F,13226.0,0.0,,2018,1,11,PAYEMENT,13226.0,M1319156415
15713,1196428',2018-01-11,FDRL/NATIONAL ELECTRONIC F,16227.0,0.0,,2018,1,11,CHECK_WITHDRAWAL,16227.0,M361847129
15714,1196428',2018-01-11,FDRL/NATIONAL ELECTRONIC F,27610.0,0.0,,2018,1,11,CASH_OUT,27610.0,C1790202239
15715,1196428',2018-01-11,FDRL/NATIONAL ELECTRONIC F,13029.0,0.0,,2018,1,11,CHECK_WITHDRAWAL,13029.0,M955868325
15716,1196428',2018-01-11,FDRL/NATIONAL ELECTRONIC F,27360.0,0.0,,2018,1,11,PAYEMENT,27360.0,M1251133153
15717,1196428',2018-01-11,FDRL/NATIONAL ELECTRONIC F,29620.0,0.0,,2018,1,11,PAYEMENT,29620.0,M1854311181
15718,1196428',2018-01-11,FDRL/NATIONAL ELECTRONIC F,10308.0,0.0,,2018,1,11,CASH_OUT,10308.0,C928023753
15719,1196428',2018-01-11,FDRL/NATIONAL ELECTRONIC F,18314.0,0.0,,2018,1,11,CHECK_WITHDRAWAL,18314.0,M771609335
15720,1196428',2018-01-11,FDRL/NATIONAL ELECTRONIC F,28750.0,0.0,,2018,1,11,CASH_OUT,28750.0,C1452722471
15721,1196428',2018-01-11,FDRL/NATIONAL ELECTRONIC F,18314.0,0.0,,2018,1,11,CHECK_WITHDRAWAL,18314.0,M1625968481
15722,1196428',2018-01-11,FDRL/NATIONAL ELECTRONIC F,12529.0,0.0,,2018,1,11,PAYEMENT,12529.0,M458727925
15723,1196428',2018-01-11,FDRL/NATIONAL ELECTRONIC F,18314.0,0.0,,2018,1,11,DEBIT,18314.0,C111210112
15724,1196428',2018-01-11,FDRL/NATIONAL ELECTRONIC F,27360.0,0.0,,2018,1,11,CHECK_WITHDRAWAL,27360.0,C464246030
15725,1196428',2018-01-11,FDRL/NATIONAL ELECTRONIC F,15691.0,0.0,,2018,1,11,CASH_OUT,15691.0,M2080752777
15726,1196428',2018-01-11,FDRL/NATIONAL ELECTRONIC F,25100.0,0.0,,2018,1,11,PAYEMENT,25100.0,M1357563045
15727,1196428',2018-01-11,FDRL/NATIONAL ELECTRONIC F,18314.0,0.0,,2018,1,11,DEBIT,18314.0,M68500741
15728,1196428',2018-01-11,FDRL/NATIONAL ELECTRONIC F,20403.0,0.0,,2018,1,11,DEBIT,20403.0,C1664330755
15729,1196428',2018-01-11,FDRL/NATIONAL ELECTRONIC F,14868.0,0.0,,2018,1,11,PAYEMENT,14868.0,C1823014131
15730,1196428',2018-01-11,FDRL/NATIONAL ELECTRONIC F,18314.0,0.0,,2018,1,11,DEBIT,18314.0,M1293355387
15731,1196428',2018-01-11,FDRL/NATIONAL ELECTRONIC F,26050.0,0.0,,2018,1,11,PAYEMENT,26050.0,M34599177
15732,1196428',2018-01-11,FDRL/NATIONAL ELECTRONIC F,12222.0,0.0,,2018,1,11,CHECK_WITHDRAWAL,12222.0,M685059787
15733,1196428',2018-01-11,FDRL/NATIONAL ELECTRONIC F,24712.0,0.0,,2018,1,11,CHECK_WITHDRAWAL,24712.0,M376456946
15734,1196428',2018-01-11,FDRL/NATIONAL ELECTRONIC F,24712.0,0.0,,2018,1,11,DEBIT,24712.0,M793798217
15735,1196428',2018-01-11,FDRL/NATIONAL ELECTRONIC F,18097.0,0.0,,2018,1,11,CASH_OUT,18097.0,C264685626
15736,1196428',2018-01-11,FDRL/NATIONAL ELECTRONIC F,12357.0,0.0,,2018,1,11,DEBIT,12357.0,M954243999
15737,1196428',2018-01-11,FDRL/NATIONAL ELECTRONIC F,6489.0,0.0,,2018,1,11,PAYEMENT,6489.0,C1816986148
15738,1196428',2018-01-11,FDRL/NATIONAL ELECTRONIC F,6489.0,0.0,,2018,1,11,PAYEMENT,6489.0,C1144527317
15739,1196428',2018-01-11,FDRL/NATIONAL ELECTRONIC F,8271.0,0.0,,2018,1,11,PAYEMENT,8271.0,C1790831319
15740,1196428',2018-01-11,FDRL/NATIONAL ELECTRONIC F,8271.0,0.0,,2018,1,11,PAYEMENT,8271.0,C571435580
15741,1196428',2018-01-11,FDRL/NATIONAL ELECTRONIC F,12357.0,0.0,,2018,1,11,CASH_OUT,12357.0,C1262016786
15742,1196428',2018-01-11,FDRL/NATIONAL ELECTRONIC F,7353.0,0.0,,2018,1,11,DEBIT,7353.0,C1287328228
15743,1196428',2018-01-11,FDRL/NATIONAL ELECTRONIC F,12357.0,0.0,,2018,1,11,CASH_OUT,12357.0,C329473339
15744,1196428',2018-01-11,FDRL/INTERNAL FUND TRANSFE,20750.0,0.0,,2018,1,11,CHECK_WITHDRAWAL,20750.0,C1354725727
15745,1196428',2018-01-11,FDRL/NATIONAL ELECTRONIC F,27014.0,0.0,,2018,1,11,PAYEMENT,27014.0,C1300519073
15746,1196428',2018-01-11,FDRL/NATIONAL ELECTRONIC F,22840.0,0.0,,2018,1,11,PAYEMENT,22840.0,C2052185144
15747,1196428',2018-01-11,FDRL/NATIONAL ELECTRONIC F,27711.0,0.0,,2018,1,11,DEBIT,27711.0,C1485516154
15748,1196428',2018-01-11,FDRL/NATIONAL ELECTRONIC F,10821.0,0.0,,2018,1,11,DEBIT,10821.0,C2143477943
15749,1196428',2018-01-11,FDRL/NATIONAL ELECTRONIC F,22729.0,0.0,,2018,1,11,CHECK_WITHDRAWAL,22729.0,C476402209
15750,1196428',2018-01-11,FDRL/NATIONAL ELECTRONIC F,12499.0,0.0,,2018,1,11,DEBIT,12499.0,C1255024717
15751,1196428',2018-01-11,FDRL/NATIONAL ELECTRONIC F,22322.0,0.0,,2018,1,11,CHECK_WITHDRAWAL,22322.0,C1870367457
15752,1196428',2018-01-11,FDRL/NATIONAL ELECTRONIC F,15333.0,0.0,,2018,1,11,CASH_OUT,15333.0,C465257140
15753,1196428',2018-01-11,FDRL/NATIONAL ELECTRONIC F,14944.0,0.0,,2018,1,11,PAYEMENT,14944.0,C745740822
15754,1196428',2018-01-11,FDRL/NATIONAL ELECTRONIC F,26825.0,0.0,,2018,1,11,PAYEMENT,26825.0,C1390121014
15755,1196428',2018-01-11,FDRL/NATIONAL ELECTRONIC F,15167.0,0.0,,2018,1,11,PAYEMENT,15167.0,C1481851679
15756,1196428',2018-01-11,FDRL/NATIONAL ELECTRONIC F,17271.0,0.0,,2018,1,11,CHECK_WITHDRAWAL,17271.0,C741431520
15757,1196428',2018-01-11,FDRL/NATIONAL ELECTRONIC F,22778.0,0.0,,2018,1,11,DEBIT,22778.0,C758888772
15758,1196428',2018-01-11,FDRL/NATIONAL ELECTRONIC F,16809.0,0.0,,2018,1,11,CASH_OUT,16809.0,C1001409363
15759,1196428',2018-01-11,FDRL/NATIONAL ELECTRONIC F,13786.0,0.0,,2018,1,11,CASH_OUT,13786.0,M1340854901
15760,1196428',2018-01-11,FDRL/NATIONAL ELECTRONIC F,22491.0,0.0,,2018,1,11,CHECK_WITHDRAWAL,22491.0,M265997755
15761,1196428',2018-01-11,FDRL/NATIONAL ELECTRONIC F,26165.0,0.0,,2018,1,11,PAYEMENT,26165.0,M1257695233
15762,1196428',2018-01-11,FDRL/NATIONAL ELECTRONIC F,10063.0,0.0,,2018,1,11,PAYEMENT,10063.0,C150309335
15763,1196428',2018-01-11,FDRL/NATIONAL ELECTRONIC F,28480.0,0.0,,2018,1,11,DEBIT,28480.0,M1572611628
15764,1196428',2018-01-11,FDRL/NATIONAL ELECTRONIC F,8878.0,0.0,,2018,1,11,DEBIT,8878.0,M280183141
15765,1196428',2018-01-11,FDRL/NATIONAL ELECTRONIC F,19373.0,0.0,,2018,1,11,DEBIT,19373.0,M808540700
15766,1196428',2018-01-11,FDRL/NATIONAL ELECTRONIC F,18092.0,0.0,,2018,1,11,CHECK_WITHDRAWAL,18092.0,M565481399
15767,1196428',2018-01-11,FDRL/NATIONAL ELECTRONIC F,13697.0,0.0,,2018,1,11,DEBIT,13697.0,C842729010
15768,1196428',2018-01-11,FDRL/NATIONAL ELECTRONIC F,24348.0,0.0,,2018,1,11,CHECK_WITHDRAWAL,24348.0,M178371442
15769,1196428',2018-01-11,FDRL/NATIONAL ELECTRONIC F,13697.0,0.0,,2018,1,11,DEBIT,13697.0,M2076445832
15770,1196428',2018-01-11,FDRL/NATIONAL ELECTRONIC F,18059.0,0.0,,2018,1,11,CASH_OUT,18059.0,C599968109
15771,1196428',2018-01-11,FDRL/NATIONAL ELECTRONIC F,23403.0,0.0,,2018,1,11,DEBIT,23403.0,C599265282
15772,1196428',2018-01-11,FDRL/NATIONAL ELECTRONIC F,18697.0,0.0,,2018,1,11,PAYEMENT,18697.0,C669771073
15773,1196428',2018-01-11,FDRL/NATIONAL ELECTRONIC F,9574.0,0.0,,2018,1,11,PAYEMENT,9574.0,C2137848242
15774,1196428',2018-01-11,FDRL/NATIONAL ELECTRONIC F,19535.0,0.0,,2018,1,11,DEBIT,19535.0,M997986347
15775,1196428',2018-01-11,FDRL/NATIONAL ELECTRONIC F,21043.0,0.0,,2018,1,11,PAYEMENT,21043.0,M1063792159
15776,1196428',2018-01-11,FDRL/NATIONAL ELECTRONIC F,29552.0,0.0,,2018,1,11,CASH_OUT,29552.0,C22448303
15777,1196428',2018-01-11,FDRL/NATIONAL ELECTRONIC F,19252.0,0.0,,2018,1,11,CHECK_WITHDRAWAL,19252.0,M315692635
15778,1196428',2018-01-11,FDRL/NATIONAL ELECTRONIC F,9844.0,0.0,,2018,1,11,PAYEMENT,9844.0,M803644277
15779,1196428',2018-01-11,FDRL/NATIONAL ELECTRONIC F,14424.0,0.0,,2018,1,11,PAYEMENT,14424.0,M415913007
15780,1196428',2018-01-11,FDRL/NATIONAL ELECTRONIC F,17317.0,0.0,,2018,1,11,CHECK_WITHDRAWAL,17317.0,M1344197461
15781,1196428',2018-01-11,FDRL/NATIONAL ELECTRONIC F,16153.0,0.0,,2018,1,11,CHECK_WITHDRAWAL,16153.0,M132014623
15782,1196428',2018-01-11,FDRL/NATIONAL ELECTRONIC F,25704.0,0.0,,2018,1,11,CASH_OUT,25704.0,M577051450
15783,1196428',2018-01-11,FDRL/NATIONAL ELECTRONIC F,19628.0,0.0,,2018,1,11,CASH_OUT,19628.0,C1491676195
15784,1196428',2018-01-11,FDRL/NATIONAL ELECTRONIC F,25971.0,0.0,,2018,1,11,CASH_OUT,25971.0,C943166837
15785,1196428',2018-01-11,FDRL/NATIONAL ELECTRONIC F,7061.0,0.0,,2018,1,11,PAYEMENT,7061.0,M1402953791
15786,1196428',2018-01-11,FDRL/NATIONAL ELECTRONIC F,19424.0,0.0,,2018,1,11,DEBIT,19424.0,M1974589236
15787,1196428',2018-01-11,FDRL/NATIONAL ELECTRONIC F,9591.0,0.0,,2018,1,11,CASH_OUT,9591.0,C1701412896
15788,1196428',2018-01-11,FDRL/NATIONAL ELECTRONIC F,12786.0,0.0,,2018,1,11,CASH_OUT,12786.0,M1355606971
15789,1196428',2018-01-11,FDRL/NATIONAL ELECTRONIC F,9827.0,0.0,,2018,1,11,CHECK_WITHDRAWAL,9827.0,M1037747072
15790,1196428',2018-01-11,FDRL/NATIONAL ELECTRONIC F,9827.0,0.0,,2018,1,11,CHECK_WITHDRAWAL,9827.0,M82220349
15791,1196428',2018-01-11,FDRL/NATIONAL ELECTRONIC F,18096.0,0.0,,2018,1,11,CASH_OUT,18096.0,M953439482
15792,1196428',2018-01-11,FDRL/NATIONAL ELECTRONIC F,20642.0,0.0,,2018,1,11,CASH_OUT,20642.0,C1914282536
15793,1196428',2018-01-11,FDRL/NATIONAL ELECTRONIC F,15244.0,0.0,,2018,1,11,DEBIT,15244.0,C691636444
15794,1196428',2018-01-11,FDRL/NATIONAL ELECTRONIC F,14521.0,0.0,,2018,1,11,CHECK_WITHDRAWAL,14521.0,C683605346
15795,1196428',2018-01-11,FDRL/NATIONAL ELECTRONIC F,12715.0,0.0,,2018,1,11,CHECK_WITHDRAWAL,12715.0,M1967366965
15796,1196428',2018-01-11,FDRL/NATIONAL ELECTRONIC F,13816.0,0.0,,2018,1,11,DEBIT,13816.0,M508405148
15797,1196428',2018-01-11,FDRL/NATIONAL ELECTRONIC F,19798.0,0.0,,2018,1,11,DEBIT,19798.0,M1295579320
15798,1196428',2018-01-11,FDRL/NATIONAL ELECTRONIC F,19061.0,0.0,,2018,1,11,CHECK_WITHDRAWAL,19061.0,M995168511
15799,1196428',2018-01-11,FDRL/NATIONAL ELECTRONIC F,29066.0,0.0,,2018,1,11,DEBIT,29066.0,M1102425439
15800,1196428',2018-01-11,FDRL/NATIONAL ELECTRONIC F,23511.0,0.0,,2018,1,11,PAYEMENT,23511.0,M590053012
15801,1196428',2018-01-11,FDRL/NATIONAL ELECTRONIC F,13885.0,0.0,,2018,1,11,CHECK_WITHDRAWAL,13885.0,M386886002
15802,1196428',2018-01-11,FDRL/NATIONAL ELECTRONIC F,19449.0,0.0,,2018,1,11,CHECK_WITHDRAWAL,19449.0,M227585143
15803,1196428',2018-01-11,FDRL/NATIONAL ELECTRONIC F,17959.0,0.0,,2018,1,11,PAYEMENT,17959.0,M2105068287
15804,1196428',2018-01-11,FDRL/NATIONAL ELECTRONIC F,20322.0,0.0,,2018,1,11,CASH_OUT,20322.0,M1038116064
15805,1196428',2018-01-11,FDRL/NATIONAL ELECTRONIC F,23365.0,0.0,,2018,1,11,PAYEMENT,23365.0,M345805867
15806,1196428',2018-01-11,FDRL/NATIONAL ELECTRONIC F,24977.0,0.0,,2018,1,11,CASH_OUT,24977.0,M1128144161
15807,1196428',2018-01-11,FDRL/NATIONAL ELECTRONIC F,16989.0,0.0,,2018,1,11,CASH_OUT,16989.0,M1492172037
15808,1196428',2018-01-11,FDRL/NATIONAL ELECTRONIC F,16788.0,0.0,,2018,1,11,CASH_OUT,16788.0,M731603444
15809,1196428',2018-01-11,FDRL/NATIONAL ELECTRONIC F,26918.0,0.0,,2018,1,11,PAYEMENT,26918.0,M879683510
15810,1196428',2018-01-11,FDRL/NATIONAL ELECTRONIC F,11680.0,0.0,,2018,1,11,PAYEMENT,11680.0,M555126583
15811,1196428',2018-01-11,FDRL/NATIONAL ELECTRONIC F,23412.0,0.0,,2018,1,11,CHECK_WITHDRAWAL,23412.0,M1344791022
15812,1196428',2018-01-11,FDRL/NATIONAL ELECTRONIC F,22583.0,0.0,,2018,1,11,PAYEMENT,22583.0,M40493588
15813,1196428',2018-01-11,FDRL/NATIONAL ELECTRONIC F,14316.0,0.0,,2018,1,11,PAYEMENT,14316.0,M1099885881
15814,1196428',2018-01-11,FDRL/NATIONAL ELECTRONIC F,22495.0,0.0,,2018,1,11,PAYEMENT,22495.0,M107256650
15815,1196428',2018-01-11,FDRL/NATIONAL ELECTRONIC F,10600.0,0.0,,2018,1,11,PAYEMENT,10600.0,M1410611700
15816,1196428',2018-01-11,NEFT/000029127606/ACCOUNT,0.0,27360.0,,2018,1,11,CASH_IN,27360.0,M954062800
15817,1196428',2018-01-11,BEAT CSH PKP DEL GURG 550,0.0,569000.0,,2018,1,11,CASH_IN,569000.0,M13013852
15818,1196428',2018-01-11,TRF FROM  Indiaforensic SERVICES,0.0,10500000.0,,2018,1,11,CASH_IN,10500000.0,M1101858256
15819,1196428',2018-01-11,TRF FROM  Indiaforensic SERVICES,0.0,200000.0,,2018,1,11,TRANSFER,200000.0,M1180862248
15820,1196428',2018-01-11,TRF FROM  Indiaforensic SERVICES,0.0,166000.0,,2018,1,11,CASH_IN,166000.0,M966462848
15821,1196428',2018-01-11,TRF FROM  Indiaforensic SERVICES,0.0,3200000.0,,2018,1,11,TRANSFER,3200000.0,M1284324188
15822,1196428',2018-01-11,FDRL/INTERNAL FUND TRANSFE,5000000.0,0.0,,2018,1,11,CASH_OUT,5000000.0,C374625527
15823,1196428',2018-01-11,FDRL/INTERNAL FUND TRANSFE,5000000.0,0.0,,2018,1,11,PAYEMENT,5000000.0,C1262822392
15824,1196428',2018-01-11,FDRL/INTERNAL FUND TRANSFE,5000000.0,0.0,,2018,1,11,CASH_OUT,5000000.0,C1671386208
15825,1196428',2018-01-11,FDRL/INTERNAL FUND TRANSFE,5000000.0,0.0,,2018,1,11,DEBIT,5000000.0,C1869197498
15826,1196428',2018-01-11,FDRL/INTERNAL FUND TRANSFE,5000000.0,0.0,,2018,1,11,CHECK_WITHDRAWAL,5000000.0,C271488817
15827,1196428',2018-01-11,FDRL/INTERNAL FUND TRANSFE,1000000.0,0.0,,2018,1,11,PAYEMENT,1000000.0,M1915909017
15828,1196428',2018-01-11,FDRL/INTERNAL FUND TRANSFE,500000.0,0.0,,2018,1,11,DEBIT,500000.0,C2052185144
15829,1196428',2018-01-12,NEFT/BDBLH18012001502/PAW,0.0,9000.0,,2018,1,12,TRANSFER,9000.0,C646059443
15830,1196428',2018-01-12,RTGS/ICICH18012616391/O I,0.0,1200000.0,,2018,1,12,CASH_IN,1200000.0,C1982591789
15831,1196428',2018-01-12,RTGS/HDFCH18012441674/PAY,0.0,3840000.0,,2018,1,12,CHECK_CASHING,3840000.0,C1977614404
15832,1196428',2018-01-12,RTGS/HDFCH18012447198/PAY,0.0,6640000.0,,2018,1,12,CASH_IN,6640000.0,C1883840933
15833,1196428',2018-01-12,FDRL/INTERNAL FUND TRANSFE,500000.0,0.0,,2018,1,12,DEBIT,500000.0,C2007207148
15834,1196428',2018-01-12,FDRL/INTERNAL FUND TRANSFE,500000.0,0.0,,2018,1,12,DEBIT,500000.0,M1014644493
15835,1196428',2018-01-12,FDRL/REAL TIME GROSS SETTL,10000000.0,0.0,,2018,1,12,DEBIT,10000000.0,C381605910
15836,1196428',2018-01-12,RTGS/BARBH18012893988/MAK,0.0,201111.0,,2018,1,12,CHECK_CASHING,201111.0,M1056752544
15837,1196428',2018-01-12,NEFT/AXISP18012066598/ACC,0.0,25000000.0,,2018,1,12,CASH_IN,25000000.0,M729567968
15838,1196428',2018-01-12,CASHDEP/VIKASMARG/TP,0.0,77000.0,,2018,1,12,CASH_IN,77000.0,M1723507087
15839,1196428',2018-01-12,"Indiaforensic USA, INC./USD/4461",0.0,2823508.67,,2018,1,12,CASH_IN,2823508.67,C849038219
15840,1196428',2018-01-12,IRTT00701801121,1613.23,0.0,,2018,1,12,DEBIT,1613.23,C1038678108
15841,1196428',2018-01-12,NEFT/N012180452702073/PAY,0.0,1698476.6,,2018,1,12,CHECK_CASHING,1698476.6,M1976340229
15842,1196428',2018-01-12,NEFT/N012180452702122/PAY,0.0,1052214.84,,2018,1,12,CHECK_CASHING,1052214.84,M693274483
15843,1196428',2018-01-12,FDRL/NATIONAL ELECTRONIC F,100000.0,0.0,,2018,1,12,CHECK_WITHDRAWAL,100000.0,M838050003
15844,1196428',2018-01-12,FDRL/NATIONAL ELECTRONIC F,100000.0,0.0,,2018,1,12,CASH_OUT,100000.0,C1009972184
15845,1196428',2018-01-12,Indiaforensic SERVICES INDIA PVT,0.0,697694.0,,2018,1,12,CASH_IN,697694.0,C63475121
15846,1196428',2018-01-12,NEFT/N012180452884416/PAY,0.0,8400000.0,,2018,1,12,CHECK_CASHING,8400000.0,C1130075212
15847,1196428',2018-01-12,YOURSELF FOR BULK NEFT  B,3500000.0,0.0,,2018,1,12,DEBIT,3500000.0,C851316413
15848,1196428',2018-01-12,YOURSELF FOR BULK NEFT  B,14467800.0,0.0,,2018,1,12,CASH_OUT,14467800.0,M718843573
15849,1196428',2018-01-12,TRF FROM  Indiaforensic SERVICES,0.0,12500000.0,,2018,1,12,CHECK_CASHING,12500000.0,M1217713614
15850,1196428',2018-01-12,TRF FROM  Indiaforensic SERVICES,0.0,4000000.0,,2018,1,12,CASH_IN,4000000.0,M706338650
15851,1196428',2018-01-12,NEFT/FDRL656260020/Indiaforensic,0.0,2000000.0,,2018,1,12,CHECK_CASHING,2000000.0,M995800830
15852,1196428',2018-01-12,FDRL/INTERNAL FUND TRANSFE,500000.0,0.0,,2018,1,12,CASH_OUT,500000.0,C1073259437
15853,1196428',2018-01-12,FDRL/INTERNAL FUND TRANSFE,500000.0,0.0,,2018,1,12,CASH_OUT,500000.0,M1699315785
15854,1196428',2018-01-12,FDRL/INTERNAL FUND TRANSFE,300000.0,0.0,,2018,1,12,DEBIT,300000.0,M1163711030
15855,1196428',2018-01-12,FDRL/INTERNAL FUND TRANSFE,300000.0,0.0,,2018,1,12,CHECK_WITHDRAWAL,300000.0,C320106510
15856,1196428',2018-01-12,FDRL/INTERNAL FUND TRANSFE,15000000.0,0.0,,2018,1,12,CASH_OUT,15000000.0,M597251930
15857,1196428',2018-01-12,FDRL/INTERNAL FUND TRANSFE,15000000.0,0.0,,2018,1,12,CHECK_WITHDRAWAL,15000000.0,M1515100477
15858,1196428',2018-01-12,FDRL/INTERNAL FUND TRANSFE,4000000.0,0.0,,2018,1,12,DEBIT,4000000.0,M1412315921
15859,1196428',2018-01-12,FDRL/INTERNAL FUND TRANSFE,500000.0,0.0,,2018,1,12,CHECK_WITHDRAWAL,500000.0,M1168923345
15860,1196428',2018-01-12,FDRL/INTERNAL FUND TRANSFE,5000000.0,0.0,,2018,1,12,CHECK_WITHDRAWAL,5000000.0,M2042700604
15861,1196428',2018-01-12,BEAT CSH PKP DEL GURG 550,0.0,619000.0,,2018,1,12,CHECK_CASHING,619000.0,C710481910
15862,1196428',2018-01-13,UPI/801312661057/SONU RAJ,0.0,11800.0,,2018,1,13,CHECK_CASHING,11800.0,M1474634841
15863,1196428',2018-01-15,RTGS/HDFCH18015545923/PAY,0.0,8400000.0,,2018,1,15,CHECK_CASHING,8400000.0,C669419693
15864,1196428',2018-01-15,FDRL/NATIONAL ELECTRONIC F,32735.0,0.0,,2018,1,15,CASH_OUT,32735.0,C2095611317
15865,1196428',2018-01-15,FDRL/NATIONAL ELECTRONIC F,39925.0,0.0,,2018,1,15,CHECK_WITHDRAWAL,39925.0,C1316560467
15866,1196428',2018-01-15,FDRL/NATIONAL ELECTRONIC F,52059.0,0.0,,2018,1,15,CHECK_WITHDRAWAL,52059.0,M1572144334
15867,1196428',2018-01-15,FDRL/NATIONAL ELECTRONIC F,32313.0,0.0,,2018,1,15,CHECK_WITHDRAWAL,32313.0,M593517569
15868,1196428',2018-01-15,FDRL/NATIONAL ELECTRONIC F,97716.0,0.0,,2018,1,15,CHECK_WITHDRAWAL,97716.0,M558730564
15869,1196428',2018-01-15,FDRL/NATIONAL ELECTRONIC F,33340.0,0.0,,2018,1,15,CHECK_WITHDRAWAL,33340.0,C736160330
15870,1196428',2018-01-15,FDRL/NATIONAL ELECTRONIC F,30933.0,0.0,,2018,1,15,DEBIT,30933.0,C417236208
15871,1196428',2018-01-15,FDRL/NATIONAL ELECTRONIC F,70541.0,0.0,,2018,1,15,DEBIT,70541.0,C931482420
15872,1196428',2018-01-15,FDRL/NATIONAL ELECTRONIC F,82834.0,0.0,,2018,1,15,CASH_OUT,82834.0,M405976415
15873,1196428',2018-01-15,FDRL/NATIONAL ELECTRONIC F,48574.0,0.0,,2018,1,15,CASH_OUT,48574.0,C208341157
15874,1196428',2018-01-15,FDRL/NATIONAL ELECTRONIC F,50595.0,0.0,,2018,1,15,DEBIT,50595.0,C382697424
15875,1196428',2018-01-15,FDRL/NATIONAL ELECTRONIC F,32167.0,0.0,,2018,1,15,CHECK_WITHDRAWAL,32167.0,M875577692
15876,1196428',2018-01-15,FDRL/NATIONAL ELECTRONIC F,60917.0,0.0,,2018,1,15,CASH_OUT,60917.0,C1822578654
15877,1196428',2018-01-15,FDRL/NATIONAL ELECTRONIC F,63453.0,0.0,,2018,1,15,DEBIT,63453.0,M2022435822
15878,1196428',2018-01-15,FDRL/NATIONAL ELECTRONIC F,33824.0,0.0,,2018,1,15,CHECK_WITHDRAWAL,33824.0,M1867372125
15879,1196428',2018-01-15,FDRL/NATIONAL ELECTRONIC F,39022.0,0.0,,2018,1,15,DEBIT,39022.0,M556592378
15880,1196428',2018-01-15,FDRL/NATIONAL ELECTRONIC F,61015.0,0.0,,2018,1,15,CASH_OUT,61015.0,C807072084
15881,1196428',2018-01-15,FDRL/NATIONAL ELECTRONIC F,37210.0,0.0,,2018,1,15,CASH_OUT,37210.0,C2077098348
15882,1196428',2018-01-15,FDRL/NATIONAL ELECTRONIC F,65517.0,0.0,,2018,1,15,PAYEMENT,65517.0,M1751878963
15883,1196428',2018-01-15,FDRL/NATIONAL ELECTRONIC F,33155.0,0.0,,2018,1,15,CHECK_WITHDRAWAL,33155.0,C1618278649
15884,1196428',2018-01-15,FDRL/NATIONAL ELECTRONIC F,33724.0,0.0,,2018,1,15,PAYEMENT,33724.0,C1987564320
15885,1196428',2018-01-15,FDRL/NATIONAL ELECTRONIC F,52830.0,0.0,,2018,1,15,CHECK_WITHDRAWAL,52830.0,M848162783
15886,1196428',2018-01-15,FDRL/NATIONAL ELECTRONIC F,31312.0,0.0,,2018,1,15,CHECK_WITHDRAWAL,31312.0,M347906624
15887,1196428',2018-01-15,FDRL/NATIONAL ELECTRONIC F,65543.0,0.0,,2018,1,15,CASH_OUT,65543.0,M271658762
15888,1196428',2018-01-15,FDRL/NATIONAL ELECTRONIC F,34667.0,0.0,,2018,1,15,CASH_OUT,34667.0,M1403007770
15889,1196428',2018-01-15,FDRL/NATIONAL ELECTRONIC F,47269.0,0.0,,2018,1,15,CASH_OUT,47269.0,M2043631011
15890,1196428',2018-01-15,FDRL/NATIONAL ELECTRONIC F,58032.0,0.0,,2018,1,15,CASH_OUT,58032.0,C107095723
15891,1196428',2018-01-15,FDRL/NATIONAL ELECTRONIC F,67064.0,0.0,,2018,1,15,CHECK_WITHDRAWAL,67064.0,C985934102
15892,1196428',2018-01-15,FDRL/NATIONAL ELECTRONIC F,34353.0,0.0,,2018,1,15,CHECK_WITHDRAWAL,34353.0,C824197891
15893,1196428',2018-01-15,FDRL/NATIONAL ELECTRONIC F,37713.0,0.0,,2018,1,15,PAYEMENT,37713.0,C1696218625
15894,1196428',2018-01-15,FDRL/NATIONAL ELECTRONIC F,33839.0,0.0,,2018,1,15,DEBIT,33839.0,M1817447589
15895,1196428',2018-01-15,FDRL/NATIONAL ELECTRONIC F,55332.0,0.0,,2018,1,15,PAYEMENT,55332.0,C168639687
15896,1196428',2018-01-15,FDRL/NATIONAL ELECTRONIC F,84099.0,0.0,,2018,1,15,CASH_OUT,84099.0,C1630293008
15897,1196428',2018-01-15,FDRL/NATIONAL ELECTRONIC F,32897.0,0.0,,2018,1,15,CASH_OUT,32897.0,C1577420620
15898,1196428',2018-01-15,FDRL/NATIONAL ELECTRONIC F,30166.0,0.0,,2018,1,15,CASH_OUT,30166.0,C35263828
15899,1196428',2018-01-15,FDRL/NATIONAL ELECTRONIC F,41079.0,0.0,,2018,1,15,PAYEMENT,41079.0,M2014874822
15900,1196428',2018-01-15,FDRL/NATIONAL ELECTRONIC F,53682.0,0.0,,2018,1,15,CHECK_WITHDRAWAL,53682.0,M1553772873
15901,1196428',2018-01-15,FDRL/NATIONAL ELECTRONIC F,39973.0,0.0,,2018,1,15,DEBIT,39973.0,C905650857
15902,1196428',2018-01-15,FDRL/NATIONAL ELECTRONIC F,50748.0,0.0,,2018,1,15,CASH_OUT,50748.0,C1502287290
15903,1196428',2018-01-15,FDRL/NATIONAL ELECTRONIC F,39550.0,0.0,,2018,1,15,CHECK_WITHDRAWAL,39550.0,M1197564988
15904,1196428',2018-01-15,FDRL/NATIONAL ELECTRONIC F,50927.0,0.0,,2018,1,15,DEBIT,50927.0,M1843534160
15905,1196428',2018-01-15,FDRL/NATIONAL ELECTRONIC F,33988.0,0.0,,2018,1,15,DEBIT,33988.0,C871895680
15906,1196428',2018-01-15,FDRL/NATIONAL ELECTRONIC F,33427.0,0.0,,2018,1,15,DEBIT,33427.0,C1398530689
15907,1196428',2018-01-15,FDRL/NATIONAL ELECTRONIC F,30619.0,0.0,,2018,1,15,DEBIT,30619.0,M834859488
15908,1196428',2018-01-15,FDRL/NATIONAL ELECTRONIC F,70043.0,0.0,,2018,1,15,PAYEMENT,70043.0,M463880076
15909,1196428',2018-01-15,FDRL/NATIONAL ELECTRONIC F,45686.0,0.0,,2018,1,15,CASH_OUT,45686.0,M1273091698
15910,1196428',2018-01-15,FDRL/NATIONAL ELECTRONIC F,49843.0,0.0,,2018,1,15,CHECK_WITHDRAWAL,49843.0,M134350609
15911,1196428',2018-01-15,FDRL/NATIONAL ELECTRONIC F,32038.0,0.0,,2018,1,15,CHECK_WITHDRAWAL,32038.0,M1939822545
15912,1196428',2018-01-15,FDRL/NATIONAL ELECTRONIC F,40251.0,0.0,,2018,1,15,PAYEMENT,40251.0,M1498010747
15913,1196428',2018-01-15,FDRL/NATIONAL ELECTRONIC F,33349.0,0.0,,2018,1,15,CASH_OUT,33349.0,M615833646
15914,1196428',2018-01-15,FDRL/NATIONAL ELECTRONIC F,45019.0,0.0,,2018,1,15,CHECK_WITHDRAWAL,45019.0,M695601535
15915,1196428',2018-01-15,FDRL/NATIONAL ELECTRONIC F,40488.0,0.0,,2018,1,15,DEBIT,40488.0,M1741551200
15916,1196428',2018-01-15,FDRL/NATIONAL ELECTRONIC F,39921.0,0.0,,2018,1,15,CASH_OUT,39921.0,M533060514
15917,1196428',2018-01-15,FDRL/NATIONAL ELECTRONIC F,37864.0,0.0,,2018,1,15,CASH_OUT,37864.0,M763925237
15918,1196428',2018-01-15,FDRL/NATIONAL ELECTRONIC F,41180.0,0.0,,2018,1,15,CHECK_WITHDRAWAL,41180.0,M309397793
15919,1196428',2018-01-15,FDRL/NATIONAL ELECTRONIC F,32410.0,0.0,,2018,1,15,DEBIT,32410.0,M786088183
15920,1196428',2018-01-15,FDRL/NATIONAL ELECTRONIC F,34531.0,0.0,,2018,1,15,DEBIT,34531.0,M1362397723
15921,1196428',2018-01-15,FDRL/NATIONAL ELECTRONIC F,34537.0,0.0,,2018,1,15,CASH_OUT,34537.0,M166947904
15922,1196428',2018-01-15,FDRL/NATIONAL ELECTRONIC F,38389.0,0.0,,2018,1,15,DEBIT,38389.0,M39384037
15923,1196428',2018-01-15,FDRL/NATIONAL ELECTRONIC F,34766.0,0.0,,2018,1,15,DEBIT,34766.0,M1475711030
15924,1196428',2018-01-15,FDRL/NATIONAL ELECTRONIC F,47401.0,0.0,,2018,1,15,CHECK_WITHDRAWAL,47401.0,M727579419
15925,1196428',2018-01-15,FDRL/NATIONAL ELECTRONIC F,43979.0,0.0,,2018,1,15,DEBIT,43979.0,M654290745
15926,1196428',2018-01-15,FDRL/NATIONAL ELECTRONIC F,35393.0,0.0,,2018,1,15,PAYEMENT,35393.0,C1559145228
15927,1196428',2018-01-15,FDRL/NATIONAL ELECTRONIC F,32669.0,0.0,,2018,1,15,DEBIT,32669.0,M688458571
15928,1196428',2018-01-15,FDRL/NATIONAL ELECTRONIC F,35148.0,0.0,,2018,1,15,PAYEMENT,35148.0,M1895621189
15929,1196428',2018-01-15,FDRL/NATIONAL ELECTRONIC F,43946.0,0.0,,2018,1,15,CASH_OUT,43946.0,M1516781526
15930,1196428',2018-01-15,FDRL/NATIONAL ELECTRONIC F,37004.0,0.0,,2018,1,15,DEBIT,37004.0,M409559965
15931,1196428',2018-01-15,FDRL/NATIONAL ELECTRONIC F,38462.0,0.0,,2018,1,15,PAYEMENT,38462.0,M1771169983
15932,1196428',2018-01-15,FDRL/NATIONAL ELECTRONIC F,30098.0,0.0,,2018,1,15,DEBIT,30098.0,C470217116
15933,1196428',2018-01-15,FDRL/NATIONAL ELECTRONIC F,47218.0,0.0,,2018,1,15,CHECK_WITHDRAWAL,47218.0,M585745963
15934,1196428',2018-01-15,FDRL/NATIONAL ELECTRONIC F,31293.0,0.0,,2018,1,15,DEBIT,31293.0,M2096974885
15935,1196428',2018-01-15,FDRL/NATIONAL ELECTRONIC F,35730.0,0.0,,2018,1,15,CASH_OUT,35730.0,M1287228290
15936,1196428',2018-01-15,FDRL/NATIONAL ELECTRONIC F,45169.0,0.0,,2018,1,15,DEBIT,45169.0,M1178751818
15937,1196428',2018-01-15,FDRL/NATIONAL ELECTRONIC F,34767.0,0.0,,2018,1,15,CHECK_WITHDRAWAL,34767.0,M145594829
15938,1196428',2018-01-15,FDRL/NATIONAL ELECTRONIC F,33296.0,0.0,,2018,1,15,DEBIT,33296.0,M1232351629
15939,1196428',2018-01-15,FDRL/NATIONAL ELECTRONIC F,48062.0,0.0,,2018,1,15,PAYEMENT,48062.0,M1656904340
15940,1196428',2018-01-15,FDRL/NATIONAL ELECTRONIC F,38300.0,0.0,,2018,1,15,CASH_OUT,38300.0,C24404443
15941,1196428',2018-01-15,FDRL/NATIONAL ELECTRONIC F,30363.0,0.0,,2018,1,15,DEBIT,30363.0,C596299019
15942,1196428',2018-01-15,FDRL/NATIONAL ELECTRONIC F,40538.0,0.0,,2018,1,15,DEBIT,40538.0,C1983747920
15943,1196428',2018-01-15,FDRL/NATIONAL ELECTRONIC F,30333.0,0.0,,2018,1,15,CASH_OUT,30333.0,C696705647
15944,1196428',2018-01-15,FDRL/NATIONAL ELECTRONIC F,34555.0,0.0,,2018,1,15,CHECK_WITHDRAWAL,34555.0,C1845765982
15945,1196428',2018-01-15,FDRL/NATIONAL ELECTRONIC F,32115.0,0.0,,2018,1,15,PAYEMENT,32115.0,M877365519
15946,1196428',2018-01-15,FDRL/NATIONAL ELECTRONIC F,40196.0,0.0,,2018,1,15,PAYEMENT,40196.0,C134604590
15947,1196428',2018-01-15,FDRL/NATIONAL ELECTRONIC F,33598.0,0.0,,2018,1,15,CASH_OUT,33598.0,M1053485132
15948,1196428',2018-01-15,FDRL/NATIONAL ELECTRONIC F,47012.0,0.0,,2018,1,15,PAYEMENT,47012.0,M1698378565
15949,1196428',2018-01-15,FDRL/NATIONAL ELECTRONIC F,34269.0,0.0,,2018,1,15,PAYEMENT,34269.0,M1418167825
15950,1196428',2018-01-15,FDRL/NATIONAL ELECTRONIC F,39766.0,0.0,,2018,1,15,DEBIT,39766.0,M915318947
15951,1196428',2018-01-15,FDRL/NATIONAL ELECTRONIC F,30545.0,0.0,,2018,1,15,CASH_OUT,30545.0,M1471526064
15952,1196428',2018-01-15,FDRL/NATIONAL ELECTRONIC F,42065.0,0.0,,2018,1,15,PAYEMENT,42065.0,C474166728
15953,1196428',2018-01-15,FDRL/NATIONAL ELECTRONIC F,37913.0,0.0,,2018,1,15,CASH_OUT,37913.0,M1777764920
15954,1196428',2018-01-15,FDRL/NATIONAL ELECTRONIC F,40737.0,0.0,,2018,1,15,CASH_OUT,40737.0,C1833549064
15955,1196428',2018-01-15,FDRL/NATIONAL ELECTRONIC F,34140.0,0.0,,2018,1,15,PAYEMENT,34140.0,M327804056
15956,1196428',2018-01-15,FDRL/NATIONAL ELECTRONIC F,37263.0,0.0,,2018,1,15,CHECK_WITHDRAWAL,37263.0,M939893108
15957,1196428',2018-01-15,FDRL/NATIONAL ELECTRONIC F,38531.0,0.0,,2018,1,15,PAYEMENT,38531.0,C1938462589
15958,1196428',2018-01-15,FDRL/NATIONAL ELECTRONIC F,34670.0,0.0,,2018,1,15,PAYEMENT,34670.0,M974784761
15959,1196428',2018-01-15,FDRL/NATIONAL ELECTRONIC F,43833.0,0.0,,2018,1,15,PAYEMENT,43833.0,M209997138
15960,1196428',2018-01-15,FDRL/NATIONAL ELECTRONIC F,49250.0,0.0,,2018,1,15,DEBIT,49250.0,M359327148
15961,1196428',2018-01-15,FDRL/NATIONAL ELECTRONIC F,37710.0,0.0,,2018,1,15,CASH_OUT,37710.0,C1519216494
15962,1196428',2018-01-15,FDRL/INTERNAL FUND TRANSFE,35275.0,0.0,,2018,1,15,PAYEMENT,35275.0,M142106520
15963,1196428',2018-01-15,FDRL/INTERNAL FUND TRANSFE,38882.0,0.0,,2018,1,15,CASH_OUT,38882.0,C1979080020
15964,1196428',2018-01-15,FDRL/NATIONAL ELECTRONIC F,35302.0,0.0,,2018,1,15,PAYEMENT,35302.0,C635281078
15965,1196428',2018-01-15,FDRL/NATIONAL ELECTRONIC F,62868.0,0.0,,2018,1,15,PAYEMENT,62868.0,C1866672043
15966,1196428',2018-01-15,FDRL/NATIONAL ELECTRONIC F,79324.0,0.0,,2018,1,15,PAYEMENT,79324.0,M155979068
15967,1196428',2018-01-15,FDRL/NATIONAL ELECTRONIC F,82548.0,0.0,,2018,1,15,CASH_OUT,82548.0,M111496179
15968,1196428',2018-01-15,FDRL/NATIONAL ELECTRONIC F,30345.0,0.0,,2018,1,15,CASH_OUT,30345.0,M1472428747
15969,1196428',2018-01-15,FDRL/NATIONAL ELECTRONIC F,40505.0,0.0,,2018,1,15,PAYEMENT,40505.0,C1167813715
15970,1196428',2018-01-15,FDRL/NATIONAL ELECTRONIC F,64127.0,0.0,,2018,1,15,CASH_OUT,64127.0,M235839070
15971,1196428',2018-01-15,FDRL/NATIONAL ELECTRONIC F,71460.0,0.0,,2018,1,15,PAYEMENT,71460.0,M1881768592
15972,1196428',2018-01-15,FDRL/NATIONAL ELECTRONIC F,38069.0,0.0,,2018,1,15,PAYEMENT,38069.0,C185503802
15973,1196428',2018-01-15,FDRL/NATIONAL ELECTRONIC F,41950.0,0.0,,2018,1,15,DEBIT,41950.0,C403147759
15974,1196428',2018-01-15,FDRL/NATIONAL ELECTRONIC F,31117.0,0.0,,2018,1,15,CHECK_WITHDRAWAL,31117.0,M1725462644
15975,1196428',2018-01-15,FDRL/NATIONAL ELECTRONIC F,50094.0,0.0,,2018,1,15,CHECK_WITHDRAWAL,50094.0,M685639359
15976,1196428',2018-01-15,FDRL/NATIONAL ELECTRONIC F,12930.0,0.0,,2018,1,15,DEBIT,12930.0,M499928991
15977,1196428',2018-01-15,FDRL/NATIONAL ELECTRONIC F,231323.0,0.0,,2018,1,15,CASH_OUT,231323.0,M960322367
15978,1196428',2018-01-15,NEFT/BARBR18015753080/MAK,0.0,95950.0,,2018,1,15,TRANSFER,95950.0,M1786085833
15979,1196428',2018-01-15,NEFT/N015180453692982/PAY,0.0,1.0,,2018,1,15,CASH_IN,1.0,M718103121
15980,1196428',2018-01-15,CASHDEP/VIKASMARG/TP,0.0,51000.0,,2018,1,15,CHECK_CASHING,51000.0,M757687320
15981,1196428',2018-01-15,Indiaforensic SERVICES INDIA PVT,0.0,923948.0,,2018,1,15,CHECK_CASHING,923948.0,M1144148971
15982,1196428',2018-01-15,FDRL/REAL TIME GROSS SETTL,3000000.0,0.0,,2018,1,15,PAYEMENT,3000000.0,M1868505862
15983,1196428',2018-01-15,FDRL/INTERNAL FUND TRANSFE,27550.0,0.0,,2018,1,15,PAYEMENT,27550.0,M1608080402
15984,1196428',2018-01-15,FDRL/INTERNAL FUND TRANSFE,72879.0,0.0,,2018,1,15,PAYEMENT,72879.0,M1154038476
15985,1196428',2018-01-15,NEFT/N015180453719316/PAY,0.0,1351025.72,,2018,1,15,CASH_IN,1351025.72,M1325923139
15986,1196428',2018-01-15,FDRL/NATIONAL ELECTRONIC F,56794.0,0.0,,2018,1,15,PAYEMENT,56794.0,M1396188238
15987,1196428',2018-01-15,FDRL/NATIONAL ELECTRONIC F,56618.0,0.0,,2018,1,15,PAYEMENT,56618.0,M554850979
15988,1196428',2018-01-15,FDRL/NATIONAL ELECTRONIC F,66521.0,0.0,,2018,1,15,PAYEMENT,66521.0,M1055780232
15989,1196428',2018-01-15,FDRL/NATIONAL ELECTRONIC F,68171.0,0.0,,2018,1,15,CASH_OUT,68171.0,M662568271
15990,1196428',2018-01-15,FDRL/NATIONAL ELECTRONIC F,58659.0,0.0,,2018,1,15,PAYEMENT,58659.0,C1649449847
15991,1196428',2018-01-15,FDRL/NATIONAL ELECTRONIC F,94766.0,0.0,,2018,1,15,CASH_OUT,94766.0,C1198167820
15992,1196428',2018-01-15,FDRL/NATIONAL ELECTRONIC F,53458.0,0.0,,2018,1,15,CASH_OUT,53458.0,C749672494
15993,1196428',2018-01-15,FDRL/NATIONAL ELECTRONIC F,71392.0,0.0,,2018,1,15,CHECK_WITHDRAWAL,71392.0,C1423992712
15994,1196428',2018-01-15,FDRL/NATIONAL ELECTRONIC F,83116.0,0.0,,2018,1,15,CHECK_WITHDRAWAL,83116.0,C313124964
15995,1196428',2018-01-15,FDRL/NATIONAL ELECTRONIC F,61178.0,0.0,,2018,1,15,CASH_OUT,61178.0,C500153041
15996,1196428',2018-01-15,FDRL/NATIONAL ELECTRONIC F,90259.0,0.0,,2018,1,15,CASH_OUT,90259.0,C728526866
15997,1196428',2018-01-15,FDRL/NATIONAL ELECTRONIC F,58822.0,0.0,,2018,1,15,CASH_OUT,58822.0,C40075281
15998,1196428',2018-01-15,FDRL/NATIONAL ELECTRONIC F,58659.0,0.0,,2018,1,15,CASH_OUT,58659.0,C456538529
15999,1196428',2018-01-15,FDRL/NATIONAL ELECTRONIC F,90229.0,0.0,,2018,1,15,PAYEMENT,90229.0,C2117043942
16000,1196428',2018-01-15,FDRL/NATIONAL ELECTRONIC F,87085.0,0.0,,2018,1,15,DEBIT,87085.0,C1838584624
16001,1196428',2018-01-15,FDRL/NATIONAL ELECTRONIC F,79617.0,0.0,,2018,1,15,CASH_OUT,79617.0,M1733424208
16002,1196428',2018-01-15,FDRL/NATIONAL ELECTRONIC F,57017.0,0.0,,2018,1,15,DEBIT,57017.0,M1060393794
16003,1196428',2018-01-15,FDRL/NATIONAL ELECTRONIC F,74083.0,0.0,,2018,1,15,DEBIT,74083.0,M226593165
16004,1196428',2018-01-15,FDRL/NATIONAL ELECTRONIC F,54692.0,0.0,,2018,1,15,DEBIT,54692.0,M426584880
16005,1196428',2018-01-15,FDRL/NATIONAL ELECTRONIC F,90144.0,0.0,,2018,1,15,CASH_OUT,90144.0,C448155494
16006,1196428',2018-01-15,FDRL/NATIONAL ELECTRONIC F,59406.0,0.0,,2018,1,15,PAYEMENT,59406.0,M1594302764
16007,1196428',2018-01-15,FDRL/NATIONAL ELECTRONIC F,69661.0,0.0,,2018,1,15,DEBIT,69661.0,M271366306
16008,1196428',2018-01-15,FDRL/NATIONAL ELECTRONIC F,58565.0,0.0,,2018,1,15,CASH_OUT,58565.0,C348708793
16009,1196428',2018-01-15,BEAT CSH PKP DEL GURG 550,0.0,1000000.0,,2018,1,15,TRANSFER,1000000.0,M462659391
16010,1196428',2018-01-15,TRF FROM  Indiaforensic SERVICES,0.0,15000000.0,,2018,1,15,CHECK_CASHING,15000000.0,M547825235
16011,1196428',2018-01-15,TRF FROM  Indiaforensic SERVICES,0.0,15000000.0,,2018,1,15,CASH_IN,15000000.0,M1301971459
16012,1196428',2018-01-15,TRF FROM  Indiaforensic SERVICES,0.0,9900000.0,,2018,1,15,CHECK_CASHING,9900000.0,M1155771218
16013,1196428',2018-01-15,FDRL/INTERNAL FUND TRANSFE,10000000.0,0.0,,2018,1,15,CHECK_WITHDRAWAL,10000000.0,M734120998
16014,1196428',2018-01-15,FDRL/INTERNAL FUND TRANSFE,15000000.0,0.0,,2018,1,15,DEBIT,15000000.0,M1404561012
16015,1196428',2018-01-15,FDRL/INTERNAL FUND TRANSFE,15000000.0,0.0,,2018,1,15,DEBIT,15000000.0,M1376999853
16016,1196428',2018-01-16,FDRL/REAL TIME GROSS SETTL,2000000.0,0.0,,2018,1,16,CASH_OUT,2000000.0,M255307196
16017,1196428',2018-01-16,NEFT/N016180454084833/TEC,0.0,300000.0,,2018,1,16,TRANSFER,300000.0,M11285367
16018,1196428',2018-01-16,IB:TPFT0053880131 4090004,0.0,10000.0,,2018,1,16,CHECK_CASHING,10000.0,M714914851
16019,1196428',2018-01-16,RTGS/HDFCH18016658427/PAY,0.0,4560000.0,,2018,1,16,CHECK_CASHING,4560000.0,M1438724935
16020,1196428',2018-01-16,RTGS/HDFCH18016658431/PAY,0.0,4960000.0,,2018,1,16,TRANSFER,4960000.0,M662472677
16021,1196428',2018-01-16,FDRL/REAL TIME GROSS SETTL,10000000.0,0.0,,2018,1,16,CHECK_WITHDRAWAL,10000000.0,M1932384587
16022,1196428',2018-01-16,FDRL/INTERNAL FUND TRANSFE,200000.0,0.0,,2018,1,16,CHECK_WITHDRAWAL,200000.0,M719480872
16023,1196428',2018-01-16,NEFT/BARBS18016082710/MAK,0.0,130360.0,,2018,1,16,CHECK_CASHING,130360.0,M1278136570
16024,1196428',2018-01-16,NEFT/20399213311DC/EKO IN,0.0,1500000.0,,2018,1,16,CASH_IN,1500000.0,M148964727
16025,1196428',2018-01-16,CASHDEP/VIKASMARG/TP,0.0,71000.0,,2018,1,16,TRANSFER,71000.0,M1177742051
16026,1196428',2018-01-16,Indiaforensic SERVICES INDIA PVT,0.0,602103.0,,2018,1,16,CASH_IN,602103.0,M724365571
16027,1196428',2018-01-16,NEFT/N016180454468281/PAY,0.0,7420.24,,2018,1,16,TRANSFER,7420.24,M212535805
16028,1196428',2018-01-16,NEFT/N016180454488963/PAY,0.0,857469.49,,2018,1,16,CHECK_CASHING,857469.49,M1596397541
16029,1196428',2018-01-16,BEAT CSH PKP DEL GURG 550,0.0,310000.0,,2018,1,16,CHECK_CASHING,310000.0,M713285225
16030,1196428',2018-01-16,TRF FROM  Indiaforensic SERVICES,0.0,3100000.0,,2018,1,16,CASH_IN,3100000.0,C2032389005
16031,1196428',2018-01-16,TRF FROM  Indiaforensic SERVICES,0.0,11000000.0,,2018,1,16,CHECK_CASHING,11000000.0,M1156533869
16032,1196428',2018-01-16,2DFINE SERVICES DMCC/USD/,1927500.0,0.0,,2018,1,16,CASH_OUT,1927500.0,M105292474
16033,1196428',2018-01-16,ORTT00701801352,1451.95,0.0,,2018,1,16,DEBIT,1451.95,M1410438390
16034,1196428',2018-01-16,FDRL/INTERNAL FUND TRANSFE,15000000.0,0.0,,2018,1,16,DEBIT,15000000.0,M1257755465
16035,1196428',2018-01-16,FDRL/INTERNAL FUND TRANSFE,500000.0,0.0,,2018,1,16,PAYEMENT,500000.0,M1640401120
16036,1196428',2018-01-17,RTGS/HDFCH18017743061/PAY,0.0,3840000.0,,2018,1,17,TRANSFER,3840000.0,M1399060771
16037,1196428',2018-01-17,RTGS/HDFCH18017743082/PAY,0.0,5760000.0,,2018,1,17,CASH_IN,5760000.0,C1262822392
16038,1196428',2018-01-17,FDRL/REAL TIME GROSS SETTL,10000000.0,0.0,,2018,1,17,CASH_OUT,10000000.0,M148589770
16039,1196428',2018-01-17,NEFT/BARBS18017450005/MAK,0.0,110111.0,,2018,1,17,CASH_IN,110111.0,M984489239
16040,1196428',2018-01-17,"Indiaforensic USA, INC./USD/7329",0.0,4663600.5,,2018,1,17,CHECK_CASHING,4663600.5,C2115055717
16041,1196428',2018-01-17,IRTT00701801412,1944.45,0.0,,2018,1,17,CASH_OUT,1944.45,C1166654566
16042,1196428',2018-01-17,IMPS 801715801761 FROM SA,0.0,100000.0,,2018,1,17,TRANSFER,100000.0,M88042020
16043,1196428',2018-01-17,FDRL/REAL TIME GROSS SETTL,2000000.0,0.0,,2018,1,17,CASH_OUT,2000000.0,M717278894
16044,1196428',2018-01-17,FDRL/REAL TIME GROSS SETTL,2000000.0,0.0,,2018,1,17,CHECK_WITHDRAWAL,2000000.0,M129220812
16045,1196428',2018-01-17,RTGS/IDFBH18017300949/ART,0.0,10000000.0,,2018,1,17,CASH_IN,10000000.0,M1015272304
16046,1196428',2018-01-17,FDRL/REAL TIME GROSS SETTL,10000000.0,0.0,,2018,1,17,PAYEMENT,10000000.0,C1007717381
16047,1196428',2018-01-17,RTGS/IDFBH18017300947/ART,0.0,10000000.0,,2018,1,17,TRANSFER,10000000.0,C1240091493
16048,1196428',2018-01-17,RTGS/IDFBH18017300951/ART,0.0,10000000.0,,2018,1,17,CHECK_CASHING,10000000.0,C1396297158
16049,1196428',2018-01-17,FDRL/INTERNAL FUND TRANSFE,10000000.0,0.0,,2018,1,17,DEBIT,10000000.0,M705803524
16050,1196428',2018-01-17,FDRL/INTERNAL FUND TRANSFE,10000000.0,0.0,,2018,1,17,PAYEMENT,10000000.0,C978740207
16051,1196428',2018-01-17,IMPS 801715898330 FROM PA,0.0,48075.0,,2018,1,17,CHECK_CASHING,48075.0,C115885991
16052,1196428',2018-01-17,NEFT/AXISP18017057383/ACC,0.0,3000000.0,,2018,1,17,CASH_IN,3000000.0,C587433505
16053,1196428',2018-01-17,NEFT/N017180455136918/PAY,0.0,2683665.12,,2018,1,17,TRANSFER,2683665.12,C1637186972
16054,1196428',2018-01-17,NEFT/N017180455136958/PAY,0.0,4009299.0,,2018,1,17,TRANSFER,4009299.0,M190739308
16055,1196428',2018-01-17,TRF FROM  Indiaforensic SERVICES,0.0,3000000.0,,2018,1,17,CHECK_CASHING,3000000.0,C778306577
16056,1196428',2018-01-17,NEFT/FDRL656260003/Indiaforensic,0.0,1000000.0,,2018,1,17,TRANSFER,1000000.0,M1863711975
16057,1196428',2018-01-17,NEFT/FDRL656260021/Indiaforensic,0.0,2000000.0,,2018,1,17,TRANSFER,2000000.0,M1469855297
16058,1196428',2018-01-17,NEFT/SBIN518017688123/Indfor,0.0,5000000.0,,2018,1,17,CHECK_CASHING,5000000.0,M794421806
16059,1196428',2018-01-17,FDRL/NATIONAL ELECTRONIC F,2000000.0,0.0,,2018,1,17,DEBIT,2000000.0,M1334051844
16060,1196428',2018-01-17,FDRL/NATIONAL ELECTRONIC F,3000000.0,0.0,,2018,1,17,DEBIT,3000000.0,M515450283
16061,1196428',2018-01-17,IMPS 801717885351 FROM DA,0.0,35000.0,,2018,1,17,TRANSFER,35000.0,M1747790771
16062,1196428',2018-01-17,FDRL/INTERNAL FUND TRANSFE,300000.0,0.0,,2018,1,17,DEBIT,300000.0,M1284135884
16063,1196428',2018-01-17,IMPS 801718116646 FROM SA,0.0,200000.0,,2018,1,17,CASH_IN,200000.0,C420561530
16064,1196428',2018-01-17,YOURSELF FOR BULK NEFT  B,8311650.0,0.0,,2018,1,17,DEBIT,8311650.0,M694158341
16065,1196428',2018-01-17,TRF FROM  Indiaforensic SERVICES,0.0,10000000.0,,2018,1,17,CASH_IN,10000000.0,C2046578329
16066,1196428',2018-01-17,TRF FROM  Indiaforensic SERVICES,0.0,1000000.0,,2018,1,17,TRANSFER,1000000.0,M942812964
16067,1196428',2018-01-17,FDRL/INTERNAL FUND TRANSFE,5000000.0,0.0,,2018,1,17,DEBIT,5000000.0,M1977844832
16068,1196428',2018-01-17,BEAT CSH PKP DEL GURG 550,0.0,310500.0,,2018,1,17,TRANSFER,310500.0,M1171276229
16069,1196428',2018-01-18,FDRL/REAL TIME GROSS SETTL,10000000.0,0.0,,2018,1,18,CHECK_WITHDRAWAL,10000000.0,M1741253456
16070,1196428',2018-01-18,FDRL/REAL TIME GROSS SETTL,3000000.0,0.0,,2018,1,18,CHECK_WITHDRAWAL,3000000.0,M1549630173
16071,1196428',2018-01-18,FDRL/REAL TIME GROSS SETTL,1000000.0,0.0,,2018,1,18,DEBIT,1000000.0,C1548218207
16072,1196428',2018-01-18,RTGS/HDFCH18018846175/PAY,0.0,5040000.0,,2018,1,18,CHECK_CASHING,5040000.0,C242559404
16073,1196428',2018-01-18,RTGS/HDFCH18018845736/PAY,0.0,3520000.0,,2018,1,18,TRANSFER,3520000.0,C1153596299
16074,1196428',2018-01-18,FDRL/REAL TIME GROSS SETTL,3000000.0,0.0,,2018,1,18,CASH_OUT,3000000.0,M708011911
16075,1196428',2018-01-18,FDRL/REAL TIME GROSS SETTL,5000000.0,0.0,,2018,1,18,DEBIT,5000000.0,M1579526490
16076,1196428',2018-01-18,NEFT/N018180001661627/MAH,0.0,11800.0,,2018,1,18,CHECK_CASHING,11800.0,C1924874046
16077,1196428',2018-01-18,NEFT/20401251711DC/ARTHAS,0.0,225000.0,,2018,1,18,CHECK_CASHING,225000.0,C1079343872
16078,1196428',2018-01-18,FIXED   MOBILE PTE LTD/US,0.0,315835.23,,2018,1,18,CHECK_CASHING,315835.23,M1025387324
16079,1196428',2018-01-18,IRTT00701801570,669.25,0.0,,2018,1,18,CASH_OUT,669.25,M2114990234
16080,1196428',2018-01-18,NEFT/BARBT18018007253/MAK,0.0,50150.0,,2018,1,18,CASH_IN,50150.0,M1843420945
16081,1196428',2018-01-18,NEFT/BARBT18018071070/MAK,0.0,51650.0,,2018,1,18,TRANSFER,51650.0,C863811613
16082,1196428',2018-01-18,NEFT/N018180455785276/PAY,0.0,957679.96,,2018,1,18,CHECK_CASHING,957679.96,M1539382844
16083,1196428',2018-01-18,Indiaforensic SERVICES INDIA PVT,0.0,728895.0,,2018,1,18,TRANSFER,728895.0,M1846768700
16084,1196428',2018-01-18,Indiaforensic SERVICES INDIA PVT,0.0,655677.0,,2018,1,18,CASH_IN,655677.0,C1640747200
16085,1196428',2018-01-18,NEFT/N018180455785299/PAY,0.0,1240285.9,,2018,1,18,CASH_IN,1240285.9,M1099038981
16086,1196428',2018-01-18,NEFT/AXISP18018070462/ACC,0.0,4000000.0,,2018,1,18,CHECK_CASHING,4000000.0,C344610846
16087,1196428',2018-01-18,CASHDEP/SILVASSA/,0.0,60000.0,,2018,1,18,TRANSFER,60000.0,C1919277981
16088,1196428',2018-01-18,TRF FROM  Indiaforensic SERVICES,0.0,5000000.0,,2018,1,18,TRANSFER,5000000.0,C2104652067
16089,1196428',2018-01-18,"TRF FROM,  Indiaforensic SERVICE",0.0,3000000.0,,2018,1,18,CHECK_CASHING,3000000.0,C1092465037
16090,1196428',2018-01-18,TRF FROM  Indiaforensic SERVICES,0.0,500000.0,,2018,1,18,CHECK_CASHING,500000.0,M995633719
16091,1196428',2018-01-18,NEFT/IDFBH18018194709/ART,0.0,5000000.0,,2018,1,18,CASH_IN,5000000.0,M938465080
16092,1196428',2018-01-18,TRF FROM  Indiaforensic SERVICES,0.0,3000000.0,,2018,1,18,TRANSFER,3000000.0,M1834981639
16093,1196428',2018-01-18,BEAT CSH PKP DEL GURG 550,0.0,79000.0,,2018,1,18,CHECK_CASHING,79000.0,M1775303360
16094,1196428',2018-01-18,FDRL/INTERNAL FUND TRANSFE,5000000.0,0.0,,2018,1,18,PAYEMENT,5000000.0,M261084274
16095,1196428',2018-01-18,FDRL/INTERNAL FUND TRANSFE,5000000.0,0.0,,2018,1,18,PAYEMENT,5000000.0,M1007295516
16096,1196428',2018-01-18,FDRL/INTERNAL FUND TRANSFE,5000000.0,0.0,,2018,1,18,CHECK_WITHDRAWAL,5000000.0,M470234716
16097,1196428',2018-01-18,FDRL/INTERNAL FUND TRANSFE,5000000.0,0.0,,2018,1,18,CASH_OUT,5000000.0,M905290562
16098,1196428',2018-01-18,FDRL/INTERNAL FUND TRANSFE,5000000.0,0.0,,2018,1,18,CASH_OUT,5000000.0,M798935213
16099,1196428',2018-01-19,RTGS/HDFCH18019949463/PAY,0.0,5680000.0,,2018,1,19,TRANSFER,5680000.0,M1932154134
16100,1196428',2018-01-19,RTGS/HDFCH18019952268/PAY,0.0,3280000.0,,2018,1,19,CHECK_CASHING,3280000.0,M1426777731
16101,1196428',2018-01-19,FDRL/REAL TIME GROSS SETTL,3000000.0,0.0,,2018,1,19,DEBIT,3000000.0,M2001931511
16102,1196428',2018-01-19,FDRL/REAL TIME GROSS SETTL,3000000.0,0.0,,2018,1,19,CHECK_WITHDRAWAL,3000000.0,M1028639221
16103,1196428',2018-01-19,FDRL/REAL TIME GROSS SETTL,3000000.0,0.0,,2018,1,19,CHECK_WITHDRAWAL,3000000.0,M129965176
16104,1196428',2018-01-19,NEFT/N019180456264840/TEC,0.0,300000.0,,2018,1,19,CASH_IN,300000.0,M1666930496
16105,1196428',2018-01-19,NEFT/20402271751DC/ARTHAS,0.0,350000.0,,2018,1,19,CHECK_CASHING,350000.0,M1348049534
16106,1196428',2018-01-19,NEFT/20402251031DC/ARTHAS,0.0,500000.0,,2018,1,19,TRANSFER,500000.0,M149861385
16107,1196428',2018-01-19,CASHDEP/VIKASMARG/TP,0.0,78000.0,,2018,1,19,CHECK_CASHING,78000.0,M1803845616
16108,1196428',2018-01-19,RTGS/HDFCH18019006760/PAY,0.0,1489087.0,,2018,1,19,CHECK_CASHING,1489087.0,M396463835
16109,1196428',2018-01-19,RTGS/HDFCH18019005361/PAY,0.0,652648.88,,2018,1,19,CASH_IN,652648.88,M1022045468
16110,1196428',2018-01-19,NEFT/BARBT18019423390/MAK,0.0,85560.0,,2018,1,19,TRANSFER,85560.0,M1556446144
16111,1196428',2018-01-19,NEFT/IDFBH18019198912/FUN,0.0,39200.0,,2018,1,19,CASH_IN,39200.0,M141959252
16112,1196428',2018-01-19,IRTT00701801751,1518.48,0.0,,2018,1,19,PAYEMENT,1518.48,M1997459283
16113,1196428',2018-01-19,"Indiaforensic USA, INC./USD/3616",0.0,2297086.46,,2018,1,19,CHECK_CASHING,2297086.46,M539292855
16114,1196428',2018-01-19,NEFT/FDRL656260018/Indiaforensic,0.0,2000000.0,,2018,1,19,CASH_IN,2000000.0,M878266233
16115,1196428',2018-01-19,NEFT/FDRL656260019/Indiaforensic,0.0,2000000.0,,2018,1,19,TRANSFER,2000000.0,M1660780699
16116,1196428',2018-01-19,Indiaforensic SERVICES INDIA PVT,0.0,652388.0,,2018,1,19,CHECK_CASHING,652388.0,M1242431450
16117,1196428',2018-01-19,NEFT/AXISP18019058743/ACC,0.0,10000000.0,,2018,1,19,TRANSFER,10000000.0,M2075133206
16118,1196428',2018-01-19,FDRL/INTERNAL FUND TRANSFE,200000.0,0.0,,2018,1,19,DEBIT,200000.0,M1651383848
16119,1196428',2018-01-19,FDRL/INTERNAL FUND TRANSFE,300000.0,0.0,,2018,1,19,PAYEMENT,300000.0,M1364290623
16120,1196428',2018-01-19,FDRL/INTERNAL FUND TRANSFE,1000000.0,0.0,,2018,1,19,CASH_OUT,1000000.0,M1119145556
16121,1196428',2018-01-19,NEFT/AXISP18019058742/ACC,0.0,15000000.0,,2018,1,19,CASH_IN,15000000.0,M552762676
16122,1196428',2018-01-19,"Indiaforensic USA, INC./USD/1160",0.0,73732.75,,2018,1,19,CASH_IN,73732.75,M1549335447
16123,1196428',2018-01-19,IRTT00701801798,427.72,0.0,,2018,1,19,CASH_OUT,427.72,M1407332998
16124,1196428',2018-01-19,NEFT/IDFBH18019202627/FUN,0.0,44100.0,,2018,1,19,CASH_IN,44100.0,M575173490
16125,1196428',2018-01-19,YOURSELF FOR BULK NEFT  B,10803360.0,0.0,,2018,1,19,DEBIT,10803360.0,M1463959599
16126,1196428',2018-01-19,2DFINE SERVICES DMCC/USD/,639000.0,0.0,,2018,1,19,CASH_OUT,639000.0,C191614132
16127,1196428',2018-01-19,ORTT00701801766,960.1,0.0,,2018,1,19,DEBIT,960.1,C1885712019
16128,1196428',2018-01-19,TRF FROM  Indiaforensic SERVICES,0.0,2800000.0,,2018,1,19,CASH_IN,2800000.0,M1406881784
16129,1196428',2018-01-19,TRF FROM  Indiaforensic SERVICES,0.0,10000000.0,,2018,1,19,TRANSFER,10000000.0,C1161865950
16130,1196428',2018-01-19,BEAT CSH PKP DEL GURG 550,0.0,239500.0,,2018,1,19,CHECK_CASHING,239500.0,M1558051277
16131,1196428',2018-01-19,FDRL/INTERNAL FUND TRANSFE,5000000.0,0.0,,2018,1,19,CASH_OUT,5000000.0,M1173085824
16132,1196428',2018-01-19,FDRL/INTERNAL FUND TRANSFE,5000000.0,0.0,,2018,1,19,CASH_OUT,5000000.0,M569018137
16133,1196428',2018-01-19,FDRL/INTERNAL FUND TRANSFE,5000000.0,0.0,,2018,1,19,CASH_OUT,5000000.0,M1770271962
16134,1196428',2018-01-19,FDRL/INTERNAL FUND TRANSFE,5000000.0,0.0,,2018,1,19,CHECK_WITHDRAWAL,5000000.0,M1586738337
16135,1196428',2018-01-19,FDRL/INTERNAL FUND TRANSFE,5000000.0,0.0,,2018,1,19,CHECK_WITHDRAWAL,5000000.0,M1674738101
16136,1196428',2018-01-19,FDRL/INTERNAL FUND TRANSFE,3000000.0,0.0,,2018,1,19,CASH_OUT,3000000.0,C1590550415
16137,1196428',2018-01-20,FDRL/REAL TIME GROSS SETTL,3000000.0,0.0,,2018,1,20,DEBIT,3000000.0,C705321061
16138,1196428',2018-01-20,FDRL/REAL TIME GROSS SETTL,5000000.0,0.0,,2018,1,20,CASH_OUT,5000000.0,M873689156
16139,1196428',2018-01-20,RTGS/HDFCH18020066683/PAY,0.0,3360000.0,,2018,1,20,CASH_IN,3360000.0,M1538317866
16140,1196428',2018-01-20,RTGS/HDFCH18020066700/PAY,0.0,6320000.0,,2018,1,20,TRANSFER,6320000.0,C262828207
16141,1196428',2018-01-20,RTGS/ICICH18020659281/O I,0.0,1500000.0,,2018,1,20,CASH_IN,1500000.0,C1222590577
16142,1196428',2018-01-20,FDRL/REAL TIME GROSS SETTL,1000000.0,0.0,,2018,1,20,DEBIT,1000000.0,M2089852906
16143,1196428',2018-01-20,FDRL/REAL TIME GROSS SETTL,10000000.0,0.0,,2018,1,20,CHECK_WITHDRAWAL,10000000.0,M629502621
16144,1196428',2018-01-20,NEFT/20403479731DC/ARTHAS,0.0,50000.0,,2018,1,20,CASH_IN,50000.0,M511596806
16145,1196428',2018-01-20,NEFT/20403445791DC/ARTHAS,0.0,300000.0,,2018,1,20,CASH_IN,300000.0,M2079635991
16146,1196428',2018-01-20,NEFT/FDRL656260013/Indiaforensic,0.0,2000000.0,,2018,1,20,CASH_IN,2000000.0,M1044456366
16147,1196428',2018-01-20,NEFT/FDRL656260014/Indiaforensic,0.0,2000000.0,,2018,1,20,TRANSFER,2000000.0,C1689840534
16148,1196428',2018-01-20,FDRL/REAL TIME GROSS SETTL,5000000.0,0.0,,2018,1,20,DEBIT,5000000.0,M1092817314
16149,1196428',2018-01-20,NEFT/N020180457204101/PAY,0.0,790810.52,,2018,1,20,CHECK_CASHING,790810.52,C1475909248
16150,1196428',2018-01-20,NEFT/BARBT18020795164/MAK,0.0,90950.0,,2018,1,20,TRANSFER,90950.0,M2040472550
16151,1196428',2018-01-20,NEFT/N020180457204120/PAY,0.0,1636917.64,,2018,1,20,CHECK_CASHING,1636917.64,C979719862
16152,1196428',2018-01-20,IMPS 802017004690 FROM DA,0.0,20000.0,,2018,1,20,CASH_IN,20000.0,C985934102
16153,1196428',2018-01-20,TRF FROM  Indiaforensic SERVICES,0.0,2000000.0,,2018,1,20,TRANSFER,2000000.0,C731253803
16154,1196428',2018-01-20,TRF FROM  Indiaforensic SERVICES,0.0,2000000.0,,2018,1,20,TRANSFER,2000000.0,C1609562230
16155,1196428',2018-01-20,TRF FROM  Indiaforensic SERVICES,0.0,5000000.0,,2018,1,20,CHECK_CASHING,5000000.0,M1076923640
16156,1196428',2018-01-20,TRF FROM  Indiaforensic SERVICES,0.0,2000000.0,,2018,1,20,CHECK_CASHING,2000000.0,M1144262832
16157,1196428',2018-01-20,BEAT CSH PKP DEL GURG 550,0.0,216000.0,,2018,1,20,TRANSFER,216000.0,M942922351
16158,1196428',2018-01-20,FDRL/INTERNAL FUND TRANSFE,10000000.0,0.0,,2018,1,20,CHECK_WITHDRAWAL,10000000.0,M1582038853
16159,1196428',2018-01-20,FDRL/INTERNAL FUND TRANSFE,3000000.0,0.0,,2018,1,20,DEBIT,3000000.0,M36034212
16160,1196428',2018-01-20,FDRL/INTERNAL FUND TRANSFE,500000.0,0.0,,2018,1,20,DEBIT,500000.0,M1326356346
16161,1196428',2018-01-22,RTGS/HDFCH18022151942/PAY,0.0,4800000.0,,2018,1,22,TRANSFER,4800000.0,C27489818
16162,1196428',2018-01-22,RTGS/HDFCH18022154368/PAY,0.0,3680000.0,,2018,1,22,CASH_IN,3680000.0,C747979499
16163,1196428',2018-01-22,FDRL/INTERNAL FUND TRANSFE,500000.0,0.0,,2018,1,22,DEBIT,500000.0,C1660095722
16164,1196428',2018-01-22,FDRL/REAL TIME GROSS SETTL,2000000.0,0.0,,2018,1,22,CASH_OUT,2000000.0,C372017580
16165,1196428',2018-01-22,FDRL/REAL TIME GROSS SETTL,5000000.0,0.0,,2018,1,22,CASH_OUT,5000000.0,M370179552
16166,1196428',2018-01-22,FDRL/INTERNAL FUND TRANSFE,500000.0,0.0,,2018,1,22,PAYEMENT,500000.0,C802935635
16167,1196428',2018-01-22,IB:TPFT0054349531 4090004,0.0,10000.0,,2018,1,22,CASH_IN,10000.0,M1523086740
16168,1196428',2018-01-22,IMPS 802213095888 FROM SA,0.0,15000.0,,2018,1,22,CASH_IN,15000.0,M902885640
16169,1196428',2018-01-22,CASHDEP/HAUS KHAS/ZAHER,0.0,50000.0,,2018,1,22,CASH_IN,50000.0,C459172227
16170,1196428',2018-01-22,NEFT/BARBU18022079883/MAK,0.0,116004.0,,2018,1,22,CASH_IN,116004.0,C265108079
16171,1196428',2018-01-22,NEFT/FDRL656260402/Indiaforensic,0.0,3000000.0,,2018,1,22,TRANSFER,3000000.0,C35126588
16172,1196428',2018-01-22,Indiaforensic SERVICES INDIA PVT,0.0,1495750.0,,2018,1,22,TRANSFER,1495750.0,C1589477624
16173,1196428',2018-01-22,NEFT/N022180457844043/PAY,0.0,984961.26,,2018,1,22,CHECK_CASHING,984961.26,C1283595719
16174,1196428',2018-01-22,NEFT/N022180457843946/PAY,0.0,1117851.84,,2018,1,22,CHECK_CASHING,1117851.84,C101084405
16175,1196428',2018-01-22,NEFT/IT36701801223221/FIX,0.0,65000.0,,2018,1,22,CHECK_CASHING,65000.0,M7891579
16176,1196428',2018-01-22,NEFT/FDRL656260005/Indiaforensic,0.0,1000000.0,,2018,1,22,CASH_IN,1000000.0,M150228660
16177,1196428',2018-01-22,NEFT/FDRL656260006/Indiaforensic,0.0,1000000.0,,2018,1,22,TRANSFER,1000000.0,M190019040
16178,1196428',2018-01-22,NEFT/FDRL656260012/Indiaforensic,0.0,2000000.0,,2018,1,22,CASH_IN,2000000.0,M1462909495
16179,1196428',2018-01-22,NEFT/FDRL656260008/Indiaforensic,0.0,2000000.0,,2018,1,22,CASH_IN,2000000.0,C1192983708
16180,1196428',2018-01-22,NEFT/FDRL656260007/Indiaforensic,0.0,2000000.0,,2018,1,22,CASH_IN,2000000.0,M1730398598
16181,1196428',2018-01-22,TRF FROM  Indiaforensic SERVICES,0.0,13000000.0,,2018,1,22,TRANSFER,13000000.0,M1492635498
16182,1196428',2018-01-22,BEAT CSH PKP DEL GURG 550,0.0,329400.0,,2018,1,22,TRANSFER,329400.0,M738483886
16183,1196428',2018-01-22,TRF FROM  Indiaforensic SERVICES,0.0,5400000.0,,2018,1,22,CASH_IN,5400000.0,M1583014678
16184,1196428',2018-01-22,FDRL/INTERNAL FUND TRANSFE,15000000.0,0.0,,2018,1,22,CASH_OUT,15000000.0,C395114097
16185,1196428',2018-01-22,FDRL/INTERNAL FUND TRANSFE,10000000.0,0.0,,2018,1,22,DEBIT,10000000.0,M743943553
16186,1196428',2018-01-22,FDRL/INTERNAL FUND TRANSFE,2000000.0,0.0,,2018,1,22,DEBIT,2000000.0,M2034445578
16187,1196428',2018-01-22,FDRL/INTERNAL FUND TRANSFE,2000000.0,0.0,,2018,1,22,CASH_OUT,2000000.0,C1383942363
16188,1196428',2018-01-23,FDRL/REAL TIME GROSS SETTL,5000000.0,0.0,,2018,1,23,DEBIT,5000000.0,M72285092
16189,1196428',2018-01-23,TRF FROM  Indiaforensic ONLINE S,0.0,33570.0,,2018,1,23,TRANSFER,33570.0,M586185216
16190,1196428',2018-01-23,RTGS/HDFCH18023243631/PAY,0.0,5360000.0,,2018,1,23,CHECK_CASHING,5360000.0,M1378755468
16191,1196428',2018-01-23,RTGS/HDFCH18023245061/PAY,0.0,3520000.0,,2018,1,23,TRANSFER,3520000.0,C765980478
16192,1196428',2018-01-23,FDRL/REAL TIME GROSS SETTL,3000000.0,0.0,,2018,1,23,PAYEMENT,3000000.0,C1200314947
16193,1196428',2018-01-23,FDRL/REAL TIME GROSS SETTL,3000000.0,0.0,,2018,1,23,CHECK_WITHDRAWAL,3000000.0,C1973491942
16194,1196428',2018-01-23,FDRL/REAL TIME GROSS SETTL,3000000.0,0.0,,2018,1,23,CHECK_WITHDRAWAL,3000000.0,C1689374891
16195,1196428',2018-01-23,FDRL/INTERNAL FUND TRANSFE,300000.0,0.0,,2018,1,23,CASH_OUT,300000.0,C2053639017
16196,1196428',2018-01-23,NEFT/20405654681DC/ARTHAS,0.0,75000.0,,2018,1,23,TRANSFER,75000.0,C1654056127
16197,1196428',2018-01-23,CASHDEP/VIKASMARG/TP,0.0,104000.0,,2018,1,23,CASH_IN,104000.0,C803368825
16198,1196428',2018-01-23,"Indiaforensic USA, INC./USD/5702",0.0,3621889.56,,2018,1,23,CASH_IN,3621889.56,C892686452
16199,1196428',2018-01-23,IRTT00701802046,1756.94,0.0,,2018,1,23,DEBIT,1756.94,C2031563133
16200,1196428',2018-01-23,TRF FROM  Indiaforensic SERVICES,0.0,3000000.0,,2018,1,23,TRANSFER,3000000.0,C1619402333
16201,1196428',2018-01-23,FDRL/INTERNAL FUND TRANSFE,1000000.0,0.0,,2018,1,23,CASH_OUT,1000000.0,C1149273771
16202,1196428',2018-01-23,FDRL/NATIONAL ELECTRONIC F,1250.0,0.0,,2018,1,23,DEBIT,1250.0,C2109470512
16203,1196428',2018-01-23,FDRL/NATIONAL ELECTRONIC F,1250.0,0.0,,2018,1,23,DEBIT,1250.0,C1059781259
16204,1196428',2018-01-23,FDRL/NATIONAL ELECTRONIC F,1250.0,0.0,,2018,1,23,CASH_OUT,1250.0,C125722707
16205,1196428',2018-01-23,FDRL/NATIONAL ELECTRONIC F,1250.0,0.0,,2018,1,23,CHECK_WITHDRAWAL,1250.0,C1778300121
16206,1196428',2018-01-23,FDRL/NATIONAL ELECTRONIC F,1250.0,0.0,,2018,1,23,CHECK_WITHDRAWAL,1250.0,C313124964
16207,1196428',2018-01-23,FDRL/NATIONAL ELECTRONIC F,1250.0,0.0,,2018,1,23,DEBIT,1250.0,C1220897602
16208,1196428',2018-01-23,FDRL/NATIONAL ELECTRONIC F,1250.0,0.0,,2018,1,23,PAYEMENT,1250.0,C1515704208
16209,1196428',2018-01-23,FDRL/NATIONAL ELECTRONIC F,1250.0,0.0,,2018,1,23,CASH_OUT,1250.0,C1313534832
16210,1196428',2018-01-23,FDRL/NATIONAL ELECTRONIC F,1250.0,0.0,,2018,1,23,CHECK_WITHDRAWAL,1250.0,C1141137903
16211,1196428',2018-01-23,FDRL/NATIONAL ELECTRONIC F,1250.0,0.0,,2018,1,23,PAYEMENT,1250.0,C1869228744
16212,1196428',2018-01-23,FDRL/NATIONAL ELECTRONIC F,1250.0,0.0,,2018,1,23,CHECK_WITHDRAWAL,1250.0,C2078250226
16213,1196428',2018-01-23,FDRL/NATIONAL ELECTRONIC F,1250.0,0.0,,2018,1,23,CHECK_WITHDRAWAL,1250.0,C1300519073
16214,1196428',2018-01-23,FDRL/NATIONAL ELECTRONIC F,1250.0,0.0,,2018,1,23,PAYEMENT,1250.0,M1808484670
16215,1196428',2018-01-23,FDRL/NATIONAL ELECTRONIC F,1250.0,0.0,,2018,1,23,CASH_OUT,1250.0,M829035073
16216,1196428',2018-01-23,FDRL/NATIONAL ELECTRONIC F,1250.0,0.0,,2018,1,23,CHECK_WITHDRAWAL,1250.0,M1674174327
16217,1196428',2018-01-23,FDRL/NATIONAL ELECTRONIC F,1250.0,0.0,,2018,1,23,CASH_OUT,1250.0,M2135203084
16218,1196428',2018-01-23,FDRL/NATIONAL ELECTRONIC F,1250.0,0.0,,2018,1,23,DEBIT,1250.0,C1673971173
16219,1196428',2018-01-23,FDRL/NATIONAL ELECTRONIC F,1250.0,0.0,,2018,1,23,PAYEMENT,1250.0,C339099861
16220,1196428',2018-01-23,FDRL/NATIONAL ELECTRONIC F,605.0,0.0,,2018,1,23,CHECK_WITHDRAWAL,605.0,M2045422556
16221,1196428',2018-01-23,FDRL/NATIONAL ELECTRONIC F,1250.0,0.0,,2018,1,23,DEBIT,1250.0,C1266035080
16222,1196428',2018-01-23,FDRL/NATIONAL ELECTRONIC F,1250.0,0.0,,2018,1,23,CHECK_WITHDRAWAL,1250.0,C1060041730
16223,1196428',2018-01-23,FDRL/NATIONAL ELECTRONIC F,806.0,0.0,,2018,1,23,DEBIT,806.0,C1475395523
16224,1196428',2018-01-23,FDRL/NATIONAL ELECTRONIC F,1250.0,0.0,,2018,1,23,DEBIT,1250.0,C265845794
16225,1196428',2018-01-23,FDRL/NATIONAL ELECTRONIC F,1250.0,0.0,,2018,1,23,PAYEMENT,1250.0,C58091972
16226,1196428',2018-01-23,FDRL/NATIONAL ELECTRONIC F,1250.0,0.0,,2018,1,23,CASH_OUT,1250.0,C193864812
16227,1196428',2018-01-23,FDRL/NATIONAL ELECTRONIC F,1250.0,0.0,,2018,1,23,PAYEMENT,1250.0,C681835572
16228,1196428',2018-01-23,FDRL/NATIONAL ELECTRONIC F,1250.0,0.0,,2018,1,23,CASH_OUT,1250.0,C965197768
16229,1196428',2018-01-23,FDRL/NATIONAL ELECTRONIC F,1250.0,0.0,,2018,1,23,CHECK_WITHDRAWAL,1250.0,C893038039
16230,1196428',2018-01-23,FDRL/NATIONAL ELECTRONIC F,1250.0,0.0,,2018,1,23,CASH_OUT,1250.0,C1317731757
16231,1196428',2018-01-23,FDRL/NATIONAL ELECTRONIC F,1250.0,0.0,,2018,1,23,DEBIT,1250.0,C1373467808
16232,1196428',2018-01-23,FDRL/NATIONAL ELECTRONIC F,1250.0,0.0,,2018,1,23,PAYEMENT,1250.0,C1318822808
16233,1196428',2018-01-23,FDRL/NATIONAL ELECTRONIC F,1250.0,0.0,,2018,1,23,CASH_OUT,1250.0,C1424731356
16234,1196428',2018-01-23,FDRL/NATIONAL ELECTRONIC F,1250.0,0.0,,2018,1,23,CHECK_WITHDRAWAL,1250.0,C1439007204
16235,1196428',2018-01-23,FDRL/NATIONAL ELECTRONIC F,1250.0,0.0,,2018,1,23,CHECK_WITHDRAWAL,1250.0,C1116292004
16236,1196428',2018-01-23,FDRL/NATIONAL ELECTRONIC F,1250.0,0.0,,2018,1,23,CASH_OUT,1250.0,C638551812
16237,1196428',2018-01-23,FDRL/NATIONAL ELECTRONIC F,1250.0,0.0,,2018,1,23,PAYEMENT,1250.0,C193826743
16238,1196428',2018-01-23,FDRL/NATIONAL ELECTRONIC F,1250.0,0.0,,2018,1,23,PAYEMENT,1250.0,C309167705
16239,1196428',2018-01-23,FDRL/NATIONAL ELECTRONIC F,1250.0,0.0,,2018,1,23,PAYEMENT,1250.0,C811597470
16240,1196428',2018-01-23,FDRL/NATIONAL ELECTRONIC F,1250.0,0.0,,2018,1,23,CHECK_WITHDRAWAL,1250.0,C1014923261
16241,1196428',2018-01-23,FDRL/NATIONAL ELECTRONIC F,1129.0,0.0,,2018,1,23,PAYEMENT,1129.0,C925574515
16242,1196428',2018-01-23,FDRL/NATIONAL ELECTRONIC F,1129.0,0.0,,2018,1,23,CASH_OUT,1129.0,C1988152146
16243,1196428',2018-01-23,FDRL/NATIONAL ELECTRONIC F,1129.0,0.0,,2018,1,23,DEBIT,1129.0,C71555810
16244,1196428',2018-01-23,FDRL/NATIONAL ELECTRONIC F,927.0,0.0,,2018,1,23,DEBIT,927.0,C1273939873
16245,1196428',2018-01-23,FDRL/NATIONAL ELECTRONIC F,1129.0,0.0,,2018,1,23,CHECK_WITHDRAWAL,1129.0,C749672494
16246,1196428',2018-01-23,FDRL/NATIONAL ELECTRONIC F,565.0,0.0,,2018,1,23,DEBIT,565.0,C1504109395
16247,1196428',2018-01-23,FDRL/NATIONAL ELECTRONIC F,565.0,0.0,,2018,1,23,CASH_OUT,565.0,C2107268831
16248,1196428',2018-01-23,FDRL/NATIONAL ELECTRONIC F,321545.0,0.0,,2018,1,23,DEBIT,321545.0,C1141137903
16249,1196428',2018-01-23,FDRL/NATIONAL ELECTRONIC F,72661.0,0.0,,2018,1,23,CASH_OUT,72661.0,M492166970
16250,1196428',2018-01-23,FDRL/NATIONAL ELECTRONIC F,1129.0,0.0,,2018,1,23,PAYEMENT,1129.0,C762570948
16251,1196428',2018-01-23,FDRL/NATIONAL ELECTRONIC F,565.0,0.0,,2018,1,23,DEBIT,565.0,C1440282299
16252,1196428',2018-01-23,FDRL/NATIONAL ELECTRONIC F,1250.0,0.0,,2018,1,23,CHECK_WITHDRAWAL,1250.0,M1583639547
16253,1196428',2018-01-23,FDRL/NATIONAL ELECTRONIC F,1250.0,0.0,,2018,1,23,CASH_OUT,1250.0,M1476691574
16254,1196428',2018-01-23,FDRL/NATIONAL ELECTRONIC F,1250.0,0.0,,2018,1,23,CHECK_WITHDRAWAL,1250.0,C893339434
16255,1196428',2018-01-23,FDRL/NATIONAL ELECTRONIC F,1250.0,0.0,,2018,1,23,PAYEMENT,1250.0,M722806861
16256,1196428',2018-01-23,FDRL/NATIONAL ELECTRONIC F,1250.0,0.0,,2018,1,23,CHECK_WITHDRAWAL,1250.0,C1150610696
16257,1196428',2018-01-23,FDRL/NATIONAL ELECTRONIC F,1250.0,0.0,,2018,1,23,DEBIT,1250.0,C1674899618
16258,1196428',2018-01-23,FDRL/NATIONAL ELECTRONIC F,1250.0,0.0,,2018,1,23,CHECK_WITHDRAWAL,1250.0,M481126602
16259,1196428',2018-01-23,FDRL/NATIONAL ELECTRONIC F,1250.0,0.0,,2018,1,23,PAYEMENT,1250.0,C1793325972
16260,1196428',2018-01-23,FDRL/NATIONAL ELECTRONIC F,1250.0,0.0,,2018,1,23,PAYEMENT,1250.0,M132360639
16261,1196428',2018-01-23,FDRL/NATIONAL ELECTRONIC F,1250.0,0.0,,2018,1,23,PAYEMENT,1250.0,M2052092920
16262,1196428',2018-01-23,FDRL/NATIONAL ELECTRONIC F,1250.0,0.0,,2018,1,23,CASH_OUT,1250.0,M236650472
16263,1196428',2018-01-23,FDRL/NATIONAL ELECTRONIC F,1250.0,0.0,,2018,1,23,PAYEMENT,1250.0,M2089634452
16264,1196428',2018-01-23,FDRL/NATIONAL ELECTRONIC F,1250.0,0.0,,2018,1,23,PAYEMENT,1250.0,M1097809105
16265,1196428',2018-01-23,FDRL/NATIONAL ELECTRONIC F,1250.0,0.0,,2018,1,23,DEBIT,1250.0,C302025300
16266,1196428',2018-01-23,FDRL/NATIONAL ELECTRONIC F,1250.0,0.0,,2018,1,23,DEBIT,1250.0,M134742492
16267,1196428',2018-01-23,FDRL/NATIONAL ELECTRONIC F,1250.0,0.0,,2018,1,23,DEBIT,1250.0,C1511785794
16268,1196428',2018-01-23,FDRL/NATIONAL ELECTRONIC F,1250.0,0.0,,2018,1,23,CASH_OUT,1250.0,M1604293868
16269,1196428',2018-01-23,FDRL/NATIONAL ELECTRONIC F,1250.0,0.0,,2018,1,23,CHECK_WITHDRAWAL,1250.0,M1853641629
16270,1196428',2018-01-23,FDRL/NATIONAL ELECTRONIC F,1250.0,0.0,,2018,1,23,CASH_OUT,1250.0,M710600916
16271,1196428',2018-01-23,FDRL/NATIONAL ELECTRONIC F,1250.0,0.0,,2018,1,23,CHECK_WITHDRAWAL,1250.0,M985323561
16272,1196428',2018-01-23,FDRL/NATIONAL ELECTRONIC F,1250.0,0.0,,2018,1,23,DEBIT,1250.0,M1194715097
16273,1196428',2018-01-23,FDRL/NATIONAL ELECTRONIC F,1250.0,0.0,,2018,1,23,CHECK_WITHDRAWAL,1250.0,M693684695
16274,1196428',2018-01-23,FDRL/INTERNAL FUND TRANSFE,1250.0,0.0,,2018,1,23,PAYEMENT,1250.0,M1582319135
16275,1196428',2018-01-23,FDRL/NATIONAL ELECTRONIC F,57755.0,0.0,,2018,1,23,PAYEMENT,57755.0,M227290600
16276,1196428',2018-01-23,FDRL/NATIONAL ELECTRONIC F,1250.0,0.0,,2018,1,23,CHECK_WITHDRAWAL,1250.0,M2089806029
16277,1196428',2018-01-23,NEFT/FDRL656260407/Indiaforensic,0.0,3000000.0,,2018,1,23,TRANSFER,3000000.0,M1477278751
16278,1196428',2018-01-23,NEFT/FDRL656260408/Indiaforensic,0.0,3000000.0,,2018,1,23,CASH_IN,3000000.0,M1650385017
16279,1196428',2018-01-23,NEFT/BARBU18023462522/MAK,0.0,82222.0,,2018,1,23,CHECK_CASHING,82222.0,M1921059756
16280,1196428',2018-01-23,Indiaforensic SERVICES INDIA PVT,0.0,617982.32,,2018,1,23,TRANSFER,617982.32,M590434145
16281,1196428',2018-01-23,NEFT/N023180458568813/PAY,0.0,537075.8,,2018,1,23,CASH_IN,537075.8,M1671621366
16282,1196428',2018-01-23,NEFT/N023180458543380/PAY,0.0,1314170.22,,2018,1,23,CASH_IN,1314170.22,M899686935
16283,1196428',2018-01-23,FDRL/NATIONAL ELECTRONIC F,3000.0,0.0,,2018,1,23,CHECK_WITHDRAWAL,3000.0,M2054039573
16284,1196428',2018-01-23,FDRL/NATIONAL ELECTRONIC F,2500.0,0.0,,2018,1,23,CHECK_WITHDRAWAL,2500.0,M1271480561
16285,1196428',2018-01-23,FDRL/NATIONAL ELECTRONIC F,2500.0,0.0,,2018,1,23,PAYEMENT,2500.0,C1259769769
16286,1196428',2018-01-23,FDRL/NATIONAL ELECTRONIC F,2500.0,0.0,,2018,1,23,DEBIT,2500.0,M649539827
16287,1196428',2018-01-23,FDRL/NATIONAL ELECTRONIC F,2000.0,0.0,,2018,1,23,CASH_OUT,2000.0,C893350828
16288,1196428',2018-01-23,FDRL/NATIONAL ELECTRONIC F,5000.0,0.0,,2018,1,23,DEBIT,5000.0,M20364107
16289,1196428',2018-01-23,FDRL/NATIONAL ELECTRONIC F,3000.0,0.0,,2018,1,23,CHECK_WITHDRAWAL,3000.0,M2023197227
16290,1196428',2018-01-23,FDRL/NATIONAL ELECTRONIC F,27360.0,0.0,,2018,1,23,DEBIT,27360.0,C232812328
16291,1196428',2018-01-23,FDRL/NATIONAL ELECTRONIC F,132747.0,0.0,,2018,1,23,CHECK_WITHDRAWAL,132747.0,M902890505
16292,1196428',2018-01-23,FDRL/NATIONAL ELECTRONIC F,134100.0,0.0,,2018,1,23,PAYEMENT,134100.0,M1465861273
16293,1196428',2018-01-23,FDRL/NATIONAL ELECTRONIC F,144243.0,0.0,,2018,1,23,PAYEMENT,144243.0,M949506330
16294,1196428',2018-01-23,FDRL/NATIONAL ELECTRONIC F,111313.0,0.0,,2018,1,23,CHECK_WITHDRAWAL,111313.0,M2084969506
16295,1196428',2018-01-23,FDRL/NATIONAL ELECTRONIC F,103395.0,0.0,,2018,1,23,CHECK_WITHDRAWAL,103395.0,M608038618
16296,1196428',2018-01-23,FDRL/NATIONAL ELECTRONIC F,102530.0,0.0,,2018,1,23,PAYEMENT,102530.0,M1041764081
16297,1196428',2018-01-23,FDRL/NATIONAL ELECTRONIC F,103387.0,0.0,,2018,1,23,PAYEMENT,103387.0,M277788688
16298,1196428',2018-01-23,FDRL/NATIONAL ELECTRONIC F,157344.0,0.0,,2018,1,23,CASH_OUT,157344.0,M31440957
16299,1196428',2018-01-23,FDRL/NATIONAL ELECTRONIC F,145068.0,0.0,,2018,1,23,PAYEMENT,145068.0,C1805162633
16300,1196428',2018-01-23,FDRL/NATIONAL ELECTRONIC F,219075.0,0.0,,2018,1,23,PAYEMENT,219075.0,M1201023997
16301,1196428',2018-01-23,FDRL/NATIONAL ELECTRONIC F,135081.0,0.0,,2018,1,23,PAYEMENT,135081.0,M1412743565
16302,1196428',2018-01-23,FDRL/NATIONAL ELECTRONIC F,2500.0,0.0,,2018,1,23,CHECK_WITHDRAWAL,2500.0,M1887477561
16303,1196428',2018-01-23,FDRL/NATIONAL ELECTRONIC F,2500.0,0.0,,2018,1,23,CHECK_WITHDRAWAL,2500.0,C435161028
16304,1196428',2018-01-23,FDRL/NATIONAL ELECTRONIC F,2000.0,0.0,,2018,1,23,CHECK_WITHDRAWAL,2000.0,M2126024846
16305,1196428',2018-01-23,FDRL/NATIONAL ELECTRONIC F,2500.0,0.0,,2018,1,23,PAYEMENT,2500.0,M885738476
16306,1196428',2018-01-23,FDRL/NATIONAL ELECTRONIC F,2000.0,0.0,,2018,1,23,DEBIT,2000.0,C1273939873
16307,1196428',2018-01-23,FDRL/INTERNAL FUND TRANSFE,500000.0,0.0,,2018,1,23,PAYEMENT,500000.0,C464094472
16308,1196428',2018-01-23,FDRL/INTERNAL FUND TRANSFE,500000.0,0.0,,2018,1,23,DEBIT,500000.0,C1475998599
16309,1196428',2018-01-23,TRF FROM  Indiaforensic SERVICES,0.0,7400000.0,,2018,1,23,CASH_IN,7400000.0,C1789550256
16310,1196428',2018-01-23,NEFT/IOBAN18023635027/K A,0.0,2500.0,,2018,1,23,TRANSFER,2500.0,C1805445027
16311,1196428',2018-01-23,BEAT CSH PKP DEL GURG 550,0.0,141000.0,,2018,1,23,CASH_IN,141000.0,C968448640
16312,1196428',2018-01-23,FDRL/INTERNAL FUND TRANSFE,15000000.0,0.0,,2018,1,23,CHECK_WITHDRAWAL,15000000.0,C691636444
16313,1196428',2018-01-23,FDRL/INTERNAL FUND TRANSFE,3000000.0,0.0,,2018,1,23,DEBIT,3000000.0,C1778801068
16314,1196428',2018-01-23,FDRL/INTERNAL FUND TRANSFE,500000.0,0.0,,2018,1,23,DEBIT,500000.0,C2029896123
16315,1196428',2018-01-24,RTGS/HDFCH18024356363/PAY,0.0,2720000.0,,2018,1,24,TRANSFER,2720000.0,C1677727024
16316,1196428',2018-01-24,RTGS/HDFCH18024353615/PAY,0.0,4640000.0,,2018,1,24,CASH_IN,4640000.0,C1525944481
16317,1196428',2018-01-24,FDRL/REAL TIME GROSS SETTL,2000000.0,0.0,,2018,1,24,PAYEMENT,2000000.0,C481402298
16318,1196428',2018-01-24,FDRL/REAL TIME GROSS SETTL,5000000.0,0.0,,2018,1,24,CHECK_WITHDRAWAL,5000000.0,C177457290
16319,1196428',2018-01-24,NEFT/FDRL656260404/Indiaforensic,0.0,3000000.0,,2018,1,24,CASH_IN,3000000.0,M1138171728
16320,1196428',2018-01-24,NEFT/FDRL656260406/Indiaforensic,0.0,3000000.0,,2018,1,24,TRANSFER,3000000.0,C1452722471
16321,1196428',2018-01-24,FDRL/REAL TIME GROSS SETTL,3000000.0,0.0,,2018,1,24,CHECK_WITHDRAWAL,3000000.0,C861958315
16322,1196428',2018-01-24,FDRL/REAL TIME GROSS SETTL,3000000.0,0.0,,2018,1,24,PAYEMENT,3000000.0,M919438675
16323,1196428',2018-01-24,NEFT/20406762841DC/ARTHAS,0.0,75000.0,,2018,1,24,TRANSFER,75000.0,M1501022601
16324,1196428',2018-01-24,RTGS/IDFBH18024300721/ART,0.0,10000000.0,,2018,1,24,CASH_IN,10000000.0,M397708705
16325,1196428',2018-01-24,RTGS/IDFBH18024300673/ART,0.0,10000000.0,,2018,1,24,CHECK_CASHING,10000000.0,M1092898377
16326,1196428',2018-01-24,RTGS/IDFBH18024300724/ART,0.0,10000000.0,,2018,1,24,TRANSFER,10000000.0,M1957947378
16327,1196428',2018-01-24,FDRL/REAL TIME GROSS SETTL,10000000.0,0.0,,2018,1,24,PAYEMENT,10000000.0,C785703145
16328,1196428',2018-01-24,FDRL/REAL TIME GROSS SETTL,10000000.0,0.0,,2018,1,24,PAYEMENT,10000000.0,M2094125621
16329,1196428',2018-01-24,FDRL/REAL TIME GROSS SETTL,10000000.0,0.0,,2018,1,24,DEBIT,10000000.0,M1918034019
16330,1196428',2018-01-24,IB:TPFT0054527051 4090004,0.0,10000.0,,2018,1,24,CASH_IN,10000.0,M745483242
16331,1196428',2018-01-24,NEFT/BARBU18024763700/MAK,0.0,90999.0,,2018,1,24,CHECK_CASHING,90999.0,M1878714361
16332,1196428',2018-01-24,Indiaforensic SERVICES INDIA PVT,0.0,708357.37,,2018,1,24,CHECK_CASHING,708357.37,M203939387
16333,1196428',2018-01-24,NEFT/N024180459173589/PAY,0.0,1.0,,2018,1,24,CHECK_CASHING,1.0,C382934088
16334,1196428',2018-01-24,NEFT/N024180459173616/PAY,0.0,1226874.88,,2018,1,24,TRANSFER,1226874.88,C158876320
16335,1196428',2018-01-24,TRF FROM  Indiaforensic SERVICES,0.0,2700000.0,,2018,1,24,CASH_IN,2700000.0,C732929236
16336,1196428',2018-01-24,TRF FROM  Indiaforensic SERVICES,0.0,7400000.0,,2018,1,24,TRANSFER,7400000.0,C1554622120
16337,1196428',2018-01-24,BEAT CSH PKP DEL GURG 550,0.0,186000.0,,2018,1,24,CHECK_CASHING,186000.0,C1359484306
16338,1196428',2018-01-24,FDRL/INTERNAL FUND TRANSFE,6000000.0,0.0,,2018,1,24,CHECK_WITHDRAWAL,6000000.0,C1782704802
16339,1196428',2018-01-24,FDRL/INTERNAL FUND TRANSFE,7000000.0,0.0,,2018,1,24,CASH_OUT,7000000.0,C1609562230
16340,1196428',2018-01-25,IMPS 802510163827 FROM DA,0.0,10000.0,,2018,1,25,CHECK_CASHING,10000.0,C1220897602
16341,1196428',2018-01-25,NEFT/20407772161DC/ARTHAS,0.0,25000.0,,2018,1,25,CASH_IN,25000.0,C1213257323
16342,1196428',2018-01-25,RTGS/HDFCH18025467705/PAY,0.0,4400000.0,,2018,1,25,CHECK_CASHING,4400000.0,C674913323
16343,1196428',2018-01-25,FDRL/REAL TIME GROSS SETTL,1000000.0,0.0,,2018,1,25,CHECK_WITHDRAWAL,1000000.0,C803116137
16344,1196428',2018-01-25,FDRL/REAL TIME GROSS SETTL,3000000.0,0.0,,2018,1,25,DEBIT,3000000.0,C1450417897
16345,1196428',2018-01-25,RTGS/ICICH18025422534/O I,0.0,2500000.0,,2018,1,25,TRANSFER,2500000.0,C826383690
16346,1196428',2018-01-25,FDRL/REAL TIME GROSS SETTL,3000000.0,0.0,,2018,1,25,DEBIT,3000000.0,M1718920203
16347,1196428',2018-01-25,IMPS 802513001688 FROM SA,0.0,200000.0,,2018,1,25,CASH_IN,200000.0,M1002711260
16348,1196428',2018-01-25,NEFT/N025180459895792/TEC,0.0,300000.0,,2018,1,25,CASH_IN,300000.0,C545710008
16349,1196428',2018-01-25,NEFT/AXISP18025035632/ACC,0.0,26000000.0,,2018,1,25,TRANSFER,26000000.0,C1838584624
16350,1196428',2018-01-25,FDRL/REAL TIME GROSS SETTL,5000000.0,0.0,,2018,1,25,CASH_OUT,5000000.0,C1030706332
16351,1196428',2018-01-25,FDRL/REAL TIME GROSS SETTL,10000000.0,0.0,,2018,1,25,PAYEMENT,10000000.0,M2129060443
16352,1196428',2018-01-25,FDRL/REAL TIME GROSS SETTL,10000000.0,0.0,,2018,1,25,CHECK_WITHDRAWAL,10000000.0,C1195471589
16353,1196428',2018-01-25,FDRL/INTERNAL FUND TRANSFE,300000.0,0.0,,2018,1,25,CHECK_WITHDRAWAL,300000.0,M1398128260
16354,1196428',2018-01-25,FDRL/INTERNAL FUND TRANSFE,300000.0,0.0,,2018,1,25,PAYEMENT,300000.0,C1856036778
16355,1196428',2018-01-25,FDRL/REAL TIME GROSS SETTL,1000000.0,0.0,,2018,1,25,CHECK_WITHDRAWAL,1000000.0,C2067546399
16356,1196428',2018-01-25,"Indiaforensic USA, INC./USD/2499",0.0,1577368.8,,2018,1,25,TRANSFER,1577368.8,C818570949
16357,1196428',2018-01-25,IRTT00701802350,1388.93,0.0,,2018,1,25,DEBIT,1388.93,M535878604
16358,1196428',2018-01-25,RTGS/IDFBH18025300723/ART,0.0,5000000.0,,2018,1,25,TRANSFER,5000000.0,C358945794
16359,1196428',2018-01-25,RTGS/HDFCH18025531339/PAY,0.0,2900000.0,,2018,1,25,CHECK_CASHING,2900000.0,C922511709
16360,1196428',2018-01-25,Indiaforensic SERVICES INDIA PVT,0.0,758294.97,,2018,1,25,CHECK_CASHING,758294.97,C988138425
16361,1196428',2018-01-25,NEFT/N025180460144330/PAY,0.0,619173.12,,2018,1,25,TRANSFER,619173.12,C814900611
16362,1196428',2018-01-25,NEFT/N025180460141915/PAY,0.0,2341217.91,,2018,1,25,CASH_IN,2341217.91,C1467740330
16363,1196428',2018-01-25,NEFT/BARBV18025212296/MAK,0.0,65555.0,,2018,1,25,TRANSFER,65555.0,M858308953
16364,1196428',2018-01-25,TRF FROM  Indiaforensic SERVICES,0.0,2600000.0,,2018,1,25,CASH_IN,2600000.0,M1773085261
16365,1196428',2018-01-25,YOURSELF FOR BULK NEFT  B,7950750.0,0.0,,2018,1,25,DEBIT,7950750.0,M472606308
16366,1196428',2018-01-25,NEFT/N025180460230865/PAY,0.0,3500000.0,,2018,1,25,TRANSFER,3500000.0,M51583809
16367,1196428',2018-01-25,BEAT CSH PKP DEL GURG 550,0.0,98000.0,,2018,1,25,CHECK_CASHING,98000.0,M1337700382
16368,1196428',2018-01-25,TRF FROM  Indiaforensic SERVICES,0.0,5000000.0,,2018,1,25,CASH_IN,5000000.0,C1918034924
16369,1196428',2018-01-25,TRF FROM  Indiaforensic SERVICES,0.0,2000000.0,,2018,1,25,CHECK_CASHING,2000000.0,M527477577
16370,1196428',2018-01-25,FDRL/INTERNAL FUND TRANSFE,15000000.0,0.0,,2018,1,25,CASH_OUT,15000000.0,M577217292
16371,1196428',2018-01-25,FDRL/INTERNAL FUND TRANSFE,500000.0,0.0,,2018,1,25,DEBIT,500000.0,C184253187
16372,1196428',2018-01-25,FDRL/INTERNAL FUND TRANSFE,3000000.0,0.0,,2018,1,25,CHECK_WITHDRAWAL,3000000.0,C1778300121
16373,1196428',2018-01-29,RTGS/HDFCH18029577514/PAY,0.0,4800000.0,,2018,1,29,CASH_IN,4800000.0,C667504652
16374,1196428',2018-01-29,RTGS/HDFCH18029577518/PAY,0.0,1780000.0,,2018,1,29,CASH_IN,1780000.0,C638590716
16375,1196428',2018-01-29,NEFT/BARBV18029491916/MAK,0.0,82353.0,,2018,1,29,CHECK_CASHING,82353.0,C1532153384
16376,1196428',2018-01-29,FDRL/INTERNAL FUND TRANSFE,500000.0,0.0,,2018,1,29,PAYEMENT,500000.0,C208427878
16377,1196428',2018-01-29,FDRL/INTERNAL FUND TRANSFE,500000.0,0.0,,2018,1,29,PAYEMENT,500000.0,C1530086509
16378,1196428',2018-01-29,FDRL/INTERNAL FUND TRANSFE,500000.0,0.0,,2018,1,29,CASH_OUT,500000.0,C703957828
16379,1196428',2018-01-29,FDRL/REAL TIME GROSS SETTL,5000000.0,0.0,,2018,1,29,CHECK_WITHDRAWAL,5000000.0,C891020651
16380,1196428',2018-01-29,"Indiaforensic USA, INC./USD/3990",0.0,252207.9,,2018,1,29,CASH_IN,252207.9,M1680032445
16381,1196428',2018-01-29,IRTT00701802540,611.99,0.0,,2018,1,29,CASH_OUT,611.99,C553264065
16382,1196428',2018-01-29,IMPS 802914482031 FROM RA,0.0,11800.0,,2018,1,29,TRANSFER,11800.0,M1097298586
16383,1196428',2018-01-29,NEFT/IDFBH18029239618/FUN,0.0,19600.0,,2018,1,29,CASH_IN,19600.0,M870026554
16384,1196428',2018-01-29,NEFT/BARBV18029643114/MAK,0.0,89987.0,,2018,1,29,TRANSFER,89987.0,C695653925
16385,1196428',2018-01-29,Indiaforensic SERVICES INDIA PVT,0.0,1289715.4,,2018,1,29,CASH_IN,1289715.4,M1248361658
16386,1196428',2018-01-29,NEFT/N029180461353827/PAY,0.0,901648.12,,2018,1,29,CASH_IN,901648.12,C1689262323
16387,1196428',2018-01-29,NEFT/N029180461349737/PAY,0.0,1453652.21,,2018,1,29,CHECK_CASHING,1453652.21,C1757877803
16388,1196428',2018-01-29,TRF FROM  Indiaforensic SERVICES,0.0,5800000.0,,2018,1,29,CASH_IN,5800000.0,C1849933855
16389,1196428',2018-01-29,TRF FROM  Indiaforensic SERVICES,0.0,13000000.0,,2018,1,29,TRANSFER,13000000.0,C1753128715
16390,1196428',2018-01-29,TRF FROM  Indiaforensic SERVICES,0.0,10900000.0,,2018,1,29,CHECK_CASHING,10900000.0,C1527761090
16391,1196428',2018-01-29,NEFT/N029180461400247/PAY,0.0,36524.48,,2018,1,29,TRANSFER,36524.48,C1754722089
16392,1196428',2018-01-29,BEAT CSH PKP DEL GURG 550,0.0,546000.0,,2018,1,29,CHECK_CASHING,546000.0,C1261039678
16393,1196428',2018-01-29,FDRL/INTERNAL FUND TRANSFE,15000000.0,0.0,,2018,1,29,CASH_OUT,15000000.0,C836514715
16394,1196428',2018-01-29,FDRL/INTERNAL FUND TRANSFE,5000000.0,0.0,,2018,1,29,PAYEMENT,5000000.0,C1640961071
16395,1196428',2018-01-30,RTGS/HDFCH18030710068/PAY,0.0,4480000.0,,2018,1,30,TRANSFER,4480000.0,C1838584624
16396,1196428',2018-01-30,RTGS/HDFCH18030714557/PAY,0.0,3520000.0,,2018,1,30,CASH_IN,3520000.0,C1209271652
16397,1196428',2018-01-30,FDRL/NATIONAL ELECTRONIC F,30580.0,0.0,,2018,1,30,DEBIT,30580.0,C745740822
16398,1196428',2018-01-30,FDRL/NATIONAL ELECTRONIC F,71567.0,0.0,,2018,1,30,CASH_OUT,71567.0,C1401721023
16399,1196428',2018-01-30,FDRL/NATIONAL ELECTRONIC F,16697.0,0.0,,2018,1,30,CHECK_WITHDRAWAL,16697.0,C47827984
16400,1196428',2018-01-30,FDRL/REAL TIME GROSS SETTL,10000000.0,0.0,,2018,1,30,CHECK_WITHDRAWAL,10000000.0,C1849941462
16401,1196428',2018-01-30,IMPS 803012849624 FROM SA,0.0,50000.0,,2018,1,30,CHECK_CASHING,50000.0,C70895366
16402,1196428',2018-01-30,IRTT00701802774,953.23,0.0,,2018,1,30,CASH_OUT,953.23,C977993101
16403,1196428',2018-01-30,FIXED   MOBILE PTE LTD/US,0.0,631363.72,,2018,1,30,CHECK_CASHING,631363.72,C2116873183
16404,1196428',2018-01-30,NEFT/FDRL656260403/Indiaforensic,0.0,3000000.0,,2018,1,30,TRANSFER,3000000.0,C892686452
16405,1196428',2018-01-30,NEFT/BARBV18030944166/MAK,0.0,50550.0,,2018,1,30,TRANSFER,50550.0,C1540270363
16406,1196428',2018-01-30,FDRL/REAL TIME GROSS SETTL,1000000.0,0.0,,2018,1,30,DEBIT,1000000.0,C534662976
16407,1196428',2018-01-30,FDRL/REAL TIME GROSS SETTL,5000000.0,0.0,,2018,1,30,PAYEMENT,5000000.0,C30013970
16408,1196428',2018-01-30,TRF FROM  Indiaforensic ONLINE S,0.0,65000.0,,2018,1,30,CHECK_CASHING,65000.0,C1809373351
16409,1196428',2018-01-30,NEFT/BARBW18030048543/MAK,0.0,70777.0,,2018,1,30,CHECK_CASHING,70777.0,C741431520
16410,1196428',2018-01-30,TELEPOWER COMMUNICATIONS,6286776.0,0.0,,2018,1,30,PAYEMENT,6286776.0,C669771073
16411,1196428',2018-01-30,IMAR00701800577,8431.62,0.0,,2018,1,30,CHECK_WITHDRAWAL,8431.62,C1915091057
16412,1196428',2018-01-30,NEFT/N030180462369638/PAY,0.0,960474.74,,2018,1,30,CHECK_CASHING,960474.74,C323287038
16413,1196428',2018-01-30,NEFT/N030180462353170/PAY,0.0,1379092.72,,2018,1,30,CASH_IN,1379092.72,C1027992087
16414,1196428',2018-01-30,Indiaforensic SERVICES INDIA PVT,0.0,439233.0,,2018,1,30,CHECK_CASHING,439233.0,C1435804085
16415,1196428',2018-01-30,TRF FROM  Indiaforensic SERVICES,0.0,2900000.0,,2018,1,30,CASH_IN,2900000.0,C1153596299
16416,1196428',2018-01-30,TRF FROM  Indiaforensic SERVICES,0.0,10500000.0,,2018,1,30,CASH_IN,10500000.0,C1541743053
16417,1196428',2018-01-30,FDRL/INTERNAL FUND TRANSFE,10000000.0,0.0,,2018,1,30,PAYEMENT,10000000.0,C1213257323
16418,1196428',2018-01-30,FDRL/INTERNAL FUND TRANSFE,5000000.0,0.0,,2018,1,30,DEBIT,5000000.0,C295081230
16419,1196428',2018-01-30,FDRL/INTERNAL FUND TRANSFE,1000000.0,0.0,,2018,1,30,DEBIT,1000000.0,C531511436
16420,1196428',2018-01-31,RTGS/HDFCH18031834455/PAY,0.0,3120000.0,,2018,1,31,CASH_IN,3120000.0,C175291188
16421,1196428',2018-01-31,RTGS/HDFCH18031833771/PAY,0.0,4560000.0,,2018,1,31,TRANSFER,4560000.0,C1259769769
16422,1196428',2018-01-31,IRTT00701802933,1861.81,0.0,,2018,1,31,PAYEMENT,1861.81,C205300866
16423,1196428',2018-01-31,"Indiaforensic USA, INC./USD/6636",0.0,4204476.15,,2018,1,31,CASH_IN,4204476.15,C1297873690
16424,1196428',2018-01-31,NEFT/BARBW18031406977/MAK,0.0,160666.0,,2018,1,31,CHECK_CASHING,160666.0,C715819458
16425,1196428',2018-01-31,NEFT/N031180463264656/TEC,0.0,700000.0,,2018,1,31,TRANSFER,700000.0,C18928637
16426,1196428',2018-01-31,IB:TPFT0054999551 4090004,0.0,10000.0,,2018,1,31,TRANSFER,10000.0,C1079343872
16427,1196428',2018-01-31,RTGS/YESBH18031819484/Indfor,13000000.0,0.0,,2018,1,31,CASH_OUT,13000000.0,C99275333
16428,1196428',2018-01-31,Indiaforensic SERVICES INDIA PVT,0.0,671433.0,,2018,1,31,TRANSFER,671433.0,C1450828900
16429,1196428',2018-01-31,NEFT/N031180463644761/PAY,0.0,957522.0,,2018,1,31,CHECK_CASHING,957522.0,C1339257929
16430,1196428',2018-01-31,NEFT/N031180463632265/PAY,0.0,1187878.08,,2018,1,31,TRANSFER,1187878.08,C893041125
16431,1196428',2018-01-31,FDRL/INTERNAL FUND TRANSFE,0.0,2000000.0,,2018,1,31,CASH_IN,2000000.0,C380242442
16432,1196428',2018-01-31,FDRL/INTERNAL FUND TRANSFE,0.0,2000000.0,,2018,1,31,TRANSFER,2000000.0,C1220897602
16433,1196428',2018-01-31,FDRL/INTERNAL FUND TRANSFE,0.0,2000000.0,,2018,1,31,TRANSFER,2000000.0,C495071437
16434,1196428',2018-01-31,FDRL/INTERNAL FUND TRANSFE,0.0,2000000.0,,2018,1,31,TRANSFER,2000000.0,C1753128715
16435,1196428',2018-01-31,NEFT CHARGES AND GST/0000,29.5,0.0,,2018,1,31,DEBIT,29.5,C1387460501
16436,1196428',2018-01-31,NEFT/000030383006/ARTHASH,10000000.0,0.0,,2018,1,31,PAYEMENT,10000000.0,C425987411
16437,1196428',2018-01-31,BEAT CSH PKP DEL GURG 617,0.0,214000.0,,2018,1,31,CASH_IN,214000.0,C914293025
16438,1196428',2018-01-31,TRF FROM  Indiaforensic SERVICES,0.0,10000000.0,,2018,1,31,TRANSFER,10000000.0,C1765998352
16439,1196428',2018-01-31,FDRL/INTERNAL FUND TRANSFE,5000000.0,0.0,,2018,1,31,CASH_OUT,5000000.0,C1651144763
16440,1196428',2018-01-31,1196428:Int.Coll:01-01-20,815070.0,0.0,,2018,1,31,DEBIT,815070.0,C922871524
16441,1196428',2018-02-01,FDRL/REAL TIME GROSS SETTL,5000000.0,0.0,,2018,2,1,CASH_OUT,5000000.0,C506903242
16442,1196428',2018-02-01,FDRL/REAL TIME GROSS SETTL,2000000.0,0.0,,2018,2,1,CHECK_WITHDRAWAL,2000000.0,M2072059657
16443,1196428',2018-02-01,FDRL/REAL TIME GROSS SETTL,2000000.0,0.0,,2018,2,1,PAYEMENT,2000000.0,C304406966
16444,1196428',2018-02-01,RTGS/HDFCH18032928826/PAY,0.0,3600000.0,,2018,2,1,CHECK_CASHING,3600000.0,C75629578
16445,1196428',2018-02-01,RTGS/HDFCH18032926599/PAY,0.0,1920000.0,,2018,2,1,CHECK_CASHING,1920000.0,M1037398211
16446,1196428',2018-02-01,TRF FROM  Indiaforensic SERVICES,0.0,500000.0,,2018,2,1,CASH_IN,500000.0,C2072030256
16447,1196428',2018-02-01,TRF FROM  Indiaforensic SERVICES,0.0,2000000.0,,2018,2,1,TRANSFER,2000000.0,C886888353
16448,1196428',2018-02-01,NEFT/20413626831DC/ARTHAS,0.0,250000.0,,2018,2,1,CASH_IN,250000.0,C701279123
16449,1196428',2018-02-01,FDRL/REAL TIME GROSS SETTL,5000000.0,0.0,,2018,2,1,CHECK_WITHDRAWAL,5000000.0,C864016033
16450,1196428',2018-02-01,RTGS/IDFBH18032300570/ART,0.0,10000000.0,,2018,2,1,TRANSFER,10000000.0,C515442419
16451,1196428',2018-02-01,RTGS/IDFBH18032300555/ART,0.0,10000000.0,,2018,2,1,CHECK_CASHING,10000000.0,M2127093801
16452,1196428',2018-02-01,RTGS/IDFBH18032300557/ART,0.0,10000000.0,,2018,2,1,CHECK_CASHING,10000000.0,C1649686970
16453,1196428',2018-02-01,NEFT/000039688327/ARVIND,0.0,11800.0,,2018,2,1,CHECK_CASHING,11800.0,C701855966
16454,1196428',2018-02-01,FDRL/REAL TIME GROSS SETTL,15000000.0,0.0,,2018,2,1,PAYEMENT,15000000.0,C1505217516
16455,1196428',2018-02-01,FDRL/REAL TIME GROSS SETTL,15000000.0,0.0,,2018,2,1,CHECK_WITHDRAWAL,15000000.0,M676875212
16456,1196428',2018-02-01,CASHDEP/NOIDA/TP,0.0,104000.0,,2018,2,1,TRANSFER,104000.0,C681709819
16457,1196428',2018-02-01,FUJIAN NEWLAND PAYMENT TE,2673576.0,0.0,,2018,2,1,CASH_OUT,2673576.0,M1025042585
16458,1196428',2018-02-01,IMAR00701800634,5824.76,0.0,,2018,2,1,CHECK_WITHDRAWAL,5824.76,C807247901
16459,1196428',2018-02-01,NEFT/N032180465191682/PAY,0.0,934367.23,,2018,2,1,CASH_IN,934367.23,M18308448
16460,1196428',2018-02-01,NEFT/N032180465187584/PAY,0.0,686038.2,,2018,2,1,CHECK_CASHING,686038.2,M170030714
16461,1196428',2018-02-01,NEFT/IDFBH18032282591/FUN,0.0,29400.0,,2018,2,1,CASH_IN,29400.0,M621155607
16462,1196428',2018-02-01,IMPS 803217453139 FROM SA,0.0,50000.0,,2018,2,1,CHECK_CASHING,50000.0,C1660095722
16463,1196428',2018-02-01,NEFT/AXISP18032527603/ACC,0.0,4000000.0,,2018,2,1,CHECK_CASHING,4000000.0,M1571765149
16464,1196428',2018-02-01,TRF FROM  Indiaforensic SERVICES,0.0,3300000.0,,2018,2,1,CASH_IN,3300000.0,C1663686815
16465,1196428',2018-02-01,TRF FROM  Indiaforensic SERVICES,0.0,5000000.0,,2018,2,1,CHECK_CASHING,5000000.0,M279824269
16466,1196428',2018-02-01,TRF FROM  Indiaforensic SERVICES,0.0,2000000.0,,2018,2,1,TRANSFER,2000000.0,M1570490488
16467,1196428',2018-02-01,BEAT CSH PKP DEL GURG 617,0.0,94000.0,,2018,2,1,CHECK_CASHING,94000.0,M1063002743
16468,1196428',2018-02-02,FDRL/INTERNAL FUND TRANSFE,500000.0,0.0,,2018,2,2,PAYEMENT,500000.0,M1530195938
16469,1196428',2018-02-02,FDRL/INTERNAL FUND TRANSFE,1000000.0,0.0,,2018,2,2,CHECK_WITHDRAWAL,1000000.0,C1883840933
16470,1196428',2018-02-02,FDRL/INTERNAL FUND TRANSFE,10000000.0,0.0,,2018,2,2,CASH_OUT,10000000.0,M2097586567
16471,1196428',2018-02-02,FDRL/INTERNAL FUND TRANSFE,5000000.0,0.0,,2018,2,2,DEBIT,5000000.0,C1700852615
16472,1196428',2018-02-02,NEFT/20415112621DC/ARTHAS,0.0,125000.0,,2018,2,2,TRANSFER,125000.0,C1457728035
16473,1196428',2018-02-02,RTGS/HDFCH18033046872/PAY,0.0,5040000.0,,2018,2,2,CASH_IN,5040000.0,C47249488
16474,1196428',2018-02-02,RTGS/HDFCH18033044890/PAY,0.0,2640000.0,,2018,2,2,CHECK_CASHING,2640000.0,C33524623
16475,1196428',2018-02-02,Indiaforensic SERVICES INDIA PVT,0.0,612383.0,,2018,2,2,TRANSFER,612383.0,C2133591152
16476,1196428',2018-02-02,FDRL/REAL TIME GROSS SETTL,2000000.0,0.0,,2018,2,2,PAYEMENT,2000000.0,C193864812
16477,1196428',2018-02-02,FDRL/REAL TIME GROSS SETTL,5000000.0,0.0,,2018,2,2,CASH_OUT,5000000.0,C1058921154
16478,1196428',2018-02-02,FDRL/REAL TIME GROSS SETTL,1000000.0,0.0,,2018,2,2,DEBIT,1000000.0,C798678484
16479,1196428',2018-02-02,FDRL/INTERNAL FUND TRANSFE,200000.0,0.0,,2018,2,2,CASH_OUT,200000.0,C769342184
16480,1196428',2018-02-02,FDRL/INTERNAL FUND TRANSFE,300000.0,0.0,,2018,2,2,CHECK_WITHDRAWAL,300000.0,C981198566
16481,1196428',2018-02-02,CASHDEP/VIKASMARG/TP,0.0,80000.0,,2018,2,2,TRANSFER,80000.0,C1281898359
16482,1196428',2018-02-02,FDRL/INTERNAL FUND TRANSFE,0.0,3000000.0,,2018,2,2,CHECK_CASHING,3000000.0,C30013970
16483,1196428',2018-02-02,FDRL/INTERNAL FUND TRANSFE,0.0,3000000.0,,2018,2,2,CASH_IN,3000000.0,C31789747
16484,1196428',2018-02-02,FDRL/REAL TIME GROSS SETTL,5000000.0,0.0,,2018,2,2,CASH_OUT,5000000.0,C93518808
16485,1196428',2018-02-02,FDRL/REAL TIME GROSS SETTL,1000000.0,0.0,,2018,2,2,CASH_OUT,1000000.0,C2093546827
16486,1196428',2018-02-02,FUJIAN NEWLAND PAYMENT TE,158242.3,0.0,,2018,2,2,DEBIT,158242.3,C976133979
16487,1196428',2018-02-02,IMAR00701800693,1117.42,0.0,,2018,2,2,CASH_OUT,1117.42,C849038219
16488,1196428',2018-02-02,NEFT/BARBX18033763726/MAK,0.0,80800.0,,2018,2,2,CASH_IN,80800.0,C1789550256
16489,1196428',2018-02-02,NEFT/AXISP18033059112/ACC,0.0,15000000.0,,2018,2,2,TRANSFER,15000000.0,C363475076
16490,1196428',2018-02-02,NEFT/AXISP18033059113/ACC,0.0,9000000.0,,2018,2,2,CHECK_CASHING,9000000.0,C2110623348
16491,1196428',2018-02-02,Indiaforensic SERVICES INDIA PVT,0.0,606803.0,,2018,2,2,CHECK_CASHING,606803.0,C1161820020
16492,1196428',2018-02-02,NEFT/N033180466310065/PAY,0.0,734168.52,,2018,2,2,CASH_IN,734168.52,C627675433
16493,1196428',2018-02-02,NEFT/N033180466309970/PAY,0.0,1.0,,2018,2,2,TRANSFER,1.0,C1145835418
16494,1196428',2018-02-02,TRF FROM  Indiaforensic SERVICES,0.0,15000000.0,,2018,2,2,CHECK_CASHING,15000000.0,C1778300121
16495,1196428',2018-02-02,TRF FROM  Indiaforensic SERVICES,0.0,7200000.0,,2018,2,2,TRANSFER,7200000.0,C1325626015
16496,1196428',2018-02-02,FDRL/INTERNAL FUND TRANSFE,500000.0,0.0,,2018,2,2,CASH_OUT,500000.0,C8733802
16497,1196428',2018-02-02,FDRL/INTERNAL FUND TRANSFE,500000.0,0.0,,2018,2,2,CASH_OUT,500000.0,C990053853
16498,1196428',2018-02-02,FDRL/INTERNAL FUND TRANSFE,500000.0,0.0,,2018,2,2,CASH_OUT,500000.0,C218193338
16499,1196428',2018-02-02,FDRL/INTERNAL FUND TRANSFE,500000.0,0.0,,2018,2,2,DEBIT,500000.0,M832073005
16500,1196428',2018-02-02,FDRL/INTERNAL FUND TRANSFE,500000.0,0.0,,2018,2,2,CASH_OUT,500000.0,M189083850
16501,1196428',2018-02-02,NEFT CHARGES AND GST/0000,29.5,0.0,,2018,2,2,DEBIT,29.5,C103357744
16502,1196428',2018-02-02,NEFT/000030549913/GALENA,14000000.0,0.0,,2018,2,2,DEBIT,14000000.0,M1942890330
16503,1196428',2018-02-02,FDRL/INTERNAL FUND TRANSFE,0.0,3000000.0,,2018,2,2,CHECK_CASHING,3000000.0,C2011941350
16504,1196428',2018-02-02,YOURSELF FOR BULK NEFT  B,13604812.0,0.0,,2018,2,2,CHECK_WITHDRAWAL,13604812.0,C1505755152
16505,1196428',2018-02-02,"Indiaforensic USA, INC./USD/3318",0.0,2107247.5,,2018,2,2,CHECK_CASHING,2107247.5,M1051118371
16506,1196428',2018-02-02,IRTT00701803317,1484.3,0.0,,2018,2,2,CASH_OUT,1484.3,M1502077581
16507,1196428',2018-02-02,BEAT CSH PKP DEL GURG 617,0.0,146000.0,,2018,2,2,CASH_IN,146000.0,M1801625172
16508,1196428',2018-02-02,FDRL/INTERNAL FUND TRANSFE,10000000.0,0.0,,2018,2,2,PAYEMENT,10000000.0,C360898540
16509,1196428',2018-02-02,FDRL/INTERNAL FUND TRANSFE,10000000.0,0.0,,2018,2,2,PAYEMENT,10000000.0,M1408738192
16510,1196428',2018-02-02,FDRL/INTERNAL FUND TRANSFE,3000000.0,0.0,,2018,2,2,CASH_OUT,3000000.0,C237594516
16511,1196428',2018-02-03,RTGS/HDFCH18034112945/PAY,0.0,4720000.0,,2018,2,3,CASH_IN,4720000.0,M1645271006
16512,1196428',2018-02-03,RTGS/HDFCH18034112946/PAY,0.0,2640000.0,,2018,2,3,CHECK_CASHING,2640000.0,M1616707854
16513,1196428',2018-02-03,FDRL/INTERNAL FUND TRANSFE,0.0,3000000.0,,2018,2,3,TRANSFER,3000000.0,C1334973394
16514,1196428',2018-02-03,FDRL/INTERNAL FUND TRANSFE,0.0,3000000.0,,2018,2,3,TRANSFER,3000000.0,M1547406846
16515,1196428',2018-02-03,FDRL/REAL TIME GROSS SETTL,10000000.0,0.0,,2018,2,3,PAYEMENT,10000000.0,M51814511
16516,1196428',2018-02-03,FDRL/REAL TIME GROSS SETTL,3000000.0,0.0,,2018,2,3,CHECK_WITHDRAWAL,3000000.0,M1679527434
16517,1196428',2018-02-03,FDRL/INTERNAL FUND TRANSFE,0.0,5000000.0,,2018,2,3,CHECK_CASHING,5000000.0,M858729243
16518,1196428',2018-02-03,FDRL/INTERNAL FUND TRANSFE,0.0,5000000.0,,2018,2,3,CASH_IN,5000000.0,M317858117
16519,1196428',2018-02-03,FDRL/INTERNAL FUND TRANSFE,0.0,5000000.0,,2018,2,3,CHECK_CASHING,5000000.0,M974232437
16520,1196428',2018-02-03,IB:TPFT0055403391 4090004,0.0,10000.0,,2018,2,3,TRANSFER,10000.0,M535001108
16521,1196428',2018-02-03,FDRL/NATIONAL ELECTRONIC F,5000000.0,0.0,,2018,2,3,DEBIT,5000000.0,M967799453
16522,1196428',2018-02-03,FDRL/NATIONAL ELECTRONIC F,10000000.0,0.0,,2018,2,3,CHECK_WITHDRAWAL,10000000.0,M1704857178
16523,1196428',2018-02-03,TRF FROM  Indiaforensic SERVICES,0.0,15000000.0,,2018,2,3,TRANSFER,15000000.0,M888552844
16524,1196428',2018-02-03,TRF FROM  Indiaforensic SERVICES,0.0,3000000.0,,2018,2,3,TRANSFER,3000000.0,M257269635
16525,1196428',2018-02-03,TRF FROM  Indiaforensic SERVICES,0.0,3000000.0,,2018,2,3,CHECK_CASHING,3000000.0,C1305075214
16526,1196428',2018-02-03,DD FOR  Indiaforensic SERVICES I,0.0,2000000.0,,2018,2,3,CASH_IN,2000000.0,C1627965794
16527,1196428',2018-02-03,TRF FROM  Indiaforensic SERVICES,0.0,500000.0,,2018,2,3,CHECK_CASHING,500000.0,M1559676676
16528,1196428',2018-02-03,NEFT/N034180467138190/PAY,0.0,356267.28,,2018,2,3,CASH_IN,356267.28,C741431520
16529,1196428',2018-02-03,FDRL/NATIONAL ELECTRONIC F,5000000.0,0.0,,2018,2,3,CHECK_WITHDRAWAL,5000000.0,C2143477943
16530,1196428',2018-02-03,NEFT/N034180467137791/PAY,0.0,1995816.51,,2018,2,3,CASH_IN,1995816.51,C638551812
16531,1196428',2018-02-03,TRF FROM  Indiaforensic SERVICES,0.0,2000000.0,,2018,2,3,CHECK_CASHING,2000000.0,C1027296777
16532,1196428',2018-02-03,TRF FROM  Indiaforensic SERVICES,0.0,500000.0,,2018,2,3,TRANSFER,500000.0,C1554540309
16533,1196428',2018-02-03,FDRL/INTERNAL FUND TRANSFE,10000000.0,0.0,,2018,2,3,DEBIT,10000000.0,M2120427827
16534,1196428',2018-02-03,FDRL/INTERNAL FUND TRANSFE,10000000.0,0.0,,2018,2,3,DEBIT,10000000.0,C820910648
16535,1196428',2018-02-03,FDRL/INTERNAL FUND TRANSFE,3000000.0,0.0,,2018,2,3,PAYEMENT,3000000.0,M415456371
16536,1196428',2018-02-03,FDRL/INTERNAL FUND TRANSFE,500000.0,0.0,,2018,2,3,PAYEMENT,500000.0,M598340030
16537,1196428',2018-02-03,BEAT CSH PKP DEL GURG 617,0.0,69000.0,,2018,2,3,CHECK_CASHING,69000.0,C345679794
16538,1196428',2018-02-03,IMPS 803418240076 FROM SA,0.0,200000.0,,2018,2,3,CASH_IN,200000.0,M1605050346
16539,1196428',2018-02-05,NEFT/P18020581958185/SUNI,0.0,50000.0,,2018,2,5,CASH_IN,50000.0,C1144070975
16540,1196428',2018-02-05,RTGS/HDFCH18036220778/PAY,0.0,7040000.0,,2018,2,5,CHECK_CASHING,7040000.0,M639999796
16541,1196428',2018-02-05,RTGS/HDFCH18036224887/PAY,0.0,6560000.0,,2018,2,5,TRANSFER,6560000.0,C343534938
16542,1196428',2018-02-05,RTGS/SCBLH18036004823/FIX,0.0,300000.0,,2018,2,5,TRANSFER,300000.0,M479872561
16543,1196428',2018-02-05,FDRL/REAL TIME GROSS SETTL,2000000.0,0.0,,2018,2,5,DEBIT,2000000.0,M61732893
16544,1196428',2018-02-05,FDRL/REAL TIME GROSS SETTL,10000000.0,0.0,,2018,2,5,CASH_OUT,10000000.0,C160632822
16545,1196428',2018-02-05,NEFT/BARBY18036591833/MAK,0.0,51550.0,,2018,2,5,CHECK_CASHING,51550.0,C1183266411
16546,1196428',2018-02-05,NEFT/N036180468237308/PAY,0.0,1.0,,2018,2,5,CHECK_CASHING,1.0,M1328778262
16547,1196428',2018-02-05,NEFT/N036180468237777/PAY,0.0,1803589.58,,2018,2,5,TRANSFER,1803589.58,M704806959
16548,1196428',2018-02-05,TRF FROM  Indiaforensic SERVICES,0.0,14200000.0,,2018,2,5,TRANSFER,14200000.0,C229313132
16549,1196428',2018-02-05,BEAT CSH PKP DEL GURG 617,0.0,202000.0,,2018,2,5,CHECK_CASHING,202000.0,M325906300
16550,1196428',2018-02-05,TRF FROM  Indiaforensic SERVICES,0.0,6000000.0,,2018,2,5,TRANSFER,6000000.0,M1267748122
16551,1196428',2018-02-05,FDRL/INTERNAL FUND TRANSFE,7000000.0,0.0,,2018,2,5,CHECK_WITHDRAWAL,7000000.0,M159739450
16552,1196428',2018-02-05,FDRL/INTERNAL FUND TRANSFE,7000000.0,0.0,,2018,2,5,DEBIT,7000000.0,M1702289141
16553,1196428',2018-02-06,FDRL/REAL TIME GROSS SETTL,10000000.0,0.0,,2018,2,6,PAYEMENT,10000000.0,C1200612373
16554,1196428',2018-02-06,IB:TPFT0055650901 4090004,0.0,10000.0,,2018,2,6,CHECK_CASHING,10000.0,C1840046890
16555,1196428',2018-02-06,RTGS/HDFCH18037397462/PAY,0.0,4640000.0,,2018,2,6,TRANSFER,4640000.0,M1261751850
16556,1196428',2018-02-06,RTGS/HDFCH18037398711/PAY,0.0,3360000.0,,2018,2,6,CASH_IN,3360000.0,M1535970431
16557,1196428',2018-02-06,CASHDEP/VIKASMARG/TP,0.0,50000.0,,2018,2,6,CHECK_CASHING,50000.0,M524251983
16558,1196428',2018-02-06,FDRL/REAL TIME GROSS SETTL,5000000.0,0.0,,2018,2,6,CHECK_WITHDRAWAL,5000000.0,C1406749291
16559,1196428',2018-02-06,FDRL/REAL TIME GROSS SETTL,3000000.0,0.0,,2018,2,6,DEBIT,3000000.0,C1415645767
16560,1196428',2018-02-06,NEFT/20419428601DC/ARTHAS,0.0,25000.0,,2018,2,6,TRANSFER,25000.0,M1816834020
16561,1196428',2018-02-06,NEFT/BARBZ18037002806/MAK,0.0,50555.0,,2018,2,6,CASH_IN,50555.0,C1732292969
16562,1196428',2018-02-06,FDRL/INTERNAL FUND TRANSFE,0.0,3000000.0,,2018,2,6,CASH_IN,3000000.0,M1739764490
16563,1196428',2018-02-06,FDRL/INTERNAL FUND TRANSFE,0.0,3000000.0,,2018,2,6,CHECK_CASHING,3000000.0,M1664129150
16564,1196428',2018-02-06,Indiaforensic SERVICES INDIA PVT,0.0,2315395.0,,2018,2,6,CASH_IN,2315395.0,M1128852062
16565,1196428',2018-02-06,TRF FROM  Indiaforensic SERVICES,0.0,14900000.0,,2018,2,6,CASH_IN,14900000.0,M182471589
16566,1196428',2018-02-06,FDRL/NATIONAL ELECTRONIC F,10000000.0,0.0,,2018,2,6,CHECK_WITHDRAWAL,10000000.0,M1056074872
16567,1196428',2018-02-06,FDRL/NATIONAL ELECTRONIC F,10000000.0,0.0,,2018,2,6,CHECK_WITHDRAWAL,10000000.0,M2106622700
16568,1196428',2018-02-06,NEFT/N037180469335682/PAY,0.0,1.0,,2018,2,6,CASH_IN,1.0,M163766295
16569,1196428',2018-02-06,FDRL/INTERNAL FUND TRANSFE,500000.0,0.0,,2018,2,6,DEBIT,500000.0,M802332120
16570,1196428',2018-02-06,FDRL/INTERNAL FUND TRANSFE,500000.0,0.0,,2018,2,6,CHECK_WITHDRAWAL,500000.0,M1676185662
16571,1196428',2018-02-06,NEFT/N037180469326531/PAY,0.0,1227264.91,,2018,2,6,CASH_IN,1227264.91,M1776427379
16572,1196428',2018-02-06,FDRL/INTERNAL FUND TRANSFE,0.0,5000000.0,,2018,2,6,CASH_IN,5000000.0,M334173295
16573,1196428',2018-02-06,FDRL/INTERNAL FUND TRANSFE,0.0,5000000.0,,2018,2,6,CASH_IN,5000000.0,M330490124
16574,1196428',2018-02-06,FDRL/INTERNAL FUND TRANSFE,0.0,5000000.0,,2018,2,6,CASH_IN,5000000.0,M1154845973
16575,1196428',2018-02-06,FDRL/INTERNAL FUND TRANSFE,0.0,5000000.0,,2018,2,6,CASH_IN,5000000.0,M911987264
16576,1196428',2018-02-06,FDRL/INTERNAL FUND TRANSFE,0.0,5000000.0,,2018,2,6,TRANSFER,5000000.0,M1680147473
16577,1196428',2018-02-06,TRF FROM  Indiaforensic SERVICES,0.0,4000000.0,,2018,2,6,TRANSFER,4000000.0,M293659205
16578,1196428',2018-02-06,FDRL/INTERNAL FUND TRANSFE,15000000.0,0.0,,2018,2,6,PAYEMENT,15000000.0,M1432093328
16579,1196428',2018-02-06,FDRL/INTERNAL FUND TRANSFE,10000000.0,0.0,,2018,2,6,PAYEMENT,10000000.0,M901262414
16580,1196428',2018-02-06,BEAT CSH PKP DEL GURG 617,0.0,266500.0,,2018,2,6,CASH_IN,266500.0,M899962047
16581,1196428',2018-02-07,FDRL/REAL TIME GROSS SETTL,3000000.0,0.0,,2018,2,7,CASH_OUT,3000000.0,M32715716
16582,1196428',2018-02-07,FDRL/REAL TIME GROSS SETTL,5000000.0,0.0,,2018,2,7,PAYEMENT,5000000.0,M1510311379
16583,1196428',2018-02-07,FT ZL1802070FC06F68 PRAVE,0.0,97000.0,,2018,2,7,CHECK_CASHING,97000.0,M1517206841
16584,1196428',2018-02-07,RTGS/HDFCH18038575895/PAY,0.0,4160000.0,,2018,2,7,CASH_IN,4160000.0,M2030024765
16585,1196428',2018-02-07,RTGS/HDFCH18038577417/PAY,0.0,2940000.0,,2018,2,7,CASH_IN,2940000.0,M1267580132
16586,1196428',2018-02-07,FDRL/REAL TIME GROSS SETTL,5000000.0,0.0,,2018,2,7,DEBIT,5000000.0,C655391383
16587,1196428',2018-02-07,FDRL/REAL TIME GROSS SETTL,1000000.0,0.0,,2018,2,7,PAYEMENT,1000000.0,C2117215775
16588,1196428',2018-02-07,FDRL/REAL TIME GROSS SETTL,1000000.0,0.0,,2018,2,7,DEBIT,1000000.0,C2106576360
16589,1196428',2018-02-07,NEFT/20421090331DC/ARTHAS,0.0,25000.0,,2018,2,7,CASH_IN,25000.0,M267789972
16590,1196428',2018-02-07,NEFT/BARBZ18038418305/MAK,0.0,50002.0,,2018,2,7,TRANSFER,50002.0,M292960678
16591,1196428',2018-02-07,FDRL/INTERNAL FUND TRANSFE,300000.0,0.0,,2018,2,7,PAYEMENT,300000.0,C1638372110
16592,1196428',2018-02-07,FDRL/INTERNAL FUND TRANSFE,300000.0,0.0,,2018,2,7,DEBIT,300000.0,C1377774115
16593,1196428',2018-02-07,NEFT/N038180470258397/PAY,0.0,823794.63,,2018,2,7,TRANSFER,823794.63,M1877845145
16594,1196428',2018-02-07,NEFT/N038180470258395/PAY,0.0,1103641.46,,2018,2,7,CASH_IN,1103641.46,M869149988
16595,1196428',2018-02-07,Indiaforensic SERVICES INDIA PVT,0.0,470169.0,,2018,2,7,CHECK_CASHING,470169.0,M1324498984
16596,1196428',2018-02-07,"Indiaforensic USA, INC./USD/4998",0.0,3188724.0,,2018,2,7,TRANSFER,3188724.0,C748014372
16597,1196428',2018-02-07,IRTT00701803841,1678.97,0.0,,2018,2,7,CHECK_WITHDRAWAL,1678.97,M1556526073
16598,1196428',2018-02-07,NEFT/AXISP18038186565/ACC,0.0,5000000.0,,2018,2,7,TRANSFER,5000000.0,M1113797896
16599,1196428',2018-02-07,TRF FROM  Indiaforensic SERVICES,0.0,11400000.0,,2018,2,7,TRANSFER,11400000.0,M111103216
16600,1196428',2018-02-07,TRF FROM  Indiaforensic SERVICES,0.0,3000000.0,,2018,2,7,TRANSFER,3000000.0,M402054040
16601,1196428',2018-02-07,BEAT CSH PKP DEL GURG 617,0.0,236500.0,,2018,2,7,TRANSFER,236500.0,C1174935745
16602,1196428',2018-02-07,FDRL/INTERNAL FUND TRANSFE,10000000.0,0.0,,2018,2,7,PAYEMENT,10000000.0,M3128155
16603,1196428',2018-02-07,FDRL/INTERNAL FUND TRANSFE,10000000.0,0.0,,2018,2,7,CASH_OUT,10000000.0,M804435874
16604,1196428',2018-02-07,FDRL/INTERNAL FUND TRANSFE,5000000.0,0.0,,2018,2,7,CHECK_WITHDRAWAL,5000000.0,M22524150
16605,1196428',2018-02-08,NEFT/20422220551DC/ARTHAS,0.0,25000.0,,2018,2,8,TRANSFER,25000.0,C717951588
16606,1196428',2018-02-08,RTGS/HDFCH18039762780/PAY,0.0,4640000.0,,2018,2,8,CASH_IN,4640000.0,M994429804
16607,1196428',2018-02-08,RTGS/HDFCH18039761611/PAY,0.0,2160000.0,,2018,2,8,TRANSFER,2160000.0,M42960844
16608,1196428',2018-02-08,FDRL/REAL TIME GROSS SETTL,5000000.0,0.0,,2018,2,8,DEBIT,5000000.0,M117897905
16609,1196428',2018-02-08,FDRL/REAL TIME GROSS SETTL,1000000.0,0.0,,2018,2,8,CHECK_WITHDRAWAL,1000000.0,M919103236
16610,1196428',2018-02-08,FDRL/REAL TIME GROSS SETTL,1000000.0,0.0,,2018,2,8,DEBIT,1000000.0,M2117556230
16611,1196428',2018-02-08,NEFT/BARBZ18039836730/MAK,0.0,50560.0,,2018,2,8,CASH_IN,50560.0,M2047174428
16612,1196428',2018-02-08,IMPS 803915097780 FROM SA,0.0,50000.0,,2018,2,8,CHECK_CASHING,50000.0,M1468774738
16613,1196428',2018-02-08,IMPS 803915111442 FROM SA,0.0,30000.0,,2018,2,8,CASH_IN,30000.0,M266577647
16614,1196428',2018-02-08,NEFT/N039180471244462/PAY,0.0,524726.72,,2018,2,8,CHECK_CASHING,524726.72,M1474343674
16615,1196428',2018-02-08,FDRL/INTERNAL FUND TRANSFE,0.0,2000000.0,,2018,2,8,CASH_IN,2000000.0,M1664266643
16616,1196428',2018-02-08,FDRL/INTERNAL FUND TRANSFE,0.0,2000000.0,,2018,2,8,TRANSFER,2000000.0,M842463018
16617,1196428',2018-02-08,RTGS/IDFBH18039301036/ART,0.0,10000000.0,,2018,2,8,CHECK_CASHING,10000000.0,M284325832
16618,1196428',2018-02-08,RTGS/IDFBH18039301035/ART,0.0,10000000.0,,2018,2,8,CHECK_CASHING,10000000.0,M1784760424
16619,1196428',2018-02-08,FDRL/NATIONAL ELECTRONIC F,10000000.0,0.0,,2018,2,8,DEBIT,10000000.0,M1489026763
16620,1196428',2018-02-08,RTGS/IDFBH18039301037/ART,0.0,10000000.0,,2018,2,8,TRANSFER,10000000.0,C1800405372
16621,1196428',2018-02-08,NEFT/AXISP18039081922/ACC,0.0,4000000.0,,2018,2,8,CASH_IN,4000000.0,C2071512077
16622,1196428',2018-02-08,NEFT/N039180471245137/PAY,0.0,1281040.99,,2018,2,8,CHECK_CASHING,1281040.99,C1588635270
16623,1196428',2018-02-08,FDRL/NATIONAL ELECTRONIC F,10000000.0,0.0,,2018,2,8,PAYEMENT,10000000.0,C1495001462
16624,1196428',2018-02-08,FDRL/NATIONAL ELECTRONIC F,10000000.0,0.0,,2018,2,8,CASH_OUT,10000000.0,M84558619
16625,1196428',2018-02-08,Indiaforensic SERVICES INDIA PVT,0.0,594070.0,,2018,2,8,TRANSFER,594070.0,M113925453
16626,1196428',2018-02-08,TRF FROM  Indiaforensic SERVICES,0.0,11300000.0,,2018,2,8,CASH_IN,11300000.0,M645245228
16627,1196428',2018-02-08,FDRL/NATIONAL ELECTRONIC F,314888.0,0.0,,2018,2,8,CHECK_WITHDRAWAL,314888.0,M636094317
16628,1196428',2018-02-08,FDRL/NATIONAL ELECTRONIC F,5000000.0,0.0,,2018,2,8,CHECK_WITHDRAWAL,5000000.0,M1583961850
16629,1196428',2018-02-08,FDRL/INTERNAL FUND TRANSFE,500000.0,0.0,,2018,2,8,CASH_OUT,500000.0,M708029389
16630,1196428',2018-02-08,FDRL/INTERNAL FUND TRANSFE,500000.0,0.0,,2018,2,8,PAYEMENT,500000.0,M508231066
16631,1196428',2018-02-08,YOURSELF FOR BULK NEFT  B,2000000.0,0.0,,2018,2,8,CASH_OUT,2000000.0,C1838491463
16632,1196428',2018-02-08,YOURSELF FOR BULK NEFT  B,6016960.0,0.0,,2018,2,8,PAYEMENT,6016960.0,M1094448975
16633,1196428',2018-02-08,TRF FROM  Indiaforensic SERVICES,0.0,3000000.0,,2018,2,8,CASH_IN,3000000.0,M717841651
16634,1196428',2018-02-08,BEAT CSH PKP DEL GURG 617,0.0,271500.0,,2018,2,8,TRANSFER,271500.0,M1954167102
16635,1196428',2018-02-08,FDRL/INTERNAL FUND TRANSFE,10000000.0,0.0,,2018,2,8,CHECK_WITHDRAWAL,10000000.0,M1043087369
16636,1196428',2018-02-08,FDRL/INTERNAL FUND TRANSFE,1000000.0,0.0,,2018,2,8,CHECK_WITHDRAWAL,1000000.0,M1489610760
16637,1196428',2018-02-09,RTGS/HDFCH18040915828/PAY,0.0,3200000.0,,2018,2,9,TRANSFER,3200000.0,C1556875182
16638,1196428',2018-02-09,RTGS/HDFCH18040917142/PAY,0.0,5120000.0,,2018,2,9,CASH_IN,5120000.0,M1109811596
16639,1196428',2018-02-09,FDRL/REAL TIME GROSS SETTL,5000000.0,0.0,,2018,2,9,DEBIT,5000000.0,C101571284
16640,1196428',2018-02-09,FDRL/REAL TIME GROSS SETTL,3000000.0,0.0,,2018,2,9,CASH_OUT,3000000.0,M178952563
16641,1196428',2018-02-09,IB:TPFT0056012631 4090004,0.0,10000.0,,2018,2,9,CASH_IN,10000.0,M2081263541
16642,1196428',2018-02-09,NEFT/SBIN518040422465/ARV,0.0,11800.0,,2018,2,9,CHECK_CASHING,11800.0,C2078250226
16643,1196428',2018-02-09,IMPS 804012832324 FROM DA,0.0,40000.0,,2018,2,9,CHECK_CASHING,40000.0,C1570256460
16644,1196428',2018-02-09,FDRL/INTERNAL FUND TRANSFE,0.0,2000000.0,,2018,2,9,TRANSFER,2000000.0,M441055416
16645,1196428',2018-02-09,FDRL/INTERNAL FUND TRANSFE,0.0,2000000.0,,2018,2,9,TRANSFER,2000000.0,C2077098348
16646,1196428',2018-02-09,CASHDEP/VIKASMARG/TP,0.0,61500.0,,2018,2,9,CHECK_CASHING,61500.0,C1062254208
16647,1196428',2018-02-09,FDRL/NATIONAL ELECTRONIC F,100000.0,0.0,,2018,2,9,DEBIT,100000.0,C1787868648
16648,1196428',2018-02-09,FDRL/NATIONAL ELECTRONIC F,100000.0,0.0,,2018,2,9,PAYEMENT,100000.0,C161140376
16649,1196428',2018-02-09,NEFT/N040180472197092/PAY,0.0,836709.06,,2018,2,9,TRANSFER,836709.06,M1471351873
16650,1196428',2018-02-09,NEFT/N040180472206327/PAY,0.0,1861135.02,,2018,2,9,TRANSFER,1861135.02,M1328437771
16651,1196428',2018-02-09,FDRL/INTERNAL FUND TRANSFE,200000.0,0.0,,2018,2,9,PAYEMENT,200000.0,M341537411
16652,1196428',2018-02-09,FDRL/INTERNAL FUND TRANSFE,300000.0,0.0,,2018,2,9,PAYEMENT,300000.0,M1367049026
16653,1196428',2018-02-09,"Indiaforensic USA, INC./USD/2830",0.0,1811830.02,,2018,2,9,CHECK_CASHING,1811830.02,C2029310301
16654,1196428',2018-02-09,IRTT00701804260,1431.13,0.0,,2018,2,9,CHECK_WITHDRAWAL,1431.13,C1606699851
16655,1196428',2018-02-09,TRF FROM  Indiaforensic SERVICES,0.0,11200000.0,,2018,2,9,CASH_IN,11200000.0,C1103621993
16656,1196428',2018-02-09,FDRL/NATIONAL ELECTRONIC F,18425.0,0.0,,2018,2,9,CHECK_WITHDRAWAL,18425.0,M34447014
16657,1196428',2018-02-09,FDRL/NATIONAL ELECTRONIC F,26532.0,0.0,,2018,2,9,DEBIT,26532.0,C1428675504
16658,1196428',2018-02-09,FDRL/NATIONAL ELECTRONIC F,19788.0,0.0,,2018,2,9,PAYEMENT,19788.0,M1783999682
16659,1196428',2018-02-09,FDRL/NATIONAL ELECTRONIC F,29683.0,0.0,,2018,2,9,CASH_OUT,29683.0,C1247600089
16660,1196428',2018-02-09,FDRL/NATIONAL ELECTRONIC F,23150.0,0.0,,2018,2,9,DEBIT,23150.0,M835388411
16661,1196428',2018-02-09,FDRL/NATIONAL ELECTRONIC F,13029.0,0.0,,2018,2,9,CHECK_WITHDRAWAL,13029.0,C404279307
16662,1196428',2018-02-09,FDRL/NATIONAL ELECTRONIC F,29683.0,0.0,,2018,2,9,DEBIT,29683.0,C278407008
16663,1196428',2018-02-09,FDRL/NATIONAL ELECTRONIC F,16227.0,0.0,,2018,2,9,DEBIT,16227.0,M1721234210
16664,1196428',2018-02-09,FDRL/NATIONAL ELECTRONIC F,13438.0,0.0,,2018,2,9,PAYEMENT,13438.0,M1576908104
16665,1196428',2018-02-09,FDRL/NATIONAL ELECTRONIC F,26243.0,0.0,,2018,2,9,CASH_OUT,26243.0,M1547162536
16666,1196428',2018-02-09,FDRL/NATIONAL ELECTRONIC F,13029.0,0.0,,2018,2,9,DEBIT,13029.0,M1057827479
16667,1196428',2018-02-09,FDRL/NATIONAL ELECTRONIC F,17942.0,0.0,,2018,2,9,DEBIT,17942.0,M1498878973
16668,1196428',2018-02-09,FDRL/NATIONAL ELECTRONIC F,20606.0,0.0,,2018,2,9,PAYEMENT,20606.0,M1420281457
16669,1196428',2018-02-09,FDRL/NATIONAL ELECTRONIC F,24459.0,0.0,,2018,2,9,PAYEMENT,24459.0,M2000558609
16670,1196428',2018-02-09,FDRL/NATIONAL ELECTRONIC F,28750.0,0.0,,2018,2,9,CHECK_WITHDRAWAL,28750.0,M1598229594
16671,1196428',2018-02-09,FDRL/NATIONAL ELECTRONIC F,14970.0,0.0,,2018,2,9,CASH_OUT,14970.0,M2001514483
16672,1196428',2018-02-09,FDRL/NATIONAL ELECTRONIC F,20672.0,0.0,,2018,2,9,CASH_OUT,20672.0,M1808413339
16673,1196428',2018-02-09,FDRL/NATIONAL ELECTRONIC F,17656.0,0.0,,2018,2,9,DEBIT,17656.0,M662376084
16674,1196428',2018-02-09,FDRL/NATIONAL ELECTRONIC F,9733.0,0.0,,2018,2,9,PAYEMENT,9733.0,M1462583713
16675,1196428',2018-02-09,FDRL/NATIONAL ELECTRONIC F,26350.0,0.0,,2018,2,9,DEBIT,26350.0,M1292178703
16676,1196428',2018-02-09,FDRL/NATIONAL ELECTRONIC F,18314.0,0.0,,2018,2,9,CHECK_WITHDRAWAL,18314.0,M1378894443
16677,1196428',2018-02-09,FDRL/NATIONAL ELECTRONIC F,18314.0,0.0,,2018,2,9,DEBIT,18314.0,M671194471
16678,1196428',2018-02-09,FDRL/NATIONAL ELECTRONIC F,28610.0,0.0,,2018,2,9,CASH_OUT,28610.0,M2120887477
16679,1196428',2018-02-09,FDRL/NATIONAL ELECTRONIC F,26050.0,0.0,,2018,2,9,CHECK_WITHDRAWAL,26050.0,M1565473666
16680,1196428',2018-02-09,FDRL/NATIONAL ELECTRONIC F,14062.0,0.0,,2018,2,9,DEBIT,14062.0,M336600403
16681,1196428',2018-02-09,FDRL/NATIONAL ELECTRONIC F,20038.0,0.0,,2018,2,9,PAYEMENT,20038.0,M1108314788
16682,1196428',2018-02-09,FDRL/NATIONAL ELECTRONIC F,28610.0,0.0,,2018,2,9,PAYEMENT,28610.0,M1776708407
16683,1196428',2018-02-09,FDRL/NATIONAL ELECTRONIC F,28610.0,0.0,,2018,2,9,DEBIT,28610.0,M1886072816
16684,1196428',2018-02-09,FDRL/NATIONAL ELECTRONIC F,17837.0,0.0,,2018,2,9,CHECK_WITHDRAWAL,17837.0,M392269298
16685,1196428',2018-02-09,FDRL/NATIONAL ELECTRONIC F,14368.0,0.0,,2018,2,9,CHECK_WITHDRAWAL,14368.0,M240263357
16686,1196428',2018-02-09,FDRL/NATIONAL ELECTRONIC F,18186.0,0.0,,2018,2,9,DEBIT,18186.0,M2137827177
16687,1196428',2018-02-09,FDRL/NATIONAL ELECTRONIC F,18315.0,0.0,,2018,2,9,DEBIT,18315.0,M996688653
16688,1196428',2018-02-09,FDRL/NATIONAL ELECTRONIC F,19498.0,0.0,,2018,2,9,CASH_OUT,19498.0,C1829831147
16689,1196428',2018-02-09,FDRL/NATIONAL ELECTRONIC F,14002.0,0.0,,2018,2,9,CHECK_WITHDRAWAL,14002.0,M720435458
16690,1196428',2018-02-09,FDRL/NATIONAL ELECTRONIC F,28611.0,0.0,,2018,2,9,CASH_OUT,28611.0,M29096009
16691,1196428',2018-02-09,FDRL/NATIONAL ELECTRONIC F,12373.0,0.0,,2018,2,9,PAYEMENT,12373.0,M150995440
16692,1196428',2018-02-09,FDRL/NATIONAL ELECTRONIC F,21248.0,0.0,,2018,2,9,CHECK_WITHDRAWAL,21248.0,M1241251535
16693,1196428',2018-02-09,FDRL/NATIONAL ELECTRONIC F,15004.0,0.0,,2018,2,9,PAYEMENT,15004.0,M1254542588
16694,1196428',2018-02-09,FDRL/NATIONAL ELECTRONIC F,15154.0,0.0,,2018,2,9,CASH_OUT,15154.0,M710538853
16695,1196428',2018-02-09,FDRL/NATIONAL ELECTRONIC F,22997.0,0.0,,2018,2,9,DEBIT,22997.0,M399672840
16696,1196428',2018-02-09,FDRL/NATIONAL ELECTRONIC F,22997.0,0.0,,2018,2,9,CASH_OUT,22997.0,M1566931514
16697,1196428',2018-02-09,FDRL/NATIONAL ELECTRONIC F,12852.0,0.0,,2018,2,9,CASH_OUT,12852.0,C1540270363
16698,1196428',2018-02-09,FDRL/NATIONAL ELECTRONIC F,29340.0,0.0,,2018,2,9,DEBIT,29340.0,C900425684
16699,1196428',2018-02-09,FDRL/NATIONAL ELECTRONIC F,15779.0,0.0,,2018,2,9,DEBIT,15779.0,M1361294362
16700,1196428',2018-02-09,FDRL/NATIONAL ELECTRONIC F,14667.0,0.0,,2018,2,9,DEBIT,14667.0,C264843581
16701,1196428',2018-02-09,FDRL/NATIONAL ELECTRONIC F,35926.0,0.0,,2018,2,9,DEBIT,35926.0,M1897445965
16702,1196428',2018-02-09,FDRL/NATIONAL ELECTRONIC F,34245.0,0.0,,2018,2,9,DEBIT,34245.0,M345439288
16703,1196428',2018-02-09,FDRL/NATIONAL ELECTRONIC F,39242.0,0.0,,2018,2,9,CHECK_WITHDRAWAL,39242.0,M2130477201
16704,1196428',2018-02-09,FDRL/NATIONAL ELECTRONIC F,31942.0,0.0,,2018,2,9,DEBIT,31942.0,M1516263359
16705,1196428',2018-02-09,FDRL/NATIONAL ELECTRONIC F,31145.0,0.0,,2018,2,9,DEBIT,31145.0,M508839235
16706,1196428',2018-02-09,FDRL/NATIONAL ELECTRONIC F,30659.0,0.0,,2018,2,9,DEBIT,30659.0,M530611995
16707,1196428',2018-02-09,FDRL/NATIONAL ELECTRONIC F,36674.0,0.0,,2018,2,9,CHECK_WITHDRAWAL,36674.0,C1761324386
16708,1196428',2018-02-09,FDRL/NATIONAL ELECTRONIC F,42060.0,0.0,,2018,2,9,CASH_OUT,42060.0,C90486891
16709,1196428',2018-02-09,FDRL/NATIONAL ELECTRONIC F,39565.0,0.0,,2018,2,9,PAYEMENT,39565.0,C573200870
16710,1196428',2018-02-09,FDRL/NATIONAL ELECTRONIC F,30344.0,0.0,,2018,2,9,DEBIT,30344.0,C1825992554
16711,1196428',2018-02-09,FDRL/NATIONAL ELECTRONIC F,37295.0,0.0,,2018,2,9,CHECK_WITHDRAWAL,37295.0,M1278682262
16712,1196428',2018-02-09,FDRL/NATIONAL ELECTRONIC F,38680.0,0.0,,2018,2,9,PAYEMENT,38680.0,M2009652577
16713,1196428',2018-02-09,FDRL/NATIONAL ELECTRONIC F,38573.0,0.0,,2018,2,9,PAYEMENT,38573.0,M1504904868
16714,1196428',2018-02-09,FDRL/NATIONAL ELECTRONIC F,34573.0,0.0,,2018,2,9,DEBIT,34573.0,C88226327
16715,1196428',2018-02-09,FDRL/NATIONAL ELECTRONIC F,34787.0,0.0,,2018,2,9,PAYEMENT,34787.0,M203497386
16716,1196428',2018-02-09,FDRL/NATIONAL ELECTRONIC F,30967.0,0.0,,2018,2,9,PAYEMENT,30967.0,M1264078907
16717,1196428',2018-02-09,FDRL/NATIONAL ELECTRONIC F,38487.0,0.0,,2018,2,9,CASH_OUT,38487.0,M1870838648
16718,1196428',2018-02-09,FDRL/NATIONAL ELECTRONIC F,31845.0,0.0,,2018,2,9,PAYEMENT,31845.0,C1683963531
16719,1196428',2018-02-09,FDRL/NATIONAL ELECTRONIC F,33017.0,0.0,,2018,2,9,DEBIT,33017.0,M620120832
16720,1196428',2018-02-09,FDRL/NATIONAL ELECTRONIC F,30870.0,0.0,,2018,2,9,CHECK_WITHDRAWAL,30870.0,M37714710
16721,1196428',2018-02-09,FDRL/NATIONAL ELECTRONIC F,32527.0,0.0,,2018,2,9,PAYEMENT,32527.0,M1135370372
16722,1196428',2018-02-09,FDRL/NATIONAL ELECTRONIC F,33990.0,0.0,,2018,2,9,DEBIT,33990.0,C1700355047
16723,1196428',2018-02-09,FDRL/NATIONAL ELECTRONIC F,37390.0,0.0,,2018,2,9,CHECK_WITHDRAWAL,37390.0,C1884600481
16724,1196428',2018-02-09,FDRL/NATIONAL ELECTRONIC F,32277.0,0.0,,2018,2,9,DEBIT,32277.0,C1105527690
16725,1196428',2018-02-09,FDRL/NATIONAL ELECTRONIC F,34180.0,0.0,,2018,2,9,DEBIT,34180.0,M714819629
16726,1196428',2018-02-09,FDRL/NATIONAL ELECTRONIC F,32277.0,0.0,,2018,2,9,DEBIT,32277.0,M722465639
16727,1196428',2018-02-09,FDRL/NATIONAL ELECTRONIC F,31920.0,0.0,,2018,2,9,PAYEMENT,31920.0,C801412408
16728,1196428',2018-02-09,FDRL/NATIONAL ELECTRONIC F,47366.0,0.0,,2018,2,9,DEBIT,47366.0,M1678349105
16729,1196428',2018-02-09,FDRL/NATIONAL ELECTRONIC F,30667.0,0.0,,2018,2,9,DEBIT,30667.0,C35534346
16730,1196428',2018-02-09,FDRL/NATIONAL ELECTRONIC F,83500.0,0.0,,2018,2,9,CASH_OUT,83500.0,C943166837
16731,1196428',2018-02-09,FDRL/NATIONAL ELECTRONIC F,62167.0,0.0,,2018,2,9,CASH_OUT,62167.0,M1063088470
16732,1196428',2018-02-09,FDRL/NATIONAL ELECTRONIC F,50418.0,0.0,,2018,2,9,CHECK_WITHDRAWAL,50418.0,M634480856
16733,1196428',2018-02-09,FDRL/NATIONAL ELECTRONIC F,36725.0,0.0,,2018,2,9,DEBIT,36725.0,M1229660324
16734,1196428',2018-02-09,FDRL/NATIONAL ELECTRONIC F,77041.0,0.0,,2018,2,9,CASH_OUT,77041.0,M1995775202
16735,1196428',2018-02-09,FDRL/NATIONAL ELECTRONIC F,54932.0,0.0,,2018,2,9,PAYEMENT,54932.0,M982735022
16736,1196428',2018-02-09,FDRL/NATIONAL ELECTRONIC F,56636.0,0.0,,2018,2,9,CASH_OUT,56636.0,C1754722089
16737,1196428',2018-02-09,FDRL/NATIONAL ELECTRONIC F,72710.0,0.0,,2018,2,9,CHECK_WITHDRAWAL,72710.0,M536571624
16738,1196428',2018-02-09,FDRL/NATIONAL ELECTRONIC F,65377.0,0.0,,2018,2,9,DEBIT,65377.0,C1498878963
16739,1196428',2018-02-09,FDRL/NATIONAL ELECTRONIC F,33017.0,0.0,,2018,2,9,PAYEMENT,33017.0,C1962165946
16740,1196428',2018-02-09,FDRL/NATIONAL ELECTRONIC F,51344.0,0.0,,2018,2,9,PAYEMENT,51344.0,M1170462195
16741,1196428',2018-02-09,FDRL/NATIONAL ELECTRONIC F,68749.0,0.0,,2018,2,9,PAYEMENT,68749.0,C414205222
16742,1196428',2018-02-09,FDRL/NATIONAL ELECTRONIC F,64691.0,0.0,,2018,2,9,CHECK_WITHDRAWAL,64691.0,M1229413386
16743,1196428',2018-02-09,FDRL/NATIONAL ELECTRONIC F,66767.0,0.0,,2018,2,9,CHECK_WITHDRAWAL,66767.0,M712447692
16744,1196428',2018-02-09,FDRL/NATIONAL ELECTRONIC F,78180.0,0.0,,2018,2,9,CHECK_WITHDRAWAL,78180.0,C269902384
16745,1196428',2018-02-09,FDRL/NATIONAL ELECTRONIC F,62266.0,0.0,,2018,2,9,PAYEMENT,62266.0,C955097010
16746,1196428',2018-02-09,FDRL/NATIONAL ELECTRONIC F,60000.0,0.0,,2018,2,9,DEBIT,60000.0,C1827996167
16747,1196428',2018-02-09,FDRL/NATIONAL ELECTRONIC F,59740.0,0.0,,2018,2,9,CHECK_WITHDRAWAL,59740.0,M30162194
16748,1196428',2018-02-09,FDRL/NATIONAL ELECTRONIC F,52500.0,0.0,,2018,2,9,CASH_OUT,52500.0,C1115240385
16749,1196428',2018-02-09,FDRL/NATIONAL ELECTRONIC F,53159.0,0.0,,2018,2,9,CHECK_WITHDRAWAL,53159.0,M1710595137
16750,1196428',2018-02-09,FDRL/NATIONAL ELECTRONIC F,15004.0,0.0,,2018,2,9,CASH_OUT,15004.0,M970087106
16751,1196428',2018-02-09,FDRL/NATIONAL ELECTRONIC F,75500.0,0.0,,2018,2,9,PAYEMENT,75500.0,M561635968
16752,1196428',2018-02-09,FDRL/NATIONAL ELECTRONIC F,116234.0,0.0,,2018,2,9,CHECK_WITHDRAWAL,116234.0,C440480434
16753,1196428',2018-02-09,FDRL/NATIONAL ELECTRONIC F,18564.0,0.0,,2018,2,9,CASH_OUT,18564.0,C46748390
16754,1196428',2018-02-09,FDRL/NATIONAL ELECTRONIC F,14101.0,0.0,,2018,2,9,CASH_OUT,14101.0,M976616410
16755,1196428',2018-02-09,FDRL/NATIONAL ELECTRONIC F,55492.0,0.0,,2018,2,9,CHECK_WITHDRAWAL,55492.0,M1796408655
16756,1196428',2018-02-09,FDRL/NATIONAL ELECTRONIC F,21053.0,0.0,,2018,2,9,CHECK_WITHDRAWAL,21053.0,M424513770
16757,1196428',2018-02-09,FDRL/NATIONAL ELECTRONIC F,23299.0,0.0,,2018,2,9,PAYEMENT,23299.0,M1867357103
16758,1196428',2018-02-09,FDRL/NATIONAL ELECTRONIC F,22767.0,0.0,,2018,2,9,PAYEMENT,22767.0,M215680372
16759,1196428',2018-02-09,FDRL/NATIONAL ELECTRONIC F,15952.0,0.0,,2018,2,9,DEBIT,15952.0,M764256713
16760,1196428',2018-02-09,FDRL/NATIONAL ELECTRONIC F,20556.0,0.0,,2018,2,9,CHECK_WITHDRAWAL,20556.0,M538413261
16761,1196428',2018-02-09,FDRL/NATIONAL ELECTRONIC F,21495.0,0.0,,2018,2,9,CHECK_WITHDRAWAL,21495.0,M942160595
16762,1196428',2018-02-09,FDRL/NATIONAL ELECTRONIC F,20000.0,0.0,,2018,2,9,CASH_OUT,20000.0,M1319156415
16763,1196428',2018-02-09,FDRL/NATIONAL ELECTRONIC F,29500.0,0.0,,2018,2,9,CHECK_WITHDRAWAL,29500.0,M361847129
16764,1196428',2018-02-09,FDRL/NATIONAL ELECTRONIC F,15487.0,0.0,,2018,2,9,PAYEMENT,15487.0,C1790202239
16765,1196428',2018-02-09,FDRL/NATIONAL ELECTRONIC F,13080.0,0.0,,2018,2,9,DEBIT,13080.0,M955868325
16766,1196428',2018-02-09,FDRL/NATIONAL ELECTRONIC F,17375.0,0.0,,2018,2,9,PAYEMENT,17375.0,M1251133153
16767,1196428',2018-02-09,FDRL/NATIONAL ELECTRONIC F,19838.0,0.0,,2018,2,9,CHECK_WITHDRAWAL,19838.0,M1854311181
16768,1196428',2018-02-09,FDRL/NATIONAL ELECTRONIC F,18270.0,0.0,,2018,2,9,CHECK_WITHDRAWAL,18270.0,C928023753
16769,1196428',2018-02-09,FDRL/NATIONAL ELECTRONIC F,13589.0,0.0,,2018,2,9,PAYEMENT,13589.0,M771609335
16770,1196428',2018-02-09,FDRL/NATIONAL ELECTRONIC F,19543.0,0.0,,2018,2,9,CHECK_WITHDRAWAL,19543.0,C1452722471
16771,1196428',2018-02-09,FDRL/NATIONAL ELECTRONIC F,20583.0,0.0,,2018,2,9,CASH_OUT,20583.0,M1625968481
16772,1196428',2018-02-09,FDRL/NATIONAL ELECTRONIC F,9737.0,0.0,,2018,2,9,DEBIT,9737.0,M458727925
16773,1196428',2018-02-09,FDRL/NATIONAL ELECTRONIC F,19680.0,0.0,,2018,2,9,PAYEMENT,19680.0,C111210112
16774,1196428',2018-02-09,FDRL/NATIONAL ELECTRONIC F,28341.0,0.0,,2018,2,9,DEBIT,28341.0,C464246030
16775,1196428',2018-02-09,FDRL/NATIONAL ELECTRONIC F,24343.0,0.0,,2018,2,9,CHECK_WITHDRAWAL,24343.0,M2080752777
16776,1196428',2018-02-09,FDRL/NATIONAL ELECTRONIC F,18418.0,0.0,,2018,2,9,DEBIT,18418.0,M1357563045
16777,1196428',2018-02-09,FDRL/NATIONAL ELECTRONIC F,26177.0,0.0,,2018,2,9,PAYEMENT,26177.0,M68500741
16778,1196428',2018-02-09,FDRL/NATIONAL ELECTRONIC F,21998.0,0.0,,2018,2,9,CASH_OUT,21998.0,C1664330755
16779,1196428',2018-02-09,FDRL/NATIONAL ELECTRONIC F,20446.0,0.0,,2018,2,9,CHECK_WITHDRAWAL,20446.0,C1823014131
16780,1196428',2018-02-09,FDRL/NATIONAL ELECTRONIC F,23968.0,0.0,,2018,2,9,DEBIT,23968.0,M1293355387
16781,1196428',2018-02-09,FDRL/NATIONAL ELECTRONIC F,27559.0,0.0,,2018,2,9,DEBIT,27559.0,M34599177
16782,1196428',2018-02-09,FDRL/NATIONAL ELECTRONIC F,14876.0,0.0,,2018,2,9,CASH_OUT,14876.0,M685059787
16783,1196428',2018-02-09,FDRL/NATIONAL ELECTRONIC F,23347.0,0.0,,2018,2,9,CHECK_WITHDRAWAL,23347.0,M376456946
16784,1196428',2018-02-09,FDRL/NATIONAL ELECTRONIC F,22658.0,0.0,,2018,2,9,CHECK_WITHDRAWAL,22658.0,M793798217
16785,1196428',2018-02-09,FDRL/NATIONAL ELECTRONIC F,28610.0,0.0,,2018,2,9,CASH_OUT,28610.0,C264685626
16786,1196428',2018-02-09,FDRL/NATIONAL ELECTRONIC F,12358.0,0.0,,2018,2,9,PAYEMENT,12358.0,M954243999
16787,1196428',2018-02-09,FDRL/NATIONAL ELECTRONIC F,15765.0,0.0,,2018,2,9,CHECK_WITHDRAWAL,15765.0,C1816986148
16788,1196428',2018-02-09,FDRL/NATIONAL ELECTRONIC F,17678.0,0.0,,2018,2,9,CHECK_WITHDRAWAL,17678.0,C1144527317
16789,1196428',2018-02-09,FDRL/NATIONAL ELECTRONIC F,25713.0,0.0,,2018,2,9,CASH_OUT,25713.0,C1790831319
16790,1196428',2018-02-09,FDRL/NATIONAL ELECTRONIC F,26338.0,0.0,,2018,2,9,CHECK_WITHDRAWAL,26338.0,C571435580
16791,1196428',2018-02-09,FDRL/NATIONAL ELECTRONIC F,26338.0,0.0,,2018,2,9,CASH_OUT,26338.0,C1262016786
16792,1196428',2018-02-09,FDRL/NATIONAL ELECTRONIC F,18164.0,0.0,,2018,2,9,CASH_OUT,18164.0,C1287328228
16793,1196428',2018-02-09,FDRL/NATIONAL ELECTRONIC F,24045.0,0.0,,2018,2,9,CHECK_WITHDRAWAL,24045.0,C329473339
16794,1196428',2018-02-09,FDRL/NATIONAL ELECTRONIC F,18113.0,0.0,,2018,2,9,DEBIT,18113.0,C1354725727
16795,1196428',2018-02-09,FDRL/NATIONAL ELECTRONIC F,20378.0,0.0,,2018,2,9,DEBIT,20378.0,C1300519073
16796,1196428',2018-02-09,FDRL/NATIONAL ELECTRONIC F,19838.0,0.0,,2018,2,9,DEBIT,19838.0,C2052185144
16797,1196428',2018-02-09,FDRL/NATIONAL ELECTRONIC F,23719.0,0.0,,2018,2,9,PAYEMENT,23719.0,C1485516154
16798,1196428',2018-02-09,FDRL/NATIONAL ELECTRONIC F,24045.0,0.0,,2018,2,9,PAYEMENT,24045.0,C2143477943
16799,1196428',2018-02-09,FDRL/NATIONAL ELECTRONIC F,21343.0,0.0,,2018,2,9,DEBIT,21343.0,C476402209
16800,1196428',2018-02-09,FDRL/NATIONAL ELECTRONIC F,20856.0,0.0,,2018,2,9,PAYEMENT,20856.0,C1255024717
16801,1196428',2018-02-09,FDRL/NATIONAL ELECTRONIC F,12427.0,0.0,,2018,2,9,CASH_OUT,12427.0,C1870367457
16802,1196428',2018-02-09,FDRL/NATIONAL ELECTRONIC F,24107.0,0.0,,2018,2,9,DEBIT,24107.0,C465257140
16803,1196428',2018-02-09,FDRL/NATIONAL ELECTRONIC F,29982.0,0.0,,2018,2,9,DEBIT,29982.0,C745740822
16804,1196428',2018-02-09,FDRL/NATIONAL ELECTRONIC F,26338.0,0.0,,2018,2,9,CHECK_WITHDRAWAL,26338.0,C1390121014
16805,1196428',2018-02-09,FDRL/NATIONAL ELECTRONIC F,20129.0,0.0,,2018,2,9,PAYEMENT,20129.0,C1481851679
16806,1196428',2018-02-09,FDRL/INTERNAL FUND TRANSFE,0.0,3000000.0,,2018,2,9,TRANSFER,3000000.0,C741431520
16807,1196428',2018-02-09,FDRL/INTERNAL FUND TRANSFE,0.0,2000000.0,,2018,2,9,CHECK_CASHING,2000000.0,C758888772
16808,1196428',2018-02-09,NEFT/000031080477/ACCOUNT,0.0,14667.0,,2018,2,9,CASH_IN,14667.0,C1001409363
16809,1196428',2018-02-09,FDRL/INTERNAL FUND TRANSFE,0.0,1000000.0,,2018,2,9,TRANSFER,1000000.0,M1340854901
16810,1196428',2018-02-09,FDRL/INTERNAL FUND TRANSFE,0.0,3000000.0,,2018,2,9,CHECK_CASHING,3000000.0,M265997755
16811,1196428',2018-02-09,FDRL/INTERNAL FUND TRANSFE,0.0,3000000.0,,2018,2,9,CHECK_CASHING,3000000.0,M1257695233
16812,1196428',2018-02-09,NEFT/AXISP18040137544/ACC,0.0,18000000.0,,2018,2,9,CASH_IN,18000000.0,C150309335
16813,1196428',2018-02-09,NEFT/AXISP18040136949/ACC,0.0,5000000.0,,2018,2,9,CHECK_CASHING,5000000.0,M1572611628
16814,1196428',2018-02-09,TRF FROM  Indiaforensic SERVICES,0.0,4000000.0,,2018,2,9,CHECK_CASHING,4000000.0,M280183141
16815,1196428',2018-02-09,YOURSELF FOR BULK NEFT  B,14430000.0,0.0,,2018,2,9,DEBIT,14430000.0,M808540700
16816,1196428',2018-02-09,NEFT CHARGES AND GST/0000,29.5,0.0,,2018,2,9,PAYEMENT,29.5,M565481399
16817,1196428',2018-02-09,NEFT/000031082581/BHARTI,995000.0,0.0,,2018,2,9,CASH_OUT,995000.0,C842729010
16818,1196428',2018-02-09,NEFT/000031080473/INVALID,0.0,15004.0,,2018,2,9,CASH_IN,15004.0,M178371442
16819,1196428',2018-02-09,NEFT/000031080580/ACCOUNT,0.0,53159.0,,2018,2,9,TRANSFER,53159.0,M2076445832
16820,1196428',2018-02-09,FDRL/INTERNAL FUND TRANSFE,10000000.0,0.0,,2018,2,9,DEBIT,10000000.0,C599968109
16821,1196428',2018-02-09,FDRL/INTERNAL FUND TRANSFE,10000000.0,0.0,,2018,2,9,PAYEMENT,10000000.0,C599265282
16822,1196428',2018-02-09,FDRL/INTERNAL FUND TRANSFE,10000000.0,0.0,,2018,2,9,CHECK_WITHDRAWAL,10000000.0,C669771073
16823,1196428',2018-02-09,FDRL/INTERNAL FUND TRANSFE,3000000.0,0.0,,2018,2,9,CHECK_WITHDRAWAL,3000000.0,C2137848242
16824,1196428',2018-02-09,BEAT CSH PKP DEL GURG 617,0.0,637000.0,,2018,2,9,CHECK_CASHING,637000.0,M997986347
16825,1196428',2018-02-09,FDRL/INTERNAL FUND TRANSFE,2000000.0,0.0,,2018,2,9,DEBIT,2000000.0,M1063792159
16826,1196428',2018-02-09,FDRL/INTERNAL FUND TRANSFE,3000000.0,0.0,,2018,2,9,PAYEMENT,3000000.0,C22448303
16827,1196428',2018-02-09,FDRL/INTERNAL FUND TRANSFE,0.0,1000000.0,,2018,2,9,TRANSFER,1000000.0,M315692635
16828,1196428',2018-02-09,FDRL/INTERNAL FUND TRANSFE,2000000.0,0.0,,2018,2,9,CASH_OUT,2000000.0,M803644277
16829,1196428',2018-02-12,FDRL/NATIONAL ELECTRONIC F,20980.0,0.0,,2018,2,12,CASH_OUT,20980.0,M415913007
16830,1196428',2018-02-12,FDRL/NATIONAL ELECTRONIC F,23317.0,0.0,,2018,2,12,CHECK_WITHDRAWAL,23317.0,M1344197461
16831,1196428',2018-02-12,FDRL/NATIONAL ELECTRONIC F,13446.0,0.0,,2018,2,12,PAYEMENT,13446.0,M132014623
16832,1196428',2018-02-12,FDRL/NATIONAL ELECTRONIC F,21101.0,0.0,,2018,2,12,PAYEMENT,21101.0,M577051450
16833,1196428',2018-02-12,FDRL/NATIONAL ELECTRONIC F,17623.0,0.0,,2018,2,12,PAYEMENT,17623.0,C1491676195
16834,1196428',2018-02-12,FDRL/NATIONAL ELECTRONIC F,28868.0,0.0,,2018,2,12,CASH_OUT,28868.0,C943166837
16835,1196428',2018-02-12,FDRL/NATIONAL ELECTRONIC F,25680.0,0.0,,2018,2,12,DEBIT,25680.0,M1402953791
16836,1196428',2018-02-12,FDRL/NATIONAL ELECTRONIC F,13279.0,0.0,,2018,2,12,DEBIT,13279.0,M1974589236
16837,1196428',2018-02-12,FDRL/NATIONAL ELECTRONIC F,14525.0,0.0,,2018,2,12,PAYEMENT,14525.0,C1701412896
16838,1196428',2018-02-12,FDRL/NATIONAL ELECTRONIC F,25740.0,0.0,,2018,2,12,DEBIT,25740.0,M1355606971
16839,1196428',2018-02-12,FDRL/NATIONAL ELECTRONIC F,16651.0,0.0,,2018,2,12,PAYEMENT,16651.0,M1037747072
16840,1196428',2018-02-12,FDRL/NATIONAL ELECTRONIC F,17972.0,0.0,,2018,2,12,DEBIT,17972.0,M82220349
16841,1196428',2018-02-12,FDRL/NATIONAL ELECTRONIC F,14521.0,0.0,,2018,2,12,CASH_OUT,14521.0,M953439482
16842,1196428',2018-02-12,FDRL/NATIONAL ELECTRONIC F,18014.0,0.0,,2018,2,12,DEBIT,18014.0,C1914282536
16843,1196428',2018-02-12,FDRL/NATIONAL ELECTRONIC F,15036.0,0.0,,2018,2,12,PAYEMENT,15036.0,C691636444
16844,1196428',2018-02-12,CASHDEP/NOIDA/TP,0.0,350000.0,,2018,2,12,TRANSFER,350000.0,C683605346
16845,1196428',2018-02-12,RTGS/HDFCH18043129543/PAY,0.0,4960000.0,,2018,2,12,CHECK_CASHING,4960000.0,M1967366965
16846,1196428',2018-02-12,RTGS/HDFCH18043130925/PAY,0.0,12080000.0,,2018,2,12,CASH_IN,12080000.0,M508405148
16847,1196428',2018-02-12,CASHDEP/VIKASMARG/TP,0.0,66000.0,,2018,2,12,TRANSFER,66000.0,M1295579320
16848,1196428',2018-02-12,Indiaforensic SERVICES INDIA PVT,0.0,732904.0,,2018,2,12,CHECK_CASHING,732904.0,M995168511
16849,1196428',2018-02-12,NEFT/20426307991DC/ARTHAS,0.0,75000.0,,2018,2,12,TRANSFER,75000.0,M1102425439
16850,1196428',2018-02-12,FDRL/NATIONAL ELECTRONIC F,11950.0,0.0,,2018,2,12,CASH_OUT,11950.0,M590053012
16851,1196428',2018-02-12,FDRL/REAL TIME GROSS SETTL,15000000.0,0.0,,2018,2,12,CHECK_WITHDRAWAL,15000000.0,M386886002
16852,1196428',2018-02-12,CASHDEP/VIKASMARG/TP,0.0,34500.0,,2018,2,12,CHECK_CASHING,34500.0,M227585143
16853,1196428',2018-02-12,CASHDEP/NOIDA/TP,0.0,162000.0,,2018,2,12,CASH_IN,162000.0,M2105068287
16854,1196428',2018-02-12,FDRL/INTERNAL FUND TRANSFE,0.0,1000000.0,,2018,2,12,CHECK_CASHING,1000000.0,M1038116064
16855,1196428',2018-02-12,FDRL/INTERNAL FUND TRANSFE,0.0,3000000.0,,2018,2,12,TRANSFER,3000000.0,M345805867
16856,1196428',2018-02-12,FDRL/INTERNAL FUND TRANSFE,0.0,3000000.0,,2018,2,12,TRANSFER,3000000.0,M1128144161
16857,1196428',2018-02-12,FDRL/NATIONAL ELECTRONIC F,10000000.0,0.0,,2018,2,12,CHECK_WITHDRAWAL,10000000.0,M1492172037
16858,1196428',2018-02-12,Indiaforensic SERVICES INDIA PVT,0.0,1700133.0,,2018,2,12,CASH_IN,1700133.0,M731603444
16859,1196428',2018-02-12,FDRL/INTERNAL FUND TRANSFE,500000.0,0.0,,2018,2,12,DEBIT,500000.0,M879683510
16860,1196428',2018-02-12,FDRL/INTERNAL FUND TRANSFE,500000.0,0.0,,2018,2,12,DEBIT,500000.0,M555126583
16861,1196428',2018-02-12,NEFT/N043180473770994/TEC,0.0,200000.0,,2018,2,12,TRANSFER,200000.0,M1344791022
16862,1196428',2018-02-12,NEFT/BARBQ18043111439/MAK,0.0,64500.0,,2018,2,12,CASH_IN,64500.0,M40493588
16863,1196428',2018-02-12,TRF FROM  Indiaforensic SERVICES,0.0,15000000.0,,2018,2,12,CHECK_CASHING,15000000.0,M1099885881
16864,1196428',2018-02-12,TRF FROM  Indiaforensic SERVICES,0.0,15000000.0,,2018,2,12,TRANSFER,15000000.0,M107256650
16865,1196428',2018-02-12,NEFT/N043180473772397/PAY,0.0,3081505.78,,2018,2,12,CHECK_CASHING,3081505.78,M1410611700
16866,1196428',2018-02-12,NEFT/N043180473781991/PAY,0.0,1441783.31,,2018,2,12,TRANSFER,1441783.31,M954062800
16867,1196428',2018-02-12,NEFT CHARGES AND GST/0000,29.5,0.0,,2018,2,12,CHECK_WITHDRAWAL,29.5,M13013852
16868,1196428',2018-02-12,NEFT/000031247185/Indiaforensic,10000000.0,0.0,,2018,2,12,DEBIT,10000000.0,M1101858256
16869,1196428',2018-02-12,NEFT CHARGES AND GST/0000,29.5,0.0,,2018,2,12,CASH_OUT,29.5,M1180862248
16870,1196428',2018-02-12,NEFT/000031247073/Indiaforensic,10000000.0,0.0,,2018,2,12,PAYEMENT,10000000.0,M966462848
16871,1196428',2018-02-12,NEFT/N043180473845511/PAY,0.0,5000000.0,,2018,2,12,CASH_IN,5000000.0,M1284324188
16872,1196428',2018-02-12,TRF FROM  Indiaforensic SERVICES,0.0,2800000.0,,2018,2,12,CASH_IN,2800000.0,C374625527
16873,1196428',2018-02-12,FDRL/INTERNAL FUND TRANSFE,10000000.0,0.0,,2018,2,12,CHECK_WITHDRAWAL,10000000.0,C1262822392
16874,1196428',2018-02-12,FDRL/INTERNAL FUND TRANSFE,10000000.0,0.0,,2018,2,12,PAYEMENT,10000000.0,C1671386208
16875,1196428',2018-02-12,FDRL/INTERNAL FUND TRANSFE,3000000.0,0.0,,2018,2,12,CHECK_WITHDRAWAL,3000000.0,C1869197498
16876,1196428',2018-02-13,TRF FROM  Indiaforensic SERVICES,0.0,10000000.0,,2018,2,13,TRANSFER,10000000.0,C271488817
16877,1196428',2018-02-13,FDRL/INTERNAL FUND TRANSFE,0.0,2000000.0,,2018,2,13,CHECK_CASHING,2000000.0,M1915909017
16878,1196428',2018-02-13,FDRL/INTERNAL FUND TRANSFE,0.0,1000000.0,,2018,2,13,CHECK_CASHING,1000000.0,C2052185144
16879,1196428',2018-02-13,NEFT/BARBQ18044549814/MAK,0.0,85555.0,,2018,2,13,CASH_IN,85555.0,C646059443
16880,1196428',2018-02-13,FDRL/INTERNAL FUND TRANSFE,0.0,2000000.0,,2018,2,13,CHECK_CASHING,2000000.0,C1982591789
16881,1196428',2018-02-13,FDRL/INTERNAL FUND TRANSFE,15000000.0,0.0,,2018,2,13,PAYEMENT,15000000.0,C1977614404
16882,1196428',2018-02-13,FDRL/INTERNAL FUND TRANSFE,500000.0,0.0,,2018,2,13,DEBIT,500000.0,C1883840933
16883,1196428',2018-02-14,Indiaforensic SERVICES INDIA PVT,0.0,463564.0,,2018,2,14,TRANSFER,463564.0,C2007207148
16884,1196428',2018-02-14,RTGS/HDFCH18045436824/PAY,0.0,8720000.0,,2018,2,14,CHECK_CASHING,8720000.0,M1014644493
16885,1196428',2018-02-14,RTGS/HDFCH18045435405/PAY,0.0,680000.0,,2018,2,14,CASH_IN,680000.0,C381605910
16886,1196428',2018-02-14,FDRL/REAL TIME GROSS SETTL,10000000.0,0.0,,2018,2,14,DEBIT,10000000.0,M1056752544
16887,1196428',2018-02-14,NEFT/20429054821DC/ARTHAS,0.0,25000.0,,2018,2,14,CASH_IN,25000.0,M729567968
16888,1196428',2018-02-14,FDRL/INTERNAL FUND TRANSFE,0.0,2000000.0,,2018,2,14,CASH_IN,2000000.0,M1723507087
16889,1196428',2018-02-14,FDRL/NATIONAL ELECTRONIC F,53159.0,0.0,,2018,2,14,CHECK_WITHDRAWAL,53159.0,C849038219
16890,1196428',2018-02-14,RTGS/IDFBH18045300944/ART,0.0,10000000.0,,2018,2,14,CASH_IN,10000000.0,C1038678108
16891,1196428',2018-02-14,RTGS/IDFBH18045300961/ART,0.0,10000000.0,,2018,2,14,CHECK_CASHING,10000000.0,M1976340229
16892,1196428',2018-02-14,RTGS/IDFBH18045300950/ART,0.0,10000000.0,,2018,2,14,TRANSFER,10000000.0,M693274483
16893,1196428',2018-02-14,FDRL/NATIONAL ELECTRONIC F,5000000.0,0.0,,2018,2,14,DEBIT,5000000.0,M838050003
16894,1196428',2018-02-14,FDRL/NATIONAL ELECTRONIC F,5000000.0,0.0,,2018,2,14,CASH_OUT,5000000.0,C1009972184
16895,1196428',2018-02-14,NEFT/20429392261DC/SARVAT,0.0,200000.0,,2018,2,14,CASH_IN,200000.0,C63475121
16896,1196428',2018-02-14,NEFT/BARBQ18045920051/MAK,0.0,89950.0,,2018,2,14,CASH_IN,89950.0,C1130075212
16897,1196428',2018-02-14,TRF FROM  Indiaforensic SERVICES,0.0,13500000.0,,2018,2,14,CHECK_CASHING,13500000.0,C851316413
16898,1196428',2018-02-14,TRF FROM  Indiaforensic SERVICES,0.0,15000000.0,,2018,2,14,CASH_IN,15000000.0,M718843573
16899,1196428',2018-02-14,YOURSELF FOR BULK NEFT  S,14878700.0,0.0,,2018,2,14,CASH_OUT,14878700.0,M1217713614
16900,1196428',2018-02-14,Indiaforensic SERVICES INDIA PVT,0.0,764164.0,,2018,2,14,CHECK_CASHING,764164.0,M706338650
16901,1196428',2018-02-14,NEFT/N045180475189958/PAY,0.0,1156935.26,,2018,2,14,TRANSFER,1156935.26,M995800830
16902,1196428',2018-02-14,NEFT/N045180475189931/PAY,0.0,1974710.37,,2018,2,14,CASH_IN,1974710.37,C1073259437
16903,1196428',2018-02-14,FDRL/INTERNAL FUND TRANSFE,10000000.0,0.0,,2018,2,14,DEBIT,10000000.0,M1699315785
16904,1196428',2018-02-14,FDRL/INTERNAL FUND TRANSFE,3000000.0,0.0,,2018,2,14,PAYEMENT,3000000.0,M1163711030
16905,1196428',2018-02-14,FDRL/INTERNAL FUND TRANSFE,1000000.0,0.0,,2018,2,14,CASH_OUT,1000000.0,C320106510
16906,1196428',2018-02-14,TRF FROM  Indiaforensic SERVICES,0.0,7900000.0,,2018,2,14,TRANSFER,7900000.0,M597251930
16907,1196428',2018-02-14,"Indiaforensic USA, INC./USD/4001",0.0,2551947.86,,2018,2,14,CASH_IN,2551947.86,M1515100477
16908,1196428',2018-02-14,IRTT00701804727,1564.35,0.0,,2018,2,14,CASH_OUT,1564.35,M1412315921
16909,1196428',2018-02-15,FDRL/INTERNAL FUND TRANSFE,0.0,3000000.0,,2018,2,15,CASH_IN,3000000.0,M1168923345
16910,1196428',2018-02-15,FDRL/INTERNAL FUND TRANSFE,0.0,3000000.0,,2018,2,15,CHECK_CASHING,3000000.0,M2042700604
16911,1196428',2018-02-15,FDRL/INTERNAL FUND TRANSFE,0.0,500000.0,,2018,2,15,CHECK_CASHING,500000.0,C710481910
16912,1196428',2018-02-15,FDRL/INTERNAL FUND TRANSFE,0.0,3000000.0,,2018,2,15,CHECK_CASHING,3000000.0,M1474634841
16913,1196428',2018-02-15,FDRL/REAL TIME GROSS SETTL,15000000.0,0.0,,2018,2,15,CASH_OUT,15000000.0,C669419693
16914,1196428',2018-02-15,FDRL/REAL TIME GROSS SETTL,15000000.0,0.0,,2018,2,15,CHECK_WITHDRAWAL,15000000.0,C2095611317
16915,1196428',2018-02-15,FDRL/REAL TIME GROSS SETTL,15000000.0,0.0,,2018,2,15,PAYEMENT,15000000.0,C1316560467
16916,1196428',2018-02-15,RTGS/HDFCH18046591144/PAY,0.0,1920000.0,,2018,2,15,TRANSFER,1920000.0,M1572144334
16917,1196428',2018-02-15,RTGS/HDFCH18046592393/PAY,0.0,3680000.0,,2018,2,15,TRANSFER,3680000.0,M593517569
16918,1196428',2018-02-15,CASHDEP/SILVASSA/,0.0,25000.0,,2018,2,15,CHECK_CASHING,25000.0,M558730564
16919,1196428',2018-02-15,FDRL/REAL TIME GROSS SETTL,5000000.0,0.0,,2018,2,15,DEBIT,5000000.0,C736160330
16920,1196428',2018-02-15,FDRL/REAL TIME GROSS SETTL,1000000.0,0.0,,2018,2,15,DEBIT,1000000.0,C417236208
16921,1196428',2018-02-15,GOLD LABEL INVESTMENTS (P,0.0,66647330.4,,2018,2,15,CASH_IN,66647330.4,C931482420
16922,1196428',2018-02-15,IRTT00701804861,13750.0,0.0,,2018,2,15,CHECK_WITHDRAWAL,13750.0,M405976415
16923,1196428',2018-02-15,RTGS/SBINH18046056805/Indfor,0.0,8900000.0,,2018,2,15,TRANSFER,8900000.0,C208341157
16924,1196428',2018-02-15,NEFT/N046180475849680/PAY,0.0,638493.11,,2018,2,15,CHECK_CASHING,638493.11,C382697424
16925,1196428',2018-02-15,NEFT/N046180475854848/PAY,0.0,706851.52,,2018,2,15,TRANSFER,706851.52,M875577692
16926,1196428',2018-02-15,FDRL/NATIONAL ELECTRONIC F,5000000.0,0.0,,2018,2,15,DEBIT,5000000.0,C1822578654
16927,1196428',2018-02-15,Indiaforensic SERVICES INDIA PVT,0.0,541151.0,,2018,2,15,CHECK_CASHING,541151.0,M2022435822
16928,1196428',2018-02-15,TRF FRM  Indiaforensic SERVICES,0.0,3700000.0,,2018,2,15,CASH_IN,3700000.0,M1867372125
16929,1196428',2018-02-15,TRF FRM  Indiaforensic SERVICES,0.0,10000000.0,,2018,2,15,TRANSFER,10000000.0,M556592378
16930,1196428',2018-02-15,NEFT/N046180476005743/PAY,0.0,525612.88,,2018,2,15,CHECK_CASHING,525612.88,C807072084
16931,1196428',2018-02-15,FDRL/INTERNAL FUND TRANSFE,0.0,1000000.0,,2018,2,15,CASH_IN,1000000.0,C2077098348
16932,1196428',2018-02-15,FDRL/INTERNAL FUND TRANSFE,15000000.0,0.0,,2018,2,15,CASH_OUT,15000000.0,M1751878963
16933,1196428',2018-02-15,FDRL/INTERNAL FUND TRANSFE,15000000.0,0.0,,2018,2,15,DEBIT,15000000.0,C1618278649
16934,1196428',2018-02-15,FDRL/INTERNAL FUND TRANSFE,6647330.4,0.0,,2018,2,15,CHECK_WITHDRAWAL,6647330.4,C1987564320
16935,1196428',2018-02-15,FDRL/INTERNAL FUND TRANSFE,15000000.0,0.0,,2018,2,15,CHECK_WITHDRAWAL,15000000.0,M848162783
16936,1196428',2018-02-15,FDRL/INTERNAL FUND TRANSFE,15000000.0,0.0,,2018,2,15,DEBIT,15000000.0,M347906624
16937,1196428',2018-02-15,YOURSELF FOR BULK NEFT  B,3763850.0,0.0,,2018,2,15,DEBIT,3763850.0,M271658762
16938,1196428',2018-02-15,YOURSELF FOR BULK NEFT  B,5968000.0,0.0,,2018,2,15,CHECK_WITHDRAWAL,5968000.0,M1403007770
16939,1196428',2018-02-15,FDRL/INTERNAL FUND TRANSFE,10000000.0,0.0,,2018,2,15,CASH_OUT,10000000.0,M2043631011
16940,1196428',2018-02-15,FDRL/INTERNAL FUND TRANSFE,1000000.0,0.0,,2018,2,15,CHECK_WITHDRAWAL,1000000.0,C107095723
16941,1196428',2018-02-16,CASHDEP/NOIDA/TP,0.0,200000.0,,2018,2,16,TRANSFER,200000.0,C985934102
16942,1196428',2018-02-16,RTGS/HDFCH18047781080/PAY,0.0,5280000.0,,2018,2,16,CASH_IN,5280000.0,C824197891
16943,1196428',2018-02-16,RTGS/HDFCH18047781130/PAY,0.0,1680000.0,,2018,2,16,CHECK_CASHING,1680000.0,C1696218625
16944,1196428',2018-02-16,FDRL/REAL TIME GROSS SETTL,5000000.0,0.0,,2018,2,16,CHECK_WITHDRAWAL,5000000.0,M1817447589
16945,1196428',2018-02-16,FDRL/REAL TIME GROSS SETTL,1000000.0,0.0,,2018,2,16,DEBIT,1000000.0,C168639687
16946,1196428',2018-02-16,FDRL/REAL TIME GROSS SETTL,1000000.0,0.0,,2018,2,16,CHECK_WITHDRAWAL,1000000.0,C1630293008
16947,1196428',2018-02-16,CASHPMT/GURGAON/SELF,180000.0,0.0,,2018,2,16,CHECK_WITHDRAWAL,180000.0,C1577420620
16948,1196428',2018-02-16,FDRL/INTERNAL FUND TRANSFE,500000.0,0.0,,2018,2,16,CHECK_WITHDRAWAL,500000.0,C35263828
16949,1196428',2018-02-16,NEFT/N047180476600669/THE,0.0,10000.0,,2018,2,16,CASH_IN,10000.0,M2014874822
16950,1196428',2018-02-16,FDRL/INTERNAL FUND TRANSFE,300000.0,0.0,,2018,2,16,DEBIT,300000.0,M1553772873
16951,1196428',2018-02-16,"Indiaforensic USA, INC./USD/4990",0.0,317064.6,,2018,2,16,TRANSFER,317064.6,C905650857
16952,1196428',2018-02-16,IRTT00701805091,670.36,0.0,,2018,2,16,CHECK_WITHDRAWAL,670.36,C1502287290
16953,1196428',2018-02-16,"Indiaforensic USA, INC./USD/3057",0.0,1942862.58,,2018,2,16,CASH_IN,1942862.58,M1197564988
16954,1196428',2018-02-16,IRTT00701805089,1454.72,0.0,,2018,2,16,DEBIT,1454.72,M1843534160
16955,1196428',2018-02-16,NEFT/N047180476601093/PAY,0.0,524864.69,,2018,2,16,CASH_IN,524864.69,C871895680
16956,1196428',2018-02-16,NEFT/N047180476597339/PAY,0.0,1416769.9,,2018,2,16,TRANSFER,1416769.9,C1398530689
16957,1196428',2018-02-16,TRF FROM  Indiaforensic ONLINE S,0.0,15000000.0,,2018,2,16,CHECK_CASHING,15000000.0,M834859488
16958,1196428',2018-02-16,TRF FROM  Indiaforensic ONLINE S,0.0,15000000.0,,2018,2,16,CHECK_CASHING,15000000.0,M463880076
16959,1196428',2018-02-16,TRF FROM  Indiaforensic ONLINE S,0.0,5000000.0,,2018,2,16,TRANSFER,5000000.0,M1273091698
16960,1196428',2018-02-16,TRF FROM  Indiaforensic ONLINE S,0.0,8850.0,,2018,2,16,CASH_IN,8850.0,M134350609
16961,1196428',2018-02-16,TRF FROM  Indiaforensic ONLINE S,0.0,15000000.0,,2018,2,16,CASH_IN,15000000.0,M1939822545
16962,1196428',2018-02-16,FDRL/NATIONAL ELECTRONIC F,15171.0,0.0,,2018,2,16,DEBIT,15171.0,M1498010747
16963,1196428',2018-02-16,FDRL/NATIONAL ELECTRONIC F,46659.0,0.0,,2018,2,16,DEBIT,46659.0,M615833646
16964,1196428',2018-02-16,FDRL/NATIONAL ELECTRONIC F,16628.0,0.0,,2018,2,16,PAYEMENT,16628.0,M695601535
16965,1196428',2018-02-16,FDRL/NATIONAL ELECTRONIC F,31595.0,0.0,,2018,2,16,CASH_OUT,31595.0,M1741551200
16966,1196428',2018-02-16,FDRL/NATIONAL ELECTRONIC F,14353.0,0.0,,2018,2,16,CASH_OUT,14353.0,M533060514
16967,1196428',2018-02-16,FDRL/NATIONAL ELECTRONIC F,12786.0,0.0,,2018,2,16,DEBIT,12786.0,M763925237
16968,1196428',2018-02-16,FDRL/NATIONAL ELECTRONIC F,36552.0,0.0,,2018,2,16,CASH_OUT,36552.0,M309397793
16969,1196428',2018-02-16,FDRL/NATIONAL ELECTRONIC F,14424.0,0.0,,2018,2,16,CHECK_WITHDRAWAL,14424.0,M786088183
16970,1196428',2018-02-16,FDRL/NATIONAL ELECTRONIC F,43200.0,0.0,,2018,2,16,PAYEMENT,43200.0,M1362397723
16971,1196428',2018-02-16,FDRL/NATIONAL ELECTRONIC F,32367.0,0.0,,2018,2,16,CHECK_WITHDRAWAL,32367.0,M166947904
16972,1196428',2018-02-16,FDRL/NATIONAL ELECTRONIC F,9827.0,0.0,,2018,2,16,PAYEMENT,9827.0,M39384037
16973,1196428',2018-02-16,FDRL/NATIONAL ELECTRONIC F,7801.0,0.0,,2018,2,16,CASH_OUT,7801.0,M1475711030
16974,1196428',2018-02-16,FDRL/NATIONAL ELECTRONIC F,9827.0,0.0,,2018,2,16,DEBIT,9827.0,M727579419
16975,1196428',2018-02-16,FDRL/NATIONAL ELECTRONIC F,25597.0,0.0,,2018,2,16,CASH_OUT,25597.0,M654290745
16976,1196428',2018-02-16,FDRL/NATIONAL ELECTRONIC F,13244.0,0.0,,2018,2,16,CASH_OUT,13244.0,C1559145228
16977,1196428',2018-02-16,FDRL/NATIONAL ELECTRONIC F,8739.0,0.0,,2018,2,16,CHECK_WITHDRAWAL,8739.0,M688458571
16978,1196428',2018-02-16,FDRL/NATIONAL ELECTRONIC F,13278.0,0.0,,2018,2,16,CASH_OUT,13278.0,M1895621189
16979,1196428',2018-02-16,FDRL/NATIONAL ELECTRONIC F,9432.0,0.0,,2018,2,16,CASH_OUT,9432.0,M1516781526
16980,1196428',2018-02-16,FDRL/NATIONAL ELECTRONIC F,19449.0,0.0,,2018,2,16,CASH_OUT,19449.0,M409559965
16981,1196428',2018-02-16,FDRL/NATIONAL ELECTRONIC F,13816.0,0.0,,2018,2,16,PAYEMENT,13816.0,M1771169983
16982,1196428',2018-02-16,FDRL/NATIONAL ELECTRONIC F,28288.0,0.0,,2018,2,16,PAYEMENT,28288.0,C470217116
16983,1196428',2018-02-16,FDRL/NATIONAL ELECTRONIC F,26227.0,0.0,,2018,2,16,CASH_OUT,26227.0,M585745963
16984,1196428',2018-02-16,FDRL/NATIONAL ELECTRONIC F,19168.0,0.0,,2018,2,16,CHECK_WITHDRAWAL,19168.0,M2096974885
16985,1196428',2018-02-16,FDRL/NATIONAL ELECTRONIC F,15567.0,0.0,,2018,2,16,CHECK_WITHDRAWAL,15567.0,M1287228290
16986,1196428',2018-02-16,FDRL/NATIONAL ELECTRONIC F,23083.0,0.0,,2018,2,16,CASH_OUT,23083.0,M1178751818
16987,1196428',2018-02-16,FDRL/NATIONAL ELECTRONIC F,16989.0,0.0,,2018,2,16,PAYEMENT,16989.0,M145594829
16988,1196428',2018-02-16,FDRL/NATIONAL ELECTRONIC F,14316.0,0.0,,2018,2,16,PAYEMENT,14316.0,M1232351629
16989,1196428',2018-02-16,FDRL/NATIONAL ELECTRONIC F,12101.0,0.0,,2018,2,16,CASH_OUT,12101.0,M1656904340
16990,1196428',2018-02-16,FDRL/NATIONAL ELECTRONIC F,12953.0,0.0,,2018,2,16,CHECK_WITHDRAWAL,12953.0,C24404443
16991,1196428',2018-02-16,FDRL/NATIONAL ELECTRONIC F,27734.0,0.0,,2018,2,16,CASH_OUT,27734.0,C596299019
16992,1196428',2018-02-16,FDRL/NATIONAL ELECTRONIC F,27685.0,0.0,,2018,2,16,CHECK_WITHDRAWAL,27685.0,C1983747920
16993,1196428',2018-02-16,FDRL/NATIONAL ELECTRONIC F,10821.0,0.0,,2018,2,16,PAYEMENT,10821.0,C696705647
16994,1196428',2018-02-16,FDRL/NATIONAL ELECTRONIC F,21933.0,0.0,,2018,2,16,DEBIT,21933.0,C1845765982
16995,1196428',2018-02-16,FDRL/NATIONAL ELECTRONIC F,9886.0,0.0,,2018,2,16,CHECK_WITHDRAWAL,9886.0,M877365519
16996,1196428',2018-02-16,FDRL/NATIONAL ELECTRONIC F,22826.0,0.0,,2018,2,16,CHECK_WITHDRAWAL,22826.0,C134604590
16997,1196428',2018-02-16,FDRL/NATIONAL ELECTRONIC F,28961.0,0.0,,2018,2,16,DEBIT,28961.0,M1053485132
16998,1196428',2018-02-16,FDRL/NATIONAL ELECTRONIC F,26400.0,0.0,,2018,2,16,CHECK_WITHDRAWAL,26400.0,M1698378565
16999,1196428',2018-02-16,FDRL/NATIONAL ELECTRONIC F,24484.0,0.0,,2018,2,16,PAYEMENT,24484.0,M1418167825
17000,1196428',2018-02-16,FDRL/NATIONAL ELECTRONIC F,10583.0,0.0,,2018,2,16,PAYEMENT,10583.0,M915318947
17001,1196428',2018-02-16,FDRL/NATIONAL ELECTRONIC F,25719.0,0.0,,2018,2,16,CASH_OUT,25719.0,M1471526064
17002,1196428',2018-02-16,FDRL/NATIONAL ELECTRONIC F,22600.0,0.0,,2018,2,16,PAYEMENT,22600.0,C474166728
17003,1196428',2018-02-16,FDRL/NATIONAL ELECTRONIC F,14814.0,0.0,,2018,2,16,DEBIT,14814.0,M1777764920
17004,1196428',2018-02-16,FDRL/NATIONAL ELECTRONIC F,11558.0,0.0,,2018,2,16,CHECK_WITHDRAWAL,11558.0,C1833549064
17005,1196428',2018-02-16,FDRL/NATIONAL ELECTRONIC F,27017.0,0.0,,2018,2,16,PAYEMENT,27017.0,M327804056
17006,1196428',2018-02-16,FDRL/NATIONAL ELECTRONIC F,28891.0,0.0,,2018,2,16,PAYEMENT,28891.0,M939893108
17007,1196428',2018-02-16,FDRL/NATIONAL ELECTRONIC F,11177.0,0.0,,2018,2,16,CASH_OUT,11177.0,C1938462589
17008,1196428',2018-02-16,FDRL/NATIONAL ELECTRONIC F,19069.0,0.0,,2018,2,16,CASH_OUT,19069.0,M974784761
17009,1196428',2018-02-16,FDRL/NATIONAL ELECTRONIC F,17530.0,0.0,,2018,2,16,PAYEMENT,17530.0,M209997138
17010,1196428',2018-02-16,FDRL/NATIONAL ELECTRONIC F,11010.0,0.0,,2018,2,16,DEBIT,11010.0,M359327148
17011,1196428',2018-02-16,FDRL/NATIONAL ELECTRONIC F,28264.0,0.0,,2018,2,16,CASH_OUT,28264.0,C1519216494
17012,1196428',2018-02-16,FDRL/NATIONAL ELECTRONIC F,24090.0,0.0,,2018,2,16,CHECK_WITHDRAWAL,24090.0,M142106520
17013,1196428',2018-02-16,FDRL/NATIONAL ELECTRONIC F,24833.0,0.0,,2018,2,16,DEBIT,24833.0,C1979080020
17014,1196428',2018-02-16,FDRL/NATIONAL ELECTRONIC F,23335.0,0.0,,2018,2,16,PAYEMENT,23335.0,C635281078
17015,1196428',2018-02-16,FDRL/NATIONAL ELECTRONIC F,19572.0,0.0,,2018,2,16,CASH_OUT,19572.0,C1866672043
17016,1196428',2018-02-16,FDRL/NATIONAL ELECTRONIC F,15333.0,0.0,,2018,2,16,PAYEMENT,15333.0,M155979068
17017,1196428',2018-02-16,FDRL/NATIONAL ELECTRONIC F,57868.0,0.0,,2018,2,16,DEBIT,57868.0,M111496179
17018,1196428',2018-02-16,FDRL/NATIONAL ELECTRONIC F,59909.0,0.0,,2018,2,16,CASH_OUT,59909.0,M1472428747
17019,1196428',2018-02-16,FDRL/NATIONAL ELECTRONIC F,69421.0,0.0,,2018,2,16,CHECK_WITHDRAWAL,69421.0,C1167813715
17020,1196428',2018-02-16,FDRL/NATIONAL ELECTRONIC F,66394.0,0.0,,2018,2,16,DEBIT,66394.0,M235839070
17021,1196428',2018-02-16,FDRL/NATIONAL ELECTRONIC F,71796.0,0.0,,2018,2,16,PAYEMENT,71796.0,M1881768592
17022,1196428',2018-02-16,FDRL/NATIONAL ELECTRONIC F,54708.0,0.0,,2018,2,16,CASH_OUT,54708.0,C185503802
17023,1196428',2018-02-16,FDRL/NATIONAL ELECTRONIC F,61943.0,0.0,,2018,2,16,CHECK_WITHDRAWAL,61943.0,C403147759
17024,1196428',2018-02-16,FDRL/NATIONAL ELECTRONIC F,76840.0,0.0,,2018,2,16,PAYEMENT,76840.0,M1725462644
17025,1196428',2018-02-16,FDRL/NATIONAL ELECTRONIC F,53156.0,0.0,,2018,2,16,CHECK_WITHDRAWAL,53156.0,M685639359
17026,1196428',2018-02-16,FDRL/NATIONAL ELECTRONIC F,60184.0,0.0,,2018,2,16,CHECK_WITHDRAWAL,60184.0,M499928991
17027,1196428',2018-02-16,FDRL/NATIONAL ELECTRONIC F,60072.0,0.0,,2018,2,16,PAYEMENT,60072.0,M960322367
17028,1196428',2018-02-16,FDRL/NATIONAL ELECTRONIC F,90504.0,0.0,,2018,2,16,PAYEMENT,90504.0,M1786085833
17029,1196428',2018-02-16,FDRL/NATIONAL ELECTRONIC F,52118.0,0.0,,2018,2,16,DEBIT,52118.0,M718103121
17030,1196428',2018-02-16,FDRL/NATIONAL ELECTRONIC F,90672.0,0.0,,2018,2,16,CASH_OUT,90672.0,M757687320
17031,1196428',2018-02-16,FDRL/NATIONAL ELECTRONIC F,80867.0,0.0,,2018,2,16,CASH_OUT,80867.0,M1144148971
17032,1196428',2018-02-16,FDRL/NATIONAL ELECTRONIC F,75333.0,0.0,,2018,2,16,CASH_OUT,75333.0,M1868505862
17033,1196428',2018-02-16,FDRL/NATIONAL ELECTRONIC F,59815.0,0.0,,2018,2,16,CASH_OUT,59815.0,M1608080402
17034,1196428',2018-02-16,FDRL/NATIONAL ELECTRONIC F,70911.0,0.0,,2018,2,16,CASH_OUT,70911.0,M1154038476
17035,1196428',2018-02-16,FDRL/NATIONAL ELECTRONIC F,99750.0,0.0,,2018,2,16,PAYEMENT,99750.0,M1325923139
17036,1196428',2018-02-16,FDRL/NATIONAL ELECTRONIC F,58044.0,0.0,,2018,2,16,CHECK_WITHDRAWAL,58044.0,M1396188238
17037,1196428',2018-02-16,FDRL/NATIONAL ELECTRONIC F,64033.0,0.0,,2018,2,16,DEBIT,64033.0,M554850979
17038,1196428',2018-02-16,FDRL/NATIONAL ELECTRONIC F,96016.0,0.0,,2018,2,16,DEBIT,96016.0,M1055780232
17039,1196428',2018-02-16,FDRL/NATIONAL ELECTRONIC F,70409.0,0.0,,2018,2,16,PAYEMENT,70409.0,M662568271
17040,1196428',2018-02-16,FDRL/NATIONAL ELECTRONIC F,130997.0,0.0,,2018,2,16,CHECK_WITHDRAWAL,130997.0,C1649449847
17041,1196428',2018-02-16,FDRL/NATIONAL ELECTRONIC F,67771.0,0.0,,2018,2,16,DEBIT,67771.0,C1198167820
17042,1196428',2018-02-16,FDRL/NATIONAL ELECTRONIC F,135351.0,0.0,,2018,2,16,PAYEMENT,135351.0,C749672494
17043,1196428',2018-02-16,FDRL/NATIONAL ELECTRONIC F,145494.0,0.0,,2018,2,16,DEBIT,145494.0,C1423992712
17044,1196428',2018-02-16,FDRL/NATIONAL ELECTRONIC F,120700.0,0.0,,2018,2,16,CHECK_WITHDRAWAL,120700.0,C313124964
17045,1196428',2018-02-16,FDRL/NATIONAL ELECTRONIC F,100043.0,0.0,,2018,2,16,DEBIT,100043.0,C500153041
17046,1196428',2018-02-16,FDRL/NATIONAL ELECTRONIC F,110339.0,0.0,,2018,2,16,CHECK_WITHDRAWAL,110339.0,C728526866
17047,1196428',2018-02-16,FDRL/NATIONAL ELECTRONIC F,78375.0,0.0,,2018,2,16,DEBIT,78375.0,C40075281
17048,1196428',2018-02-16,FDRL/NATIONAL ELECTRONIC F,158594.0,0.0,,2018,2,16,CHECK_WITHDRAWAL,158594.0,C456538529
17049,1196428',2018-02-16,FDRL/NATIONAL ELECTRONIC F,112397.0,0.0,,2018,2,16,PAYEMENT,112397.0,C2117043942
17050,1196428',2018-02-16,FDRL/NATIONAL ELECTRONIC F,169570.0,0.0,,2018,2,16,PAYEMENT,169570.0,C1838584624
17051,1196428',2018-02-16,FDRL/NATIONAL ELECTRONIC F,296103.0,0.0,,2018,2,16,CHECK_WITHDRAWAL,296103.0,M1733424208
17052,1196428',2018-02-16,FDRL/NATIONAL ELECTRONIC F,15050.0,0.0,,2018,2,16,CASH_OUT,15050.0,M1060393794
17053,1196428',2018-02-16,FDRL/NATIONAL ELECTRONIC F,829016.0,0.0,,2018,2,16,CHECK_WITHDRAWAL,829016.0,M226593165
17054,1196428',2018-02-16,FDRL/NATIONAL ELECTRONIC F,15050.0,0.0,,2018,2,16,CHECK_WITHDRAWAL,15050.0,M426584880
17055,1196428',2018-02-16,FDRL/NATIONAL ELECTRONIC F,13500.0,0.0,,2018,2,16,CASH_OUT,13500.0,C448155494
17056,1196428',2018-02-16,FDRL/NATIONAL ELECTRONIC F,197878.0,0.0,,2018,2,16,PAYEMENT,197878.0,M1594302764
17057,1196428',2018-02-16,FDRL/NATIONAL ELECTRONIC F,344084.0,0.0,,2018,2,16,DEBIT,344084.0,M271366306
17058,1196428',2018-02-16,FDRL/NATIONAL ELECTRONIC F,233976.0,0.0,,2018,2,16,PAYEMENT,233976.0,C348708793
17059,1196428',2018-02-16,FDRL/NATIONAL ELECTRONIC F,15824.0,0.0,,2018,2,16,CASH_OUT,15824.0,M462659391
17060,1196428',2018-02-16,FDRL/INTERNAL FUND TRANSFE,22000.0,0.0,,2018,2,16,CASH_OUT,22000.0,M547825235
17061,1196428',2018-02-16,FDRL/NATIONAL ELECTRONIC F,13500.0,0.0,,2018,2,16,PAYEMENT,13500.0,M1301971459
17062,1196428',2018-02-16,FDRL/NATIONAL ELECTRONIC F,30933.0,0.0,,2018,2,16,DEBIT,30933.0,M1155771218
17063,1196428',2018-02-16,FDRL/NATIONAL ELECTRONIC F,41175.0,0.0,,2018,2,16,DEBIT,41175.0,M734120998
17064,1196428',2018-02-16,FDRL/NATIONAL ELECTRONIC F,16241.0,0.0,,2018,2,16,CHECK_WITHDRAWAL,16241.0,M1404561012
17065,1196428',2018-02-16,FDRL/NATIONAL ELECTRONIC F,999036.0,0.0,,2018,2,16,PAYEMENT,999036.0,M1376999853
17066,1196428',2018-02-16,FDRL/NATIONAL ELECTRONIC F,26825.0,0.0,,2018,2,16,CHECK_WITHDRAWAL,26825.0,M255307196
17067,1196428',2018-02-16,FDRL/NATIONAL ELECTRONIC F,49824.0,0.0,,2018,2,16,PAYEMENT,49824.0,M11285367
17068,1196428',2018-02-16,FDRL/NATIONAL ELECTRONIC F,33417.0,0.0,,2018,2,16,CASH_OUT,33417.0,M714914851
17069,1196428',2018-02-16,FDRL/NATIONAL ELECTRONIC F,15167.0,0.0,,2018,2,16,CASH_OUT,15167.0,M1438724935
17070,1196428',2018-02-16,FDRL/NATIONAL ELECTRONIC F,17271.0,0.0,,2018,2,16,CASH_OUT,17271.0,M662472677
17071,1196428',2018-02-16,FDRL/NATIONAL ELECTRONIC F,40150.0,0.0,,2018,2,16,PAYEMENT,40150.0,M1932384587
17072,1196428',2018-02-16,FDRL/NATIONAL ELECTRONIC F,35074.0,0.0,,2018,2,16,PAYEMENT,35074.0,M719480872
17073,1196428',2018-02-16,FDRL/NATIONAL ELECTRONIC F,35918.0,0.0,,2018,2,16,CHECK_WITHDRAWAL,35918.0,M1278136570
17074,1196428',2018-02-16,FDRL/NATIONAL ELECTRONIC F,16809.0,0.0,,2018,2,16,CHECK_WITHDRAWAL,16809.0,M148964727
17075,1196428',2018-02-16,FDRL/NATIONAL ELECTRONIC F,20491.0,0.0,,2018,2,16,CASH_OUT,20491.0,M1177742051
17076,1196428',2018-02-16,FDRL/NATIONAL ELECTRONIC F,40673.0,0.0,,2018,2,16,CHECK_WITHDRAWAL,40673.0,M724365571
17077,1196428',2018-02-16,FDRL/NATIONAL ELECTRONIC F,48519.0,0.0,,2018,2,16,CHECK_WITHDRAWAL,48519.0,M212535805
17078,1196428',2018-02-16,FDRL/NATIONAL ELECTRONIC F,37238.0,0.0,,2018,2,16,CASH_OUT,37238.0,M1596397541
17079,1196428',2018-02-16,FDRL/NATIONAL ELECTRONIC F,24653.0,0.0,,2018,2,16,PAYEMENT,24653.0,M713285225
17080,1196428',2018-02-16,FDRL/NATIONAL ELECTRONIC F,19373.0,0.0,,2018,2,16,DEBIT,19373.0,C2032389005
17081,1196428',2018-02-16,FDRL/NATIONAL ELECTRONIC F,18092.0,0.0,,2018,2,16,CHECK_WITHDRAWAL,18092.0,M1156533869
17082,1196428',2018-02-16,FDRL/NATIONAL ELECTRONIC F,41738.0,0.0,,2018,2,16,DEBIT,41738.0,M105292474
17083,1196428',2018-02-16,FDRL/NATIONAL ELECTRONIC F,30250.0,0.0,,2018,2,16,CHECK_WITHDRAWAL,30250.0,M1410438390
17084,1196428',2018-02-16,FDRL/NATIONAL ELECTRONIC F,49269.0,0.0,,2018,2,16,DEBIT,49269.0,M1257755465
17085,1196428',2018-02-16,FDRL/NATIONAL ELECTRONIC F,30695.0,0.0,,2018,2,16,CASH_OUT,30695.0,M1640401120
17086,1196428',2018-02-16,FDRL/NATIONAL ELECTRONIC F,37667.0,0.0,,2018,2,16,DEBIT,37667.0,M1399060771
17087,1196428',2018-02-16,FDRL/NATIONAL ELECTRONIC F,6407.0,0.0,,2018,2,16,PAYEMENT,6407.0,C1262822392
17088,1196428',2018-02-16,FDRL/NATIONAL ELECTRONIC F,13697.0,0.0,,2018,2,16,DEBIT,13697.0,M148589770
17089,1196428',2018-02-16,FDRL/NATIONAL ELECTRONIC F,33660.0,0.0,,2018,2,16,DEBIT,33660.0,M984489239
17090,1196428',2018-02-16,FDRL/NATIONAL ELECTRONIC F,36630.0,0.0,,2018,2,16,CASH_OUT,36630.0,C2115055717
17091,1196428',2018-02-16,FDRL/NATIONAL ELECTRONIC F,24348.0,0.0,,2018,2,16,PAYEMENT,24348.0,C1166654566
17092,1196428',2018-02-16,FDRL/NATIONAL ELECTRONIC F,39977.0,0.0,,2018,2,16,PAYEMENT,39977.0,M88042020
17093,1196428',2018-02-16,FDRL/NATIONAL ELECTRONIC F,13697.0,0.0,,2018,2,16,DEBIT,13697.0,M717278894
17094,1196428',2018-02-16,FDRL/NATIONAL ELECTRONIC F,31734.0,0.0,,2018,2,16,DEBIT,31734.0,M129220812
17095,1196428',2018-02-16,FDRL/NATIONAL ELECTRONIC F,22293.0,0.0,,2018,2,16,CASH_OUT,22293.0,M1015272304
17096,1196428',2018-02-16,FDRL/NATIONAL ELECTRONIC F,19252.0,0.0,,2018,2,16,DEBIT,19252.0,C1007717381
17097,1196428',2018-02-16,FDRL/NATIONAL ELECTRONIC F,49730.0,0.0,,2018,2,16,PAYEMENT,49730.0,C1240091493
17098,1196428',2018-02-16,FDRL/NATIONAL ELECTRONIC F,32544.0,0.0,,2018,2,16,CASH_OUT,32544.0,C1396297158
17099,1196428',2018-02-16,FDRL/NATIONAL ELECTRONIC F,20982.0,0.0,,2018,2,16,DEBIT,20982.0,M705803524
17100,1196428',2018-02-16,FDRL/NATIONAL ELECTRONIC F,19535.0,0.0,,2018,2,16,DEBIT,19535.0,C978740207
17101,1196428',2018-02-16,FDRL/NATIONAL ELECTRONIC F,36017.0,0.0,,2018,2,16,DEBIT,36017.0,C115885991
17102,1196428',2018-02-16,FDRL/NATIONAL ELECTRONIC F,14424.0,0.0,,2018,2,16,CASH_OUT,14424.0,C587433505
17103,1196428',2018-02-16,FDRL/NATIONAL ELECTRONIC F,39550.0,0.0,,2018,2,16,CHECK_WITHDRAWAL,39550.0,C1637186972
17104,1196428',2018-02-16,FDRL/NATIONAL ELECTRONIC F,33365.0,0.0,,2018,2,16,DEBIT,33365.0,M190739308
17105,1196428',2018-02-16,FDRL/NATIONAL ELECTRONIC F,19571.0,0.0,,2018,2,16,DEBIT,19571.0,C778306577
17106,1196428',2018-02-16,FDRL/INTERNAL FUND TRANSFE,38680.0,0.0,,2018,2,16,CASH_OUT,38680.0,M1863711975
17107,1196428',2018-02-16,FDRL/INTERNAL FUND TRANSFE,36525.0,0.0,,2018,2,16,PAYEMENT,36525.0,M1469855297
17108,1196428',2018-02-16,FDRL/NATIONAL ELECTRONIC F,12250.0,0.0,,2018,2,16,PAYEMENT,12250.0,M794421806
17109,1196428',2018-02-16,FDRL/NATIONAL ELECTRONIC F,344084.0,0.0,,2018,2,16,DEBIT,344084.0,M1334051844
17110,1196428',2018-02-16,FDRL/NATIONAL ELECTRONIC F,13800.0,0.0,,2018,2,16,PAYEMENT,13800.0,M515450283
17111,1196428',2018-02-16,FDRL/NATIONAL ELECTRONIC F,296103.0,0.0,,2018,2,16,DEBIT,296103.0,M1747790771
17112,1196428',2018-02-16,FDRL/NATIONAL ELECTRONIC F,197878.0,0.0,,2018,2,16,CHECK_WITHDRAWAL,197878.0,M1284135884
17113,1196428',2018-02-16,FDRL/NATIONAL ELECTRONIC F,233976.0,0.0,,2018,2,16,CASH_OUT,233976.0,C420561530
17114,1196428',2018-02-16,FDRL/NATIONAL ELECTRONIC F,12250.0,0.0,,2018,2,16,CHECK_WITHDRAWAL,12250.0,M694158341
17115,1196428',2018-02-16,FDRL/NATIONAL ELECTRONIC F,13800.0,0.0,,2018,2,16,CASH_OUT,13800.0,C2046578329
17116,1196428',2018-02-16,FDRL/INTERNAL FUND TRANSFE,15000000.0,0.0,,2018,2,16,CASH_OUT,15000000.0,M942812964
17117,1196428',2018-02-16,FDRL/INTERNAL FUND TRANSFE,15000000.0,0.0,,2018,2,16,DEBIT,15000000.0,M1977844832
17118,1196428',2018-02-16,FDRL/INTERNAL FUND TRANSFE,10000000.0,0.0,,2018,2,16,CHECK_WITHDRAWAL,10000000.0,M1171276229
17119,1196428',2018-02-16,FDRL/INTERNAL FUND TRANSFE,4000000.0,0.0,,2018,2,16,PAYEMENT,4000000.0,M1741253456
17120,1196428',2018-02-16,TRF FROM  Indiaforensic SERVICES,0.0,3700000.0,,2018,2,16,CHECK_CASHING,3700000.0,M1549630173
17121,1196428',2018-02-16,TRF FROM  Indiaforensic SERVICES,0.0,14700000.0,,2018,2,16,CHECK_CASHING,14700000.0,C1548218207
17122,1196428',2018-02-16,NEFT/AXISP18047106470/ACC,0.0,5000000.0,,2018,2,16,TRANSFER,5000000.0,C242559404
17123,1196428',2018-02-16,FDRL/INTERNAL FUND TRANSFE,0.0,3000000.0,,2018,2,16,TRANSFER,3000000.0,C1153596299
17124,1196428',2018-02-16,FDRL/INTERNAL FUND TRANSFE,500000.0,0.0,,2018,2,16,PAYEMENT,500000.0,M708011911
17125,1196428',2018-02-16,FDRL/INTERNAL FUND TRANSFE,500000.0,0.0,,2018,2,16,PAYEMENT,500000.0,M1579526490
17126,1196428',2018-02-16,FDRL/INTERNAL FUND TRANSFE,10000000.0,0.0,,2018,2,16,CHECK_WITHDRAWAL,10000000.0,C1924874046
17127,1196428',2018-02-16,FDRL/INTERNAL FUND TRANSFE,10000000.0,0.0,,2018,2,16,CASH_OUT,10000000.0,C1079343872
17128,1196428',2018-02-16,FDRL/INTERNAL FUND TRANSFE,6000000.0,0.0,,2018,2,16,PAYEMENT,6000000.0,M1025387324
17129,1196428',2018-02-17,IB:TPFT0056746341 4090004,0.0,10000.0,,2018,2,17,CASH_IN,10000.0,M2114990234
17130,1196428',2018-02-17,RTGS/HDFCH18048969029/PAY,0.0,5760000.0,,2018,2,17,TRANSFER,5760000.0,M1843420945
17131,1196428',2018-02-17,RTGS/HDFCH18048969005/PAY,0.0,2640000.0,,2018,2,17,TRANSFER,2640000.0,C863811613
17132,1196428',2018-02-17,FDRL/NATIONAL ELECTRONIC F,5000000.0,0.0,,2018,2,17,CASH_OUT,5000000.0,M1539382844
17133,1196428',2018-02-17,FDRL/REAL TIME GROSS SETTL,3000000.0,0.0,,2018,2,17,PAYEMENT,3000000.0,M1846768700
17134,1196428',2018-02-17,NEFT/BARBR18048964413/MAK,0.0,50555.0,,2018,2,17,TRANSFER,50555.0,C1640747200
17135,1196428',2018-02-17,TRF FROM  Indiaforensic SERVICES,0.0,14000000.0,,2018,2,17,CHECK_CASHING,14000000.0,M1099038981
17136,1196428',2018-02-17,FDRL/REAL TIME GROSS SETTL,10000000.0,0.0,,2018,2,17,CHECK_WITHDRAWAL,10000000.0,C344610846
17137,1196428',2018-02-17,FDRL/REAL TIME GROSS SETTL,1000000.0,0.0,,2018,2,17,PAYEMENT,1000000.0,C1919277981
17138,1196428',2018-02-17,FDRL/REAL TIME GROSS SETTL,3000000.0,0.0,,2018,2,17,CHECK_WITHDRAWAL,3000000.0,C2104652067
17139,1196428',2018-02-17,NEFT/N048180477207477/TEC,0.0,200000.0,,2018,2,17,TRANSFER,200000.0,C1092465037
17140,1196428',2018-02-17,FDRL/INTERNAL FUND TRANSFE,0.0,2000000.0,,2018,2,17,TRANSFER,2000000.0,M995633719
17141,1196428',2018-02-17,FDRL/REAL TIME GROSS SETTL,1000000.0,0.0,,2018,2,17,DEBIT,1000000.0,M938465080
17142,1196428',2018-02-17,FDRL/REAL TIME GROSS SETTL,1000000.0,0.0,,2018,2,17,DEBIT,1000000.0,M1834981639
17143,1196428',2018-02-17,NEFT/N048180477257338/PAY,0.0,730538.47,,2018,2,17,TRANSFER,730538.47,M1775303360
17144,1196428',2018-02-17,NEFT/N048180477257316/PAY,0.0,1498642.21,,2018,2,17,TRANSFER,1498642.21,M261084274
17145,1196428',2018-02-17,TRF FROM  Indiaforensic SERVICES,0.0,5000000.0,,2018,2,17,TRANSFER,5000000.0,M1007295516
17146,1196428',2018-02-17,TRF FROM  Indiaforensic SERVICES,0.0,2000000.0,,2018,2,17,TRANSFER,2000000.0,M470234716
17147,1196428',2018-02-17,TRF FROM  Indiaforensic SERVICES,0.0,5000000.0,,2018,2,17,CHECK_CASHING,5000000.0,M905290562
17148,1196428',2018-02-17,TRF FROM  Indiaforensic SERVICES,0.0,5000000.0,,2018,2,17,CHECK_CASHING,5000000.0,M798935213
17149,1196428',2018-02-17,TRF FROM  Indiaforensic SERVICES,0.0,5000000.0,,2018,2,17,TRANSFER,5000000.0,M1932154134
17150,1196428',2018-02-17,NEFT/N048180477331169/PAY,0.0,7000000.0,,2018,2,17,CHECK_CASHING,7000000.0,M1426777731
17151,1196428',2018-02-17,FDRL/NATIONAL ELECTRONIC F,5000000.0,0.0,,2018,2,17,DEBIT,5000000.0,M2001931511
17152,1196428',2018-02-17,FDRL/NATIONAL ELECTRONIC F,5000000.0,0.0,,2018,2,17,PAYEMENT,5000000.0,M1028639221
17153,1196428',2018-02-17,FDRL/NATIONAL ELECTRONIC F,5000000.0,0.0,,2018,2,17,DEBIT,5000000.0,M129965176
17154,1196428',2018-02-17,FDRL/INTERNAL FUND TRANSFE,15000000.0,0.0,,2018,2,17,DEBIT,15000000.0,M1666930496
17155,1196428',2018-02-17,FDRL/INTERNAL FUND TRANSFE,2000000.0,0.0,,2018,2,17,DEBIT,2000000.0,M1348049534
17156,1196428',2018-02-17,NEFT/AXISP18048562573/ACC,0.0,5000000.0,,2018,2,17,CHECK_CASHING,5000000.0,M149861385
17157,1196428',2018-02-19,FDRL/REAL TIME GROSS SETTL,3000000.0,0.0,,2018,2,19,CASH_OUT,3000000.0,M1803845616
17158,1196428',2018-02-19,CASHDEP/VIKASMARG/TP,0.0,66000.0,,2018,2,19,CHECK_CASHING,66000.0,M396463835
17159,1196428',2018-02-19,IB:TPFT0056879381 4090004,0.0,10000.0,,2018,2,19,CHECK_CASHING,10000.0,M1022045468
17160,1196428',2018-02-19,NEFT/BARBS18050362660/MAK,0.0,50550.0,,2018,2,19,TRANSFER,50550.0,M1556446144
17161,1196428',2018-02-19,FDRL/INTERNAL FUND TRANSFE,0.0,2000000.0,,2018,2,19,CHECK_CASHING,2000000.0,M141959252
17162,1196428',2018-02-19,FDRL/INTERNAL FUND TRANSFE,0.0,2000000.0,,2018,2,19,CASH_IN,2000000.0,M1997459283
17163,1196428',2018-02-19,FDRL/REAL TIME GROSS SETTL,5000000.0,0.0,,2018,2,19,DEBIT,5000000.0,M539292855
17164,1196428',2018-02-19,TRF TO  Indiaforensic SERVICES I,350000.0,0.0,,2018,2,19,DEBIT,350000.0,M878266233
17165,1196428',2018-02-19,IMPS 805017262983 FROM DA,0.0,45000.0,,2018,2,19,CASH_IN,45000.0,M1660780699
17166,1196428',2018-02-19,FDRL/INTERNAL FUND TRANSFE,500000.0,0.0,,2018,2,19,CHECK_WITHDRAWAL,500000.0,M1242431450
17167,1196428',2018-02-20,RTGS/HDFCH18051251475/PAY,0.0,16720000.0,,2018,2,20,CHECK_CASHING,16720000.0,M2075133206
17168,1196428',2018-02-20,FDRL/NATIONAL ELECTRONIC F,15004.0,0.0,,2018,2,20,PAYEMENT,15004.0,M1651383848
17169,1196428',2018-02-20,FDRL/REAL TIME GROSS SETTL,15000000.0,0.0,,2018,2,20,DEBIT,15000000.0,M1364290623
17170,1196428',2018-02-20,FDRL/NATIONAL ELECTRONIC F,14667.0,0.0,,2018,2,20,CHECK_WITHDRAWAL,14667.0,M1119145556
17171,1196428',2018-02-20,FDRL/INTERNAL FUND TRANSFE,2000000.0,0.0,,2018,2,20,DEBIT,2000000.0,M552762676
17172,1196428',2018-02-20,Indiaforensic SERVICES INDIA PVT,0.0,3635365.0,,2018,2,20,CASH_IN,3635365.0,M1549335447
17173,1196428',2018-02-20,FDRL/REAL TIME GROSS SETTL,3000000.0,0.0,,2018,2,20,DEBIT,3000000.0,M1407332998
17174,1196428',2018-02-20,NEFT/IT36701802202887/FIX,0.0,140000.0,,2018,2,20,CASH_IN,140000.0,M575173490
17175,1196428',2018-02-20,NEFT/AXISP18051029958/ACC,0.0,2000000.0,,2018,2,20,CHECK_CASHING,2000000.0,M1463959599
17176,1196428',2018-02-20,NEFT/SBIN418051801288/ARV,0.0,11800.0,,2018,2,20,CASH_IN,11800.0,C191614132
17177,1196428',2018-02-20,NEFT/N051180478487641/PAY,0.0,1.0,,2018,2,20,CASH_IN,1.0,C1885712019
17178,1196428',2018-02-20,FDRL/REAL TIME GROSS SETTL,1000000.0,0.0,,2018,2,20,CASH_OUT,1000000.0,M1406881784
17179,1196428',2018-02-20,FDRL/REAL TIME GROSS SETTL,1000000.0,0.0,,2018,2,20,PAYEMENT,1000000.0,C1161865950
17180,1196428',2018-02-20,TRF FRM  Indiaforensic SERVICES,0.0,15000000.0,,2018,2,20,CASH_IN,15000000.0,M1558051277
17181,1196428',2018-02-20,FDRL/REAL TIME GROSS SETTL,15000000.0,0.0,,2018,2,20,DEBIT,15000000.0,M1173085824
17182,1196428',2018-02-20,NEFT/N051180478482431/PAY,0.0,1419662.0,,2018,2,20,CASH_IN,1419662.0,M569018137
17183,1196428',2018-02-20,Indiaforensic SERVICES INDIA PVT,0.0,600669.0,,2018,2,20,CHECK_CASHING,600669.0,M1770271962
17184,1196428',2018-02-20,TRF FRM  Indiaforensic SERVICES,0.0,11500000.0,,2018,2,20,TRANSFER,11500000.0,M1586738337
17185,1196428',2018-02-20,TRF FRM  Indiaforensic SERVICES,0.0,7400000.0,,2018,2,20,CASH_IN,7400000.0,M1674738101
17186,1196428',2018-02-20,FDRL/INTERNAL FUND TRANSFE,10000000.0,0.0,,2018,2,20,CHECK_WITHDRAWAL,10000000.0,C1590550415
17187,1196428',2018-02-20,FDRL/INTERNAL FUND TRANSFE,10000000.0,0.0,,2018,2,20,CHECK_WITHDRAWAL,10000000.0,C705321061
17188,1196428',2018-02-20,FDRL/INTERNAL FUND TRANSFE,1000000.0,0.0,,2018,2,20,PAYEMENT,1000000.0,M873689156
17189,1196428',2018-02-21,NEFT/N052180478929532/TEC,0.0,300000.0,,2018,2,21,CASH_IN,300000.0,M1538317866
17190,1196428',2018-02-21,RTGS/HDFCH18052429934/PAY,0.0,6320000.0,,2018,2,21,TRANSFER,6320000.0,C262828207
17191,1196428',2018-02-21,RTGS/HDFCH18052429916/PAY,0.0,2800000.0,,2018,2,21,TRANSFER,2800000.0,C1222590577
17192,1196428',2018-02-21,NEFT/20436537761DC/ARTHAS,0.0,400000.0,,2018,2,21,CHECK_CASHING,400000.0,M2089852906
17193,1196428',2018-02-21,NEFT/20436535411DC/ARTHAS,0.0,500000.0,,2018,2,21,CASH_IN,500000.0,M629502621
17194,1196428',2018-02-21,FDRL/REAL TIME GROSS SETTL,10000000.0,0.0,,2018,2,21,CHECK_WITHDRAWAL,10000000.0,M511596806
17195,1196428',2018-02-21,FDRL/REAL TIME GROSS SETTL,1000000.0,0.0,,2018,2,21,CASH_OUT,1000000.0,M2079635991
17196,1196428',2018-02-21,TRF FRM  Indiaforensic SERVICES,0.0,5000000.0,,2018,2,21,CHECK_CASHING,5000000.0,M1044456366
17197,1196428',2018-02-21,TRF FRM  Indiaforensic SERVICES,0.0,5000000.0,,2018,2,21,CASH_IN,5000000.0,C1689840534
17198,1196428',2018-02-21,TRF FRM  Indiaforensic SERVICES,0.0,3000000.0,,2018,2,21,CHECK_CASHING,3000000.0,M1092817314
17199,1196428',2018-02-21,FDRL/REAL TIME GROSS SETTL,10000000.0,0.0,,2018,2,21,DEBIT,10000000.0,C1475909248
17200,1196428',2018-02-21,FDRL/REAL TIME GROSS SETTL,1000000.0,0.0,,2018,2,21,DEBIT,1000000.0,M2040472550
17201,1196428',2018-02-21,FDRL/REAL TIME GROSS SETTL,1000000.0,0.0,,2018,2,21,CHECK_WITHDRAWAL,1000000.0,C979719862
17202,1196428',2018-02-21,"Indiaforensic USA, INC./USD/4167",0.0,2688612.92,,2018,2,21,TRANSFER,2688612.92,C985934102
17203,1196428',2018-02-21,IRTT00701805374,1588.95,0.0,,2018,2,21,DEBIT,1588.95,C731253803
17204,1196428',2018-02-21,IB:TPFT0057080781 4090004,0.0,12000.0,,2018,2,21,TRANSFER,12000.0,C1609562230
17205,1196428',2018-02-21,RTGS/SCBLH18052005803/FIX,0.0,300000.0,,2018,2,21,CHECK_CASHING,300000.0,M1076923640
17206,1196428',2018-02-21,NEFT/N052180479194533/PAY,0.0,842764.84,,2018,2,21,TRANSFER,842764.84,M1144262832
17207,1196428',2018-02-21,NEFT/N052180479194473/PAY,0.0,858457.23,,2018,2,21,TRANSFER,858457.23,M942922351
17208,1196428',2018-02-21,FDRL/REAL TIME GROSS SETTL,3000000.0,0.0,,2018,2,21,CASH_OUT,3000000.0,M1582038853
17209,1196428',2018-02-21,FDRL/REAL TIME GROSS SETTL,1000000.0,0.0,,2018,2,21,PAYEMENT,1000000.0,M36034212
17210,1196428',2018-02-21,RTGS/IDFBH18052300932/ART,0.0,10000000.0,,2018,2,21,CASH_IN,10000000.0,M1326356346
17211,1196428',2018-02-21,RTGS/IDFBH18052300935/ART,0.0,10000000.0,,2018,2,21,CHECK_CASHING,10000000.0,C27489818
17212,1196428',2018-02-21,RTGS/IDFBH18052300936/ART,0.0,10000000.0,,2018,2,21,CHECK_CASHING,10000000.0,C747979499
17213,1196428',2018-02-21,FDRL/NATIONAL ELECTRONIC F,10000000.0,0.0,,2018,2,21,CHECK_WITHDRAWAL,10000000.0,C1660095722
17214,1196428',2018-02-21,FDRL/NATIONAL ELECTRONIC F,10000000.0,0.0,,2018,2,21,CHECK_WITHDRAWAL,10000000.0,C372017580
17215,1196428',2018-02-21,Indiaforensic SERVICES INDIA PVT,0.0,876856.0,,2018,2,21,TRANSFER,876856.0,M370179552
17216,1196428',2018-02-21,NEFT/AXISP18052083706/ACC,0.0,2000000.0,,2018,2,21,TRANSFER,2000000.0,C802935635
17217,1196428',2018-02-21,TRF FRM  Indiaforensic SERVICES,0.0,3800000.0,,2018,2,21,CHECK_CASHING,3800000.0,M1523086740
17218,1196428',2018-02-21,TRF FRM  Indiaforensic SERVICES,0.0,10700000.0,,2018,2,21,CASH_IN,10700000.0,M902885640
17219,1196428',2018-02-21,FDRL/INTERNAL FUND TRANSFE,10000000.0,0.0,,2018,2,21,CASH_OUT,10000000.0,C459172227
17220,1196428',2018-02-21,FDRL/INTERNAL FUND TRANSFE,10000000.0,0.0,,2018,2,21,CHECK_WITHDRAWAL,10000000.0,C265108079
17221,1196428',2018-02-21,FDRL/INTERNAL FUND TRANSFE,3000000.0,0.0,,2018,2,21,CASH_OUT,3000000.0,C35126588
17222,1196428',2018-02-21,FDRL/INTERNAL FUND TRANSFE,4000000.0,0.0,,2018,2,21,DEBIT,4000000.0,C1589477624
17223,1196428',2018-02-22,FDRL/INTERNAL FUND TRANSFE,500000.0,0.0,,2018,2,22,CHECK_WITHDRAWAL,500000.0,C1283595719
17224,1196428',2018-02-22,FDRL/INTERNAL FUND TRANSFE,500000.0,0.0,,2018,2,22,CASH_OUT,500000.0,C101084405
17225,1196428',2018-02-22,RTGS/HDFCH18053598318/PAY,0.0,6480000.0,,2018,2,22,TRANSFER,6480000.0,M7891579
17226,1196428',2018-02-22,RTGS/HDFCH18053598331/PAY,0.0,2960000.0,,2018,2,22,CASH_IN,2960000.0,M150228660
17227,1196428',2018-02-22,FDRL/REAL TIME GROSS SETTL,5000000.0,0.0,,2018,2,22,PAYEMENT,5000000.0,M190019040
17228,1196428',2018-02-22,FDRL/INTERNAL FUND TRANSFE,0.0,3000000.0,,2018,2,22,TRANSFER,3000000.0,M1462909495
17229,1196428',2018-02-22,FDRL/REAL TIME GROSS SETTL,5000000.0,0.0,,2018,2,22,DEBIT,5000000.0,C1192983708
17230,1196428',2018-02-22,FDRL/REAL TIME GROSS SETTL,1000000.0,0.0,,2018,2,22,CASH_OUT,1000000.0,M1730398598
17231,1196428',2018-02-22,FDRL/REAL TIME GROSS SETTL,1000000.0,0.0,,2018,2,22,PAYEMENT,1000000.0,M1492635498
17232,1196428',2018-02-22,NEFT/20437925381DC/ARTHAS,0.0,100000.0,,2018,2,22,CHECK_CASHING,100000.0,M738483886
17233,1196428',2018-02-22,CASHDEP/VIKASMARG/TP,0.0,43000.0,,2018,2,22,CHECK_CASHING,43000.0,M1583014678
17234,1196428',2018-02-22,NEFT/IT36701802222967/FIX,0.0,100000.0,,2018,2,22,CASH_IN,100000.0,C395114097
17235,1196428',2018-02-22,NEFT/N053180479926484/PAY,0.0,841949.51,,2018,2,22,CHECK_CASHING,841949.51,M743943553
17236,1196428',2018-02-22,NEFT/N053180479935865/PAY,0.0,1529888.86,,2018,2,22,CHECK_CASHING,1529888.86,M2034445578
17237,1196428',2018-02-22,Indiaforensic SERVICES INDIA PVT,0.0,947958.0,,2018,2,22,CHECK_CASHING,947958.0,C1383942363
17238,1196428',2018-02-22,TRF FRM  Indiaforensic ONLINE SE,0.0,7500000.0,,2018,2,22,CASH_IN,7500000.0,M72285092
17239,1196428',2018-02-22,FDRL/NATIONAL ELECTRONIC F,10000000.0,0.0,,2018,2,22,PAYEMENT,10000000.0,M586185216
17240,1196428',2018-02-22,TRF FRM  Indiaforensic SERVICES,0.0,2647330.0,,2018,2,22,CHECK_CASHING,2647330.0,M1378755468
17241,1196428',2018-02-22,TRF FRM  Indiaforensic SERVICES,0.0,3400000.0,,2018,2,22,TRANSFER,3400000.0,C765980478
17242,1196428',2018-02-22,FDRL/NATIONAL ELECTRONIC F,5000000.0,0.0,,2018,2,22,CHECK_WITHDRAWAL,5000000.0,C1200314947
17243,1196428',2018-02-22,FDRL/INTERNAL FUND TRANSFE,300000.0,0.0,,2018,2,22,DEBIT,300000.0,C1973491942
17244,1196428',2018-02-22,FDRL/INTERNAL FUND TRANSFE,200000.0,0.0,,2018,2,22,CHECK_WITHDRAWAL,200000.0,C1689374891
17245,1196428',2018-02-22,FDRL/INTERNAL FUND TRANSFE,500000.0,0.0,,2018,2,22,CHECK_WITHDRAWAL,500000.0,C2053639017
17246,1196428',2018-02-22,TRF FRM  Indiaforensic SERVICES,0.0,9200000.0,,2018,2,22,CHECK_CASHING,9200000.0,C1654056127
17247,1196428',2018-02-22,BEAT CSH PKP DEL GURG 617,0.0,325500.0,,2018,2,22,TRANSFER,325500.0,C803368825
17248,1196428',2018-02-22,FDRL/INTERNAL FUND TRANSFE,10000000.0,0.0,,2018,2,22,CASH_OUT,10000000.0,C892686452
17249,1196428',2018-02-22,FDRL/INTERNAL FUND TRANSFE,1000000.0,0.0,,2018,2,22,DEBIT,1000000.0,C2031563133
17250,1196428',2018-02-23,NEFT/AXISP18054001063/ACC,0.0,3000000.0,,2018,2,23,CASH_IN,3000000.0,C1619402333
17251,1196428',2018-02-23,RTGS/HDFCH18054767126/PAY,0.0,6560000.0,,2018,2,23,CHECK_CASHING,6560000.0,C1149273771
17252,1196428',2018-02-23,RTGS/HDFCH18054767093/PAY,0.0,2480000.0,,2018,2,23,CHECK_CASHING,2480000.0,C2109470512
17253,1196428',2018-02-23,FDRL/REAL TIME GROSS SETTL,10000000.0,0.0,,2018,2,23,DEBIT,10000000.0,C1059781259
17254,1196428',2018-02-23,FDRL/REAL TIME GROSS SETTL,1000000.0,0.0,,2018,2,23,PAYEMENT,1000000.0,C125722707
17255,1196428',2018-02-23,FDRL/REAL TIME GROSS SETTL,1000000.0,0.0,,2018,2,23,PAYEMENT,1000000.0,C1778300121
17256,1196428',2018-02-23,NEFT/AXISP18054027087/ACC,0.0,17000000.0,,2018,2,23,TRANSFER,17000000.0,C313124964
17257,1196428',2018-02-23,FDRL/REAL TIME GROSS SETTL,15000000.0,0.0,,2018,2,23,PAYEMENT,15000000.0,C1220897602
17258,1196428',2018-02-23,RTGS/IDFBH18054300693/ART,0.0,10000000.0,,2018,2,23,TRANSFER,10000000.0,C1515704208
17259,1196428',2018-02-23,RTGS/IDFBH18054300676/ART,0.0,10000000.0,,2018,2,23,TRANSFER,10000000.0,C1313534832
17260,1196428',2018-02-23,RTGS/IDFBH18054300680/ART,0.0,9000000.0,,2018,2,23,CASH_IN,9000000.0,C1141137903
17261,1196428',2018-02-23,"Indiaforensic USA, INC./USD/2998",0.0,1934932.05,,2018,2,23,TRANSFER,1934932.05,C1869228744
17262,1196428',2018-02-23,IRTT00701805711,1453.29,0.0,,2018,2,23,DEBIT,1453.29,C2078250226
17263,1196428',2018-02-23,FDRL/REAL TIME GROSS SETTL,15000000.0,0.0,,2018,2,23,DEBIT,15000000.0,C1300519073
17264,1196428',2018-02-23,FDRL/REAL TIME GROSS SETTL,15000000.0,0.0,,2018,2,23,DEBIT,15000000.0,M1808484670
17265,1196428',2018-02-23,CASHDEP/HAUS KHAS/,0.0,30000.0,,2018,2,23,CHECK_CASHING,30000.0,M829035073
17266,1196428',2018-02-23,TRF FRM  Indiaforensic ONLINE SE,0.0,73519.0,,2018,2,23,TRANSFER,73519.0,M1674174327
17267,1196428',2018-02-23,NEFT/20439292911DC/ARTHAS,0.0,25000.0,,2018,2,23,TRANSFER,25000.0,M2135203084
17268,1196428',2018-02-23,FDRL/REAL TIME GROSS SETTL,1000000.0,0.0,,2018,2,23,CHECK_WITHDRAWAL,1000000.0,C1673971173
17269,1196428',2018-02-23,FDRL/REAL TIME GROSS SETTL,1000000.0,0.0,,2018,2,23,CHECK_WITHDRAWAL,1000000.0,C339099861
17270,1196428',2018-02-23,FDRL/REAL TIME GROSS SETTL,1000000.0,0.0,,2018,2,23,CHECK_WITHDRAWAL,1000000.0,M2045422556
17271,1196428',2018-02-23,NEFT/N054180480667688/PAY,0.0,616271.2,,2018,2,23,CASH_IN,616271.2,C1266035080
17272,1196428',2018-02-23,NEFT/N054180480667705/PAY,0.0,6711043.14,,2018,2,23,TRANSFER,6711043.14,C1060041730
17273,1196428',2018-02-23,Indiaforensic SERVICES INDIA PVT,0.0,1019029.0,,2018,2,23,CASH_IN,1019029.0,C1475395523
17274,1196428',2018-02-23,IMPS 805417429905 FROM DA,0.0,25000.0,,2018,2,23,CASH_IN,25000.0,C265845794
17275,1196428',2018-02-23,NEFT/N054180480781519/PAY,0.0,6500000.0,,2018,2,23,CASH_IN,6500000.0,C58091972
17276,1196428',2018-02-23,FDRL/INTERNAL FUND TRANSFE,1000000.0,0.0,,2018,2,23,DEBIT,1000000.0,C193864812
17277,1196428',2018-02-23,FDRL/INTERNAL FUND TRANSFE,2000000.0,0.0,,2018,2,23,CASH_OUT,2000000.0,C681835572
17278,1196428',2018-02-23,IMPS 805417311438 FROM SA,0.0,200000.0,,2018,2,23,TRANSFER,200000.0,C965197768
17279,1196428',2018-02-23,TRF FRM  Indiaforensic SERVICES,0.0,3500000.0,,2018,2,23,CHECK_CASHING,3500000.0,C893038039
17280,1196428',2018-02-23,TRF FRM  Indiaforensic SERVICES,0.0,9600000.0,,2018,2,23,CHECK_CASHING,9600000.0,C1317731757
17281,1196428',2018-02-23,YOURSELF FOR BULK NEFT  B,8966080.0,0.0,,2018,2,23,CHECK_WITHDRAWAL,8966080.0,C1373467808
17282,1196428',2018-02-23,BEAT CSH PKP DEL GURG 617,0.0,234000.0,,2018,2,23,TRANSFER,234000.0,C1318822808
17283,1196428',2018-02-23,PBGI01001800044:Bank Guar,11800.0,0.0,,2018,2,23,CASH_OUT,11800.0,C1424731356
17284,1196428',2018-02-23,FDRL/INTERNAL FUND TRANSFE,0.0,2000000.0,,2018,2,23,TRANSFER,2000000.0,C1439007204
17285,1196428',2018-02-23,FDRL/INTERNAL FUND TRANSFE,6000000.0,0.0,,2018,2,23,PAYEMENT,6000000.0,C1116292004
17286,1196428',2018-02-23,FDRL/INTERNAL FUND TRANSFE,6000000.0,0.0,,2018,2,23,CASH_OUT,6000000.0,C638551812
17287,1196428',2018-02-23,FDRL/INTERNAL FUND TRANSFE,6000000.0,0.0,,2018,2,23,PAYEMENT,6000000.0,C193826743
17288,1196428',2018-02-23,FDRL/INTERNAL FUND TRANSFE,500000.0,0.0,,2018,2,23,PAYEMENT,500000.0,C309167705
17289,1196428',2018-02-26,CASHDEP/VIKASMARG/TP,0.0,50000.0,,2018,2,26,CHECK_CASHING,50000.0,C811597470
17290,1196428',2018-02-26,RTGS/HDFCH18057970667/PAY,0.0,14480000.0,,2018,2,26,TRANSFER,14480000.0,C1014923261
17291,1196428',2018-02-26,FDRL/REAL TIME GROSS SETTL,10000000.0,0.0,,2018,2,26,CHECK_WITHDRAWAL,10000000.0,C925574515
17292,1196428',2018-02-26,FDRL/REAL TIME GROSS SETTL,1000000.0,0.0,,2018,2,26,CHECK_WITHDRAWAL,1000000.0,C1988152146
17293,1196428',2018-02-26,FDRL/REAL TIME GROSS SETTL,1000000.0,0.0,,2018,2,26,CASH_OUT,1000000.0,C71555810
17294,1196428',2018-02-26,FDRL/REAL TIME GROSS SETTL,1000000.0,0.0,,2018,2,26,CHECK_WITHDRAWAL,1000000.0,C1273939873
17295,1196428',2018-02-26,FDRL/NATIONAL ELECTRONIC F,486249.0,0.0,,2018,2,26,CHECK_WITHDRAWAL,486249.0,C749672494
17296,1196428',2018-02-26,FDRL/INTERNAL FUND TRANSFE,500000.0,0.0,,2018,2,26,CASH_OUT,500000.0,C1504109395
17297,1196428',2018-02-26,FDRL/INTERNAL FUND TRANSFE,500000.0,0.0,,2018,2,26,DEBIT,500000.0,C2107268831
17298,1196428',2018-02-26,NEFT/N057180481831788/PAY,0.0,1.0,,2018,2,26,CHECK_CASHING,1.0,C1141137903
17299,1196428',2018-02-26,IMPS 805717539043 FROM DA,0.0,20000.0,,2018,2,26,CASH_IN,20000.0,M492166970
17300,1196428',2018-02-26,NEFT/N057180481832076/PAY,0.0,3666836.92,,2018,2,26,CHECK_CASHING,3666836.92,C762570948
17301,1196428',2018-02-26,NEFT/N057180481828228/Indfor,0.0,2000000.0,,2018,2,26,TRANSFER,2000000.0,C1440282299
17302,1196428',2018-02-26,NEFT/N057180481974874/TEC,0.0,200000.0,,2018,2,26,CHECK_CASHING,200000.0,M1583639547
17303,1196428',2018-02-26,TRF FROM  Indiaforensic SERVICES,0.0,2700000.0,,2018,2,26,CHECK_CASHING,2700000.0,M1476691574
17304,1196428',2018-02-26,TRF FROM  Indiaforensic SERVICES,0.0,15000000.0,,2018,2,26,CASH_IN,15000000.0,C893339434
17305,1196428',2018-02-26,TRF FROM  Indiaforensic SERVICES,0.0,13600000.0,,2018,2,26,TRANSFER,13600000.0,M722806861
17306,1196428',2018-02-26,TRF FROM  Indiaforensic SERVICES,0.0,10200000.0,,2018,2,26,CASH_IN,10200000.0,C1150610696
17307,1196428',2018-02-26,FDRL/INTERNAL FUND TRANSFE,15000000.0,0.0,,2018,2,26,CHECK_WITHDRAWAL,15000000.0,C1674899618
17308,1196428',2018-02-26,FDRL/INTERNAL FUND TRANSFE,15000000.0,0.0,,2018,2,26,CASH_OUT,15000000.0,M481126602
17309,1196428',2018-02-26,FDRL/INTERNAL FUND TRANSFE,15000000.0,0.0,,2018,2,26,CASH_OUT,15000000.0,C1793325972
17310,1196428',2018-02-26,BEAT CSH PKP DEL GURG 617,0.0,318000.0,,2018,2,26,TRANSFER,318000.0,M132360639
17311,1196428',2018-02-26,FDRL/INTERNAL FUND TRANSFE,3000000.0,0.0,,2018,2,26,PAYEMENT,3000000.0,M2052092920
17312,1196428',2018-02-27,RTGS/HDFCH18058209475/PAY,0.0,2660000.0,,2018,2,27,TRANSFER,2660000.0,M236650472
17313,1196428',2018-02-27,RTGS/HDFCH18058209503/PAY,0.0,4000000.0,,2018,2,27,CASH_IN,4000000.0,M2089634452
17314,1196428',2018-02-27,Indiaforensic SERVICES INDIA PVT,0.0,2436199.0,,2018,2,27,CHECK_CASHING,2436199.0,M1097809105
17315,1196428',2018-02-27,FDRL/NATIONAL ELECTRONIC F,5000000.0,0.0,,2018,2,27,CHECK_WITHDRAWAL,5000000.0,C302025300
17316,1196428',2018-02-27,FDRL/REAL TIME GROSS SETTL,1000000.0,0.0,,2018,2,27,DEBIT,1000000.0,M134742492
17317,1196428',2018-02-27,FDRL/REAL TIME GROSS SETTL,1000000.0,0.0,,2018,2,27,CASH_OUT,1000000.0,C1511785794
17318,1196428',2018-02-27,FDRL/REAL TIME GROSS SETTL,1000000.0,0.0,,2018,2,27,CASH_OUT,1000000.0,M1604293868
17319,1196428',2018-02-27,FDRL/REAL TIME GROSS SETTL,1000000.0,0.0,,2018,2,27,DEBIT,1000000.0,M1853641629
17320,1196428',2018-02-27,NEFT/IT36701802273995/FIX,0.0,120000.0,,2018,2,27,CHECK_CASHING,120000.0,M710600916
17321,1196428',2018-02-27,CASHDEP/SILVASSA/,0.0,25000.0,,2018,2,27,TRANSFER,25000.0,M985323561
17322,1196428',2018-02-27,NEFT/N058180482637471/PAY,0.0,1051242.24,,2018,2,27,CASH_IN,1051242.24,M1194715097
17323,1196428',2018-02-27,NEFT/N058180482653121/PAY,0.0,1123476.17,,2018,2,27,CHECK_CASHING,1123476.17,M693684695
17324,1196428',2018-02-27,IMPS 805817587934 FROM DA,0.0,10000.0,,2018,2,27,CHECK_CASHING,10000.0,M1582319135
17325,1196428',2018-02-27,TRF FROM  Indiaforensic SERVICES,0.0,10700000.0,,2018,2,27,TRANSFER,10700000.0,M227290600
17326,1196428',2018-02-27,TRF FROM  Indiaforensic SERVICES,0.0,2800000.0,,2018,2,27,CASH_IN,2800000.0,M2089806029
17327,1196428',2018-02-27,NEFT/20443258981DC/ARTHAS,0.0,275000.0,,2018,2,27,TRANSFER,275000.0,M1477278751
17328,1196428',2018-02-27,STAMP PAPER PURCHASING,100.0,0.0,,2018,2,27,CHECK_WITHDRAWAL,100.0,M1650385017
17329,1196428',2018-02-27,FDRL/INTERNAL FUND TRANSFE,8000000.0,0.0,,2018,2,27,DEBIT,8000000.0,M1921059756
17330,1196428',2018-02-27,FDRL/INTERNAL FUND TRANSFE,8000000.0,0.0,,2018,2,27,DEBIT,8000000.0,M590434145
17331,1196428',2018-02-27,FDRL/INTERNAL FUND TRANSFE,0.0,2000000.0,,2018,2,27,CHECK_CASHING,2000000.0,M1671621366
17332,1196428',2018-02-27,FDRL/INTERNAL FUND TRANSFE,0.0,500000.0,,2018,2,27,CASH_IN,500000.0,M899686935
17333,1196428',2018-02-27,FDRL/INTERNAL FUND TRANSFE,0.0,2000000.0,,2018,2,27,CHECK_CASHING,2000000.0,M2054039573
17334,1196428',2018-02-27,BEAT CSH PKP DEL GURG 617,0.0,288600.0,,2018,2,27,CASH_IN,288600.0,M1271480561
17335,1196428',2018-02-28,RTGS/HDFCH18059393742/PAY,0.0,3360000.0,,2018,2,28,CHECK_CASHING,3360000.0,C1259769769
17336,1196428',2018-02-28,RTGS/HDFCH18059397961/PAY,0.0,5280000.0,,2018,2,28,CHECK_CASHING,5280000.0,M649539827
17337,1196428',2018-02-28,FDRL/INTERNAL FUND TRANSFE,1000000.0,0.0,,2018,2,28,DEBIT,1000000.0,C893350828
17338,1196428',2018-02-28,FDRL/REAL TIME GROSS SETTL,10000000.0,0.0,,2018,2,28,PAYEMENT,10000000.0,M20364107
17339,1196428',2018-02-28,FDRL/REAL TIME GROSS SETTL,1000000.0,0.0,,2018,2,28,CASH_OUT,1000000.0,M2023197227
17340,1196428',2018-02-28,FDRL/REAL TIME GROSS SETTL,1000000.0,0.0,,2018,2,28,DEBIT,1000000.0,C232812328
17341,1196428',2018-02-28,IRTT00701806206,1580.08,0.0,,2018,2,28,DEBIT,1580.08,M902890505
17342,1196428',2018-02-28,"Indiaforensic USA, INC./USD/4074",0.0,2639323.77,,2018,2,28,CASH_IN,2639323.77,M1465861273
17343,1196428',2018-02-28,Indiaforensic SERVICES INDIA PVT,0.0,773169.0,,2018,2,28,CHECK_CASHING,773169.0,M949506330
17344,1196428',2018-02-28,IB:TPFT0057674851 4090004,0.0,11000.0,,2018,2,28,CHECK_CASHING,11000.0,M2084969506
17345,1196428',2018-02-28,FDRL/REAL TIME GROSS SETTL,1000000.0,0.0,,2018,2,28,CHECK_WITHDRAWAL,1000000.0,M608038618
17346,1196428',2018-02-28,FDRL/REAL TIME GROSS SETTL,1000000.0,0.0,,2018,2,28,PAYEMENT,1000000.0,M1041764081
17347,1196428',2018-02-28,FDRL/REAL TIME GROSS SETTL,1000000.0,0.0,,2018,2,28,CHECK_WITHDRAWAL,1000000.0,M277788688
17348,1196428',2018-02-28,FDRL/REAL TIME GROSS SETTL,1000000.0,0.0,,2018,2,28,CASH_OUT,1000000.0,M31440957
17349,1196428',2018-02-28,FDRL/INTERNAL FUND TRANSFE,0.0,2000000.0,,2018,2,28,TRANSFER,2000000.0,C1805162633
17350,1196428',2018-02-28,NEFT/N059180483981641/PAY,0.0,688470.22,,2018,2,28,TRANSFER,688470.22,M1201023997
17351,1196428',2018-02-28,NEFT/N059180483986546/PAY,0.0,1205946.33,,2018,2,28,CASH_IN,1205946.33,M1412743565
17352,1196428',2018-02-28,TRF FROM  Indiaforensic SERVICES,0.0,13300000.0,,2018,2,28,TRANSFER,13300000.0,M1887477561
17353,1196428',2018-02-28,FDRL/NATIONAL ELECTRONIC F,5000000.0,0.0,,2018,2,28,CHECK_WITHDRAWAL,5000000.0,C435161028
17354,1196428',2018-02-28,FDRL/NATIONAL ELECTRONIC F,5000000.0,0.0,,2018,2,28,PAYEMENT,5000000.0,M2126024846
17355,1196428',2018-02-28,FDRL/INTERNAL FUND TRANSFE,500000.0,0.0,,2018,2,28,PAYEMENT,500000.0,M885738476
17356,1196428',2018-02-28,FDRL/INTERNAL FUND TRANSFE,500000.0,0.0,,2018,2,28,CHECK_WITHDRAWAL,500000.0,C1273939873
17357,1196428',2018-02-28,IMPS 805918645943 FROM DA,0.0,20000.0,,2018,2,28,CHECK_CASHING,20000.0,C464094472
17358,1196428',2018-02-28,TRF FROM  Indiaforensic SERVICES,0.0,4800000.0,,2018,2,28,CASH_IN,4800000.0,C1475998599
17359,1196428',2018-02-28,YOURSELF FOR BULK NEFT  B,9286145.0,0.0,,2018,2,28,CHECK_WITHDRAWAL,9286145.0,C1789550256
17360,1196428',2018-02-28,BEAT CSH PKP DEL GURG 617,0.0,218000.0,,2018,2,28,TRANSFER,218000.0,C1805445027
17361,1196428',2018-02-28,1196428:Int.Coll:01-02-20,733033.0,0.0,,2018,2,28,CHECK_WITHDRAWAL,733033.0,C968448640
17362,1196428',2018-03-01,NEFT/SBIN318059031819/Indfor,0.0,4000000.0,,2018,3,1,TRANSFER,4000000.0,C691636444
17363,1196428',2018-03-01,RTGS/IDFBH18060300294/ART,0.0,10000000.0,,2018,3,1,CHECK_CASHING,10000000.0,C1778801068
17364,1196428',2018-03-01,RTGS/IDFBH18060300305/ART,0.0,10000000.0,,2018,3,1,TRANSFER,10000000.0,C2029896123
17365,1196428',2018-03-01,RTGS/IDFBH18060300295/ART,0.0,4000000.0,,2018,3,1,CASH_IN,4000000.0,C1677727024
17366,1196428',2018-03-01,FDRL/INTERNAL FUND TRANSFE,1000000.0,0.0,,2018,3,1,CASH_OUT,1000000.0,C1525944481
17367,1196428',2018-03-01,FDRL/INTERNAL FUND TRANSFE,1000000.0,0.0,,2018,3,1,PAYEMENT,1000000.0,C481402298
17368,1196428',2018-03-01,FDRL/REAL TIME GROSS SETTL,10000000.0,0.0,,2018,3,1,PAYEMENT,10000000.0,C177457290
17369,1196428',2018-03-01,FDRL/REAL TIME GROSS SETTL,15000000.0,0.0,,2018,3,1,PAYEMENT,15000000.0,M1138171728
17370,1196428',2018-03-01,RTGS/HDFCH18060629666/PAY,0.0,4800000.0,,2018,3,1,TRANSFER,4800000.0,C1452722471
17371,1196428',2018-03-01,RTGS/HDFCH18060629689/PAY,0.0,2480000.0,,2018,3,1,TRANSFER,2480000.0,C861958315
17372,1196428',2018-03-01,FDRL/INTERNAL FUND TRANSFE,500000.0,0.0,,2018,3,1,CHECK_WITHDRAWAL,500000.0,M919438675
17373,1196428',2018-03-01,FDRL/INTERNAL FUND TRANSFE,500000.0,0.0,,2018,3,1,CHECK_WITHDRAWAL,500000.0,M1501022601
17374,1196428',2018-03-01,FDRL/INTERNAL FUND TRANSFE,300000.0,0.0,,2018,3,1,CASH_OUT,300000.0,M397708705
17375,1196428',2018-03-01,FDRL/INTERNAL FUND TRANSFE,200000.0,0.0,,2018,3,1,DEBIT,200000.0,M1092898377
17376,1196428',2018-03-01,FDRL/REAL TIME GROSS SETTL,5000000.0,0.0,,2018,3,1,CASH_OUT,5000000.0,M1957947378
17377,1196428',2018-03-01,Indiaforensic SERVICES INDIA PVT,0.0,874349.0,,2018,3,1,CHECK_CASHING,874349.0,C785703145
17378,1196428',2018-03-01,NEFT/N060180485026063/TEC,0.0,300000.0,,2018,3,1,CASH_IN,300000.0,M2094125621
17379,1196428',2018-03-01,FDRL/INTERNAL FUND TRANSFE,2500000.0,0.0,,2018,3,1,CHECK_WITHDRAWAL,2500000.0,M1918034019
17380,1196428',2018-03-01,FDRL/NATIONAL ELECTRONIC F,69733.0,0.0,,2018,3,1,CASH_OUT,69733.0,M745483242
17381,1196428',2018-03-01,FDRL/INTERNAL FUND TRANSFE,6064.0,0.0,,2018,3,1,CHECK_WITHDRAWAL,6064.0,M1878714361
17382,1196428',2018-03-01,TRF FROM  Indiaforensic SERVICES,0.0,13200000.0,,2018,3,1,CHECK_CASHING,13200000.0,M203939387
17383,1196428',2018-03-01,TRF FROM  Indiaforensic SERVICES,0.0,3600000.0,,2018,3,1,CASH_IN,3600000.0,C382934088
17384,1196428',2018-03-01,NEFT/AXISP18060568543/ACC,0.0,7000000.0,,2018,3,1,CASH_IN,7000000.0,C158876320
17385,1196428',2018-03-01,Indiaforensic SERVICES INDIA PVT,0.0,759352.0,,2018,3,1,CHECK_CASHING,759352.0,C732929236
17386,1196428',2018-03-01,YOURSELF FOR BULK NEFT  B,11398700.0,0.0,,2018,3,1,CHECK_WITHDRAWAL,11398700.0,C1554622120
17387,1196428',2018-03-01,NEFT/N060180485669830/PAY,0.0,779550.06,,2018,3,1,TRANSFER,779550.06,C1359484306
17388,1196428',2018-03-01,NEFT/N060180485669832/PAY,0.0,1396398.54,,2018,3,1,TRANSFER,1396398.54,C1782704802
17389,1196428',2018-03-01,BEAT CSH PKP DEL GURG 617,0.0,91500.0,,2018,3,1,CHECK_CASHING,91500.0,C1609562230
17390,1196428',2018-03-01,NEFT/N060180485897808/PAY,0.0,2000000.0,,2018,3,1,TRANSFER,2000000.0,C1220897602
17391,1196428',2018-03-01,FDRL/INTERNAL FUND TRANSFE,7000000.0,0.0,,2018,3,1,PAYEMENT,7000000.0,C1213257323
17392,1196428',2018-03-01,FDRL/INTERNAL FUND TRANSFE,10000000.0,0.0,,2018,3,1,CHECK_WITHDRAWAL,10000000.0,C674913323
17393,1196428',2018-03-03,RTGS/HDFCH18062779841/PAY,0.0,900000.0,,2018,3,3,TRANSFER,900000.0,C803116137
17394,1196428',2018-03-03,RTGS/HDFCH18062784528/PAY,0.0,3840000.0,,2018,3,3,CASH_IN,3840000.0,C1450417897
17395,1196428',2018-03-03,CASHDEP/VIKASMARG/TP,0.0,84000.0,,2018,3,3,CASH_IN,84000.0,C826383690
17396,1196428',2018-03-03,FDRL/REAL TIME GROSS SETTL,3000000.0,0.0,,2018,3,3,DEBIT,3000000.0,M1718920203
17397,1196428',2018-03-03,FDRL/REAL TIME GROSS SETTL,3000000.0,0.0,,2018,3,3,CHECK_WITHDRAWAL,3000000.0,M1002711260
17398,1196428',2018-03-03,CASHDEP/HAUS KHAS/ZAHEER,0.0,60000.0,,2018,3,3,CASH_IN,60000.0,C545710008
17399,1196428',2018-03-03,IMPS 806214234242 FROM SA,0.0,50000.0,,2018,3,3,CHECK_CASHING,50000.0,C1838584624
17400,1196428',2018-03-03,TRF FRM  Indiaforensic SERVICES,0.0,5000000.0,,2018,3,3,TRANSFER,5000000.0,C1030706332
17401,1196428',2018-03-03,TRF FRM  Indiaforensic SERVICES,0.0,2000000.0,,2018,3,3,CHECK_CASHING,2000000.0,M2129060443
17402,1196428',2018-03-03,TRF FRM  Indiaforensic SERVICES,0.0,3000000.0,,2018,3,3,CASH_IN,3000000.0,C1195471589
17403,1196428',2018-03-03,TRF FRM  Indiaforensic SERVICES,0.0,4000000.0,,2018,3,3,CASH_IN,4000000.0,M1398128260
17404,1196428',2018-03-03,TRF FRM  Indiaforensic SERVICES,0.0,500000.0,,2018,3,3,TRANSFER,500000.0,C1856036778
17405,1196428',2018-03-03,NEFT/KKBK180628194821/Acc,0.0,12000000.0,,2018,3,3,TRANSFER,12000000.0,C2067546399
17406,1196428',2018-03-03,TRF FRM  Indiaforensic SERVICES,0.0,1000000.0,,2018,3,3,CASH_IN,1000000.0,C818570949
17407,1196428',2018-03-03,FDRL/NATIONAL ELECTRONIC F,5000000.0,0.0,,2018,3,3,DEBIT,5000000.0,M535878604
17408,1196428',2018-03-03,FDRL/NATIONAL ELECTRONIC F,5000000.0,0.0,,2018,3,3,DEBIT,5000000.0,C358945794
17409,1196428',2018-03-03,FDRL/NATIONAL ELECTRONIC F,5000000.0,0.0,,2018,3,3,DEBIT,5000000.0,C922511709
17410,1196428',2018-03-03,TRF FRM  Indiaforensic SERVICES,0.0,500000.0,,2018,3,3,TRANSFER,500000.0,C988138425
17411,1196428',2018-03-03,FDRL/INTERNAL FUND TRANSFE,1000000.0,0.0,,2018,3,3,PAYEMENT,1000000.0,C814900611
17412,1196428',2018-03-03,FDRL/INTERNAL FUND TRANSFE,1000000.0,0.0,,2018,3,3,DEBIT,1000000.0,C1467740330
17413,1196428',2018-03-03,FDRL/INTERNAL FUND TRANSFE,10000000.0,0.0,,2018,3,3,CHECK_WITHDRAWAL,10000000.0,M858308953
17414,1196428',2018-03-03,NEFT/N062180487316952/PAY,0.0,919499.05,,2018,3,3,TRANSFER,919499.05,M1773085261
17415,1196428',2018-03-03,NEFT/N062180487316937/PAY,0.0,246428.16,,2018,3,3,CHECK_CASHING,246428.16,M472606308
17416,1196428',2018-03-03,BEAT CSH PKP DEL GURG 617,0.0,158000.0,,2018,3,3,CHECK_CASHING,158000.0,M51583809
17417,1196428',2018-03-05,FDRL/INTERNAL FUND TRANSFE,0.0,2000000.0,,2018,3,5,CHECK_CASHING,2000000.0,M1337700382
17418,1196428',2018-03-05,FDRL/INTERNAL FUND TRANSFE,0.0,2000000.0,,2018,3,5,CASH_IN,2000000.0,C1918034924
17419,1196428',2018-03-05,FDRL/REAL TIME GROSS SETTL,3000000.0,0.0,,2018,3,5,CHECK_WITHDRAWAL,3000000.0,M527477577
17420,1196428',2018-03-05,FDRL/REAL TIME GROSS SETTL,3000000.0,0.0,,2018,3,5,DEBIT,3000000.0,M577217292
17421,1196428',2018-03-05,FDRL/REAL TIME GROSS SETTL,1000000.0,0.0,,2018,3,5,DEBIT,1000000.0,C184253187
17422,1196428',2018-03-05,RTGS/HDFCH18064935383/PAY,0.0,2560000.0,,2018,3,5,CHECK_CASHING,2560000.0,C1778300121
17423,1196428',2018-03-05,RTGS/HDFCH18064937059/PAY,0.0,6480000.0,,2018,3,5,TRANSFER,6480000.0,C667504652
17424,1196428',2018-03-05,FDRL/REAL TIME GROSS SETTL,2000000.0,0.0,,2018,3,5,PAYEMENT,2000000.0,C638590716
17425,1196428',2018-03-05,FDRL/REAL TIME GROSS SETTL,3000000.0,0.0,,2018,3,5,CHECK_WITHDRAWAL,3000000.0,C1532153384
17426,1196428',2018-03-05,FDRL/REAL TIME GROSS SETTL,3000000.0,0.0,,2018,3,5,CASH_OUT,3000000.0,C208427878
17427,1196428',2018-03-05,FDRL/INTERNAL FUND TRANSFE,1000000.0,0.0,,2018,3,5,CHECK_WITHDRAWAL,1000000.0,C1530086509
17428,1196428',2018-03-05,NEFT/N064180488222246/PAY,0.0,622871.48,,2018,3,5,TRANSFER,622871.48,C703957828
17429,1196428',2018-03-05,NEFT/N064180488222205/PAY,0.0,1733847.56,,2018,3,5,TRANSFER,1733847.56,C891020651
17430,1196428',2018-03-05,Indiaforensic SERVICES INDIA PVT,0.0,761185.0,,2018,3,5,TRANSFER,761185.0,M1680032445
17431,1196428',2018-03-05,TRF FRM  Indiaforensic SERVICES,0.0,11600000.0,,2018,3,5,CASH_IN,11600000.0,C553264065
17432,1196428',2018-03-05,TRF FRM  Indiaforensic SERVICES,0.0,7700000.0,,2018,3,5,TRANSFER,7700000.0,M1097298586
17433,1196428',2018-03-05,FDRL/INTERNAL FUND TRANSFE,15000000.0,0.0,,2018,3,5,DEBIT,15000000.0,M870026554
17434,1196428',2018-03-05,FDRL/INTERNAL FUND TRANSFE,1000000.0,0.0,,2018,3,5,DEBIT,1000000.0,C695653925
17435,1196428',2018-03-05,"Indiaforensic USA, INC./USD/1886",0.0,1222152.62,,2018,3,5,CASH_IN,1222152.62,M1248361658
17436,1196428',2018-03-05,IRTT00701806681,1324.99,0.0,,2018,3,5,CASH_OUT,1324.99,C1689262323
17437,1196428',2018-03-05,BEAT CSH PKP DEL GURG 617,0.0,179000.0,,2018,3,5,CHECK_CASHING,179000.0,C1757877803
17438,1196428',2018-03-06,FT ZL180306D0298F5C PRAVE,0.0,100000.0,,2018,3,6,TRANSFER,100000.0,C1849933855
17439,1196428',2018-03-06,FDRL/REAL TIME GROSS SETTL,2000000.0,0.0,,2018,3,6,CHECK_WITHDRAWAL,2000000.0,C1753128715
17440,1196428',2018-03-06,FDRL/REAL TIME GROSS SETTL,2000000.0,0.0,,2018,3,6,DEBIT,2000000.0,C1527761090
17441,1196428',2018-03-06,FDRL/REAL TIME GROSS SETTL,2000000.0,0.0,,2018,3,6,CASH_OUT,2000000.0,C1754722089
17442,1196428',2018-03-06,FDRL/REAL TIME GROSS SETTL,2000000.0,0.0,,2018,3,6,CHECK_WITHDRAWAL,2000000.0,C1261039678
17443,1196428',2018-03-06,FDRL/INTERNAL FUND TRANSFE,0.0,2000000.0,,2018,3,6,TRANSFER,2000000.0,C836514715
17444,1196428',2018-03-06,FDRL/INTERNAL FUND TRANSFE,0.0,2000000.0,,2018,3,6,CASH_IN,2000000.0,C1640961071
17445,1196428',2018-03-06,FDRL/INTERNAL FUND TRANSFE,0.0,2000000.0,,2018,3,6,CHECK_CASHING,2000000.0,C1838584624
17446,1196428',2018-03-06,FDRL/REAL TIME GROSS SETTL,3000000.0,0.0,,2018,3,6,CHECK_WITHDRAWAL,3000000.0,C1209271652
17447,1196428',2018-03-06,FDRL/REAL TIME GROSS SETTL,3000000.0,0.0,,2018,3,6,DEBIT,3000000.0,C745740822
17448,1196428',2018-03-06,NEFT/20450387051DC/ARTHAS,0.0,275000.0,,2018,3,6,CASH_IN,275000.0,C1401721023
17449,1196428',2018-03-06,RTGS/HDFCH18065129510/PAY,0.0,4800000.0,,2018,3,6,TRANSFER,4800000.0,C47827984
17450,1196428',2018-03-06,RTGS/HDFCH18065133091/PAY,0.0,1520000.0,,2018,3,6,CHECK_CASHING,1520000.0,C1849941462
17451,1196428',2018-03-06,FDRL/INTERNAL FUND TRANSFE,0.0,3000000.0,,2018,3,6,CHECK_CASHING,3000000.0,C70895366
17452,1196428',2018-03-06,FDRL/REAL TIME GROSS SETTL,3000000.0,0.0,,2018,3,6,CASH_OUT,3000000.0,C977993101
17453,1196428',2018-03-06,FDRL/REAL TIME GROSS SETTL,3000000.0,0.0,,2018,3,6,CASH_OUT,3000000.0,C2116873183
17454,1196428',2018-03-06,FDRL/REAL TIME GROSS SETTL,2000000.0,0.0,,2018,3,6,CASH_OUT,2000000.0,C892686452
17455,1196428',2018-03-06,FDRL/REAL TIME GROSS SETTL,1000000.0,0.0,,2018,3,6,CASH_OUT,1000000.0,C1540270363
17456,1196428',2018-03-06,Indiaforensic SERVICES INDIA PVT,0.0,208791.31,,2018,3,6,CHECK_CASHING,208791.31,C534662976
17457,1196428',2018-03-06,NEFT/N065180489372338/PAY,0.0,500859.34,,2018,3,6,TRANSFER,500859.34,C30013970
17458,1196428',2018-03-06,NEFT/N065180489367749/PAY,0.0,1325850.7,,2018,3,6,CHECK_CASHING,1325850.7,C1809373351
17459,1196428',2018-03-06,TRF FRM  Indiaforensic SERVICES,0.0,9000000.0,,2018,3,6,CASH_IN,9000000.0,C741431520
17460,1196428',2018-03-06,NEFT CHARGES AND GST/0000,29.5,0.0,,2018,3,6,DEBIT,29.5,C669771073
17461,1196428',2018-03-06,NEFT/000032795571/ARTHASH,10500000.0,0.0,,2018,3,6,CHECK_WITHDRAWAL,10500000.0,C1915091057
17462,1196428',2018-03-06,NEFT/IDFBH18065565043/ART,0.0,8500000.0,,2018,3,6,CHECK_CASHING,8500000.0,C323287038
17463,1196428',2018-03-06,BEAT CSH PKP DEL GURG 617,0.0,96000.0,,2018,3,6,CHECK_CASHING,96000.0,C1027992087
17464,1196428',2018-03-06,NEFT/N065180489600628/TEC,0.0,200000.0,,2018,3,6,CHECK_CASHING,200000.0,C1435804085
17465,1196428',2018-03-06,TRF FRM  Indiaforensic SERVICES,0.0,4600000.0,,2018,3,6,CASH_IN,4600000.0,C1153596299
17466,1196428',2018-03-06,FDRL/INTERNAL FUND TRANSFE,5000000.0,0.0,,2018,3,6,PAYEMENT,5000000.0,C1541743053
17467,1196428',2018-03-07,FDRL/REAL TIME GROSS SETTL,2000000.0,0.0,,2018,3,7,CASH_OUT,2000000.0,C1213257323
17468,1196428',2018-03-07,FDRL/REAL TIME GROSS SETTL,2000000.0,0.0,,2018,3,7,CASH_OUT,2000000.0,C295081230
17469,1196428',2018-03-07,FDRL/REAL TIME GROSS SETTL,2000000.0,0.0,,2018,3,7,CASH_OUT,2000000.0,C531511436
17470,1196428',2018-03-07,FDRL/REAL TIME GROSS SETTL,1000000.0,0.0,,2018,3,7,CHECK_WITHDRAWAL,1000000.0,C175291188
17471,1196428',2018-03-07,FDRL/REAL TIME GROSS SETTL,2000000.0,0.0,,2018,3,7,CASH_OUT,2000000.0,C1259769769
17472,1196428',2018-03-07,RTGS/HDFCH18066325193/PAY,0.0,1840000.0,,2018,3,7,CASH_IN,1840000.0,C205300866
17473,1196428',2018-03-07,RTGS/HDFCH18066325209/PAY,0.0,4480000.0,,2018,3,7,CHECK_CASHING,4480000.0,C1297873690
17474,1196428',2018-03-07,RTGS/IDFBH18066300504/ART,0.0,500000.0,,2018,3,7,CASH_IN,500000.0,C715819458
17475,1196428',2018-03-07,NEFT/20452070211DC/ARTHAS,0.0,100000.0,,2018,3,7,TRANSFER,100000.0,C18928637
17476,1196428',2018-03-07,NEFT/IT36701803072545/FIX,0.0,150000.0,,2018,3,7,CHECK_CASHING,150000.0,C1079343872
17477,1196428',2018-03-07,NEFT/IDFBH18066569614/ART,0.0,10000000.0,,2018,3,7,TRANSFER,10000000.0,C99275333
17478,1196428',2018-03-07,FDRL/REAL TIME GROSS SETTL,3000000.0,0.0,,2018,3,7,PAYEMENT,3000000.0,C1450828900
17479,1196428',2018-03-07,FDRL/REAL TIME GROSS SETTL,3000000.0,0.0,,2018,3,7,DEBIT,3000000.0,C1339257929
17480,1196428',2018-03-07,FDRL/REAL TIME GROSS SETTL,3000000.0,0.0,,2018,3,7,CASH_OUT,3000000.0,C893041125
17481,1196428',2018-03-07,FDRL/REAL TIME GROSS SETTL,3000000.0,0.0,,2018,3,7,CASH_OUT,3000000.0,C380242442
17482,1196428',2018-03-07,"Indiaforensic USA, INC./USD/4831",0.0,3125932.62,,2018,3,7,CHECK_CASHING,3125932.62,C1220897602
17483,1196428',2018-03-07,IRTT00701806989,1667.67,0.0,,2018,3,7,CHECK_WITHDRAWAL,1667.67,C495071437
17484,1196428',2018-03-07,IMPS 806614440771 FROM SA,0.0,100000.0,,2018,3,7,CASH_IN,100000.0,C1753128715
17485,1196428',2018-03-07,IMPS 806614457561 FROM SA,0.0,50000.0,,2018,3,7,CASH_IN,50000.0,C1387460501
17486,1196428',2018-03-07,FDRL/INTERNAL FUND TRANSFE,1000000.0,0.0,,2018,3,7,CHECK_WITHDRAWAL,1000000.0,C425987411
17487,1196428',2018-03-07,FDRL/REAL TIME GROSS SETTL,2000000.0,0.0,,2018,3,7,CHECK_WITHDRAWAL,2000000.0,C914293025
17488,1196428',2018-03-07,FDRL/REAL TIME GROSS SETTL,3000000.0,0.0,,2018,3,7,DEBIT,3000000.0,C1765998352
17489,1196428',2018-03-07,FDRL/REAL TIME GROSS SETTL,3000000.0,0.0,,2018,3,7,DEBIT,3000000.0,C1651144763
17490,1196428',2018-03-07,TRF FRM  Indiaforensic SERVICES,0.0,9600000.0,,2018,3,7,CHECK_CASHING,9600000.0,C922871524
17491,1196428',2018-03-07,RTGS/IDFBH18066300949/ART,0.0,4000000.0,,2018,3,7,CHECK_CASHING,4000000.0,M362006242
17492,1196428',2018-03-07,FDRL/REAL TIME GROSS SETTL,3000000.0,0.0,,2018,3,7,DEBIT,3000000.0,M1102318995
17493,1196428',2018-03-07,FDRL/REAL TIME GROSS SETTL,3000000.0,0.0,,2018,3,7,CASH_OUT,3000000.0,M1615555170
17494,1196428',2018-03-07,NEFT/N066180490354575/PAY,0.0,633607.6,,2018,3,7,CHECK_CASHING,633607.6,C365212068
17495,1196428',2018-03-07,TRF FRM  Indiaforensic SERVICES,0.0,4600000.0,,2018,3,7,CHECK_CASHING,4600000.0,M325536552
17496,1196428',2018-03-07,NEFT/FDRLH18066055367/VIS,0.0,5644.0,,2018,3,7,CASH_IN,5644.0,M1366710160
17497,1196428',2018-03-07,NEFT/N066180490354548/PAY,0.0,1114022.39,,2018,3,7,CASH_IN,1114022.39,C1185298063
17498,1196428',2018-03-07,Indiaforensic SERVICES INDIA PVT,0.0,189628.0,,2018,3,7,CASH_IN,189628.0,M587701107
17499,1196428',2018-03-07,FUJIAN NEWLAND PAYMENT TE,5459283.2,0.0,,2018,3,7,CASH_OUT,5459283.2,M2028350706
17500,1196428',2018-03-07,IMAR00701801320,8282.67,0.0,,2018,3,7,CASH_OUT,8282.67,M1329614931
17501,1196428',2018-03-07,FDRL/NATIONAL ELECTRONIC F,28950.0,0.0,,2018,3,7,DEBIT,28950.0,C1883840933
17502,1196428',2018-03-07,FDRL/NATIONAL ELECTRONIC F,28610.0,0.0,,2018,3,7,DEBIT,28610.0,C451111351
17503,1196428',2018-03-07,FDRL/NATIONAL ELECTRONIC F,15665.0,0.0,,2018,3,7,CHECK_WITHDRAWAL,15665.0,C265108079
17504,1196428',2018-03-07,FDRL/NATIONAL ELECTRONIC F,18315.0,0.0,,2018,3,7,CASH_OUT,18315.0,M178687580
17505,1196428',2018-03-07,FDRL/NATIONAL ELECTRONIC F,14368.0,0.0,,2018,3,7,DEBIT,14368.0,C871895680
17506,1196428',2018-03-07,FDRL/NATIONAL ELECTRONIC F,18315.0,0.0,,2018,3,7,CHECK_WITHDRAWAL,18315.0,C465257140
17507,1196428',2018-03-07,FDRL/NATIONAL ELECTRONIC F,24090.0,0.0,,2018,3,7,CASH_OUT,24090.0,M818036683
17508,1196428',2018-03-07,FDRL/NATIONAL ELECTRONIC F,26350.0,0.0,,2018,3,7,CHECK_WITHDRAWAL,26350.0,M157096748
17509,1196428',2018-03-07,FDRL/NATIONAL ELECTRONIC F,18402.0,0.0,,2018,3,7,CASH_OUT,18402.0,C1348669431
17510,1196428',2018-03-07,FDRL/NATIONAL ELECTRONIC F,28611.0,0.0,,2018,3,7,CHECK_WITHDRAWAL,28611.0,M1426770995
17511,1196428',2018-03-07,FDRL/NATIONAL ELECTRONIC F,18552.0,0.0,,2018,3,7,PAYEMENT,18552.0,M75464840
17512,1196428',2018-03-07,FDRL/NATIONAL ELECTRONIC F,15105.0,0.0,,2018,3,7,CHECK_WITHDRAWAL,15105.0,M2093954864
17513,1196428',2018-03-07,FDRL/NATIONAL ELECTRONIC F,28610.0,0.0,,2018,3,7,CASH_OUT,28610.0,M1235236113
17514,1196428',2018-03-07,FDRL/NATIONAL ELECTRONIC F,20552.0,0.0,,2018,3,7,DEBIT,20552.0,M193919297
17515,1196428',2018-03-07,FDRL/NATIONAL ELECTRONIC F,26261.0,0.0,,2018,3,7,CASH_OUT,26261.0,M1854130633
17516,1196428',2018-03-07,FDRL/NATIONAL ELECTRONIC F,28610.0,0.0,,2018,3,7,CHECK_WITHDRAWAL,28610.0,M1969857643
17517,1196428',2018-03-07,FDRL/NATIONAL ELECTRONIC F,16869.0,0.0,,2018,3,7,PAYEMENT,16869.0,M946862393
17518,1196428',2018-03-07,FDRL/NATIONAL ELECTRONIC F,12629.0,0.0,,2018,3,7,PAYEMENT,12629.0,M30052861
17519,1196428',2018-03-07,FDRL/NATIONAL ELECTRONIC F,7998.0,0.0,,2018,3,7,CASH_OUT,7998.0,M466077895
17520,1196428',2018-03-07,FDRL/NATIONAL ELECTRONIC F,25058.0,0.0,,2018,3,7,CHECK_WITHDRAWAL,25058.0,M915773790
17521,1196428',2018-03-07,FDRL/NATIONAL ELECTRONIC F,9125.0,0.0,,2018,3,7,PAYEMENT,9125.0,M2111532531
17522,1196428',2018-03-07,FDRL/NATIONAL ELECTRONIC F,7498.0,0.0,,2018,3,7,CASH_OUT,7498.0,M689497047
17523,1196428',2018-03-07,FDRL/NATIONAL ELECTRONIC F,14368.0,0.0,,2018,3,7,CASH_OUT,14368.0,M795555929
17524,1196428',2018-03-07,FDRL/NATIONAL ELECTRONIC F,9125.0,0.0,,2018,3,7,DEBIT,9125.0,M471839974
17525,1196428',2018-03-07,FDRL/NATIONAL ELECTRONIC F,7498.0,0.0,,2018,3,7,CASH_OUT,7498.0,M683161496
17526,1196428',2018-03-07,FDRL/NATIONAL ELECTRONIC F,8875.0,0.0,,2018,3,7,DEBIT,8875.0,M73571113
17527,1196428',2018-03-07,FDRL/NATIONAL ELECTRONIC F,7498.0,0.0,,2018,3,7,CHECK_WITHDRAWAL,7498.0,M136454531
17528,1196428',2018-03-07,FDRL/NATIONAL ELECTRONIC F,8875.0,0.0,,2018,3,7,DEBIT,8875.0,C2042233477
17529,1196428',2018-03-07,FDRL/NATIONAL ELECTRONIC F,7498.0,0.0,,2018,3,7,CHECK_WITHDRAWAL,7498.0,C1802632685
17530,1196428',2018-03-07,FDRL/NATIONAL ELECTRONIC F,28610.0,0.0,,2018,3,7,CHECK_WITHDRAWAL,28610.0,M650390184
17531,1196428',2018-03-07,FDRL/NATIONAL ELECTRONIC F,12629.0,0.0,,2018,3,7,DEBIT,12629.0,M1834166291
17532,1196428',2018-03-07,FDRL/NATIONAL ELECTRONIC F,11013.0,0.0,,2018,3,7,CASH_OUT,11013.0,M1288124711
17533,1196428',2018-03-07,FDRL/NATIONAL ELECTRONIC F,8875.0,0.0,,2018,3,7,DEBIT,8875.0,M1741355624
17534,1196428',2018-03-07,FDRL/NATIONAL ELECTRONIC F,17956.0,0.0,,2018,3,7,CHECK_WITHDRAWAL,17956.0,M1467569099
17535,1196428',2018-03-07,FDRL/NATIONAL ELECTRONIC F,5088.0,0.0,,2018,3,7,CASH_OUT,5088.0,C701279123
17536,1196428',2018-03-07,FDRL/NATIONAL ELECTRONIC F,28959.0,0.0,,2018,3,7,DEBIT,28959.0,C349015546
17537,1196428',2018-03-07,FDRL/NATIONAL ELECTRONIC F,8700.0,0.0,,2018,3,7,DEBIT,8700.0,C2100990049
17538,1196428',2018-03-07,FDRL/NATIONAL ELECTRONIC F,37667.0,0.0,,2018,3,7,CASH_OUT,37667.0,C2127862399
17539,1196428',2018-03-07,FDRL/NATIONAL ELECTRONIC F,33594.0,0.0,,2018,3,7,DEBIT,33594.0,C614438306
17540,1196428',2018-03-07,FDRL/NATIONAL ELECTRONIC F,36874.0,0.0,,2018,3,7,CHECK_WITHDRAWAL,36874.0,C1201057368
17541,1196428',2018-03-07,FDRL/NATIONAL ELECTRONIC F,35416.0,0.0,,2018,3,7,DEBIT,35416.0,C1371191175
17542,1196428',2018-03-07,FDRL/NATIONAL ELECTRONIC F,30657.0,0.0,,2018,3,7,CASH_OUT,30657.0,C655702946
17543,1196428',2018-03-07,FDRL/NATIONAL ELECTRONIC F,45680.0,0.0,,2018,3,7,CHECK_WITHDRAWAL,45680.0,C99275333
17544,1196428',2018-03-07,FDRL/NATIONAL ELECTRONIC F,35228.0,0.0,,2018,3,7,CASH_OUT,35228.0,C657255537
17545,1196428',2018-03-07,FDRL/NATIONAL ELECTRONIC F,32614.0,0.0,,2018,3,7,PAYEMENT,32614.0,C747464370
17546,1196428',2018-03-07,FDRL/NATIONAL ELECTRONIC F,33364.0,0.0,,2018,3,7,CHECK_WITHDRAWAL,33364.0,C1001367899
17547,1196428',2018-03-07,FDRL/NATIONAL ELECTRONIC F,30202.0,0.0,,2018,3,7,CHECK_WITHDRAWAL,30202.0,C638590716
17548,1196428',2018-03-07,FDRL/NATIONAL ELECTRONIC F,48174.0,0.0,,2018,3,7,PAYEMENT,48174.0,C151400576
17549,1196428',2018-03-07,FDRL/NATIONAL ELECTRONIC F,40547.0,0.0,,2018,3,7,PAYEMENT,40547.0,C2099688336
17550,1196428',2018-03-07,FDRL/NATIONAL ELECTRONIC F,41732.0,0.0,,2018,3,7,PAYEMENT,41732.0,C2030151083
17551,1196428',2018-03-07,FDRL/NATIONAL ELECTRONIC F,31392.0,0.0,,2018,3,7,DEBIT,31392.0,C1210180003
17552,1196428',2018-03-07,FDRL/NATIONAL ELECTRONIC F,40601.0,0.0,,2018,3,7,CASH_OUT,40601.0,C1434590943
17553,1196428',2018-03-07,FDRL/NATIONAL ELECTRONIC F,38715.0,0.0,,2018,3,7,CHECK_WITHDRAWAL,38715.0,C1211297851
17554,1196428',2018-03-07,FDRL/NATIONAL ELECTRONIC F,39750.0,0.0,,2018,3,7,CHECK_WITHDRAWAL,39750.0,C1127705091
17555,1196428',2018-03-07,FDRL/NATIONAL ELECTRONIC F,34266.0,0.0,,2018,3,7,DEBIT,34266.0,C1107546468
17556,1196428',2018-03-07,FDRL/NATIONAL ELECTRONIC F,30340.0,0.0,,2018,3,7,DEBIT,30340.0,C250593727
17557,1196428',2018-03-07,FDRL/NATIONAL ELECTRONIC F,33267.0,0.0,,2018,3,7,PAYEMENT,33267.0,C121523915
17558,1196428',2018-03-07,FDRL/NATIONAL ELECTRONIC F,30526.0,0.0,,2018,3,7,CHECK_WITHDRAWAL,30526.0,C801142660
17559,1196428',2018-03-07,FDRL/NATIONAL ELECTRONIC F,32132.0,0.0,,2018,3,7,DEBIT,32132.0,C451111351
17560,1196428',2018-03-07,FDRL/NATIONAL ELECTRONIC F,47877.0,0.0,,2018,3,7,DEBIT,47877.0,C1518728219
17561,1196428',2018-03-07,FDRL/NATIONAL ELECTRONIC F,33990.0,0.0,,2018,3,7,PAYEMENT,33990.0,C998255530
17562,1196428',2018-03-07,FDRL/NATIONAL ELECTRONIC F,32888.0,0.0,,2018,3,7,DEBIT,32888.0,C1757252775
17563,1196428',2018-03-07,FDRL/NATIONAL ELECTRONIC F,36453.0,0.0,,2018,3,7,PAYEMENT,36453.0,C1515704208
17564,1196428',2018-03-07,FDRL/NATIONAL ELECTRONIC F,31578.0,0.0,,2018,3,7,CHECK_WITHDRAWAL,31578.0,C991363637
17565,1196428',2018-03-07,FDRL/NATIONAL ELECTRONIC F,33413.0,0.0,,2018,3,7,CHECK_WITHDRAWAL,33413.0,C1144070975
17566,1196428',2018-03-07,FDRL/NATIONAL ELECTRONIC F,32870.0,0.0,,2018,3,7,DEBIT,32870.0,C1489484545
17567,1196428',2018-03-07,FDRL/NATIONAL ELECTRONIC F,30183.0,0.0,,2018,3,7,CASH_OUT,30183.0,C1859795678
17568,1196428',2018-03-07,FDRL/NATIONAL ELECTRONIC F,37980.0,0.0,,2018,3,7,DEBIT,37980.0,C569675628
17569,1196428',2018-03-07,FDRL/NATIONAL ELECTRONIC F,30856.0,0.0,,2018,3,7,PAYEMENT,30856.0,C861958315
17570,1196428',2018-03-07,FDRL/NATIONAL ELECTRONIC F,31820.0,0.0,,2018,3,7,PAYEMENT,31820.0,C724821526
17571,1196428',2018-03-07,FDRL/NATIONAL ELECTRONIC F,37968.0,0.0,,2018,3,7,PAYEMENT,37968.0,C680910891
17572,1196428',2018-03-07,FDRL/NATIONAL ELECTRONIC F,47366.0,0.0,,2018,3,7,DEBIT,47366.0,C483370168
17573,1196428',2018-03-07,FDRL/NATIONAL ELECTRONIC F,31910.0,0.0,,2018,3,7,CHECK_WITHDRAWAL,31910.0,C1919277981
17574,1196428',2018-03-07,FDRL/NATIONAL ELECTRONIC F,32277.0,0.0,,2018,3,7,PAYEMENT,32277.0,C843774579
17575,1196428',2018-03-07,FDRL/NATIONAL ELECTRONIC F,32277.0,0.0,,2018,3,7,DEBIT,32277.0,C2122200303
17576,1196428',2018-03-07,FDRL/NATIONAL ELECTRONIC F,48807.0,0.0,,2018,3,7,PAYEMENT,48807.0,C2040657244
17577,1196428',2018-03-07,FDRL/NATIONAL ELECTRONIC F,35984.0,0.0,,2018,3,7,PAYEMENT,35984.0,C1231842708
17578,1196428',2018-03-07,FDRL/NATIONAL ELECTRONIC F,65276.0,0.0,,2018,3,7,PAYEMENT,65276.0,C107095723
17579,1196428',2018-03-07,FDRL/NATIONAL ELECTRONIC F,60000.0,0.0,,2018,3,7,PAYEMENT,60000.0,C2107268831
17580,1196428',2018-03-07,FDRL/NATIONAL ELECTRONIC F,75551.0,0.0,,2018,3,7,CASH_OUT,75551.0,C163453316
17581,1196428',2018-03-07,FDRL/NATIONAL ELECTRONIC F,69827.0,0.0,,2018,3,7,DEBIT,69827.0,C1320515149
17582,1196428',2018-03-07,FDRL/NATIONAL ELECTRONIC F,50113.0,0.0,,2018,3,7,CHECK_WITHDRAWAL,50113.0,C1573641401
17583,1196428',2018-03-07,FDRL/NATIONAL ELECTRONIC F,81057.0,0.0,,2018,3,7,PAYEMENT,81057.0,C1475998599
17584,1196428',2018-03-07,FDRL/NATIONAL ELECTRONIC F,60750.0,0.0,,2018,3,7,DEBIT,60750.0,C1482944403
17585,1196428',2018-03-07,FDRL/NATIONAL ELECTRONIC F,52580.0,0.0,,2018,3,7,CASH_OUT,52580.0,C1902797635
17586,1196428',2018-03-07,FDRL/NATIONAL ELECTRONIC F,85046.0,0.0,,2018,3,7,CHECK_WITHDRAWAL,85046.0,C1750956965
17587,1196428',2018-03-07,FDRL/NATIONAL ELECTRONIC F,73336.0,0.0,,2018,3,7,DEBIT,73336.0,C985537694
17588,1196428',2018-03-07,FDRL/NATIONAL ELECTRONIC F,68457.0,0.0,,2018,3,7,CASH_OUT,68457.0,C614438306
17589,1196428',2018-03-07,FDRL/NATIONAL ELECTRONIC F,66767.0,0.0,,2018,3,7,CHECK_WITHDRAWAL,66767.0,C1083142315
17590,1196428',2018-03-07,FDRL/NATIONAL ELECTRONIC F,52750.0,0.0,,2018,3,7,PAYEMENT,52750.0,C2006081398
17591,1196428',2018-03-07,FDRL/NATIONAL ELECTRONIC F,62272.0,0.0,,2018,3,7,DEBIT,62272.0,C1772085663
17592,1196428',2018-03-07,FDRL/NATIONAL ELECTRONIC F,59740.0,0.0,,2018,3,7,CASH_OUT,59740.0,C1383831706
17593,1196428',2018-03-07,FDRL/NATIONAL ELECTRONIC F,62167.0,0.0,,2018,3,7,CASH_OUT,62167.0,C678308721
17594,1196428',2018-03-07,FDRL/NATIONAL ELECTRONIC F,75500.0,0.0,,2018,3,7,CASH_OUT,75500.0,C549269634
17595,1196428',2018-03-07,FDRL/NATIONAL ELECTRONIC F,69780.0,0.0,,2018,3,7,PAYEMENT,69780.0,C128870695
17596,1196428',2018-03-07,FDRL/NATIONAL ELECTRONIC F,84564.0,0.0,,2018,3,7,CHECK_WITHDRAWAL,84564.0,C638590716
17597,1196428',2018-03-07,FDRL/NATIONAL ELECTRONIC F,68955.0,0.0,,2018,3,7,CHECK_WITHDRAWAL,68955.0,C1829831147
17598,1196428',2018-03-07,FDRL/NATIONAL ELECTRONIC F,54832.0,0.0,,2018,3,7,DEBIT,54832.0,C1327907419
17599,1196428',2018-03-07,FDRL/NATIONAL ELECTRONIC F,66767.0,0.0,,2018,3,7,DEBIT,66767.0,C1545523026
17600,1196428',2018-03-07,FDRL/NATIONAL ELECTRONIC F,128274.0,0.0,,2018,3,7,DEBIT,128274.0,C1339208728
17601,1196428',2018-03-07,FDRL/NATIONAL ELECTRONIC F,14424.0,0.0,,2018,3,7,CASH_OUT,14424.0,C766681183
17602,1196428',2018-03-07,FDRL/NATIONAL ELECTRONIC F,12786.0,0.0,,2018,3,7,CASH_OUT,12786.0,C559483701
17603,1196428',2018-03-07,FDRL/NATIONAL ELECTRONIC F,9827.0,0.0,,2018,3,7,DEBIT,9827.0,C2143268962
17604,1196428',2018-03-07,FDRL/NATIONAL ELECTRONIC F,13816.0,0.0,,2018,3,7,CHECK_WITHDRAWAL,13816.0,C699133054
17605,1196428',2018-03-07,FDRL/NATIONAL ELECTRONIC F,13244.0,0.0,,2018,3,7,CASH_OUT,13244.0,C242520397
17606,1196428',2018-03-07,FDRL/NATIONAL ELECTRONIC F,19449.0,0.0,,2018,3,7,PAYEMENT,19449.0,C236282128
17607,1196428',2018-03-07,FDRL/NATIONAL ELECTRONIC F,26227.0,0.0,,2018,3,7,DEBIT,26227.0,C2011996123
17608,1196428',2018-03-07,FDRL/NATIONAL ELECTRONIC F,23520.0,0.0,,2018,3,7,DEBIT,23520.0,C1877453512
17609,1196428',2018-03-07,FDRL/NATIONAL ELECTRONIC F,19168.0,0.0,,2018,3,7,PAYEMENT,19168.0,C1554622120
17610,1196428',2018-03-07,FDRL/NATIONAL ELECTRONIC F,16989.0,0.0,,2018,3,7,DEBIT,16989.0,C36856762
17611,1196428',2018-03-07,FDRL/NATIONAL ELECTRONIC F,14316.0,0.0,,2018,3,7,CASH_OUT,14316.0,C1251991550
17612,1196428',2018-03-07,FDRL/NATIONAL ELECTRONIC F,28288.0,0.0,,2018,3,7,CASH_OUT,28288.0,C917768476
17613,1196428',2018-03-07,FDRL/NATIONAL ELECTRONIC F,10583.0,0.0,,2018,3,7,PAYEMENT,10583.0,C1149273771
17614,1196428',2018-03-07,FDRL/NATIONAL ELECTRONIC F,27734.0,0.0,,2018,3,7,PAYEMENT,27734.0,C1130075212
17615,1196428',2018-03-07,FDRL/NATIONAL ELECTRONIC F,28961.0,0.0,,2018,3,7,PAYEMENT,28961.0,C1891834647
17616,1196428',2018-03-07,FDRL/NATIONAL ELECTRONIC F,10796.0,0.0,,2018,3,7,PAYEMENT,10796.0,C46748390
17617,1196428',2018-03-07,FDRL/NATIONAL ELECTRONIC F,14814.0,0.0,,2018,3,7,PAYEMENT,14814.0,C1146577120
17618,1196428',2018-03-07,FDRL/NATIONAL ELECTRONIC F,3597.0,0.0,,2018,3,7,CHECK_WITHDRAWAL,3597.0,C214974969
17619,1196428',2018-03-07,FDRL/NATIONAL ELECTRONIC F,4533.0,0.0,,2018,3,7,DEBIT,4533.0,C1060563153
17620,1196428',2018-03-07,FDRL/NATIONAL ELECTRONIC F,11010.0,0.0,,2018,3,7,DEBIT,11010.0,C979719862
17621,1196428',2018-03-07,FDRL/NATIONAL ELECTRONIC F,17530.0,0.0,,2018,3,7,PAYEMENT,17530.0,C1778801068
17622,1196428',2018-03-07,FDRL/NATIONAL ELECTRONIC F,28264.0,0.0,,2018,3,7,PAYEMENT,28264.0,C1485516154
17623,1196428',2018-03-07,FDRL/NATIONAL ELECTRONIC F,26095.0,0.0,,2018,3,7,CHECK_WITHDRAWAL,26095.0,C1653433120
17624,1196428',2018-03-07,FDRL/NATIONAL ELECTRONIC F,24090.0,0.0,,2018,3,7,CHECK_WITHDRAWAL,24090.0,C58642425
17625,1196428',2018-03-07,FDRL/NATIONAL ELECTRONIC F,9827.0,0.0,,2018,3,7,CASH_OUT,9827.0,C320106510
17626,1196428',2018-03-07,FDRL/NATIONAL ELECTRONIC F,9886.0,0.0,,2018,3,7,DEBIT,9886.0,C173275257
17627,1196428',2018-03-07,FDRL/NATIONAL ELECTRONIC F,16417.0,0.0,,2018,3,7,CASH_OUT,16417.0,C692060775
17628,1196428',2018-03-07,FDRL/NATIONAL ELECTRONIC F,26400.0,0.0,,2018,3,7,CASH_OUT,26400.0,C423580937
17629,1196428',2018-03-07,FDRL/NATIONAL ELECTRONIC F,12953.0,0.0,,2018,3,7,CHECK_WITHDRAWAL,12953.0,C1807896178
17630,1196428',2018-03-07,FDRL/NATIONAL ELECTRONIC F,27685.0,0.0,,2018,3,7,PAYEMENT,27685.0,C872592585
17631,1196428',2018-03-07,FDRL/NATIONAL ELECTRONIC F,12101.0,0.0,,2018,3,7,DEBIT,12101.0,C668345982
17632,1196428',2018-03-07,FDRL/NATIONAL ELECTRONIC F,24484.0,0.0,,2018,3,7,DEBIT,24484.0,C183354406
17633,1196428',2018-03-07,FDRL/NATIONAL ELECTRONIC F,21933.0,0.0,,2018,3,7,CASH_OUT,21933.0,C1486249495
17634,1196428',2018-03-07,FDRL/NATIONAL ELECTRONIC F,22600.0,0.0,,2018,3,7,CASH_OUT,22600.0,C1914683579
17635,1196428',2018-03-07,FDRL/NATIONAL ELECTRONIC F,25719.0,0.0,,2018,3,7,DEBIT,25719.0,C720370261
17636,1196428',2018-03-07,FDRL/NATIONAL ELECTRONIC F,12468.0,0.0,,2018,3,7,DEBIT,12468.0,C1406749291
17637,1196428',2018-03-07,FDRL/NATIONAL ELECTRONIC F,22293.0,0.0,,2018,3,7,DEBIT,22293.0,C1405220014
17638,1196428',2018-03-07,FDRL/NATIONAL ELECTRONIC F,15167.0,0.0,,2018,3,7,CHECK_WITHDRAWAL,15167.0,C952610115
17639,1196428',2018-03-07,FDRL/NATIONAL ELECTRONIC F,25717.0,0.0,,2018,3,7,DEBIT,25717.0,C1379289710
17640,1196428',2018-03-07,FDRL/NATIONAL ELECTRONIC F,13494.0,0.0,,2018,3,7,DEBIT,13494.0,C1700852615
17641,1196428',2018-03-07,FDRL/NATIONAL ELECTRONIC F,29551.0,0.0,,2018,3,7,PAYEMENT,29551.0,C1615443145
17642,1196428',2018-03-07,FDRL/NATIONAL ELECTRONIC F,13606.0,0.0,,2018,3,7,CASH_OUT,13606.0,C364592569
17643,1196428',2018-03-07,FDRL/NATIONAL ELECTRONIC F,14588.0,0.0,,2018,3,7,CASH_OUT,14588.0,C744708435
17644,1196428',2018-03-07,FDRL/NATIONAL ELECTRONIC F,28472.0,0.0,,2018,3,7,CHECK_WITHDRAWAL,28472.0,C190097337
17645,1196428',2018-03-07,FDRL/NATIONAL ELECTRONIC F,14421.0,0.0,,2018,3,7,PAYEMENT,14421.0,C1211297851
17646,1196428',2018-03-07,FDRL/NATIONAL ELECTRONIC F,18670.0,0.0,,2018,3,7,DEBIT,18670.0,C1672788422
17647,1196428',2018-03-07,FDRL/NATIONAL ELECTRONIC F,26980.0,0.0,,2018,3,7,CHECK_WITHDRAWAL,26980.0,M1517556400
17648,1196428',2018-03-07,FDRL/NATIONAL ELECTRONIC F,18668.0,0.0,,2018,3,7,CHECK_WITHDRAWAL,18668.0,M834139250
17649,1196428',2018-03-07,FDRL/NATIONAL ELECTRONIC F,20093.0,0.0,,2018,3,7,CHECK_WITHDRAWAL,20093.0,M274423320
17650,1196428',2018-03-07,FDRL/NATIONAL ELECTRONIC F,21370.0,0.0,,2018,3,7,DEBIT,21370.0,M56882594
17651,1196428',2018-03-07,FDRL/NATIONAL ELECTRONIC F,23281.0,0.0,,2018,3,7,DEBIT,23281.0,M573226515
17652,1196428',2018-03-07,FDRL/NATIONAL ELECTRONIC F,18192.0,0.0,,2018,3,7,DEBIT,18192.0,M2145388720
17653,1196428',2018-03-07,FDRL/NATIONAL ELECTRONIC F,22263.0,0.0,,2018,3,7,CHECK_WITHDRAWAL,22263.0,M1007053670
17654,1196428',2018-03-07,FDRL/NATIONAL ELECTRONIC F,13080.0,0.0,,2018,3,7,CASH_OUT,13080.0,M836776239
17655,1196428',2018-03-07,FDRL/NATIONAL ELECTRONIC F,23122.0,0.0,,2018,3,7,CASH_OUT,23122.0,M704627187
17656,1196428',2018-03-07,FDRL/NATIONAL ELECTRONIC F,27821.0,0.0,,2018,3,7,DEBIT,27821.0,M120353665
17657,1196428',2018-03-07,FDRL/NATIONAL ELECTRONIC F,25450.0,0.0,,2018,3,7,CASH_OUT,25450.0,M418807220
17658,1196428',2018-03-07,FDRL/NATIONAL ELECTRONIC F,19859.0,0.0,,2018,3,7,DEBIT,19859.0,M1642259938
17659,1196428',2018-03-07,FDRL/NATIONAL ELECTRONIC F,29392.0,0.0,,2018,3,7,PAYEMENT,29392.0,M195917885
17660,1196428',2018-03-07,FDRL/NATIONAL ELECTRONIC F,19180.0,0.0,,2018,3,7,CASH_OUT,19180.0,M1231113028
17661,1196428',2018-03-07,FDRL/NATIONAL ELECTRONIC F,28342.0,0.0,,2018,3,7,PAYEMENT,28342.0,M1693410204
17662,1196428',2018-03-07,FDRL/NATIONAL ELECTRONIC F,26819.0,0.0,,2018,3,7,DEBIT,26819.0,C1665979484
17663,1196428',2018-03-07,FDRL/NATIONAL ELECTRONIC F,27057.0,0.0,,2018,3,7,CHECK_WITHDRAWAL,27057.0,M1392645527
17664,1196428',2018-03-07,FDRL/NATIONAL ELECTRONIC F,23963.0,0.0,,2018,3,7,DEBIT,23963.0,C382431057
17665,1196428',2018-03-07,FDRL/NATIONAL ELECTRONIC F,28000.0,0.0,,2018,3,7,DEBIT,28000.0,M1293861567
17666,1196428',2018-03-07,FDRL/NATIONAL ELECTRONIC F,14876.0,0.0,,2018,3,7,DEBIT,14876.0,M836597567
17667,1196428',2018-03-07,FDRL/NATIONAL ELECTRONIC F,19076.0,0.0,,2018,3,7,DEBIT,19076.0,M1417531678
17668,1196428',2018-03-07,FDRL/NATIONAL ELECTRONIC F,29452.0,0.0,,2018,3,7,PAYEMENT,29452.0,C846947180
17669,1196428',2018-03-07,FDRL/NATIONAL ELECTRONIC F,27080.0,0.0,,2018,3,7,CHECK_WITHDRAWAL,27080.0,C214774813
17670,1196428',2018-03-07,FDRL/NATIONAL ELECTRONIC F,12358.0,0.0,,2018,3,7,CHECK_WITHDRAWAL,12358.0,M612957520
17671,1196428',2018-03-07,FDRL/NATIONAL ELECTRONIC F,26162.0,0.0,,2018,3,7,CASH_OUT,26162.0,M159577677
17672,1196428',2018-03-07,FDRL/NATIONAL ELECTRONIC F,28582.0,0.0,,2018,3,7,DEBIT,28582.0,C599726537
17673,1196428',2018-03-07,FDRL/NATIONAL ELECTRONIC F,23396.0,0.0,,2018,3,7,PAYEMENT,23396.0,C392292416
17674,1196428',2018-03-07,FDRL/NATIONAL ELECTRONIC F,18013.0,0.0,,2018,3,7,DEBIT,18013.0,C904383922
17675,1196428',2018-03-07,FDRL/NATIONAL ELECTRONIC F,21376.0,0.0,,2018,3,7,CHECK_WITHDRAWAL,21376.0,C1315729466
17676,1196428',2018-03-07,FDRL/NATIONAL ELECTRONIC F,18361.0,0.0,,2018,3,7,CASH_OUT,18361.0,C1163480574
17677,1196428',2018-03-07,FDRL/NATIONAL ELECTRONIC F,19547.0,0.0,,2018,3,7,PAYEMENT,19547.0,C1197606915
17678,1196428',2018-03-07,FDRL/NATIONAL ELECTRONIC F,29852.0,0.0,,2018,3,7,DEBIT,29852.0,C619068319
17679,1196428',2018-03-07,FDRL/NATIONAL ELECTRONIC F,27849.0,0.0,,2018,3,7,DEBIT,27849.0,C2129901484
17680,1196428',2018-03-07,FDRL/NATIONAL ELECTRONIC F,21311.0,0.0,,2018,3,7,DEBIT,21311.0,C1440325059
17681,1196428',2018-03-07,FDRL/NATIONAL ELECTRONIC F,21180.0,0.0,,2018,3,7,PAYEMENT,21180.0,M26357815
17682,1196428',2018-03-07,FDRL/NATIONAL ELECTRONIC F,24107.0,0.0,,2018,3,7,DEBIT,24107.0,C1054909747
17683,1196428',2018-03-07,FDRL/NATIONAL ELECTRONIC F,29711.0,0.0,,2018,3,7,DEBIT,29711.0,C1210879412
17684,1196428',2018-03-07,FDRL/NATIONAL ELECTRONIC F,12872.0,0.0,,2018,3,7,CASH_OUT,12872.0,M1933021271
17685,1196428',2018-03-07,FDRL/NATIONAL ELECTRONIC F,28557.0,0.0,,2018,3,7,DEBIT,28557.0,C1039162432
17686,1196428',2018-03-07,FDRL/NATIONAL ELECTRONIC F,26350.0,0.0,,2018,3,7,PAYEMENT,26350.0,C1134894336
17687,1196428',2018-03-07,FDRL/NATIONAL ELECTRONIC F,26174.0,0.0,,2018,3,7,CHECK_WITHDRAWAL,26174.0,M208410913
17688,1196428',2018-03-07,FDRL/NATIONAL ELECTRONIC F,14012.0,0.0,,2018,3,7,CHECK_WITHDRAWAL,14012.0,C1459757869
17689,1196428',2018-03-07,FDRL/NATIONAL ELECTRONIC F,27089.0,0.0,,2018,3,7,CHECK_WITHDRAWAL,27089.0,C850807405
17690,1196428',2018-03-07,FDRL/NATIONAL ELECTRONIC F,29113.0,0.0,,2018,3,7,DEBIT,29113.0,C732929122
17691,1196428',2018-03-07,FDRL/NATIONAL ELECTRONIC F,23477.0,0.0,,2018,3,7,PAYEMENT,23477.0,C2083562754
17692,1196428',2018-03-07,FDRL/NATIONAL ELECTRONIC F,20439.0,0.0,,2018,3,7,PAYEMENT,20439.0,C863811613
17693,1196428',2018-03-07,FDRL/NATIONAL ELECTRONIC F,13334.0,0.0,,2018,3,7,PAYEMENT,13334.0,C214974969
17694,1196428',2018-03-07,FDRL/NATIONAL ELECTRONIC F,20672.0,0.0,,2018,3,7,PAYEMENT,20672.0,C720759478
17695,1196428',2018-03-07,FDRL/NATIONAL ELECTRONIC F,29350.0,0.0,,2018,3,7,CASH_OUT,29350.0,C1262822392
17696,1196428',2018-03-07,FDRL/NATIONAL ELECTRONIC F,20378.0,0.0,,2018,3,7,CHECK_WITHDRAWAL,20378.0,C1303868418
17697,1196428',2018-03-07,FDRL/NATIONAL ELECTRONIC F,18237.0,0.0,,2018,3,7,CASH_OUT,18237.0,C1732292969
17698,1196428',2018-03-07,FDRL/NATIONAL ELECTRONIC F,18314.0,0.0,,2018,3,7,CHECK_WITHDRAWAL,18314.0,C1266035080
17699,1196428',2018-03-07,FDRL/NATIONAL ELECTRONIC F,17944.0,0.0,,2018,3,7,PAYEMENT,17944.0,C1802632685
17700,1196428',2018-03-07,FDRL/INTERNAL FUND TRANSFE,22000.0,0.0,,2018,3,7,CASH_OUT,22000.0,C769342184
17701,1196428',2018-03-07,FDRL/NATIONAL ELECTRONIC F,10821.0,0.0,,2018,3,7,CASH_OUT,10821.0,C1247600089
17702,1196428',2018-03-07,FDRL/NATIONAL ELECTRONIC F,23335.0,0.0,,2018,3,7,PAYEMENT,23335.0,C34231099
17703,1196428',2018-03-07,FDRL/NATIONAL ELECTRONIC F,24653.0,0.0,,2018,3,7,DEBIT,24653.0,C1649686970
17704,1196428',2018-03-07,FDRL/NATIONAL ELECTRONIC F,24348.0,0.0,,2018,3,7,PAYEMENT,24348.0,C801142660
17705,1196428',2018-03-07,FDRL/NATIONAL ELECTRONIC F,21237.0,0.0,,2018,3,7,DEBIT,21237.0,C1577213552
17706,1196428',2018-03-07,FDRL/NATIONAL ELECTRONIC F,19535.0,0.0,,2018,3,7,DEBIT,19535.0,M678945978
17707,1196428',2018-03-07,FDRL/NATIONAL ELECTRONIC F,25597.0,0.0,,2018,3,7,PAYEMENT,25597.0,M1513052113
17708,1196428',2018-03-07,FDRL/NATIONAL ELECTRONIC F,23083.0,0.0,,2018,3,7,CASH_OUT,23083.0,M762648193
17709,1196428',2018-03-07,FDRL/NATIONAL ELECTRONIC F,19069.0,0.0,,2018,3,7,PAYEMENT,19069.0,M1236649776
17710,1196428',2018-03-07,FDRL/NATIONAL ELECTRONIC F,16809.0,0.0,,2018,3,7,PAYEMENT,16809.0,C1659797072
17711,1196428',2018-03-07,FDRL/NATIONAL ELECTRONIC F,22826.0,0.0,,2018,3,7,DEBIT,22826.0,M942372013
17712,1196428',2018-03-07,FDRL/NATIONAL ELECTRONIC F,26825.0,0.0,,2018,3,7,PAYEMENT,26825.0,M484312508
17713,1196428',2018-03-07,FDRL/NATIONAL ELECTRONIC F,20491.0,0.0,,2018,3,7,CASH_OUT,20491.0,M533122238
17714,1196428',2018-03-07,FDRL/NATIONAL ELECTRONIC F,19373.0,0.0,,2018,3,7,CHECK_WITHDRAWAL,19373.0,M688228131
17715,1196428',2018-03-07,FDRL/NATIONAL ELECTRONIC F,18092.0,0.0,,2018,3,7,CHECK_WITHDRAWAL,18092.0,C1441378585
17716,1196428',2018-03-07,FDRL/NATIONAL ELECTRONIC F,13697.0,0.0,,2018,3,7,CASH_OUT,13697.0,M927706019
17717,1196428',2018-03-07,FDRL/NATIONAL ELECTRONIC F,10761.92,0.0,,2018,3,7,CASH_OUT,10761.92,M410802244
17718,1196428',2018-03-07,FDRL/NATIONAL ELECTRONIC F,16061.0,0.0,,2018,3,7,DEBIT,16061.0,C1424731356
17719,1196428',2018-03-07,FDRL/NATIONAL ELECTRONIC F,19252.0,0.0,,2018,3,7,DEBIT,19252.0,M120418140
17720,1196428',2018-03-07,FDRL/NATIONAL ELECTRONIC F,14424.0,0.0,,2018,3,7,CHECK_WITHDRAWAL,14424.0,M16881239
17721,1196428',2018-03-07,FDRL/NATIONAL ELECTRONIC F,18567.0,0.0,,2018,3,7,CHECK_WITHDRAWAL,18567.0,M516339638
17722,1196428',2018-03-07,FDRL/NATIONAL ELECTRONIC F,17271.0,0.0,,2018,3,7,PAYEMENT,17271.0,C67985650
17723,1196428',2018-03-07,FDRL/NATIONAL ELECTRONIC F,15171.0,0.0,,2018,3,7,CHECK_WITHDRAWAL,15171.0,C1286736411
17724,1196428',2018-03-07,FDRL/NATIONAL ELECTRONIC F,14353.0,0.0,,2018,3,7,PAYEMENT,14353.0,M298885726
17725,1196428',2018-03-07,FDRL/NATIONAL ELECTRONIC F,16628.0,0.0,,2018,3,7,CASH_OUT,16628.0,C1199737595
17726,1196428',2018-03-07,FDRL/NATIONAL ELECTRONIC F,12715.0,0.0,,2018,3,7,PAYEMENT,12715.0,M1419980341
17727,1196428',2018-03-07,FDRL/NATIONAL ELECTRONIC F,11950.0,0.0,,2018,3,7,CHECK_WITHDRAWAL,11950.0,C1870367457
17728,1196428',2018-03-07,FDRL/NATIONAL ELECTRONIC F,13092.59,0.0,,2018,3,7,CASH_OUT,13092.59,C1640747200
17729,1196428',2018-03-07,FDRL/NATIONAL ELECTRONIC F,7987.0,0.0,,2018,3,7,CASH_OUT,7987.0,C1057000374
17730,1196428',2018-03-07,FDRL/INTERNAL FUND TRANSFE,300000.0,0.0,,2018,3,7,PAYEMENT,300000.0,C1653433120
17731,1196428',2018-03-07,FDRL/INTERNAL FUND TRANSFE,300000.0,0.0,,2018,3,7,PAYEMENT,300000.0,M1618635005
17732,1196428',2018-03-07,FDRL/INTERNAL FUND TRANSFE,300000.0,0.0,,2018,3,7,CHECK_WITHDRAWAL,300000.0,M1465626666
17733,1196428',2018-03-07,FDRL/INTERNAL FUND TRANSFE,300000.0,0.0,,2018,3,7,DEBIT,300000.0,M1864439842
17734,1196428',2018-03-07,FDRL/INTERNAL FUND TRANSFE,300000.0,0.0,,2018,3,7,CHECK_WITHDRAWAL,300000.0,C1642006480
17735,1196428',2018-03-07,FDRL/INTERNAL FUND TRANSFE,300000.0,0.0,,2018,3,7,DEBIT,300000.0,C1065997164
17736,1196428',2018-03-07,FDRL/INTERNAL FUND TRANSFE,300000.0,0.0,,2018,3,7,CHECK_WITHDRAWAL,300000.0,C1254893565
17737,1196428',2018-03-07,NEFT/000032882961/ACCOUNT,0.0,20552.0,,2018,3,7,TRANSFER,20552.0,C111975277
17738,1196428',2018-03-07,NEFT/000032883154/ACCOUNT,0.0,66767.0,,2018,3,7,TRANSFER,66767.0,C2113748097
17739,1196428',2018-03-07,IMPS 806619189554 FROM SA,0.0,200000.0,,2018,3,7,CHECK_CASHING,200000.0,C1793325972
17740,1196428',2018-03-07,BEAT CSH PKP DEL GURG 617,0.0,79500.0,,2018,3,7,CASH_IN,79500.0,C1554565380
17741,1196428',2018-03-08,NEFT/000032882957/INVALID,0.0,18402.0,,2018,3,8,CHECK_CASHING,18402.0,C1909597726
17742,1196428',2018-03-08,FDRL/INTERNAL FUND TRANSFE,0.0,2000000.0,,2018,3,8,CHECK_CASHING,2000000.0,C444613285
17743,1196428',2018-03-08,FDRL/INTERNAL FUND TRANSFE,0.0,3000000.0,,2018,3,8,CHECK_CASHING,3000000.0,C1503560125
17744,1196428',2018-03-08,FDRL/REAL TIME GROSS SETTL,1000000.0,0.0,,2018,3,8,CHECK_WITHDRAWAL,1000000.0,C638590716
17745,1196428',2018-03-08,FDRL/REAL TIME GROSS SETTL,2000000.0,0.0,,2018,3,8,DEBIT,2000000.0,C1467806809
17746,1196428',2018-03-08,FDRL/REAL TIME GROSS SETTL,2000000.0,0.0,,2018,3,8,DEBIT,2000000.0,C1161865950
17747,1196428',2018-03-08,NEFT/N067180491021913/PAY,0.0,1840000.0,,2018,3,8,CASH_IN,1840000.0,C991505714
17748,1196428',2018-03-08,NEFT/N067180491030234/PAY,0.0,4160000.0,,2018,3,8,CHECK_CASHING,4160000.0,C1183266411
17749,1196428',2018-03-08,FDRL/REAL TIME GROSS SETTL,3000000.0,0.0,,2018,3,8,PAYEMENT,3000000.0,C1419794148
17750,1196428',2018-03-08,FDRL/REAL TIME GROSS SETTL,3000000.0,0.0,,2018,3,8,DEBIT,3000000.0,C679235222
17751,1196428',2018-03-08,TRF FROM  Indiaforensic SERVICES,0.0,4700000.0,,2018,3,8,TRANSFER,4700000.0,C1440282299
17752,1196428',2018-03-08,TRF FROM  Indiaforensic SERVICES,0.0,4900000.0,,2018,3,8,CASH_IN,4900000.0,C716442925
17753,1196428',2018-03-08,NEFT/N067180491363855/PAY,0.0,406006.17,,2018,3,8,CASH_IN,406006.17,C2103065350
17754,1196428',2018-03-08,Indiaforensic SERVICES INDIA PVT,0.0,273268.0,,2018,3,8,TRANSFER,273268.0,C818570949
17755,1196428',2018-03-08,NEFT/N067180491363892/PAY,0.0,1113749.08,,2018,3,8,CASH_IN,1113749.08,C1383454473
17756,1196428',2018-03-08,NEFT/AXISP18067115973/ACC,0.0,2000000.0,,2018,3,8,CASH_IN,2000000.0,M805440227
17757,1196428',2018-03-08,FDRL/INTERNAL FUND TRANSFE,5000000.0,0.0,,2018,3,8,CHECK_WITHDRAWAL,5000000.0,M1985763875
17758,1196428',2018-03-08,FDRL/INTERNAL FUND TRANSFE,5000000.0,0.0,,2018,3,8,CASH_OUT,5000000.0,M128147002
17759,1196428',2018-03-09,FDRL/REAL TIME GROSS SETTL,2000000.0,0.0,,2018,3,9,PAYEMENT,2000000.0,C653745564
17760,1196428',2018-03-09,FDRL/REAL TIME GROSS SETTL,1000000.0,0.0,,2018,3,9,PAYEMENT,1000000.0,C39713115
17761,1196428',2018-03-09,CASHDEP/NOIDA/TP,0.0,103000.0,,2018,3,9,CASH_IN,103000.0,C1477641326
17762,1196428',2018-03-09,FDRL/INTERNAL FUND TRANSFE,0.0,2000000.0,,2018,3,9,CHECK_CASHING,2000000.0,C1787868648
17763,1196428',2018-03-09,FDRL/REAL TIME GROSS SETTL,2000000.0,0.0,,2018,3,9,PAYEMENT,2000000.0,C653745564
17764,1196428',2018-03-09,NEFT/N068180491924733/TEC,0.0,200000.0,,2018,3,9,CHECK_CASHING,200000.0,C1128238842
17765,1196428',2018-03-09,RTGS/HDFCH18068671932/PAY,0.0,4160000.0,,2018,3,9,CHECK_CASHING,4160000.0,C1218365329
17766,1196428',2018-03-09,RTGS/HDFCH18068671897/PAY,0.0,1440000.0,,2018,3,9,CASH_IN,1440000.0,C322477902
17767,1196428',2018-03-09,FDRL/INTERNAL FUND TRANSFE,1000000.0,0.0,,2018,3,9,CHECK_WITHDRAWAL,1000000.0,C1186819207
17768,1196428',2018-03-09,FDRL/REAL TIME GROSS SETTL,2000000.0,0.0,,2018,3,9,PAYEMENT,2000000.0,C1414919255
17769,1196428',2018-03-09,FDRL/REAL TIME GROSS SETTL,3000000.0,0.0,,2018,3,9,DEBIT,3000000.0,C173141569
17770,1196428',2018-03-09,INTEX TECHNOLOGIES INDIA,1000000.0,0.0,,2018,3,9,PAYEMENT,1000000.0,M1985612284
17771,1196428',2018-03-09,IMPS 806813933892 FROM MA,0.0,2750.0,,2018,3,9,CASH_IN,2750.0,C1304046855
17772,1196428',2018-03-09,RTGS/ICICH18068328625/ART,0.0,10000000.0,,2018,3,9,CHECK_CASHING,10000000.0,M1495725171
17773,1196428',2018-03-09,FDRL/REAL TIME GROSS SETTL,10000000.0,0.0,,2018,3,9,PAYEMENT,10000000.0,C910260446
17774,1196428',2018-03-09,FDRL/NATIONAL ELECTRONIC F,15824.0,0.0,,2018,3,9,DEBIT,15824.0,C533866202
17775,1196428',2018-03-09,TRF FROM  Indiaforensic SERVICES,0.0,6700000.0,,2018,3,9,CASH_IN,6700000.0,C489693281
17776,1196428',2018-03-09,FDRL/REAL TIME GROSS SETTL,3000000.0,0.0,,2018,3,9,PAYEMENT,3000000.0,C1216911343
17777,1196428',2018-03-09,FDRL/REAL TIME GROSS SETTL,3000000.0,0.0,,2018,3,9,DEBIT,3000000.0,M1442331311
17778,1196428',2018-03-09,FDRL/INTERNAL FUND TRANSFE,500000.0,0.0,,2018,3,9,CHECK_WITHDRAWAL,500000.0,C1648214200
17779,1196428',2018-03-09,NEFT/AXISP18068064567/ACC,0.0,16000000.0,,2018,3,9,CHECK_CASHING,16000000.0,C979387846
17780,1196428',2018-03-09,NEFT/N068180492369315/PAY,0.0,200111.2,,2018,3,9,CHECK_CASHING,200111.2,C1474411656
17781,1196428',2018-03-09,NEFT/N068180492364532/PAY,0.0,1088178.9,,2018,3,9,TRANSFER,1088178.9,C1060563153
17782,1196428',2018-03-09,IRTT00701807308,1439.54,0.0,,2018,3,9,CASH_OUT,1439.54,M657074855
17783,1196428',2018-03-09,"Indiaforensic USA, INC./USD/2869",0.0,1858547.24,,2018,3,9,CASH_IN,1858547.24,C2037251990
17784,1196428',2018-03-09,TRF FROM  Indiaforensic SERVICES,0.0,4400000.0,,2018,3,9,CASH_IN,4400000.0,C458582664
17785,1196428',2018-03-09,Indiaforensic SERVICES INDIA PVT,0.0,211644.0,,2018,3,9,CASH_IN,211644.0,C1487669283
17786,1196428',2018-03-09,NEFT/IDFBH18068604168/FUN,0.0,19600.0,,2018,3,9,TRANSFER,19600.0,M1993608846
17787,1196428',2018-03-09,NEFT CHARGES AND GST/0000,29.5,0.0,,2018,3,9,CHECK_WITHDRAWAL,29.5,M974526786
17788,1196428',2018-03-09,NEFT/000033059339/GALENA,10000000.0,0.0,,2018,3,9,CASH_OUT,10000000.0,C1443373883
17789,1196428',2018-03-09,YOURSELF FOR BULK NEFT  B,8420440.0,0.0,,2018,3,9,DEBIT,8420440.0,C301121080
17790,1196428',2018-03-09,BEAT CSH PKP DEL GURG 617,0.0,250700.0,,2018,3,9,CASH_IN,250700.0,M1055420087
17791,1196428',2018-03-09,FDRL/INTERNAL FUND TRANSFE,500000.0,0.0,,2018,3,9,CASH_OUT,500000.0,C1518728219
17792,1196428',2018-03-09,FDRL/INTERNAL FUND TRANSFE,200000.0,0.0,,2018,3,9,DEBIT,200000.0,M533779930
17793,1196428',2018-03-09,FDRL/INTERNAL FUND TRANSFE,200000.0,0.0,,2018,3,9,CASH_OUT,200000.0,M2137105801
17794,1196428',2018-03-09,FDRL/INTERNAL FUND TRANSFE,5000000.0,0.0,,2018,3,9,PAYEMENT,5000000.0,M458189677
17795,1196428',2018-03-09,BEAT CSH PKP DEL GURG 617,0.0,148000.0,,2018,3,9,CHECK_CASHING,148000.0,C365212068
17796,1196428',2018-03-10,IMPS 806917639583 FROM MR,0.0,11800.0,,2018,3,10,CHECK_CASHING,11800.0,M1302433324
17797,1196428',2018-03-12,CASHDEP/NOIDA/TP,0.0,220000.0,,2018,3,12,CHECK_CASHING,220000.0,M1232928571
17798,1196428',2018-03-12,RTGS/HDFCH18071866105/PAY,0.0,9200000.0,,2018,3,12,CHECK_CASHING,9200000.0,M1670027479
17799,1196428',2018-03-12,RTGS/HDFCH18071866094/PAY,0.0,3280000.0,,2018,3,12,CHECK_CASHING,3280000.0,M1290946615
17800,1196428',2018-03-12,FDRL/INTERNAL FUND TRANSFE,200000.0,0.0,,2018,3,12,CHECK_WITHDRAWAL,200000.0,C309167705
17801,1196428',2018-03-12,FDRL/INTERNAL FUND TRANSFE,500000.0,0.0,,2018,3,12,PAYEMENT,500000.0,C339082934
17802,1196428',2018-03-12,FDRL/INTERNAL FUND TRANSFE,1000000.0,0.0,,2018,3,12,PAYEMENT,1000000.0,M2010511875
17803,1196428',2018-03-12,FDRL/INTERNAL FUND TRANSFE,1000000.0,0.0,,2018,3,12,CHECK_WITHDRAWAL,1000000.0,M462849534
17804,1196428',2018-03-12,FDRL/REAL TIME GROSS SETTL,10000000.0,0.0,,2018,3,12,CASH_OUT,10000000.0,C351394592
17805,1196428',2018-03-12,CASHDEP/VIKASMARG/TP,0.0,47500.0,,2018,3,12,CASH_IN,47500.0,M1360833062
17806,1196428',2018-03-12,RTGS/SCBLH18071005768/FIX,0.0,200000.0,,2018,3,12,TRANSFER,200000.0,M572066097
17807,1196428',2018-03-12,CASHDEP/FARIDABAD/TP,0.0,50000.0,,2018,3,12,CASH_IN,50000.0,C1834992330
17808,1196428',2018-03-12,NEFT/N071180493765055/TEC,0.0,200000.0,,2018,3,12,CHECK_CASHING,200000.0,C414205222
17809,1196428',2018-03-12,NEFT/N071180493769142/PAY,0.0,683928.12,,2018,3,12,CHECK_CASHING,683928.12,M984140747
17810,1196428',2018-03-12,TRF FROM  Indiaforensic SERVICES,0.0,15000000.0,,2018,3,12,CHECK_CASHING,15000000.0,M1088410051
17811,1196428',2018-03-12,TRF FROM  Indiaforensic SERVICES,0.0,4000000.0,,2018,3,12,CASH_IN,4000000.0,C2011869283
17812,1196428',2018-03-12,NEFT/N071180493761926/PAY,0.0,1593358.78,,2018,3,12,CHECK_CASHING,1593358.78,C1945802665
17813,1196428',2018-03-12,FDRL/NATIONAL ELECTRONIC F,40673.0,0.0,,2018,3,12,PAYEMENT,40673.0,M1077314533
17814,1196428',2018-03-12,FDRL/NATIONAL ELECTRONIC F,48519.0,0.0,,2018,3,12,CASH_OUT,48519.0,M1866006542
17815,1196428',2018-03-12,FDRL/NATIONAL ELECTRONIC F,71796.0,0.0,,2018,3,12,CASH_OUT,71796.0,C948005484
17816,1196428',2018-03-12,FDRL/NATIONAL ELECTRONIC F,30695.0,0.0,,2018,3,12,PAYEMENT,30695.0,C1947645280
17817,1196428',2018-03-12,FDRL/NATIONAL ELECTRONIC F,54708.0,0.0,,2018,3,12,DEBIT,54708.0,M1086816037
17818,1196428',2018-03-12,FDRL/NATIONAL ELECTRONIC F,76840.0,0.0,,2018,3,12,DEBIT,76840.0,C746359178
17819,1196428',2018-03-12,FDRL/NATIONAL ELECTRONIC F,36500.0,0.0,,2018,3,12,CHECK_WITHDRAWAL,36500.0,C1049804269
17820,1196428',2018-03-12,FDRL/NATIONAL ELECTRONIC F,37238.0,0.0,,2018,3,12,CASH_OUT,37238.0,M229520915
17821,1196428',2018-03-12,FDRL/NATIONAL ELECTRONIC F,60072.0,0.0,,2018,3,12,DEBIT,60072.0,C1506782127
17822,1196428',2018-03-12,FDRL/NATIONAL ELECTRONIC F,60183.0,0.0,,2018,3,12,DEBIT,60183.0,C979387846
17823,1196428',2018-03-12,FDRL/NATIONAL ELECTRONIC F,41738.0,0.0,,2018,3,12,CHECK_WITHDRAWAL,41738.0,M221267015
17824,1196428',2018-03-12,FDRL/NATIONAL ELECTRONIC F,52118.0,0.0,,2018,3,12,CASH_OUT,52118.0,M1137320872
17825,1196428',2018-03-12,FDRL/NATIONAL ELECTRONIC F,49269.0,0.0,,2018,3,12,PAYEMENT,49269.0,M708161397
17826,1196428',2018-03-12,FDRL/NATIONAL ELECTRONIC F,53156.0,0.0,,2018,3,12,DEBIT,53156.0,C2145319283
17827,1196428',2018-03-12,FDRL/NATIONAL ELECTRONIC F,33660.0,0.0,,2018,3,12,DEBIT,33660.0,M1247246596
17828,1196428',2018-03-12,FDRL/NATIONAL ELECTRONIC F,90672.0,0.0,,2018,3,12,CASH_OUT,90672.0,M1146008755
17829,1196428',2018-03-12,FDRL/NATIONAL ELECTRONIC F,80867.0,0.0,,2018,3,12,PAYEMENT,80867.0,C1057152052
17830,1196428',2018-03-12,FDRL/NATIONAL ELECTRONIC F,59814.0,0.0,,2018,3,12,CHECK_WITHDRAWAL,59814.0,C849038219
17831,1196428',2018-03-12,FDRL/NATIONAL ELECTRONIC F,90504.0,0.0,,2018,3,12,PAYEMENT,90504.0,C510382951
17832,1196428',2018-03-12,FDRL/NATIONAL ELECTRONIC F,75333.0,0.0,,2018,3,12,CASH_OUT,75333.0,C2010551794
17833,1196428',2018-03-12,FDRL/NATIONAL ELECTRONIC F,96722.0,0.0,,2018,3,12,CASH_OUT,96722.0,C155439298
17834,1196428',2018-03-12,FDRL/NATIONAL ELECTRONIC F,58044.0,0.0,,2018,3,12,DEBIT,58044.0,M1405372797
17835,1196428',2018-03-12,FDRL/NATIONAL ELECTRONIC F,70911.0,0.0,,2018,3,12,DEBIT,70911.0,M645572406
17836,1196428',2018-03-12,FDRL/NATIONAL ELECTRONIC F,64033.0,0.0,,2018,3,12,CHECK_WITHDRAWAL,64033.0,M572511553
17837,1196428',2018-03-12,FDRL/NATIONAL ELECTRONIC F,96016.0,0.0,,2018,3,12,DEBIT,96016.0,C1963862935
17838,1196428',2018-03-12,FDRL/NATIONAL ELECTRONIC F,57257.0,0.0,,2018,3,12,DEBIT,57257.0,C1231540556
17839,1196428',2018-03-12,FDRL/NATIONAL ELECTRONIC F,67771.0,0.0,,2018,3,12,CASH_OUT,67771.0,M861232157
17840,1196428',2018-03-12,FDRL/NATIONAL ELECTRONIC F,48767.0,0.0,,2018,3,12,DEBIT,48767.0,M1115027378
17841,1196428',2018-03-12,FDRL/NATIONAL ELECTRONIC F,32543.0,0.0,,2018,3,12,CASH_OUT,32543.0,M1436555707
17842,1196428',2018-03-12,FDRL/NATIONAL ELECTRONIC F,33365.0,0.0,,2018,3,12,CASH_OUT,33365.0,C1651379334
17843,1196428',2018-03-12,FDRL/NATIONAL ELECTRONIC F,39550.0,0.0,,2018,3,12,CASH_OUT,39550.0,C1587143371
17844,1196428',2018-03-12,FDRL/NATIONAL ELECTRONIC F,36017.0,0.0,,2018,3,12,CHECK_WITHDRAWAL,36017.0,C1321128627
17845,1196428',2018-03-12,FDRL/NATIONAL ELECTRONIC F,31595.0,0.0,,2018,3,12,CASH_OUT,31595.0,M2122686682
17846,1196428',2018-03-12,FDRL/NATIONAL ELECTRONIC F,45200.0,0.0,,2018,3,12,PAYEMENT,45200.0,M922394301
17847,1196428',2018-03-12,FDRL/NATIONAL ELECTRONIC F,36552.0,0.0,,2018,3,12,CHECK_WITHDRAWAL,36552.0,M697107300
17848,1196428',2018-03-12,FDRL/NATIONAL ELECTRONIC F,31827.0,0.0,,2018,3,12,DEBIT,31827.0,C1359953204
17849,1196428',2018-03-12,FDRL/NATIONAL ELECTRONIC F,130996.0,0.0,,2018,3,12,CHECK_WITHDRAWAL,130996.0,M2046900034
17850,1196428',2018-03-12,FDRL/NATIONAL ELECTRONIC F,135350.0,0.0,,2018,3,12,CASH_OUT,135350.0,M2011623981
17851,1196428',2018-03-12,FDRL/NATIONAL ELECTRONIC F,43200.0,0.0,,2018,3,12,CHECK_WITHDRAWAL,43200.0,M1094310128
17852,1196428',2018-03-12,FDRL/NATIONAL ELECTRONIC F,145493.0,0.0,,2018,3,12,CHECK_WITHDRAWAL,145493.0,C99219259
17853,1196428',2018-03-12,FDRL/NATIONAL ELECTRONIC F,116353.0,0.0,,2018,3,12,CASH_OUT,116353.0,M920834503
17854,1196428',2018-03-12,FDRL/NATIONAL ELECTRONIC F,100043.0,0.0,,2018,3,12,DEBIT,100043.0,C1945802665
17855,1196428',2018-03-12,FDRL/NATIONAL ELECTRONIC F,112397.0,0.0,,2018,3,12,PAYEMENT,112397.0,C922511709
17856,1196428',2018-03-12,FDRL/NATIONAL ELECTRONIC F,120700.0,0.0,,2018,3,12,DEBIT,120700.0,C2113748097
17857,1196428',2018-03-12,FDRL/NATIONAL ELECTRONIC F,158593.0,0.0,,2018,3,12,PAYEMENT,158593.0,C1174600239
17858,1196428',2018-03-12,FDRL/NATIONAL ELECTRONIC F,201691.0,0.0,,2018,3,12,DEBIT,201691.0,C870563118
17859,1196428',2018-03-12,FDRL/INTERNAL FUND TRANSFE,36525.0,0.0,,2018,3,12,PAYEMENT,36525.0,C404279307
17860,1196428',2018-03-12,FDRL/NATIONAL ELECTRONIC F,169469.0,0.0,,2018,3,12,DEBIT,169469.0,C372017580
17861,1196428',2018-03-12,FDRL/INTERNAL FUND TRANSFE,38680.0,0.0,,2018,3,12,PAYEMENT,38680.0,C388527192
17862,1196428',2018-03-12,FDRL/NATIONAL ELECTRONIC F,32367.0,0.0,,2018,3,12,CHECK_WITHDRAWAL,32367.0,C800097916
17863,1196428',2018-03-12,FDRL/NATIONAL ELECTRONIC F,14101.0,0.0,,2018,3,12,DEBIT,14101.0,C1343642221
17864,1196428',2018-03-12,FDRL/NATIONAL ELECTRONIC F,16401.0,0.0,,2018,3,12,CASH_OUT,16401.0,C1538961175
17865,1196428',2018-03-12,FDRL/NATIONAL ELECTRONIC F,18402.0,0.0,,2018,3,12,CASH_OUT,18402.0,C872592585
17866,1196428',2018-03-12,FDRL/NATIONAL ELECTRONIC F,66767.0,0.0,,2018,3,12,CASH_OUT,66767.0,C670244241
17867,1196428',2018-03-12,FDRL/NATIONAL ELECTRONIC F,9125.0,0.0,,2018,3,12,CHECK_WITHDRAWAL,9125.0,C1413055366
17868,1196428',2018-03-12,FDRL/NATIONAL ELECTRONIC F,27119.0,0.0,,2018,3,12,CHECK_WITHDRAWAL,27119.0,C1573641401
17869,1196428',2018-03-12,FDRL/NATIONAL ELECTRONIC F,20552.0,0.0,,2018,3,12,DEBIT,20552.0,C1220897602
17870,1196428',2018-03-12,FDRL/NATIONAL ELECTRONIC F,31360.0,0.0,,2018,3,12,CASH_OUT,31360.0,C906718881
17871,1196428',2018-03-12,FDRL/NATIONAL ELECTRONIC F,41175.0,0.0,,2018,3,12,CASH_OUT,41175.0,C1700852615
17872,1196428',2018-03-12,FDRL/NATIONAL ELECTRONIC F,21217.0,0.0,,2018,3,12,PAYEMENT,21217.0,C1874138331
17873,1196428',2018-03-12,FDRL/NATIONAL ELECTRONIC F,59908.0,0.0,,2018,3,12,CHECK_WITHDRAWAL,59908.0,C1541385794
17874,1196428',2018-03-12,FDRL/NATIONAL ELECTRONIC F,59765.0,0.0,,2018,3,12,DEBIT,59765.0,C847761155
17875,1196428',2018-03-12,FDRL/NATIONAL ELECTRONIC F,49824.0,0.0,,2018,3,12,DEBIT,49824.0,C345679794
17876,1196428',2018-03-12,FDRL/NATIONAL ELECTRONIC F,30933.0,0.0,,2018,3,12,CHECK_WITHDRAWAL,30933.0,C1318822808
17877,1196428',2018-03-12,FDRL/NATIONAL ELECTRONIC F,70650.0,0.0,,2018,3,12,CHECK_WITHDRAWAL,70650.0,C875761527
17878,1196428',2018-03-12,FDRL/NATIONAL ELECTRONIC F,33417.0,0.0,,2018,3,12,DEBIT,33417.0,C392292416
17879,1196428',2018-03-12,FDRL/NATIONAL ELECTRONIC F,66393.0,0.0,,2018,3,12,CASH_OUT,66393.0,C1805445027
17880,1196428',2018-03-12,FDRL/NATIONAL ELECTRONIC F,40150.0,0.0,,2018,3,12,DEBIT,40150.0,C439078113
17881,1196428',2018-03-12,FDRL/NATIONAL ELECTRONIC F,61943.0,0.0,,2018,3,12,PAYEMENT,61943.0,C2083562754
17882,1196428',2018-03-12,FDRL/NATIONAL ELECTRONIC F,35917.0,0.0,,2018,3,12,DEBIT,35917.0,C920011586
17883,1196428',2018-03-12,CASHDEP/GREATER KA/TPP/AN,0.0,63500.0,,2018,3,12,CASH_IN,63500.0,C1196694338
17884,1196428',2018-03-12,FDRL/INTERNAL FUND TRANSFE,500000.0,0.0,,2018,3,12,PAYEMENT,500000.0,C1556875182
17885,1196428',2018-03-12,FDRL/INTERNAL FUND TRANSFE,200000.0,0.0,,2018,3,12,CASH_OUT,200000.0,C1084435493
17886,1196428',2018-03-12,FDRL/INTERNAL FUND TRANSFE,300000.0,0.0,,2018,3,12,DEBIT,300000.0,C1583245323
17887,1196428',2018-03-12,TRF FROM  Indiaforensic SERVICES,0.0,8200000.0,,2018,3,12,TRANSFER,8200000.0,C839288013
17888,1196428',2018-03-12,TRF TO  Indiaforensic SERVICES I,220000.0,0.0,,2018,3,12,CHECK_WITHDRAWAL,220000.0,C1457728035
17889,1196428',2018-03-12,YOURSELF FOR BULK NEFT  B,2967500.0,0.0,,2018,3,12,DEBIT,2967500.0,C1054542265
17890,1196428',2018-03-12,FDRL/INTERNAL FUND TRANSFE,15000000.0,0.0,,2018,3,12,PAYEMENT,15000000.0,C1979001148
17891,1196428',2018-03-12,BEAT CSH PKP DEL GURG 617,0.0,879000.0,,2018,3,12,TRANSFER,879000.0,C146155266
17892,1196428',2018-03-13,CASHDEP/NOIDA/TP,0.0,280000.0,,2018,3,13,CHECK_CASHING,280000.0,C283471991
17893,1196428',2018-03-13,FDRL/REAL TIME GROSS SETTL,2000000.0,0.0,,2018,3,13,PAYEMENT,2000000.0,C1564931235
17894,1196428',2018-03-13,FDRL/REAL TIME GROSS SETTL,3000000.0,0.0,,2018,3,13,DEBIT,3000000.0,C1816315990
17895,1196428',2018-03-13,FDRL/REAL TIME GROSS SETTL,2000000.0,0.0,,2018,3,13,PAYEMENT,2000000.0,C1579141271
17896,1196428',2018-03-13,Indiaforensic SERVICES INDIA PVT,0.0,453230.0,,2018,3,13,CHECK_CASHING,453230.0,C1218365329
17897,1196428',2018-03-13,TRF FROM  Indiaforensic SERVICES,0.0,5000000.0,,2018,3,13,CHECK_CASHING,5000000.0,C361268035
17898,1196428',2018-03-13,FDRL/INTERNAL FUND TRANSFE,0.0,3000000.0,,2018,3,13,CHECK_CASHING,3000000.0,C191614132
17899,1196428',2018-03-13,FDRL/REAL TIME GROSS SETTL,3000000.0,0.0,,2018,3,13,CHECK_WITHDRAWAL,3000000.0,C1259769769
17900,1196428',2018-03-13,FDRL/REAL TIME GROSS SETTL,3000000.0,0.0,,2018,3,13,CHECK_WITHDRAWAL,3000000.0,C1978557426
17901,1196428',2018-03-13,RTGS/HDFCH18072096546/PAY,0.0,3920000.0,,2018,3,13,CHECK_CASHING,3920000.0,C2113508588
17902,1196428',2018-03-13,RTGS/HDFCH18072096562/PAY,0.0,2640000.0,,2018,3,13,TRANSFER,2640000.0,C1899073220
17903,1196428',2018-03-13,FDRL/REAL TIME GROSS SETTL,3000000.0,0.0,,2018,3,13,CHECK_WITHDRAWAL,3000000.0,C69214838
17904,1196428',2018-03-13,FDRL/REAL TIME GROSS SETTL,3000000.0,0.0,,2018,3,13,CASH_OUT,3000000.0,C767544292
17905,1196428',2018-03-13,FDRL/REAL TIME GROSS SETTL,3000000.0,0.0,,2018,3,13,CHECK_WITHDRAWAL,3000000.0,C1233191588
17906,1196428',2018-03-13,TRF FROM  Indiaforensic SERVICES,0.0,11200000.0,,2018,3,13,TRANSFER,11200000.0,C1979585370
17907,1196428',2018-03-13,FDRL/REAL TIME GROSS SETTL,10000000.0,0.0,,2018,3,13,PAYEMENT,10000000.0,C1485516154
17908,1196428',2018-03-13,FDRL/REAL TIME GROSS SETTL,2000000.0,0.0,,2018,3,13,CASH_OUT,2000000.0,C1414919255
17909,1196428',2018-03-13,Indiaforensic SERVICES INDIA PVT,0.0,241574.0,,2018,3,13,TRANSFER,241574.0,C710481910
17910,1196428',2018-03-13,NEFT/N072180494772894/PAY,0.0,1040368.4,,2018,3,13,CHECK_CASHING,1040368.4,C1651379334
17911,1196428',2018-03-13,NEFT/N072180494772848/PAY,0.0,1740541.17,,2018,3,13,CASH_IN,1740541.17,C28125426
17912,1196428',2018-03-13,BEAT CSH PKP DEL GURG 617,0.0,227500.0,,2018,3,13,TRANSFER,227500.0,M1126154865
17913,1196428',2018-03-13,TRF FROM  Indiaforensic SERVICES,0.0,5200000.0,,2018,3,13,CASH_IN,5200000.0,C978609035
17914,1196428',2018-03-13,BULK NEFT RETURN/ACNOTEXI,0.0,1000000.0,,2018,3,13,CASH_IN,1000000.0,M797669623
17915,1196428',2018-03-13,FDRL/INTERNAL FUND TRANSFE,1000000.0,0.0,,2018,3,13,PAYEMENT,1000000.0,M1847001824
17916,1196428',2018-03-13,FDRL/INTERNAL FUND TRANSFE,5000000.0,0.0,,2018,3,13,DEBIT,5000000.0,C1948471365
17917,1196428',2018-03-14,FDRL/INTERNAL FUND TRANSFE,1000000.0,0.0,,2018,3,14,CHECK_WITHDRAWAL,1000000.0,C447934822
17918,1196428',2018-03-14,CASHDEP/NOIDA/TP,0.0,224000.0,,2018,3,14,TRANSFER,224000.0,M1210915769
17919,1196428',2018-03-14,FDRL/INTERNAL FUND TRANSFE,0.0,2000000.0,,2018,3,14,TRANSFER,2000000.0,M2028813425
17920,1196428',2018-03-14,FDRL/INTERNAL FUND TRANSFE,0.0,2000000.0,,2018,3,14,CHECK_CASHING,2000000.0,C1066176965
17921,1196428',2018-03-14,FDRL/REAL TIME GROSS SETTL,3000000.0,0.0,,2018,3,14,CHECK_WITHDRAWAL,3000000.0,M9337347
17922,1196428',2018-03-14,FDRL/REAL TIME GROSS SETTL,3000000.0,0.0,,2018,3,14,CASH_OUT,3000000.0,C142211154
17923,1196428',2018-03-14,RTGS/HDFCH18073282256/PAY,0.0,4400000.0,,2018,3,14,TRANSFER,4400000.0,M809845484
17924,1196428',2018-03-14,RTGS/HDFCH18073282237/PAY,0.0,1760000.0,,2018,3,14,TRANSFER,1760000.0,C575335780
17925,1196428',2018-03-14,NEFT/20460928931DC/ARTHAS,0.0,50000.0,,2018,3,14,TRANSFER,50000.0,C1585249461
17926,1196428',2018-03-14,FDRL/REAL TIME GROSS SETTL,3000000.0,0.0,,2018,3,14,DEBIT,3000000.0,C1054909747
17927,1196428',2018-03-14,FDRL/REAL TIME GROSS SETTL,3000000.0,0.0,,2018,3,14,DEBIT,3000000.0,M719342934
17928,1196428',2018-03-14,FDRL/INTERNAL FUND TRANSFE,1000000.0,0.0,,2018,3,14,PAYEMENT,1000000.0,M1679859032
17929,1196428',2018-03-14,NEFT/AXISP18073056842/ACC,0.0,1000000.0,,2018,3,14,CHECK_CASHING,1000000.0,M61304121
17930,1196428',2018-03-14,TRF FROM  Indiaforensic SERVICES,0.0,3000000.0,,2018,3,14,TRANSFER,3000000.0,M39931614
17931,1196428',2018-03-14,TRF FROM  Indiaforensic SERVICES,0.0,600000.0,,2018,3,14,TRANSFER,600000.0,M963530944
17932,1196428',2018-03-14,TRF FROM  Indiaforensic SERVICES,0.0,7600000.0,,2018,3,14,CASH_IN,7600000.0,M229301500
17933,1196428',2018-03-14,FDRL/REAL TIME GROSS SETTL,10000000.0,0.0,,2018,3,14,CHECK_WITHDRAWAL,10000000.0,M109739216
17934,1196428',2018-03-14,FDRL/REAL TIME GROSS SETTL,2000000.0,0.0,,2018,3,14,CASH_OUT,2000000.0,C1564931235
17935,1196428',2018-03-14,"Indiaforensic USA, INC./USD/3912",0.0,2531193.4,,2018,3,14,CASH_IN,2531193.4,M1894452268
17936,1196428',2018-03-14,IRTT00701807771,1560.61,0.0,,2018,3,14,DEBIT,1560.61,C2089779261
17937,1196428',2018-03-14,NEFT/N073180495567503/PAY,0.0,476729.68,,2018,3,14,CASH_IN,476729.68,M1292563401
17938,1196428',2018-03-14,NEFT/N073180495567524/PAY,0.0,1306983.75,,2018,3,14,CHECK_CASHING,1306983.75,M1415260410
17939,1196428',2018-03-14,Indiaforensic SERVICES INDIA PVT,0.0,230171.0,,2018,3,14,TRANSFER,230171.0,C619068319
17940,1196428',2018-03-14,FDRL/INTERNAL FUND TRANSFE,1000000.0,0.0,,2018,3,14,PAYEMENT,1000000.0,C372017580
17941,1196428',2018-03-14,FDRL/INTERNAL FUND TRANSFE,300000.0,0.0,,2018,3,14,DEBIT,300000.0,C1615804266
17942,1196428',2018-03-14,FDRL/INTERNAL FUND TRANSFE,500000.0,0.0,,2018,3,14,CHECK_WITHDRAWAL,500000.0,C2011996123
17943,1196428',2018-03-14,FDRL/INTERNAL FUND TRANSFE,500000.0,0.0,,2018,3,14,PAYEMENT,500000.0,C1501701470
17944,1196428',2018-03-14,TRF FROM  Indiaforensic SERVICES,0.0,5000000.0,,2018,3,14,CHECK_CASHING,5000000.0,C849038219
17945,1196428',2018-03-14,FDRL/INTERNAL FUND TRANSFE,5000000.0,0.0,,2018,3,14,DEBIT,5000000.0,C399685190
17946,1196428',2018-03-14,FDRL/INTERNAL FUND TRANSFE,2000000.0,0.0,,2018,3,14,DEBIT,2000000.0,M1245948589
17947,1196428',2018-03-14,BEAT CSH PKP DEL GURG 617,0.0,346500.0,,2018,3,14,CASH_IN,346500.0,M1727286255
17948,1196428',2018-03-15,CASHDEP/NOIDA/TP,0.0,134000.0,,2018,3,15,CHECK_CASHING,134000.0,M312717383
17949,1196428',2018-03-15,RTGS/HDFCH18074456257/PAY,0.0,3600000.0,,2018,3,15,TRANSFER,3600000.0,M1284687471
17950,1196428',2018-03-15,RTGS/HDFCH18074454329/PAY,0.0,1680000.0,,2018,3,15,CASH_IN,1680000.0,M359411618
17951,1196428',2018-03-15,CASHDEP/VIKASMARG/TP,0.0,33000.0,,2018,3,15,CASH_IN,33000.0,M771068844
17952,1196428',2018-03-15,NEFT/20462430771DC/ARTHAS,0.0,25000.0,,2018,3,15,TRANSFER,25000.0,M1475705589
17953,1196428',2018-03-15,FDRL/REAL TIME GROSS SETTL,3000000.0,0.0,,2018,3,15,DEBIT,3000000.0,C1003872245
17954,1196428',2018-03-15,FDRL/REAL TIME GROSS SETTL,3000000.0,0.0,,2018,3,15,CASH_OUT,3000000.0,C1245472829
17955,1196428',2018-03-15,TRF FROM  Indiaforensic SERVICES,0.0,7700000.0,,2018,3,15,TRANSFER,7700000.0,M149581228
17956,1196428',2018-03-15,FDRL/REAL TIME GROSS SETTL,3000000.0,0.0,,2018,3,15,CHECK_WITHDRAWAL,3000000.0,C715819458
17957,1196428',2018-03-15,FDRL/REAL TIME GROSS SETTL,1000000.0,0.0,,2018,3,15,CASH_OUT,1000000.0,C712956349
17958,1196428',2018-03-15,FDRL/REAL TIME GROSS SETTL,3000000.0,0.0,,2018,3,15,DEBIT,3000000.0,M1314966180
17959,1196428',2018-03-15,NEFT/N074180496343231/TEC,0.0,300000.0,,2018,3,15,TRANSFER,300000.0,C1940815076
17960,1196428',2018-03-15,NEFT/N074180496403976/PAY,0.0,912013.3,,2018,3,15,TRANSFER,912013.3,M1873399683
17961,1196428',2018-03-15,NEFT/N074180496404029/PAY,0.0,511180.54,,2018,3,15,CHECK_CASHING,511180.54,M831341599
17962,1196428',2018-03-15,NEFT/P18031594378756/KADU,0.0,10000.0,,2018,3,15,CHECK_CASHING,10000.0,M890520916
17963,1196428',2018-03-15,FDRL/INTERNAL FUND TRANSFE,1000000.0,0.0,,2018,3,15,PAYEMENT,1000000.0,M1775772917
17964,1196428',2018-03-15,CASHDEP/SILVASSA/,0.0,15000.0,,2018,3,15,CHECK_CASHING,15000.0,M1756075046
17965,1196428',2018-03-15,TRF FROM  Indiaforensic SERVICES,0.0,4200000.0,,2018,3,15,CHECK_CASHING,4200000.0,M59339273
17966,1196428',2018-03-15,Indiaforensic SERVICES INDIA PVT,0.0,219039.0,,2018,3,15,CHECK_CASHING,219039.0,M1515923497
17967,1196428',2018-03-15,BEAT CSH PKP DEL GURG 617,0.0,289000.0,,2018,3,15,CHECK_CASHING,289000.0,M1227829817
17968,1196428',2018-03-15,NEFT/KKBK180741091748/Acc,0.0,4000000.0,,2018,3,15,TRANSFER,4000000.0,M147508715
17969,1196428',2018-03-15,FDRL/INTERNAL FUND TRANSFE,10000000.0,0.0,,2018,3,15,PAYEMENT,10000000.0,M1229084948
17970,1196428',2018-03-16,FDRL/INTERNAL FUND TRANSFE,0.0,2000000.0,,2018,3,16,CHECK_CASHING,2000000.0,M21653658
17971,1196428',2018-03-16,FDRL/REAL TIME GROSS SETTL,2000000.0,0.0,,2018,3,16,PAYEMENT,2000000.0,M1138303443
17972,1196428',2018-03-16,RTGS/HDFCH18075647212/PAY,0.0,3840000.0,,2018,3,16,CHECK_CASHING,3840000.0,M1157228303
17973,1196428',2018-03-16,RTGS/HDFCH18075647180/PAY,0.0,1440000.0,,2018,3,16,CHECK_CASHING,1440000.0,M343911080
17974,1196428',2018-03-16,CASHDEP/NOIDA/TP,0.0,126000.0,,2018,3,16,TRANSFER,126000.0,M590566106
17975,1196428',2018-03-16,NEFT/20464016071DC/ARTHAS,0.0,25000.0,,2018,3,16,CHECK_CASHING,25000.0,M1113751147
17976,1196428',2018-03-16,NEFT/AXISP18075053706/ACC,0.0,16000000.0,,2018,3,16,CHECK_CASHING,16000000.0,M464377693
17977,1196428',2018-03-16,FDRL/REAL TIME GROSS SETTL,10000000.0,0.0,,2018,3,16,CHECK_WITHDRAWAL,10000000.0,M1823493205
17978,1196428',2018-03-16,FDRL/REAL TIME GROSS SETTL,10000000.0,0.0,,2018,3,16,DEBIT,10000000.0,M887885503
17979,1196428',2018-03-16,NEFT/IDFBH18075656413/FUN,0.0,19600.0,,2018,3,16,CHECK_CASHING,19600.0,C2103065350
17980,1196428',2018-03-16,FDRL/INTERNAL FUND TRANSFE,1500000.0,0.0,,2018,3,16,CHECK_WITHDRAWAL,1500000.0,M1345772956
17981,1196428',2018-03-16,Indiaforensic SERVICES INDIA PVT,0.0,212039.0,,2018,3,16,TRANSFER,212039.0,C1069131391
17982,1196428',2018-03-16,NEFT/N075180497248416/PAY,0.0,378809.58,,2018,3,16,TRANSFER,378809.58,C625232315
17983,1196428',2018-03-16,NEFT/N075180497254221/PAY,0.0,997203.47,,2018,3,16,CASH_IN,997203.47,M1842324609
17984,1196428',2018-03-16,NEFT/20464353591DC/ARTHAS,0.0,5500000.0,,2018,3,16,CHECK_CASHING,5500000.0,M866805767
17985,1196428',2018-03-16,FDRL/INTERNAL FUND TRANSFE,200000.0,0.0,,2018,3,16,CHECK_WITHDRAWAL,200000.0,C970612443
17986,1196428',2018-03-16,FDRL/INTERNAL FUND TRANSFE,300000.0,0.0,,2018,3,16,CASH_OUT,300000.0,C1016689071
17987,1196428',2018-03-16,IMPS 807517960796 FROM SA,0.0,200000.0,,2018,3,16,CHECK_CASHING,200000.0,C1790202239
17988,1196428',2018-03-16,IMPS 807517139518 FROM GU,0.0,500.0,,2018,3,16,TRANSFER,500.0,M1275744398
17989,1196428',2018-03-16,TRF FROM  Indiaforensic SERVICES,0.0,5700000.0,,2018,3,16,TRANSFER,5700000.0,M44037039
17990,1196428',2018-03-16,TRF FROM  Indiaforensic SERVICES,0.0,4300000.0,,2018,3,16,CASH_IN,4300000.0,M1514395620
17991,1196428',2018-03-16,FDRL/INTERNAL FUND TRANSFE,500000.0,0.0,,2018,3,16,PAYEMENT,500000.0,M2133555046
17992,1196428',2018-03-16,FDRL/INTERNAL FUND TRANSFE,15000000.0,0.0,,2018,3,16,CASH_OUT,15000000.0,C681835572
17993,1196428',2018-03-16,BEAT CSH PKP DEL GURG 617,0.0,353000.0,,2018,3,16,CHECK_CASHING,353000.0,C1630293008
17994,1196428',2018-03-17,FDRL/REAL TIME GROSS SETTL,1000000.0,0.0,,2018,3,17,DEBIT,1000000.0,M1705251347
17995,1196428',2018-03-17,FDRL/NATIONAL ELECTRONIC F,15776.0,0.0,,2018,3,17,PAYEMENT,15776.0,C2042228109
17996,1196428',2018-03-17,FDRL/NATIONAL ELECTRONIC F,408526.0,0.0,,2018,3,17,CASH_OUT,408526.0,C1410669831
17997,1196428',2018-03-17,FDRL/NATIONAL ELECTRONIC F,5815.0,0.0,,2018,3,17,DEBIT,5815.0,C1040847151
17998,1196428',2018-03-17,FDRL/NATIONAL ELECTRONIC F,4111.0,0.0,,2018,3,17,CHECK_WITHDRAWAL,4111.0,M2129125819
17999,1196428',2018-03-17,FDRL/NATIONAL ELECTRONIC F,14568.0,0.0,,2018,3,17,PAYEMENT,14568.0,M1143552059
18000,1196428',2018-03-17,RTGS/HDFCH18076815633/PAY,0.0,1680000.0,,2018,3,17,TRANSFER,1680000.0,M354813619
18001,1196428',2018-03-17,RTGS/HDFCH18076816662/PAY,0.0,3360000.0,,2018,3,17,CASH_IN,3360000.0,C1567808902
18002,1196428',2018-03-17,NEFT/N076180497778657/MAH,0.0,1000.0,,2018,3,17,TRANSFER,1000.0,M137358091
18003,1196428',2018-03-17,CASHDEP/NOIDA/TP,0.0,202000.0,,2018,3,17,CASH_IN,202000.0,C2123122269
18004,1196428',2018-03-17,FDRL/INTERNAL FUND TRANSFE,0.0,3000000.0,,2018,3,17,CHECK_CASHING,3000000.0,M136358885
18005,1196428',2018-03-17,NEFT/N076180497828744/MAH,0.0,47000.0,,2018,3,17,CASH_IN,47000.0,M434552545
18006,1196428',2018-03-17,FDRL/REAL TIME GROSS SETTL,2000000.0,0.0,,2018,3,17,DEBIT,2000000.0,C777863332
18007,1196428',2018-03-17,FDRL/REAL TIME GROSS SETTL,3000000.0,0.0,,2018,3,17,CHECK_WITHDRAWAL,3000000.0,C121523915
18008,1196428',2018-03-17,FDRL/REAL TIME GROSS SETTL,3000000.0,0.0,,2018,3,17,DEBIT,3000000.0,M317148495
18009,1196428',2018-03-17,CHQ DEP/1884/OWDEL1/SCBL/,0.0,50000.0,,2018,3,17,TRANSFER,50000.0,C1753885705
18010,1196428',2018-03-17,TRF FROM  Indiaforensic SERVICES,0.0,5000000.0,,2018,3,17,CHECK_CASHING,5000000.0,M1635682741
18011,1196428',2018-03-17,NEFT/N076180498061102/PAY,0.0,523544.08,,2018,3,17,CASH_IN,523544.08,M1387003338
18012,1196428',2018-03-17,NEFT/N076180498066167/PAY,0.0,904554.14,,2018,3,17,CASH_IN,904554.14,M1441850231
18013,1196428',2018-03-17,TRF FROM  Indiaforensic SERVICES,0.0,2000000.0,,2018,3,17,CASH_IN,2000000.0,C257884050
18014,1196428',2018-03-17,TRF FROM  Indiaforensic SERVICES,0.0,500000.0,,2018,3,17,CASH_IN,500000.0,M1064481154
18015,1196428',2018-03-17,FDRL/INTERNAL FUND TRANSFE,5000000.0,0.0,,2018,3,17,PAYEMENT,5000000.0,M192483133
18016,1196428',2018-03-17,FDRL/INTERNAL FUND TRANSFE,4000000.0,0.0,,2018,3,17,PAYEMENT,4000000.0,C1067741229
18017,1196428',2018-03-17,FDRL/INTERNAL FUND TRANSFE,500000.0,0.0,,2018,3,17,PAYEMENT,500000.0,M953674220
18018,1196428',2018-03-17,BEAT CSH PKP DEL GURG 617,0.0,138700.0,,2018,3,17,CASH_IN,138700.0,M652278729
18019,1196428',2018-03-19,RTGS/HDFCH18078966527/PAY,0.0,2720000.0,,2018,3,19,TRANSFER,2720000.0,M1946782788
18020,1196428',2018-03-19,RTGS/HDFCH18078968628/PAY,0.0,4000000.0,,2018,3,19,CHECK_CASHING,4000000.0,M235978251
18021,1196428',2018-03-19,FDRL/NATIONAL ELECTRONIC F,6570.0,0.0,,2018,3,19,CHECK_WITHDRAWAL,6570.0,C186847111
18022,1196428',2018-03-19,FDRL/REAL TIME GROSS SETTL,3000000.0,0.0,,2018,3,19,DEBIT,3000000.0,C28125426
18023,1196428',2018-03-19,FDRL/REAL TIME GROSS SETTL,3000000.0,0.0,,2018,3,19,PAYEMENT,3000000.0,C349015546
18024,1196428',2018-03-19,CASHDEP/VIKASMARG/TP,0.0,356000.0,,2018,3,19,TRANSFER,356000.0,C755583709
18025,1196428',2018-03-19,IMPS 807811048097 FROM SA,0.0,50000.0,,2018,3,19,CHECK_CASHING,50000.0,M168658496
18026,1196428',2018-03-19,FDRL/INTERNAL FUND TRANSFE,0.0,3000000.0,,2018,3,19,CHECK_CASHING,3000000.0,M1495660115
18027,1196428',2018-03-19,FDRL/REAL TIME GROSS SETTL,2000000.0,0.0,,2018,3,19,DEBIT,2000000.0,C1186449563
18028,1196428',2018-03-19,FDRL/REAL TIME GROSS SETTL,2000000.0,0.0,,2018,3,19,CHECK_WITHDRAWAL,2000000.0,C553790651
18029,1196428',2018-03-19,NEFT/N078180498783246/PAY,0.0,647514.48,,2018,3,19,CASH_IN,647514.48,M223450876
18030,1196428',2018-03-19,FDRL/REAL TIME GROSS SETTL,1000000.0,0.0,,2018,3,19,DEBIT,1000000.0,C288197656
18031,1196428',2018-03-19,NEFT/N078180498779691/PAY,0.0,1008801.05,,2018,3,19,CASH_IN,1008801.05,M1584135095
18032,1196428',2018-03-19,TRF FROM  Indiaforensic SERVICES,0.0,4000000.0,,2018,3,19,CHECK_CASHING,4000000.0,M197041844
18033,1196428',2018-03-19,TRF FROM  Indiaforensic SERVICES,0.0,4000000.0,,2018,3,19,CASH_IN,4000000.0,M472464874
18034,1196428',2018-03-19,"NETHOPE, INC/USD/140000/6",0.0,9072000.0,,2018,3,19,CHECK_CASHING,9072000.0,M1604986086
18035,1196428',2018-03-19,IRTT00701808494,2737.96,0.0,,2018,3,19,DEBIT,2737.96,C934085675
18036,1196428',2018-03-19,NEFT/N078180498912372/TEC,0.0,200000.0,,2018,3,19,CHECK_CASHING,200000.0,M863401706
18037,1196428',2018-03-19,"Indiaforensic USA, INC./USD/2580",0.0,1672034.4,,2018,3,19,CHECK_CASHING,1672034.4,M523084658
18038,1196428',2018-03-19,IRTT00701808492,1405.97,0.0,,2018,3,19,CASH_OUT,1405.97,M1971845723
18039,1196428',2018-03-19,NEFT CHARGES AND GST/0000,29.5,0.0,,2018,3,19,PAYEMENT,29.5,C2013691076
18040,1196428',2018-03-19,NEFT/000033793200/GALENA,3000000.0,0.0,,2018,3,19,CASH_OUT,3000000.0,M1358249113
18041,1196428',2018-03-19,YOURSELF FOR BULK NEFT  B,13182505.0,0.0,,2018,3,19,CASH_OUT,13182505.0,C1253356749
18042,1196428',2018-03-19,TRF FROM  Indiaforensic SERVICES,0.0,9500000.0,,2018,3,19,CASH_IN,9500000.0,C1311325237
18043,1196428',2018-03-19,FDRL/INTERNAL FUND TRANSFE,10000000.0,0.0,,2018,3,19,CHECK_WITHDRAWAL,10000000.0,C1150610696
18044,1196428',2018-03-19,BEAT CSH PKP DEL GURG6179,0.0,333500.0,,2018,3,19,CASH_IN,333500.0,C720759478
18045,1196428',2018-03-20,CASHDEP/NOIDA/TP,0.0,50000.0,,2018,3,20,CASH_IN,50000.0,C1354183876
18046,1196428',2018-03-20,CASHDEP/NOIDA/TP,0.0,72000.0,,2018,3,20,CASH_IN,72000.0,C1014154376
18047,1196428',2018-03-20,RTGS/HDFCH18079160821/PAY,0.0,2080000.0,,2018,3,20,CASH_IN,2080000.0,C2006081398
18048,1196428',2018-03-20,RTGS/HDFCH18079160835/PAY,0.0,3360000.0,,2018,3,20,CASH_IN,3360000.0,C428796726
18049,1196428',2018-03-20,FDRL/REAL TIME GROSS SETTL,3000000.0,0.0,,2018,3,20,PAYEMENT,3000000.0,C1957274125
18050,1196428',2018-03-20,NEFT/SIBLN18079236041/M A,0.0,11800.0,,2018,3,20,CASH_IN,11800.0,C1531333864
18051,1196428',2018-03-20,"Indiaforensic USA, INC./USD/4990",0.0,324100.5,,2018,3,20,TRANSFER,324100.5,C1475998599
18052,1196428',2018-03-20,IRTT00701808556,676.69,0.0,,2018,3,20,CASH_OUT,676.69,C440708502
18053,1196428',2018-03-20,NEFT/IT36701803202909/FIX,0.0,80000.0,,2018,3,20,CHECK_CASHING,80000.0,C2065199032
18054,1196428',2018-03-20,FDRL/REAL TIME GROSS SETTL,3000000.0,0.0,,2018,3,20,PAYEMENT,3000000.0,C874023329
18055,1196428',2018-03-20,FDRL/REAL TIME GROSS SETTL,3000000.0,0.0,,2018,3,20,CHECK_WITHDRAWAL,3000000.0,C455218098
18056,1196428',2018-03-20,NEFT/20468138151DC/ARTHAS,0.0,225000.0,,2018,3,20,TRANSFER,225000.0,C508000580
18057,1196428',2018-03-20,NEFT/CITIN18834909938/RTG,0.0,140000.0,,2018,3,20,CASH_IN,140000.0,C1649686970
18058,1196428',2018-03-20,FDRL/REAL TIME GROSS SETTL,1000000.0,0.0,,2018,3,20,CHECK_WITHDRAWAL,1000000.0,C194746285
18059,1196428',2018-03-20,TRF FROM  Indiaforensic SERVICES,0.0,11900000.0,,2018,3,20,CASH_IN,11900000.0,C1504109395
18060,1196428',2018-03-20,IMPS 807915066939 FROM SE,0.0,1128.0,,2018,3,20,CASH_IN,1128.0,C265845794
18061,1196428',2018-03-20,FDRL/REAL TIME GROSS SETTL,3000000.0,0.0,,2018,3,20,DEBIT,3000000.0,C769342184
18062,1196428',2018-03-20,FDRL/REAL TIME GROSS SETTL,3000000.0,0.0,,2018,3,20,CASH_OUT,3000000.0,C648021642
18063,1196428',2018-03-20,NEFT/AXISP18079096613/ACC,0.0,2000000.0,,2018,3,20,TRANSFER,2000000.0,C170954749
18064,1196428',2018-03-20,FDRL/REAL TIME GROSS SETTL,3000000.0,0.0,,2018,3,20,CHECK_WITHDRAWAL,3000000.0,M654225053
18065,1196428',2018-03-20,NEFT/N079180499711169/PAY,0.0,870744.47,,2018,3,20,TRANSFER,870744.47,M824752879
18066,1196428',2018-03-20,NEFT/N079180499702349/PAY,0.0,516927.56,,2018,3,20,CASH_IN,516927.56,M1013990901
18067,1196428',2018-03-20,Indiaforensic SERVICES INDIA PVT,0.0,753729.0,,2018,3,20,CHECK_CASHING,753729.0,M1648796233
18068,1196428',2018-03-20,FDRL/INTERNAL FUND TRANSFE,200000.0,0.0,,2018,3,20,CHECK_WITHDRAWAL,200000.0,C1051187510
18069,1196428',2018-03-20,FDRL/INTERNAL FUND TRANSFE,500000.0,0.0,,2018,3,20,CASH_OUT,500000.0,M89201946
18070,1196428',2018-03-20,TRF FROM  Indiaforensic SERVICES,0.0,4200000.0,,2018,3,20,CASH_IN,4200000.0,M1078093442
18071,1196428',2018-03-20,BEAT CSH PKP DEL GURG6179,0.0,148000.0,,2018,3,20,CASH_IN,148000.0,C1237095816
18072,1196428',2018-03-20,FDRL/INTERNAL FUND TRANSFE,5000000.0,0.0,,2018,3,20,CHECK_WITHDRAWAL,5000000.0,C1731824557
18073,1196428',2018-03-20,FDRL/INTERNAL FUND TRANSFE,5000000.0,0.0,,2018,3,20,CHECK_WITHDRAWAL,5000000.0,C1369695156
18074,1196428',2018-03-20,FDRL/INTERNAL FUND TRANSFE,500000.0,0.0,,2018,3,20,PAYEMENT,500000.0,M367715578
18075,1196428',2018-03-21,FDRL/NATIONAL ELECTRONIC F,35600.0,0.0,,2018,3,21,CASH_OUT,35600.0,C1793325972
18076,1196428',2018-03-21,RTGS/HDFCH18080348432/PAY,0.0,3920000.0,,2018,3,21,CASH_IN,3920000.0,C1333404258
18077,1196428',2018-03-21,RTGS/HDFCH18080348406/PAY,0.0,1760000.0,,2018,3,21,CASH_IN,1760000.0,C1096283470
18078,1196428',2018-03-21,FDRL/INTERNAL FUND TRANSFE,0.0,3000000.0,,2018,3,21,TRANSFER,3000000.0,C656977363
18079,1196428',2018-03-21,FDRL/REAL TIME GROSS SETTL,3000000.0,0.0,,2018,3,21,CASH_OUT,3000000.0,C1415645767
18080,1196428',2018-03-21,FDRL/REAL TIME GROSS SETTL,3000000.0,0.0,,2018,3,21,CASH_OUT,3000000.0,C1487669283
18081,1196428',2018-03-21,FDRL/REAL TIME GROSS SETTL,3000000.0,0.0,,2018,3,21,PAYEMENT,3000000.0,C1023714065
18082,1196428',2018-03-21,"Indiaforensic USA, INC./USD/1593",0.0,1034341.8,,2018,3,21,CASH_IN,1034341.8,C1787868648
18083,1196428',2018-03-21,IRTT00701808673,1291.18,0.0,,2018,3,21,DEBIT,1291.18,C1255024717
18084,1196428',2018-03-21,CHQ DEP/123/OWDEL1/KKBK/G,0.0,300000.0,,2018,3,21,CASH_IN,300000.0,C1079343872
18085,1196428',2018-03-21,FDRL/INTERNAL FUND TRANSFE,0.0,2000000.0,,2018,3,21,CHECK_CASHING,2000000.0,C67985650
18086,1196428',2018-03-21,FDRL/NATIONAL ELECTRONIC F,18402.0,0.0,,2018,3,21,DEBIT,18402.0,C497806226
18087,1196428',2018-03-21,TRF FROM  Indiaforensic SERVICES,0.0,5100000.0,,2018,3,21,CASH_IN,5100000.0,M1445757582
18088,1196428',2018-03-21,FDRL/REAL TIME GROSS SETTL,3000000.0,0.0,,2018,3,21,CHECK_WITHDRAWAL,3000000.0,M1794919680
18089,1196428',2018-03-21,FDRL/REAL TIME GROSS SETTL,3000000.0,0.0,,2018,3,21,CASH_OUT,3000000.0,M608188371
18090,1196428',2018-03-21,FDRL/REAL TIME GROSS SETTL,2000000.0,0.0,,2018,3,21,CHECK_WITHDRAWAL,2000000.0,C1849941462
18091,1196428',2018-03-21,NEFT/N080180500473928/PAY,0.0,570871.44,,2018,3,21,CASH_IN,570871.44,C711248671
18092,1196428',2018-03-21,NEFT/N080180500469308/PAY,0.0,1287292.95,,2018,3,21,CASH_IN,1287292.95,C506046490
18093,1196428',2018-03-21,NEFT/20469838571DC/ARTHAS,0.0,4000000.0,,2018,3,21,CASH_IN,4000000.0,M570785664
18094,1196428',2018-03-21,NEFT/PUNBH18080234285/M/S,0.0,11800.0,,2018,3,21,CHECK_CASHING,11800.0,C1904349935
18095,1196428',2018-03-21,NEFT/AXISP18080131356/ACC,0.0,2000000.0,,2018,3,21,TRANSFER,2000000.0,C1501701470
18096,1196428',2018-03-21,BEAT CSH PKP DEL GURG 617,0.0,144000.0,,2018,3,21,CHECK_CASHING,144000.0,M232819883
18097,1196428',2018-03-21,TRF FROM  Indiaforensic SERVICES,0.0,2000000.0,,2018,3,21,CASH_IN,2000000.0,M1444087474
18098,1196428',2018-03-21,TRF FROM  Indiaforensic SERVICES,0.0,2000000.0,,2018,3,21,CHECK_CASHING,2000000.0,M1541225257
18099,1196428',2018-03-21,FDRL/INTERNAL FUND TRANSFE,5000000.0,0.0,,2018,3,21,CASH_OUT,5000000.0,M1452282479
18100,1196428',2018-03-21,FDRL/INTERNAL FUND TRANSFE,3000000.0,0.0,,2018,3,21,CASH_OUT,3000000.0,C1383942363
18101,1196428',2018-03-22,FDRL/NATIONAL ELECTRONIC F,5129.0,0.0,,2018,3,22,PAYEMENT,5129.0,M1610701672
18102,1196428',2018-03-22,FDRL/REAL TIME GROSS SETTL,2000000.0,0.0,,2018,3,22,CHECK_WITHDRAWAL,2000000.0,M2143829063
18103,1196428',2018-03-22,FDRL/REAL TIME GROSS SETTL,2000000.0,0.0,,2018,3,22,PAYEMENT,2000000.0,C2136310491
18104,1196428',2018-03-22,NEFT/N081180500863474/TEC,0.0,200000.0,,2018,3,22,CHECK_CASHING,200000.0,C254038376
18105,1196428',2018-03-22,RTGS/HDFCH18081549368/PAY,0.0,3680000.0,,2018,3,22,TRANSFER,3680000.0,M1950482654
18106,1196428',2018-03-22,RTGS/HDFCH18081550728/PAY,0.0,1360000.0,,2018,3,22,CHECK_CASHING,1360000.0,M404886328
18107,1196428',2018-03-22,FDRL/INTERNAL FUND TRANSFE,0.0,3000000.0,,2018,3,22,TRANSFER,3000000.0,C1905244066
18108,1196428',2018-03-22,FDRL/INTERNAL FUND TRANSFE,0.0,2000000.0,,2018,3,22,CHECK_CASHING,2000000.0,M2118899895
18109,1196428',2018-03-22,FDRL/INTERNAL FUND TRANSFE,10000000.0,0.0,,2018,3,22,CASH_OUT,10000000.0,C1433627902
18110,1196428',2018-03-22,TRF FROM  Indiaforensic SERVICES,0.0,7100000.0,,2018,3,22,TRANSFER,7100000.0,C1716892902
18111,1196428',2018-03-22,CASHDEP/NOIDA/TP,0.0,94000.0,,2018,3,22,TRANSFER,94000.0,C388583042
18112,1196428',2018-03-22,FDRL/REAL TIME GROSS SETTL,3000000.0,0.0,,2018,3,22,CHECK_WITHDRAWAL,3000000.0,M73548281
18113,1196428',2018-03-22,FDRL/REAL TIME GROSS SETTL,3000000.0,0.0,,2018,3,22,CASH_OUT,3000000.0,M128343003
18114,1196428',2018-03-22,FDRL/REAL TIME GROSS SETTL,1000000.0,0.0,,2018,3,22,CASH_OUT,1000000.0,M137691595
18115,1196428',2018-03-22,NEFT/IOBAN18081681018/M/S,0.0,5000.0,,2018,3,22,CASH_IN,5000.0,M1144162910
18116,1196428',2018-03-22,NEFT/IOBAN18081680764/M/S,0.0,5000.0,,2018,3,22,CHECK_CASHING,5000.0,M230551274
18117,1196428',2018-03-22,NEFT/ANDBN18219654680/SAI,0.0,11800.0,,2018,3,22,TRANSFER,11800.0,M1468126209
18118,1196428',2018-03-22,NEFT/PUNBH18081355774/SAN,0.0,40000.0,,2018,3,22,CASH_IN,40000.0,M744006350
18119,1196428',2018-03-22,TRF FROM  Indiaforensic ONLINE S,0.0,10000000.0,,2018,3,22,CASH_IN,10000000.0,M2095996719
18120,1196428',2018-03-22,NEFT/P18032294741693/KADU,0.0,15000.0,,2018,3,22,CHECK_CASHING,15000.0,M1569402768
18121,1196428',2018-03-22,FDRL/REAL TIME GROSS SETTL,3000000.0,0.0,,2018,3,22,DEBIT,3000000.0,M1134956408
18122,1196428',2018-03-22,FDRL/REAL TIME GROSS SETTL,2000000.0,0.0,,2018,3,22,PAYEMENT,2000000.0,M377529497
18123,1196428',2018-03-22,FDRL/REAL TIME GROSS SETTL,2000000.0,0.0,,2018,3,22,CASH_OUT,2000000.0,M1360209760
18124,1196428',2018-03-22,FDRL/REAL TIME GROSS SETTL,3000000.0,0.0,,2018,3,22,CHECK_WITHDRAWAL,3000000.0,M1336788066
18125,1196428',2018-03-22,NEFT/N081180501212438/PAY,0.0,509883.4,,2018,3,22,TRANSFER,509883.4,M1287115371
18126,1196428',2018-03-22,NEFT/N081180501218874/PAY,0.0,1004081.69,,2018,3,22,CHECK_CASHING,1004081.69,M1639324923
18127,1196428',2018-03-22,TRF FROM  Indiaforensic ONLINE S,0.0,58551.0,,2018,3,22,TRANSFER,58551.0,M694186625
18128,1196428',2018-03-22,Indiaforensic SERVICES INDIA PVT,0.0,392851.0,,2018,3,22,CHECK_CASHING,392851.0,M1912710034
18129,1196428',2018-03-22,NEFT/SBIN418081817630/BIN,0.0,37494.1,,2018,3,22,CASH_IN,37494.1,M901536036
18130,1196428',2018-03-22,TRF FROM  Indiaforensic SERVICES,0.0,3300000.0,,2018,3,22,CHECK_CASHING,3300000.0,M1625505749
18131,1196428',2018-03-22,NEFT/AXISP18081092595/ACC,0.0,2000000.0,,2018,3,22,CHECK_CASHING,2000000.0,M1040924126
18132,1196428',2018-03-22,FDRL/INTERNAL FUND TRANSFE,500000.0,0.0,,2018,3,22,CASH_OUT,500000.0,M1349358282
18133,1196428',2018-03-22,FDRL/INTERNAL FUND TRANSFE,500000.0,0.0,,2018,3,22,CHECK_WITHDRAWAL,500000.0,M394526334
18134,1196428',2018-03-22,FDRL/INTERNAL FUND TRANSFE,5000000.0,0.0,,2018,3,22,DEBIT,5000000.0,C2121674731
18135,1196428',2018-03-22,FDRL/INTERNAL FUND TRANSFE,200000.0,0.0,,2018,3,22,CASH_OUT,200000.0,M880644527
18136,1196428',2018-03-22,BEAT CSH PKP DEL GURG 617,0.0,114000.0,,2018,3,22,CHECK_CASHING,114000.0,C1749186397
18137,1196428',2018-03-23,CASHDEP/NOIDA/TP,0.0,63000.0,,2018,3,23,TRANSFER,63000.0,C1467740330
18138,1196428',2018-03-23,FDRL/NATIONAL ELECTRONIC F,23400.0,0.0,,2018,3,23,DEBIT,23400.0,C85074823
18139,1196428',2018-03-23,FDRL/NATIONAL ELECTRONIC F,102751.0,0.0,,2018,3,23,CHECK_WITHDRAWAL,102751.0,C2110180989
18140,1196428',2018-03-23,FDRL/NATIONAL ELECTRONIC F,180609.0,0.0,,2018,3,23,PAYEMENT,180609.0,M1290283032
18141,1196428',2018-03-23,FDRL/NATIONAL ELECTRONIC F,61171.0,0.0,,2018,3,23,CHECK_WITHDRAWAL,61171.0,C69736093
18142,1196428',2018-03-23,FDRL/NATIONAL ELECTRONIC F,50410.0,0.0,,2018,3,23,PAYEMENT,50410.0,M1281501991
18143,1196428',2018-03-23,RTGS/HDFCH18082718540/PAY,0.0,1520000.0,,2018,3,23,TRANSFER,1520000.0,C1371191175
18144,1196428',2018-03-23,RTGS/HDFCH18082730182/PAY,0.0,4160000.0,,2018,3,23,CASH_IN,4160000.0,M306096217
18145,1196428',2018-03-23,FDRL/REAL TIME GROSS SETTL,2000000.0,0.0,,2018,3,23,PAYEMENT,2000000.0,M905405472
18146,1196428',2018-03-23,FDRL/REAL TIME GROSS SETTL,2000000.0,0.0,,2018,3,23,PAYEMENT,2000000.0,C251966229
18147,1196428',2018-03-23,FDRL/REAL TIME GROSS SETTL,3000000.0,0.0,,2018,3,23,PAYEMENT,3000000.0,C1811787479
18148,1196428',2018-03-23,RTGS/CORPH18082599832/Indfor,0.0,2200000.0,,2018,3,23,TRANSFER,2200000.0,M1903597138
18149,1196428',2018-03-23,RTGS/CSBKH18082000327/Indfor,0.0,1000000.0,,2018,3,23,TRANSFER,1000000.0,M1310772456
18150,1196428',2018-03-23,IB:TPFT0677370151 3090040,0.0,25000.0,,2018,3,23,TRANSFER,25000.0,C1958390694
18151,1196428',2018-03-23,FDRL/REAL TIME GROSS SETTL,3000000.0,0.0,,2018,3,23,DEBIT,3000000.0,C704024200
18152,1196428',2018-03-23,NEFT/P18032394797450/KADU,0.0,100000.0,,2018,3,23,CHECK_CASHING,100000.0,C1575675375
18153,1196428',2018-03-23,NEFT/AXISP18082065206/ACC,0.0,13000000.0,,2018,3,23,CASH_IN,13000000.0,M1681736858
18154,1196428',2018-03-23,FDRL/REAL TIME GROSS SETTL,10000000.0,0.0,,2018,3,23,PAYEMENT,10000000.0,M1473800257
18155,1196428',2018-03-23,FDRL/REAL TIME GROSS SETTL,2000000.0,0.0,,2018,3,23,PAYEMENT,2000000.0,M798813864
18156,1196428',2018-03-23,RTGS/ICICH18082444217/ART,0.0,4000000.0,,2018,3,23,CHECK_CASHING,4000000.0,C122086708
18157,1196428',2018-03-23,CASHDEP/NOIDA/,0.0,70000.0,,2018,3,23,CHECK_CASHING,70000.0,M1001363246
18158,1196428',2018-03-23,NEFT/N082180502071549/PAY,0.0,3150000.0,,2018,3,23,CASH_IN,3150000.0,C2127862399
18159,1196428',2018-03-23,NEFT/N082180502068497/PAY,0.0,438575.8,,2018,3,23,CHECK_CASHING,438575.8,M283593725
18160,1196428',2018-03-23,NEFT/N082180502059890/PAY,0.0,1070503.88,,2018,3,23,CHECK_CASHING,1070503.88,C1065774928
18161,1196428',2018-03-23,TRF FROM  Indiaforensic SERVICES,0.0,5800000.0,,2018,3,23,TRANSFER,5800000.0,C1426317832
18162,1196428',2018-03-23,Indiaforensic SERVICES INDIA PVT,0.0,211019.0,,2018,3,23,TRANSFER,211019.0,C1200612373
18163,1196428',2018-03-23,NEFT/N082180502239185/BAT,0.0,25000.0,,2018,3,23,TRANSFER,25000.0,C495071437
18164,1196428',2018-03-23,NEFT CHARGES AND GST/0000,29.5,0.0,,2018,3,23,CHECK_WITHDRAWAL,29.5,C1777285191
18165,1196428',2018-03-23,NEFT/000034132225/GALENA,4000000.0,0.0,,2018,3,23,CASH_OUT,4000000.0,C779119558
18166,1196428',2018-03-23,NEFT/IDFBH18082706844/FUN,0.0,19600.0,,2018,3,23,CHECK_CASHING,19600.0,M1619952918
18167,1196428',2018-03-23,TRF FROM  Indiaforensic SERVICES,0.0,4000000.0,,2018,3,23,TRANSFER,4000000.0,C1336996537
18168,1196428',2018-03-23,BEAT CSH PKP DEL GURG6179,0.0,119500.0,,2018,3,23,TRANSFER,119500.0,M31430091
18169,1196428',2018-03-23,FDRL/INTERNAL FUND TRANSFE,500000.0,0.0,,2018,3,23,CHECK_WITHDRAWAL,500000.0,M1843937496
18170,1196428',2018-03-23,FDRL/INTERNAL FUND TRANSFE,200000.0,0.0,,2018,3,23,DEBIT,200000.0,M666450201
18171,1196428',2018-03-23,FDRL/INTERNAL FUND TRANSFE,5000000.0,0.0,,2018,3,23,CHECK_WITHDRAWAL,5000000.0,M1977486760
18172,1196428',2018-03-23,FDRL/INTERNAL FUND TRANSFE,10000000.0,0.0,,2018,3,23,DEBIT,10000000.0,M1836094089
18173,1196428',2018-03-23,FDRL/INTERNAL FUND TRANSFE,1000000.0,0.0,,2018,3,23,CASH_OUT,1000000.0,C1081599606
18174,1196428',2018-03-26,NEFT/BARBU18085048622/MAK,0.0,65500.0,,2018,3,26,CASH_IN,65500.0,C1429623854
18175,1196428',2018-03-26,RTGS/SBINH18085016406/Indfor,0.0,400000.0,,2018,3,26,TRANSFER,400000.0,M1530162893
18176,1196428',2018-03-26,FDRL/NATIONAL ELECTRONIC F,30002.0,0.0,,2018,3,26,PAYEMENT,30002.0,C1369695156
18177,1196428',2018-03-26,FDRL/NATIONAL ELECTRONIC F,96908.0,0.0,,2018,3,26,PAYEMENT,96908.0,C891020651
18178,1196428',2018-03-26,FDRL/NATIONAL ELECTRONIC F,54192.0,0.0,,2018,3,26,DEBIT,54192.0,C1219273867
18179,1196428',2018-03-26,NEFT/N085180502708266/TEC,0.0,200000.0,,2018,3,26,TRANSFER,200000.0,C365212068
18180,1196428',2018-03-26,RTGS/HDFCH18085985545/PAY,0.0,2800000.0,,2018,3,26,CASH_IN,2800000.0,C423580937
18181,1196428',2018-03-26,RTGS/HDFCH18085983189/PAY,0.0,7020000.0,,2018,3,26,TRANSFER,7020000.0,C675203915
18182,1196428',2018-03-26,FDRL/REAL TIME GROSS SETTL,3000000.0,0.0,,2018,3,26,DEBIT,3000000.0,C1728766751
18183,1196428',2018-03-26,FDRL/REAL TIME GROSS SETTL,3000000.0,0.0,,2018,3,26,CASH_OUT,3000000.0,C1104197405
18184,1196428',2018-03-26,FDRL/REAL TIME GROSS SETTL,3000000.0,0.0,,2018,3,26,DEBIT,3000000.0,C728526866
18185,1196428',2018-03-26,FDRL/INTERNAL FUND TRANSFE,1000000.0,0.0,,2018,3,26,DEBIT,1000000.0,C1532153384
18186,1196428',2018-03-26,NEFT/SBIN718085691447/SAM,0.0,11800.0,,2018,3,26,CHECK_CASHING,11800.0,C66893623
18187,1196428',2018-03-26,CASHDEP/HAUS KHAS/ZAHIR,0.0,55000.0,,2018,3,26,CASH_IN,55000.0,C2096057945
18188,1196428',2018-03-26,NEFT/IT36701803263583/FIX,0.0,180000.0,,2018,3,26,TRANSFER,180000.0,C968448640
18189,1196428',2018-03-26,RTGS/PUNBH18085891560/SAN,0.0,250000.0,,2018,3,26,TRANSFER,250000.0,C1039162432
18190,1196428',2018-03-26,TRF FROM  Indiaforensic SERVICES,0.0,10000000.0,,2018,3,26,CASH_IN,10000000.0,C1672788422
18191,1196428',2018-03-26,"Indiaforensic USA, INC./USD/2095",0.0,1354370.58,,2018,3,26,CHECK_CASHING,1354370.58,C1938348365
18192,1196428',2018-03-26,IRTT00701809183,1348.79,0.0,,2018,3,26,DEBIT,1348.79,C1664330755
18193,1196428',2018-03-26,FDRL/INTERNAL FUND TRANSFE,1000000.0,0.0,,2018,3,26,CHECK_WITHDRAWAL,1000000.0,C836514715
18194,1196428',2018-03-26,NEFT/N085180503204323/PAY,0.0,498866.24,,2018,3,26,CHECK_CASHING,498866.24,C1276319779
18195,1196428',2018-03-26,NEFT/N085180503207153/PAY,0.0,1649735.23,,2018,3,26,CHECK_CASHING,1649735.23,M1506176709
18196,1196428',2018-03-26,IMPS 808517814873 FROM 34,0.0,1000.0,,2018,3,26,CHECK_CASHING,1000.0,M1469731192
18197,1196428',2018-03-26,YOURSELF FOR BULK NEFT  B,7224785.0,0.0,,2018,3,26,PAYEMENT,7224785.0,M1969348579
18198,1196428',2018-03-26,TRF FROM  Indiaforensic SERVICES,0.0,13800000.0,,2018,3,26,CASH_IN,13800000.0,M1558237610
18199,1196428',2018-03-26,TRF FROM  Indiaforensic SERVICES,0.0,10800000.0,,2018,3,26,CHECK_CASHING,10800000.0,C2086425573
18200,1196428',2018-03-26,TRF FROM  Indiaforensic SERVICES,0.0,15000000.0,,2018,3,26,CASH_IN,15000000.0,M451962020
18201,1196428',2018-03-26,TRF FROM  Indiaforensic SERVICES,0.0,15000000.0,,2018,3,26,CASH_IN,15000000.0,M400575685
18202,1196428',2018-03-26,TRF FROM  Indiaforensic ONLINE S,0.0,14800.0,,2018,3,26,TRANSFER,14800.0,M141301294
18203,1196428',2018-03-26,BEAT CSH PKP DEL GURG 617,0.0,283000.0,,2018,3,26,CASH_IN,283000.0,M1637507521
18204,1196428',2018-03-26,FDRL/INTERNAL FUND TRANSFE,10000000.0,0.0,,2018,3,26,PAYEMENT,10000000.0,C1315234892
18205,1196428',2018-03-26,FDRL/INTERNAL FUND TRANSFE,10000000.0,0.0,,2018,3,26,CASH_OUT,10000000.0,C2070626006
18206,1196428',2018-03-26,FDRL/INTERNAL FUND TRANSFE,3000000.0,0.0,,2018,3,26,CHECK_WITHDRAWAL,3000000.0,C373928166
18207,1196428',2018-03-26,FDRL/INTERNAL FUND TRANSFE,0.0,3000000.0,,2018,3,26,CHECK_CASHING,3000000.0,C1023714065
18208,1196428',2018-03-27,FDRL/REAL TIME GROSS SETTL,15000000.0,0.0,,2018,3,27,DEBIT,15000000.0,C1870367457
18209,1196428',2018-03-27,NEFT/SBIN818085542694/MAA,0.0,11800.0,,2018,3,27,CHECK_CASHING,11800.0,C1825634724
18210,1196428',2018-03-27,CASHDEP/NOIDA/TP,0.0,62000.0,,2018,3,27,CHECK_CASHING,62000.0,C643996026
18211,1196428',2018-03-27,FDRL/NATIONAL ELECTRONIC F,6200.0,0.0,,2018,3,27,PAYEMENT,6200.0,C33574809
18212,1196428',2018-03-27,FDRL/NATIONAL ELECTRONIC F,6000.0,0.0,,2018,3,27,CHECK_WITHDRAWAL,6000.0,C691636444
18213,1196428',2018-03-27,FDRL/NATIONAL ELECTRONIC F,6000.0,0.0,,2018,3,27,PAYEMENT,6000.0,C1818730877
18214,1196428',2018-03-27,FDRL/REAL TIME GROSS SETTL,3000000.0,0.0,,2018,3,27,DEBIT,3000000.0,C1073259437
18215,1196428',2018-03-27,RTGS/HDFCH18086212749/PAY,0.0,4960000.0,,2018,3,27,TRANSFER,4960000.0,C1448348248
18216,1196428',2018-03-27,RTGS/HDFCH18086212747/PAY,0.0,2400000.0,,2018,3,27,CHECK_CASHING,2400000.0,C395114097
18217,1196428',2018-03-27,FDRL/REAL TIME GROSS SETTL,15000000.0,0.0,,2018,3,27,CASH_OUT,15000000.0,C1036454560
18218,1196428',2018-03-27,FDRL/REAL TIME GROSS SETTL,15000000.0,0.0,,2018,3,27,PAYEMENT,15000000.0,C75457651
18219,1196428',2018-03-27,Indiaforensic SERVICES INDIA PVT,0.0,441721.0,,2018,3,27,TRANSFER,441721.0,C1883840933
18220,1196428',2018-03-27,FDRL/INTERNAL FUND TRANSFE,0.0,3000000.0,,2018,3,27,CASH_IN,3000000.0,C2078250226
18221,1196428',2018-03-27,FDRL/INTERNAL FUND TRANSFE,0.0,3000000.0,,2018,3,27,TRANSFER,3000000.0,C963383848
18222,1196428',2018-03-27,FDRL/INTERNAL FUND TRANSFE,0.0,3000000.0,,2018,3,27,CASH_IN,3000000.0,C42158278
18223,1196428',2018-03-27,FDRL/INTERNAL FUND TRANSFE,1000000.0,0.0,,2018,3,27,CHECK_WITHDRAWAL,1000000.0,C1825775199
18224,1196428',2018-03-27,FDRL/INTERNAL FUND TRANSFE,0.0,3000000.0,,2018,3,27,CASH_IN,3000000.0,C1234059684
18225,1196428',2018-03-27,FDRL/INTERNAL FUND TRANSFE,0.0,2000000.0,,2018,3,27,CASH_IN,2000000.0,C1689374891
18226,1196428',2018-03-27,FDRL/INTERNAL FUND TRANSFE,0.0,3000000.0,,2018,3,27,TRANSFER,3000000.0,C408304912
18227,1196428',2018-03-27,FDRL/INTERNAL FUND TRANSFE,0.0,3000000.0,,2018,3,27,CASH_IN,3000000.0,C1664330755
18228,1196428',2018-03-27,FDRL/INTERNAL FUND TRANSFE,0.0,3000000.0,,2018,3,27,TRANSFER,3000000.0,C2043257128
18229,1196428',2018-03-27,FDRL/INTERNAL FUND TRANSFE,0.0,3000000.0,,2018,3,27,TRANSFER,3000000.0,C1440325059
18230,1196428',2018-03-27,FDRL/INTERNAL FUND TRANSFE,0.0,2000000.0,,2018,3,27,TRANSFER,2000000.0,C1009195400
18231,1196428',2018-03-27,FDRL/INTERNAL FUND TRANSFE,0.0,3000000.0,,2018,3,27,TRANSFER,3000000.0,C549277650
18232,1196428',2018-03-27,FDRL/INTERNAL FUND TRANSFE,0.0,3000000.0,,2018,3,27,CHECK_CASHING,3000000.0,C1495761010
18233,1196428',2018-03-27,FDRL/INTERNAL FUND TRANSFE,0.0,3000000.0,,2018,3,27,CASH_IN,3000000.0,C1456465598
18234,1196428',2018-03-27,FDRL/INTERNAL FUND TRANSFE,0.0,3000000.0,,2018,3,27,TRANSFER,3000000.0,C1262822392
18235,1196428',2018-03-27,FDRL/REAL TIME GROSS SETTL,15000000.0,0.0,,2018,3,27,CASH_OUT,15000000.0,C1790202239
18236,1196428',2018-03-27,FDRL/REAL TIME GROSS SETTL,15000000.0,0.0,,2018,3,27,CHECK_WITHDRAWAL,15000000.0,C455218098
18237,1196428',2018-03-27,TRF FROM  Indiaforensic SERVICES,0.0,15000000.0,,2018,3,27,CHECK_CASHING,15000000.0,C720759478
18238,1196428',2018-03-27,TRF FROM  Indiaforensic SERVICES,0.0,7000000.0,,2018,3,27,CHECK_CASHING,7000000.0,C1034584766
18239,1196428',2018-03-27,YOURSELF FOR BULK NEFT  B,8554590.0,0.0,,2018,3,27,CHECK_WITHDRAWAL,8554590.0,C766681183
18240,1196428',2018-03-27,NEFT/N086180504193204/PAY,0.0,1310961.55,,2018,3,27,CASH_IN,1310961.55,C1052170153
18241,1196428',2018-03-27,NEFT/N086180504189982/PAY,0.0,1076666.28,,2018,3,27,TRANSFER,1076666.28,C1674899618
18242,1196428',2018-03-27,NEFT/20476187251DC/ARTHAS,0.0,300000.0,,2018,3,27,TRANSFER,300000.0,C455226533
18243,1196428',2018-03-27,Indiaforensic SERVICES INDIA PVT,0.0,186746.0,,2018,3,27,CHECK_CASHING,186746.0,C1203094087
18244,1196428',2018-03-27,FDRL/INTERNAL FUND TRANSFE,1000000.0,0.0,,2018,3,27,PAYEMENT,1000000.0,C957917689
18245,1196428',2018-03-27,FDRL/INTERNAL FUND TRANSFE,1000000.0,0.0,,2018,3,27,PAYEMENT,1000000.0,C2071512077
18246,1196428',2018-03-27,TRF FROM  Indiaforensic SERVICES,0.0,3100000.0,,2018,3,27,CASH_IN,3100000.0,C777790557
18247,1196428',2018-03-27,FDRL/INTERNAL FUND TRANSFE,10000000.0,0.0,,2018,3,27,PAYEMENT,10000000.0,C399070738
18248,1196428',2018-03-27,FDRL/INTERNAL FUND TRANSFE,10000000.0,0.0,,2018,3,27,DEBIT,10000000.0,C1218365329
18249,1196428',2018-03-27,FDRL/INTERNAL FUND TRANSFE,200000.0,0.0,,2018,3,27,PAYEMENT,200000.0,C843467284
18250,1196428',2018-03-27,BEAT CSH PKP DEL GURG 617,0.0,150000.0,,2018,3,27,TRANSFER,150000.0,C2030151083
18251,1196428',2018-03-28,IMPS 808710554645 FROM PO,0.0,40000.0,,2018,3,28,TRANSFER,40000.0,C1026066400
18252,1196428',2018-03-28,RTGS/HDFCH18087480323/PAY,0.0,1920000.0,,2018,3,28,CHECK_CASHING,1920000.0,C1651945012
18253,1196428',2018-03-28,RTGS/HDFCH18087480341/PAY,0.0,4480000.0,,2018,3,28,TRANSFER,4480000.0,C118648358
18254,1196428',2018-03-28,FDRL/REAL TIME GROSS SETTL,3000000.0,0.0,,2018,3,28,CASH_OUT,3000000.0,C542766981
18255,1196428',2018-03-28,FDRL/REAL TIME GROSS SETTL,3000000.0,0.0,,2018,3,28,PAYEMENT,3000000.0,C191614132
18256,1196428',2018-03-28,FDRL/REAL TIME GROSS SETTL,3000000.0,0.0,,2018,3,28,PAYEMENT,3000000.0,C57497207
18257,1196428',2018-03-28,FDRL/REAL TIME GROSS SETTL,3000000.0,0.0,,2018,3,28,CASH_OUT,3000000.0,C1477979030
18258,1196428',2018-03-28,CASHDEP/NOIDA/TP,0.0,84000.0,,2018,3,28,CHECK_CASHING,84000.0,C1938348365
18259,1196428',2018-03-28,NEFT/CBINH18087112154/JAM,0.0,50000.0,,2018,3,28,TRANSFER,50000.0,C669419693
18260,1196428',2018-03-28,RTGS/YESBH18087960638/IND,296116.0,0.0,,2018,3,28,PAYEMENT,296116.0,C1833549064
18261,1196428',2018-03-28,INTEX TECHNOLOGIES INDIA,1000000.0,0.0,,2018,3,28,DEBIT,1000000.0,C2115055717
18262,1196428',2018-03-28,FDRL/INTERNAL FUND TRANSFE,500000.0,0.0,,2018,3,28,CASH_OUT,500000.0,C1286885448
18263,1196428',2018-03-28,NEFT/FDRLH18087705924/SRE,0.0,11800.0,,2018,3,28,TRANSFER,11800.0,C435161028
18264,1196428',2018-03-28,NEFT/20477747311DC/SARVAT,0.0,200000.0,,2018,3,28,CASH_IN,200000.0,C1883788127
18265,1196428',2018-03-28,TRF FROM  Indiaforensic SERVICES,0.0,15000000.0,,2018,3,28,CHECK_CASHING,15000000.0,C619068319
18266,1196428',2018-03-28,FDRL/REAL TIME GROSS SETTL,15000000.0,0.0,,2018,3,28,CHECK_WITHDRAWAL,15000000.0,C1978557426
18267,1196428',2018-03-28,TRF FROM  Indiaforensic SERVICES,0.0,7500000.0,,2018,3,28,CHECK_CASHING,7500000.0,C1894575391
18268,1196428',2018-03-28,FDRL/INTERNAL FUND TRANSFE,1000000.0,0.0,,2018,3,28,PAYEMENT,1000000.0,C74288440
18269,1196428',2018-03-28,NEFT/N087180505459770/PAY,0.0,445015.88,,2018,3,28,CASH_IN,445015.88,C473344802
18270,1196428',2018-03-28,NEFT/N087180505453935/PAY,0.0,1168078.22,,2018,3,28,CHECK_CASHING,1168078.22,C1648214200
18271,1196428',2018-03-28,Indiaforensic SERVICES INDIA PVT,0.0,222628.0,,2018,3,28,TRANSFER,222628.0,C1934634055
18272,1196428',2018-03-28,NEFT/AXISP18087605974/ACC,0.0,13000000.0,,2018,3,28,CASH_IN,13000000.0,C54142591
18273,1196428',2018-03-28,TRF FROM  Indiaforensic SERVICES,0.0,1800000.0,,2018,3,28,TRANSFER,1800000.0,M1428821144
18274,1196428',2018-03-28,NEFT/N087180505583008/PAY,0.0,4000000.0,,2018,3,28,CHECK_CASHING,4000000.0,C1014154376
18275,1196428',2018-03-28,NEFT/N087180505794332/TEC,0.0,400000.0,,2018,3,28,TRANSFER,400000.0,M670855394
18276,1196428',2018-03-28,"Indiaforensic USA, INC./USD/2646",0.0,1710826.88,,2018,3,28,CASH_IN,1710826.88,C2061973160
18277,1196428',2018-03-28,IRTT00701809461,1412.95,0.0,,2018,3,28,CHECK_WITHDRAWAL,1412.95,M1498309822
18278,1196428',2018-03-28,NEFT/SBIN218087108269/MAH,0.0,11800.0,,2018,3,28,CHECK_CASHING,11800.0,M107988060
18279,1196428',2018-03-28,FDRL/INTERNAL FUND TRANSFE,15000000.0,0.0,,2018,3,28,CHECK_WITHDRAWAL,15000000.0,C28125426
18280,1196428',2018-03-28,FDRL/INTERNAL FUND TRANSFE,2000000.0,0.0,,2018,3,28,PAYEMENT,2000000.0,C1261940766
18281,1196428',2018-03-28,FDRL/INTERNAL FUND TRANSFE,1000000.0,0.0,,2018,3,28,CHECK_WITHDRAWAL,1000000.0,C1962165946
18282,1196428',2018-03-28,BEAT CSH PKP DEL GURG 617,0.0,171500.0,,2018,3,28,CASH_IN,171500.0,M1907149505
18283,1196428',2018-03-29,FDRL/NATIONAL ELECTRONIC F,163198.0,0.0,,2018,3,29,PAYEMENT,163198.0,C1271057169
18284,1196428',2018-03-29,FDRL/REAL TIME GROSS SETTL,10000000.0,0.0,,2018,3,29,CASH_OUT,10000000.0,M2100909601
18285,1196428',2018-03-29,NEFT/IOBAN18088686364/M/S,0.0,100000.0,,2018,3,29,CHECK_CASHING,100000.0,M2142744798
18286,1196428',2018-03-29,RTGS/HDFCH18088850102/GIL,0.0,202000.0,,2018,3,29,CHECK_CASHING,202000.0,C486750945
18287,1196428',2018-03-29,NEFT/SBIN318088322429/JAG,0.0,11800.1,,2018,3,29,CHECK_CASHING,11800.1,M251270712
18288,1196428',2018-03-29,NEFT/CBINH18088131635/M s,0.0,11800.0,,2018,3,29,CASH_IN,11800.0,C836514715
18289,1196428',2018-03-29,FDRL/INTERNAL FUND TRANSFE,300000.0,0.0,,2018,3,29,CASH_OUT,300000.0,C1885738296
18290,1196428',2018-03-29,FDRL/INTERNAL FUND TRANSFE,200000.0,0.0,,2018,3,29,CASH_OUT,200000.0,C361268035
18291,1196428',2018-03-29,FDRL/INTERNAL FUND TRANSFE,1000000.0,0.0,,2018,3,29,DEBIT,1000000.0,M1544876608
18292,1196428',2018-03-30,FUND TRF FROM  Indiaforensic SER,0.0,5000000.0,,2018,3,30,CASH_IN,5000000.0,M100483625
18293,1196428',2018-03-30,FUND TRF FROM  Indiaforensic SER,0.0,1000000.0,,2018,3,30,CASH_IN,1000000.0,M1859526558
18294,1196428',2018-03-30,FUND TRF TO  Indiaforensic SERVI,1000000.0,0.0,,2018,3,30,CASH_OUT,1000000.0,C620638596
18295,1196428',2018-03-31,FDRL/INTERNAL FUND TRANSFE,200000.0,0.0,,2018,3,31,CASH_OUT,200000.0,M443668686
18296,1196428',2018-03-31,RTGS/HDFCH18090916130/PAY,0.0,2320000.0,,2018,3,31,CASH_IN,2320000.0,C1062791125
18297,1196428',2018-03-31,RTGS/HDFCH18090916159/PAY,0.0,10260000.0,,2018,3,31,TRANSFER,10260000.0,M880552474
18298,1196428',2018-03-31,FDRL/NATIONAL ELECTRONIC F,117717.0,0.0,,2018,3,31,CHECK_WITHDRAWAL,117717.0,C1935293965
18299,1196428',2018-03-31,FDRL/INTERNAL FUND TRANSFE,2500000.0,0.0,,2018,3,31,DEBIT,2500000.0,C33837320
18300,1196428',2018-03-31,FDRL/INTERNAL FUND TRANSFE,2500000.0,0.0,,2018,3,31,CASH_OUT,2500000.0,C1197606915
18301,1196428',2018-03-31,FDRL/INTERNAL FUND TRANSFE,0.0,3000000.0,,2018,3,31,CHECK_CASHING,3000000.0,C1161865950
18302,1196428',2018-03-31,FDRL/REAL TIME GROSS SETTL,3000000.0,0.0,,2018,3,31,CASH_OUT,3000000.0,C1546629479
18303,1196428',2018-03-31,FDRL/REAL TIME GROSS SETTL,3000000.0,0.0,,2018,3,31,CHECK_WITHDRAWAL,3000000.0,C660101474
18304,1196428',2018-03-31,FDRL/REAL TIME GROSS SETTL,3000000.0,0.0,,2018,3,31,DEBIT,3000000.0,C1494895909
18305,1196428',2018-03-31,FDRL/REAL TIME GROSS SETTL,3000000.0,0.0,,2018,3,31,DEBIT,3000000.0,C1949945675
18306,1196428',2018-03-31,FDRL/REAL TIME GROSS SETTL,3000000.0,0.0,,2018,3,31,DEBIT,3000000.0,C2112826959
18307,1196428',2018-03-31,NEFT/BARBX18090002713/MAK,0.0,60550.0,,2018,3,31,CASH_IN,60550.0,C422990138
18308,1196428',2018-03-31,FDRL/INTERNAL FUND TRANSFE,500000.0,0.0,,2018,3,31,CASH_OUT,500000.0,C679235222
18309,1196428',2018-03-31,TRF FRO Indiaforensic SERVICES I,0.0,15000000.0,,2018,3,31,TRANSFER,15000000.0,C580441921
18310,1196428',2018-03-31,TRF FRO Indiaforensic SERVICES I,0.0,15000000.0,,2018,3,31,CASH_IN,15000000.0,C716083600
18311,1196428',2018-03-31,TRF FRO Indiaforensic SERVICES I,0.0,10000000.0,,2018,3,31,TRANSFER,10000000.0,C1665979484
18312,1196428',2018-03-31,FDRL/NATIONAL ELECTRONIC F,2000.0,0.0,,2018,3,31,PAYEMENT,2000.0,C1824348154
18313,1196428',2018-03-31,FDRL/NATIONAL ELECTRONIC F,2000.0,0.0,,2018,3,31,CHECK_WITHDRAWAL,2000.0,C1167066016
18314,1196428',2018-03-31,FDRL/NATIONAL ELECTRONIC F,19585.0,0.0,,2018,3,31,CHECK_WITHDRAWAL,19585.0,C1010306008
18315,1196428',2018-03-31,FDRL/NATIONAL ELECTRONIC F,2500.0,0.0,,2018,3,31,CHECK_WITHDRAWAL,2500.0,C1081599606
18316,1196428',2018-03-31,FDRL/NATIONAL ELECTRONIC F,2500.0,0.0,,2018,3,31,CHECK_WITHDRAWAL,2500.0,C1016893923
18317,1196428',2018-03-31,FDRL/NATIONAL ELECTRONIC F,2500.0,0.0,,2018,3,31,CHECK_WITHDRAWAL,2500.0,M1839053453
18318,1196428',2018-03-31,FDRL/NATIONAL ELECTRONIC F,3000.0,0.0,,2018,3,31,CASH_OUT,3000.0,C1877059833
18319,1196428',2018-03-31,FDRL/NATIONAL ELECTRONIC F,2500.0,0.0,,2018,3,31,PAYEMENT,2500.0,C2078745453
18320,1196428',2018-03-31,FDRL/NATIONAL ELECTRONIC F,2000.0,0.0,,2018,3,31,PAYEMENT,2000.0,M1349239380
18321,1196428',2018-03-31,FDRL/NATIONAL ELECTRONIC F,2500.0,0.0,,2018,3,31,PAYEMENT,2500.0,C665639335
18322,1196428',2018-03-31,FDRL/NATIONAL ELECTRONIC F,5000.0,0.0,,2018,3,31,PAYEMENT,5000.0,M684094469
18323,1196428',2018-03-31,FDRL/NATIONAL ELECTRONIC F,2500.0,0.0,,2018,3,31,CHECK_WITHDRAWAL,2500.0,C571113365
18324,1196428',2018-03-31,FDRL/NATIONAL ELECTRONIC F,3000.0,0.0,,2018,3,31,PAYEMENT,3000.0,C1871196571
18325,1196428',2018-03-31,TRF FROM  Indiaforensic SERVICES,0.0,2800000.0,,2018,3,31,CHECK_CASHING,2800000.0,M1182165783
18326,1196428',2018-03-31,NEFT/KKBKH18090443904/DEL,0.0,293629.36,,2018,3,31,TRANSFER,293629.36,C1856036778
18327,1196428',2018-03-31,FDRL/REAL TIME GROSS SETTL,5000000.0,0.0,,2018,3,31,DEBIT,5000000.0,C1039162432
18328,1196428',2018-03-31,FDRL/REAL TIME GROSS SETTL,5000000.0,0.0,,2018,3,31,DEBIT,5000000.0,C1698593276
18329,1196428',2018-03-31,FDRL/REAL TIME GROSS SETTL,5000000.0,0.0,,2018,3,31,DEBIT,5000000.0,C1247600089
18330,1196428',2018-03-31,FDRL/REAL TIME GROSS SETTL,5000000.0,0.0,,2018,3,31,CHECK_WITHDRAWAL,5000000.0,M1856923485
18331,1196428',2018-03-31,FDRL/NATIONAL ELECTRONIC F,14600.0,0.0,,2018,3,31,CASH_OUT,14600.0,M1145240172
18332,1196428',2018-03-31,Indiaforensic SERVICES INDIA PVT,0.0,654973.0,,2018,3,31,CASH_IN,654973.0,M1540763549
18333,1196428',2018-03-31,FDRL/NATIONAL ELECTRONIC F,5000000.0,0.0,,2018,3,31,PAYEMENT,5000000.0,M1519004034
18334,1196428',2018-03-31,FDRL/NATIONAL ELECTRONIC F,5000000.0,0.0,,2018,3,31,DEBIT,5000000.0,C1396755641
18335,1196428',2018-03-31,FDRL/NATIONAL ELECTRONIC F,5000000.0,0.0,,2018,3,31,CHECK_WITHDRAWAL,5000000.0,M1196715231
18336,1196428',2018-03-31,FDRL/NATIONAL ELECTRONIC F,5000000.0,0.0,,2018,3,31,PAYEMENT,5000000.0,C499052031
18337,1196428',2018-03-31,TRF FROM  Indiaforensic SERVICES,0.0,2000000.0,,2018,3,31,CHECK_CASHING,2000000.0,M624947178
18338,1196428',2018-03-31,NEFT/N090180508883411/PAY,0.0,596907.12,,2018,3,31,TRANSFER,596907.12,C1028574311
18339,1196428',2018-03-31,TRF FROM  Indiaforensic SERVICES,0.0,2000000.0,,2018,3,31,CASH_IN,2000000.0,C370428315
18340,1196428',2018-03-31,FDRL/INTERNAL FUND TRANSFE,5000000.0,0.0,,2018,3,31,CHECK_WITHDRAWAL,5000000.0,C569022831
18341,1196428',2018-03-31,FDRL/INTERNAL FUND TRANSFE,3000000.0,0.0,,2018,3,31,CASH_OUT,3000000.0,C236282128
18342,1196428',2018-03-31,NEFT/N090180508891628/PAY,0.0,2904310.01,,2018,3,31,CASH_IN,2904310.01,C90486891
18343,1196428',2018-03-31,FDRL/INTERNAL FUND TRANSFE,3000000.0,0.0,,2018,3,31,CASH_OUT,3000000.0,M1116249422
18344,1196428',2018-03-31,TRF FROM  Indiaforensic SERVICES,0.0,1000000.0,,2018,3,31,TRANSFER,1000000.0,M448528645
18345,1196428',2018-03-31,FDRL/INTERNAL FUND TRANSFE,1000000.0,0.0,,2018,3,31,DEBIT,1000000.0,M652296712
18346,1196428',2018-03-31,NEFT/N090180508963245/PAY,0.0,3000000.0,,2018,3,31,TRANSFER,3000000.0,M2060417999
18347,1196428',2018-03-31,BEAT CSH PKP DEL GURG 617,0.0,536000.0,,2018,3,31,CASH_IN,536000.0,M1490309303
18348,1196428',2018-03-31,1196428:Int.Coll:01-03-20,805321.0,0.0,,2018,3,31,PAYEMENT,805321.0,M1459456769
18349,1196428',2018-04-03,FDRL/INTERNAL FUND TRANSFE,2000000.0,0.0,,2018,4,3,CHECK_WITHDRAWAL,2000000.0,C506903242
18350,1196428',2018-04-03,FDRL/NATIONAL ELECTRONIC F,100518.0,0.0,,2018,4,3,CASH_OUT,100518.0,M2072059657
18351,1196428',2018-04-03,FDRL/NATIONAL ELECTRONIC F,252565.0,0.0,,2018,4,3,PAYEMENT,252565.0,C304406966
18352,1196428',2018-04-03,FDRL/NATIONAL ELECTRONIC F,50020.0,0.0,,2018,4,3,PAYEMENT,50020.0,C75629578
18353,1196428',2018-04-03,RTGS/HDFCH18093380807/PAY,0.0,2320000.0,,2018,4,3,CASH_IN,2320000.0,M1037398211
18354,1196428',2018-04-03,RTGS/HDFCH18093380822/PAY,0.0,3720000.0,,2018,4,3,CASH_IN,3720000.0,C2072030256
18355,1196428',2018-04-03,UPI/809312162201/Indiaforensic/A,0.0,100.0,,2018,4,3,CHECK_CASHING,100.0,C886888353
18356,1196428',2018-04-03,FDRL/REAL TIME GROSS SETTL,3000000.0,0.0,,2018,4,3,PAYEMENT,3000000.0,C701279123
18357,1196428',2018-04-03,FDRL/REAL TIME GROSS SETTL,3000000.0,0.0,,2018,4,3,CASH_OUT,3000000.0,C864016033
18358,1196428',2018-04-03,NEFT/20483731921DC/ARTHAS,0.0,50000.0,,2018,4,3,TRANSFER,50000.0,C515442419
18359,1196428',2018-04-03,RTGS/SCBLH18093004923/FIX,0.0,220000.0,,2018,4,3,TRANSFER,220000.0,M2127093801
18360,1196428',2018-04-03,TRF FROM  Indiaforensic SERVICES,0.0,15000000.0,,2018,4,3,CHECK_CASHING,15000000.0,C1649686970
18361,1196428',2018-04-03,TRF FROM  Indiaforensic SERVICES,0.0,15000000.0,,2018,4,3,CASH_IN,15000000.0,C701855966
18362,1196428',2018-04-03,TRF FROM  Indiaforensic SERVICES,0.0,6000000.0,,2018,4,3,TRANSFER,6000000.0,C1505217516
18363,1196428',2018-04-03,FDRL/REAL TIME GROSS SETTL,15000000.0,0.0,,2018,4,3,CASH_OUT,15000000.0,M676875212
18364,1196428',2018-04-03,FDRL/REAL TIME GROSS SETTL,15000000.0,0.0,,2018,4,3,CASH_OUT,15000000.0,C681709819
18365,1196428',2018-04-03,FDRL/REAL TIME GROSS SETTL,3000000.0,0.0,,2018,4,3,CASH_OUT,3000000.0,M1025042585
18366,1196428',2018-04-03,FDRL/REAL TIME GROSS SETTL,3000000.0,0.0,,2018,4,3,DEBIT,3000000.0,C807247901
18367,1196428',2018-04-03,TRF FROM  Indiaforensic SERVICES,0.0,15000000.0,,2018,4,3,CHECK_CASHING,15000000.0,M18308448
18368,1196428',2018-04-03,TRF FROM  Indiaforensic SERVICES,0.0,400000.0,,2018,4,3,TRANSFER,400000.0,M170030714
18369,1196428',2018-04-03,FDRL/NATIONAL ELECTRONIC F,15000000.0,0.0,,2018,4,3,CHECK_WITHDRAWAL,15000000.0,M621155607
18370,1196428',2018-04-03,NEFT/P18040395295769/KADU,0.0,70000.0,,2018,4,3,CHECK_CASHING,70000.0,C1660095722
18371,1196428',2018-04-03,Indiaforensic SERVICES INDIA PVT,0.0,488801.0,,2018,4,3,CASH_IN,488801.0,M1571765149
18372,1196428',2018-04-03,UPI/809317413303/Indiaforensic R,0.0,20000.0,,2018,4,3,TRANSFER,20000.0,C1663686815
18373,1196428',2018-04-03,NEFT/SBIN818093424373/KIR,0.0,11800.0,,2018,4,3,CASH_IN,11800.0,M279824269
18374,1196428',2018-04-03,NEFT/N093180510645386/PAY,0.0,696556.12,,2018,4,3,TRANSFER,696556.12,M1570490488
18375,1196428',2018-04-03,NEFT/N093180510652102/PAY,0.0,2635342.22,,2018,4,3,CHECK_CASHING,2635342.22,M1063002743
18376,1196428',2018-04-03,IRTT00701809781,1326.57,0.0,,2018,4,3,CHECK_WITHDRAWAL,1326.57,M1530195938
18377,1196428',2018-04-03,"Indiaforensic USA, INC./USD/1899",0.0,1230940.8,,2018,4,3,TRANSFER,1230940.8,C1883840933
18378,1196428',2018-04-03,FDRL/INTERNAL FUND TRANSFE,15000000.0,0.0,,2018,4,3,CASH_OUT,15000000.0,M2097586567
18379,1196428',2018-04-03,FDRL/INTERNAL FUND TRANSFE,10000000.0,0.0,,2018,4,3,PAYEMENT,10000000.0,C1700852615
18380,1196428',2018-04-03,BEAT CSH PKP DEL GURG 617,0.0,284500.0,,2018,4,3,CHECK_CASHING,284500.0,C1457728035
18381,1196428',2018-04-03,"Indiaforensic USA, INC./USD/2501",0.0,1621166.4,,2018,4,3,TRANSFER,1621166.4,C47249488
18382,1196428',2018-04-03,IRTT00701810022,1396.81,0.0,,2018,4,3,CASH_OUT,1396.81,C33524623
18383,1196428',2018-04-03,NEFT/AXISP18093387724/ACC,0.0,6000000.0,,2018,4,3,CASH_IN,6000000.0,C2133591152
18384,1196428',2018-04-04,FDRL/REAL TIME GROSS SETTL,10000000.0,0.0,,2018,4,4,CASH_OUT,10000000.0,C193864812
18385,1196428',2018-04-04,FDRL/REAL TIME GROSS SETTL,2000000.0,0.0,,2018,4,4,DEBIT,2000000.0,C1058921154
18386,1196428',2018-04-04,FDRL/REAL TIME GROSS SETTL,2000000.0,0.0,,2018,4,4,DEBIT,2000000.0,C798678484
18387,1196428',2018-04-04,FDRL/INTERNAL FUND TRANSFE,1000000.0,0.0,,2018,4,4,CASH_OUT,1000000.0,C769342184
18388,1196428',2018-04-04,FDRL/INTERNAL FUND TRANSFE,1000000.0,0.0,,2018,4,4,CASH_OUT,1000000.0,C981198566
18389,1196428',2018-04-04,FDRL/REAL TIME GROSS SETTL,3000000.0,0.0,,2018,4,4,CASH_OUT,3000000.0,C1281898359
18390,1196428',2018-04-04,IMPS 809410383353 FROM SA,0.0,200000.0,,2018,4,4,CHECK_CASHING,200000.0,C30013970
18391,1196428',2018-04-04,CASHDEP/NOIDA/TP,0.0,63000.0,,2018,4,4,CASH_IN,63000.0,C31789747
18392,1196428',2018-04-04,NEFT/N094180511193504/TEC,0.0,200000.0,,2018,4,4,CHECK_CASHING,200000.0,C93518808
18393,1196428',2018-04-04,FDRL/NATIONAL ELECTRONIC F,45322.0,0.0,,2018,4,4,CASH_OUT,45322.0,C2093546827
18394,1196428',2018-04-04,RTGS/HDFCH18094582625/PAY,0.0,2720000.0,,2018,4,4,CASH_IN,2720000.0,C976133979
18395,1196428',2018-04-04,RTGS/HDFCH18094583718/PAY,0.0,1840000.0,,2018,4,4,CASH_IN,1840000.0,C849038219
18396,1196428',2018-04-04,NEFT/20485355051DC/ARTHAS,0.0,25000.0,,2018,4,4,TRANSFER,25000.0,C1789550256
18397,1196428',2018-04-04,TRF FROM  Indiaforensic SERVICES,0.0,4500000.0,,2018,4,4,CASH_IN,4500000.0,C363475076
18398,1196428',2018-04-04,FDRL/REAL TIME GROSS SETTL,3000000.0,0.0,,2018,4,4,PAYEMENT,3000000.0,C2110623348
18399,1196428',2018-04-04,FDRL/REAL TIME GROSS SETTL,3000000.0,0.0,,2018,4,4,PAYEMENT,3000000.0,C1161820020
18400,1196428',2018-04-04,FDRL/REAL TIME GROSS SETTL,3000000.0,0.0,,2018,4,4,CHECK_WITHDRAWAL,3000000.0,C627675433
18401,1196428',2018-04-04,FDRL/NATIONAL ELECTRONIC F,20000.0,0.0,,2018,4,4,PAYEMENT,20000.0,C1145835418
18402,1196428',2018-04-04,FDRL/NATIONAL ELECTRONIC F,16320.0,0.0,,2018,4,4,CHECK_WITHDRAWAL,16320.0,C1778300121
18403,1196428',2018-04-04,FDRL/NATIONAL ELECTRONIC F,18000.0,0.0,,2018,4,4,CASH_OUT,18000.0,C1325626015
18404,1196428',2018-04-04,FDRL/NATIONAL ELECTRONIC F,18000.0,0.0,,2018,4,4,DEBIT,18000.0,C8733802
18405,1196428',2018-04-04,FDRL/NATIONAL ELECTRONIC F,18000.0,0.0,,2018,4,4,CHECK_WITHDRAWAL,18000.0,C990053853
18406,1196428',2018-04-04,FDRL/NATIONAL ELECTRONIC F,18000.0,0.0,,2018,4,4,PAYEMENT,18000.0,C218193338
18407,1196428',2018-04-04,FDRL/NATIONAL ELECTRONIC F,16000.0,0.0,,2018,4,4,DEBIT,16000.0,M832073005
18408,1196428',2018-04-04,FDRL/NATIONAL ELECTRONIC F,14000.0,0.0,,2018,4,4,CASH_OUT,14000.0,M189083850
18409,1196428',2018-04-04,FDRL/NATIONAL ELECTRONIC F,9589.0,0.0,,2018,4,4,CHECK_WITHDRAWAL,9589.0,C103357744
18410,1196428',2018-04-04,FDRL/NATIONAL ELECTRONIC F,3120.0,0.0,,2018,4,4,DEBIT,3120.0,M1942890330
18411,1196428',2018-04-04,FDRL/NATIONAL ELECTRONIC F,18000.0,0.0,,2018,4,4,PAYEMENT,18000.0,C2011941350
18412,1196428',2018-04-04,FDRL/NATIONAL ELECTRONIC F,12000.0,0.0,,2018,4,4,CHECK_WITHDRAWAL,12000.0,C1505755152
18413,1196428',2018-04-04,FDRL/NATIONAL ELECTRONIC F,14000.0,0.0,,2018,4,4,DEBIT,14000.0,M1051118371
18414,1196428',2018-04-04,FDRL/NATIONAL ELECTRONIC F,15000.0,0.0,,2018,4,4,PAYEMENT,15000.0,M1502077581
18415,1196428',2018-04-04,FDRL/NATIONAL ELECTRONIC F,10676.0,0.0,,2018,4,4,CHECK_WITHDRAWAL,10676.0,M1801625172
18416,1196428',2018-04-04,FDRL/NATIONAL ELECTRONIC F,12000.0,0.0,,2018,4,4,PAYEMENT,12000.0,C360898540
18417,1196428',2018-04-04,FDRL/INTERNAL FUND TRANSFE,0.0,2000000.0,,2018,4,4,CASH_IN,2000000.0,M1408738192
18418,1196428',2018-04-04,FDRL/INTERNAL FUND TRANSFE,0.0,3000000.0,,2018,4,4,CHECK_CASHING,3000000.0,C237594516
18419,1196428',2018-04-04,TRF FROM  Indiaforensic SERVICES,0.0,15000000.0,,2018,4,4,CASH_IN,15000000.0,M1645271006
18420,1196428',2018-04-04,TRF FROM  Indiaforensic SERVICES,0.0,11800000.0,,2018,4,4,CASH_IN,11800000.0,M1616707854
18421,1196428',2018-04-04,CASHDEP/VIKASMARG/TP,0.0,226000.0,,2018,4,4,CASH_IN,226000.0,C1334973394
18422,1196428',2018-04-04,NEFT/N094180511772424/PAY,0.0,577693.12,,2018,4,4,CASH_IN,577693.12,M1547406846
18423,1196428',2018-04-04,NEFT/N094180511781679/PAY,0.0,3985407.03,,2018,4,4,CHECK_CASHING,3985407.03,M51814511
18424,1196428',2018-04-04,Indiaforensic SERVICES INDIA PVT,0.0,211519.0,,2018,4,4,TRANSFER,211519.0,M1679527434
18425,1196428',2018-04-04,IMPS 809417638441 FROM SA,0.0,25000.0,,2018,4,4,CASH_IN,25000.0,M858729243
18426,1196428',2018-04-04,FUJIAN NEWLAND PAYMENT TE,4213918.2,0.0,,2018,4,4,DEBIT,4213918.2,M317858117
18427,1196428',2018-04-04,IMAR00701801884,8058.51,0.0,,2018,4,4,CHECK_WITHDRAWAL,8058.51,M974232437
18428,1196428',2018-04-04,TRF TO Indiaforensic SERVICES IN,15000000.0,0.0,,2018,4,4,CASH_OUT,15000000.0,M535001108
18429,1196428',2018-04-04,TRF TO Indiaforensic SERVICES IN,15000000.0,0.0,,2018,4,4,CASH_OUT,15000000.0,M967799453
18430,1196428',2018-04-04,FDRL/INTERNAL FUND TRANSFE,0.0,3000000.0,,2018,4,4,CASH_IN,3000000.0,M1704857178
18431,1196428',2018-04-04,FDRL/INTERNAL FUND TRANSFE,0.0,3000000.0,,2018,4,4,TRANSFER,3000000.0,M888552844
18432,1196428',2018-04-04,TRF TO  Indiaforensic SERVICES I,7500000.0,0.0,,2018,4,4,PAYEMENT,7500000.0,M257269635
18433,1196428',2018-04-04,BEAT CSH PKP DEL GURG 617,0.0,199500.0,,2018,4,4,TRANSFER,199500.0,C1305075214
18434,1196428',2018-04-04,FUJIAN NEWLAND PAYMENT TE,1369476.0,0.0,,2018,4,4,DEBIT,1369476.0,C1627965794
18435,1196428',2018-04-04,IMAR00701801898,3666.49,0.0,,2018,4,4,CASH_OUT,3666.49,M1559676676
18436,1196428',2018-04-05,CASHDEP/NOIDA/TP,0.0,130000.0,,2018,4,5,TRANSFER,130000.0,C741431520
18437,1196428',2018-04-05,FDRL/NATIONAL ELECTRONIC F,117663.0,0.0,,2018,4,5,CASH_OUT,117663.0,C2143477943
18438,1196428',2018-04-05,RTGS/HDFCH18095754044/PAY,0.0,1440000.0,,2018,4,5,CHECK_CASHING,1440000.0,C638551812
18439,1196428',2018-04-05,RTGS/HDFCH18095756720/PAY,0.0,2680000.0,,2018,4,5,CHECK_CASHING,2680000.0,C1027296777
18440,1196428',2018-04-05,NEFT/CBINH18095111531/JAM,0.0,50000.0,,2018,4,5,TRANSFER,50000.0,C1554540309
18441,1196428',2018-04-05,TRF FROM  Indiaforensic SERVICES,0.0,2600000.0,,2018,4,5,TRANSFER,2600000.0,M2120427827
18442,1196428',2018-04-05,FDRL/INTERNAL FUND TRANSFE,1000000.0,0.0,,2018,4,5,PAYEMENT,1000000.0,C820910648
18443,1196428',2018-04-05,FDRL/REAL TIME GROSS SETTL,3000000.0,0.0,,2018,4,5,CASH_OUT,3000000.0,M415456371
18444,1196428',2018-04-05,FDRL/REAL TIME GROSS SETTL,3000000.0,0.0,,2018,4,5,CHECK_WITHDRAWAL,3000000.0,M598340030
18445,1196428',2018-04-05,NEFT/BARBZ18095589054/MAK,0.0,50550.0,,2018,4,5,CHECK_CASHING,50550.0,C345679794
18446,1196428',2018-04-05,CHQ DEP/1827/OWDEL1/SCBL/,0.0,50000.0,,2018,4,5,CHECK_CASHING,50000.0,M1605050346
18447,1196428',2018-04-05,TRF FROM Indiaforensic SERVICES,0.0,13500000.0,,2018,4,5,CHECK_CASHING,13500000.0,C1144070975
18448,1196428',2018-04-05,TRF FROM Indiaforensic SERVICES,0.0,15000000.0,,2018,4,5,CHECK_CASHING,15000000.0,M639999796
18449,1196428',2018-04-05,FDRL/REAL TIME GROSS SETTL,15000000.0,0.0,,2018,4,5,CHECK_WITHDRAWAL,15000000.0,C343534938
18450,1196428',2018-04-05,FDRL/REAL TIME GROSS SETTL,10000000.0,0.0,,2018,4,5,CASH_OUT,10000000.0,M479872561
18451,1196428',2018-04-05,FDRL/REAL TIME GROSS SETTL,2000000.0,0.0,,2018,4,5,CASH_OUT,2000000.0,M61732893
18452,1196428',2018-04-05,FDRL/NATIONAL ELECTRONIC F,11553.0,0.0,,2018,4,5,PAYEMENT,11553.0,C160632822
18453,1196428',2018-04-05,FDRL/NATIONAL ELECTRONIC F,40000.0,0.0,,2018,4,5,DEBIT,40000.0,C1183266411
18454,1196428',2018-04-05,FDRL/NATIONAL ELECTRONIC F,77416.0,0.0,,2018,4,5,DEBIT,77416.0,M1328778262
18455,1196428',2018-04-05,NEFT/N095180513017996/PAY,0.0,382023.16,,2018,4,5,TRANSFER,382023.16,M704806959
18456,1196428',2018-04-05,NEFT/N095180513017891/PAY,0.0,4268844.29,,2018,4,5,TRANSFER,4268844.29,C229313132
18457,1196428',2018-04-05,NEFT/SBIN118095344634/SHR,0.0,5000.0,,2018,4,5,TRANSFER,5000.0,M325906300
18458,1196428',2018-04-05,NEFT/20487645101DC/ARTHAS,0.0,200000.0,,2018,4,5,CHECK_CASHING,200000.0,M1267748122
18459,1196428',2018-04-05,Indiaforensic SERVICES INDIA PVT,0.0,203667.0,,2018,4,5,CASH_IN,203667.0,M159739450
18460,1196428',2018-04-05,NEFT/AXISP18095075122/ACC,0.0,2000000.0,,2018,4,5,CASH_IN,2000000.0,M1702289141
18461,1196428',2018-04-05,TRF TO  Indiaforensic SERVICES I,0.0,200000.0,,2018,4,5,TRANSFER,200000.0,C1200612373
18462,1196428',2018-04-05,TRF TO  Indiaforensic SERVICES I,135801.0,0.0,,2018,4,5,CASH_OUT,135801.0,C1840046890
18463,1196428',2018-04-05,NEFT/SBIN118095579766/Indfor,0.0,4300000.0,,2018,4,5,TRANSFER,4300000.0,M1261751850
18464,1196428',2018-04-05,FDRL/INTERNAL FUND TRANSFE,500000.0,0.0,,2018,4,5,CASH_OUT,500000.0,M1535970431
18465,1196428',2018-04-05,FDRL/INTERNAL FUND TRANSFE,500000.0,0.0,,2018,4,5,DEBIT,500000.0,M524251983
18466,1196428',2018-04-05,TRF FROM  Indiaforensic SERVICES,0.0,4200000.0,,2018,4,5,CHECK_CASHING,4200000.0,C1406749291
18467,1196428',2018-04-05,FDRL/INTERNAL FUND TRANSFE,200000.0,0.0,,2018,4,5,CHECK_WITHDRAWAL,200000.0,C1415645767
18468,1196428',2018-04-05,BEAT CSH PKP DEL GURG 617,0.0,100000.0,,2018,4,5,TRANSFER,100000.0,M1816834020
18469,1196428',2018-04-05,FDRL/INTERNAL FUND TRANSFE,1000000.0,0.0,,2018,4,5,CHECK_WITHDRAWAL,1000000.0,C1732292969
18470,1196428',2018-04-05,FDRL/INTERNAL FUND TRANSFE,1000000.0,0.0,,2018,4,5,DEBIT,1000000.0,M1739764490
18471,1196428',2018-04-05,FDRL/INTERNAL FUND TRANSFE,1000000.0,0.0,,2018,4,5,CHECK_WITHDRAWAL,1000000.0,M1664129150
18472,1196428',2018-04-05,FDRL/INTERNAL FUND TRANSFE,10000000.0,0.0,,2018,4,5,CASH_OUT,10000000.0,M1128852062
18473,1196428',2018-04-05,FDRL/INTERNAL FUND TRANSFE,2000000.0,0.0,,2018,4,5,PAYEMENT,2000000.0,M182471589
18474,1196428',2018-04-06,FT ZL1804066B3BE2CE PRAVE,0.0,100000.0,,2018,4,6,TRANSFER,100000.0,M1056074872
18475,1196428',2018-04-06,RTGS/HDFCH18096915858/PAY,0.0,2600000.0,,2018,4,6,CHECK_CASHING,2600000.0,M2106622700
18476,1196428',2018-04-06,RTGS/HDFCH18096918158/PAY,0.0,1360000.0,,2018,4,6,CASH_IN,1360000.0,M163766295
18477,1196428',2018-04-06,FDRL/REAL TIME GROSS SETTL,2000000.0,0.0,,2018,4,6,CASH_OUT,2000000.0,M802332120
18478,1196428',2018-04-06,FDRL/REAL TIME GROSS SETTL,3000000.0,0.0,,2018,4,6,DEBIT,3000000.0,M1676185662
18479,1196428',2018-04-06,NEFT/20488744031DC/ARTHAS,0.0,50000.0,,2018,4,6,CHECK_CASHING,50000.0,M1776427379
18480,1196428',2018-04-06,NEFT/AXIR180966182945/PER,0.0,11800.0,,2018,4,6,CASH_IN,11800.0,M334173295
18481,1196428',2018-04-06,FDRL/NATIONAL ELECTRONIC F,45055.0,0.0,,2018,4,6,CHECK_WITHDRAWAL,45055.0,M330490124
18482,1196428',2018-04-06,NEFT/FDRLH18096420207/MIZ,0.0,11800.0,,2018,4,6,TRANSFER,11800.0,M1154845973
18483,1196428',2018-04-06,TRF FROM  Indiaforensic SERVICES,0.0,15000000.0,,2018,4,6,CASH_IN,15000000.0,M911987264
18484,1196428',2018-04-06,TRF FROM  Indiaforensic SERVICES,0.0,12600000.0,,2018,4,6,CHECK_CASHING,12600000.0,M1680147473
18485,1196428',2018-04-06,"Indiaforensic USA, INC./USD/1752",0.0,1133932.2,,2018,4,6,TRANSFER,1133932.2,M293659205
18486,1196428',2018-04-06,IRTT00701810406,1309.11,0.0,,2018,4,6,CASH_OUT,1309.11,M1432093328
18487,1196428',2018-04-06,FDRL/REAL TIME GROSS SETTL,3000000.0,0.0,,2018,4,6,CASH_OUT,3000000.0,M901262414
18488,1196428',2018-04-06,FDRL/REAL TIME GROSS SETTL,10000000.0,0.0,,2018,4,6,CHECK_WITHDRAWAL,10000000.0,M899962047
18489,1196428',2018-04-06,FDRL/REAL TIME GROSS SETTL,15000000.0,0.0,,2018,4,6,DEBIT,15000000.0,M32715716
18490,1196428',2018-04-06,NEFT/BARBP18096112051/MAK,0.0,50450.0,,2018,4,6,TRANSFER,50450.0,M1510311379
18491,1196428',2018-04-06,FDRL/INTERNAL FUND TRANSFE,1000000.0,0.0,,2018,4,6,CHECK_WITHDRAWAL,1000000.0,M1517206841
18492,1196428',2018-04-06,NEFT/PUNBH18096835348/BAL,0.0,11800.0,,2018,4,6,TRANSFER,11800.0,M2030024765
18493,1196428',2018-04-06,NEFT/N096180513963166/PAY,0.0,401053.28,,2018,4,6,TRANSFER,401053.28,M1267580132
18494,1196428',2018-04-06,NEFT/N096180513963206/PAY,0.0,3943809.64,,2018,4,6,CASH_IN,3943809.64,C655391383
18495,1196428',2018-04-06,NEFT/AXISP18096080019/ACC,0.0,8000000.0,,2018,4,6,TRANSFER,8000000.0,C2117215775
18496,1196428',2018-04-06,Indiaforensic SERVICES INDIA PVT,0.0,241758.0,,2018,4,6,TRANSFER,241758.0,C2106576360
18497,1196428',2018-04-06,TRF FROM  Indiaforensic SERVICES,0.0,3700000.0,,2018,4,6,CHECK_CASHING,3700000.0,M267789972
18498,1196428',2018-04-06,FDRL/INTERNAL FUND TRANSFE,1000000.0,0.0,,2018,4,6,DEBIT,1000000.0,M292960678
18499,1196428',2018-04-06,FDRL/INTERNAL FUND TRANSFE,1000000.0,0.0,,2018,4,6,CASH_OUT,1000000.0,C1638372110
18500,1196428',2018-04-06,FDRL/INTERNAL FUND TRANSFE,10000000.0,0.0,,2018,4,6,CHECK_WITHDRAWAL,10000000.0,C1377774115
18501,1196428',2018-04-06,FDRL/INTERNAL FUND TRANSFE,4000000.0,0.0,,2018,4,6,PAYEMENT,4000000.0,M1877845145
18502,1196428',2018-04-06,BEAT CSH PKP DEL GURG 617,0.0,143000.0,,2018,4,6,CHECK_CASHING,143000.0,M869149988
18503,1196428',2018-04-07,NEFT/N097180514305043/TEC,0.0,200000.0,,2018,4,7,CASH_IN,200000.0,M1324498984
18504,1196428',2018-04-07,RTGS/HDFCH18097074411/PAY,0.0,1440000.0,,2018,4,7,TRANSFER,1440000.0,C748014372
18505,1196428',2018-04-07,RTGS/HDFCH18097074398/PAY,0.0,2760000.0,,2018,4,7,CHECK_CASHING,2760000.0,M1556526073
18506,1196428',2018-04-07,FDRL/NATIONAL ELECTRONIC F,375982.0,0.0,,2018,4,7,CASH_OUT,375982.0,M1113797896
18507,1196428',2018-04-07,FDRL/REAL TIME GROSS SETTL,2000000.0,0.0,,2018,4,7,CASH_OUT,2000000.0,M111103216
18508,1196428',2018-04-07,FDRL/REAL TIME GROSS SETTL,2000000.0,0.0,,2018,4,7,CASH_OUT,2000000.0,M402054040
18509,1196428',2018-04-07,NEFT/N097180514526068/MAH,0.0,147000.0,,2018,4,7,TRANSFER,147000.0,C1174935745
18510,1196428',2018-04-07,IMPS 809712762849 FROM SA,0.0,200000.0,,2018,4,7,CHECK_CASHING,200000.0,M3128155
18511,1196428',2018-04-07,TRF FROM Indiaforensic SERVICES,0.0,15000000.0,,2018,4,7,CASH_IN,15000000.0,M804435874
18512,1196428',2018-04-07,TRF FROM Indiaforensic SERVICES,0.0,5000000.0,,2018,4,7,CASH_IN,5000000.0,M22524150
18513,1196428',2018-04-07,TRF FROM Indiaforensic SERVICES,0.0,4000000.0,,2018,4,7,CHECK_CASHING,4000000.0,C717951588
18514,1196428',2018-04-07,FDRL/REAL TIME GROSS SETTL,15000000.0,0.0,,2018,4,7,PAYEMENT,15000000.0,M994429804
18515,1196428',2018-04-07,FDRL/REAL TIME GROSS SETTL,2000000.0,0.0,,2018,4,7,CHECK_WITHDRAWAL,2000000.0,M42960844
18516,1196428',2018-04-07,FDRL/REAL TIME GROSS SETTL,2000000.0,0.0,,2018,4,7,DEBIT,2000000.0,M117897905
18517,1196428',2018-04-07,FDRL/NATIONAL ELECTRONIC F,18314.0,0.0,,2018,4,7,PAYEMENT,18314.0,M919103236
18518,1196428',2018-04-07,FDRL/NATIONAL ELECTRONIC F,26050.0,0.0,,2018,4,7,CHECK_WITHDRAWAL,26050.0,M2117556230
18519,1196428',2018-04-07,FDRL/NATIONAL ELECTRONIC F,16880.0,0.0,,2018,4,7,DEBIT,16880.0,M2047174428
18520,1196428',2018-04-07,FDRL/NATIONAL ELECTRONIC F,29860.0,0.0,,2018,4,7,CASH_OUT,29860.0,M1468774738
18521,1196428',2018-04-07,FDRL/NATIONAL ELECTRONIC F,29739.0,0.0,,2018,4,7,CHECK_WITHDRAWAL,29739.0,M266577647
18522,1196428',2018-04-07,FDRL/NATIONAL ELECTRONIC F,6141.0,0.0,,2018,4,7,PAYEMENT,6141.0,M1474343674
18523,1196428',2018-04-07,FDRL/NATIONAL ELECTRONIC F,18564.0,0.0,,2018,4,7,CASH_OUT,18564.0,M1664266643
18524,1196428',2018-04-07,FDRL/NATIONAL ELECTRONIC F,29175.0,0.0,,2018,4,7,CASH_OUT,29175.0,M842463018
18525,1196428',2018-04-07,FDRL/NATIONAL ELECTRONIC F,4467.0,0.0,,2018,4,7,DEBIT,4467.0,M284325832
18526,1196428',2018-04-07,FDRL/NATIONAL ELECTRONIC F,7400.0,0.0,,2018,4,7,PAYEMENT,7400.0,M1784760424
18527,1196428',2018-04-07,FDRL/NATIONAL ELECTRONIC F,18314.0,0.0,,2018,4,7,PAYEMENT,18314.0,M1489026763
18528,1196428',2018-04-07,FDRL/NATIONAL ELECTRONIC F,29175.0,0.0,,2018,4,7,CHECK_WITHDRAWAL,29175.0,C1800405372
18529,1196428',2018-04-07,FDRL/NATIONAL ELECTRONIC F,18314.0,0.0,,2018,4,7,PAYEMENT,18314.0,C2071512077
18530,1196428',2018-04-07,FDRL/NATIONAL ELECTRONIC F,26350.0,0.0,,2018,4,7,PAYEMENT,26350.0,C1588635270
18531,1196428',2018-04-07,FDRL/NATIONAL ELECTRONIC F,24090.0,0.0,,2018,4,7,CHECK_WITHDRAWAL,24090.0,C1495001462
18532,1196428',2018-04-07,FDRL/NATIONAL ELECTRONIC F,15105.0,0.0,,2018,4,7,CHECK_WITHDRAWAL,15105.0,M84558619
18533,1196428',2018-04-07,FDRL/NATIONAL ELECTRONIC F,18402.0,0.0,,2018,4,7,CHECK_WITHDRAWAL,18402.0,M113925453
18534,1196428',2018-04-07,FDRL/NATIONAL ELECTRONIC F,18552.0,0.0,,2018,4,7,DEBIT,18552.0,M645245228
18535,1196428',2018-04-07,FDRL/NATIONAL ELECTRONIC F,9326.0,0.0,,2018,4,7,PAYEMENT,9326.0,M636094317
18536,1196428',2018-04-07,FDRL/NATIONAL ELECTRONIC F,18402.0,0.0,,2018,4,7,CHECK_WITHDRAWAL,18402.0,M1583961850
18537,1196428',2018-04-07,FDRL/NATIONAL ELECTRONIC F,28610.0,0.0,,2018,4,7,CASH_OUT,28610.0,M708029389
18538,1196428',2018-04-07,FDRL/NATIONAL ELECTRONIC F,28610.0,0.0,,2018,4,7,CHECK_WITHDRAWAL,28610.0,M508231066
18539,1196428',2018-04-07,FDRL/NATIONAL ELECTRONIC F,18552.0,0.0,,2018,4,7,CASH_OUT,18552.0,C1838491463
18540,1196428',2018-04-07,FDRL/NATIONAL ELECTRONIC F,28610.0,0.0,,2018,4,7,DEBIT,28610.0,M1094448975
18541,1196428',2018-04-07,FDRL/NATIONAL ELECTRONIC F,19056.0,0.0,,2018,4,7,DEBIT,19056.0,M717841651
18542,1196428',2018-04-07,FDRL/NATIONAL ELECTRONIC F,28610.0,0.0,,2018,4,7,CASH_OUT,28610.0,M1954167102
18543,1196428',2018-04-07,FDRL/NATIONAL ELECTRONIC F,29739.0,0.0,,2018,4,7,PAYEMENT,29739.0,M1043087369
18544,1196428',2018-04-07,FDRL/NATIONAL ELECTRONIC F,18802.0,0.0,,2018,4,7,CHECK_WITHDRAWAL,18802.0,M1489610760
18545,1196428',2018-04-07,FDRL/NATIONAL ELECTRONIC F,20038.0,0.0,,2018,4,7,DEBIT,20038.0,C1556875182
18546,1196428',2018-04-07,FDRL/NATIONAL ELECTRONIC F,18802.0,0.0,,2018,4,7,PAYEMENT,18802.0,M1109811596
18547,1196428',2018-04-07,FDRL/NATIONAL ELECTRONIC F,15596.0,0.0,,2018,4,7,CHECK_WITHDRAWAL,15596.0,C101571284
18548,1196428',2018-04-07,FDRL/NATIONAL ELECTRONIC F,18552.0,0.0,,2018,4,7,CASH_OUT,18552.0,M178952563
18549,1196428',2018-04-07,FDRL/NATIONAL ELECTRONIC F,18802.0,0.0,,2018,4,7,CASH_OUT,18802.0,M2081263541
18550,1196428',2018-04-07,FDRL/NATIONAL ELECTRONIC F,15596.0,0.0,,2018,4,7,DEBIT,15596.0,C2078250226
18551,1196428',2018-04-07,FDRL/NATIONAL ELECTRONIC F,18552.0,0.0,,2018,4,7,CHECK_WITHDRAWAL,18552.0,C1570256460
18552,1196428',2018-04-07,FDRL/NATIONAL ELECTRONIC F,15596.0,0.0,,2018,4,7,PAYEMENT,15596.0,M441055416
18553,1196428',2018-04-07,FDRL/NATIONAL ELECTRONIC F,28610.0,0.0,,2018,4,7,CHECK_WITHDRAWAL,28610.0,C2077098348
18554,1196428',2018-04-07,FDRL/NATIONAL ELECTRONIC F,18552.0,0.0,,2018,4,7,CASH_OUT,18552.0,C1062254208
18555,1196428',2018-04-07,FDRL/NATIONAL ELECTRONIC F,15596.0,0.0,,2018,4,7,DEBIT,15596.0,C1787868648
18556,1196428',2018-04-07,FDRL/NATIONAL ELECTRONIC F,18352.0,0.0,,2018,4,7,CHECK_WITHDRAWAL,18352.0,C161140376
18557,1196428',2018-04-07,FDRL/NATIONAL ELECTRONIC F,24090.0,0.0,,2018,4,7,DEBIT,24090.0,M1471351873
18558,1196428',2018-04-07,FDRL/NATIONAL ELECTRONIC F,28610.0,0.0,,2018,4,7,DEBIT,28610.0,M1328437771
18559,1196428',2018-04-07,FDRL/NATIONAL ELECTRONIC F,18762.0,0.0,,2018,4,7,DEBIT,18762.0,M341537411
18560,1196428',2018-04-07,FDRL/NATIONAL ELECTRONIC F,13460.0,0.0,,2018,4,7,DEBIT,13460.0,M1367049026
18561,1196428',2018-04-07,FDRL/NATIONAL ELECTRONIC F,8282.0,0.0,,2018,4,7,DEBIT,8282.0,C2029310301
18562,1196428',2018-04-07,FDRL/NATIONAL ELECTRONIC F,3000.0,0.0,,2018,4,7,CHECK_WITHDRAWAL,3000.0,C1606699851
18563,1196428',2018-04-07,FDRL/NATIONAL ELECTRONIC F,17369.0,0.0,,2018,4,7,PAYEMENT,17369.0,C1103621993
18564,1196428',2018-04-07,FDRL/NATIONAL ELECTRONIC F,18586.0,0.0,,2018,4,7,CASH_OUT,18586.0,M34447014
18565,1196428',2018-04-07,FDRL/NATIONAL ELECTRONIC F,13210.0,0.0,,2018,4,7,PAYEMENT,13210.0,C1428675504
18566,1196428',2018-04-07,FDRL/NATIONAL ELECTRONIC F,11125.0,0.0,,2018,4,7,PAYEMENT,11125.0,M1783999682
18567,1196428',2018-04-07,FDRL/NATIONAL ELECTRONIC F,17619.0,0.0,,2018,4,7,CHECK_WITHDRAWAL,17619.0,C1247600089
18568,1196428',2018-04-07,FDRL/NATIONAL ELECTRONIC F,13210.0,0.0,,2018,4,7,PAYEMENT,13210.0,M835388411
18569,1196428',2018-04-07,FDRL/NATIONAL ELECTRONIC F,33900.0,0.0,,2018,4,7,DEBIT,33900.0,C404279307
18570,1196428',2018-04-07,FDRL/NATIONAL ELECTRONIC F,38084.0,0.0,,2018,4,7,DEBIT,38084.0,C278407008
18571,1196428',2018-04-07,FDRL/NATIONAL ELECTRONIC F,36555.0,0.0,,2018,4,7,CASH_OUT,36555.0,M1721234210
18572,1196428',2018-04-07,FDRL/NATIONAL ELECTRONIC F,34467.0,0.0,,2018,4,7,CASH_OUT,34467.0,M1576908104
18573,1196428',2018-04-07,FDRL/NATIONAL ELECTRONIC F,37527.0,0.0,,2018,4,7,CHECK_WITHDRAWAL,37527.0,M1547162536
18574,1196428',2018-04-07,FDRL/NATIONAL ELECTRONIC F,40736.0,0.0,,2018,4,7,CASH_OUT,40736.0,M1057827479
18575,1196428',2018-04-07,FDRL/NATIONAL ELECTRONIC F,30159.0,0.0,,2018,4,7,CASH_OUT,30159.0,M1498878973
18576,1196428',2018-04-07,FDRL/NATIONAL ELECTRONIC F,42209.0,0.0,,2018,4,7,CASH_OUT,42209.0,M1420281457
18577,1196428',2018-04-07,FDRL/NATIONAL ELECTRONIC F,34490.0,0.0,,2018,4,7,CASH_OUT,34490.0,M2000558609
18578,1196428',2018-04-07,FDRL/NATIONAL ELECTRONIC F,43930.0,0.0,,2018,4,7,PAYEMENT,43930.0,M1598229594
18579,1196428',2018-04-07,FDRL/NATIONAL ELECTRONIC F,33837.0,0.0,,2018,4,7,CHECK_WITHDRAWAL,33837.0,M2001514483
18580,1196428',2018-04-07,FDRL/NATIONAL ELECTRONIC F,34059.0,0.0,,2018,4,7,CASH_OUT,34059.0,M1808413339
18581,1196428',2018-04-07,FDRL/NATIONAL ELECTRONIC F,35429.0,0.0,,2018,4,7,DEBIT,35429.0,M662376084
18582,1196428',2018-04-07,FDRL/NATIONAL ELECTRONIC F,33597.0,0.0,,2018,4,7,CHECK_WITHDRAWAL,33597.0,M1462583713
18583,1196428',2018-04-07,FDRL/NATIONAL ELECTRONIC F,33626.0,0.0,,2018,4,7,PAYEMENT,33626.0,M1292178703
18584,1196428',2018-04-07,FDRL/NATIONAL ELECTRONIC F,32120.0,0.0,,2018,4,7,CHECK_WITHDRAWAL,32120.0,M1378894443
18585,1196428',2018-04-07,FDRL/NATIONAL ELECTRONIC F,41040.0,0.0,,2018,4,7,CASH_OUT,41040.0,M671194471
18586,1196428',2018-04-07,FDRL/NATIONAL ELECTRONIC F,35430.0,0.0,,2018,4,7,DEBIT,35430.0,M2120887477
18587,1196428',2018-04-07,FDRL/NATIONAL ELECTRONIC F,32657.0,0.0,,2018,4,7,DEBIT,32657.0,M1565473666
18588,1196428',2018-04-07,FDRL/NATIONAL ELECTRONIC F,36640.0,0.0,,2018,4,7,CHECK_WITHDRAWAL,36640.0,M336600403
18589,1196428',2018-04-07,FDRL/NATIONAL ELECTRONIC F,46333.0,0.0,,2018,4,7,CASH_OUT,46333.0,M1108314788
18590,1196428',2018-04-07,FDRL/NATIONAL ELECTRONIC F,42975.0,0.0,,2018,4,7,CASH_OUT,42975.0,M1776708407
18591,1196428',2018-04-07,FDRL/NATIONAL ELECTRONIC F,47914.0,0.0,,2018,4,7,CHECK_WITHDRAWAL,47914.0,M1886072816
18592,1196428',2018-04-07,FDRL/NATIONAL ELECTRONIC F,32794.0,0.0,,2018,4,7,PAYEMENT,32794.0,M392269298
18593,1196428',2018-04-07,FDRL/NATIONAL ELECTRONIC F,30610.0,0.0,,2018,4,7,CHECK_WITHDRAWAL,30610.0,M240263357
18594,1196428',2018-04-07,FDRL/NATIONAL ELECTRONIC F,61129.0,0.0,,2018,4,7,PAYEMENT,61129.0,M2137827177
18595,1196428',2018-04-07,FDRL/NATIONAL ELECTRONIC F,50810.0,0.0,,2018,4,7,DEBIT,50810.0,M996688653
18596,1196428',2018-04-07,FDRL/NATIONAL ELECTRONIC F,62865.0,0.0,,2018,4,7,PAYEMENT,62865.0,C1829831147
18597,1196428',2018-04-07,FDRL/NATIONAL ELECTRONIC F,72380.0,0.0,,2018,4,7,CHECK_WITHDRAWAL,72380.0,M720435458
18598,1196428',2018-04-07,FDRL/NATIONAL ELECTRONIC F,50088.0,0.0,,2018,4,7,CASH_OUT,50088.0,M29096009
18599,1196428',2018-04-07,FDRL/NATIONAL ELECTRONIC F,53620.0,0.0,,2018,4,7,CASH_OUT,53620.0,M150995440
18600,1196428',2018-04-07,FDRL/NATIONAL ELECTRONIC F,77974.0,0.0,,2018,4,7,CASH_OUT,77974.0,M1241251535
18601,1196428',2018-04-07,FDRL/NATIONAL ELECTRONIC F,67865.0,0.0,,2018,4,7,PAYEMENT,67865.0,M1254542588
18602,1196428',2018-04-07,FDRL/NATIONAL ELECTRONIC F,75318.0,0.0,,2018,4,7,PAYEMENT,75318.0,M710538853
18603,1196428',2018-04-07,FDRL/NATIONAL ELECTRONIC F,68783.0,0.0,,2018,4,7,CASH_OUT,68783.0,M399672840
18604,1196428',2018-04-07,FDRL/NATIONAL ELECTRONIC F,56357.0,0.0,,2018,4,7,CHECK_WITHDRAWAL,56357.0,M1566931514
18605,1196428',2018-04-07,FDRL/NATIONAL ELECTRONIC F,63393.0,0.0,,2018,4,7,CHECK_WITHDRAWAL,63393.0,C1540270363
18606,1196428',2018-04-07,FDRL/NATIONAL ELECTRONIC F,67215.0,0.0,,2018,4,7,CHECK_WITHDRAWAL,67215.0,C900425684
18607,1196428',2018-04-07,FDRL/NATIONAL ELECTRONIC F,51750.0,0.0,,2018,4,7,CASH_OUT,51750.0,M1361294362
18608,1196428',2018-04-07,FDRL/NATIONAL ELECTRONIC F,76629.0,0.0,,2018,4,7,PAYEMENT,76629.0,C264843581
18609,1196428',2018-04-07,FDRL/NATIONAL ELECTRONIC F,66767.0,0.0,,2018,4,7,PAYEMENT,66767.0,M1897445965
18610,1196428',2018-04-07,FDRL/NATIONAL ELECTRONIC F,60869.0,0.0,,2018,4,7,DEBIT,60869.0,M345439288
18611,1196428',2018-04-07,FDRL/NATIONAL ELECTRONIC F,63356.0,0.0,,2018,4,7,DEBIT,63356.0,M2130477201
18612,1196428',2018-04-07,FDRL/NATIONAL ELECTRONIC F,69780.0,0.0,,2018,4,7,DEBIT,69780.0,M1516263359
18613,1196428',2018-04-07,FDRL/NATIONAL ELECTRONIC F,60651.0,0.0,,2018,4,7,DEBIT,60651.0,M508839235
18614,1196428',2018-04-07,FDRL/NATIONAL ELECTRONIC F,111781.0,0.0,,2018,4,7,DEBIT,111781.0,M530611995
18615,1196428',2018-04-07,FDRL/NATIONAL ELECTRONIC F,255404.0,0.0,,2018,4,7,CASH_OUT,255404.0,C1761324386
18616,1196428',2018-04-07,FDRL/NATIONAL ELECTRONIC F,104500.0,0.0,,2018,4,7,CHECK_WITHDRAWAL,104500.0,C90486891
18617,1196428',2018-04-07,FDRL/NATIONAL ELECTRONIC F,9827.0,0.0,,2018,4,7,CHECK_WITHDRAWAL,9827.0,C573200870
18618,1196428',2018-04-07,FDRL/NATIONAL ELECTRONIC F,15171.0,0.0,,2018,4,7,CHECK_WITHDRAWAL,15171.0,C1825992554
18619,1196428',2018-04-07,FDRL/NATIONAL ELECTRONIC F,14353.0,0.0,,2018,4,7,CHECK_WITHDRAWAL,14353.0,M1278682262
18620,1196428',2018-04-07,FDRL/NATIONAL ELECTRONIC F,19628.0,0.0,,2018,4,7,DEBIT,19628.0,M2009652577
18621,1196428',2018-04-07,FDRL/NATIONAL ELECTRONIC F,9827.0,0.0,,2018,4,7,DEBIT,9827.0,M1504904868
18622,1196428',2018-04-07,FDRL/NATIONAL ELECTRONIC F,13244.0,0.0,,2018,4,7,CHECK_WITHDRAWAL,13244.0,C88226327
18623,1196428',2018-04-07,FDRL/NATIONAL ELECTRONIC F,14424.0,0.0,,2018,4,7,PAYEMENT,14424.0,M203497386
18624,1196428',2018-04-07,FDRL/NATIONAL ELECTRONIC F,13816.0,0.0,,2018,4,7,CASH_OUT,13816.0,M1264078907
18625,1196428',2018-04-07,FDRL/NATIONAL ELECTRONIC F,19449.0,0.0,,2018,4,7,CASH_OUT,19449.0,M1870838648
18626,1196428',2018-04-07,FDRL/NATIONAL ELECTRONIC F,29128.0,0.0,,2018,4,7,CHECK_WITHDRAWAL,29128.0,C1683963531
18627,1196428',2018-04-07,FDRL/NATIONAL ELECTRONIC F,16989.0,0.0,,2018,4,7,CASH_OUT,16989.0,M620120832
18628,1196428',2018-04-07,FDRL/NATIONAL ELECTRONIC F,14316.0,0.0,,2018,4,7,PAYEMENT,14316.0,M37714710
18629,1196428',2018-04-07,FDRL/NATIONAL ELECTRONIC F,10583.0,0.0,,2018,4,7,DEBIT,10583.0,M1135370372
18630,1196428',2018-04-07,FDRL/NATIONAL ELECTRONIC F,29538.0,0.0,,2018,4,7,CHECK_WITHDRAWAL,29538.0,C1700355047
18631,1196428',2018-04-07,FDRL/NATIONAL ELECTRONIC F,18095.0,0.0,,2018,4,7,CASH_OUT,18095.0,C1884600481
18632,1196428',2018-04-07,FDRL/NATIONAL ELECTRONIC F,14814.0,0.0,,2018,4,7,DEBIT,14814.0,C1105527690
18633,1196428',2018-04-07,FDRL/NATIONAL ELECTRONIC F,12596.0,0.0,,2018,4,7,CHECK_WITHDRAWAL,12596.0,M714819629
18634,1196428',2018-04-07,FDRL/NATIONAL ELECTRONIC F,12596.0,0.0,,2018,4,7,CASH_OUT,12596.0,M722465639
18635,1196428',2018-04-07,FDRL/NATIONAL ELECTRONIC F,4470.0,0.0,,2018,4,7,CASH_OUT,4470.0,C801412408
18636,1196428',2018-04-07,FDRL/NATIONAL ELECTRONIC F,7069.0,0.0,,2018,4,7,PAYEMENT,7069.0,M1678349105
18637,1196428',2018-04-07,FDRL/NATIONAL ELECTRONIC F,15871.0,0.0,,2018,4,7,DEBIT,15871.0,C35534346
18638,1196428',2018-04-07,FDRL/NATIONAL ELECTRONIC F,26095.0,0.0,,2018,4,7,CASH_OUT,26095.0,C943166837
18639,1196428',2018-04-07,FDRL/NATIONAL ELECTRONIC F,9886.0,0.0,,2018,4,7,CASH_OUT,9886.0,M1063088470
18640,1196428',2018-04-07,FDRL/NATIONAL ELECTRONIC F,3911.0,0.0,,2018,4,7,CHECK_WITHDRAWAL,3911.0,M634480856
18641,1196428',2018-04-07,FDRL/NATIONAL ELECTRONIC F,11010.0,0.0,,2018,4,7,DEBIT,11010.0,M1229660324
18642,1196428',2018-04-07,FDRL/NATIONAL ELECTRONIC F,12953.0,0.0,,2018,4,7,CHECK_WITHDRAWAL,12953.0,M1995775202
18643,1196428',2018-04-07,FDRL/NATIONAL ELECTRONIC F,15333.0,0.0,,2018,4,7,DEBIT,15333.0,M982735022
18644,1196428',2018-04-07,FDRL/NATIONAL ELECTRONIC F,12101.0,0.0,,2018,4,7,DEBIT,12101.0,C1754722089
18645,1196428',2018-04-07,FDRL/NATIONAL ELECTRONIC F,10848.0,0.0,,2018,4,7,PAYEMENT,10848.0,M536571624
18646,1196428',2018-04-07,FDRL/NATIONAL ELECTRONIC F,11368.0,0.0,,2018,4,7,CHECK_WITHDRAWAL,11368.0,C1498878963
18647,1196428',2018-04-07,FDRL/NATIONAL ELECTRONIC F,15167.0,0.0,,2018,4,7,DEBIT,15167.0,C1962165946
18648,1196428',2018-04-07,FDRL/NATIONAL ELECTRONIC F,27025.0,0.0,,2018,4,7,DEBIT,27025.0,M1170462195
18649,1196428',2018-04-07,FDRL/NATIONAL ELECTRONIC F,21933.0,0.0,,2018,4,7,PAYEMENT,21933.0,C414205222
18650,1196428',2018-04-07,FDRL/NATIONAL ELECTRONIC F,18998.0,0.0,,2018,4,7,PAYEMENT,18998.0,M1229413386
18651,1196428',2018-04-07,FDRL/NATIONAL ELECTRONIC F,24628.0,0.0,,2018,4,7,CASH_OUT,24628.0,M712447692
18652,1196428',2018-04-07,FDRL/NATIONAL ELECTRONIC F,8367.0,0.0,,2018,4,7,PAYEMENT,8367.0,C269902384
18653,1196428',2018-04-07,FDRL/NATIONAL ELECTRONIC F,24057.0,0.0,,2018,4,7,CASH_OUT,24057.0,C955097010
18654,1196428',2018-04-07,FDRL/NATIONAL ELECTRONIC F,24648.0,0.0,,2018,4,7,PAYEMENT,24648.0,C1827996167
18655,1196428',2018-04-07,FDRL/NATIONAL ELECTRONIC F,14909.0,0.0,,2018,4,7,CASH_OUT,14909.0,M30162194
18656,1196428',2018-04-07,FDRL/NATIONAL ELECTRONIC F,14521.0,0.0,,2018,4,7,CASH_OUT,14521.0,C1115240385
18657,1196428',2018-04-07,FDRL/NATIONAL ELECTRONIC F,18014.0,0.0,,2018,4,7,CHECK_WITHDRAWAL,18014.0,M1710595137
18658,1196428',2018-04-07,FDRL/NATIONAL ELECTRONIC F,17972.0,0.0,,2018,4,7,CHECK_WITHDRAWAL,17972.0,M970087106
18659,1196428',2018-04-07,FDRL/NATIONAL ELECTRONIC F,29303.0,0.0,,2018,4,7,PAYEMENT,29303.0,M561635968
18660,1196428',2018-04-07,FDRL/NATIONAL ELECTRONIC F,12103.0,0.0,,2018,4,7,DEBIT,12103.0,C440480434
18661,1196428',2018-04-07,FDRL/NATIONAL ELECTRONIC F,15016.0,0.0,,2018,4,7,PAYEMENT,15016.0,C46748390
18662,1196428',2018-04-07,FDRL/NATIONAL ELECTRONIC F,21206.0,0.0,,2018,4,7,CASH_OUT,21206.0,M976616410
18663,1196428',2018-04-07,FDRL/NATIONAL ELECTRONIC F,16223.0,0.0,,2018,4,7,CHECK_WITHDRAWAL,16223.0,M1796408655
18664,1196428',2018-04-07,FDRL/NATIONAL ELECTRONIC F,15244.0,0.0,,2018,4,7,CASH_OUT,15244.0,M424513770
18665,1196428',2018-04-07,FDRL/NATIONAL ELECTRONIC F,29650.0,0.0,,2018,4,7,CASH_OUT,29650.0,M1867357103
18666,1196428',2018-04-07,FDRL/NATIONAL ELECTRONIC F,4926.0,0.0,,2018,4,7,CASH_OUT,4926.0,M215680372
18667,1196428',2018-04-07,FDRL/NATIONAL ELECTRONIC F,9315.0,0.0,,2018,4,7,CASH_OUT,9315.0,M764256713
18668,1196428',2018-04-07,FDRL/NATIONAL ELECTRONIC F,26599.0,0.0,,2018,4,7,CHECK_WITHDRAWAL,26599.0,M538413261
18669,1196428',2018-04-07,FDRL/NATIONAL ELECTRONIC F,20519.0,0.0,,2018,4,7,DEBIT,20519.0,M942160595
18670,1196428',2018-04-07,FDRL/NATIONAL ELECTRONIC F,10017.0,0.0,,2018,4,7,CASH_OUT,10017.0,M1319156415
18671,1196428',2018-04-07,FDRL/NATIONAL ELECTRONIC F,9894.0,0.0,,2018,4,7,DEBIT,9894.0,M361847129
18672,1196428',2018-04-07,FDRL/NATIONAL ELECTRONIC F,29793.0,0.0,,2018,4,7,PAYEMENT,29793.0,C1790202239
18673,1196428',2018-04-07,FDRL/NATIONAL ELECTRONIC F,26350.0,0.0,,2018,4,7,CHECK_WITHDRAWAL,26350.0,M955868325
18674,1196428',2018-04-07,FDRL/NATIONAL ELECTRONIC F,18470.0,0.0,,2018,4,7,DEBIT,18470.0,M1251133153
18675,1196428',2018-04-07,FDRL/NATIONAL ELECTRONIC F,10531.0,0.0,,2018,4,7,DEBIT,10531.0,M1854311181
18676,1196428',2018-04-07,FDRL/NATIONAL ELECTRONIC F,18612.0,0.0,,2018,4,7,CHECK_WITHDRAWAL,18612.0,C928023753
18677,1196428',2018-04-07,FDRL/NATIONAL ELECTRONIC F,18418.0,0.0,,2018,4,7,CASH_OUT,18418.0,M771609335
18678,1196428',2018-04-07,FDRL/NATIONAL ELECTRONIC F,19969.0,0.0,,2018,4,7,CASH_OUT,19969.0,C1452722471
18679,1196428',2018-04-07,FDRL/NATIONAL ELECTRONIC F,9350.0,0.0,,2018,4,7,PAYEMENT,9350.0,M1625968481
18680,1196428',2018-04-07,FDRL/NATIONAL ELECTRONIC F,13725.0,0.0,,2018,4,7,PAYEMENT,13725.0,M458727925
18681,1196428',2018-04-07,FDRL/NATIONAL ELECTRONIC F,20728.0,0.0,,2018,4,7,CASH_OUT,20728.0,C111210112
18682,1196428',2018-04-07,FDRL/NATIONAL ELECTRONIC F,9233.0,0.0,,2018,4,7,CASH_OUT,9233.0,C464246030
18683,1196428',2018-04-07,FDRL/NATIONAL ELECTRONIC F,9009.0,0.0,,2018,4,7,CHECK_WITHDRAWAL,9009.0,M2080752777
18684,1196428',2018-04-07,FDRL/NATIONAL ELECTRONIC F,12358.0,0.0,,2018,4,7,DEBIT,12358.0,M1357563045
18685,1196428',2018-04-07,FDRL/NATIONAL ELECTRONIC F,18314.0,0.0,,2018,4,7,CHECK_WITHDRAWAL,18314.0,M68500741
18686,1196428',2018-04-07,FDRL/NATIONAL ELECTRONIC F,14876.0,0.0,,2018,4,7,CASH_OUT,14876.0,C1664330755
18687,1196428',2018-04-07,FDRL/NATIONAL ELECTRONIC F,17689.0,0.0,,2018,4,7,CHECK_WITHDRAWAL,17689.0,C1823014131
18688,1196428',2018-04-07,FDRL/NATIONAL ELECTRONIC F,11010.0,0.0,,2018,4,7,CHECK_WITHDRAWAL,11010.0,M1293355387
18689,1196428',2018-04-07,FDRL/NATIONAL ELECTRONIC F,18314.0,0.0,,2018,4,7,PAYEMENT,18314.0,M34599177
18690,1196428',2018-04-07,FDRL/NATIONAL ELECTRONIC F,18230.0,0.0,,2018,4,7,CHECK_WITHDRAWAL,18230.0,M685059787
18691,1196428',2018-04-07,FDRL/NATIONAL ELECTRONIC F,18314.0,0.0,,2018,4,7,DEBIT,18314.0,M376456946
18692,1196428',2018-04-07,FDRL/NATIONAL ELECTRONIC F,18564.0,0.0,,2018,4,7,DEBIT,18564.0,M793798217
18693,1196428',2018-04-07,FDRL/NATIONAL ELECTRONIC F,29363.0,0.0,,2018,4,7,CASH_OUT,29363.0,C264685626
18694,1196428',2018-04-07,FDRL/NATIONAL ELECTRONIC F,26350.0,0.0,,2018,4,7,DEBIT,26350.0,M954243999
18695,1196428',2018-04-07,FDRL/NATIONAL ELECTRONIC F,17086.0,0.0,,2018,4,7,DEBIT,17086.0,C1816986148
18696,1196428',2018-04-07,FDRL/NATIONAL ELECTRONIC F,18314.0,0.0,,2018,4,7,PAYEMENT,18314.0,C1144527317
18697,1196428',2018-04-07,FDRL/NATIONAL ELECTRONIC F,18314.0,0.0,,2018,4,7,PAYEMENT,18314.0,C1790831319
18698,1196428',2018-04-07,FDRL/NATIONAL ELECTRONIC F,23631.0,0.0,,2018,4,7,CASH_OUT,23631.0,C571435580
18699,1196428',2018-04-07,FDRL/NATIONAL ELECTRONIC F,25357.0,0.0,,2018,4,7,CHECK_WITHDRAWAL,25357.0,C1262016786
18700,1196428',2018-04-07,FDRL/NATIONAL ELECTRONIC F,18314.0,0.0,,2018,4,7,CASH_OUT,18314.0,C1287328228
18701,1196428',2018-04-07,FDRL/NATIONAL ELECTRONIC F,28245.0,0.0,,2018,4,7,CASH_OUT,28245.0,C329473339
18702,1196428',2018-04-07,FDRL/NATIONAL ELECTRONIC F,28850.0,0.0,,2018,4,7,CHECK_WITHDRAWAL,28850.0,C1354725727
18703,1196428',2018-04-07,FDRL/NATIONAL ELECTRONIC F,13029.0,0.0,,2018,4,7,PAYEMENT,13029.0,C1300519073
18704,1196428',2018-04-07,FDRL/NATIONAL ELECTRONIC F,18564.0,0.0,,2018,4,7,CHECK_WITHDRAWAL,18564.0,C2052185144
18705,1196428',2018-04-07,FDRL/NATIONAL ELECTRONIC F,8580.0,0.0,,2018,4,7,CASH_OUT,8580.0,C1485516154
18706,1196428',2018-04-07,FDRL/NATIONAL ELECTRONIC F,15800.0,0.0,,2018,4,7,DEBIT,15800.0,C2143477943
18707,1196428',2018-04-07,FDRL/NATIONAL ELECTRONIC F,29860.0,0.0,,2018,4,7,DEBIT,29860.0,C476402209
18708,1196428',2018-04-07,FDRL/NATIONAL ELECTRONIC F,18314.0,0.0,,2018,4,7,CASH_OUT,18314.0,C1255024717
18709,1196428',2018-04-07,FDRL/NATIONAL ELECTRONIC F,15977.0,0.0,,2018,4,7,CASH_OUT,15977.0,C1870367457
18710,1196428',2018-04-07,FDRL/NATIONAL ELECTRONIC F,28750.0,0.0,,2018,4,7,PAYEMENT,28750.0,C465257140
18711,1196428',2018-04-07,FDRL/NATIONAL ELECTRONIC F,12529.0,0.0,,2018,4,7,CASH_OUT,12529.0,C745740822
18712,1196428',2018-04-07,FDRL/NATIONAL ELECTRONIC F,18984.0,0.0,,2018,4,7,CASH_OUT,18984.0,C1390121014
18713,1196428',2018-04-07,FDRL/NATIONAL ELECTRONIC F,18314.0,0.0,,2018,4,7,CHECK_WITHDRAWAL,18314.0,C1481851679
18714,1196428',2018-04-07,FDRL/NATIONAL ELECTRONIC F,13029.0,0.0,,2018,4,7,PAYEMENT,13029.0,C741431520
18715,1196428',2018-04-07,FDRL/INTERNAL FUND TRANSFE,22000.0,0.0,,2018,4,7,DEBIT,22000.0,C758888772
18716,1196428',2018-04-07,FDRL/NATIONAL ELECTRONIC F,19792.0,0.0,,2018,4,7,CASH_OUT,19792.0,C1001409363
18717,1196428',2018-04-07,FDRL/NATIONAL ELECTRONIC F,10821.0,0.0,,2018,4,7,PAYEMENT,10821.0,M1340854901
18718,1196428',2018-04-07,FDRL/NATIONAL ELECTRONIC F,11737.0,0.0,,2018,4,7,DEBIT,11737.0,M265997755
18719,1196428',2018-04-07,FDRL/NATIONAL ELECTRONIC F,7271.0,0.0,,2018,4,7,DEBIT,7271.0,M1257695233
18720,1196428',2018-04-07,FDRL/NATIONAL ELECTRONIC F,13084.0,0.0,,2018,4,7,DEBIT,13084.0,C150309335
18721,1196428',2018-04-07,FDRL/NATIONAL ELECTRONIC F,23335.0,0.0,,2018,4,7,CASH_OUT,23335.0,M1572611628
18722,1196428',2018-04-07,FDRL/NATIONAL ELECTRONIC F,24348.0,0.0,,2018,4,7,DEBIT,24348.0,M280183141
18723,1196428',2018-04-07,FDRL/NATIONAL ELECTRONIC F,12715.0,0.0,,2018,4,7,CASH_OUT,12715.0,M808540700
18724,1196428',2018-04-07,FDRL/NATIONAL ELECTRONIC F,26749.0,0.0,,2018,4,7,DEBIT,26749.0,M565481399
18725,1196428',2018-04-07,FDRL/NATIONAL ELECTRONIC F,25597.0,0.0,,2018,4,7,PAYEMENT,25597.0,C842729010
18726,1196428',2018-04-07,FDRL/NATIONAL ELECTRONIC F,23083.0,0.0,,2018,4,7,CASH_OUT,23083.0,M178371442
18727,1196428',2018-04-07,FDRL/NATIONAL ELECTRONIC F,19069.0,0.0,,2018,4,7,DEBIT,19069.0,M2076445832
18728,1196428',2018-04-07,FDRL/NATIONAL ELECTRONIC F,19535.0,0.0,,2018,4,7,CASH_OUT,19535.0,C599968109
18729,1196428',2018-04-07,FDRL/NATIONAL ELECTRONIC F,17271.0,0.0,,2018,4,7,CASH_OUT,17271.0,C599265282
18730,1196428',2018-04-07,FDRL/NATIONAL ELECTRONIC F,20491.0,0.0,,2018,4,7,CASH_OUT,20491.0,C669771073
18731,1196428',2018-04-07,FDRL/NATIONAL ELECTRONIC F,16809.0,0.0,,2018,4,7,CHECK_WITHDRAWAL,16809.0,C2137848242
18732,1196428',2018-04-07,FDRL/NATIONAL ELECTRONIC F,13697.0,0.0,,2018,4,7,DEBIT,13697.0,M997986347
18733,1196428',2018-04-07,FDRL/NATIONAL ELECTRONIC F,26825.0,0.0,,2018,4,7,CASH_OUT,26825.0,M1063792159
18734,1196428',2018-04-07,FDRL/NATIONAL ELECTRONIC F,19424.0,0.0,,2018,4,7,DEBIT,19424.0,C22448303
18735,1196428',2018-04-07,FDRL/NATIONAL ELECTRONIC F,16061.0,0.0,,2018,4,7,PAYEMENT,16061.0,M315692635
18736,1196428',2018-04-07,FDRL/NATIONAL ELECTRONIC F,28525.0,0.0,,2018,4,7,CASH_OUT,28525.0,M803644277
18737,1196428',2018-04-07,FDRL/NATIONAL ELECTRONIC F,19373.0,0.0,,2018,4,7,DEBIT,19373.0,M415913007
18738,1196428',2018-04-07,FDRL/NATIONAL ELECTRONIC F,18092.0,0.0,,2018,4,7,DEBIT,18092.0,M1344197461
18739,1196428',2018-04-07,FDRL/NATIONAL ELECTRONIC F,19252.0,0.0,,2018,4,7,CASH_OUT,19252.0,M132014623
18740,1196428',2018-04-07,NEFT/000035308278/ACCOUNT,0.0,9326.0,,2018,4,7,CASH_IN,9326.0,M577051450
18741,1196428',2018-04-07,NEFT/N097180514900201/PAY,0.0,383765.28,,2018,4,7,TRANSFER,383765.28,C1491676195
18742,1196428',2018-04-07,NEFT/000035308275/INVALID,0.0,18402.0,,2018,4,7,TRANSFER,18402.0,C943166837
18743,1196428',2018-04-07,NEFT/N097180514901366/PAY,0.0,4194754.97,,2018,4,7,TRANSFER,4194754.97,M1402953791
18744,1196428',2018-04-07,TRF FROM  Indiaforensic SERVICES,0.0,500000.0,,2018,4,7,CASH_IN,500000.0,M1974589236
18745,1196428',2018-04-07,TRF FROM  Indiaforensic SERVICES,0.0,500000.0,,2018,4,7,CHECK_CASHING,500000.0,C1701412896
18746,1196428',2018-04-07,NEFT/AXISP18097147619/ACC,0.0,8000000.0,,2018,4,7,TRANSFER,8000000.0,M1355606971
18747,1196428',2018-04-07,FDRL/INTERNAL FUND TRANSFE,5000000.0,0.0,,2018,4,7,CASH_OUT,5000000.0,M1037747072
18748,1196428',2018-04-07,FDRL/INTERNAL FUND TRANSFE,5000000.0,0.0,,2018,4,7,PAYEMENT,5000000.0,M82220349
18749,1196428',2018-04-07,FDRL/INTERNAL FUND TRANSFE,1000000.0,0.0,,2018,4,7,DEBIT,1000000.0,M953439482
18750,1196428',2018-04-07,FDRL/INTERNAL FUND TRANSFE,500000.0,0.0,,2018,4,7,CASH_OUT,500000.0,C1914282536
18751,1196428',2018-04-07,FDRL/INTERNAL FUND TRANSFE,2000000.0,0.0,,2018,4,7,CHECK_WITHDRAWAL,2000000.0,C691636444
18752,1196428',2018-04-07,BEAT CSH PKP DEL GURG6179,0.0,72500.0,,2018,4,7,TRANSFER,72500.0,C683605346
18753,1196428',2018-04-09,CASHDEP/NOIDA/TP,0.0,301000.0,,2018,4,9,TRANSFER,301000.0,M1967366965
18754,1196428',2018-04-09,RTGS/HDFCH18099222246/PAY,0.0,2320000.0,,2018,4,9,CHECK_CASHING,2320000.0,M508405148
18755,1196428',2018-04-09,RTGS/HDFCH18099222253/PAY,0.0,4320000.0,,2018,4,9,TRANSFER,4320000.0,M1295579320
18756,1196428',2018-04-09,NEFT/N099180515482470/ASH,0.0,299.0,,2018,4,9,TRANSFER,299.0,M995168511
18757,1196428',2018-04-09,FDRL/NATIONAL ELECTRONIC F,311556.0,0.0,,2018,4,9,CHECK_WITHDRAWAL,311556.0,M1102425439
18758,1196428',2018-04-09,FDRL/NATIONAL ELECTRONIC F,36410.0,0.0,,2018,4,9,CASH_OUT,36410.0,M590053012
18759,1196428',2018-04-09,FDRL/INTERNAL FUND TRANSFE,1000000.0,0.0,,2018,4,9,DEBIT,1000000.0,M386886002
18760,1196428',2018-04-09,FDRL/REAL TIME GROSS SETTL,3000000.0,0.0,,2018,4,9,DEBIT,3000000.0,M227585143
18761,1196428',2018-04-09,FDRL/REAL TIME GROSS SETTL,3000000.0,0.0,,2018,4,9,DEBIT,3000000.0,M2105068287
18762,1196428',2018-04-09,RTGS/SCBLH18099003042/FIX,0.0,300000.0,,2018,4,9,CASH_IN,300000.0,M1038116064
18763,1196428',2018-04-09,NEFT/SBIN418099051982/Mr,0.0,23600.0,,2018,4,9,CASH_IN,23600.0,M345805867
18764,1196428',2018-04-09,NEFT/N099180515731619/ASH,0.0,71251.0,,2018,4,9,CHECK_CASHING,71251.0,M1128144161
18765,1196428',2018-04-09,TRF FROM  Indiaforensic SERVICES,0.0,15000000.0,,2018,4,9,CHECK_CASHING,15000000.0,M1492172037
18766,1196428',2018-04-09,TRF FROM  Indiaforensic SERVICES,0.0,15000000.0,,2018,4,9,CHECK_CASHING,15000000.0,M731603444
18767,1196428',2018-04-09,TRF FROM  Indiaforensic SERVICES,0.0,13700000.0,,2018,4,9,CASH_IN,13700000.0,M879683510
18768,1196428',2018-04-09,FDRL/REAL TIME GROSS SETTL,15000000.0,0.0,,2018,4,9,PAYEMENT,15000000.0,M555126583
18769,1196428',2018-04-09,FDRL/REAL TIME GROSS SETTL,10000000.0,0.0,,2018,4,9,PAYEMENT,10000000.0,M1344791022
18770,1196428',2018-04-09,FDRL/REAL TIME GROSS SETTL,15000000.0,0.0,,2018,4,9,CASH_OUT,15000000.0,M40493588
18771,1196428',2018-04-09,FDRL/INTERNAL FUND TRANSFE,1000000.0,0.0,,2018,4,9,PAYEMENT,1000000.0,M1099885881
18772,1196428',2018-04-09,NEFT/P18040995672534/KADU,0.0,80000.0,,2018,4,9,CHECK_CASHING,80000.0,M107256650
18773,1196428',2018-04-09,NEFT/N099180516006895/PAY,0.0,578684.12,,2018,4,9,CHECK_CASHING,578684.12,M1410611700
18774,1196428',2018-04-09,CASHPMT/GURGAON/SELF,135000.0,0.0,,2018,4,9,CASH_OUT,135000.0,M954062800
18775,1196428',2018-04-09,Indiaforensic SERVICES INDIA PVT,0.0,729667.0,,2018,4,9,CHECK_CASHING,729667.0,M13013852
18776,1196428',2018-04-09,NEFT/N099180516003065/PAY,0.0,6518588.51,,2018,4,9,TRANSFER,6518588.51,M1101858256
18777,1196428',2018-04-09,FDRL/INTERNAL FUND TRANSFE,500000.0,0.0,,2018,4,9,CHECK_WITHDRAWAL,500000.0,M1180862248
18778,1196428',2018-04-09,TRF FROM  Indiaforensic SERVICES,0.0,10000000.0,,2018,4,9,CHECK_CASHING,10000000.0,M966462848
18779,1196428',2018-04-09,TRF FROM  Indiaforensic SERVICES,0.0,500000.0,,2018,4,9,CHECK_CASHING,500000.0,M1284324188
18780,1196428',2018-04-09,FDRL/INTERNAL FUND TRANSFE,300000.0,0.0,,2018,4,9,PAYEMENT,300000.0,C374625527
18781,1196428',2018-04-09,FDRL/INTERNAL FUND TRANSFE,300000.0,0.0,,2018,4,9,DEBIT,300000.0,C1262822392
18782,1196428',2018-04-09,FDRL/INTERNAL FUND TRANSFE,10000000.0,0.0,,2018,4,9,DEBIT,10000000.0,C1671386208
18783,1196428',2018-04-09,FDRL/INTERNAL FUND TRANSFE,500000.0,0.0,,2018,4,9,DEBIT,500000.0,C1869197498
18784,1196428',2018-04-09,BEAT CSH PKP DEL GURG 617,0.0,284500.0,,2018,4,9,CHECK_CASHING,284500.0,C271488817
18785,1196428',2018-04-09,FDRL/INTERNAL FUND TRANSFE,2000000.0,0.0,,2018,4,9,PAYEMENT,2000000.0,M1915909017
18786,1196428',2018-04-10,NEFT/N100180516356527/KUM,0.0,11800.0,,2018,4,10,CHECK_CASHING,11800.0,C2052185144
18787,1196428',2018-04-10,FDRL/INTERNAL FUND TRANSFE,1000000.0,0.0,,2018,4,10,CHECK_WITHDRAWAL,1000000.0,C646059443
18788,1196428',2018-04-10,FDRL/INTERNAL FUND TRANSFE,500000.0,0.0,,2018,4,10,CHECK_WITHDRAWAL,500000.0,C1982591789
18789,1196428',2018-04-10,FDRL/NATIONAL ELECTRONIC F,47503.0,0.0,,2018,4,10,PAYEMENT,47503.0,C1977614404
18790,1196428',2018-04-10,FDRL/REAL TIME GROSS SETTL,2000000.0,0.0,,2018,4,10,PAYEMENT,2000000.0,C1883840933
18791,1196428',2018-04-10,FDRL/REAL TIME GROSS SETTL,3000000.0,0.0,,2018,4,10,CHECK_WITHDRAWAL,3000000.0,C2007207148
18792,1196428',2018-04-10,FDRL/INTERNAL FUND TRANSFE,1000000.0,0.0,,2018,4,10,PAYEMENT,1000000.0,M1014644493
18793,1196428',2018-04-10,CASHDEP/NOIDA/TP,0.0,102000.0,,2018,4,10,CASH_IN,102000.0,C381605910
18794,1196428',2018-04-10,RTGS/HDFCH18100414367/PAY,0.0,1600000.0,,2018,4,10,TRANSFER,1600000.0,M1056752544
18795,1196428',2018-04-10,RTGS/HDFCH18100416987/PAY,0.0,2720000.0,,2018,4,10,TRANSFER,2720000.0,M729567968
18796,1196428',2018-04-10,FDRL/INTERNAL FUND TRANSFE,500000.0,0.0,,2018,4,10,PAYEMENT,500000.0,M1723507087
18797,1196428',2018-04-10,FDRL/INTERNAL FUND TRANSFE,500000.0,0.0,,2018,4,10,PAYEMENT,500000.0,C849038219
18798,1196428',2018-04-10,FDRL/INTERNAL FUND TRANSFE,500000.0,0.0,,2018,4,10,CASH_OUT,500000.0,C1038678108
18799,1196428',2018-04-10,FDRL/INTERNAL FUND TRANSFE,500000.0,0.0,,2018,4,10,PAYEMENT,500000.0,M1976340229
18800,1196428',2018-04-10,TRF TO  Indiaforensic SERVICES I,240000.0,0.0,,2018,4,10,CHECK_WITHDRAWAL,240000.0,M693274483
18801,1196428',2018-04-10,NEFT/AXISP18100051628/ACC,0.0,3000000.0,,2018,4,10,CASH_IN,3000000.0,M838050003
18802,1196428',2018-04-10,FDRL/INTERNAL FUND TRANSFE,500000.0,0.0,,2018,4,10,DEBIT,500000.0,C1009972184
18803,1196428',2018-04-10,FDRL/INTERNAL FUND TRANSFE,500000.0,0.0,,2018,4,10,CHECK_WITHDRAWAL,500000.0,C63475121
18804,1196428',2018-04-10,FDRL/INTERNAL FUND TRANSFE,500000.0,0.0,,2018,4,10,CASH_OUT,500000.0,C1130075212
18805,1196428',2018-04-10,FDRL/REAL TIME GROSS SETTL,2000000.0,0.0,,2018,4,10,PAYEMENT,2000000.0,C851316413
18806,1196428',2018-04-10,FDRL/REAL TIME GROSS SETTL,2000000.0,0.0,,2018,4,10,CHECK_WITHDRAWAL,2000000.0,M718843573
18807,1196428',2018-04-10,IMPS 810016970011 FROM M,0.0,500.0,,2018,4,10,TRANSFER,500.0,M1217713614
18808,1196428',2018-04-10,NEFT/N100180517004938/PAY,0.0,605921.16,,2018,4,10,CASH_IN,605921.16,M706338650
18809,1196428',2018-04-10,NEFT/N100180517004909/PAY,0.0,582205.95,,2018,4,10,CHECK_CASHING,582205.95,M995800830
18810,1196428',2018-04-10,Indiaforensic SERVICES INDIA PVT,0.0,191870.0,,2018,4,10,TRANSFER,191870.0,C1073259437
18811,1196428',2018-04-10,TRF FROM  Indiaforensic SERVICES,0.0,4900000.0,,2018,4,10,CASH_IN,4900000.0,M1699315785
18812,1196428',2018-04-10,FDRL/INTERNAL FUND TRANSFE,3000000.0,0.0,,2018,4,10,CASH_OUT,3000000.0,M1163711030
18813,1196428',2018-04-10,FDRL/INTERNAL FUND TRANSFE,3000000.0,0.0,,2018,4,10,PAYEMENT,3000000.0,C320106510
18814,1196428',2018-04-10,FDRL/INTERNAL FUND TRANSFE,0.0,3000000.0,,2018,4,10,CHECK_CASHING,3000000.0,M597251930
18815,1196428',2018-04-10,FDRL/INTERNAL FUND TRANSFE,1000000.0,0.0,,2018,4,10,CHECK_WITHDRAWAL,1000000.0,M1515100477
18816,1196428',2018-04-10,FDRL/INTERNAL FUND TRANSFE,2000000.0,0.0,,2018,4,10,CHECK_WITHDRAWAL,2000000.0,M1412315921
18817,1196428',2018-04-10,BEAT CSH PKP DEL GURG 643,0.0,250000.0,,2018,4,10,TRANSFER,250000.0,M1168923345
18818,1196428',2018-04-10,FDRL/INTERNAL FUND TRANSFE,500000.0,0.0,,2018,4,10,CHECK_WITHDRAWAL,500000.0,M2042700604
18819,1196428',2018-04-11,FDRL/NATIONAL ELECTRONIC F,100016.0,0.0,,2018,4,11,CHECK_WITHDRAWAL,100016.0,C710481910
18820,1196428',2018-04-11,TRF FROM  Indiaforensic SERVICES,0.0,10000000.0,,2018,4,11,CHECK_CASHING,10000000.0,M1474634841
18821,1196428',2018-04-11,TRF FROM  Indiaforensic SERVICES,0.0,1000000.0,,2018,4,11,CHECK_CASHING,1000000.0,C669419693
18822,1196428',2018-04-11,TRF FROM  Indiaforensic SERVICES,0.0,500000.0,,2018,4,11,TRANSFER,500000.0,C2095611317
18823,1196428',2018-04-11,FDRL/INTERNAL FUND TRANSFE,500000.0,0.0,,2018,4,11,CHECK_WITHDRAWAL,500000.0,C1316560467
18824,1196428',2018-04-11,FDRL/INTERNAL FUND TRANSFE,500000.0,0.0,,2018,4,11,PAYEMENT,500000.0,M1572144334
18825,1196428',2018-04-11,FDRL/INTERNAL FUND TRANSFE,500000.0,0.0,,2018,4,11,CHECK_WITHDRAWAL,500000.0,M593517569
18826,1196428',2018-04-11,FDRL/INTERNAL FUND TRANSFE,500000.0,0.0,,2018,4,11,CASH_OUT,500000.0,M558730564
18827,1196428',2018-04-11,FDRL/INTERNAL FUND TRANSFE,500000.0,0.0,,2018,4,11,PAYEMENT,500000.0,C736160330
18828,1196428',2018-04-11,FDRL/INTERNAL FUND TRANSFE,500000.0,0.0,,2018,4,11,CHECK_WITHDRAWAL,500000.0,C417236208
18829,1196428',2018-04-11,FDRL/REAL TIME GROSS SETTL,2000000.0,0.0,,2018,4,11,CASH_OUT,2000000.0,C931482420
18830,1196428',2018-04-11,FDRL/REAL TIME GROSS SETTL,3000000.0,0.0,,2018,4,11,DEBIT,3000000.0,M405976415
18831,1196428',2018-04-11,FDRL/REAL TIME GROSS SETTL,3000000.0,0.0,,2018,4,11,PAYEMENT,3000000.0,C208341157
18832,1196428',2018-04-11,RTGS/HDFCH18101575242/PAY,0.0,2480000.0,,2018,4,11,CASH_IN,2480000.0,C382697424
18833,1196428',2018-04-11,RTGS/HDFCH18101575295/PAY,0.0,1600000.0,,2018,4,11,CHECK_CASHING,1600000.0,M875577692
18834,1196428',2018-04-11,FDRL/INTERNAL FUND TRANSFE,500000.0,0.0,,2018,4,11,DEBIT,500000.0,C1822578654
18835,1196428',2018-04-11,CASHDEP/NOIDA/TP,0.0,142000.0,,2018,4,11,CASH_IN,142000.0,M2022435822
18836,1196428',2018-04-11,NEFT/AXISP18101045979/ACC,0.0,3000000.0,,2018,4,11,CHECK_CASHING,3000000.0,M1867372125
18837,1196428',2018-04-11,TRF FROM  Indiaforensic SERVICES,0.0,15000000.0,,2018,4,11,CHECK_CASHING,15000000.0,M556592378
18838,1196428',2018-04-11,TRF FROM  Indiaforensic SERVICES,0.0,13500000.0,,2018,4,11,CHECK_CASHING,13500000.0,C807072084
18839,1196428',2018-04-11,FDRL/REAL TIME GROSS SETTL,15000000.0,0.0,,2018,4,11,CHECK_WITHDRAWAL,15000000.0,C2077098348
18840,1196428',2018-04-11,FDRL/REAL TIME GROSS SETTL,10000000.0,0.0,,2018,4,11,CASH_OUT,10000000.0,M1751878963
18841,1196428',2018-04-11,FDRL/REAL TIME GROSS SETTL,3000000.0,0.0,,2018,4,11,CHECK_WITHDRAWAL,3000000.0,C1618278649
18842,1196428',2018-04-11,RTGS/PUNBH18101165364/SAN,0.0,270000.0,,2018,4,11,TRANSFER,270000.0,C1987564320
18843,1196428',2018-04-11,CASHDEP/GURGAON/,0.0,450000.0,,2018,4,11,TRANSFER,450000.0,M848162783
18844,1196428',2018-04-11,NEFT/N101180517952066/PAY,0.0,277221.8,,2018,4,11,CHECK_CASHING,277221.8,M347906624
18845,1196428',2018-04-11,NEFT/BARBR18101073457/MAK,0.0,50860.0,,2018,4,11,TRANSFER,50860.0,M271658762
18846,1196428',2018-04-11,NEFT/N101180517947053/PAY,0.0,7429444.07,,2018,4,11,CASH_IN,7429444.07,M1403007770
18847,1196428',2018-04-11,NEFT/N101180518006322/TEC,0.0,200000.0,,2018,4,11,CASH_IN,200000.0,M2043631011
18848,1196428',2018-04-11,NEFT/N101180518065491/ASH,0.0,102460.0,,2018,4,11,CHECK_CASHING,102460.0,C107095723
18849,1196428',2018-04-11,FDRL/INTERNAL FUND TRANSFE,300000.0,0.0,,2018,4,11,CASH_OUT,300000.0,C985934102
18850,1196428',2018-04-11,FDRL/INTERNAL FUND TRANSFE,500000.0,0.0,,2018,4,11,CHECK_WITHDRAWAL,500000.0,C824197891
18851,1196428',2018-04-11,BEAT CSH PKP DEL GURG 643,0.0,332000.0,,2018,4,11,TRANSFER,332000.0,C1696218625
18852,1196428',2018-04-11,TRF FROM  Indiaforensic SERVICES,0.0,4500000.0,,2018,4,11,CHECK_CASHING,4500000.0,M1817447589
18853,1196428',2018-04-11,TRF TO  Indiaforensic SERVICES I,1935500.0,0.0,,2018,4,11,CASH_OUT,1935500.0,C168639687
18854,1196428',2018-04-11,FDRL/INTERNAL FUND TRANSFE,10000000.0,0.0,,2018,4,11,CHECK_WITHDRAWAL,10000000.0,C1630293008
18855,1196428',2018-04-11,FDRL/INTERNAL FUND TRANSFE,1000000.0,0.0,,2018,4,11,CHECK_WITHDRAWAL,1000000.0,C1577420620
18856,1196428',2018-04-11,FDRL/INTERNAL FUND TRANSFE,2000000.0,0.0,,2018,4,11,CHECK_WITHDRAWAL,2000000.0,C35263828
18857,1196428',2018-04-12,CASHDEP/NOIDA/TP,0.0,154000.0,,2018,4,12,CASH_IN,154000.0,M2014874822
18858,1196428',2018-04-12,Indiaforensic SERVICES INDIA PVT,0.0,276658.0,,2018,4,12,CASH_IN,276658.0,M1553772873
18859,1196428',2018-04-12,RTGS/HDFCH18102733854/PAY,0.0,1760000.0,,2018,4,12,CHECK_CASHING,1760000.0,C905650857
18860,1196428',2018-04-12,RTGS/HDFCH18102733860/PAY,0.0,2520000.0,,2018,4,12,CHECK_CASHING,2520000.0,C1502287290
18861,1196428',2018-04-12,FDRL/NATIONAL ELECTRONIC F,330886.0,0.0,,2018,4,12,CASH_OUT,330886.0,M1197564988
18862,1196428',2018-04-12,FDRL/REAL TIME GROSS SETTL,2000000.0,0.0,,2018,4,12,CASH_OUT,2000000.0,M1843534160
18863,1196428',2018-04-12,FDRL/INTERNAL FUND TRANSFE,1000000.0,0.0,,2018,4,12,CASH_OUT,1000000.0,C871895680
18864,1196428',2018-04-12,FDRL/INTERNAL FUND TRANSFE,1000000.0,0.0,,2018,4,12,CASH_OUT,1000000.0,C1398530689
18865,1196428',2018-04-12,FDRL/NATIONAL ELECTRONIC F,86004.0,0.0,,2018,4,12,CASH_OUT,86004.0,M834859488
18866,1196428',2018-04-12,FDRL/NATIONAL ELECTRONIC F,96085.0,0.0,,2018,4,12,PAYEMENT,96085.0,M463880076
18867,1196428',2018-04-12,FDRL/NATIONAL ELECTRONIC F,65015.0,0.0,,2018,4,12,DEBIT,65015.0,M1273091698
18868,1196428',2018-04-12,FDRL/NATIONAL ELECTRONIC F,74830.0,0.0,,2018,4,12,CHECK_WITHDRAWAL,74830.0,M134350609
18869,1196428',2018-04-12,FDRL/NATIONAL ELECTRONIC F,56306.0,0.0,,2018,4,12,PAYEMENT,56306.0,M1939822545
18870,1196428',2018-04-12,FDRL/NATIONAL ELECTRONIC F,77833.0,0.0,,2018,4,12,PAYEMENT,77833.0,M1498010747
18871,1196428',2018-04-12,FDRL/NATIONAL ELECTRONIC F,85316.0,0.0,,2018,4,12,DEBIT,85316.0,M615833646
18872,1196428',2018-04-12,FDRL/NATIONAL ELECTRONIC F,71471.0,0.0,,2018,4,12,DEBIT,71471.0,M695601535
18873,1196428',2018-04-12,FDRL/NATIONAL ELECTRONIC F,90689.0,0.0,,2018,4,12,CHECK_WITHDRAWAL,90689.0,M1741551200
18874,1196428',2018-04-12,FDRL/NATIONAL ELECTRONIC F,60656.0,0.0,,2018,4,12,CASH_OUT,60656.0,M533060514
18875,1196428',2018-04-12,FDRL/NATIONAL ELECTRONIC F,97556.0,0.0,,2018,4,12,PAYEMENT,97556.0,M763925237
18876,1196428',2018-04-12,FDRL/NATIONAL ELECTRONIC F,55522.0,0.0,,2018,4,12,PAYEMENT,55522.0,M309397793
18877,1196428',2018-04-12,FDRL/NATIONAL ELECTRONIC F,60739.0,0.0,,2018,4,12,DEBIT,60739.0,M786088183
18878,1196428',2018-04-12,FDRL/NATIONAL ELECTRONIC F,82283.0,0.0,,2018,4,12,CASH_OUT,82283.0,M1362397723
18879,1196428',2018-04-12,FDRL/NATIONAL ELECTRONIC F,113132.0,0.0,,2018,4,12,PAYEMENT,113132.0,M166947904
18880,1196428',2018-04-12,FDRL/NATIONAL ELECTRONIC F,64555.0,0.0,,2018,4,12,CHECK_WITHDRAWAL,64555.0,M39384037
18881,1196428',2018-04-12,FDRL/NATIONAL ELECTRONIC F,162877.0,0.0,,2018,4,12,CHECK_WITHDRAWAL,162877.0,M1475711030
18882,1196428',2018-04-12,FDRL/NATIONAL ELECTRONIC F,224098.0,0.0,,2018,4,12,DEBIT,224098.0,M727579419
18883,1196428',2018-04-12,FDRL/NATIONAL ELECTRONIC F,131224.0,0.0,,2018,4,12,CASH_OUT,131224.0,M654290745
18884,1196428',2018-04-12,FDRL/NATIONAL ELECTRONIC F,164717.0,0.0,,2018,4,12,DEBIT,164717.0,C1559145228
18885,1196428',2018-04-12,FDRL/NATIONAL ELECTRONIC F,150223.0,0.0,,2018,4,12,PAYEMENT,150223.0,M688458571
18886,1196428',2018-04-12,FDRL/NATIONAL ELECTRONIC F,176641.0,0.0,,2018,4,12,DEBIT,176641.0,M1895621189
18887,1196428',2018-04-12,FDRL/NATIONAL ELECTRONIC F,113921.0,0.0,,2018,4,12,PAYEMENT,113921.0,M1516781526
18888,1196428',2018-04-12,FDRL/NATIONAL ELECTRONIC F,256183.0,0.0,,2018,4,12,DEBIT,256183.0,M409559965
18889,1196428',2018-04-12,FDRL/NATIONAL ELECTRONIC F,188166.0,0.0,,2018,4,12,DEBIT,188166.0,M1771169983
18890,1196428',2018-04-12,FDRL/NATIONAL ELECTRONIC F,40180.0,0.0,,2018,4,12,CHECK_WITHDRAWAL,40180.0,C470217116
18891,1196428',2018-04-12,FDRL/NATIONAL ELECTRONIC F,34667.0,0.0,,2018,4,12,DEBIT,34667.0,M585745963
18892,1196428',2018-04-12,FDRL/NATIONAL ELECTRONIC F,35808.0,0.0,,2018,4,12,PAYEMENT,35808.0,M2096974885
18893,1196428',2018-04-12,FDRL/NATIONAL ELECTRONIC F,40843.0,0.0,,2018,4,12,CASH_OUT,40843.0,M1287228290
18894,1196428',2018-04-12,FDRL/NATIONAL ELECTRONIC F,39063.0,0.0,,2018,4,12,PAYEMENT,39063.0,M1178751818
18895,1196428',2018-04-12,FDRL/NATIONAL ELECTRONIC F,35185.0,0.0,,2018,4,12,PAYEMENT,35185.0,M145594829
18896,1196428',2018-04-12,FDRL/NATIONAL ELECTRONIC F,31883.0,0.0,,2018,4,12,DEBIT,31883.0,M1232351629
18897,1196428',2018-04-12,FDRL/NATIONAL ELECTRONIC F,30100.0,0.0,,2018,4,12,CHECK_WITHDRAWAL,30100.0,M1656904340
18898,1196428',2018-04-12,FDRL/NATIONAL ELECTRONIC F,43634.0,0.0,,2018,4,12,CHECK_WITHDRAWAL,43634.0,C24404443
18899,1196428',2018-04-12,FDRL/NATIONAL ELECTRONIC F,46455.0,0.0,,2018,4,12,PAYEMENT,46455.0,C596299019
18900,1196428',2018-04-12,FDRL/NATIONAL ELECTRONIC F,45167.0,0.0,,2018,4,12,PAYEMENT,45167.0,C1983747920
18901,1196428',2018-04-12,FDRL/NATIONAL ELECTRONIC F,47050.0,0.0,,2018,4,12,DEBIT,47050.0,C696705647
18902,1196428',2018-04-12,FDRL/NATIONAL ELECTRONIC F,43310.0,0.0,,2018,4,12,CHECK_WITHDRAWAL,43310.0,C1845765982
18903,1196428',2018-04-12,FDRL/NATIONAL ELECTRONIC F,99193.0,0.0,,2018,4,12,CASH_OUT,99193.0,M877365519
18904,1196428',2018-04-12,FDRL/NATIONAL ELECTRONIC F,43356.0,0.0,,2018,4,12,CASH_OUT,43356.0,C134604590
18905,1196428',2018-04-12,FDRL/NATIONAL ELECTRONIC F,89537.0,0.0,,2018,4,12,DEBIT,89537.0,M1053485132
18906,1196428',2018-04-12,FDRL/NATIONAL ELECTRONIC F,65243.0,0.0,,2018,4,12,CASH_OUT,65243.0,M1698378565
18907,1196428',2018-04-12,FDRL/NATIONAL ELECTRONIC F,51833.0,0.0,,2018,4,12,PAYEMENT,51833.0,M1418167825
18908,1196428',2018-04-12,FDRL/NATIONAL ELECTRONIC F,78380.0,0.0,,2018,4,12,PAYEMENT,78380.0,M915318947
18909,1196428',2018-04-12,FDRL/NATIONAL ELECTRONIC F,74164.0,0.0,,2018,4,12,PAYEMENT,74164.0,M1471526064
18910,1196428',2018-04-12,FDRL/NATIONAL ELECTRONIC F,41758.0,0.0,,2018,4,12,DEBIT,41758.0,C474166728
18911,1196428',2018-04-12,FDRL/NATIONAL ELECTRONIC F,65219.0,0.0,,2018,4,12,PAYEMENT,65219.0,M1777764920
18912,1196428',2018-04-12,FDRL/NATIONAL ELECTRONIC F,82415.0,0.0,,2018,4,12,PAYEMENT,82415.0,C1833549064
18913,1196428',2018-04-12,FDRL/NATIONAL ELECTRONIC F,54814.0,0.0,,2018,4,12,CHECK_WITHDRAWAL,54814.0,M327804056
18914,1196428',2018-04-12,FDRL/INTERNAL FUND TRANSFE,45847.0,0.0,,2018,4,12,CHECK_WITHDRAWAL,45847.0,M939893108
18915,1196428',2018-04-12,FDRL/NATIONAL ELECTRONIC F,30802.0,0.0,,2018,4,12,CASH_OUT,30802.0,C1938462589
18916,1196428',2018-04-12,FDRL/NATIONAL ELECTRONIC F,30326.0,0.0,,2018,4,12,DEBIT,30326.0,M974784761
18917,1196428',2018-04-12,FDRL/NATIONAL ELECTRONIC F,39354.0,0.0,,2018,4,12,CASH_OUT,39354.0,M209997138
18918,1196428',2018-04-12,FDRL/NATIONAL ELECTRONIC F,30359.0,0.0,,2018,4,12,PAYEMENT,30359.0,M359327148
18919,1196428',2018-04-12,FDRL/NATIONAL ELECTRONIC F,48536.0,0.0,,2018,4,12,CHECK_WITHDRAWAL,48536.0,C1519216494
18920,1196428',2018-04-12,FDRL/NATIONAL ELECTRONIC F,40183.0,0.0,,2018,4,12,CHECK_WITHDRAWAL,40183.0,M142106520
18921,1196428',2018-04-12,FDRL/NATIONAL ELECTRONIC F,46277.0,0.0,,2018,4,12,CASH_OUT,46277.0,C1979080020
18922,1196428',2018-04-12,FDRL/NATIONAL ELECTRONIC F,36290.0,0.0,,2018,4,12,PAYEMENT,36290.0,C635281078
18923,1196428',2018-04-12,FDRL/NATIONAL ELECTRONIC F,30933.0,0.0,,2018,4,12,CHECK_WITHDRAWAL,30933.0,C1866672043
18924,1196428',2018-04-12,FDRL/NATIONAL ELECTRONIC F,48173.0,0.0,,2018,4,12,PAYEMENT,48173.0,M155979068
18925,1196428',2018-04-12,FDRL/NATIONAL ELECTRONIC F,40750.0,0.0,,2018,4,12,CHECK_WITHDRAWAL,40750.0,M111496179
18926,1196428',2018-04-12,FDRL/NATIONAL ELECTRONIC F,30578.0,0.0,,2018,4,12,PAYEMENT,30578.0,M1472428747
18927,1196428',2018-04-12,FDRL/NATIONAL ELECTRONIC F,33043.0,0.0,,2018,4,12,CHECK_WITHDRAWAL,33043.0,C1167813715
18928,1196428',2018-04-12,FDRL/NATIONAL ELECTRONIC F,33727.0,0.0,,2018,4,12,DEBIT,33727.0,M235839070
18929,1196428',2018-04-12,FDRL/NATIONAL ELECTRONIC F,9527.0,0.0,,2018,4,12,CHECK_WITHDRAWAL,9527.0,M1881768592
18930,1196428',2018-04-12,FDRL/NATIONAL ELECTRONIC F,35234.0,0.0,,2018,4,12,DEBIT,35234.0,C185503802
18931,1196428',2018-04-12,FDRL/NATIONAL ELECTRONIC F,29514.0,0.0,,2018,4,12,CHECK_WITHDRAWAL,29514.0,C403147759
18932,1196428',2018-04-12,FDRL/NATIONAL ELECTRONIC F,30321.0,0.0,,2018,4,12,DEBIT,30321.0,M1725462644
18933,1196428',2018-04-12,FDRL/NATIONAL ELECTRONIC F,32845.0,0.0,,2018,4,12,PAYEMENT,32845.0,M685639359
18934,1196428',2018-04-12,FDRL/NATIONAL ELECTRONIC F,36630.0,0.0,,2018,4,12,CASH_OUT,36630.0,M499928991
18935,1196428',2018-04-12,FDRL/INTERNAL FUND TRANSFE,46180.0,0.0,,2018,4,12,DEBIT,46180.0,M960322367
18936,1196428',2018-04-12,FDRL/NATIONAL ELECTRONIC F,105548.0,0.0,,2018,4,12,DEBIT,105548.0,M1786085833
18937,1196428',2018-04-12,FDRL/INTERNAL FUND TRANSFE,1000000.0,0.0,,2018,4,12,DEBIT,1000000.0,M718103121
18938,1196428',2018-04-12,NEFT/IDIBH18102234712/PVT,0.0,11800.0,,2018,4,12,CASH_IN,11800.0,M757687320
18939,1196428',2018-04-12,IMPS 810214611021 FROM SA,0.0,30000.0,,2018,4,12,TRANSFER,30000.0,M1144148971
18940,1196428',2018-04-12,TRF FROM  Indiaforensic SERVICES,0.0,15000000.0,,2018,4,12,CASH_IN,15000000.0,M1868505862
18941,1196428',2018-04-12,TRF FROM  Indiaforensic SERVICES,0.0,11000000.0,,2018,4,12,TRANSFER,11000000.0,M1608080402
18942,1196428',2018-04-12,FDRL/REAL TIME GROSS SETTL,10000000.0,0.0,,2018,4,12,PAYEMENT,10000000.0,M1154038476
18943,1196428',2018-04-12,FDRL/REAL TIME GROSS SETTL,15000000.0,0.0,,2018,4,12,PAYEMENT,15000000.0,M1325923139
18944,1196428',2018-04-12,NEFT/N102180518669961/PAY,0.0,576621.04,,2018,4,12,CHECK_CASHING,576621.04,M1396188238
18945,1196428',2018-04-12,FDRL/INTERNAL FUND TRANSFE,1000000.0,0.0,,2018,4,12,DEBIT,1000000.0,M554850979
18946,1196428',2018-04-12,NEFT/N102180518669971/PAY,0.0,3779728.96,,2018,4,12,CASH_IN,3779728.96,M1055780232
18947,1196428',2018-04-12,Indiaforensic SERVICES INDIA PVT,0.0,215978.0,,2018,4,12,CASH_IN,215978.0,M662568271
18948,1196428',2018-04-12,NEFT/AXISP18102082746/ACC,0.0,4000000.0,,2018,4,12,TRANSFER,4000000.0,C1649449847
18949,1196428',2018-04-12,FDRL/INTERNAL FUND TRANSFE,500000.0,0.0,,2018,4,12,CASH_OUT,500000.0,C1198167820
18950,1196428',2018-04-12,FDRL/INTERNAL FUND TRANSFE,300000.0,0.0,,2018,4,12,CASH_OUT,300000.0,C749672494
18951,1196428',2018-04-12,FDRL/INTERNAL FUND TRANSFE,5000000.0,0.0,,2018,4,12,PAYEMENT,5000000.0,C1423992712
18952,1196428',2018-04-12,BEAT CSH PKP DEL GURG 643,0.0,258400.0,,2018,4,12,CASH_IN,258400.0,C313124964
18953,1196428',2018-04-13,FDRL/INTERNAL FUND TRANSFE,2000000.0,0.0,,2018,4,13,PAYEMENT,2000000.0,C500153041
18954,1196428',2018-04-13,CASHDEP/NOIDA/TP,0.0,164000.0,,2018,4,13,CASH_IN,164000.0,C728526866
18955,1196428',2018-04-13,FDRL/NATIONAL ELECTRONIC F,15824.0,0.0,,2018,4,13,DEBIT,15824.0,C40075281
18956,1196428',2018-04-13,FDRL/NATIONAL ELECTRONIC F,379795.0,0.0,,2018,4,13,PAYEMENT,379795.0,C456538529
18957,1196428',2018-04-13,FDRL/NATIONAL ELECTRONIC F,9326.0,0.0,,2018,4,13,DEBIT,9326.0,C2117043942
18958,1196428',2018-04-13,FDRL/NATIONAL ELECTRONIC F,18402.0,0.0,,2018,4,13,CHECK_WITHDRAWAL,18402.0,C1838584624
18959,1196428',2018-04-13,FDRL/NATIONAL ELECTRONIC F,264666.0,0.0,,2018,4,13,PAYEMENT,264666.0,M1733424208
18960,1196428',2018-04-13,RTGS/HDFCH18103912389/PAY,0.0,2120000.0,,2018,4,13,CASH_IN,2120000.0,M1060393794
18961,1196428',2018-04-13,RTGS/HDFCH18103914560/PAY,0.0,1840000.0,,2018,4,13,TRANSFER,1840000.0,M226593165
18962,1196428',2018-04-13,TRF FROM  Indiaforensic SERVICES,0.0,4000000.0,,2018,4,13,CHECK_CASHING,4000000.0,M426584880
18963,1196428',2018-04-13,FDRL/REAL TIME GROSS SETTL,3000000.0,0.0,,2018,4,13,CASH_OUT,3000000.0,C448155494
18964,1196428',2018-04-13,FDRL/REAL TIME GROSS SETTL,3000000.0,0.0,,2018,4,13,CASH_OUT,3000000.0,M1594302764
18965,1196428',2018-04-13,FDRL/REAL TIME GROSS SETTL,2000000.0,0.0,,2018,4,13,CASH_OUT,2000000.0,M271366306
18966,1196428',2018-04-13,TRF FROM  Indiaforensic SERVICES,0.0,1000000.0,,2018,4,13,TRANSFER,1000000.0,C348708793
18967,1196428',2018-04-13,TRF FROM  Indiaforensic SERVICES,0.0,15000000.0,,2018,4,13,CASH_IN,15000000.0,M462659391
18968,1196428',2018-04-13,TRF FROM  Indiaforensic SERVICES,0.0,11000000.0,,2018,4,13,CHECK_CASHING,11000000.0,M547825235
18969,1196428',2018-04-13,CHQ DEP/985/OWDEL1/HDFC/S,0.0,11800.0,,2018,4,13,CASH_IN,11800.0,M1301971459
18970,1196428',2018-04-13,CHQ DEP/72587/OWDEL1/UBIN,0.0,11800.0,,2018,4,13,TRANSFER,11800.0,M1155771218
18971,1196428',2018-04-13,CHQ DEP/205/OWDEL1/HDFC/G,0.0,11800.0,,2018,4,13,CHECK_CASHING,11800.0,M734120998
18972,1196428',2018-04-13,CHQ DEP/743/OWDEL1/HDFC/S,0.0,11800.0,,2018,4,13,CASH_IN,11800.0,M1404561012
18973,1196428',2018-04-13,CHQ DEP/198844/OWDEL1/SBI,0.0,11800.0,,2018,4,13,TRANSFER,11800.0,M1376999853
18974,1196428',2018-04-13,CHQ DEP/229712/OWDEL1/ORB,0.0,11800.0,,2018,4,13,CHECK_CASHING,11800.0,M255307196
18975,1196428',2018-04-13,CHQ DEP/354263/OWDEL1/SBI,0.0,11800.0,,2018,4,13,CHECK_CASHING,11800.0,M11285367
18976,1196428',2018-04-13,CHQ DEP/152/OWDEL1/HDFC/S,0.0,11800.0,,2018,4,13,CHECK_CASHING,11800.0,M714914851
18977,1196428',2018-04-13,CHQ DEP/382/OWDEL1/UCBA/G,0.0,11800.0,,2018,4,13,TRANSFER,11800.0,M1438724935
18978,1196428',2018-04-13,CHQ DEP/74410/OWDEL1/UBIN,0.0,11800.0,,2018,4,13,CASH_IN,11800.0,M662472677
18979,1196428',2018-04-13,FDRL/REAL TIME GROSS SETTL,15000000.0,0.0,,2018,4,13,CHECK_WITHDRAWAL,15000000.0,M1932384587
18980,1196428',2018-04-13,FDRL/REAL TIME GROSS SETTL,10000000.0,0.0,,2018,4,13,PAYEMENT,10000000.0,M719480872
18981,1196428',2018-04-13,FDRL/REAL TIME GROSS SETTL,2000000.0,0.0,,2018,4,13,DEBIT,2000000.0,M1278136570
18982,1196428',2018-04-13,NEFT/BARBR18103761562/MAK,0.0,60560.0,,2018,4,13,CHECK_CASHING,60560.0,M148964727
18983,1196428',2018-04-13,NEFT/P18041395953170/KADU,0.0,120000.0,,2018,4,13,CASH_IN,120000.0,M1177742051
18984,1196428',2018-04-13,NEFT/N103180519584904/PAY,0.0,513755.48,,2018,4,13,CHECK_CASHING,513755.48,M724365571
18985,1196428',2018-04-13,"Indiaforensic USA, INC./USD/1604",0.0,1040996.0,,2018,4,13,CASH_IN,1040996.0,M212535805
18986,1196428',2018-04-13,IRTT00701811156,1292.38,0.0,,2018,4,13,PAYEMENT,1292.38,M1596397541
18987,1196428',2018-04-13,NEFT/N103180519587869/PAY,0.0,3200857.96,,2018,4,13,CASH_IN,3200857.96,M713285225
18988,1196428',2018-04-13,Indiaforensic SERVICES INDIA PVT,0.0,259910.0,,2018,4,13,CASH_IN,259910.0,C2032389005
18989,1196428',2018-04-13,IMPS 810317948542 FROM AR,0.0,100000.0,,2018,4,13,TRANSFER,100000.0,M1156533869
18990,1196428',2018-04-13,NEFT/N103180519659316/PAY,0.0,4500000.0,,2018,4,13,CHECK_CASHING,4500000.0,M105292474
18991,1196428',2018-04-13,NEFT/N103180519742200/ASH,0.0,129997.0,,2018,4,13,TRANSFER,129997.0,M1410438390
18992,1196428',2018-04-13,NEFT/AXISP18103187899/ACC,0.0,6000000.0,,2018,4,13,CASH_IN,6000000.0,M1257755465
18993,1196428',2018-04-13,NEFT/AXISP18103187898/ACC,0.0,10000000.0,,2018,4,13,CASH_IN,10000000.0,M1640401120
18994,1196428',2018-04-13,TRF FROM  Indiaforensic SERVICES,0.0,5400000.0,,2018,4,13,TRANSFER,5400000.0,M1399060771
18995,1196428',2018-04-13,BEAT CSH PKP DEL UDYO6439,0.0,328600.0,,2018,4,13,TRANSFER,328600.0,C1262822392
18996,1196428',2018-04-13,FDRL/INTERNAL FUND TRANSFE,500000.0,0.0,,2018,4,13,DEBIT,500000.0,M148589770
18997,1196428',2018-04-13,FDRL/INTERNAL FUND TRANSFE,500000.0,0.0,,2018,4,13,CASH_OUT,500000.0,M984489239
18998,1196428',2018-04-13,FDRL/INTERNAL FUND TRANSFE,200000.0,0.0,,2018,4,13,DEBIT,200000.0,C2115055717
18999,1196428',2018-04-13,FDRL/INTERNAL FUND TRANSFE,200000.0,0.0,,2018,4,13,CASH_OUT,200000.0,C1166654566
19000,1196428',2018-04-13,FDRL/INTERNAL FUND TRANSFE,2000000.0,0.0,,2018,4,13,PAYEMENT,2000000.0,M88042020
19001,1196428',2018-04-13,FDRL/INTERNAL FUND TRANSFE,2000000.0,0.0,,2018,4,13,CASH_OUT,2000000.0,M717278894
19002,1196428',2018-04-13,FDRL/INTERNAL FUND TRANSFE,1000000.0,0.0,,2018,4,13,PAYEMENT,1000000.0,M129220812
19003,1196428',2018-04-13,FDRL/INTERNAL FUND TRANSFE,5000000.0,0.0,,2018,4,13,CHECK_WITHDRAWAL,5000000.0,M1015272304
19004,1196428',2018-04-13,FDRL/INTERNAL FUND TRANSFE,5000000.0,0.0,,2018,4,13,PAYEMENT,5000000.0,C1007717381
19005,1196428',2018-04-13,FDRL/INTERNAL FUND TRANSFE,10000000.0,0.0,,2018,4,13,PAYEMENT,10000000.0,C1240091493
19006,1196428',2018-04-13,FDRL/INTERNAL FUND TRANSFE,5000000.0,0.0,,2018,4,13,CHECK_WITHDRAWAL,5000000.0,C1396297158
19007,1196428',2018-04-13,FDRL/INTERNAL FUND TRANSFE,1000000.0,0.0,,2018,4,13,CASH_OUT,1000000.0,M705803524
19008,1196428',2018-04-16,FDRL/NATIONAL ELECTRONIC F,32840.0,0.0,,2018,4,16,CASH_OUT,32840.0,C978740207
19009,1196428',2018-04-16,CASHDEP/NOIDA/TP,0.0,160000.0,,2018,4,16,CASH_IN,160000.0,C115885991
19010,1196428',2018-04-16,RTGS/HDFCH18106094921/PAY,0.0,4520000.0,,2018,4,16,CASH_IN,4520000.0,C587433505
19011,1196428',2018-04-16,FDRL/NATIONAL ELECTRONIC F,184507.0,0.0,,2018,4,16,DEBIT,184507.0,C1637186972
19012,1196428',2018-04-16,FDRL/NATIONAL ELECTRONIC F,75622.0,0.0,,2018,4,16,PAYEMENT,75622.0,M190739308
19013,1196428',2018-04-16,FDRL/NATIONAL ELECTRONIC F,158017.0,0.0,,2018,4,16,PAYEMENT,158017.0,C778306577
19014,1196428',2018-04-16,RTGS/HDFCH18106103664/MAH,0.0,250000.0,,2018,4,16,CASH_IN,250000.0,M1863711975
19015,1196428',2018-04-16,FDRL/INTERNAL FUND TRANSFE,1000000.0,0.0,,2018,4,16,DEBIT,1000000.0,M1469855297
19016,1196428',2018-04-16,CHQ DEP/18241/OWDEL1/ORBC,0.0,11800.0,,2018,4,16,TRANSFER,11800.0,M794421806
19017,1196428',2018-04-16,CHQ DEP/176520/OWDEL1/SBI,0.0,11800.0,,2018,4,16,CHECK_CASHING,11800.0,M1334051844
19018,1196428',2018-04-16,CHQ DEP/1287/OWDEL1/HDFC/,0.0,11800.0,,2018,4,16,CHECK_CASHING,11800.0,M515450283
19019,1196428',2018-04-16,CHQ DEP/260181/OWDEL1/SBI,0.0,11800.0,,2018,4,16,CHECK_CASHING,11800.0,M1747790771
19020,1196428',2018-04-16,CHQ DEP/1133/OWDEL1/HDFC/,0.0,11800.0,,2018,4,16,CHECK_CASHING,11800.0,M1284135884
19021,1196428',2018-04-16,CHQ DEP/883/OWDEL1/UCBA/G,0.0,11800.0,,2018,4,16,CASH_IN,11800.0,C420561530
19022,1196428',2018-04-16,CHQ DEP/1244/OWDEL1/UCBA/,0.0,11800.0,,2018,4,16,CHECK_CASHING,11800.0,M694158341
19023,1196428',2018-04-16,CHQ DEP/1572/OWDEL1/HDFC/,0.0,11800.0,,2018,4,16,CASH_IN,11800.0,C2046578329
19024,1196428',2018-04-16,CHQ DEP/135758/OWDEL1/ALL,0.0,11800.0,,2018,4,16,CHECK_CASHING,11800.0,M942812964
19025,1196428',2018-04-16,CHQ DEP/989/OWDEL1/HDFC/R,0.0,11800.0,,2018,4,16,TRANSFER,11800.0,M1977844832
19026,1196428',2018-04-16,CHQ DEP/380223/OWDEL1/CNR,0.0,11800.0,,2018,4,16,CASH_IN,11800.0,M1171276229
19027,1196428',2018-04-16,TRF FROM  Indiaforensic SERVICES,0.0,15000000.0,,2018,4,16,CASH_IN,15000000.0,M1741253456
19028,1196428',2018-04-16,TRF FROM  Indiaforensic SERVICES,0.0,15000000.0,,2018,4,16,CASH_IN,15000000.0,M1549630173
19029,1196428',2018-04-16,TRF FROM  Indiaforensic SERVICES,0.0,15000000.0,,2018,4,16,CASH_IN,15000000.0,C1548218207
19030,1196428',2018-04-16,FDRL/INTERNAL FUND TRANSFE,2000000.0,0.0,,2018,4,16,PAYEMENT,2000000.0,C242559404
19031,1196428',2018-04-16,FDRL/REAL TIME GROSS SETTL,10000000.0,0.0,,2018,4,16,CASH_OUT,10000000.0,C1153596299
19032,1196428',2018-04-16,FDRL/REAL TIME GROSS SETTL,15000000.0,0.0,,2018,4,16,PAYEMENT,15000000.0,M708011911
19033,1196428',2018-04-16,FDRL/REAL TIME GROSS SETTL,15000000.0,0.0,,2018,4,16,PAYEMENT,15000000.0,M1579526490
19034,1196428',2018-04-16,CASHDEP/NOIDA/TP,0.0,94000.0,,2018,4,16,TRANSFER,94000.0,C1924874046
19035,1196428',2018-04-16,TRF FROM  Indiaforensic SERVICES,0.0,15000000.0,,2018,4,16,CASH_IN,15000000.0,C1079343872
19036,1196428',2018-04-16,TRF FROM  Indiaforensic SERVICES,0.0,7300000.0,,2018,4,16,CHECK_CASHING,7300000.0,M1025387324
19037,1196428',2018-04-16,NEFT/N106180520751567/PAY,0.0,1.0,,2018,4,16,CHECK_CASHING,1.0,M2114990234
19038,1196428',2018-04-16,IMPS 810616100119 FROM SA,0.0,200000.0,,2018,4,16,CASH_IN,200000.0,M1843420945
19039,1196428',2018-04-16,FDRL/NATIONAL ELECTRONIC F,10000000.0,0.0,,2018,4,16,CASH_OUT,10000000.0,C863811613
19040,1196428',2018-04-16,NEFT/N106180520747140/PAY,0.0,5294033.05,,2018,4,16,TRANSFER,5294033.05,M1539382844
19041,1196428',2018-04-16,NEFT/N106180520854098/PAY,0.0,108214.46,,2018,4,16,TRANSFER,108214.46,M1846768700
19042,1196428',2018-04-16,FDRL/INTERNAL FUND TRANSFE,1500000.0,0.0,,2018,4,16,PAYEMENT,1500000.0,C1640747200
19043,1196428',2018-04-16,NEFT/N106180520860926/PAY,0.0,2200411.68,,2018,4,16,CASH_IN,2200411.68,M1099038981
19044,1196428',2018-04-16,TRF FROM  Indiaforensic SERVICES,0.0,5000000.0,,2018,4,16,TRANSFER,5000000.0,C344610846
19045,1196428',2018-04-16,TRF FROM  Indiaforensic SERVICES,0.0,2000000.0,,2018,4,16,CASH_IN,2000000.0,C1919277981
19046,1196428',2018-04-16,TRF FROM  Indiaforensic SERVICES,0.0,3000000.0,,2018,4,16,CASH_IN,3000000.0,C2104652067
19047,1196428',2018-04-16,TRF FROM  Indiaforensic SERVICES,0.0,5600000.0,,2018,4,16,CHECK_CASHING,5600000.0,C1092465037
19048,1196428',2018-04-16,FDRL/INTERNAL FUND TRANSFE,15000000.0,0.0,,2018,4,16,PAYEMENT,15000000.0,M995633719
19049,1196428',2018-04-16,FDRL/INTERNAL FUND TRANSFE,15000000.0,0.0,,2018,4,16,CASH_OUT,15000000.0,M938465080
19050,1196428',2018-04-16,FDRL/INTERNAL FUND TRANSFE,2000000.0,0.0,,2018,4,16,CHECK_WITHDRAWAL,2000000.0,M1834981639
19051,1196428',2018-04-16,BEAT CSH PKP DEL GURG 643,0.0,445500.0,,2018,4,16,CASH_IN,445500.0,M1775303360
19052,1196428',2018-04-17,Indiaforensic SERVICES INDIA PVT,0.0,508526.0,,2018,4,17,TRANSFER,508526.0,M261084274
19053,1196428',2018-04-17,FDRL/NATIONAL ELECTRONIC F,404574.0,0.0,,2018,4,17,DEBIT,404574.0,M1007295516
19054,1196428',2018-04-17,FDRL/INTERNAL FUND TRANSFE,1000000.0,0.0,,2018,4,17,PAYEMENT,1000000.0,M470234716
19055,1196428',2018-04-17,RTGS/HDFCH18107290400/PAY,0.0,2560000.0,,2018,4,17,TRANSFER,2560000.0,M905290562
19056,1196428',2018-04-17,FDRL/INTERNAL FUND TRANSFE,1000000.0,0.0,,2018,4,17,DEBIT,1000000.0,M798935213
19057,1196428',2018-04-17,FUJIAN NEWLAND PAYMENT TE,6757118.16,0.0,,2018,4,17,CASH_OUT,6757118.16,M1932154134
19058,1196428',2018-04-17,IMAR00701802187,8516.28,0.0,,2018,4,17,CASH_OUT,8516.28,M1426777731
19059,1196428',2018-04-17,CHQ DEP/143/OWDEL1/UCBA/G,0.0,11800.0,,2018,4,17,CHECK_CASHING,11800.0,M2001931511
19060,1196428',2018-04-17,CHQ DEP/626/OWDEL1/HDFC/G,0.0,11800.0,,2018,4,17,TRANSFER,11800.0,M1028639221
19061,1196428',2018-04-17,CHQ DEP/49/OWDEL1/HDFC/GU,0.0,11800.0,,2018,4,17,CHECK_CASHING,11800.0,M129965176
19062,1196428',2018-04-17,CHQ DEP/157718/OWDEL1/CBI,0.0,11800.0,,2018,4,17,CASH_IN,11800.0,M1666930496
19063,1196428',2018-04-17,CHQ DEP/56009/OWDEL1/SBIN,0.0,11800.0,,2018,4,17,CASH_IN,11800.0,M1348049534
19064,1196428',2018-04-17,CHQ DEP/675627/OWDEL1/PUN,0.0,11800.0,,2018,4,17,CHECK_CASHING,11800.0,M149861385
19065,1196428',2018-04-17,CHQ DEP/463624/OWDEL1/PUN,0.0,11800.0,,2018,4,17,TRANSFER,11800.0,M1803845616
19066,1196428',2018-04-17,CHQ DEP/24680/OWDEL1/PUNB,0.0,11800.0,,2018,4,17,CHECK_CASHING,11800.0,M396463835
19067,1196428',2018-04-17,FDRL/INTERNAL FUND TRANSFE,1000000.0,0.0,,2018,4,17,CHECK_WITHDRAWAL,1000000.0,M1022045468
19068,1196428',2018-04-17,TRF FROM  Indiaforensic SERVICES,0.0,15000000.0,,2018,4,17,TRANSFER,15000000.0,M1556446144
19069,1196428',2018-04-17,TRF FROM  Indiaforensic SERVICES,0.0,13300000.0,,2018,4,17,CASH_IN,13300000.0,M141959252
19070,1196428',2018-04-17,NEFT/SAA131645928/BHAMBRA,0.0,11800.0,,2018,4,17,CASH_IN,11800.0,M1997459283
19071,1196428',2018-04-17,FDRL/REAL TIME GROSS SETTL,15000000.0,0.0,,2018,4,17,PAYEMENT,15000000.0,M539292855
19072,1196428',2018-04-17,FDRL/REAL TIME GROSS SETTL,10000000.0,0.0,,2018,4,17,DEBIT,10000000.0,M878266233
19073,1196428',2018-04-17,CHQ DEPOSIT RETURN/463624,11800.0,0.0,,2018,4,17,PAYEMENT,11800.0,M1660780699
19074,1196428',2018-04-17,NEFT/N107180521628823/PAY,0.0,500206.72,,2018,4,17,CHECK_CASHING,500206.72,M1242431450
19075,1196428',2018-04-17,NEFT/N107180521628800/PAY,0.0,4054013.61,,2018,4,17,CHECK_CASHING,4054013.61,M2075133206
19076,1196428',2018-04-17,FUJIAN NEWLAND PAYMENT TE,62462.5,0.0,,2018,4,17,CHECK_WITHDRAWAL,62462.5,M1651383848
19077,1196428',2018-04-17,IMAR00701802199,997.43,0.0,,2018,4,17,DEBIT,997.43,M1364290623
19078,1196428',2018-04-17,Indiaforensic SERVICES INDIA PVT,0.0,229388.0,,2018,4,17,CASH_IN,229388.0,M1119145556
19079,1196428',2018-04-17,TRF FROM  Indiaforensic SERVICES,0.0,4200000.0,,2018,4,17,CASH_IN,4200000.0,M552762676
19080,1196428',2018-04-17,BEAT CSH PKP DEL GURG 643,0.0,198000.0,,2018,4,17,TRANSFER,198000.0,M1549335447
19081,1196428',2018-04-17,FDRL/INTERNAL FUND TRANSFE,5000000.0,0.0,,2018,4,17,PAYEMENT,5000000.0,M1407332998
19082,1196428',2018-04-17,FDRL/INTERNAL FUND TRANSFE,5000000.0,0.0,,2018,4,17,DEBIT,5000000.0,M575173490
19083,1196428',2018-04-17,FDRL/INTERNAL FUND TRANSFE,4000000.0,0.0,,2018,4,17,CHECK_WITHDRAWAL,4000000.0,M1463959599
19084,1196428',2018-04-17,FDRL/INTERNAL FUND TRANSFE,200000.0,0.0,,2018,4,17,CHECK_WITHDRAWAL,200000.0,C191614132
19085,1196428',2018-04-17,FDRL/INTERNAL FUND TRANSFE,500000.0,0.0,,2018,4,17,DEBIT,500000.0,C1885712019
19086,1196428',2018-04-17,CHQ DEPOSIT RETURN/463624,100.0,0.0,,2018,4,17,PAYEMENT,100.0,M1406881784
19087,1196428',2018-04-17,CHQ DEPOSIT RETURN/463624,18.0,0.0,,2018,4,17,DEBIT,18.0,C1161865950
19088,1196428',2018-04-18,RTGS/SBINH18108002152/Indfor,0.0,1000000.0,,2018,4,18,TRANSFER,1000000.0,M1558051277
19089,1196428',2018-04-18,FDRL/NATIONAL ELECTRONIC F,223058.0,0.0,,2018,4,18,CHECK_WITHDRAWAL,223058.0,M1173085824
19090,1196428',2018-04-18,RTGS/HDFCH18108459898/PAY,0.0,2360000.0,,2018,4,18,TRANSFER,2360000.0,M569018137
19091,1196428',2018-04-18,RTGS/HDFCH18108459923/PAY,0.0,2560000.0,,2018,4,18,CASH_IN,2560000.0,M1770271962
19092,1196428',2018-04-18,FDRL/INTERNAL FUND TRANSFE,1000000.0,0.0,,2018,4,18,CHECK_WITHDRAWAL,1000000.0,M1586738337
19093,1196428',2018-04-18,TRF FROM  Indiaforensic SERVICES,0.0,2100000.0,,2018,4,18,CHECK_CASHING,2100000.0,M1674738101
19094,1196428',2018-04-18,NEFT/20503604711DC/ARTHAS,0.0,150000.0,,2018,4,18,TRANSFER,150000.0,C1590550415
19095,1196428',2018-04-18,FDRL/REAL TIME GROSS SETTL,2000000.0,0.0,,2018,4,18,CASH_OUT,2000000.0,C705321061
19096,1196428',2018-04-18,FDRL/REAL TIME GROSS SETTL,2000000.0,0.0,,2018,4,18,CHECK_WITHDRAWAL,2000000.0,M873689156
19097,1196428',2018-04-18,TELEPOWER COMMUNICATION C,1485950.0,0.0,,2018,4,18,CASH_OUT,1485950.0,M1538317866
19098,1196428',2018-04-18,IMAR00701802234,3859.25,0.0,,2018,4,18,CHECK_WITHDRAWAL,3859.25,C262828207
19099,1196428',2018-04-18,FDRL/INTERNAL FUND TRANSFE,500000.0,0.0,,2018,4,18,CHECK_WITHDRAWAL,500000.0,C1222590577
19100,1196428',2018-04-18,NEFT/IT36701804182322/FIX,0.0,100000.0,,2018,4,18,CASH_IN,100000.0,M2089852906
19101,1196428',2018-04-18,NEFT/SBIN118108869933/KAL,0.0,11800.0,,2018,4,18,CHECK_CASHING,11800.0,M629502621
19102,1196428',2018-04-18,"Indiaforensic USA, INC./USD/1998",0.0,1310082.3,,2018,4,18,CHECK_CASHING,1310082.3,M511596806
19103,1196428',2018-04-18,IRTT00701811550,1340.81,0.0,,2018,4,18,CASH_OUT,1340.81,M2079635991
19104,1196428',2018-04-18,FDRL/INTERNAL FUND TRANSFE,200000.0,0.0,,2018,4,18,CHECK_WITHDRAWAL,200000.0,M1044456366
19105,1196428',2018-04-18,FDRL/INTERNAL FUND TRANSFE,300000.0,0.0,,2018,4,18,CASH_OUT,300000.0,C1689840534
19106,1196428',2018-04-18,"Indiaforensic USA, INC./USD/2354",0.0,1543505.85,,2018,4,18,CHECK_CASHING,1543505.85,M1092817314
19107,1196428',2018-04-18,IRTT00701811546,1382.83,0.0,,2018,4,18,PAYEMENT,1382.83,C1475909248
19108,1196428',2018-04-18,FDRL/INTERNAL FUND TRANSFE,1000000.0,0.0,,2018,4,18,PAYEMENT,1000000.0,M2040472550
19109,1196428',2018-04-18,CASHDEP/VIKASMARG/TP,0.0,134000.0,,2018,4,18,CASH_IN,134000.0,C979719862
19110,1196428',2018-04-18,NEFT/AXIR181080000149/PER,0.0,200000.0,,2018,4,18,CASH_IN,200000.0,C985934102
19111,1196428',2018-04-18,FDRL/REAL TIME GROSS SETTL,2000000.0,0.0,,2018,4,18,DEBIT,2000000.0,C731253803
19112,1196428',2018-04-18,TRF FROM  Indiaforensic SERVICES,0.0,15000000.0,,2018,4,18,CASH_IN,15000000.0,C1609562230
19113,1196428',2018-04-18,TRF FROM  Indiaforensic SERVICES,0.0,12700000.0,,2018,4,18,CHECK_CASHING,12700000.0,M1076923640
19114,1196428',2018-04-18,FDRL/REAL TIME GROSS SETTL,15000000.0,0.0,,2018,4,18,CASH_OUT,15000000.0,M1144262832
19115,1196428',2018-04-18,FDRL/REAL TIME GROSS SETTL,10000000.0,0.0,,2018,4,18,PAYEMENT,10000000.0,M942922351
19116,1196428',2018-04-18,FDRL/INTERNAL FUND TRANSFE,1000000.0,0.0,,2018,4,18,DEBIT,1000000.0,M1582038853
19117,1196428',2018-04-18,NEFT/N108180522345789/PAY,0.0,677874.32,,2018,4,18,TRANSFER,677874.32,M36034212
19118,1196428',2018-04-18,NEFT/N108180522352742/PAY,0.0,4927995.93,,2018,4,18,CASH_IN,4927995.93,M1326356346
19119,1196428',2018-04-18,NEFT/SBIN218108119984/SAM,0.0,2000.0,,2018,4,18,CASH_IN,2000.0,C27489818
19120,1196428',2018-04-18,TRF FROM  Indiaforensic SERVICES,0.0,6400000.0,,2018,4,18,CASH_IN,6400000.0,C747979499
19121,1196428',2018-04-18,FDRL/INTERNAL FUND TRANSFE,10000000.0,0.0,,2018,4,18,CHECK_WITHDRAWAL,10000000.0,C1660095722
19122,1196428',2018-04-18,FDRL/INTERNAL FUND TRANSFE,1000000.0,0.0,,2018,4,18,PAYEMENT,1000000.0,C372017580
19123,1196428',2018-04-18,FDRL/INTERNAL FUND TRANSFE,2000000.0,0.0,,2018,4,18,PAYEMENT,2000000.0,M370179552
19124,1196428',2018-04-18,FDRL/INTERNAL FUND TRANSFE,500000.0,0.0,,2018,4,18,CASH_OUT,500000.0,C802935635
19125,1196428',2018-04-18,FDRL/INTERNAL FUND TRANSFE,500000.0,0.0,,2018,4,18,CHECK_WITHDRAWAL,500000.0,M1523086740
19126,1196428',2018-04-19,NEFT/N109180522579819/ASH,0.0,100599.0,,2018,4,19,TRANSFER,100599.0,M902885640
19127,1196428',2018-04-19,FDRL/NATIONAL ELECTRONIC F,264686.0,0.0,,2018,4,19,PAYEMENT,264686.0,C459172227
19128,1196428',2018-04-19,RTGS/HDFCH18109614389/PAY,0.0,2440000.0,,2018,4,19,TRANSFER,2440000.0,C265108079
19129,1196428',2018-04-19,RTGS/HDFCH18109628649/PAY,0.0,1760000.0,,2018,4,19,CASH_IN,1760000.0,C35126588
19130,1196428',2018-04-19,FDRL/INTERNAL FUND TRANSFE,500000.0,0.0,,2018,4,19,PAYEMENT,500000.0,C1589477624
19131,1196428',2018-04-19,FDRL/REAL TIME GROSS SETTL,2000000.0,0.0,,2018,4,19,CHECK_WITHDRAWAL,2000000.0,C1283595719
19132,1196428',2018-04-19,FDRL/REAL TIME GROSS SETTL,2000000.0,0.0,,2018,4,19,CHECK_WITHDRAWAL,2000000.0,C101084405
19133,1196428',2018-04-19,NEFT/BARBT18109326430/MAK,0.0,50550.0,,2018,4,19,TRANSFER,50550.0,M7891579
19134,1196428',2018-04-19,CHQ DEP/671/OWDEL1/ORBC/H,0.0,11800.0,,2018,4,19,TRANSFER,11800.0,M150228660
19135,1196428',2018-04-19,NEFT/20505062921DC/ARTHAS,0.0,25000.0,,2018,4,19,CASH_IN,25000.0,M190019040
19136,1196428',2018-04-19,NEFT/FDRLH18109393490/SRE,0.0,20000.0,,2018,4,19,TRANSFER,20000.0,M1462909495
19137,1196428',2018-04-19,TRF FROM  Indiaforensic SERVICES,0.0,500000.0,,2018,4,19,CHECK_CASHING,500000.0,C1192983708
19138,1196428',2018-04-19,TRF FROM  Indiaforensic SERVICES,0.0,2000000.0,,2018,4,19,CHECK_CASHING,2000000.0,M1730398598
19139,1196428',2018-04-19,TRF FROM  Indiaforensic SERVICES,0.0,5000000.0,,2018,4,19,TRANSFER,5000000.0,M1492635498
19140,1196428',2018-04-19,TRF FROM  Indiaforensic SERVICES,0.0,15000000.0,,2018,4,19,TRANSFER,15000000.0,M738483886
19141,1196428',2018-04-19,TRF FROM  Indiaforensic SERVICES,0.0,15000000.0,,2018,4,19,CHECK_CASHING,15000000.0,M1583014678
19142,1196428',2018-04-19,FDRL/REAL TIME GROSS SETTL,15000000.0,0.0,,2018,4,19,CHECK_WITHDRAWAL,15000000.0,C395114097
19143,1196428',2018-04-19,FDRL/REAL TIME GROSS SETTL,15000000.0,0.0,,2018,4,19,CHECK_WITHDRAWAL,15000000.0,M743943553
19144,1196428',2018-04-19,FDRL/INTERNAL FUND TRANSFE,500000.0,0.0,,2018,4,19,CASH_OUT,500000.0,M2034445578
19145,1196428',2018-04-19,NEFT/SBIN218109819938/SUP,0.0,11800.0,,2018,4,19,CHECK_CASHING,11800.0,C1383942363
19146,1196428',2018-04-19,NEFT/N109180523004083/PAY,0.0,496622.96,,2018,4,19,TRANSFER,496622.96,M72285092
19147,1196428',2018-04-19,NEFT/FDRL807722660/URANGAT,0.0,11800.0,,2018,4,19,CHECK_CASHING,11800.0,M586185216
19148,1196428',2018-04-19,Indiaforensic SERVICES INDIA PVT,0.0,274431.0,,2018,4,19,CASH_IN,274431.0,M1378755468
19149,1196428',2018-04-19,FDRL/REAL TIME GROSS SETTL,2000000.0,0.0,,2018,4,19,PAYEMENT,2000000.0,C765980478
19150,1196428',2018-04-19,FDRL/REAL TIME GROSS SETTL,2000000.0,0.0,,2018,4,19,DEBIT,2000000.0,C1200314947
19151,1196428',2018-04-19,IMPS 810916397290 FROM PU,0.0,15000.0,,2018,4,19,TRANSFER,15000.0,C1973491942
19152,1196428',2018-04-19,NEFT/N109180523003986/PAY,0.0,3717584.73,,2018,4,19,CASH_IN,3717584.73,C1689374891
19153,1196428',2018-04-19,RTGS/DLXBH18109500738/KAD,0.0,200000.0,,2018,4,19,CASH_IN,200000.0,C2053639017
19154,1196428',2018-04-19,NEFT/SBIN218109883222/MAD,0.0,11800.0,,2018,4,19,TRANSFER,11800.0,C1654056127
19155,1196428',2018-04-19,NEFT/N109180523169933/TEC,0.0,100000.0,,2018,4,19,CASH_IN,100000.0,C803368825
19156,1196428',2018-04-19,TRF FROM  Indiaforensic SERVICES,0.0,500000.0,,2018,4,19,CASH_IN,500000.0,C892686452
19157,1196428',2018-04-19,TRF FROM  Indiaforensic SERVICES,0.0,1000000.0,,2018,4,19,TRANSFER,1000000.0,C2031563133
19158,1196428',2018-04-19,TRF FROM  Indiaforensic SERVICES,0.0,5000000.0,,2018,4,19,TRANSFER,5000000.0,C1619402333
19159,1196428',2018-04-19,FDRL/INTERNAL FUND TRANSFE,10000000.0,0.0,,2018,4,19,DEBIT,10000000.0,C1149273771
19160,1196428',2018-04-19,FDRL/INTERNAL FUND TRANSFE,4000000.0,0.0,,2018,4,19,CASH_OUT,4000000.0,C2109470512
19161,1196428',2018-04-20,FDRL/INTERNAL FUND TRANSFE,46065.65,0.0,,2018,4,20,DEBIT,46065.65,C1059781259
19162,1196428',2018-04-20,FDRL/NATIONAL ELECTRONIC F,47390.0,0.0,,2018,4,20,DEBIT,47390.0,C125722707
19163,1196428',2018-04-20,IMPS 811011353373 FROM SA,0.0,50000.0,,2018,4,20,CHECK_CASHING,50000.0,C1778300121
19164,1196428',2018-04-20,RTGS/HDFCH18110798102/PAY,0.0,2080000.0,,2018,4,20,TRANSFER,2080000.0,C313124964
19165,1196428',2018-04-20,RTGS/HDFCH18110791934/PAY,0.0,1600000.0,,2018,4,20,TRANSFER,1600000.0,C1220897602
19166,1196428',2018-04-20,NEFT/20506260331DC/ARTHAS,0.0,25595.0,,2018,4,20,CHECK_CASHING,25595.0,C1515704208
19167,1196428',2018-04-20,FDRL/INTERNAL FUND TRANSFE,1000000.0,0.0,,2018,4,20,PAYEMENT,1000000.0,C1313534832
19168,1196428',2018-04-20,FDRL/REAL TIME GROSS SETTL,3000000.0,0.0,,2018,4,20,CHECK_WITHDRAWAL,3000000.0,C1141137903
19169,1196428',2018-04-20,CHQ DEP/305925/OWDEL1/SBI,0.0,11800.0,,2018,4,20,CASH_IN,11800.0,C1869228744
19170,1196428',2018-04-20,CHQ DEP/378826/OWDEL1/SBI,0.0,11800.0,,2018,4,20,TRANSFER,11800.0,C2078250226
19171,1196428',2018-04-20,CHQ DEP/20890/OWDEL1/UTIB,0.0,11800.0,,2018,4,20,CASH_IN,11800.0,C1300519073
19172,1196428',2018-04-20,CHQ DEP/397308/OWDEL1/SBI,0.0,11800.0,,2018,4,20,CASH_IN,11800.0,M1808484670
19173,1196428',2018-04-20,CHQ DEP/22452/OWDEL1/CBIN,0.0,11800.0,,2018,4,20,TRANSFER,11800.0,M829035073
19174,1196428',2018-04-20,CHQ DEP/668805/OWDEL1/CNR,0.0,11800.0,,2018,4,20,TRANSFER,11800.0,M1674174327
19175,1196428',2018-04-20,CHQ DEP/507185/OWDEL1/PUN,0.0,11800.0,,2018,4,20,TRANSFER,11800.0,M2135203084
19176,1196428',2018-04-20,CHQ DEP/944804/OWDEL1/ICI,0.0,11800.0,,2018,4,20,CHECK_CASHING,11800.0,C1673971173
19177,1196428',2018-04-20,CHQ DEP/430640/OWDEL1/SBI,0.0,11800.0,,2018,4,20,CHECK_CASHING,11800.0,C339099861
19178,1196428',2018-04-20,CHQ DEP/378823/OWDEL1/SBI,0.0,11800.0,,2018,4,20,CASH_IN,11800.0,M2045422556
19179,1196428',2018-04-20,CHQ DEP/13651/OWDEL1/PUNB,0.0,11800.0,,2018,4,20,CHECK_CASHING,11800.0,C1266035080
19180,1196428',2018-04-20,CHQ DEP/86946/OWDEL1/PUNB,0.0,11800.0,,2018,4,20,TRANSFER,11800.0,C1060041730
19181,1196428',2018-04-20,CHQ DEP/342541/OWDEL1/ICI,0.0,11800.0,,2018,4,20,TRANSFER,11800.0,C1475395523
19182,1196428',2018-04-20,CHQ DEP/317433/OWDEL1/SBI,0.0,11800.0,,2018,4,20,TRANSFER,11800.0,C265845794
19183,1196428',2018-04-20,CHQ DEP/65245/OWDEL1/CORP,0.0,11800.0,,2018,4,20,CASH_IN,11800.0,C58091972
19184,1196428',2018-04-20,CHQ DEP/900357/OWDEL1/VIJ,0.0,11800.0,,2018,4,20,TRANSFER,11800.0,C193864812
19185,1196428',2018-04-20,CHQ DEP/338/OWDEL1/HDFC/R,0.0,11800.0,,2018,4,20,CASH_IN,11800.0,C681835572
19186,1196428',2018-04-20,CHQ DEP/25/OWDEL1/ICIC/,0.0,11800.0,,2018,4,20,CHECK_CASHING,11800.0,C965197768
19187,1196428',2018-04-20,CHQ DEP/354484/OWDEL1/SBI,0.0,11800.0,,2018,4,20,CASH_IN,11800.0,C893038039
19188,1196428',2018-04-20,CHQ DEP/376390/OWDEL1/SBI,0.0,11800.0,,2018,4,20,TRANSFER,11800.0,C1317731757
19189,1196428',2018-04-20,CHQ DEP/692390/OWDEL1/ICI,0.0,11800.0,,2018,4,20,TRANSFER,11800.0,C1373467808
19190,1196428',2018-04-20,CHQ DEP/14299/OWDEL1/ORBC,0.0,11800.0,,2018,4,20,CHECK_CASHING,11800.0,C1318822808
19191,1196428',2018-04-20,CHQ DEP/564576/OWDEL1/PUN,0.0,11800.0,,2018,4,20,CASH_IN,11800.0,C1424731356
19192,1196428',2018-04-20,CHQ DEP/333442/OWDEL1/SBI,0.0,11800.0,,2018,4,20,CASH_IN,11800.0,C1439007204
19193,1196428',2018-04-20,CHQ DEP/324129/OWDEL1/SBI,0.0,11800.0,,2018,4,20,TRANSFER,11800.0,C1116292004
19194,1196428',2018-04-20,CHQ DEP/211/OWDEL1/HDFC/,0.0,11800.0,,2018,4,20,TRANSFER,11800.0,C638551812
19195,1196428',2018-04-20,CHQ DEP/444326/OWDEL1/PUN,0.0,11800.0,,2018,4,20,CASH_IN,11800.0,C193826743
19196,1196428',2018-04-20,CHQ DEP/420614/OWDEL1/SBI,0.0,11800.0,,2018,4,20,TRANSFER,11800.0,C309167705
19197,1196428',2018-04-20,CHQ DEP/445644/OWDEL1/SBI,0.0,11800.0,,2018,4,20,CHECK_CASHING,11800.0,C811597470
19198,1196428',2018-04-20,CHQ DEP/237442/OWDEL1/PUN,0.0,11800.0,,2018,4,20,CHECK_CASHING,11800.0,C1014923261
19199,1196428',2018-04-20,CHQ DEP/278777/OWDEL1/SBI,0.0,11800.0,,2018,4,20,CHECK_CASHING,11800.0,C925574515
19200,1196428',2018-04-20,CHQ DEP/165/OWDEL1/BARB/N,0.0,11800.0,,2018,4,20,CASH_IN,11800.0,C1988152146
19201,1196428',2018-04-20,CHQ DEP/611089/OWDEL1/PUN,0.0,11800.0,,2018,4,20,CASH_IN,11800.0,C71555810
19202,1196428',2018-04-20,CHQ DEP/34645/OWDEL1/CBIN,0.0,11800.0,,2018,4,20,TRANSFER,11800.0,C1273939873
19203,1196428',2018-04-20,CHQ DEP/211339/OWDEL1/STB,0.0,11800.0,,2018,4,20,TRANSFER,11800.0,C749672494
19204,1196428',2018-04-20,CHQ DEP/457784/OWDEL1/SBI,0.0,11800.0,,2018,4,20,TRANSFER,11800.0,C1504109395
19205,1196428',2018-04-20,CHQ DEP/467925/OWDEL1/SBI,0.0,11800.0,,2018,4,20,TRANSFER,11800.0,C2107268831
19206,1196428',2018-04-20,CHQ DEP/425655/OWDEL1/SBI,0.0,11800.0,,2018,4,20,TRANSFER,11800.0,C1141137903
19207,1196428',2018-04-20,CHQ DEP/340108/OWDEL1/SBI,0.0,11800.0,,2018,4,20,CHECK_CASHING,11800.0,M492166970
19208,1196428',2018-04-20,CHQ DEP/311101/OWDEL1/PUN,0.0,11800.0,,2018,4,20,CASH_IN,11800.0,C762570948
19209,1196428',2018-04-20,CHQ DEP/39869/OWDEL1/ORBC,0.0,11800.0,,2018,4,20,TRANSFER,11800.0,C1440282299
19210,1196428',2018-04-20,CHQ DEP/177334/OWDEL1/SBI,0.0,11800.0,,2018,4,20,TRANSFER,11800.0,M1583639547
19211,1196428',2018-04-20,CHQ DEP/76383/OWDEL1/PUNB,0.0,11800.0,,2018,4,20,CHECK_CASHING,11800.0,M1476691574
19212,1196428',2018-04-20,CHQ DEP/570870/OWDEL1/SBI,0.0,11800.0,,2018,4,20,TRANSFER,11800.0,C893339434
19213,1196428',2018-04-20,CHQ DEP/417698/OWDEL1/SBI,0.0,11800.0,,2018,4,20,TRANSFER,11800.0,M722806861
19214,1196428',2018-04-20,CHQ DEP/815669/OWDEL1/PUN,0.0,11800.0,,2018,4,20,TRANSFER,11800.0,C1150610696
19215,1196428',2018-04-20,CHQ DEP/911054/OWDEL1/PUN,0.0,11800.0,,2018,4,20,TRANSFER,11800.0,C1674899618
19216,1196428',2018-04-20,CHQ DEP/3192/OWDEL1/CORP/,0.0,11800.0,,2018,4,20,CHECK_CASHING,11800.0,M481126602
19217,1196428',2018-04-20,CHQ DEP/443378/OWDEL1/SBI,0.0,11800.0,,2018,4,20,CASH_IN,11800.0,C1793325972
19218,1196428',2018-04-20,CHQ DEP/303264/OWDEL1/SBI,0.0,11800.0,,2018,4,20,CHECK_CASHING,11800.0,M132360639
19219,1196428',2018-04-20,CHQ DEP/301734/OWDEL1/SBI,0.0,11800.0,,2018,4,20,TRANSFER,11800.0,M2052092920
19220,1196428',2018-04-20,CHQ DEP/705073/OWDEL1/PUN,0.0,11800.0,,2018,4,20,TRANSFER,11800.0,M236650472
19221,1196428',2018-04-20,CHQ DEP/6442/OWDEL1/UTIB/,0.0,11800.0,,2018,4,20,TRANSFER,11800.0,M2089634452
19222,1196428',2018-04-20,CHQ DEP/301889/OWDEL1/SBI,0.0,11800.0,,2018,4,20,CASH_IN,11800.0,M1097809105
19223,1196428',2018-04-20,CHQ DEP/304948/OWDEL1/SBI,0.0,11800.0,,2018,4,20,CASH_IN,11800.0,C302025300
19224,1196428',2018-04-20,CHQ DEP/642/OWDEL1/CORP/N,0.0,11800.0,,2018,4,20,CHECK_CASHING,11800.0,M134742492
19225,1196428',2018-04-20,CHQ DEP/349902/OWDEL1/SBI,0.0,11800.0,,2018,4,20,TRANSFER,11800.0,C1511785794
19226,1196428',2018-04-20,CHQ DEP/644633/OWDEL1/PUN,0.0,11800.0,,2018,4,20,CASH_IN,11800.0,M1604293868
19227,1196428',2018-04-20,CHQ DEP/26902/OWDEL1/MAHB,0.0,11800.0,,2018,4,20,CHECK_CASHING,11800.0,M1853641629
19228,1196428',2018-04-20,CHQ DEP/20834/OWDEL1/ORBC,0.0,11800.0,,2018,4,20,CHECK_CASHING,11800.0,M710600916
19229,1196428',2018-04-20,CHQ DEP/106/OWDEL1/HDFC/,0.0,11800.0,,2018,4,20,CASH_IN,11800.0,M985323561
19230,1196428',2018-04-20,CHQ DEP/253360/OWDEL1/SBI,0.0,11800.0,,2018,4,20,CHECK_CASHING,11800.0,M1194715097
19231,1196428',2018-04-20,CHQ DEP/18056/OWDEL1/SBIN,0.0,11800.0,,2018,4,20,CHECK_CASHING,11800.0,M693684695
19232,1196428',2018-04-20,CHQ DEP/455279/OWDEL1/COR,0.0,11800.0,,2018,4,20,TRANSFER,11800.0,M1582319135
19233,1196428',2018-04-20,CHQ DEP/720903/OWDEL1/PUN,0.0,11800.0,,2018,4,20,CHECK_CASHING,11800.0,M227290600
19234,1196428',2018-04-20,CHQ DEP/828/OWDEL1/ORBC/M,0.0,11800.0,,2018,4,20,CHECK_CASHING,11800.0,M2089806029
19235,1196428',2018-04-20,CHQ DEP/704052/OWDEL1/PUN,0.0,11800.0,,2018,4,20,CASH_IN,11800.0,M1477278751
19236,1196428',2018-04-20,CHQ DEP/658727/OWDEL1/SBI,0.0,11800.0,,2018,4,20,CASH_IN,11800.0,M1650385017
19237,1196428',2018-04-20,CHQ DEP/677573/OWDEL1/PUN,0.0,11800.0,,2018,4,20,CASH_IN,11800.0,M1921059756
19238,1196428',2018-04-20,CHQ DEP/317366/OWDEL1/SBI,0.0,11800.0,,2018,4,20,CASH_IN,11800.0,M590434145
19239,1196428',2018-04-20,CHQ DEP/45/OWDEL1/HDFC/,0.0,11800.0,,2018,4,20,TRANSFER,11800.0,M1671621366
19240,1196428',2018-04-20,CHQ DEP/390783/OWDEL1/PUN,0.0,11800.0,,2018,4,20,CASH_IN,11800.0,M899686935
19241,1196428',2018-04-20,CHQ DEP/5874/OWDEL1/ALLA/,0.0,11800.0,,2018,4,20,CHECK_CASHING,11800.0,M2054039573
19242,1196428',2018-04-20,CHQ DEP/51/OWDEL1/HDFC/NE,0.0,11800.0,,2018,4,20,CASH_IN,11800.0,M1271480561
19243,1196428',2018-04-20,CHQ DEP/78568/OWDEL1/CORP,0.0,11800.0,,2018,4,20,CHECK_CASHING,11800.0,C1259769769
19244,1196428',2018-04-20,CHQ DEP/557316/OWDEL1/PUN,0.0,11800.0,,2018,4,20,CASH_IN,11800.0,M649539827
19245,1196428',2018-04-20,CHQ DEP/325743/OWDEL1/SBI,0.0,11800.0,,2018,4,20,TRANSFER,11800.0,C893350828
19246,1196428',2018-04-20,CHQ DEP/287781/OWDEL1/PUN,0.0,11800.0,,2018,4,20,TRANSFER,11800.0,M20364107
19247,1196428',2018-04-20,CHQ DEP/3495/OWDEL1/THE V,0.0,11800.0,,2018,4,20,TRANSFER,11800.0,M2023197227
19248,1196428',2018-04-20,CHQ DEP/324595/OWDEL1/SBI,0.0,11800.0,,2018,4,20,CASH_IN,11800.0,C232812328
19249,1196428',2018-04-20,CHQ DEP/163630/OWDEL1/ICI,0.0,11800.0,,2018,4,20,CHECK_CASHING,11800.0,M902890505
19250,1196428',2018-04-20,CHQ DEP/2362/OWDEL1/UTIB/,0.0,11800.0,,2018,4,20,CHECK_CASHING,11800.0,M1465861273
19251,1196428',2018-04-20,CHQ DEP/502863/OWDEL1/SBI,0.0,11800.0,,2018,4,20,CHECK_CASHING,11800.0,M949506330
19252,1196428',2018-04-20,CHQ DEP/172/OWDEL1/HDFC/,0.0,11800.0,,2018,4,20,CHECK_CASHING,11800.0,M2084969506
19253,1196428',2018-04-20,CHQ DEP/130237/OWDEL1/PSI,0.0,11800.0,,2018,4,20,TRANSFER,11800.0,M608038618
19254,1196428',2018-04-20,CHQ DEP/313294/OWDEL1/SBI,0.0,11800.0,,2018,4,20,TRANSFER,11800.0,M1041764081
19255,1196428',2018-04-20,CHQ DEP/924651/OWDEL1/IND,0.0,11800.0,,2018,4,20,TRANSFER,11800.0,M277788688
19256,1196428',2018-04-20,CHQ DEP/987011/OWDEL1/SBI,0.0,11800.0,,2018,4,20,TRANSFER,11800.0,M31440957
19257,1196428',2018-04-20,CHQ DEP/470632/OWDEL1/SBI,0.0,11800.0,,2018,4,20,TRANSFER,11800.0,C1805162633
19258,1196428',2018-04-20,CHQ DEP/69377/OWDEL1/SBIN,0.0,11800.0,,2018,4,20,CASH_IN,11800.0,M1201023997
19259,1196428',2018-04-20,CHQ DEP/493325/OWDEL1/SBI,0.0,11800.0,,2018,4,20,CASH_IN,11800.0,M1412743565
19260,1196428',2018-04-20,CHQ DEP/64348/OWDEL1/UTIB,0.0,11800.0,,2018,4,20,CASH_IN,11800.0,M1887477561
19261,1196428',2018-04-20,CHQ DEP/93856/OWDEL1/PUNB,0.0,11800.0,,2018,4,20,CASH_IN,11800.0,C435161028
19262,1196428',2018-04-20,CHQ DEP/772897/OWDEL1/SBI,0.0,11800.0,,2018,4,20,CASH_IN,11800.0,M2126024846
19263,1196428',2018-04-20,CHQ DEP/293/OWDEL1/HDFC/P,0.0,11800.0,,2018,4,20,CHECK_CASHING,11800.0,M885738476
19264,1196428',2018-04-20,CHQ DEP/727062/OWDEL1/SBI,0.0,11800.0,,2018,4,20,TRANSFER,11800.0,C1273939873
19265,1196428',2018-04-20,CHQ DEP/362826/OWDEL1/SBI,0.0,11800.0,,2018,4,20,CHECK_CASHING,11800.0,C464094472
19266,1196428',2018-04-20,CHQ DEP/616091/OWDEL1/PUN,0.0,11800.0,,2018,4,20,TRANSFER,11800.0,C1475998599
19267,1196428',2018-04-20,NEFT/SBIN318110532553/JAI,0.0,11800.0,,2018,4,20,TRANSFER,11800.0,C1789550256
19268,1196428',2018-04-20,NEFT/AXISP18110035859/ACC,0.0,2000000.0,,2018,4,20,TRANSFER,2000000.0,C1805445027
19269,1196428',2018-04-20,FDRL/INTERNAL FUND TRANSFE,1000000.0,0.0,,2018,4,20,PAYEMENT,1000000.0,C968448640
19270,1196428',2018-04-20,NEFT/AXISP18110039822/VAR,0.0,11800.0,,2018,4,20,TRANSFER,11800.0,C691636444
19271,1196428',2018-04-20,TRF FROM  Indiaforensic SERVICES,0.0,15000000.0,,2018,4,20,TRANSFER,15000000.0,C1778801068
19272,1196428',2018-04-20,TRF FROM  Indiaforensic SERVICES,0.0,15000000.0,,2018,4,20,CHECK_CASHING,15000000.0,C2029896123
19273,1196428',2018-04-20,TRF FROM  Indiaforensic SERVICES,0.0,4000000.0,,2018,4,20,TRANSFER,4000000.0,C1677727024
19274,1196428',2018-04-20,FDRL/REAL TIME GROSS SETTL,15000000.0,0.0,,2018,4,20,CASH_OUT,15000000.0,C1525944481
19275,1196428',2018-04-20,FDRL/REAL TIME GROSS SETTL,15000000.0,0.0,,2018,4,20,DEBIT,15000000.0,C481402298
19276,1196428',2018-04-20,FDRL/REAL TIME GROSS SETTL,2000000.0,0.0,,2018,4,20,CHECK_WITHDRAWAL,2000000.0,C177457290
19277,1196428',2018-04-20,FDRL/REAL TIME GROSS SETTL,2000000.0,0.0,,2018,4,20,DEBIT,2000000.0,M1138171728
19278,1196428',2018-04-20,CHQ DEPOSIT RETURN/378826,11800.0,0.0,,2018,4,20,DEBIT,11800.0,C1452722471
19279,1196428',2018-04-20,CHQ DEPOSIT RETURN/397308,11800.0,0.0,,2018,4,20,CHECK_WITHDRAWAL,11800.0,C861958315
19280,1196428',2018-04-20,CHQ DEPOSIT RETURN/378823,11800.0,0.0,,2018,4,20,DEBIT,11800.0,M919438675
19281,1196428',2018-04-20,CHQ DEPOSIT RETURN/13651/,11800.0,0.0,,2018,4,20,CASH_OUT,11800.0,M1501022601
19282,1196428',2018-04-20,CHQ DEPOSIT RETURN/444326,11800.0,0.0,,2018,4,20,CASH_OUT,11800.0,M397708705
19283,1196428',2018-04-20,CHQ DEPOSIT RETURN/165/FU,11800.0,0.0,,2018,4,20,CASH_OUT,11800.0,M1092898377
19284,1196428',2018-04-20,CHQ DEPOSIT RETURN/425655,11800.0,0.0,,2018,4,20,PAYEMENT,11800.0,M1957947378
19285,1196428',2018-04-20,CHQ DEPOSIT RETURN/76383/,11800.0,0.0,,2018,4,20,CASH_OUT,11800.0,C785703145
19286,1196428',2018-04-20,CHQ DEPOSIT RETURN/417698,11800.0,0.0,,2018,4,20,PAYEMENT,11800.0,M2094125621
19287,1196428',2018-04-20,CHQ DEPOSIT RETURN/301734,11800.0,0.0,,2018,4,20,PAYEMENT,11800.0,M1918034019
19288,1196428',2018-04-20,CHQ DEPOSIT RETURN/304948,11800.0,0.0,,2018,4,20,PAYEMENT,11800.0,M745483242
19289,1196428',2018-04-20,CHQ DEPOSIT RETURN/253360,11800.0,0.0,,2018,4,20,CHECK_WITHDRAWAL,11800.0,M1878714361
19290,1196428',2018-04-20,CHQ DEPOSIT RETURN/455279,11800.0,0.0,,2018,4,20,DEBIT,11800.0,M203939387
19291,1196428',2018-04-20,CHQ DEPOSIT RETURN/828/EX,11800.0,0.0,,2018,4,20,CASH_OUT,11800.0,C382934088
19292,1196428',2018-04-20,CHQ DEPOSIT RETURN/317366,11800.0,0.0,,2018,4,20,CASH_OUT,11800.0,C158876320
19293,1196428',2018-04-20,CHQ DEPOSIT RETURN/78568/,11800.0,0.0,,2018,4,20,CASH_OUT,11800.0,C732929236
19294,1196428',2018-04-20,CHQ DEPOSIT RETURN/287781,11800.0,0.0,,2018,4,20,DEBIT,11800.0,C1554622120
19295,1196428',2018-04-20,CHQ DEPOSIT RETURN/163630,11800.0,0.0,,2018,4,20,CHECK_WITHDRAWAL,11800.0,C1359484306
19296,1196428',2018-04-20,CHQ DEPOSIT RETURN/727062,11800.0,0.0,,2018,4,20,CHECK_WITHDRAWAL,11800.0,C1782704802
19297,1196428',2018-04-20,NEFT/N110180523726471/PAY,0.0,424714.48,,2018,4,20,CASH_IN,424714.48,C1609562230
19298,1196428',2018-04-20,NEFT/N110180523726520/PAY,0.0,3142162.59,,2018,4,20,CHECK_CASHING,3142162.59,C1220897602
19299,1196428',2018-04-20,NEFT/N110180523764123/ASH,0.0,125567.0,,2018,4,20,CASH_IN,125567.0,C1213257323
19300,1196428',2018-04-20,FDRL/INTERNAL FUND TRANSFE,0.0,1000000.0,,2018,4,20,TRANSFER,1000000.0,C674913323
19301,1196428',2018-04-20,Shortfall recovery for ^[,4297.0,0.0,,2018,4,20,PAYEMENT,4297.0,C803116137
19302,1196428',2018-04-20,Shortfall recovery for ^[,144.0,0.0,,2018,4,20,CHECK_WITHDRAWAL,144.0,C1450417897
19303,1196428',2018-04-20,Shortfall recovery for ^[,104783.0,0.0,,2018,4,20,DEBIT,104783.0,C826383690
19304,1196428',2018-04-20,Shortfall recovery for ^[,3662.0,0.0,,2018,4,20,CHECK_WITHDRAWAL,3662.0,M1718920203
19305,1196428',2018-04-20,Shortfall recovery for ^[,289670.04,0.0,,2018,4,20,CHECK_WITHDRAWAL,289670.04,M1002711260
19306,1196428',2018-04-20,Shortfall recovery for ^[,2286.0,0.0,,2018,4,20,PAYEMENT,2286.0,C545710008
19307,1196428',2018-04-20,Shortfall recovery for ^[,6950.0,0.0,,2018,4,20,PAYEMENT,6950.0,C1838584624
19308,1196428',2018-04-20,Shortfall recovery for ^[,696.0,0.0,,2018,4,20,CASH_OUT,696.0,C1030706332
19309,1196428',2018-04-20,Shortfall recovery for ^[,1892.0,0.0,,2018,4,20,DEBIT,1892.0,M2129060443
19310,1196428',2018-04-20,Shortfall recovery for ^[,598.0,0.0,,2018,4,20,CHECK_WITHDRAWAL,598.0,C1195471589
19311,1196428',2018-04-20,Shortfall recovery for ^[,583.0,0.0,,2018,4,20,DEBIT,583.0,M1398128260
19312,1196428',2018-04-20,Shortfall recovery for ^[,8188.0,0.0,,2018,4,20,CASH_OUT,8188.0,C1856036778
19313,1196428',2018-04-20,Shortfall recovery for ^[,96.0,0.0,,2018,4,20,DEBIT,96.0,C2067546399
19314,1196428',2018-04-20,Shortfall recovery for ^[,1996.0,0.0,,2018,4,20,PAYEMENT,1996.0,C818570949
19315,1196428',2018-04-20,Shortfall recovery for ^[,406.0,0.0,,2018,4,20,DEBIT,406.0,M535878604
19316,1196428',2018-04-20,Shortfall recovery for ^[,29000.0,0.0,,2018,4,20,DEBIT,29000.0,C358945794
19317,1196428',2018-04-20,Shortfall recovery for ^[,51.0,0.0,,2018,4,20,CASH_OUT,51.0,C922511709
19318,1196428',2018-04-20,Shortfall recovery for ^[,34098.0,0.0,,2018,4,20,PAYEMENT,34098.0,C988138425
19319,1196428',2018-04-20,Shortfall recovery for ^[,7604.0,0.0,,2018,4,20,CHECK_WITHDRAWAL,7604.0,C814900611
19320,1196428',2018-04-20,Shortfall recovery for ^[,19616.0,0.0,,2018,4,20,DEBIT,19616.0,C1467740330
19321,1196428',2018-04-20,FDRL/INTERNAL FUND TRANSFE,1000000.0,0.0,,2018,4,20,CHECK_WITHDRAWAL,1000000.0,M858308953
19322,1196428',2018-04-20,FDRL/INTERNAL FUND TRANSFE,1000000.0,0.0,,2018,4,20,CASH_OUT,1000000.0,M1773085261
19323,1196428',2018-04-20,IMPS 811017256514 FROM SH,0.0,11800.0,,2018,4,20,CHECK_CASHING,11800.0,M472606308
19324,1196428',2018-04-20,NEFT/N110180523900830/TEC,0.0,300000.0,,2018,4,20,CHECK_CASHING,300000.0,M51583809
19325,1196428',2018-04-20,Shortfall recovery for ^[,34.0,0.0,,2018,4,20,DEBIT,34.0,M1337700382
19326,1196428',2018-04-20,Shortfall recovery for ^[,400.0,0.0,,2018,4,20,CASH_OUT,400.0,C1918034924
19327,1196428',2018-04-20,Shortfall recovery for ^[,51.0,0.0,,2018,4,20,CHECK_WITHDRAWAL,51.0,M527477577
19328,1196428',2018-04-20,Shortfall recovery for ^[,58.0,0.0,,2018,4,20,CHECK_WITHDRAWAL,58.0,M577217292
19329,1196428',2018-04-20,Shortfall recovery for ^[,33.0,0.0,,2018,4,20,DEBIT,33.0,C184253187
19330,1196428',2018-04-20,Shortfall recovery for ^[,94.0,0.0,,2018,4,20,CHECK_WITHDRAWAL,94.0,C1778300121
19331,1196428',2018-04-20,FDRL/INTERNAL FUND TRANSFE,4000000.0,0.0,,2018,4,20,PAYEMENT,4000000.0,C667504652
19332,1196428',2018-04-20,FDRL/INTERNAL FUND TRANSFE,500000.0,0.0,,2018,4,20,DEBIT,500000.0,C638590716
19333,1196428',2018-04-20,BEAT CSH PKP DEL GURG 643,0.0,51000.0,,2018,4,20,TRANSFER,51000.0,C1532153384
19334,1196428',2018-04-20,CHQ DEPOSIT RETURN/378826,100.0,0.0,,2018,4,20,DEBIT,100.0,C208427878
19335,1196428',2018-04-20,CHQ DEPOSIT RETURN/378826,18.0,0.0,,2018,4,20,CASH_OUT,18.0,C1530086509
19336,1196428',2018-04-20,CHQ DEPOSIT RETURN/397308,100.0,0.0,,2018,4,20,PAYEMENT,100.0,C703957828
19337,1196428',2018-04-20,CHQ DEPOSIT RETURN/397308,18.0,0.0,,2018,4,20,CASH_OUT,18.0,C891020651
19338,1196428',2018-04-20,CHQ DEPOSIT RETURN/378823,100.0,0.0,,2018,4,20,DEBIT,100.0,M1680032445
19339,1196428',2018-04-20,CHQ DEPOSIT RETURN/378823,18.0,0.0,,2018,4,20,DEBIT,18.0,C553264065
19340,1196428',2018-04-20,CHQ DEPOSIT RETURN/165/CH,100.0,0.0,,2018,4,20,PAYEMENT,100.0,M1097298586
19341,1196428',2018-04-20,CHQ DEPOSIT RETURN/165/GS,18.0,0.0,,2018,4,20,CHECK_WITHDRAWAL,18.0,M870026554
19342,1196428',2018-04-20,CHQ DEPOSIT RETURN/425655,100.0,0.0,,2018,4,20,CHECK_WITHDRAWAL,100.0,C695653925
19343,1196428',2018-04-20,CHQ DEPOSIT RETURN/425655,18.0,0.0,,2018,4,20,DEBIT,18.0,M1248361658
19344,1196428',2018-04-20,CHQ DEPOSIT RETURN/417698,100.0,0.0,,2018,4,20,CHECK_WITHDRAWAL,100.0,C1689262323
19345,1196428',2018-04-20,CHQ DEPOSIT RETURN/417698,18.0,0.0,,2018,4,20,CHECK_WITHDRAWAL,18.0,C1757877803
19346,1196428',2018-04-20,CHQ DEPOSIT RETURN/301734,100.0,0.0,,2018,4,20,CASH_OUT,100.0,C1849933855
19347,1196428',2018-04-20,CHQ DEPOSIT RETURN/301734,18.0,0.0,,2018,4,20,PAYEMENT,18.0,C1753128715
19348,1196428',2018-04-20,CHQ DEPOSIT RETURN/304948,100.0,0.0,,2018,4,20,CHECK_WITHDRAWAL,100.0,C1527761090
19349,1196428',2018-04-20,CHQ DEPOSIT RETURN/304948,18.0,0.0,,2018,4,20,CASH_OUT,18.0,C1754722089
19350,1196428',2018-04-20,CHQ DEPOSIT RETURN/253360,100.0,0.0,,2018,4,20,DEBIT,100.0,C1261039678
19351,1196428',2018-04-20,CHQ DEPOSIT RETURN/253360,18.0,0.0,,2018,4,20,CHECK_WITHDRAWAL,18.0,C836514715
19352,1196428',2018-04-20,CHQ DEPOSIT RETURN/455279,100.0,0.0,,2018,4,20,CASH_OUT,100.0,C1640961071
19353,1196428',2018-04-20,CHQ DEPOSIT RETURN/455279,18.0,0.0,,2018,4,20,CHECK_WITHDRAWAL,18.0,C1838584624
19354,1196428',2018-04-20,CHQ DEPOSIT RETURN/828/CH,100.0,0.0,,2018,4,20,PAYEMENT,100.0,C1209271652
19355,1196428',2018-04-20,CHQ DEPOSIT RETURN/828/GS,18.0,0.0,,2018,4,20,CASH_OUT,18.0,C745740822
19356,1196428',2018-04-20,CHQ DEPOSIT RETURN/317366,100.0,0.0,,2018,4,20,CHECK_WITHDRAWAL,100.0,C1401721023
19357,1196428',2018-04-20,CHQ DEPOSIT RETURN/317366,18.0,0.0,,2018,4,20,PAYEMENT,18.0,C47827984
19358,1196428',2018-04-20,CHQ DEPOSIT RETURN/78568/,100.0,0.0,,2018,4,20,DEBIT,100.0,C1849941462
19359,1196428',2018-04-20,CHQ DEPOSIT RETURN/78568/,18.0,0.0,,2018,4,20,CHECK_WITHDRAWAL,18.0,C70895366
19360,1196428',2018-04-20,CHQ DEPOSIT RETURN/287781,100.0,0.0,,2018,4,20,CASH_OUT,100.0,C977993101
19361,1196428',2018-04-20,CHQ DEPOSIT RETURN/287781,18.0,0.0,,2018,4,20,CASH_OUT,18.0,C2116873183
19362,1196428',2018-04-20,CHQ DEPOSIT RETURN/163630,100.0,0.0,,2018,4,20,CASH_OUT,100.0,C892686452
19363,1196428',2018-04-20,CHQ DEPOSIT RETURN/163630,18.0,0.0,,2018,4,20,CHECK_WITHDRAWAL,18.0,C1540270363
19364,1196428',2018-04-20,CHQ DEPOSIT RETURN/727062,100.0,0.0,,2018,4,20,PAYEMENT,100.0,C534662976
19365,1196428',2018-04-20,CHQ DEPOSIT RETURN/727062,18.0,0.0,,2018,4,20,PAYEMENT,18.0,C30013970
19366,1196428',2018-04-21,NEFT/PUNBH18111372756/BAL,0.0,15000.0,,2018,4,21,TRANSFER,15000.0,C1809373351
19367,1196428',2018-04-21,NEFT/SAA351261553/CEEGEES,0.0,11800.0,,2018,4,21,TRANSFER,11800.0,C741431520
19368,1196428',2018-04-21,TRF FROM  Indiaforensic SERVICES,0.0,4000000.0,,2018,4,21,CHECK_CASHING,4000000.0,C669771073
19369,1196428',2018-04-21,FDRL/NATIONAL ELECTRONIC F,589600.0,0.0,,2018,4,21,DEBIT,589600.0,C1915091057
19370,1196428',2018-04-21,RTGS/HDFCH18111962244/PAY,0.0,2200000.0,,2018,4,21,TRANSFER,2200000.0,C323287038
19371,1196428',2018-04-21,RTGS/HDFCH18111963958/PAY,0.0,1520000.0,,2018,4,21,CASH_IN,1520000.0,C1027992087
19372,1196428',2018-04-21,NEFT/SBIN418111350948/KAL,0.0,11800.0,,2018,4,21,CASH_IN,11800.0,C1435804085
19373,1196428',2018-04-21,FDRL/REAL TIME GROSS SETTL,3000000.0,0.0,,2018,4,21,CHECK_WITHDRAWAL,3000000.0,C1153596299
19374,1196428',2018-04-21,FDRL/REAL TIME GROSS SETTL,2000000.0,0.0,,2018,4,21,CHECK_WITHDRAWAL,2000000.0,C1541743053
19375,1196428',2018-04-21,NEFT/N111180524200675/BAT,0.0,100000.0,,2018,4,21,CHECK_CASHING,100000.0,C1213257323
19376,1196428',2018-04-21,CHQ DEP/51762/OWDEL1/SBIN,0.0,11800.0,,2018,4,21,CHECK_CASHING,11800.0,C295081230
19377,1196428',2018-04-21,CHQ DEP/38723/OWDEL1/ORBC,0.0,11800.0,,2018,4,21,CHECK_CASHING,11800.0,C531511436
19378,1196428',2018-04-21,CHQ DEP/555205/OWDEL1/SBI,0.0,11800.0,,2018,4,21,CHECK_CASHING,11800.0,C175291188
19379,1196428',2018-04-21,CHQ DEP/2640/OWDEL1/ORBC/,0.0,11800.0,,2018,4,21,TRANSFER,11800.0,C1259769769
19380,1196428',2018-04-21,CHQ DEP/115926/OWDEL1/PUN,0.0,11800.0,,2018,4,21,TRANSFER,11800.0,C205300866
19381,1196428',2018-04-21,CHQ DEP/934920/OWDEL1/CNR,0.0,11800.0,,2018,4,21,TRANSFER,11800.0,C1297873690
19382,1196428',2018-04-21,CHQ DEP/303795/OWDEL1/SBI,0.0,11800.0,,2018,4,21,TRANSFER,11800.0,C715819458
19383,1196428',2018-04-21,CHQ DEP/487/OWDEL1/HDFC/I,0.0,11800.0,,2018,4,21,CASH_IN,11800.0,C18928637
19384,1196428',2018-04-21,CHQ DEP/806952/OWDEL1/SBI,0.0,11800.0,,2018,4,21,CASH_IN,11800.0,C1079343872
19385,1196428',2018-04-21,CHQ DEP/306733/OWDEL1/SBI,0.0,11800.0,,2018,4,21,TRANSFER,11800.0,C99275333
19386,1196428',2018-04-21,CHQ DEP/261115/OWDEL1/SBI,0.0,11800.0,,2018,4,21,CASH_IN,11800.0,C1450828900
19387,1196428',2018-04-21,CHQ DEP/35701/OWDEL1/CORP,0.0,11800.0,,2018,4,21,CHECK_CASHING,11800.0,C1339257929
19388,1196428',2018-04-21,CHQ DEP/1078/OWDEL1/HDFC/,0.0,8260.0,,2018,4,21,TRANSFER,8260.0,C893041125
19389,1196428',2018-04-21,CHQ DEP/34049/OWDEL1/SBIN,0.0,11800.0,,2018,4,21,CASH_IN,11800.0,C380242442
19390,1196428',2018-04-21,CHQ DEP/25748/OWDEL1/IBKL,0.0,11800.0,,2018,4,21,CASH_IN,11800.0,C1220897602
19391,1196428',2018-04-21,CHQ DEP/354/OWDEL1/BARB/G,0.0,11800.0,,2018,4,21,CASH_IN,11800.0,C495071437
19392,1196428',2018-04-21,CHQ DEP/255197/OWDEL1/SBI,0.0,11800.0,,2018,4,21,TRANSFER,11800.0,C1753128715
19393,1196428',2018-04-21,CHQ DEP/69/OWDEL1/HDFC/MA,0.0,11800.0,,2018,4,21,TRANSFER,11800.0,C1387460501
19394,1196428',2018-04-21,CHQ DEP/1367/OWDEL1/HDFC/,0.0,11800.0,,2018,4,21,TRANSFER,11800.0,C425987411
19395,1196428',2018-04-21,CHQ DEP/175900/OWDEL1/SBI,0.0,11800.0,,2018,4,21,CASH_IN,11800.0,C914293025
19396,1196428',2018-04-21,CHQ DEP/166/OWDEL1/HDFC/F,0.0,11800.0,,2018,4,21,TRANSFER,11800.0,C1765998352
19397,1196428',2018-04-21,CHQ DEP/789122/OWDEL1/SYN,0.0,11800.0,,2018,4,21,CHECK_CASHING,11800.0,C1651144763
19398,1196428',2018-04-21,CHQ DEP/112960/OWDEL1/CNR,0.0,11800.0,,2018,4,21,CHECK_CASHING,11800.0,C922871524
19399,1196428',2018-04-21,CHQ DEP/262427/OWDEL1/SBI,0.0,11800.0,,2018,4,21,TRANSFER,11800.0,C1877059833
19400,1196428',2018-04-21,CHQ DEP/239346/OWDEL1/UBI,0.0,11800.0,,2018,4,21,CASH_IN,11800.0,C1477641326
19401,1196428',2018-04-21,CHQ DEP/715994/OWDEL1/ICI,0.0,11800.0,,2018,4,21,TRANSFER,11800.0,C836514715
19402,1196428',2018-04-21,CHQ DEP/35/OWDEL1/HDFC/BH,0.0,11800.0,,2018,4,21,TRANSFER,11800.0,C330226144
19403,1196428',2018-04-21,CHQ DEP/122487/OWDEL1/SBI,0.0,11800.0,,2018,4,21,TRANSFER,11800.0,C837153776
19404,1196428',2018-04-21,CHQ DEP/223/OWDEL1/HDFC/,0.0,11800.0,,2018,4,21,TRANSFER,11800.0,C1092318644
19405,1196428',2018-04-21,CHQ DEP/44/OWDEL1/HDFC/NE,0.0,11800.0,,2018,4,21,CASH_IN,11800.0,C1234776885
19406,1196428',2018-04-21,CHQ DEP/975207/OWDEL1/YES,0.0,11800.0,,2018,4,21,CHECK_CASHING,11800.0,C1107146140
19407,1196428',2018-04-21,CHQ DEP/406/OWDEL1/HDFC/,0.0,11800.0,,2018,4,21,CHECK_CASHING,11800.0,C438379413
19408,1196428',2018-04-21,CHQ DEP/210682/OWDEL1/PUN,0.0,11800.0,,2018,4,21,CHECK_CASHING,11800.0,C782432613
19409,1196428',2018-04-21,CHQ DEP/48299/OWDEL1/CBIN,0.0,11800.0,,2018,4,21,CASH_IN,11800.0,C1423992712
19410,1196428',2018-04-21,CHQ DEP/595516/OWDEL1/SBI,0.0,11800.0,,2018,4,21,TRANSFER,11800.0,C1749476584
19411,1196428',2018-04-21,CHQ DEP/354252/OWDEL1/SBI,0.0,11800.0,,2018,4,21,CHECK_CASHING,11800.0,C1396755641
19412,1196428',2018-04-21,CHQ DEP/686204/OWDEL1/SBI,0.0,11800.0,,2018,4,21,CASH_IN,11800.0,C712956349
19413,1196428',2018-04-21,CHQ DEP/305750/OWDEL1/SBI,0.0,11800.0,,2018,4,21,CHECK_CASHING,11800.0,C1413055366
19414,1196428',2018-04-21,CHQ DEP/3251/OWDEL1/ALLA/,0.0,11800.0,,2018,4,21,CASH_IN,11800.0,C741431520
19415,1196428',2018-04-21,CHQ DEP/30/OWDEL1/HDFC/MU,0.0,11800.0,,2018,4,21,TRANSFER,11800.0,C1316897476
19416,1196428',2018-04-21,CHQ DEP/200666/OWDEL1/PUN,0.0,11800.0,,2018,4,21,CHECK_CASHING,11800.0,C157316544
19417,1196428',2018-04-21,CHQ DEP/754731/OWDEL1/PUN,0.0,11800.0,,2018,4,21,CASH_IN,11800.0,C875761527
19418,1196428',2018-04-21,CHQ DEP/538/OWDEL1/HDFC/A,0.0,11800.0,,2018,4,21,TRANSFER,11800.0,C1337741679
19419,1196428',2018-04-21,CHQ DEP/265811/OWDEL1/COR,0.0,11800.0,,2018,4,21,CHECK_CASHING,11800.0,C329829198
19420,1196428',2018-04-21,CHQ DEP/211/OWDEL1/HDFC/A,0.0,11800.0,,2018,4,21,TRANSFER,11800.0,C2070626006
19421,1196428',2018-04-21,CHQ DEP/105112/OWDEL1/SBI,0.0,11800.0,,2018,4,21,CASH_IN,11800.0,C758750856
19422,1196428',2018-04-21,CHQ DEP/41213/OWDEL1/UBIN,0.0,11800.0,,2018,4,21,TRANSFER,11800.0,C1842297286
19423,1196428',2018-04-21,CHQ DEP/331117/OWDEL1/SBI,0.0,11800.0,,2018,4,21,TRANSFER,11800.0,C456538529
19424,1196428',2018-04-21,CHQ DEP/247043/OWDEL1/SBI,0.0,11800.0,,2018,4,21,CHECK_CASHING,11800.0,C545710008
19425,1196428',2018-04-21,CHQ DEP/832245/OWDEL1/SBI,0.0,11800.0,,2018,4,21,CHECK_CASHING,11800.0,C8290162
19426,1196428',2018-04-21,CHQ DEP/120986/OWDEL1/ALL,0.0,11800.0,,2018,4,21,CHECK_CASHING,11800.0,C1872618824
19427,1196428',2018-04-21,CHQ DEP/3692/OWDEL1/UTIB/,0.0,11800.0,,2018,4,21,TRANSFER,11800.0,C1247600089
19428,1196428',2018-04-21,CHQ DEP/909774/OWDEL1/SBI,0.0,11800.0,,2018,4,21,CHECK_CASHING,11800.0,C709091500
19429,1196428',2018-04-21,CHQ DEP/126234/OWDEL1/SBI,0.0,11800.0,,2018,4,21,TRANSFER,11800.0,C667346055
19430,1196428',2018-04-21,CHQ DEP/322/OWDEL1/HDFC/H,0.0,11800.0,,2018,4,21,CHECK_CASHING,11800.0,C573200870
19431,1196428',2018-04-21,CHQ DEP/88275/OWDEL1/CBIN,0.0,11800.0,,2018,4,21,CHECK_CASHING,11800.0,C1909597726
19432,1196428',2018-04-21,CHQ DEP/41943/OWDEL1/ORBC,0.0,11800.0,,2018,4,21,TRANSFER,11800.0,C2082673402
19433,1196428',2018-04-21,CHQ DEP/235/OWDEL1/HDFC/,0.0,11800.0,,2018,4,21,CASH_IN,11800.0,C332911016
19434,1196428',2018-04-21,CHQ DEP/450485/OWDEL1/SBI,0.0,11800.0,,2018,4,21,TRANSFER,11800.0,C1326243087
19435,1196428',2018-04-21,CHQ DEP/2417/OWDEL1/ORBC/,0.0,11800.0,,2018,4,21,CASH_IN,11800.0,C1311325237
19436,1196428',2018-04-21,CHQ DEP/12875/OWDEL1/ORBC,0.0,11800.0,,2018,4,21,TRANSFER,11800.0,C1626759869
19437,1196428',2018-04-21,CHQ DEP/486820/OWDEL1/SBI,0.0,11800.0,,2018,4,21,CHECK_CASHING,11800.0,C1937962514
19438,1196428',2018-04-21,CHQ DEP/291/OWDEL1/KKBK/G,0.0,11800.0,,2018,4,21,CASH_IN,11800.0,C1166654566
19439,1196428',2018-04-21,CHQ DEP/22267/OWDEL1/UTIB,0.0,11800.0,,2018,4,21,CHECK_CASHING,11800.0,C1722141669
19440,1196428',2018-04-21,CHQ DEP/482682/OWDEL1/SBI,0.0,11800.0,,2018,4,21,CASH_IN,11800.0,C1269336757
19441,1196428',2018-04-21,CHQ DEP/450819/OWDEL1/SBI,0.0,11800.0,,2018,4,21,CHECK_CASHING,11800.0,C1255024717
19442,1196428',2018-04-21,CHQ DEP/626418/OWDEL1/SBI,0.0,11800.0,,2018,4,21,CASH_IN,11800.0,C423580937
19443,1196428',2018-04-21,CHQ DEP/852064/OWDEL1/PUN,0.0,11800.0,,2018,4,21,CASH_IN,11800.0,C571113365
19444,1196428',2018-04-21,FDRL/INTERNAL FUND TRANSFE,1000000.0,0.0,,2018,4,21,PAYEMENT,1000000.0,C2136124320
19445,1196428',2018-04-21,NEFT/PUNBH18111437980/PUN,0.0,100000.0,,2018,4,21,CHECK_CASHING,100000.0,C75474253
19446,1196428',2018-04-21,NEFT/AXISP18111036986/ACC,0.0,10000000.0,,2018,4,21,CHECK_CASHING,10000000.0,C1582765215
19447,1196428',2018-04-21,FDRL/REAL TIME GROSS SETTL,10000000.0,0.0,,2018,4,21,PAYEMENT,10000000.0,C1107146140
19448,1196428',2018-04-21,FDRL/INTERNAL FUND TRANSFE,300000.0,0.0,,2018,4,21,CASH_OUT,300000.0,C343534938
19449,1196428',2018-04-21,FDRL/INTERNAL FUND TRANSFE,300000.0,0.0,,2018,4,21,PAYEMENT,300000.0,C480500119
19450,1196428',2018-04-21,RTGS/DLXBH18111500477/KAD,0.0,200000.0,,2018,4,21,CHECK_CASHING,200000.0,C1052170153
19451,1196428',2018-04-21,TRF FROM  Indiaforensic SERVICES,0.0,2000000.0,,2018,4,21,CASH_IN,2000000.0,C403254166
19452,1196428',2018-04-21,TRF FROM  Indiaforensic SERVICES,0.0,15000000.0,,2018,4,21,CASH_IN,15000000.0,C1757877803
19453,1196428',2018-04-21,FDRL/REAL TIME GROSS SETTL,2000000.0,0.0,,2018,4,21,PAYEMENT,2000000.0,C896393489
19454,1196428',2018-04-21,FDRL/REAL TIME GROSS SETTL,15000000.0,0.0,,2018,4,21,PAYEMENT,15000000.0,C1178471274
19455,1196428',2018-04-21,NEFT/N111180524380416/PAY,0.0,424765.52,,2018,4,21,CASH_IN,424765.52,C1615443145
19456,1196428',2018-04-21,NEFT/N111180524380205/PAY,0.0,3316075.22,,2018,4,21,CASH_IN,3316075.22,C607702142
19457,1196428',2018-04-21,TRF FROM  Indiaforensic SERVICES,0.0,5000000.0,,2018,4,21,CHECK_CASHING,5000000.0,C489693281
19458,1196428',2018-04-21,TRF FROM  Indiaforensic SERVICES,0.0,4000000.0,,2018,4,21,CHECK_CASHING,4000000.0,C256902273
19459,1196428',2018-04-21,NEFT/N111180524438276/ASH,0.0,125593.0,,2018,4,21,CHECK_CASHING,125593.0,C732470450
19460,1196428',2018-04-21,FDRL/INTERNAL FUND TRANSFE,500000.0,0.0,,2018,4,21,PAYEMENT,500000.0,C648021642
19461,1196428',2018-04-21,FDRL/INTERNAL FUND TRANSFE,500000.0,0.0,,2018,4,21,DEBIT,500000.0,C93518808
19462,1196428',2018-04-21,NEFT/FDRLH18111600919/MIZ,0.0,4500.0,,2018,4,21,TRANSFER,4500.0,C40075281
19463,1196428',2018-04-21,FDRL/INTERNAL FUND TRANSFE,10000000.0,0.0,,2018,4,21,PAYEMENT,10000000.0,C1786099923
19464,1196428',2018-04-21,CHQ DEPOSIT RETURN/38723/,11800.0,0.0,,2018,4,21,DEBIT,11800.0,C1927159174
19465,1196428',2018-04-21,CHQ DEPOSIT RETURN/555205,11800.0,0.0,,2018,4,21,CASH_OUT,11800.0,C188246551
19466,1196428',2018-04-21,CHQ DEPOSIT RETURN/806952,11800.0,0.0,,2018,4,21,PAYEMENT,11800.0,C155439298
19467,1196428',2018-04-21,CHQ DEPOSIT RETURN/255197,11800.0,0.0,,2018,4,21,PAYEMENT,11800.0,C1627965794
19468,1196428',2018-04-21,CHQ DEPOSIT RETURN/789122,11800.0,0.0,,2018,4,21,CHECK_WITHDRAWAL,11800.0,C1023714065
19469,1196428',2018-04-21,CHQ DEPOSIT RETURN/354252,11800.0,0.0,,2018,4,21,CASH_OUT,11800.0,C746359178
19470,1196428',2018-04-21,CHQ DEPOSIT RETURN/247043,11800.0,0.0,,2018,4,21,PAYEMENT,11800.0,C1219248641
19471,1196428',2018-04-21,FDRL/INTERNAL FUND TRANSFE,2000000.0,0.0,,2018,4,21,CASH_OUT,2000000.0,C1022680775
19472,1196428',2018-04-21,TRF FROM  Indiaforensic SERVICES,0.0,500000.0,,2018,4,21,CHECK_CASHING,500000.0,C1966562224
19473,1196428',2018-04-21,TRF FROM  Indiaforensic SERVICES,0.0,4000000.0,,2018,4,21,CHECK_CASHING,4000000.0,C1298316171
19474,1196428',2018-04-21,FDRL/INTERNAL FUND TRANSFE,6000000.0,0.0,,2018,4,21,CASH_OUT,6000000.0,C1150610696
19475,1196428',2018-04-21,BEAT CSH PKP DEL GURG 630,0.0,175500.0,,2018,4,21,CHECK_CASHING,175500.0,C378218735
19476,1196428',2018-04-21,CHQ DEPOSIT RETURN/38723/,100.0,0.0,,2018,4,21,CHECK_WITHDRAWAL,100.0,C444920847
19477,1196428',2018-04-21,CHQ DEPOSIT RETURN/38723/,18.0,0.0,,2018,4,21,PAYEMENT,18.0,C904383922
19478,1196428',2018-04-21,CHQ DEPOSIT RETURN/555205,100.0,0.0,,2018,4,21,PAYEMENT,100.0,C1615443145
19479,1196428',2018-04-21,CHQ DEPOSIT RETURN/555205,18.0,0.0,,2018,4,21,PAYEMENT,18.0,C1200417755
19480,1196428',2018-04-21,CHQ DEPOSIT RETURN/806952,100.0,0.0,,2018,4,21,CHECK_WITHDRAWAL,100.0,C1219248641
19481,1196428',2018-04-21,CHQ DEPOSIT RETURN/806952,18.0,0.0,,2018,4,21,PAYEMENT,18.0,C974088986
19482,1196428',2018-04-21,CHQ DEPOSIT RETURN/255197,100.0,0.0,,2018,4,21,CHECK_WITHDRAWAL,100.0,C646059443
19483,1196428',2018-04-21,CHQ DEPOSIT RETURN/255197,18.0,0.0,,2018,4,21,CASH_OUT,18.0,C54142591
19484,1196428',2018-04-21,CHQ DEPOSIT RETURN/789122,100.0,0.0,,2018,4,21,DEBIT,100.0,C1167066016
19485,1196428',2018-04-21,CHQ DEPOSIT RETURN/789122,18.0,0.0,,2018,4,21,CASH_OUT,18.0,C1327907419
19486,1196428',2018-04-21,CHQ DEPOSIT RETURN/354252,100.0,0.0,,2018,4,21,PAYEMENT,100.0,C1778801068
19487,1196428',2018-04-21,CHQ DEPOSIT RETURN/354252,18.0,0.0,,2018,4,21,CHECK_WITHDRAWAL,18.0,C1318491599
19488,1196428',2018-04-21,CHQ DEPOSIT RETURN/247043,100.0,0.0,,2018,4,21,CASH_OUT,100.0,C1134776066
19489,1196428',2018-04-21,CHQ DEPOSIT RETURN/247043,18.0,0.0,,2018,4,21,PAYEMENT,18.0,C728526866
19490,1196428',2018-04-23,RTGS/UTIBH18113644730/PER,0.0,700000.0,,2018,4,23,CASH_IN,700000.0,C348708793
19491,1196428',2018-04-23,FDRL/NATIONAL ELECTRONIC F,376528.0,0.0,,2018,4,23,DEBIT,376528.0,C312537393
19492,1196428',2018-04-23,FDRL/NATIONAL ELECTRONIC F,154735.0,0.0,,2018,4,23,DEBIT,154735.0,C1590550415
19493,1196428',2018-04-23,RTGS/HDFCH18113088545/PAY,0.0,1760000.0,,2018,4,23,CASH_IN,1760000.0,C281632155
19494,1196428',2018-04-23,RTGS/HDFCH18113088507/PAY,0.0,3120000.0,,2018,4,23,CHECK_CASHING,3120000.0,C1337741679
19495,1196428',2018-04-23,NEFT/20508888691DC/ARTHAS,0.0,200000.0,,2018,4,23,CHECK_CASHING,200000.0,C635281078
19496,1196428',2018-04-23,FDRL/REAL TIME GROSS SETTL,2000000.0,0.0,,2018,4,23,PAYEMENT,2000000.0,C1424731356
19497,1196428',2018-04-23,FDRL/REAL TIME GROSS SETTL,2000000.0,0.0,,2018,4,23,PAYEMENT,2000000.0,C2040656033
19498,1196428',2018-04-23,NEFT/IOBAN18113509399/NAR,0.0,3750.0,,2018,4,23,TRANSFER,3750.0,C218193338
19499,1196428',2018-04-23,IMPS 811312447733 FROM SA,0.0,100000.0,,2018,4,23,CASH_IN,100000.0,C1036454560
19500,1196428',2018-04-23,NEFT/IOBAN18113525864/NAR,0.0,3750.0,,2018,4,23,CASH_IN,3750.0,C1317731757
19501,1196428',2018-04-23,NEFT/FDRLH18113636728/SRE,0.0,50000.0,,2018,4,23,CASH_IN,50000.0,C1671179293
19502,1196428',2018-04-23,TRF FROM  Indiaforensic SERVICES,0.0,15000000.0,,2018,4,23,CHECK_CASHING,15000000.0,C2127862399
19503,1196428',2018-04-23,TRF FROM  Indiaforensic SERVICES,0.0,15000000.0,,2018,4,23,CASH_IN,15000000.0,C657255537
19504,1196428',2018-04-23,FDRL/REAL TIME GROSS SETTL,15000000.0,0.0,,2018,4,23,PAYEMENT,15000000.0,C1334679764
19505,1196428',2018-04-23,TRF FROM  Indiaforensic SERVICES,0.0,10000000.0,,2018,4,23,CHECK_CASHING,10000000.0,C1039960084
19506,1196428',2018-04-23,TRF FROM  Indiaforensic SERVICES,0.0,3000000.0,,2018,4,23,CHECK_CASHING,3000000.0,C928023753
19507,1196428',2018-04-23,FDRL/REAL TIME GROSS SETTL,15000000.0,0.0,,2018,4,23,DEBIT,15000000.0,C1734649556
19508,1196428',2018-04-23,FDRL/REAL TIME GROSS SETTL,10000000.0,0.0,,2018,4,23,CASH_OUT,10000000.0,C1189861498
19509,1196428',2018-04-23,NEFT/N113180524953310/THA,0.0,11800.0,,2018,4,23,CASH_IN,11800.0,C232834050
19510,1196428',2018-04-23,NEFT/N113180525045439/PAY,0.0,435903.12,,2018,4,23,CHECK_CASHING,435903.12,C1509170127
19511,1196428',2018-04-23,NEFT/N113180525056333/PAY,0.0,4710383.29,,2018,4,23,CASH_IN,4710383.29,C749013731
19512,1196428',2018-04-23,NEFT/SBIN518113325612/SHI,0.0,11800.0,,2018,4,23,CASH_IN,11800.0,C1039162432
19513,1196428',2018-04-23,NEFT/N113180525173108/ASH,0.0,100799.0,,2018,4,23,TRANSFER,100799.0,C1337741679
19514,1196428',2018-04-23,TRF FROM  Indiaforensic SERVICES,0.0,10000000.0,,2018,4,23,CASH_IN,10000000.0,C1022680775
19515,1196428',2018-04-23,TRF FROM  Indiaforensic SERVICES,0.0,1000000.0,,2018,4,23,CASH_IN,1000000.0,C1219273867
19516,1196428',2018-04-23,FDRL/INTERNAL FUND TRANSFE,2000000.0,0.0,,2018,4,23,CHECK_WITHDRAWAL,2000000.0,C2040656033
19517,1196428',2018-04-23,FDRL/INTERNAL FUND TRANSFE,7000000.0,0.0,,2018,4,23,CHECK_WITHDRAWAL,7000000.0,C932583850
19518,1196428',2018-04-23,FDRL/INTERNAL FUND TRANSFE,8000000.0,0.0,,2018,4,23,DEBIT,8000000.0,C181168745
19519,1196428',2018-04-23,FDRL/INTERNAL FUND TRANSFE,1000000.0,0.0,,2018,4,23,DEBIT,1000000.0,C1339678445
19520,1196428',2018-04-23,BEAT CSH PKP DEL GURG 643,0.0,246500.0,,2018,4,23,TRANSFER,246500.0,M1853791403
19521,1196428',2018-04-24,FDRL/REAL TIME GROSS SETTL,2000000.0,0.0,,2018,4,24,PAYEMENT,2000000.0,M1783982816
19522,1196428',2018-04-24,FDRL/NATIONAL ELECTRONIC F,644426.0,0.0,,2018,4,24,CHECK_WITHDRAWAL,644426.0,M2097609292
19523,1196428',2018-04-24,NEFT/IT36701804242491/FIX,0.0,150000.0,,2018,4,24,TRANSFER,150000.0,M1225249765
19524,1196428',2018-04-24,RTGS/HDFCH18114289438/PAY,0.0,2280000.0,,2018,4,24,CASH_IN,2280000.0,C2072201071
19525,1196428',2018-04-24,RTGS/HDFCH18114293007/PAY,0.0,1760000.0,,2018,4,24,CASH_IN,1760000.0,M1957752919
19526,1196428',2018-04-24,FDRL/INTERNAL FUND TRANSFE,1000000.0,0.0,,2018,4,24,CHECK_WITHDRAWAL,1000000.0,C1292435170
19527,1196428',2018-04-24,FDRL/REAL TIME GROSS SETTL,1000000.0,0.0,,2018,4,24,CHECK_WITHDRAWAL,1000000.0,C761069599
19528,1196428',2018-04-24,FDRL/REAL TIME GROSS SETTL,1000000.0,0.0,,2018,4,24,DEBIT,1000000.0,M1214112061
19529,1196428',2018-04-24,FDRL/REAL TIME GROSS SETTL,1000000.0,0.0,,2018,4,24,PAYEMENT,1000000.0,C1782113663
19530,1196428',2018-04-24,NEFT/PUNBH18114850364/PUN,0.0,150000.0,,2018,4,24,CHECK_CASHING,150000.0,M488360507
19531,1196428',2018-04-24,NEFT/AXISP18114033642/NEE,0.0,11800.0,,2018,4,24,CHECK_CASHING,11800.0,C1842297286
19532,1196428',2018-04-24,TRF FROM  Indiaforensic SERVICES,0.0,15000000.0,,2018,4,24,TRANSFER,15000000.0,C1486249495
19533,1196428',2018-04-24,TRF FROM  Indiaforensic SERVICES,0.0,15000000.0,,2018,4,24,CASH_IN,15000000.0,C1975607158
19534,1196428',2018-04-24,TRF FROM  Indiaforensic SERVICES,0.0,1000000.0,,2018,4,24,CASH_IN,1000000.0,M979622014
19535,1196428',2018-04-24,TRF FROM  Indiaforensic SERVICES,0.0,500000.0,,2018,4,24,TRANSFER,500000.0,M1228053737
19536,1196428',2018-04-24,NEFT/N114180525630588/TEC,0.0,200000.0,,2018,4,24,CHECK_CASHING,200000.0,M778573937
19537,1196428',2018-04-24,NEFT/BARBU18114625461/MAK,0.0,50650.0,,2018,4,24,CASH_IN,50650.0,M618677016
19538,1196428',2018-04-24,RTGS/UTIBH18114656421/PER,0.0,500000.0,,2018,4,24,CASH_IN,500000.0,M615306131
19539,1196428',2018-04-24,FDRL/REAL TIME GROSS SETTL,15000000.0,0.0,,2018,4,24,CHECK_WITHDRAWAL,15000000.0,M961127018
19540,1196428',2018-04-24,FDRL/REAL TIME GROSS SETTL,15000000.0,0.0,,2018,4,24,DEBIT,15000000.0,C2036368507
19541,1196428',2018-04-24,NEFT/N114180525734684/ASH,0.0,90988.0,,2018,4,24,CHECK_CASHING,90988.0,M1597516322
19542,1196428',2018-04-24,FDRL/INTERNAL FUND TRANSFE,300000.0,0.0,,2018,4,24,CHECK_WITHDRAWAL,300000.0,M1963435950
19543,1196428',2018-04-24,FDRL/INTERNAL FUND TRANSFE,200000.0,0.0,,2018,4,24,CHECK_WITHDRAWAL,200000.0,M1688226308
19544,1196428',2018-04-24,FDRL/INTERNAL FUND TRANSFE,200000.0,0.0,,2018,4,24,DEBIT,200000.0,M856791465
19545,1196428',2018-04-24,Indiaforensic SERVICES INDIA PVT,0.0,299733.0,,2018,4,24,TRANSFER,299733.0,M387995891
19546,1196428',2018-04-24,TRF FROM  Indiaforensic SERVICES,0.0,1500000.0,,2018,4,24,CHECK_CASHING,1500000.0,M1209924775
19547,1196428',2018-04-24,Indiaforensic SERVICES INDIA PVT,0.0,1090598.0,,2018,4,24,TRANSFER,1090598.0,M452691017
19548,1196428',2018-04-24,NEFT/N114180525780462/PAY,0.0,568067.92,,2018,4,24,CASH_IN,568067.92,M1034146037
19549,1196428',2018-04-24,NEFT/N114180525780215/PAY,0.0,3452549.42,,2018,4,24,CHECK_CASHING,3452549.42,C1941371857
19550,1196428',2018-04-24,IMPS 811417148744 FROM SA,0.0,200000.0,,2018,4,24,TRANSFER,200000.0,M1142724632
19551,1196428',2018-04-24,BEAT CSH PKP DEL GURG 643,0.0,172000.0,,2018,4,24,CHECK_CASHING,172000.0,C527175306
19552,1196428',2018-04-24,TRF FROM  Indiaforensic SERVICES,0.0,4000000.0,,2018,4,24,TRANSFER,4000000.0,M1508497914
19553,1196428',2018-04-24,FDRL/INTERNAL FUND TRANSFE,10000000.0,0.0,,2018,4,24,PAYEMENT,10000000.0,M1079463647
19554,1196428',2018-04-24,FDRL/INTERNAL FUND TRANSFE,4000000.0,0.0,,2018,4,24,CASH_OUT,4000000.0,M1793912921
19555,1196428',2018-04-24,TRF FROM  Indiaforensic SERVICES,0.0,3000000.0,,2018,4,24,TRANSFER,3000000.0,M1128604343
19556,1196428',2018-04-24,FDRL/INTERNAL FUND TRANSFE,2000000.0,0.0,,2018,4,24,CASH_OUT,2000000.0,C313124964
19557,1196428',2018-04-25,RTGS/HDFCH18115446723/PAY,0.0,1280000.0,,2018,4,25,CHECK_CASHING,1280000.0,M288209772
19558,1196428',2018-04-25,RTGS/HDFCH18115450010/PAY,0.0,2000000.0,,2018,4,25,CHECK_CASHING,2000000.0,M1927910415
19559,1196428',2018-04-25,FDRL/INTERNAL FUND TRANSFE,2000000.0,0.0,,2018,4,25,CHECK_WITHDRAWAL,2000000.0,C2071512077
19560,1196428',2018-04-25,FDRL/NATIONAL ELECTRONIC F,827277.0,0.0,,2018,4,25,DEBIT,827277.0,M1346814966
19561,1196428',2018-04-25,FDRL/INTERNAL FUND TRANSFE,1000000.0,0.0,,2018,4,25,CASH_OUT,1000000.0,M61575226
19562,1196428',2018-04-25,CHQ DEP/245823/OWDEL1/SBI,0.0,11800.0,,2018,4,25,CHECK_CASHING,11800.0,C866356999
19563,1196428',2018-04-25,CHQ DEP/245337/OWDEL1/UBI,0.0,11800.0,,2018,4,25,CHECK_CASHING,11800.0,M1075577306
19564,1196428',2018-04-25,CHQ DEP/3342/OWDEL1/PUNB/,0.0,11800.0,,2018,4,25,TRANSFER,11800.0,M1662164405
19565,1196428',2018-04-25,CHQ DEP/32197/OWDEL1/ICIC,0.0,11800.0,,2018,4,25,CHECK_CASHING,11800.0,M552377681
19566,1196428',2018-04-25,CHQ DEP/684048/OWDEL1/PUN,0.0,11800.0,,2018,4,25,CASH_IN,11800.0,M63197837
19567,1196428',2018-04-25,CHQ DEP/716061/OWDEL1/ICI,0.0,11800.0,,2018,4,25,TRANSFER,11800.0,M903390485
19568,1196428',2018-04-25,CHQ DEP/990706/OWDEL1/PUN,0.0,11800.0,,2018,4,25,CHECK_CASHING,11800.0,M71402253
19569,1196428',2018-04-25,CHQ DEP/195043/OWDEL1/PUN,0.0,11800.0,,2018,4,25,CASH_IN,11800.0,M1346116432
19570,1196428',2018-04-25,CHQ DEP/693/OWDEL1/HDFC/B,0.0,11800.0,,2018,4,25,CHECK_CASHING,11800.0,M2048354408
19571,1196428',2018-04-25,TRF FROM  Indiaforensic SERVICES,0.0,15000000.0,,2018,4,25,TRANSFER,15000000.0,M220772619
19572,1196428',2018-04-25,TRF FROM  Indiaforensic SERVICES,0.0,13800000.0,,2018,4,25,CHECK_CASHING,13800000.0,M135907837
19573,1196428',2018-04-25,FDRL/REAL TIME GROSS SETTL,15000000.0,0.0,,2018,4,25,CASH_OUT,15000000.0,M186617766
19574,1196428',2018-04-25,FDRL/REAL TIME GROSS SETTL,2000000.0,0.0,,2018,4,25,DEBIT,2000000.0,M1632324002
19575,1196428',2018-04-25,FDRL/REAL TIME GROSS SETTL,2000000.0,0.0,,2018,4,25,PAYEMENT,2000000.0,M1764219688
19576,1196428',2018-04-25,FDRL/REAL TIME GROSS SETTL,2000000.0,0.0,,2018,4,25,CASH_OUT,2000000.0,M753600010
19577,1196428',2018-04-25,FDRL/REAL TIME GROSS SETTL,2000000.0,0.0,,2018,4,25,CHECK_WITHDRAWAL,2000000.0,M1968263729
19578,1196428',2018-04-25,FDRL/REAL TIME GROSS SETTL,2000000.0,0.0,,2018,4,25,CASH_OUT,2000000.0,M617956928
19579,1196428',2018-04-25,FDRL/REAL TIME GROSS SETTL,2000000.0,0.0,,2018,4,25,DEBIT,2000000.0,M946863453
19580,1196428',2018-04-25,FDRL/REAL TIME GROSS SETTL,2000000.0,0.0,,2018,4,25,DEBIT,2000000.0,M812836831
19581,1196428',2018-04-25,CHQ DEPOSIT RETURN/716061,11800.0,0.0,,2018,4,25,CHECK_WITHDRAWAL,11800.0,M937052761
19582,1196428',2018-04-25,NEFT/N115180526506199/PAY,0.0,415075.6,,2018,4,25,CHECK_CASHING,415075.6,M1950779148
19583,1196428',2018-04-25,NEFT/N115180526502275/PAY,0.0,3074117.69,,2018,4,25,TRANSFER,3074117.69,M665184080
19584,1196428',2018-04-25,TRF FROM  Indiaforensic SERVICES,0.0,5800000.0,,2018,4,25,CASH_IN,5800000.0,M1518221240
19585,1196428',2018-04-25,NEFT/PUNBH18115147161/PUN,0.0,100000.0,,2018,4,25,CHECK_CASHING,100000.0,M1460329476
19586,1196428',2018-04-25,IMPS 811518106182 FROM SA,0.0,200.0,,2018,4,25,CASH_IN,200.0,M1674917459
19587,1196428',2018-04-25,FDRL/INTERNAL FUND TRANSFE,0.0,2000000.0,,2018,4,25,CASH_IN,2000000.0,C678651991
19588,1196428',2018-04-25,FDRL/INTERNAL FUND TRANSFE,0.0,2000000.0,,2018,4,25,TRANSFER,2000000.0,M1957582539
19589,1196428',2018-04-25,FDRL/INTERNAL FUND TRANSFE,6000000.0,0.0,,2018,4,25,PAYEMENT,6000000.0,C1219248641
19590,1196428',2018-04-25,FDRL/INTERNAL FUND TRANSFE,7000000.0,0.0,,2018,4,25,CASH_OUT,7000000.0,M1733512939
19591,1196428',2018-04-25,BEAT CSH PKP DEL GURG 643,0.0,122000.0,,2018,4,25,CASH_IN,122000.0,M1130454983
19592,1196428',2018-04-26,RTGS/UTIBH18116665996/PER,0.0,700000.0,,2018,4,26,TRANSFER,700000.0,C2070157789
19593,1196428',2018-04-26,RTGS/SBINH18116005320/Indfor,0.0,1300000.0,,2018,4,26,TRANSFER,1300000.0,C115457323
19594,1196428',2018-04-26,RTGS/HDFCH18116612677/PAY,0.0,2160000.0,,2018,4,26,TRANSFER,2160000.0,C1334669858
19595,1196428',2018-04-26,RTGS/HDFCH18116615298/PAY,0.0,960000.0,,2018,4,26,CHECK_CASHING,960000.0,M757390373
19596,1196428',2018-04-26,FDRL/NATIONAL ELECTRONIC F,1070024.0,0.0,,2018,4,26,DEBIT,1070024.0,C2032924554
19597,1196428',2018-04-26,CHQ DEP/89484/OWDEL1/SBIN,0.0,2500.0,,2018,4,26,TRANSFER,2500.0,C1313534832
19598,1196428',2018-04-26,CHQ DEP/895208/OWDEL1/SBI,0.0,2500.0,,2018,4,26,CASH_IN,2500.0,C1435804085
19599,1196428',2018-04-26,CHQ DEP/89486/OWDEL1/SBIN,0.0,2500.0,,2018,4,26,CASH_IN,2500.0,C441599944
19600,1196428',2018-04-26,CHQ DEP/89485/OWDEL1/SBIN,0.0,2500.0,,2018,4,26,CHECK_CASHING,2500.0,C1254526270
19601,1196428',2018-04-26,CHQ DEP/89483/OWDEL1/SBIN,0.0,2500.0,,2018,4,26,CHECK_CASHING,2500.0,C486750945
19602,1196428',2018-04-26,CHQ DEP/89481/OWDEL1/SBIN,0.0,2500.0,,2018,4,26,CASH_IN,2500.0,C807247901
19603,1196428',2018-04-26,CHQ DEP/89490/OWDEL1/SBIN,0.0,2500.0,,2018,4,26,CASH_IN,2500.0,C991363637
19604,1196428',2018-04-26,CHQ DEP/89493/OWDEL1/SBIN,0.0,2500.0,,2018,4,26,CHECK_CASHING,2500.0,C1040847151
19605,1196428',2018-04-26,CHQ DEP/89492/OWDEL1/SBIN,0.0,2500.0,,2018,4,26,TRANSFER,2500.0,C121523915
19606,1196428',2018-04-26,CHQ DEP/355814/OWDEL1/SBI,0.0,2500.0,,2018,4,26,CASH_IN,2500.0,C1727565779
19607,1196428',2018-04-26,CHQ DEP/355813/OWDEL1/SBI,0.0,2500.0,,2018,4,26,CHECK_CASHING,2500.0,C965197768
19608,1196428',2018-04-26,CHQ DEP/898317/OWDEL1/SBI,0.0,2500.0,,2018,4,26,TRANSFER,2500.0,C1847521348
19609,1196428',2018-04-26,CHQ DEP/898318/OWDEL1/SBI,0.0,2500.0,,2018,4,26,TRANSFER,2500.0,C657255537
19610,1196428',2018-04-26,CHQ DEP/562708/OWDEL1/SBI,0.0,2500.0,,2018,4,26,TRANSFER,2500.0,C31789747
19611,1196428',2018-04-26,CHQ DEP/265907/OWDEL1/SBI,0.0,2500.0,,2018,4,26,CHECK_CASHING,2500.0,C365212068
19612,1196428',2018-04-26,CHQ DEP/265905/OWDEL1/SBI,0.0,2500.0,,2018,4,26,CHECK_CASHING,2500.0,C1645903235
19613,1196428',2018-04-26,CHQ DEP/664910/OWDEL1/SBI,0.0,2500.0,,2018,4,26,CHECK_CASHING,2500.0,C8290162
19614,1196428',2018-04-26,CHQ DEP/89325/OWDEL1/SBIN,0.0,2500.0,,2018,4,26,TRANSFER,2500.0,C2112142735
19615,1196428',2018-04-26,CHQ DEP/89313/OWDEL1/SBIN,0.0,2500.0,,2018,4,26,CASH_IN,2500.0,C1147977782
19616,1196428',2018-04-26,CHQ DEP/89341/OWDEL1/SBIN,0.0,2500.0,,2018,4,26,TRANSFER,2500.0,C1965592391
19617,1196428',2018-04-26,CHQ DEP/89012/OWDEL1/SBIN,0.0,25000.0,,2018,4,26,CHECK_CASHING,25000.0,C1153596299
19618,1196428',2018-04-26,CHQ DEP/1834/OWDEL1/SCBL/,0.0,50000.0,,2018,4,26,TRANSFER,50000.0,C2006081398
19619,1196428',2018-04-26,INTEX TECHNOLOGIES INDIA,1000000.0,0.0,,2018,4,26,CHECK_WITHDRAWAL,1000000.0,C1090263069
19620,1196428',2018-04-26,NEFT/20513041511DC/ARTHAS,0.0,44655.0,,2018,4,26,CHECK_CASHING,44655.0,C121523915
19621,1196428',2018-04-26,FDRL/INTERNAL FUND TRANSFE,500000.0,0.0,,2018,4,26,PAYEMENT,500000.0,C8733802
19622,1196428',2018-04-26,FDRL/INTERNAL FUND TRANSFE,2000000.0,0.0,,2018,4,26,CASH_OUT,2000000.0,C189963646
19623,1196428',2018-04-26,FDRL/INTERNAL FUND TRANSFE,500000.0,0.0,,2018,4,26,DEBIT,500000.0,C40075281
19624,1196428',2018-04-26,FDRL/INTERNAL FUND TRANSFE,500000.0,0.0,,2018,4,26,CHECK_WITHDRAWAL,500000.0,C1220897602
19625,1196428',2018-04-26,TRF FROM  Indiaforensic SERVICES,0.0,12200000.0,,2018,4,26,CASH_IN,12200000.0,C68113386
19626,1196428',2018-04-26,TRF FROM  Indiaforensic SERVICES,0.0,15000000.0,,2018,4,26,CASH_IN,15000000.0,C683605346
19627,1196428',2018-04-26,FDRL/REAL TIME GROSS SETTL,15000000.0,0.0,,2018,4,26,CASH_OUT,15000000.0,C1085479446
19628,1196428',2018-04-26,FDRL/REAL TIME GROSS SETTL,2000000.0,0.0,,2018,4,26,DEBIT,2000000.0,C1246134024
19629,1196428',2018-04-26,FDRL/REAL TIME GROSS SETTL,2000000.0,0.0,,2018,4,26,PAYEMENT,2000000.0,C875830058
19630,1196428',2018-04-26,FDRL/REAL TIME GROSS SETTL,2000000.0,0.0,,2018,4,26,CHECK_WITHDRAWAL,2000000.0,C347725669
19631,1196428',2018-04-26,FDRL/REAL TIME GROSS SETTL,2000000.0,0.0,,2018,4,26,CHECK_WITHDRAWAL,2000000.0,C1474411656
19632,1196428',2018-04-26,FDRL/REAL TIME GROSS SETTL,2000000.0,0.0,,2018,4,26,DEBIT,2000000.0,C771303504
19633,1196428',2018-04-26,RTGS/HDFCH18116684946/GIL,0.0,201000.0,,2018,4,26,TRANSFER,201000.0,C2083562754
19634,1196428',2018-04-26,TRF FROM  Indiaforensic ONLINE S,0.0,54846.0,,2018,4,26,CHECK_CASHING,54846.0,C611621587
19635,1196428',2018-04-26,NEFT/P18042696523747/KADU,0.0,100000.0,,2018,4,26,CASH_IN,100000.0,C1887692104
19636,1196428',2018-04-26,NEFT/N116180527220176/PAY,0.0,301038.36,,2018,4,26,CHECK_CASHING,301038.36,C761069599
19637,1196428',2018-04-26,NEFT/PUNBH18116343791/PUN,0.0,100000.0,,2018,4,26,CASH_IN,100000.0,C1219273867
19638,1196428',2018-04-26,NEFT/N116180527229056/PAY,0.0,3317360.69,,2018,4,26,TRANSFER,3317360.69,C175291188
19639,1196428',2018-04-26,NEFT/N116180527250353/ASH,0.0,109999.0,,2018,4,26,CHECK_CASHING,109999.0,C1332701679
19640,1196428',2018-04-26,CHQ DEPOSIT RETURN/89012/,25000.0,0.0,,2018,4,26,CHECK_WITHDRAWAL,25000.0,M842696460
19641,1196428',2018-04-26,TRF TO  Indiaforensic SERVICES I,500000.0,0.0,,2018,4,26,CHECK_WITHDRAWAL,500000.0,C3743274
19642,1196428',2018-04-26,TRF FROM  Indiaforensic SERVICES,0.0,5900000.0,,2018,4,26,TRANSFER,5900000.0,C470217116
19643,1196428',2018-04-26,FDRL/INTERNAL FUND TRANSFE,5000000.0,0.0,,2018,4,26,PAYEMENT,5000000.0,C1211297851
19644,1196428',2018-04-26,FDRL/INTERNAL FUND TRANSFE,5000000.0,0.0,,2018,4,26,PAYEMENT,5000000.0,C1760872167
19645,1196428',2018-04-26,FDRL/INTERNAL FUND TRANSFE,500000.0,0.0,,2018,4,26,CHECK_WITHDRAWAL,500000.0,C587433505
19646,1196428',2018-04-26,FDRL/INTERNAL FUND TRANSFE,500000.0,0.0,,2018,4,26,PAYEMENT,500000.0,C265108079
19647,1196428',2018-04-27,FDRL/INTERNAL FUND TRANSFE,500000.0,0.0,,2018,4,27,PAYEMENT,500000.0,C224342296
19648,1196428',2018-04-27,FDRL/INTERNAL FUND TRANSFE,500000.0,0.0,,2018,4,27,PAYEMENT,500000.0,C599968109
19649,1196428',2018-04-27,NEFT/IOBAN18117455343/NAR,0.0,20000.0,,2018,4,27,CASH_IN,20000.0,C580735116
19650,1196428',2018-04-27,NEFT/N117180527611498/TEC,0.0,300000.0,,2018,4,27,CASH_IN,300000.0,C1738994372
19651,1196428',2018-04-27,NEFT/BARBV18117581203/SAN,0.0,50000.0,,2018,4,27,TRANSFER,50000.0,C1394526584
19652,1196428',2018-04-27,NEFT/BARBV18117581388/SAN,0.0,9000.0,,2018,4,27,CHECK_CASHING,9000.0,C849038219
19653,1196428',2018-04-27,RTGS/HDFCH18117815015/PAY,0.0,1520000.0,,2018,4,27,TRANSFER,1520000.0,C194746285
19654,1196428',2018-04-27,RTGS/HDFCH18117815005/PAY,0.0,2240000.0,,2018,4,27,CASH_IN,2240000.0,C1940189108
19655,1196428',2018-04-27,FDRL/NATIONAL ELECTRONIC F,126690.0,0.0,,2018,4,27,CASH_OUT,126690.0,C471293240
19656,1196428',2018-04-27,FDRL/NATIONAL ELECTRONIC F,253500.0,0.0,,2018,4,27,DEBIT,253500.0,C569022831
19657,1196428',2018-04-27,FDRL/NATIONAL ELECTRONIC F,389660.0,0.0,,2018,4,27,CASH_OUT,389660.0,C66893623
19658,1196428',2018-04-27,FDRL/INTERNAL FUND TRANSFE,500000.0,0.0,,2018,4,27,CASH_OUT,500000.0,C1880332929
19659,1196428',2018-04-27,FDRL/INTERNAL FUND TRANSFE,500000.0,0.0,,2018,4,27,CASH_OUT,500000.0,C1842297286
19660,1196428',2018-04-27,FDRL/INTERNAL FUND TRANSFE,500000.0,0.0,,2018,4,27,CASH_OUT,500000.0,C2011904058
19661,1196428',2018-04-27,PROCESSING_FEE_ODGEN,1200000.0,0.0,,2018,4,27,DEBIT,1200000.0,C2036926986
19662,1196428',2018-04-27,GOODS AND SERVICES TAX,216000.0,0.0,,2018,4,27,DEBIT,216000.0,C1757877803
19663,1196428',2018-04-27,FDRL/INTERNAL FUND TRANSFE,500000.0,0.0,,2018,4,27,DEBIT,500000.0,C1058634310
19664,1196428',2018-04-27,CASHDEP/CHITTORGAR/,0.0,40000.0,,2018,4,27,CASH_IN,40000.0,C1426908073
19665,1196428',2018-04-27,NEFT/000036886426/ACCOUNT,0.0,126690.0,,2018,4,27,TRANSFER,126690.0,C1023714065
19666,1196428',2018-04-27,NEFT/000036886432/ACCOUNT,0.0,253500.0,,2018,4,27,CASH_IN,253500.0,C1924874046
19667,1196428',2018-04-27,FDRL/INTERNAL FUND TRANSFE,500000.0,0.0,,2018,4,27,CHECK_WITHDRAWAL,500000.0,C1414763289
19668,1196428',2018-04-27,RTGS/HDFCH18117867919/PAY,0.0,2240000.0,,2018,4,27,CASH_IN,2240000.0,C313124964
19669,1196428',2018-04-27,NEFT/AXISP18117046094/ACC,0.0,13200000.0,,2018,4,27,TRANSFER,13200000.0,C208427878
19670,1196428',2018-04-27,TRF FROM  Indiaforensic SERVICES,0.0,15000000.0,,2018,4,27,CASH_IN,15000000.0,C1577420620
19671,1196428',2018-04-27,TRF FROM  Indiaforensic SERVICES,0.0,13400000.0,,2018,4,27,CASH_IN,13400000.0,C580431625
19672,1196428',2018-04-27,FDRL/REAL TIME GROSS SETTL,15000000.0,0.0,,2018,4,27,DEBIT,15000000.0,C208427878
19673,1196428',2018-04-27,FDRL/REAL TIME GROSS SETTL,15000000.0,0.0,,2018,4,27,CASH_OUT,15000000.0,C1981839580
19674,1196428',2018-04-27,FDRL/REAL TIME GROSS SETTL,2000000.0,0.0,,2018,4,27,DEBIT,2000000.0,C447691425
19675,1196428',2018-04-27,FDRL/REAL TIME GROSS SETTL,2000000.0,0.0,,2018,4,27,PAYEMENT,2000000.0,C705321061
19676,1196428',2018-04-27,FDRL/REAL TIME GROSS SETTL,2000000.0,0.0,,2018,4,27,PAYEMENT,2000000.0,C248609774
19677,1196428',2018-04-27,FDRL/REAL TIME GROSS SETTL,2000000.0,0.0,,2018,4,27,CASH_OUT,2000000.0,C160284738
19678,1196428',2018-04-27,FDRL/REAL TIME GROSS SETTL,2000000.0,0.0,,2018,4,27,CASH_OUT,2000000.0,C1059781259
19679,1196428',2018-04-27,FDRL/REAL TIME GROSS SETTL,2000000.0,0.0,,2018,4,27,PAYEMENT,2000000.0,C128736076
19680,1196428',2018-04-27,TRF FROM  Indiaforensic SERVICES,0.0,6000000.0,,2018,4,27,TRANSFER,6000000.0,C339099861
19681,1196428',2018-04-27,FDRL/INTERNAL FUND TRANSFE,500000.0,0.0,,2018,4,27,DEBIT,500000.0,C713961699
19682,1196428',2018-04-27,CASHDEP/VIKASMARG/TP,0.0,118000.0,,2018,4,27,CHECK_CASHING,118000.0,C678308721
19683,1196428',2018-04-27,NEFT/N117180528156783/PAY,0.0,397354.24,,2018,4,27,CASH_IN,397354.24,C1410669831
19684,1196428',2018-04-27,IMPS 811717313997 FROM AS,0.0,110225.0,,2018,4,27,TRANSFER,110225.0,C1880332929
19685,1196428',2018-04-27,Payments For : 9090000542,1154724.68,0.0,,2018,4,27,CHECK_WITHDRAWAL,1154724.68,C1211297851
19686,1196428',2018-04-27,Payments For : 9090000542,3550685.0,0.0,,2018,4,27,PAYEMENT,3550685.0,C1978557426
19687,1196428',2018-04-27,NEFT/N117180528161291/PAY,0.0,4000000.0,,2018,4,27,TRANSFER,4000000.0,C75457651
19688,1196428',2018-04-27,NEFT/N117180528161242/PAY,0.0,1159093.61,,2018,4,27,TRANSFER,1159093.61,C1390121014
19689,1196428',2018-04-27,FDRL/INTERNAL FUND TRANSFE,300000.0,0.0,,2018,4,27,CHECK_WITHDRAWAL,300000.0,C1185567380
19690,1196428',2018-04-27,FDRL/INTERNAL FUND TRANSFE,300000.0,0.0,,2018,4,27,CASH_OUT,300000.0,C1141137903
19691,1196428',2018-04-27,FDRL/INTERNAL FUND TRANSFE,2000000.0,0.0,,2018,4,27,CHECK_WITHDRAWAL,2000000.0,C818570949
19692,1196428',2018-04-27,NEFT/SBIN818117758002/MS,0.0,20000.0,,2018,4,27,CASH_IN,20000.0,C675203915
19693,1196428',2018-04-27,NEFT/20515015431DC/ARTHAS,0.0,50000.0,,2018,4,27,CASH_IN,50000.0,C1945802665
19694,1196428',2018-04-27,NEFT/IOBAN18117594944/NAR,0.0,31953.0,,2018,4,27,CASH_IN,31953.0,C1313534832
19695,1196428',2018-04-27,FDRL/INTERNAL FUND TRANSFE,6000000.0,0.0,,2018,4,27,CHECK_WITHDRAWAL,6000000.0,C715819458
19696,1196428',2018-04-27,BEAT CSH PKP DEL GURG 643,0.0,271000.0,,2018,4,27,CASH_IN,271000.0,C1790831319
19697,1196428',2018-04-27,FDRL/INTERNAL FUND TRANSFE,0.0,3000000.0,,2018,4,27,TRANSFER,3000000.0,C372017580
19698,1196428',2018-04-27,FDRL/INTERNAL FUND TRANSFE,2000000.0,0.0,,2018,4,27,PAYEMENT,2000000.0,C651445737
19699,1196428',2018-04-27,FDRL/INTERNAL FUND TRANSFE,500000.0,0.0,,2018,4,27,CASH_OUT,500000.0,C1671386208
19700,1196428',2018-04-27,FDRL/INTERNAL FUND TRANSFE,500000.0,0.0,,2018,4,27,DEBIT,500000.0,C1256728724
19701,1196428',2018-04-30,RTGS/UTIBH18120681819/PER,0.0,1000000.0,,2018,4,30,TRANSFER,1000000.0,M1416318316
19702,1196428',2018-04-30,NEFT/IOBAN18120673643/NAR,0.0,19175.0,,2018,4,30,TRANSFER,19175.0,M266230483
19703,1196428',2018-04-30,RTGS/SBINH18120010851/Indfor,0.0,3000000.0,,2018,4,30,CASH_IN,3000000.0,M888481372
19704,1196428',2018-04-30,FDRL/NATIONAL ELECTRONIC F,1175565.0,0.0,,2018,4,30,CASH_OUT,1175565.0,M44852826
19705,1196428',2018-04-30,FDRL/NATIONAL ELECTRONIC F,1646342.0,0.0,,2018,4,30,CASH_OUT,1646342.0,M2106457809
19706,1196428',2018-04-30,FDRL/NATIONAL ELECTRONIC F,1542129.0,0.0,,2018,4,30,PAYEMENT,1542129.0,M780445680
19707,1196428',2018-04-30,RTGS/HDFCH18120024838/MAH,0.0,250000.0,,2018,4,30,TRANSFER,250000.0,C1150043970
19708,1196428',2018-04-30,CHQ DEP/279298/OWDEL1/UTI,0.0,11800.0,,2018,4,30,TRANSFER,11800.0,C681419196
19709,1196428',2018-04-30,CHQ DEP/610105/OWDEL1/ORB,0.0,11800.0,,2018,4,30,CASH_IN,11800.0,C388527192
19710,1196428',2018-04-30,CHQ DEP/60721/OWDEL1/INDR,0.0,11800.0,,2018,4,30,CASH_IN,11800.0,C787040724
19711,1196428',2018-04-30,NEFT/IOBAN18120468612/NAR,0.0,45123.0,,2018,4,30,CHECK_CASHING,45123.0,M566205790
19712,1196428',2018-04-30,IMPS 812015016268 FROM SA,0.0,30000.0,,2018,4,30,CHECK_CASHING,30000.0,M773209924
19713,1196428',2018-04-30,NEFT/P18043096657829/KADU,0.0,70000.0,,2018,4,30,CHECK_CASHING,70000.0,M1357504973
19714,1196428',2018-04-30,IMPS 812016308714 FROM AS,0.0,65000.0,,2018,4,30,CHECK_CASHING,65000.0,M306472468
19715,1196428',2018-04-30,IMPS 812017329088 FROM AS,0.0,24998.0,,2018,4,30,TRANSFER,24998.0,M245162942
19716,1196428',2018-04-30,FDRL/INTERNAL FUND TRANSFE,200000.0,0.0,,2018,4,30,PAYEMENT,200000.0,M251169645
19717,1196428',2018-04-30,FDRL/INTERNAL FUND TRANSFE,0.0,2000000.0,,2018,4,30,CASH_IN,2000000.0,M1388264076
19718,1196428',2018-04-30,FDRL/INTERNAL FUND TRANSFE,2000000.0,0.0,,2018,4,30,DEBIT,2000000.0,M1313821159
19719,1196428',2018-04-30,1196428:Int.Coll:01-04-20,795461.0,0.0,,2018,4,30,DEBIT,795461.0,M1663347416
19720,1196428',2018-05-01,IMPS 812110380503 FROM AS,0.0,90994.0,,2018,5,1,CASH_IN,90994.0,C506903242
19721,1196428',2018-05-01,TRF FROM  Indiaforensic SERVICES,0.0,15000000.0,,2018,5,1,TRANSFER,15000000.0,M2072059657
19722,1196428',2018-05-01,TRF FROM  Indiaforensic SERVICES,0.0,15000000.0,,2018,5,1,CASH_IN,15000000.0,C304406966
19723,1196428',2018-05-01,TRF FROM  Indiaforensic SERVICES,0.0,15000000.0,,2018,5,1,CHECK_CASHING,15000000.0,C75629578
19724,1196428',2018-05-01,TRF FROM  Indiaforensic SERVICES,0.0,10000000.0,,2018,5,1,CHECK_CASHING,10000000.0,M1037398211
19725,1196428',2018-05-01,TRF FROM  Indiaforensic SERVICES,0.0,10000000.0,,2018,5,1,TRANSFER,10000000.0,C2072030256
19726,1196428',2018-05-01,FDRL/REAL TIME GROSS SETTL,15000000.0,0.0,,2018,5,1,PAYEMENT,15000000.0,C886888353
19727,1196428',2018-05-01,FDRL/REAL TIME GROSS SETTL,15000000.0,0.0,,2018,5,1,CHECK_WITHDRAWAL,15000000.0,C701279123
19728,1196428',2018-05-01,FDRL/REAL TIME GROSS SETTL,15000000.0,0.0,,2018,5,1,PAYEMENT,15000000.0,C864016033
19729,1196428',2018-05-01,FDRL/NATIONAL ELECTRONIC F,3479264.0,0.0,,2018,5,1,PAYEMENT,3479264.0,C515442419
19730,1196428',2018-05-01,FDRL/NATIONAL ELECTRONIC F,31640.0,0.0,,2018,5,1,CHECK_WITHDRAWAL,31640.0,M2127093801
19731,1196428',2018-05-01,FDRL/NATIONAL ELECTRONIC F,126690.0,0.0,,2018,5,1,CHECK_WITHDRAWAL,126690.0,C1649686970
19732,1196428',2018-05-01,FDRL/NATIONAL ELECTRONIC F,253500.0,0.0,,2018,5,1,DEBIT,253500.0,C701855966
19733,1196428',2018-05-01,FDRL/INTERNAL FUND TRANSFE,2000000.0,0.0,,2018,5,1,PAYEMENT,2000000.0,C1505217516
19734,1196428',2018-05-01,FDRL/INTERNAL FUND TRANSFE,2000000.0,0.0,,2018,5,1,CHECK_WITHDRAWAL,2000000.0,M676875212
19735,1196428',2018-05-01,RTGS/PUNBH18121451749/PUN,0.0,400000.0,,2018,5,1,CASH_IN,400000.0,C681709819
19736,1196428',2018-05-01,NEFT/BARBW18121636499/MAK,0.0,58500.0,,2018,5,1,CHECK_CASHING,58500.0,M1025042585
19737,1196428',2018-05-01,FDRL/INTERNAL FUND TRANSFE,200000.0,0.0,,2018,5,1,CHECK_WITHDRAWAL,200000.0,C807247901
19738,1196428',2018-05-01,FDRL/INTERNAL FUND TRANSFE,200000.0,0.0,,2018,5,1,CASH_OUT,200000.0,M18308448
19739,1196428',2018-05-01,NEFT/IOBAN18121657282/NAR,0.0,51265.0,,2018,5,1,CHECK_CASHING,51265.0,M170030714
19740,1196428',2018-05-01,TRF FROM  Indiaforensic SERVICES,0.0,5500000.0,,2018,5,1,CHECK_CASHING,5500000.0,M621155607
19741,1196428',2018-05-01,TRF FROM  Indiaforensic SERVICES,0.0,15000000.0,,2018,5,1,CASH_IN,15000000.0,C1660095722
19742,1196428',2018-05-01,FDRL/REAL TIME GROSS SETTL,2000000.0,0.0,,2018,5,1,CASH_OUT,2000000.0,M1571765149
19743,1196428',2018-05-01,FDRL/REAL TIME GROSS SETTL,2000000.0,0.0,,2018,5,1,DEBIT,2000000.0,C1663686815
19744,1196428',2018-05-01,FDRL/REAL TIME GROSS SETTL,2000000.0,0.0,,2018,5,1,CHECK_WITHDRAWAL,2000000.0,M279824269
19745,1196428',2018-05-01,FDRL/REAL TIME GROSS SETTL,2000000.0,0.0,,2018,5,1,DEBIT,2000000.0,M1570490488
19746,1196428',2018-05-01,FDRL/REAL TIME GROSS SETTL,2000000.0,0.0,,2018,5,1,CHECK_WITHDRAWAL,2000000.0,M1063002743
19747,1196428',2018-05-01,FDRL/REAL TIME GROSS SETTL,2000000.0,0.0,,2018,5,1,PAYEMENT,2000000.0,M1530195938
19748,1196428',2018-05-01,NEFT/N121180530498279/ASH,0.0,24995.0,,2018,5,1,CASH_IN,24995.0,C1883840933
19749,1196428',2018-05-01,RTGS/PUNBH18121461246/PUN,0.0,200000.0,,2018,5,1,CASH_IN,200000.0,M2097586567
19750,1196428',2018-05-01,FDRL/INTERNAL FUND TRANSFE,500000.0,0.0,,2018,5,1,CASH_OUT,500000.0,C1700852615
19751,1196428',2018-05-01,FDRL/INTERNAL FUND TRANSFE,0.0,1000000.0,,2018,5,1,CASH_IN,1000000.0,C1457728035
19752,1196428',2018-05-01,FDRL/INTERNAL FUND TRANSFE,0.0,2000000.0,,2018,5,1,TRANSFER,2000000.0,C47249488
19753,1196428',2018-05-01,FDRL/INTERNAL FUND TRANSFE,7000000.0,0.0,,2018,5,1,DEBIT,7000000.0,C33524623
19754,1196428',2018-05-01,FDRL/INTERNAL FUND TRANSFE,7000000.0,0.0,,2018,5,1,DEBIT,7000000.0,C2133591152
19755,1196428',2018-05-01,FDRL/INTERNAL FUND TRANSFE,7000000.0,0.0,,2018,5,1,PAYEMENT,7000000.0,C193864812
19756,1196428',2018-05-01,FDRL/INTERNAL FUND TRANSFE,2000000.0,0.0,,2018,5,1,CHECK_WITHDRAWAL,2000000.0,C1058921154
19757,1196428',2018-05-01,BEAT CSH PKP DEL GURG 643,0.0,219500.0,,2018,5,1,TRANSFER,219500.0,C798678484
19758,1196428',2018-05-02,RTGS/SCBLH18122001661/FIX,0.0,200000.0,,2018,5,2,CASH_IN,200000.0,C769342184
19759,1196428',2018-05-02,RTGS/HDFCH18122259212/PAY,0.0,6800000.0,,2018,5,2,CASH_IN,6800000.0,C981198566
19760,1196428',2018-05-02,RTGS/HDFCH18122262902/PAY,0.0,11600000.0,,2018,5,2,TRANSFER,11600000.0,C1281898359
19761,1196428',2018-05-02,NEFT/N122180531040724/ASH,0.0,90555.0,,2018,5,2,CASH_IN,90555.0,C30013970
19762,1196428',2018-05-02,NEFT/IDFBH18122029055/FUN,0.0,49000.0,,2018,5,2,TRANSFER,49000.0,C31789747
19763,1196428',2018-05-02,FDRL/NATIONAL ELECTRONIC F,603868.0,0.0,,2018,5,2,CASH_OUT,603868.0,C93518808
19764,1196428',2018-05-02,RTGS/UTIBH18122695695/PER,0.0,890000.0,,2018,5,2,CASH_IN,890000.0,C2093546827
19765,1196428',2018-05-02,IMPS 812212311444 FROM AS,0.0,120450.0,,2018,5,2,TRANSFER,120450.0,C976133979
19766,1196428',2018-05-02,CHQ DEP/681174/OWDEL1/SBI,0.0,11800.0,,2018,5,2,CHECK_CASHING,11800.0,C849038219
19767,1196428',2018-05-02,CHQ DEP/552525/OWDEL1/SBI,0.0,11800.0,,2018,5,2,TRANSFER,11800.0,C1789550256
19768,1196428',2018-05-02,CHQ DEP/181021/OWDEL1/UBI,0.0,11800.0,,2018,5,2,CHECK_CASHING,11800.0,C363475076
19769,1196428',2018-05-02,CHQ DEP/324684/OWDEL1/PUN,0.0,11800.0,,2018,5,2,TRANSFER,11800.0,C2110623348
19770,1196428',2018-05-02,CHQ DEP/917/OWDEL1/HDFC/J,0.0,11800.0,,2018,5,2,TRANSFER,11800.0,C1161820020
19771,1196428',2018-05-02,CHQ DEP/54454/OWDEL1/ORBC,0.0,11800.0,,2018,5,2,TRANSFER,11800.0,C627675433
19772,1196428',2018-05-02,CHQ DEP/625797/OWDEL1/IND,0.0,11800.0,,2018,5,2,TRANSFER,11800.0,C1145835418
19773,1196428',2018-05-02,CHQ DEP/645919/OWDEL1/SBI,0.0,11800.0,,2018,5,2,CHECK_CASHING,11800.0,C1778300121
19774,1196428',2018-05-02,CHQ DEP/309178/OWDEL1/PUN,0.0,11800.0,,2018,5,2,CASH_IN,11800.0,C1325626015
19775,1196428',2018-05-02,CHQ DEP/582296/OWDEL1/SBI,0.0,11800.0,,2018,5,2,TRANSFER,11800.0,C8733802
19776,1196428',2018-05-02,CHQ DEP/186/OWDEL1/HDFC/Y,0.0,11800.0,,2018,5,2,TRANSFER,11800.0,C990053853
19777,1196428',2018-05-02,CHQ DEP/205828/OWDEL1/PUN,0.0,11800.0,,2018,5,2,TRANSFER,11800.0,C218193338
19778,1196428',2018-05-02,CHQ DEP/19858/OWDEL1/ORBC,0.0,11800.0,,2018,5,2,CHECK_CASHING,11800.0,M832073005
19779,1196428',2018-05-02,CHQ DEP/554565/OWDEL1/SBI,0.0,11800.0,,2018,5,2,CASH_IN,11800.0,M189083850
19780,1196428',2018-05-02,CHQ DEP/419094/OWDEL1/SBI,0.0,11800.0,,2018,5,2,TRANSFER,11800.0,C103357744
19781,1196428',2018-05-02,CHQ DEP/316498/OWDEL1/SBI,0.0,11800.0,,2018,5,2,CASH_IN,11800.0,M1942890330
19782,1196428',2018-05-02,CHQ DEP/514807/OWDEL1/SBI,0.0,11800.0,,2018,5,2,CASH_IN,11800.0,C2011941350
19783,1196428',2018-05-02,CHQ DEP/6111/OWDEL1/ORBC/,0.0,11800.0,,2018,5,2,TRANSFER,11800.0,C1505755152
19784,1196428',2018-05-02,CHQ DEP/702039/OWDEL1/SBI,0.0,11800.0,,2018,5,2,CHECK_CASHING,11800.0,M1051118371
19785,1196428',2018-05-02,CHQ DEP/332911/OWDEL1/SBI,0.0,11800.0,,2018,5,2,CHECK_CASHING,11800.0,M1502077581
19786,1196428',2018-05-02,CHQ DEP/837403/OWDEL1/PUN,0.0,11800.0,,2018,5,2,TRANSFER,11800.0,M1801625172
19787,1196428',2018-05-02,CHQ DEP/474131/OWDEL1/UTB,0.0,11800.0,,2018,5,2,CHECK_CASHING,11800.0,C360898540
19788,1196428',2018-05-02,CHQ DEP/143245/OWDEL1/SBI,0.0,11800.0,,2018,5,2,TRANSFER,11800.0,M1408738192
19789,1196428',2018-05-02,"Indiaforensic USA, INC./USD/1407",0.0,935549.55,,2018,5,2,TRANSFER,935549.55,C237594516
19790,1196428',2018-05-02,IRTT00701812717,1226.99,0.0,,2018,5,2,PAYEMENT,1226.99,M1645271006
19791,1196428',2018-05-02,NEFT/K241181220085891/M S,0.0,11800.0,,2018,5,2,TRANSFER,11800.0,M1616707854
19792,1196428',2018-05-02,NEFT/N122180531352244/TEC,0.0,300000.0,,2018,5,2,CASH_IN,300000.0,C1334973394
19793,1196428',2018-05-02,NEFT/AXISP18122289103/ACC,0.0,1000000.0,,2018,5,2,TRANSFER,1000000.0,M1547406846
19794,1196428',2018-05-02,TRF FROM  Indiaforensic SERVICES,0.0,15000000.0,,2018,5,2,CASH_IN,15000000.0,M51814511
19795,1196428',2018-05-02,TRF FROM  Indiaforensic SERVICES,0.0,9900000.0,,2018,5,2,CHECK_CASHING,9900000.0,M1679527434
19796,1196428',2018-05-02,FDRL/INTERNAL FUND TRANSFE,2000000.0,0.0,,2018,5,2,PAYEMENT,2000000.0,M858729243
19797,1196428',2018-05-02,FDRL/INTERNAL FUND TRANSFE,2000000.0,0.0,,2018,5,2,DEBIT,2000000.0,M317858117
19798,1196428',2018-05-02,FDRL/REAL TIME GROSS SETTL,15000000.0,0.0,,2018,5,2,PAYEMENT,15000000.0,M974232437
19799,1196428',2018-05-02,FDRL/REAL TIME GROSS SETTL,2000000.0,0.0,,2018,5,2,PAYEMENT,2000000.0,M535001108
19800,1196428',2018-05-02,FDRL/REAL TIME GROSS SETTL,2000000.0,0.0,,2018,5,2,CHECK_WITHDRAWAL,2000000.0,M967799453
19801,1196428',2018-05-02,FDRL/REAL TIME GROSS SETTL,2000000.0,0.0,,2018,5,2,CASH_OUT,2000000.0,M1704857178
19802,1196428',2018-05-02,FDRL/REAL TIME GROSS SETTL,2000000.0,0.0,,2018,5,2,PAYEMENT,2000000.0,M888552844
19803,1196428',2018-05-02,FDRL/REAL TIME GROSS SETTL,2000000.0,0.0,,2018,5,2,CASH_OUT,2000000.0,M257269635
19804,1196428',2018-05-02,NEFT/20519509251DC/ARTHAS,0.0,500000.0,,2018,5,2,CHECK_CASHING,500000.0,C1305075214
19805,1196428',2018-05-02,NEFT/20519516041DC/ARTHAS,0.0,225000.0,,2018,5,2,CASH_IN,225000.0,C1627965794
19806,1196428',2018-05-02,CHQ DEPOSIT RETURN/309178,11800.0,0.0,,2018,5,2,CHECK_WITHDRAWAL,11800.0,M1559676676
19807,1196428',2018-05-02,CHQ DEPOSIT RETURN/554565,11800.0,0.0,,2018,5,2,CHECK_WITHDRAWAL,11800.0,C741431520
19808,1196428',2018-05-02,CHQ DEPOSIT RETURN/419094,11800.0,0.0,,2018,5,2,CASH_OUT,11800.0,C2143477943
19809,1196428',2018-05-02,FDRL/INTERNAL FUND TRANSFE,500000.0,0.0,,2018,5,2,DEBIT,500000.0,C638551812
19810,1196428',2018-05-02,Indiaforensic SERVICES INDIA PVT,0.0,776375.95,,2018,5,2,TRANSFER,776375.95,C1027296777
19811,1196428',2018-05-02,NEFT/N122180531748870/PAY,0.0,1.0,,2018,5,2,TRANSFER,1.0,C1554540309
19812,1196428',2018-05-02,NEFT/N122180531753624/PAY,0.0,3823600.03,,2018,5,2,CHECK_CASHING,3823600.03,M2120427827
19813,1196428',2018-05-02,NEFT/SBIN318122049511/MS,0.0,50000.0,,2018,5,2,CHECK_CASHING,50000.0,C820910648
19814,1196428',2018-05-02,NEFT/P18050296776210/KADU,0.0,100000.0,,2018,5,2,CASH_IN,100000.0,M415456371
19815,1196428',2018-05-02,NEFT/20519784771DC/DEVIKI,0.0,11800.0,,2018,5,2,CASH_IN,11800.0,M598340030
19816,1196428',2018-05-02,BEAT CSH PKP DEL GURG 643,0.0,30500.0,,2018,5,2,CASH_IN,30500.0,C345679794
19817,1196428',2018-05-02,TRF FROM  Indiaforensic SERVICES,0.0,6000000.0,,2018,5,2,TRANSFER,6000000.0,M1605050346
19818,1196428',2018-05-02,FDRL/INTERNAL FUND TRANSFE,6000000.0,0.0,,2018,5,2,PAYEMENT,6000000.0,C1144070975
19819,1196428',2018-05-02,FDRL/INTERNAL FUND TRANSFE,5000000.0,0.0,,2018,5,2,CASH_OUT,5000000.0,M639999796
19820,1196428',2018-05-02,FDRL/INTERNAL FUND TRANSFE,3000000.0,0.0,,2018,5,2,DEBIT,3000000.0,C343534938
19821,1196428',2018-05-02,FDRL/INTERNAL FUND TRANSFE,3000000.0,0.0,,2018,5,2,CASH_OUT,3000000.0,M479872561
19822,1196428',2018-05-02,FDRL/INTERNAL FUND TRANSFE,3000000.0,0.0,,2018,5,2,DEBIT,3000000.0,M61732893
19823,1196428',2018-05-02,CHQ DEPOSIT RETURN/309178,100.0,0.0,,2018,5,2,DEBIT,100.0,C160632822
19824,1196428',2018-05-02,CHQ DEPOSIT RETURN/309178,18.0,0.0,,2018,5,2,CASH_OUT,18.0,C1183266411
19825,1196428',2018-05-02,CHQ DEPOSIT RETURN/554565,100.0,0.0,,2018,5,2,CHECK_WITHDRAWAL,100.0,M1328778262
19826,1196428',2018-05-02,CHQ DEPOSIT RETURN/554565,18.0,0.0,,2018,5,2,DEBIT,18.0,M704806959
19827,1196428',2018-05-02,CHQ DEPOSIT RETURN/419094,100.0,0.0,,2018,5,2,DEBIT,100.0,C229313132
19828,1196428',2018-05-02,CHQ DEPOSIT RETURN/419094,18.0,0.0,,2018,5,2,CHECK_WITHDRAWAL,18.0,M325906300
19829,1196428',2018-05-03,Indiaforensic SERVICES INDIA PVT,0.0,230997.0,,2018,5,3,TRANSFER,230997.0,M1267748122
19830,1196428',2018-05-03,Indiaforensic SERVICES INDIA PVT,0.0,534976.0,,2018,5,3,CASH_IN,534976.0,M159739450
19831,1196428',2018-05-03,FDRL/NATIONAL ELECTRONIC F,1378302.0,0.0,,2018,5,3,DEBIT,1378302.0,M1702289141
19832,1196428',2018-05-03,FDRL/INTERNAL FUND TRANSFE,2000000.0,0.0,,2018,5,3,CASH_OUT,2000000.0,C1200612373
19833,1196428',2018-05-03,RTGS/HDFCH18123469016/PAY,0.0,4640000.0,,2018,5,3,TRANSFER,4640000.0,C1840046890
19834,1196428',2018-05-03,RTGS/HDFCH18123465403/PAY,0.0,1840000.0,,2018,5,3,TRANSFER,1840000.0,M1261751850
19835,1196428',2018-05-03,RTGS/UTIBH18123613065/PER,0.0,900000.0,,2018,5,3,TRANSFER,900000.0,M1535970431
19836,1196428',2018-05-03,FDRL/REAL TIME GROSS SETTL,1000000.0,0.0,,2018,5,3,DEBIT,1000000.0,M524251983
19837,1196428',2018-05-03,FDRL/REAL TIME GROSS SETTL,1000000.0,0.0,,2018,5,3,CHECK_WITHDRAWAL,1000000.0,C1406749291
19838,1196428',2018-05-03,FDRL/REAL TIME GROSS SETTL,1000000.0,0.0,,2018,5,3,CASH_OUT,1000000.0,C1415645767
19839,1196428',2018-05-03,FDRL/REAL TIME GROSS SETTL,1000000.0,0.0,,2018,5,3,PAYEMENT,1000000.0,M1816834020
19840,1196428',2018-05-03,FDRL/REAL TIME GROSS SETTL,1000000.0,0.0,,2018,5,3,DEBIT,1000000.0,C1732292969
19841,1196428',2018-05-03,FDRL/REAL TIME GROSS SETTL,1000000.0,0.0,,2018,5,3,PAYEMENT,1000000.0,M1739764490
19842,1196428',2018-05-03,FDRL/REAL TIME GROSS SETTL,1000000.0,0.0,,2018,5,3,CASH_OUT,1000000.0,M1664129150
19843,1196428',2018-05-03,FDRL/REAL TIME GROSS SETTL,1000000.0,0.0,,2018,5,3,CASH_OUT,1000000.0,M1128852062
19844,1196428',2018-05-03,FDRL/REAL TIME GROSS SETTL,1000000.0,0.0,,2018,5,3,CASH_OUT,1000000.0,M182471589
19845,1196428',2018-05-03,FDRL/REAL TIME GROSS SETTL,1000000.0,0.0,,2018,5,3,CHECK_WITHDRAWAL,1000000.0,M1056074872
19846,1196428',2018-05-03,IMPS 812312865612 FROM SA,0.0,200000.0,,2018,5,3,CASH_IN,200000.0,M2106622700
19847,1196428',2018-05-03,NEFT/BARBX18123540339/MAK,0.0,55650.0,,2018,5,3,CHECK_CASHING,55650.0,M163766295
19848,1196428',2018-05-03,NEFT/IOBAN18123438635/NAR,0.0,61263.0,,2018,5,3,CASH_IN,61263.0,M802332120
19849,1196428',2018-05-03,FDRL/INTERNAL FUND TRANSFE,2000000.0,0.0,,2018,5,3,CHECK_WITHDRAWAL,2000000.0,M1676185662
19850,1196428',2018-05-03,FDRL/INTERNAL FUND TRANSFE,300000.0,0.0,,2018,5,3,CASH_OUT,300000.0,M1776427379
19851,1196428',2018-05-03,"Indiaforensic USA, INC./USD/1518",0.0,1006955.73,,2018,5,3,TRANSFER,1006955.73,M334173295
19852,1196428',2018-05-03,IRTT00701813218,1286.25,0.0,,2018,5,3,PAYEMENT,1286.25,M330490124
19853,1196428',2018-05-03,FDRL/INTERNAL FUND TRANSFE,500000.0,0.0,,2018,5,3,DEBIT,500000.0,M1154845973
19854,1196428',2018-05-03,IRTT00701813222,1164.02,0.0,,2018,5,3,CHECK_WITHDRAWAL,1164.02,M911987264
19855,1196428',2018-05-03,Indiaforensic USA INC./USD/13026,0.0,865577.7,,2018,5,3,TRANSFER,865577.7,M1680147473
19856,1196428',2018-05-03,NEFT/IDIBH18123196805/Ms.,0.0,5000.0,,2018,5,3,CASH_IN,5000.0,M293659205
19857,1196428',2018-05-03,NEFT/SBIN318123742204/HAR,0.0,11800.0,,2018,5,3,CHECK_CASHING,11800.0,M1432093328
19858,1196428',2018-05-03,TRF FROM  Indiaforensic SERVICES,0.0,15000000.0,,2018,5,3,CASH_IN,15000000.0,M901262414
19859,1196428',2018-05-03,TRF FROM  Indiaforensic SERVICES,0.0,12500000.0,,2018,5,3,CASH_IN,12500000.0,M899962047
19860,1196428',2018-05-03,FDRL/REAL TIME GROSS SETTL,10000000.0,0.0,,2018,5,3,DEBIT,10000000.0,M32715716
19861,1196428',2018-05-03,FDRL/REAL TIME GROSS SETTL,15000000.0,0.0,,2018,5,3,CHECK_WITHDRAWAL,15000000.0,M1510311379
19862,1196428',2018-05-03,FDRL/INTERNAL FUND TRANSFE,1000000.0,0.0,,2018,5,3,DEBIT,1000000.0,M1517206841
19863,1196428',2018-05-03,NEFT/000046173162/SREE MA,0.0,11800.0,,2018,5,3,CHECK_CASHING,11800.0,M2030024765
19864,1196428',2018-05-03,NEFT/P18050305104670/K C,0.0,11800.0,,2018,5,3,CASH_IN,11800.0,M1267580132
19865,1196428',2018-05-03,FDRL/NATIONAL ELECTRONIC F,100000.0,0.0,,2018,5,3,DEBIT,100000.0,C655391383
19866,1196428',2018-05-03,FDRL/NATIONAL ELECTRONIC F,100000.0,0.0,,2018,5,3,DEBIT,100000.0,C2117215775
19867,1196428',2018-05-03,NEFT/N123180532840455/PAY,0.0,1.0,,2018,5,3,TRANSFER,1.0,C2106576360
19868,1196428',2018-05-03,NEFT/N123180532847234/PAY,0.0,359555.2,,2018,5,3,TRANSFER,359555.2,M267789972
19869,1196428',2018-05-03,FDRL/INTERNAL FUND TRANSFE,1000000.0,0.0,,2018,5,3,CASH_OUT,1000000.0,M292960678
19870,1196428',2018-05-03,Indiaforensic SERVICES INDIA PVT,0.0,469329.0,,2018,5,3,CHECK_CASHING,469329.0,C1638372110
19871,1196428',2018-05-03,NEFT/AXISP18123229661/ACC,0.0,3000000.0,,2018,5,3,CASH_IN,3000000.0,C1377774115
19872,1196428',2018-05-03,TRF FROM  Indiaforensic SERVICES,0.0,5800000.0,,2018,5,3,CASH_IN,5800000.0,M1877845145
19873,1196428',2018-05-03,BEAT CSH PKP DEL UDYO 643,0.0,165000.0,,2018,5,3,TRANSFER,165000.0,M869149988
19874,1196428',2018-05-03,FDRL/INTERNAL FUND TRANSFE,10000000.0,0.0,,2018,5,3,CHECK_WITHDRAWAL,10000000.0,M1324498984
19875,1196428',2018-05-03,FDRL/INTERNAL FUND TRANSFE,500000.0,0.0,,2018,5,3,CHECK_WITHDRAWAL,500000.0,C748014372
19876,1196428',2018-05-03,FDRL/INTERNAL FUND TRANSFE,500000.0,0.0,,2018,5,3,CASH_OUT,500000.0,M1556526073
19877,1196428',2018-05-04,FDRL/NATIONAL ELECTRONIC F,45055.0,0.0,,2018,5,4,DEBIT,45055.0,M1113797896
19878,1196428',2018-05-04,NEFT/SBIN418124199889/NAR,0.0,116.0,,2018,5,4,CHECK_CASHING,116.0,M111103216
19879,1196428',2018-05-04,FDRL/NATIONAL ELECTRONIC F,2094734.0,0.0,,2018,5,4,CASH_OUT,2094734.0,M402054040
19880,1196428',2018-05-04,IMPS 812411342332 FROM AS,0.0,60000.0,,2018,5,4,CHECK_CASHING,60000.0,C1174935745
19881,1196428',2018-05-04,RTGS/HDFCH18124669164/PAY,0.0,3440000.0,,2018,5,4,CHECK_CASHING,3440000.0,M3128155
19882,1196428',2018-05-04,RTGS/HDFCH18124663962/PAY,0.0,5120000.0,,2018,5,4,TRANSFER,5120000.0,M804435874
19883,1196428',2018-05-04,NEFT/VIJBH18124008133/PAD,0.0,11800.0,,2018,5,4,TRANSFER,11800.0,M22524150
19884,1196428',2018-05-04,NEFT/N124180533414852/TEC,0.0,300000.0,,2018,5,4,CHECK_CASHING,300000.0,C717951588
19885,1196428',2018-05-04,FDRL/REAL TIME GROSS SETTL,5000000.0,0.0,,2018,5,4,CASH_OUT,5000000.0,M994429804
19886,1196428',2018-05-04,FDRL/REAL TIME GROSS SETTL,2000000.0,0.0,,2018,5,4,PAYEMENT,2000000.0,M42960844
19887,1196428',2018-05-04,NEFT/IT36701805042721/FIX,0.0,100000.0,,2018,5,4,CASH_IN,100000.0,M117897905
19888,1196428',2018-05-04,NEFT/SAA354372472/K.K.AGE,0.0,11800.0,,2018,5,4,TRANSFER,11800.0,M919103236
19889,1196428',2018-05-04,FDRL/INTERNAL FUND TRANSFE,1000000.0,0.0,,2018,5,4,PAYEMENT,1000000.0,M2117556230
19890,1196428',2018-05-04,CHQ DEP/152/OWDEL1/HDFC/S,0.0,11800.0,,2018,5,4,CHECK_CASHING,11800.0,M2047174428
19891,1196428',2018-05-04,CHQ DEP/138585/OWDEL1/COR,0.0,11800.0,,2018,5,4,CASH_IN,11800.0,M1468774738
19892,1196428',2018-05-04,RTGS/PUNBH18124514691/PUN,0.0,300000.0,,2018,5,4,CHECK_CASHING,300000.0,M266577647
19893,1196428',2018-05-04,NEFT/N124180533621223/BAT,0.0,200000.0,,2018,5,4,TRANSFER,200000.0,M1474343674
19894,1196428',2018-05-04,"Indiaforensic USA, INC./USD/1354",0.0,899520.8,,2018,5,4,CHECK_CASHING,899520.8,M1664266643
19895,1196428',2018-05-04,IRTT00701813422,1194.57,0.0,,2018,5,4,DEBIT,1194.57,M842463018
19896,1196428',2018-05-04,FDRL/INTERNAL FUND TRANSFE,1000000.0,0.0,,2018,5,4,CASH_OUT,1000000.0,M284325832
19897,1196428',2018-05-04,FDRL/INTERNAL FUND TRANSFE,1000000.0,0.0,,2018,5,4,PAYEMENT,1000000.0,M1784760424
19898,1196428',2018-05-04,"Indiaforensic USA, INC./USD/1428",0.0,948741.13,,2018,5,4,CHECK_CASHING,948741.13,M1489026763
19899,1196428',2018-05-04,IRTT00701813456,1238.87,0.0,,2018,5,4,DEBIT,1238.87,C1800405372
19900,1196428',2018-05-04,NEFT/SBIN418124549977/NAR,0.0,61267.0,,2018,5,4,TRANSFER,61267.0,C2071512077
19901,1196428',2018-05-04,NEFT/P18050496950940/KADU,0.0,100000.0,,2018,5,4,CASH_IN,100000.0,C1588635270
19902,1196428',2018-05-04,TRF FROM  Indiaforensic SERVICES,0.0,15000000.0,,2018,5,4,TRANSFER,15000000.0,C1495001462
19903,1196428',2018-05-04,TRF FROM  Indiaforensic SERVICES,0.0,15000000.0,,2018,5,4,CHECK_CASHING,15000000.0,M84558619
19904,1196428',2018-05-04,TRF FROM  Indiaforensic SERVICES,0.0,300000.0,,2018,5,4,TRANSFER,300000.0,M113925453
19905,1196428',2018-05-04,FDRL/REAL TIME GROSS SETTL,15000000.0,0.0,,2018,5,4,PAYEMENT,15000000.0,M645245228
19906,1196428',2018-05-04,FDRL/REAL TIME GROSS SETTL,15000000.0,0.0,,2018,5,4,CHECK_WITHDRAWAL,15000000.0,M636094317
19907,1196428',2018-05-04,NEFT/N124180533898572/PAY,0.0,1.0,,2018,5,4,CASH_IN,1.0,M1583961850
19908,1196428',2018-05-04,NEFT/N124180533898908/PAY,0.0,2759308.64,,2018,5,4,CASH_IN,2759308.64,M708029389
19909,1196428',2018-05-04,CHQ DEPOSIT RETURN/138585,11800.0,0.0,,2018,5,4,PAYEMENT,11800.0,M508231066
19910,1196428',2018-05-04,Indiaforensic SERVICES INDIA PVT,0.0,282667.0,,2018,5,4,CASH_IN,282667.0,C1838491463
19911,1196428',2018-05-04,FDRL/INTERNAL FUND TRANSFE,200000.0,0.0,,2018,5,4,PAYEMENT,200000.0,M1094448975
19912,1196428',2018-05-04,FDRL/INTERNAL FUND TRANSFE,300000.0,0.0,,2018,5,4,CHECK_WITHDRAWAL,300000.0,M717841651
19913,1196428',2018-05-04,NEFT/AXISP18124157249/ACC,0.0,5000000.0,,2018,5,4,TRANSFER,5000000.0,M1954167102
19914,1196428',2018-05-04,TRF FROM  Indiaforensic SERVICES,0.0,4300000.0,,2018,5,4,CHECK_CASHING,4300000.0,M1043087369
19915,1196428',2018-05-04,BEAT CSH PKP DEL UDYO 643,0.0,120000.0,,2018,5,4,CHECK_CASHING,120000.0,M1489610760
19916,1196428',2018-05-04,FDRL/INTERNAL FUND TRANSFE,10000000.0,0.0,,2018,5,4,CASH_OUT,10000000.0,C1556875182
19917,1196428',2018-05-04,FDRL/INTERNAL FUND TRANSFE,3000000.0,0.0,,2018,5,4,PAYEMENT,3000000.0,M1109811596
19918,1196428',2018-05-04,FDRL/INTERNAL FUND TRANSFE,500000.0,0.0,,2018,5,4,PAYEMENT,500000.0,C101571284
19919,1196428',2018-05-04,CHQ DEPOSIT RETURN/138585,100.0,0.0,,2018,5,4,PAYEMENT,100.0,M178952563
19920,1196428',2018-05-04,CHQ DEPOSIT RETURN/138585,18.0,0.0,,2018,5,4,CHECK_WITHDRAWAL,18.0,M2081263541
19921,1196428',2018-05-05,IMPS 812506752414 FROM SU,0.0,750.0,,2018,5,5,CHECK_CASHING,750.0,C2078250226
19922,1196428',2018-05-05,IMPS 812510378543 FROM AS,0.0,65560.0,,2018,5,5,CASH_IN,65560.0,C1570256460
19923,1196428',2018-05-05,IMPS 812511551581 FROM DH,0.0,11800.0,,2018,5,5,TRANSFER,11800.0,M441055416
19924,1196428',2018-05-05,RTGS/HDFCH18125844468/PAY,0.0,4960000.0,,2018,5,5,CHECK_CASHING,4960000.0,C2077098348
19925,1196428',2018-05-05,RTGS/HDFCH18125844499/PAY,0.0,309888.56,,2018,5,5,CHECK_CASHING,309888.56,C1062254208
19926,1196428',2018-05-05,FDRL/INTERNAL FUND TRANSFE,2000000.0,0.0,,2018,5,5,CHECK_WITHDRAWAL,2000000.0,C1787868648
19927,1196428',2018-05-05,FDRL/NATIONAL ELECTRONIC F,2057722.0,0.0,,2018,5,5,PAYEMENT,2057722.0,C161140376
19928,1196428',2018-05-05,CHQ DEP/187131/OWDEL1/ORB,0.0,11800.0,,2018,5,5,CASH_IN,11800.0,M1471351873
19929,1196428',2018-05-05,CHQ DEP/925760/OWDEL1/ICI,0.0,11800.0,,2018,5,5,CHECK_CASHING,11800.0,M1328437771
19930,1196428',2018-05-05,CHQ DEP/635529/OWDEL1/IOB,0.0,11800.0,,2018,5,5,CHECK_CASHING,11800.0,M341537411
19931,1196428',2018-05-05,CHQ DEP/153618/OWDEL1/ORB,0.0,11800.0,,2018,5,5,CASH_IN,11800.0,M1367049026
19932,1196428',2018-05-05,CHQ DEP/1/OWDEL1/HDFC/PAL,0.0,11800.0,,2018,5,5,TRANSFER,11800.0,C2029310301
19933,1196428',2018-05-05,CHQ DEP/111/OWDEL1/HDFC/H,0.0,11800.0,,2018,5,5,CHECK_CASHING,11800.0,C1606699851
19934,1196428',2018-05-05,NEFT/IOBAN18125560427/NAR,0.0,54285.0,,2018,5,5,CHECK_CASHING,54285.0,C1103621993
19935,1196428',2018-05-05,FDRL/INTERNAL FUND TRANSFE,1000000.0,0.0,,2018,5,5,DEBIT,1000000.0,M34447014
19936,1196428',2018-05-05,NEFT/N125180534754013/JUN,0.0,10000.0,,2018,5,5,CASH_IN,10000.0,C1428675504
19937,1196428',2018-05-05,TRF FROM  Indiaforensic SERVICES,0.0,10000000.0,,2018,5,5,CHECK_CASHING,10000000.0,M1783999682
19938,1196428',2018-05-05,TRF FROM  Indiaforensic SERVICES,0.0,5000000.0,,2018,5,5,CHECK_CASHING,5000000.0,C1247600089
19939,1196428',2018-05-05,TRF FROM  Indiaforensic SERVICES,0.0,4000000.0,,2018,5,5,TRANSFER,4000000.0,M835388411
19940,1196428',2018-05-05,TRF FROM  Indiaforensic SERVICES,0.0,500000.0,,2018,5,5,CHECK_CASHING,500000.0,C404279307
19941,1196428',2018-05-05,TRF FROM  Indiaforensic SERVICES,0.0,10000000.0,,2018,5,5,CASH_IN,10000000.0,C278407008
19942,1196428',2018-05-05,FDRL/REAL TIME GROSS SETTL,15000000.0,0.0,,2018,5,5,PAYEMENT,15000000.0,M1721234210
19943,1196428',2018-05-05,NEFT/N125180534778505/BAT,0.0,100000.0,,2018,5,5,CHECK_CASHING,100000.0,M1576908104
19944,1196428',2018-05-05,FDRL/REAL TIME GROSS SETTL,15000000.0,0.0,,2018,5,5,DEBIT,15000000.0,M1547162536
19945,1196428',2018-05-05,NEFT/AXISP18125085389/ACC,0.0,10000000.0,,2018,5,5,CASH_IN,10000000.0,M1057827479
19946,1196428',2018-05-05,RTGS/PUNBH18125539926/PUN,0.0,250000.0,,2018,5,5,CHECK_CASHING,250000.0,M1498878973
19947,1196428',2018-05-05,CHQ DEPOSIT RETURN/635529,11800.0,0.0,,2018,5,5,PAYEMENT,11800.0,M1420281457
19948,1196428',2018-05-05,NEFT/N125180534854806/PAY,0.0,1.0,,2018,5,5,TRANSFER,1.0,M2000558609
19949,1196428',2018-05-05,NEFT/N125180534850698/PAY,0.0,1246822.44,,2018,5,5,CASH_IN,1246822.44,M1598229594
19950,1196428',2018-05-05,FDRL/INTERNAL FUND TRANSFE,1000000.0,0.0,,2018,5,5,PAYEMENT,1000000.0,M2001514483
19951,1196428',2018-05-05,NEFT/N125180534909693/PAY,0.0,545719.76,,2018,5,5,CASH_IN,545719.76,M1808413339
19952,1196428',2018-05-05,TRF FROM  Indiaforensic SERVICES,0.0,500000.0,,2018,5,5,CASH_IN,500000.0,M662376084
19953,1196428',2018-05-05,TRF FROM  Indiaforensic SERVICES,0.0,2000000.0,,2018,5,5,CASH_IN,2000000.0,M1462583713
19954,1196428',2018-05-05,TRF FRM  Indiaforensic SERVICES,0.0,5000000.0,,2018,5,5,CHECK_CASHING,5000000.0,M1292178703
19955,1196428',2018-05-05,FDRL/INTERNAL FUND TRANSFE,0.0,2000000.0,,2018,5,5,CASH_IN,2000000.0,M1378894443
19956,1196428',2018-05-05,NEFT/IOBAN18125654169/NAR,0.0,45283.0,,2018,5,5,CHECK_CASHING,45283.0,M671194471
19957,1196428',2018-05-05,BEAT CSH PKP DELUDYOG 643,0.0,114000.0,,2018,5,5,CASH_IN,114000.0,M2120887477
19958,1196428',2018-05-05,FDRL/INTERNAL FUND TRANSFE,1000000.0,0.0,,2018,5,5,CHECK_WITHDRAWAL,1000000.0,M1565473666
19959,1196428',2018-05-05,FDRL/INTERNAL FUND TRANSFE,2000000.0,0.0,,2018,5,5,CHECK_WITHDRAWAL,2000000.0,M336600403
19960,1196428',2018-05-05,FDRL/INTERNAL FUND TRANSFE,10000000.0,0.0,,2018,5,5,DEBIT,10000000.0,M1108314788
19961,1196428',2018-05-05,FDRL/INTERNAL FUND TRANSFE,8000000.0,0.0,,2018,5,5,CASH_OUT,8000000.0,M1776708407
19962,1196428',2018-05-05,CHQ DEPOSIT RETURN/635529,100.0,0.0,,2018,5,5,DEBIT,100.0,M1886072816
19963,1196428',2018-05-05,CHQ DEPOSIT RETURN/635529,18.0,0.0,,2018,5,5,DEBIT,18.0,M392269298
19964,1196428',2018-05-06,IMPS 812617387732 FROM AS,0.0,49997.0,,2018,5,6,CHECK_CASHING,49997.0,M240263357
19965,1196428',2018-05-07,NEFT/SBIN518127903532/NAR,0.0,81253.0,,2018,5,7,CHECK_CASHING,81253.0,M2137827177
19966,1196428',2018-05-07,FT ZL18050724549963 PRAVE,0.0,100000.0,,2018,5,7,CASH_IN,100000.0,M996688653
19967,1196428',2018-05-07,NEFT/FDRLH18127644220/SRE,0.0,100000.0,,2018,5,7,CHECK_CASHING,100000.0,C1829831147
19968,1196428',2018-05-07,RTGS/HDFCH18127988163/PAY,0.0,2000000.0,,2018,5,7,CHECK_CASHING,2000000.0,M720435458
19969,1196428',2018-05-07,RTGS/HDFCH18127994753/PAY,0.0,7040000.0,,2018,5,7,CHECK_CASHING,7040000.0,M29096009
19970,1196428',2018-05-07,CASHDEP/VIKASMARG/TP,0.0,161000.0,,2018,5,7,CHECK_CASHING,161000.0,M150995440
19971,1196428',2018-05-07,FDRL/NATIONAL ELECTRONIC F,1266681.0,0.0,,2018,5,7,CASH_OUT,1266681.0,M1241251535
19972,1196428',2018-05-07,FDRL/NATIONAL ELECTRONIC F,852186.0,0.0,,2018,5,7,PAYEMENT,852186.0,M1254542588
19973,1196428',2018-05-07,FDRL/REAL TIME GROSS SETTL,5000000.0,0.0,,2018,5,7,CHECK_WITHDRAWAL,5000000.0,M710538853
19974,1196428',2018-05-07,NEFT/N127180535575308/JUN,0.0,100000.0,,2018,5,7,CHECK_CASHING,100000.0,M399672840
19975,1196428',2018-05-07,RTGS/SCBLH18127003070/FIX,0.0,300000.0,,2018,5,7,CHECK_CASHING,300000.0,M1566931514
19976,1196428',2018-05-07,FDRL/INTERNAL FUND TRANSFE,2000000.0,0.0,,2018,5,7,CASH_OUT,2000000.0,C1540270363
19977,1196428',2018-05-07,TRF FROM  Indiaforensic SERVICES,0.0,12100000.0,,2018,5,7,TRANSFER,12100000.0,C900425684
19978,1196428',2018-05-07,TRF FROM  Indiaforensic SERVICES,0.0,15000000.0,,2018,5,7,CHECK_CASHING,15000000.0,M1361294362
19979,1196428',2018-05-07,TRF FROM  Indiaforensic SERVICES,0.0,15000000.0,,2018,5,7,CHECK_CASHING,15000000.0,C264843581
19980,1196428',2018-05-07,FDRL/REAL TIME GROSS SETTL,15000000.0,0.0,,2018,5,7,PAYEMENT,15000000.0,M1897445965
19981,1196428',2018-05-07,FDRL/REAL TIME GROSS SETTL,10000000.0,0.0,,2018,5,7,DEBIT,10000000.0,M345439288
19982,1196428',2018-05-07,FDRL/REAL TIME GROSS SETTL,15000000.0,0.0,,2018,5,7,DEBIT,15000000.0,M2130477201
19983,1196428',2018-05-07,NEFT/BARBY18127861611/MAK,0.0,50550.0,,2018,5,7,CHECK_CASHING,50550.0,M1516263359
19984,1196428',2018-05-07,NEFT/20526147941DC/ARTHAS,0.0,53872.0,,2018,5,7,TRANSFER,53872.0,M508839235
19985,1196428',2018-05-07,FDRL/INTERNAL FUND TRANSFE,2000000.0,0.0,,2018,5,7,DEBIT,2000000.0,M530611995
19986,1196428',2018-05-07,IMPS 812716375434 FROM AS,0.0,60000.0,,2018,5,7,CASH_IN,60000.0,C1761324386
19987,1196428',2018-05-07,NEFT/N127180535965317/PAY,0.0,591024.96,,2018,5,7,TRANSFER,591024.96,C90486891
19988,1196428',2018-05-07,NEFT/SAA47132817/RAMESH F,0.0,25000.0,,2018,5,7,CASH_IN,25000.0,C573200870
19989,1196428',2018-05-07,LINKEDIN SINGAPORE PTE LT,132542.1,0.0,,2018,5,7,PAYEMENT,132542.1,C1825992554
19990,1196428',2018-05-07,ORTT00701812056,504.29,0.0,,2018,5,7,DEBIT,504.29,M1278682262
19991,1196428',2018-05-07,NEFT/N127180535965341/PAY,0.0,1834161.69,,2018,5,7,CHECK_CASHING,1834161.69,M2009652577
19992,1196428',2018-05-07,TRF FROM  Indiaforensic SERVICES,0.0,4000000.0,,2018,5,7,CASH_IN,4000000.0,M1504904868
19993,1196428',2018-05-07,TRF FROM  Indiaforensic SERVICES,0.0,3000000.0,,2018,5,7,TRANSFER,3000000.0,C88226327
19994,1196428',2018-05-07,NEFT/PUNBH18127972205/PUN,0.0,100000.0,,2018,5,7,CASH_IN,100000.0,M203497386
19995,1196428',2018-05-07,FDRL/INTERNAL FUND TRANSFE,500000.0,0.0,,2018,5,7,CHECK_WITHDRAWAL,500000.0,M1264078907
19996,1196428',2018-05-07,FDRL/INTERNAL FUND TRANSFE,10000000.0,0.0,,2018,5,7,CHECK_WITHDRAWAL,10000000.0,M1870838648
19997,1196428',2018-05-07,BEAT CSH PKP DEL UDYO 643,0.0,161000.0,,2018,5,7,CASH_IN,161000.0,C1683963531
19998,1196428',2018-05-08,TRF FROM  Indiaforensic SERVICES,0.0,6500000.0,,2018,5,8,TRANSFER,6500000.0,M620120832
19999,1196428',2018-05-08,FDRL/REAL TIME GROSS SETTL,5000000.0,0.0,,2018,5,8,CHECK_WITHDRAWAL,5000000.0,M37714710
20000,1196428',2018-05-08,FDRL/INTERNAL FUND TRANSFE,1000000.0,0.0,,2018,5,8,CASH_OUT,1000000.0,M1135370372
20001,1196428',2018-05-08,NEFT/SBIN618128911405/NAR,0.0,45283.0,,2018,5,8,CHECK_CASHING,45283.0,C1700355047
20002,1196428',2018-05-08,RTGS/HDFCH18128183253/PAY,0.0,4320000.0,,2018,5,8,TRANSFER,4320000.0,C1884600481
20003,1196428',2018-05-08,RTGS/HDFCH18128184811/PAY,0.0,1840000.0,,2018,5,8,TRANSFER,1840000.0,C1105527690
20004,1196428',2018-05-08,FDRL/NATIONAL ELECTRONIC F,1511816.0,0.0,,2018,5,8,DEBIT,1511816.0,M714819629
20005,1196428',2018-05-08,FDRL/REAL TIME GROSS SETTL,5000000.0,0.0,,2018,5,8,DEBIT,5000000.0,M722465639
20006,1196428',2018-05-08,RTGS/PUNBH18128574867/PUN,0.0,300000.0,,2018,5,8,CHECK_CASHING,300000.0,C801412408
20007,1196428',2018-05-08,Indiaforensic SERVICES INDIA PVT,0.0,640695.0,,2018,5,8,CASH_IN,640695.0,M1678349105
20008,1196428',2018-05-08,FDRL/INTERNAL FUND TRANSFE,1000000.0,0.0,,2018,5,8,DEBIT,1000000.0,C35534346
20009,1196428',2018-05-08,TRF FROM  Indiaforensic SERVICES,0.0,15000000.0,,2018,5,8,CASH_IN,15000000.0,C943166837
20010,1196428',2018-05-08,TRF FROM  Indiaforensic SERVICES,0.0,7000000.0,,2018,5,8,CASH_IN,7000000.0,M1063088470
20011,1196428',2018-05-08,FDRL/REAL TIME GROSS SETTL,15000000.0,0.0,,2018,5,8,CHECK_WITHDRAWAL,15000000.0,M634480856
20012,1196428',2018-05-08,RTGS/DLXBH18128500475/KAD,0.0,200000.0,,2018,5,8,CHECK_CASHING,200000.0,M1229660324
20013,1196428',2018-05-08,FDRL/REAL TIME GROSS SETTL,5000000.0,0.0,,2018,5,8,CHECK_WITHDRAWAL,5000000.0,M1995775202
20014,1196428',2018-05-08,NEFT/IOBAN18128422754/ASH,0.0,110501.0,,2018,5,8,TRANSFER,110501.0,M982735022
20015,1196428',2018-05-08,FDRL/INTERNAL FUND TRANSFE,2000000.0,0.0,,2018,5,8,CASH_OUT,2000000.0,C1754722089
20016,1196428',2018-05-08,TRF FROM  Indiaforensic SERVICES,0.0,5000000.0,,2018,5,8,CASH_IN,5000000.0,M536571624
20017,1196428',2018-05-08,Indiaforensic SERVICES INDIA PVT,0.0,298403.0,,2018,5,8,TRANSFER,298403.0,C1498878963
20018,1196428',2018-05-08,FDRL/NATIONAL ELECTRONIC F,22351.0,0.0,,2018,5,8,CHECK_WITHDRAWAL,22351.0,C1962165946
20019,1196428',2018-05-08,FDRL/NATIONAL ELECTRONIC F,5482.0,0.0,,2018,5,8,CASH_OUT,5482.0,M1170462195
20020,1196428',2018-05-08,FDRL/NATIONAL ELECTRONIC F,7255.0,0.0,,2018,5,8,CASH_OUT,7255.0,C414205222
20021,1196428',2018-05-08,FDRL/NATIONAL ELECTRONIC F,22045.0,0.0,,2018,5,8,CASH_OUT,22045.0,M1229413386
20022,1196428',2018-05-08,FDRL/NATIONAL ELECTRONIC F,23203.0,0.0,,2018,5,8,CASH_OUT,23203.0,M712447692
20023,1196428',2018-05-08,FDRL/NATIONAL ELECTRONIC F,14521.0,0.0,,2018,5,8,DEBIT,14521.0,C269902384
20024,1196428',2018-05-08,FDRL/NATIONAL ELECTRONIC F,27675.0,0.0,,2018,5,8,PAYEMENT,27675.0,C955097010
20025,1196428',2018-05-08,FDRL/NATIONAL ELECTRONIC F,16042.0,0.0,,2018,5,8,CASH_OUT,16042.0,C1827996167
20026,1196428',2018-05-08,FDRL/NATIONAL ELECTRONIC F,12244.0,0.0,,2018,5,8,PAYEMENT,12244.0,M30162194
20027,1196428',2018-05-08,FDRL/NATIONAL ELECTRONIC F,28160.0,0.0,,2018,5,8,PAYEMENT,28160.0,C1115240385
20028,1196428',2018-05-08,FDRL/NATIONAL ELECTRONIC F,16288.0,0.0,,2018,5,8,PAYEMENT,16288.0,M1710595137
20029,1196428',2018-05-08,FDRL/NATIONAL ELECTRONIC F,23860.0,0.0,,2018,5,8,DEBIT,23860.0,M970087106
20030,1196428',2018-05-08,FDRL/NATIONAL ELECTRONIC F,19017.0,0.0,,2018,5,8,CASH_OUT,19017.0,M561635968
20031,1196428',2018-05-08,FDRL/NATIONAL ELECTRONIC F,24455.0,0.0,,2018,5,8,PAYEMENT,24455.0,C440480434
20032,1196428',2018-05-08,FDRL/NATIONAL ELECTRONIC F,12477.0,0.0,,2018,5,8,CASH_OUT,12477.0,C46748390
20033,1196428',2018-05-08,FDRL/NATIONAL ELECTRONIC F,10546.0,0.0,,2018,5,8,PAYEMENT,10546.0,M976616410
20034,1196428',2018-05-08,FDRL/NATIONAL ELECTRONIC F,24093.0,0.0,,2018,5,8,CHECK_WITHDRAWAL,24093.0,M1796408655
20035,1196428',2018-05-08,FDRL/NATIONAL ELECTRONIC F,21990.0,0.0,,2018,5,8,DEBIT,21990.0,M424513770
20036,1196428',2018-05-08,FDRL/NATIONAL ELECTRONIC F,9529.0,0.0,,2018,5,8,DEBIT,9529.0,M1867357103
20037,1196428',2018-05-08,FDRL/NATIONAL ELECTRONIC F,28160.0,0.0,,2018,5,8,CASH_OUT,28160.0,M215680372
20038,1196428',2018-05-08,FDRL/NATIONAL ELECTRONIC F,26400.0,0.0,,2018,5,8,CHECK_WITHDRAWAL,26400.0,M764256713
20039,1196428',2018-05-08,FDRL/NATIONAL ELECTRONIC F,9886.0,0.0,,2018,5,8,CASH_OUT,9886.0,M538413261
20040,1196428',2018-05-08,FDRL/NATIONAL ELECTRONIC F,11376.0,0.0,,2018,5,8,CASH_OUT,11376.0,M942160595
20041,1196428',2018-05-08,FDRL/NATIONAL ELECTRONIC F,15389.0,0.0,,2018,5,8,CHECK_WITHDRAWAL,15389.0,M1319156415
20042,1196428',2018-05-08,FDRL/NATIONAL ELECTRONIC F,21692.0,0.0,,2018,5,8,CHECK_WITHDRAWAL,21692.0,M361847129
20043,1196428',2018-05-08,FDRL/NATIONAL ELECTRONIC F,16112.0,0.0,,2018,5,8,CHECK_WITHDRAWAL,16112.0,C1790202239
20044,1196428',2018-05-08,FDRL/NATIONAL ELECTRONIC F,3778.0,0.0,,2018,5,8,PAYEMENT,3778.0,M955868325
20045,1196428',2018-05-08,FDRL/NATIONAL ELECTRONIC F,20130.0,0.0,,2018,5,8,CASH_OUT,20130.0,M1251133153
20046,1196428',2018-05-08,FDRL/NATIONAL ELECTRONIC F,3511.0,0.0,,2018,5,8,DEBIT,3511.0,M1854311181
20047,1196428',2018-05-08,FDRL/NATIONAL ELECTRONIC F,28453.0,0.0,,2018,5,8,PAYEMENT,28453.0,C928023753
20048,1196428',2018-05-08,FDRL/NATIONAL ELECTRONIC F,27634.0,0.0,,2018,5,8,DEBIT,27634.0,M771609335
20049,1196428',2018-05-08,FDRL/NATIONAL ELECTRONIC F,13333.0,0.0,,2018,5,8,CHECK_WITHDRAWAL,13333.0,C1452722471
20050,1196428',2018-05-08,FDRL/NATIONAL ELECTRONIC F,17394.0,0.0,,2018,5,8,PAYEMENT,17394.0,M1625968481
20051,1196428',2018-05-08,FDRL/NATIONAL ELECTRONIC F,15140.0,0.0,,2018,5,8,PAYEMENT,15140.0,M458727925
20052,1196428',2018-05-08,FDRL/NATIONAL ELECTRONIC F,14814.0,0.0,,2018,5,8,DEBIT,14814.0,C111210112
20053,1196428',2018-05-08,FDRL/NATIONAL ELECTRONIC F,23203.0,0.0,,2018,5,8,CHECK_WITHDRAWAL,23203.0,C464246030
20054,1196428',2018-05-08,FDRL/NATIONAL ELECTRONIC F,24860.0,0.0,,2018,5,8,CHECK_WITHDRAWAL,24860.0,M2080752777
20055,1196428',2018-05-08,FDRL/NATIONAL ELECTRONIC F,26277.0,0.0,,2018,5,8,DEBIT,26277.0,M1357563045
20056,1196428',2018-05-08,FDRL/NATIONAL ELECTRONIC F,24200.0,0.0,,2018,5,8,DEBIT,24200.0,M68500741
20057,1196428',2018-05-08,FDRL/NATIONAL ELECTRONIC F,23105.0,0.0,,2018,5,8,DEBIT,23105.0,C1664330755
20058,1196428',2018-05-08,FDRL/NATIONAL ELECTRONIC F,14814.0,0.0,,2018,5,8,DEBIT,14814.0,C1823014131
20059,1196428',2018-05-08,FDRL/NATIONAL ELECTRONIC F,24860.0,0.0,,2018,5,8,CHECK_WITHDRAWAL,24860.0,M1293355387
20060,1196428',2018-05-08,FDRL/NATIONAL ELECTRONIC F,27120.0,0.0,,2018,5,8,PAYEMENT,27120.0,M34599177
20061,1196428',2018-05-08,FDRL/NATIONAL ELECTRONIC F,5801.0,0.0,,2018,5,8,CHECK_WITHDRAWAL,5801.0,M685059787
20062,1196428',2018-05-08,FDRL/NATIONAL ELECTRONIC F,14285.0,0.0,,2018,5,8,CHECK_WITHDRAWAL,14285.0,M376456946
20063,1196428',2018-05-08,FDRL/NATIONAL ELECTRONIC F,14048.0,0.0,,2018,5,8,CASH_OUT,14048.0,M793798217
20064,1196428',2018-05-08,FDRL/NATIONAL ELECTRONIC F,14048.0,0.0,,2018,5,8,PAYEMENT,14048.0,C264685626
20065,1196428',2018-05-08,FDRL/NATIONAL ELECTRONIC F,11967.0,0.0,,2018,5,8,PAYEMENT,11967.0,M954243999
20066,1196428',2018-05-08,FDRL/NATIONAL ELECTRONIC F,21093.0,0.0,,2018,5,8,CASH_OUT,21093.0,C1816986148
20067,1196428',2018-05-08,FDRL/NATIONAL ELECTRONIC F,23203.0,0.0,,2018,5,8,CASH_OUT,23203.0,C1144527317
20068,1196428',2018-05-08,FDRL/NATIONAL ELECTRONIC F,15052.0,0.0,,2018,5,8,DEBIT,15052.0,C1790831319
20069,1196428',2018-05-08,FDRL/NATIONAL ELECTRONIC F,21093.0,0.0,,2018,5,8,CASH_OUT,21093.0,C571435580
20070,1196428',2018-05-08,FDRL/NATIONAL ELECTRONIC F,8397.0,0.0,,2018,5,8,CHECK_WITHDRAWAL,8397.0,C1262016786
20071,1196428',2018-05-08,FDRL/NATIONAL ELECTRONIC F,13045.0,0.0,,2018,5,8,DEBIT,13045.0,C1287328228
20072,1196428',2018-05-08,FDRL/NATIONAL ELECTRONIC F,20387.0,0.0,,2018,5,8,CHECK_WITHDRAWAL,20387.0,C329473339
20073,1196428',2018-05-08,FDRL/NATIONAL ELECTRONIC F,8530.0,0.0,,2018,5,8,CASH_OUT,8530.0,C1354725727
20074,1196428',2018-05-08,FDRL/NATIONAL ELECTRONIC F,29735.0,0.0,,2018,5,8,PAYEMENT,29735.0,C1300519073
20075,1196428',2018-05-08,FDRL/NATIONAL ELECTRONIC F,16391.0,0.0,,2018,5,8,CHECK_WITHDRAWAL,16391.0,C2052185144
20076,1196428',2018-05-08,FDRL/NATIONAL ELECTRONIC F,13547.0,0.0,,2018,5,8,CHECK_WITHDRAWAL,13547.0,C1485516154
20077,1196428',2018-05-08,FDRL/NATIONAL ELECTRONIC F,14048.0,0.0,,2018,5,8,CHECK_WITHDRAWAL,14048.0,C2143477943
20078,1196428',2018-05-08,FDRL/NATIONAL ELECTRONIC F,37821.0,0.0,,2018,5,8,PAYEMENT,37821.0,C476402209
20079,1196428',2018-05-08,FDRL/NATIONAL ELECTRONIC F,11756.0,0.0,,2018,5,8,CHECK_WITHDRAWAL,11756.0,C1255024717
20080,1196428',2018-05-08,FDRL/NATIONAL ELECTRONIC F,41413.0,0.0,,2018,5,8,PAYEMENT,41413.0,C1870367457
20081,1196428',2018-05-08,FDRL/NATIONAL ELECTRONIC F,41377.0,0.0,,2018,5,8,PAYEMENT,41377.0,C465257140
20082,1196428',2018-05-08,FDRL/NATIONAL ELECTRONIC F,31080.0,0.0,,2018,5,8,PAYEMENT,31080.0,C745740822
20083,1196428',2018-05-08,FDRL/NATIONAL ELECTRONIC F,39948.0,0.0,,2018,5,8,CASH_OUT,39948.0,C1390121014
20084,1196428',2018-05-08,FDRL/NATIONAL ELECTRONIC F,43193.0,0.0,,2018,5,8,PAYEMENT,43193.0,C1481851679
20085,1196428',2018-05-08,FDRL/NATIONAL ELECTRONIC F,39614.0,0.0,,2018,5,8,CASH_OUT,39614.0,C741431520
20086,1196428',2018-05-08,FDRL/NATIONAL ELECTRONIC F,30998.0,0.0,,2018,5,8,CHECK_WITHDRAWAL,30998.0,C758888772
20087,1196428',2018-05-08,FDRL/NATIONAL ELECTRONIC F,45000.0,0.0,,2018,5,8,DEBIT,45000.0,C1001409363
20088,1196428',2018-05-08,FDRL/NATIONAL ELECTRONIC F,35358.0,0.0,,2018,5,8,CASH_OUT,35358.0,M1340854901
20089,1196428',2018-05-08,FDRL/NATIONAL ELECTRONIC F,30768.0,0.0,,2018,5,8,DEBIT,30768.0,M265997755
20090,1196428',2018-05-08,FDRL/NATIONAL ELECTRONIC F,40137.0,0.0,,2018,5,8,DEBIT,40137.0,M1257695233
20091,1196428',2018-05-08,FDRL/NATIONAL ELECTRONIC F,31862.0,0.0,,2018,5,8,CASH_OUT,31862.0,C150309335
20092,1196428',2018-05-08,FDRL/NATIONAL ELECTRONIC F,38380.0,0.0,,2018,5,8,CASH_OUT,38380.0,M1572611628
20093,1196428',2018-05-08,FDRL/NATIONAL ELECTRONIC F,33464.0,0.0,,2018,5,8,DEBIT,33464.0,M280183141
20094,1196428',2018-05-08,FDRL/NATIONAL ELECTRONIC F,31468.0,0.0,,2018,5,8,PAYEMENT,31468.0,M808540700
20095,1196428',2018-05-08,FDRL/NATIONAL ELECTRONIC F,44463.0,0.0,,2018,5,8,DEBIT,44463.0,M565481399
20096,1196428',2018-05-08,FDRL/NATIONAL ELECTRONIC F,36776.0,0.0,,2018,5,8,CHECK_WITHDRAWAL,36776.0,C842729010
20097,1196428',2018-05-08,FDRL/NATIONAL ELECTRONIC F,51116.0,0.0,,2018,5,8,CHECK_WITHDRAWAL,51116.0,M178371442
20098,1196428',2018-05-08,FDRL/NATIONAL ELECTRONIC F,33145.0,0.0,,2018,5,8,DEBIT,33145.0,M2076445832
20099,1196428',2018-05-08,FDRL/NATIONAL ELECTRONIC F,36586.0,0.0,,2018,5,8,CHECK_WITHDRAWAL,36586.0,C599968109
20100,1196428',2018-05-08,FDRL/NATIONAL ELECTRONIC F,68192.0,0.0,,2018,5,8,DEBIT,68192.0,C599265282
20101,1196428',2018-05-08,FDRL/NATIONAL ELECTRONIC F,63825.0,0.0,,2018,5,8,CASH_OUT,63825.0,C669771073
20102,1196428',2018-05-08,FDRL/NATIONAL ELECTRONIC F,56282.0,0.0,,2018,5,8,PAYEMENT,56282.0,C2137848242
20103,1196428',2018-05-08,FDRL/NATIONAL ELECTRONIC F,57267.0,0.0,,2018,5,8,DEBIT,57267.0,M997986347
20104,1196428',2018-05-08,FDRL/NATIONAL ELECTRONIC F,56008.0,0.0,,2018,5,8,PAYEMENT,56008.0,M1063792159
20105,1196428',2018-05-08,FDRL/NATIONAL ELECTRONIC F,58394.0,0.0,,2018,5,8,CASH_OUT,58394.0,C22448303
20106,1196428',2018-05-08,FDRL/NATIONAL ELECTRONIC F,55797.0,0.0,,2018,5,8,CASH_OUT,55797.0,M315692635
20107,1196428',2018-05-08,FDRL/NATIONAL ELECTRONIC F,63717.0,0.0,,2018,5,8,CHECK_WITHDRAWAL,63717.0,M803644277
20108,1196428',2018-05-08,FDRL/NATIONAL ELECTRONIC F,85258.0,0.0,,2018,5,8,PAYEMENT,85258.0,M415913007
20109,1196428',2018-05-08,FDRL/NATIONAL ELECTRONIC F,76549.0,0.0,,2018,5,8,CHECK_WITHDRAWAL,76549.0,M1344197461
20110,1196428',2018-05-08,FDRL/NATIONAL ELECTRONIC F,52866.0,0.0,,2018,5,8,CHECK_WITHDRAWAL,52866.0,M132014623
20111,1196428',2018-05-08,FDRL/NATIONAL ELECTRONIC F,54099.0,0.0,,2018,5,8,CASH_OUT,54099.0,M577051450
20112,1196428',2018-05-08,FDRL/NATIONAL ELECTRONIC F,56008.0,0.0,,2018,5,8,CHECK_WITHDRAWAL,56008.0,C1491676195
20113,1196428',2018-05-08,FDRL/NATIONAL ELECTRONIC F,70253.0,0.0,,2018,5,8,CASH_OUT,70253.0,C943166837
20114,1196428',2018-05-08,FDRL/NATIONAL ELECTRONIC F,68075.0,0.0,,2018,5,8,CASH_OUT,68075.0,M1402953791
20115,1196428',2018-05-08,FDRL/NATIONAL ELECTRONIC F,59222.0,0.0,,2018,5,8,CASH_OUT,59222.0,M1974589236
20116,1196428',2018-05-08,FDRL/NATIONAL ELECTRONIC F,105424.0,0.0,,2018,5,8,PAYEMENT,105424.0,C1701412896
20117,1196428',2018-05-08,FDRL/NATIONAL ELECTRONIC F,51235.0,0.0,,2018,5,8,PAYEMENT,51235.0,M1355606971
20118,1196428',2018-05-08,FDRL/NATIONAL ELECTRONIC F,6957.0,0.0,,2018,5,8,CHECK_WITHDRAWAL,6957.0,M1037747072
20119,1196428',2018-05-08,FDRL/NATIONAL ELECTRONIC F,11686.0,0.0,,2018,5,8,CASH_OUT,11686.0,M82220349
20120,1196428',2018-05-08,FDRL/NATIONAL ELECTRONIC F,6009.0,0.0,,2018,5,8,CASH_OUT,6009.0,M953439482
20121,1196428',2018-05-08,FDRL/NATIONAL ELECTRONIC F,7894.0,0.0,,2018,5,8,CASH_OUT,7894.0,C1914282536
20122,1196428',2018-05-08,FDRL/NATIONAL ELECTRONIC F,7519.0,0.0,,2018,5,8,PAYEMENT,7519.0,C691636444
20123,1196428',2018-05-08,FDRL/NATIONAL ELECTRONIC F,5514.0,0.0,,2018,5,8,CHECK_WITHDRAWAL,5514.0,C683605346
20124,1196428',2018-05-08,FDRL/NATIONAL ELECTRONIC F,5803.0,0.0,,2018,5,8,DEBIT,5803.0,M1967366965
20125,1196428',2018-05-08,FDRL/NATIONAL ELECTRONIC F,7894.0,0.0,,2018,5,8,PAYEMENT,7894.0,M508405148
20126,1196428',2018-05-08,FDRL/NATIONAL ELECTRONIC F,6009.0,0.0,,2018,5,8,CHECK_WITHDRAWAL,6009.0,M1295579320
20127,1196428',2018-05-08,FDRL/NATIONAL ELECTRONIC F,25949.0,0.0,,2018,5,8,PAYEMENT,25949.0,M995168511
20128,1196428',2018-05-08,FDRL/NATIONAL ELECTRONIC F,17251.0,0.0,,2018,5,8,PAYEMENT,17251.0,M1102425439
20129,1196428',2018-05-08,FDRL/NATIONAL ELECTRONIC F,5274.0,0.0,,2018,5,8,CASH_OUT,5274.0,M590053012
20130,1196428',2018-05-08,FDRL/NATIONAL ELECTRONIC F,19003.0,0.0,,2018,5,8,PAYEMENT,19003.0,M386886002
20131,1196428',2018-05-08,FDRL/NATIONAL ELECTRONIC F,26574.0,0.0,,2018,5,8,PAYEMENT,26574.0,M227585143
20132,1196428',2018-05-08,FDRL/NATIONAL ELECTRONIC F,12358.0,0.0,,2018,5,8,DEBIT,12358.0,M2105068287
20133,1196428',2018-05-08,FDRL/NATIONAL ELECTRONIC F,8144.0,0.0,,2018,5,8,CHECK_WITHDRAWAL,8144.0,M1038116064
20134,1196428',2018-05-08,FDRL/NATIONAL ELECTRONIC F,6259.0,0.0,,2018,5,8,PAYEMENT,6259.0,M345805867
20135,1196428',2018-05-08,FDRL/NATIONAL ELECTRONIC F,17423.0,0.0,,2018,5,8,CHECK_WITHDRAWAL,17423.0,M1128144161
20136,1196428',2018-05-08,FDRL/NATIONAL ELECTRONIC F,10334.0,0.0,,2018,5,8,CHECK_WITHDRAWAL,10334.0,M1492172037
20137,1196428',2018-05-08,FDRL/NATIONAL ELECTRONIC F,25289.0,0.0,,2018,5,8,PAYEMENT,25289.0,M731603444
20138,1196428',2018-05-08,FDRL/NATIONAL ELECTRONIC F,26277.0,0.0,,2018,5,8,PAYEMENT,26277.0,M879683510
20139,1196428',2018-05-08,FDRL/NATIONAL ELECTRONIC F,15052.0,0.0,,2018,5,8,PAYEMENT,15052.0,M555126583
20140,1196428',2018-05-08,FDRL/NATIONAL ELECTRONIC F,14514.0,0.0,,2018,5,8,PAYEMENT,14514.0,M1344791022
20141,1196428',2018-05-08,FDRL/NATIONAL ELECTRONIC F,25650.0,0.0,,2018,5,8,CASH_OUT,25650.0,M40493588
20142,1196428',2018-05-08,FDRL/NATIONAL ELECTRONIC F,15543.0,0.0,,2018,5,8,CASH_OUT,15543.0,M1099885881
20143,1196428',2018-05-08,FDRL/NATIONAL ELECTRONIC F,24860.0,0.0,,2018,5,8,PAYEMENT,24860.0,M107256650
20144,1196428',2018-05-08,FDRL/NATIONAL ELECTRONIC F,14814.0,0.0,,2018,5,8,DEBIT,14814.0,M1410611700
20145,1196428',2018-05-08,FDRL/NATIONAL ELECTRONIC F,16118.0,0.0,,2018,5,8,CASH_OUT,16118.0,M954062800
20146,1196428',2018-05-08,FDRL/NATIONAL ELECTRONIC F,23040.0,0.0,,2018,5,8,DEBIT,23040.0,M13013852
20147,1196428',2018-05-08,FDRL/NATIONAL ELECTRONIC F,15052.0,0.0,,2018,5,8,CASH_OUT,15052.0,M1101858256
20148,1196428',2018-05-08,FDRL/NATIONAL ELECTRONIC F,20693.0,0.0,,2018,5,8,CASH_OUT,20693.0,M1180862248
20149,1196428',2018-05-08,FDRL/NATIONAL ELECTRONIC F,20340.0,0.0,,2018,5,8,CASH_OUT,20340.0,M966462848
20150,1196428',2018-05-08,FDRL/NATIONAL ELECTRONIC F,15052.0,0.0,,2018,5,8,PAYEMENT,15052.0,M1284324188
20151,1196428',2018-05-08,FDRL/NATIONAL ELECTRONIC F,22360.0,0.0,,2018,5,8,CASH_OUT,22360.0,C374625527
20152,1196428',2018-05-08,FDRL/NATIONAL ELECTRONIC F,14561.0,0.0,,2018,5,8,PAYEMENT,14561.0,C1262822392
20153,1196428',2018-05-08,FDRL/NATIONAL ELECTRONIC F,15527.0,0.0,,2018,5,8,CHECK_WITHDRAWAL,15527.0,C1671386208
20154,1196428',2018-05-08,FDRL/NATIONAL ELECTRONIC F,14561.0,0.0,,2018,5,8,CASH_OUT,14561.0,C1869197498
20155,1196428',2018-05-08,FDRL/NATIONAL ELECTRONIC F,14814.0,0.0,,2018,5,8,PAYEMENT,14814.0,C271488817
20156,1196428',2018-05-08,FDRL/NATIONAL ELECTRONIC F,22360.0,0.0,,2018,5,8,DEBIT,22360.0,M1915909017
20157,1196428',2018-05-08,FDRL/NATIONAL ELECTRONIC F,17326.0,0.0,,2018,5,8,CHECK_WITHDRAWAL,17326.0,C2052185144
20158,1196428',2018-05-08,FDRL/NATIONAL ELECTRONIC F,8482.0,0.0,,2018,5,8,PAYEMENT,8482.0,C646059443
20159,1196428',2018-05-08,FDRL/NATIONAL ELECTRONIC F,2698.0,0.0,,2018,5,8,CHECK_WITHDRAWAL,2698.0,C1982591789
20160,1196428',2018-05-08,FDRL/NATIONAL ELECTRONIC F,15052.0,0.0,,2018,5,8,CHECK_WITHDRAWAL,15052.0,C1977614404
20161,1196428',2018-05-08,FDRL/NATIONAL ELECTRONIC F,25000.0,0.0,,2018,5,8,DEBIT,25000.0,C1883840933
20162,1196428',2018-05-08,FDRL/NATIONAL ELECTRONIC F,19241.0,0.0,,2018,5,8,CHECK_WITHDRAWAL,19241.0,C2007207148
20163,1196428',2018-05-08,FDRL/NATIONAL ELECTRONIC F,12960.0,0.0,,2018,5,8,PAYEMENT,12960.0,M1014644493
20164,1196428',2018-05-08,FDRL/NATIONAL ELECTRONIC F,15550.0,0.0,,2018,5,8,CASH_OUT,15550.0,C381605910
20165,1196428',2018-05-08,FDRL/NATIONAL ELECTRONIC F,7692.0,0.0,,2018,5,8,CASH_OUT,7692.0,M1056752544
20166,1196428',2018-05-08,FDRL/NATIONAL ELECTRONIC F,23203.0,0.0,,2018,5,8,PAYEMENT,23203.0,M729567968
20167,1196428',2018-05-08,FDRL/NATIONAL ELECTRONIC F,15392.0,0.0,,2018,5,8,CASH_OUT,15392.0,M1723507087
20168,1196428',2018-05-08,FDRL/NATIONAL ELECTRONIC F,13333.0,0.0,,2018,5,8,DEBIT,13333.0,C849038219
20169,1196428',2018-05-08,FDRL/NATIONAL ELECTRONIC F,16612.0,0.0,,2018,5,8,CHECK_WITHDRAWAL,16612.0,C1038678108
20170,1196428',2018-05-08,FDRL/NATIONAL ELECTRONIC F,28160.0,0.0,,2018,5,8,PAYEMENT,28160.0,M1976340229
20171,1196428',2018-05-08,FDRL/NATIONAL ELECTRONIC F,6009.0,0.0,,2018,5,8,PAYEMENT,6009.0,M693274483
20172,1196428',2018-05-08,FDRL/NATIONAL ELECTRONIC F,11510.0,0.0,,2018,5,8,DEBIT,11510.0,M838050003
20173,1196428',2018-05-08,FDRL/NATIONAL ELECTRONIC F,11421.0,0.0,,2018,5,8,DEBIT,11421.0,C1009972184
20174,1196428',2018-05-08,FDRL/NATIONAL ELECTRONIC F,27780.0,0.0,,2018,5,8,DEBIT,27780.0,C63475121
20175,1196428',2018-05-08,FDRL/NATIONAL ELECTRONIC F,20323.0,0.0,,2018,5,8,PAYEMENT,20323.0,C1130075212
20176,1196428',2018-05-08,FDRL/NATIONAL ELECTRONIC F,14538.0,0.0,,2018,5,8,DEBIT,14538.0,C851316413
20177,1196428',2018-05-08,FDRL/NATIONAL ELECTRONIC F,21980.0,0.0,,2018,5,8,CHECK_WITHDRAWAL,21980.0,M718843573
20178,1196428',2018-05-08,FDRL/NATIONAL ELECTRONIC F,25614.0,0.0,,2018,5,8,PAYEMENT,25614.0,M1217713614
20179,1196428',2018-05-08,FDRL/NATIONAL ELECTRONIC F,7719.0,0.0,,2018,5,8,CASH_OUT,7719.0,M706338650
20180,1196428',2018-05-08,FDRL/NATIONAL ELECTRONIC F,17837.0,0.0,,2018,5,8,CASH_OUT,17837.0,M995800830
20181,1196428',2018-05-08,FDRL/NATIONAL ELECTRONIC F,17851.0,0.0,,2018,5,8,DEBIT,17851.0,C1073259437
20182,1196428',2018-05-08,FDRL/NATIONAL ELECTRONIC F,22230.0,0.0,,2018,5,8,CHECK_WITHDRAWAL,22230.0,M1699315785
20183,1196428',2018-05-08,FDRL/NATIONAL ELECTRONIC F,13818.0,0.0,,2018,5,8,PAYEMENT,13818.0,M1163711030
20184,1196428',2018-05-08,FDRL/NATIONAL ELECTRONIC F,14538.0,0.0,,2018,5,8,CHECK_WITHDRAWAL,14538.0,C320106510
20185,1196428',2018-05-08,FDRL/NATIONAL ELECTRONIC F,10592.0,0.0,,2018,5,8,PAYEMENT,10592.0,M597251930
20186,1196428',2018-05-08,FDRL/NATIONAL ELECTRONIC F,28030.0,0.0,,2018,5,8,PAYEMENT,28030.0,M1515100477
20187,1196428',2018-05-08,FDRL/NATIONAL ELECTRONIC F,14538.0,0.0,,2018,5,8,PAYEMENT,14538.0,M1412315921
20188,1196428',2018-05-08,NEFT/000037835328/ACCOUNT,0.0,11686.0,,2018,5,8,CHECK_CASHING,11686.0,M1168923345
20189,1196428',2018-05-08,NEFT/SBIN718128578129/NAR,0.0,41239.0,,2018,5,8,CHECK_CASHING,41239.0,M2042700604
20190,1196428',2018-05-08,NEFT/N128180537191888/TEC,0.0,200000.0,,2018,5,8,CASH_IN,200000.0,C710481910
20191,1196428',2018-05-08,TRF FROM  Indiaforensic SERVICES,0.0,3800000.0,,2018,5,8,TRANSFER,3800000.0,M1474634841
20192,1196428',2018-05-08,BEAT CSH PKP DEL UDYO 643,0.0,207500.0,,2018,5,8,CASH_IN,207500.0,C669419693
20193,1196428',2018-05-08,IMPS 812819919036 FROM GA,0.0,200000.0,,2018,5,8,TRANSFER,200000.0,C2095611317
20194,1196428',2018-05-08,IMPS 812819924294 FROM GA,0.0,200000.0,,2018,5,8,TRANSFER,200000.0,C1316560467
20195,1196428',2018-05-08,IMPS 812819925392 FROM GA,0.0,200000.0,,2018,5,8,CHECK_CASHING,200000.0,M1572144334
20196,1196428',2018-05-08,IMPS 812819926430 FROM GA,0.0,200000.0,,2018,5,8,CHECK_CASHING,200000.0,M593517569
20197,1196428',2018-05-08,IMPS 812819928407 FROM GA,0.0,200000.0,,2018,5,8,TRANSFER,200000.0,M558730564
20198,1196428',2018-05-08,IMPS 812819928181 FROM GA,0.0,200000.0,,2018,5,8,TRANSFER,200000.0,C736160330
20199,1196428',2018-05-08,FDRL/INTERNAL FUND TRANSFE,0.0,1000000.0,,2018,5,8,TRANSFER,1000000.0,C417236208
20200,1196428',2018-05-08,FDRL/INTERNAL FUND TRANSFE,0.0,1000000.0,,2018,5,8,CHECK_CASHING,1000000.0,C931482420
20201,1196428',2018-05-08,IMPS 812819930687 FROM GA,0.0,200000.0,,2018,5,8,TRANSFER,200000.0,M405976415
20202,1196428',2018-05-08,IMPS 812819932288 FROM GA,0.0,200000.0,,2018,5,8,TRANSFER,200000.0,C208341157
20203,1196428',2018-05-08,IMPS 812819933570 FROM GA,0.0,200000.0,,2018,5,8,CHECK_CASHING,200000.0,C382697424
20204,1196428',2018-05-08,IMPS 812819935327 FROM GA,0.0,200000.0,,2018,5,8,CHECK_CASHING,200000.0,M875577692
20205,1196428',2018-05-08,IMPS 812819935038 FROM GA,0.0,200000.0,,2018,5,8,CHECK_CASHING,200000.0,C1822578654
20206,1196428',2018-05-08,IMPS 812819937771 FROM GA,0.0,200000.0,,2018,5,8,CHECK_CASHING,200000.0,M2022435822
20207,1196428',2018-05-08,IMPS 812819939750 FROM GA,0.0,200000.0,,2018,5,8,CASH_IN,200000.0,M1867372125
20208,1196428',2018-05-08,IMPS 812819939202 FROM GA,0.0,200000.0,,2018,5,8,CASH_IN,200000.0,M556592378
20209,1196428',2018-05-08,IMPS 812819941151 FROM GA,0.0,200000.0,,2018,5,8,TRANSFER,200000.0,C807072084
20210,1196428',2018-05-08,FDRL/INTERNAL FUND TRANSFE,10000000.0,0.0,,2018,5,8,DEBIT,10000000.0,C2077098348
20211,1196428',2018-05-08,IMPS 812819945500 FROM GA,0.0,200000.0,,2018,5,8,CHECK_CASHING,200000.0,M1751878963
20212,1196428',2018-05-08,IMPS 812819947384 FROM GA,0.0,200000.0,,2018,5,8,TRANSFER,200000.0,C1618278649
20213,1196428',2018-05-08,IMPS 812819949301 FROM GA,0.0,200000.0,,2018,5,8,TRANSFER,200000.0,C1987564320
20214,1196428',2018-05-08,IMPS 812820950568 FROM GA,0.0,200000.0,,2018,5,8,CHECK_CASHING,200000.0,M848162783
20215,1196428',2018-05-08,IMPS 812820952749 FROM GA,0.0,200000.0,,2018,5,8,TRANSFER,200000.0,M347906624
20216,1196428',2018-05-08,IMPS 812820956305 FROM GA,0.0,200000.0,,2018,5,8,TRANSFER,200000.0,M271658762
20217,1196428',2018-05-08,IMPS 812820957088 FROM GA,0.0,200000.0,,2018,5,8,CHECK_CASHING,200000.0,M1403007770
20218,1196428',2018-05-08,IMPS 812820960312 FROM GA,0.0,200000.0,,2018,5,8,TRANSFER,200000.0,M2043631011
20219,1196428',2018-05-08,FDRL/INTERNAL FUND TRANSFE,1000000.0,0.0,,2018,5,8,CHECK_WITHDRAWAL,1000000.0,C107095723
20220,1196428',2018-05-08,FDRL/INTERNAL FUND TRANSFE,1000000.0,0.0,,2018,5,8,CASH_OUT,1000000.0,C985934102
20221,1196428',2018-05-08,FDRL/INTERNAL FUND TRANSFE,300000.0,0.0,,2018,5,8,CHECK_WITHDRAWAL,300000.0,C824197891
20222,1196428',2018-05-08,IMPS 812820053741 FROM GA,0.0,1050.0,,2018,5,8,CASH_IN,1050.0,C1696218625
20223,1196428',2018-05-09,RTGS/UTIBH18129652025/PER,0.0,900000.0,,2018,5,9,TRANSFER,900000.0,M1817447589
20224,1196428',2018-05-09,NEFT/20528758731DC/GALENA,0.0,200000.0,,2018,5,9,CASH_IN,200000.0,C168639687
20225,1196428',2018-05-09,NEFT/20528759191DC/GALENA,0.0,200000.0,,2018,5,9,CASH_IN,200000.0,C1630293008
20226,1196428',2018-05-09,RTGS/SBINH18129008954/Indfor,0.0,1000000.0,,2018,5,9,TRANSFER,1000000.0,C1577420620
20227,1196428',2018-05-09,RTGS/HDFCH18129346954/PAY,0.0,4480000.0,,2018,5,9,CASH_IN,4480000.0,C35263828
20228,1196428',2018-05-09,RTGS/HDFCH18129346912/PAY,0.0,1680000.0,,2018,5,9,CASH_IN,1680000.0,M2014874822
20229,1196428',2018-05-09,NEFT/IDIBH18129480824/PVT,0.0,10000.0,,2018,5,9,CHECK_CASHING,10000.0,M1553772873
20230,1196428',2018-05-09,FDRL/INTERNAL FUND TRANSFE,500000.0,0.0,,2018,5,9,CASH_OUT,500000.0,C905650857
20231,1196428',2018-05-09,FDRL/INTERNAL FUND TRANSFE,1000000.0,0.0,,2018,5,9,PAYEMENT,1000000.0,C1502287290
20232,1196428',2018-05-09,FDRL/INTERNAL FUND TRANSFE,2000000.0,0.0,,2018,5,9,CHECK_WITHDRAWAL,2000000.0,M1197564988
20233,1196428',2018-05-09,FDRL/NATIONAL ELECTRONIC F,2454721.0,0.0,,2018,5,9,CHECK_WITHDRAWAL,2454721.0,M1843534160
20234,1196428',2018-05-09,CHQ DEP/113133/OWDEL1/PUN,0.0,11800.0,,2018,5,9,TRANSFER,11800.0,C871895680
20235,1196428',2018-05-09,CHQ DEP/702405/OWDEL1/PUN,0.0,11800.0,,2018,5,9,CASH_IN,11800.0,C1398530689
20236,1196428',2018-05-09,CHQ DEP/291887/OWDEL1/SBI,0.0,11800.0,,2018,5,9,TRANSFER,11800.0,M834859488
20237,1196428',2018-05-09,CHQ DEP/121412/OWDEL1/UBI,0.0,11800.0,,2018,5,9,CASH_IN,11800.0,M463880076
20238,1196428',2018-05-09,CHQ DEP/427168/OWDEL1/PUN,0.0,11800.0,,2018,5,9,TRANSFER,11800.0,M1273091698
20239,1196428',2018-05-09,CHQ DEP/352/OWDEL1/SBIN/B,0.0,11800.0,,2018,5,9,TRANSFER,11800.0,M134350609
20240,1196428',2018-05-09,CHQ DEP/1606/OWDEL1/ORBC/,0.0,11800.0,,2018,5,9,CHECK_CASHING,11800.0,M1939822545
20241,1196428',2018-05-09,CHQ DEP/35046/OWDEL1/SBIN,0.0,11800.0,,2018,5,9,CHECK_CASHING,11800.0,M1498010747
20242,1196428',2018-05-09,CHQ DEP/370/OWDEL1/HDFC/S,0.0,11800.0,,2018,5,9,CASH_IN,11800.0,M615833646
20243,1196428',2018-05-09,CHQ DEP/22267/OWDEL1/CBIN,0.0,11800.0,,2018,5,9,CHECK_CASHING,11800.0,M695601535
20244,1196428',2018-05-09,CHQ DEP/738/OWDEL1/HDFC/N,0.0,11800.0,,2018,5,9,CHECK_CASHING,11800.0,M1741551200
20245,1196428',2018-05-09,CHQ DEP/119/OWDEL1/HDFC/,0.0,11800.0,,2018,5,9,TRANSFER,11800.0,M533060514
20246,1196428',2018-05-09,CHQ DEP/56275/OWDEL1/SBIN,0.0,11800.0,,2018,5,9,CASH_IN,11800.0,M763925237
20247,1196428',2018-05-09,CHQ DEP/139324/OWDEL1/UBI,0.0,11800.0,,2018,5,9,CASH_IN,11800.0,M309397793
20248,1196428',2018-05-09,CHQ DEP/690609/OWDEL1/SBI,0.0,11800.0,,2018,5,9,CASH_IN,11800.0,M786088183
20249,1196428',2018-05-09,NEFT/IOBAN18129619334/ASH,0.0,180000.0,,2018,5,9,CASH_IN,180000.0,M1362397723
20250,1196428',2018-05-09,NEFT/BARBZ18129768552/MAK,0.0,56650.0,,2018,5,9,CASH_IN,56650.0,M166947904
20251,1196428',2018-05-09,NEFT/AXISP18129048449/ACC,0.0,1000000.0,,2018,5,9,TRANSFER,1000000.0,M39384037
20252,1196428',2018-05-09,FDRL/INTERNAL FUND TRANSFE,2000000.0,0.0,,2018,5,9,CASH_OUT,2000000.0,M1475711030
20253,1196428',2018-05-09,NEFT/SBIN818129089020/NAR,0.0,42587.0,,2018,5,9,CHECK_CASHING,42587.0,M727579419
20254,1196428',2018-05-09,NEFT/N129180537780359/BAT,0.0,100000.0,,2018,5,9,CASH_IN,100000.0,M654290745
20255,1196428',2018-05-09,TRF FROM  Indiaforensic SERVICES,0.0,15000000.0,,2018,5,9,CHECK_CASHING,15000000.0,C1559145228
20256,1196428',2018-05-09,TRF FROM  Indiaforensic SERVICES,0.0,14600000.0,,2018,5,9,CHECK_CASHING,14600000.0,M688458571
20257,1196428',2018-05-09,TRF FROM  Indiaforensic SERVICES,0.0,2000000.0,,2018,5,9,CASH_IN,2000000.0,M1895621189
20258,1196428',2018-05-09,FDRL/REAL TIME GROSS SETTL,15000000.0,0.0,,2018,5,9,CHECK_WITHDRAWAL,15000000.0,M1516781526
20259,1196428',2018-05-09,FDRL/REAL TIME GROSS SETTL,13000000.0,0.0,,2018,5,9,DEBIT,13000000.0,M409559965
20260,1196428',2018-05-09,FDRL/NATIONAL ELECTRONIC F,11700.0,0.0,,2018,5,9,DEBIT,11700.0,M1771169983
20261,1196428',2018-05-09,"Indiaforensic USA, INC./USD/1902",0.0,1275133.29,,2018,5,9,CASH_IN,1275133.29,C470217116
20262,1196428',2018-05-09,IRTT00701813944,1334.52,0.0,,2018,5,9,PAYEMENT,1334.52,M585745963
20263,1196428',2018-05-09,BEAT CSH PKP DEL UDYOG 64,0.0,369000.0,,2018,5,9,TRANSFER,369000.0,M2096974885
20264,1196428',2018-05-09,NEFT/000045250990/Indiaforensic,0.0,1700000.0,,2018,5,9,CHECK_CASHING,1700000.0,M1287228290
20265,1196428',2018-05-09,TRF FROM  Indiaforensic SERVICES,0.0,6700000.0,,2018,5,9,CASH_IN,6700000.0,M1178751818
20266,1196428',2018-05-09,FDRL/INTERNAL FUND TRANSFE,500000.0,0.0,,2018,5,9,CASH_OUT,500000.0,M145594829
20267,1196428',2018-05-09,FDRL/INTERNAL FUND TRANSFE,1000000.0,0.0,,2018,5,9,DEBIT,1000000.0,M1232351629
20268,1196428',2018-05-09,FDRL/INTERNAL FUND TRANSFE,500000.0,0.0,,2018,5,9,CHECK_WITHDRAWAL,500000.0,M1656904340
20269,1196428',2018-05-09,NEFT/000045250607/Indiaforensic,0.0,2500000.0,,2018,5,9,CHECK_CASHING,2500000.0,C24404443
20270,1196428',2018-05-09,FDRL/INTERNAL FUND TRANSFE,300000.0,0.0,,2018,5,9,CASH_OUT,300000.0,C596299019
20271,1196428',2018-05-09,FDRL/INTERNAL FUND TRANSFE,6000000.0,0.0,,2018,5,9,CHECK_WITHDRAWAL,6000000.0,C1983747920
20272,1196428',2018-05-09,FDRL/INTERNAL FUND TRANSFE,7000000.0,0.0,,2018,5,9,CHECK_WITHDRAWAL,7000000.0,C696705647
20273,1196428',2018-05-09,FDRL/INTERNAL FUND TRANSFE,3000000.0,0.0,,2018,5,9,CHECK_WITHDRAWAL,3000000.0,C1845765982
20274,1196428',2018-05-10,NEFT/SBIN818130549518/NAR,0.0,51273.0,,2018,5,10,CHECK_CASHING,51273.0,M877365519
20275,1196428',2018-05-10,RTGS/SBINH18130002630/Indfor,0.0,4500000.0,,2018,5,10,TRANSFER,4500000.0,C134604590
20276,1196428',2018-05-10,FDRL/INTERNAL FUND TRANSFE,2000000.0,0.0,,2018,5,10,DEBIT,2000000.0,M1053485132
20277,1196428',2018-05-10,FDRL/NATIONAL ELECTRONIC F,2664045.0,0.0,,2018,5,10,PAYEMENT,2664045.0,M1698378565
20278,1196428',2018-05-10,TRF FROM  Indiaforensic SERVICES,0.0,15000000.0,,2018,5,10,CASH_IN,15000000.0,M1418167825
20279,1196428',2018-05-10,TRF FROM  Indiaforensic SERVICES,0.0,12200000.0,,2018,5,10,CHECK_CASHING,12200000.0,M915318947
20280,1196428',2018-05-10,FDRL/NATIONAL ELECTRONIC F,6500.0,0.0,,2018,5,10,CHECK_WITHDRAWAL,6500.0,M1471526064
20281,1196428',2018-05-10,FDRL/NATIONAL ELECTRONIC F,5500.0,0.0,,2018,5,10,CASH_OUT,5500.0,C474166728
20282,1196428',2018-05-10,FDRL/NATIONAL ELECTRONIC F,3750.0,0.0,,2018,5,10,PAYEMENT,3750.0,M1777764920
20283,1196428',2018-05-10,FDRL/NATIONAL ELECTRONIC F,5500.0,0.0,,2018,5,10,PAYEMENT,5500.0,C1833549064
20284,1196428',2018-05-10,FDRL/NATIONAL ELECTRONIC F,4000.0,0.0,,2018,5,10,DEBIT,4000.0,M327804056
20285,1196428',2018-05-10,FDRL/NATIONAL ELECTRONIC F,3750.0,0.0,,2018,5,10,CHECK_WITHDRAWAL,3750.0,M939893108
20286,1196428',2018-05-10,FDRL/NATIONAL ELECTRONIC F,5500.0,0.0,,2018,5,10,CASH_OUT,5500.0,C1938462589
20287,1196428',2018-05-10,FDRL/NATIONAL ELECTRONIC F,4000.0,0.0,,2018,5,10,CHECK_WITHDRAWAL,4000.0,M974784761
20288,1196428',2018-05-10,FDRL/NATIONAL ELECTRONIC F,3750.0,0.0,,2018,5,10,CASH_OUT,3750.0,M209997138
20289,1196428',2018-05-10,FDRL/NATIONAL ELECTRONIC F,3500.0,0.0,,2018,5,10,CHECK_WITHDRAWAL,3500.0,M359327148
20290,1196428',2018-05-10,FDRL/NATIONAL ELECTRONIC F,3750.0,0.0,,2018,5,10,DEBIT,3750.0,C1519216494
20291,1196428',2018-05-10,FDRL/NATIONAL ELECTRONIC F,4000.0,0.0,,2018,5,10,CHECK_WITHDRAWAL,4000.0,M142106520
20292,1196428',2018-05-10,FDRL/NATIONAL ELECTRONIC F,3750.0,0.0,,2018,5,10,DEBIT,3750.0,C1979080020
20293,1196428',2018-05-10,FDRL/NATIONAL ELECTRONIC F,3500.0,0.0,,2018,5,10,CHECK_WITHDRAWAL,3500.0,C635281078
20294,1196428',2018-05-10,FDRL/NATIONAL ELECTRONIC F,3500.0,0.0,,2018,5,10,DEBIT,3500.0,C1866672043
20295,1196428',2018-05-10,FDRL/NATIONAL ELECTRONIC F,3750.0,0.0,,2018,5,10,CASH_OUT,3750.0,M155979068
20296,1196428',2018-05-10,FDRL/NATIONAL ELECTRONIC F,3500.0,0.0,,2018,5,10,CASH_OUT,3500.0,M111496179
20297,1196428',2018-05-10,FDRL/NATIONAL ELECTRONIC F,10000.0,0.0,,2018,5,10,DEBIT,10000.0,M1472428747
20298,1196428',2018-05-10,FDRL/NATIONAL ELECTRONIC F,4000.0,0.0,,2018,5,10,PAYEMENT,4000.0,C1167813715
20299,1196428',2018-05-10,FDRL/NATIONAL ELECTRONIC F,3500.0,0.0,,2018,5,10,CASH_OUT,3500.0,M235839070
20300,1196428',2018-05-10,FDRL/NATIONAL ELECTRONIC F,3500.0,0.0,,2018,5,10,CHECK_WITHDRAWAL,3500.0,M1881768592
20301,1196428',2018-05-10,FDRL/NATIONAL ELECTRONIC F,3500.0,0.0,,2018,5,10,CHECK_WITHDRAWAL,3500.0,C185503802
20302,1196428',2018-05-10,FDRL/NATIONAL ELECTRONIC F,3750.0,0.0,,2018,5,10,DEBIT,3750.0,C403147759
20303,1196428',2018-05-10,FDRL/NATIONAL ELECTRONIC F,3750.0,0.0,,2018,5,10,DEBIT,3750.0,M1725462644
20304,1196428',2018-05-10,FDRL/NATIONAL ELECTRONIC F,3500.0,0.0,,2018,5,10,PAYEMENT,3500.0,M685639359
20305,1196428',2018-05-10,FDRL/NATIONAL ELECTRONIC F,3500.0,0.0,,2018,5,10,CHECK_WITHDRAWAL,3500.0,M499928991
20306,1196428',2018-05-10,FDRL/NATIONAL ELECTRONIC F,3500.0,0.0,,2018,5,10,PAYEMENT,3500.0,M960322367
20307,1196428',2018-05-10,FDRL/NATIONAL ELECTRONIC F,3500.0,0.0,,2018,5,10,CASH_OUT,3500.0,M1786085833
20308,1196428',2018-05-10,FDRL/NATIONAL ELECTRONIC F,3750.0,0.0,,2018,5,10,CHECK_WITHDRAWAL,3750.0,M718103121
20309,1196428',2018-05-10,FDRL/NATIONAL ELECTRONIC F,6500.0,0.0,,2018,5,10,DEBIT,6500.0,M757687320
20310,1196428',2018-05-10,FDRL/NATIONAL ELECTRONIC F,3750.0,0.0,,2018,5,10,PAYEMENT,3750.0,M1144148971
20311,1196428',2018-05-10,FDRL/NATIONAL ELECTRONIC F,3500.0,0.0,,2018,5,10,CASH_OUT,3500.0,M1868505862
20312,1196428',2018-05-10,FDRL/NATIONAL ELECTRONIC F,3750.0,0.0,,2018,5,10,CHECK_WITHDRAWAL,3750.0,M1608080402
20313,1196428',2018-05-10,FDRL/NATIONAL ELECTRONIC F,4000.0,0.0,,2018,5,10,CASH_OUT,4000.0,M1154038476
20314,1196428',2018-05-10,FDRL/NATIONAL ELECTRONIC F,3500.0,0.0,,2018,5,10,PAYEMENT,3500.0,M1325923139
20315,1196428',2018-05-10,FDRL/NATIONAL ELECTRONIC F,3750.0,0.0,,2018,5,10,DEBIT,3750.0,M1396188238
20316,1196428',2018-05-10,FDRL/NATIONAL ELECTRONIC F,3500.0,0.0,,2018,5,10,CHECK_WITHDRAWAL,3500.0,M554850979
20317,1196428',2018-05-10,FDRL/NATIONAL ELECTRONIC F,3750.0,0.0,,2018,5,10,CHECK_WITHDRAWAL,3750.0,M1055780232
20318,1196428',2018-05-10,FDRL/NATIONAL ELECTRONIC F,3750.0,0.0,,2018,5,10,PAYEMENT,3750.0,M662568271
20319,1196428',2018-05-10,FDRL/NATIONAL ELECTRONIC F,6500.0,0.0,,2018,5,10,PAYEMENT,6500.0,C1649449847
20320,1196428',2018-05-10,FDRL/NATIONAL ELECTRONIC F,3000.0,0.0,,2018,5,10,CASH_OUT,3000.0,C1198167820
20321,1196428',2018-05-10,FDRL/NATIONAL ELECTRONIC F,3500.0,0.0,,2018,5,10,DEBIT,3500.0,C749672494
20322,1196428',2018-05-10,FDRL/NATIONAL ELECTRONIC F,3750.0,0.0,,2018,5,10,CHECK_WITHDRAWAL,3750.0,C1423992712
20323,1196428',2018-05-10,FDRL/NATIONAL ELECTRONIC F,4000.0,0.0,,2018,5,10,DEBIT,4000.0,C313124964
20324,1196428',2018-05-10,FDRL/NATIONAL ELECTRONIC F,3750.0,0.0,,2018,5,10,CASH_OUT,3750.0,C500153041
20325,1196428',2018-05-10,FDRL/NATIONAL ELECTRONIC F,3750.0,0.0,,2018,5,10,DEBIT,3750.0,C728526866
20326,1196428',2018-05-10,FDRL/NATIONAL ELECTRONIC F,6500.0,0.0,,2018,5,10,PAYEMENT,6500.0,C40075281
20327,1196428',2018-05-10,FDRL/NATIONAL ELECTRONIC F,3750.0,0.0,,2018,5,10,PAYEMENT,3750.0,C456538529
20328,1196428',2018-05-10,FDRL/NATIONAL ELECTRONIC F,3750.0,0.0,,2018,5,10,PAYEMENT,3750.0,C2117043942
20329,1196428',2018-05-10,FDRL/NATIONAL ELECTRONIC F,5500.0,0.0,,2018,5,10,CHECK_WITHDRAWAL,5500.0,C1838584624
20330,1196428',2018-05-10,FDRL/NATIONAL ELECTRONIC F,5500.0,0.0,,2018,5,10,DEBIT,5500.0,M1733424208
20331,1196428',2018-05-10,FDRL/NATIONAL ELECTRONIC F,3750.0,0.0,,2018,5,10,DEBIT,3750.0,M1060393794
20332,1196428',2018-05-10,FDRL/NATIONAL ELECTRONIC F,3750.0,0.0,,2018,5,10,CASH_OUT,3750.0,M226593165
20333,1196428',2018-05-10,FDRL/NATIONAL ELECTRONIC F,3500.0,0.0,,2018,5,10,PAYEMENT,3500.0,M426584880
20334,1196428',2018-05-10,FDRL/NATIONAL ELECTRONIC F,3000.0,0.0,,2018,5,10,DEBIT,3000.0,C448155494
20335,1196428',2018-05-10,FDRL/NATIONAL ELECTRONIC F,6500.0,0.0,,2018,5,10,CASH_OUT,6500.0,M1594302764
20336,1196428',2018-05-10,FDRL/NATIONAL ELECTRONIC F,6500.0,0.0,,2018,5,10,PAYEMENT,6500.0,M271366306
20337,1196428',2018-05-10,FDRL/NATIONAL ELECTRONIC F,3750.0,0.0,,2018,5,10,DEBIT,3750.0,C348708793
20338,1196428',2018-05-10,FDRL/NATIONAL ELECTRONIC F,3750.0,0.0,,2018,5,10,CHECK_WITHDRAWAL,3750.0,M462659391
20339,1196428',2018-05-10,FDRL/NATIONAL ELECTRONIC F,3000.0,0.0,,2018,5,10,DEBIT,3000.0,M547825235
20340,1196428',2018-05-10,FDRL/NATIONAL ELECTRONIC F,3500.0,0.0,,2018,5,10,CASH_OUT,3500.0,M1301971459
20341,1196428',2018-05-10,FDRL/NATIONAL ELECTRONIC F,3500.0,0.0,,2018,5,10,CASH_OUT,3500.0,M1155771218
20342,1196428',2018-05-10,FDRL/NATIONAL ELECTRONIC F,3500.0,0.0,,2018,5,10,CASH_OUT,3500.0,M734120998
20343,1196428',2018-05-10,FDRL/NATIONAL ELECTRONIC F,3750.0,0.0,,2018,5,10,CASH_OUT,3750.0,M1404561012
20344,1196428',2018-05-10,FDRL/NATIONAL ELECTRONIC F,3750.0,0.0,,2018,5,10,CASH_OUT,3750.0,M1376999853
20345,1196428',2018-05-10,FDRL/NATIONAL ELECTRONIC F,3500.0,0.0,,2018,5,10,PAYEMENT,3500.0,M255307196
20346,1196428',2018-05-10,FDRL/NATIONAL ELECTRONIC F,3750.0,0.0,,2018,5,10,CASH_OUT,3750.0,M11285367
20347,1196428',2018-05-10,FDRL/NATIONAL ELECTRONIC F,5500.0,0.0,,2018,5,10,DEBIT,5500.0,M714914851
20348,1196428',2018-05-10,FDRL/NATIONAL ELECTRONIC F,3750.0,0.0,,2018,5,10,CHECK_WITHDRAWAL,3750.0,M1438724935
20349,1196428',2018-05-10,FDRL/NATIONAL ELECTRONIC F,3750.0,0.0,,2018,5,10,CASH_OUT,3750.0,M662472677
20350,1196428',2018-05-10,FDRL/NATIONAL ELECTRONIC F,3750.0,0.0,,2018,5,10,CHECK_WITHDRAWAL,3750.0,M1932384587
20351,1196428',2018-05-10,FDRL/NATIONAL ELECTRONIC F,3500.0,0.0,,2018,5,10,CASH_OUT,3500.0,M719480872
20352,1196428',2018-05-10,FDRL/NATIONAL ELECTRONIC F,3500.0,0.0,,2018,5,10,PAYEMENT,3500.0,M1278136570
20353,1196428',2018-05-10,FDRL/NATIONAL ELECTRONIC F,3750.0,0.0,,2018,5,10,CASH_OUT,3750.0,M148964727
20354,1196428',2018-05-10,FDRL/NATIONAL ELECTRONIC F,3000.0,0.0,,2018,5,10,CASH_OUT,3000.0,M1177742051
20355,1196428',2018-05-10,FDRL/NATIONAL ELECTRONIC F,3750.0,0.0,,2018,5,10,CASH_OUT,3750.0,M724365571
20356,1196428',2018-05-10,FDRL/NATIONAL ELECTRONIC F,3500.0,0.0,,2018,5,10,CHECK_WITHDRAWAL,3500.0,M212535805
20357,1196428',2018-05-10,FDRL/NATIONAL ELECTRONIC F,3000.0,0.0,,2018,5,10,PAYEMENT,3000.0,M1596397541
20358,1196428',2018-05-10,FDRL/NATIONAL ELECTRONIC F,3750.0,0.0,,2018,5,10,PAYEMENT,3750.0,M713285225
20359,1196428',2018-05-10,FDRL/NATIONAL ELECTRONIC F,3000.0,0.0,,2018,5,10,DEBIT,3000.0,C2032389005
20360,1196428',2018-05-10,FDRL/NATIONAL ELECTRONIC F,3750.0,0.0,,2018,5,10,CHECK_WITHDRAWAL,3750.0,M1156533869
20361,1196428',2018-05-10,FDRL/NATIONAL ELECTRONIC F,3500.0,0.0,,2018,5,10,CHECK_WITHDRAWAL,3500.0,M105292474
20362,1196428',2018-05-10,FDRL/NATIONAL ELECTRONIC F,3500.0,0.0,,2018,5,10,DEBIT,3500.0,M1410438390
20363,1196428',2018-05-10,FDRL/NATIONAL ELECTRONIC F,3750.0,0.0,,2018,5,10,DEBIT,3750.0,M1257755465
20364,1196428',2018-05-10,FDRL/NATIONAL ELECTRONIC F,3750.0,0.0,,2018,5,10,DEBIT,3750.0,M1640401120
20365,1196428',2018-05-10,FDRL/NATIONAL ELECTRONIC F,3750.0,0.0,,2018,5,10,DEBIT,3750.0,M1399060771
20366,1196428',2018-05-10,FDRL/NATIONAL ELECTRONIC F,3750.0,0.0,,2018,5,10,DEBIT,3750.0,C1262822392
20367,1196428',2018-05-10,FDRL/NATIONAL ELECTRONIC F,3500.0,0.0,,2018,5,10,CHECK_WITHDRAWAL,3500.0,M148589770
20368,1196428',2018-05-10,FDRL/NATIONAL ELECTRONIC F,3500.0,0.0,,2018,5,10,PAYEMENT,3500.0,M984489239
20369,1196428',2018-05-10,FDRL/NATIONAL ELECTRONIC F,3500.0,0.0,,2018,5,10,DEBIT,3500.0,C2115055717
20370,1196428',2018-05-10,FDRL/NATIONAL ELECTRONIC F,6500.0,0.0,,2018,5,10,CHECK_WITHDRAWAL,6500.0,C1166654566
20371,1196428',2018-05-10,FDRL/NATIONAL ELECTRONIC F,3000.0,0.0,,2018,5,10,DEBIT,3000.0,M88042020
20372,1196428',2018-05-10,FDRL/NATIONAL ELECTRONIC F,5500.0,0.0,,2018,5,10,CASH_OUT,5500.0,M717278894
20373,1196428',2018-05-10,FDRL/NATIONAL ELECTRONIC F,4000.0,0.0,,2018,5,10,PAYEMENT,4000.0,M129220812
20374,1196428',2018-05-10,FDRL/NATIONAL ELECTRONIC F,4000.0,0.0,,2018,5,10,PAYEMENT,4000.0,M1015272304
20375,1196428',2018-05-10,FDRL/NATIONAL ELECTRONIC F,5500.0,0.0,,2018,5,10,CASH_OUT,5500.0,C1007717381
20376,1196428',2018-05-10,FDRL/NATIONAL ELECTRONIC F,3750.0,0.0,,2018,5,10,CASH_OUT,3750.0,C1240091493
20377,1196428',2018-05-10,FDRL/NATIONAL ELECTRONIC F,4000.0,0.0,,2018,5,10,PAYEMENT,4000.0,C1396297158
20378,1196428',2018-05-10,FDRL/NATIONAL ELECTRONIC F,4000.0,0.0,,2018,5,10,CASH_OUT,4000.0,M705803524
20379,1196428',2018-05-10,FDRL/NATIONAL ELECTRONIC F,5500.0,0.0,,2018,5,10,DEBIT,5500.0,C978740207
20380,1196428',2018-05-10,FDRL/NATIONAL ELECTRONIC F,3500.0,0.0,,2018,5,10,CASH_OUT,3500.0,C115885991
20381,1196428',2018-05-10,FDRL/NATIONAL ELECTRONIC F,3750.0,0.0,,2018,5,10,DEBIT,3750.0,C587433505
20382,1196428',2018-05-10,FDRL/NATIONAL ELECTRONIC F,3500.0,0.0,,2018,5,10,DEBIT,3500.0,C1637186972
20383,1196428',2018-05-10,FDRL/NATIONAL ELECTRONIC F,3750.0,0.0,,2018,5,10,DEBIT,3750.0,M190739308
20384,1196428',2018-05-10,FDRL/NATIONAL ELECTRONIC F,3750.0,0.0,,2018,5,10,DEBIT,3750.0,C778306577
20385,1196428',2018-05-10,FDRL/NATIONAL ELECTRONIC F,3750.0,0.0,,2018,5,10,CHECK_WITHDRAWAL,3750.0,M1863711975
20386,1196428',2018-05-10,FDRL/NATIONAL ELECTRONIC F,3000.0,0.0,,2018,5,10,CASH_OUT,3000.0,M1469855297
20387,1196428',2018-05-10,FDRL/NATIONAL ELECTRONIC F,4000.0,0.0,,2018,5,10,PAYEMENT,4000.0,M794421806
20388,1196428',2018-05-10,FDRL/NATIONAL ELECTRONIC F,3000.0,0.0,,2018,5,10,PAYEMENT,3000.0,M1334051844
20389,1196428',2018-05-10,FDRL/NATIONAL ELECTRONIC F,3500.0,0.0,,2018,5,10,PAYEMENT,3500.0,M515450283
20390,1196428',2018-05-10,FDRL/NATIONAL ELECTRONIC F,5500.0,0.0,,2018,5,10,CASH_OUT,5500.0,M1747790771
20391,1196428',2018-05-10,FDRL/NATIONAL ELECTRONIC F,4000.0,0.0,,2018,5,10,PAYEMENT,4000.0,M1284135884
20392,1196428',2018-05-10,FDRL/NATIONAL ELECTRONIC F,3750.0,0.0,,2018,5,10,CHECK_WITHDRAWAL,3750.0,C420561530
20393,1196428',2018-05-10,FDRL/NATIONAL ELECTRONIC F,3750.0,0.0,,2018,5,10,CHECK_WITHDRAWAL,3750.0,M694158341
20394,1196428',2018-05-10,FDRL/NATIONAL ELECTRONIC F,5500.0,0.0,,2018,5,10,CHECK_WITHDRAWAL,5500.0,C2046578329
20395,1196428',2018-05-10,FDRL/NATIONAL ELECTRONIC F,3000.0,0.0,,2018,5,10,PAYEMENT,3000.0,M942812964
20396,1196428',2018-05-10,FDRL/NATIONAL ELECTRONIC F,4000.0,0.0,,2018,5,10,PAYEMENT,4000.0,M1977844832
20397,1196428',2018-05-10,FDRL/NATIONAL ELECTRONIC F,4000.0,0.0,,2018,5,10,PAYEMENT,4000.0,M1171276229
20398,1196428',2018-05-10,FDRL/NATIONAL ELECTRONIC F,3750.0,0.0,,2018,5,10,CHECK_WITHDRAWAL,3750.0,M1741253456
20399,1196428',2018-05-10,FDRL/NATIONAL ELECTRONIC F,3750.0,0.0,,2018,5,10,CHECK_WITHDRAWAL,3750.0,M1549630173
20400,1196428',2018-05-10,FDRL/NATIONAL ELECTRONIC F,3750.0,0.0,,2018,5,10,DEBIT,3750.0,C1548218207
20401,1196428',2018-05-10,FDRL/NATIONAL ELECTRONIC F,3500.0,0.0,,2018,5,10,DEBIT,3500.0,C242559404
20402,1196428',2018-05-10,FDRL/NATIONAL ELECTRONIC F,3750.0,0.0,,2018,5,10,PAYEMENT,3750.0,C1153596299
20403,1196428',2018-05-10,FDRL/REAL TIME GROSS SETTL,15000000.0,0.0,,2018,5,10,CASH_OUT,15000000.0,M708011911
20404,1196428',2018-05-10,FDRL/REAL TIME GROSS SETTL,10000000.0,0.0,,2018,5,10,CHECK_WITHDRAWAL,10000000.0,M1579526490
20405,1196428',2018-05-10,NEFT/AXISP18130082462/ACC,0.0,2000000.0,,2018,5,10,TRANSFER,2000000.0,C1924874046
20406,1196428',2018-05-10,RTGS/UTIBH18130666472/PER,0.0,900000.0,,2018,5,10,CHECK_CASHING,900000.0,C1079343872
20407,1196428',2018-05-10,RTGS/PUNBH18130620920/PUN,0.0,250000.0,,2018,5,10,TRANSFER,250000.0,M1025387324
20408,1196428',2018-05-10,NEFT/SBIN918130146137/VEN,0.0,11800.0,,2018,5,10,CHECK_CASHING,11800.0,M2114990234
20409,1196428',2018-05-10,Indiaforensic SERVICES INDIA PVT,0.0,480821.0,,2018,5,10,TRANSFER,480821.0,M1843420945
20410,1196428',2018-05-10,IMPS 813016343250 FROM AS,0.0,55199.0,,2018,5,10,CASH_IN,55199.0,C863811613
20411,1196428',2018-05-10,NEFT/000045323945/Indiaforensic,0.0,1200000.0,,2018,5,10,CHECK_CASHING,1200000.0,M1539382844
20412,1196428',2018-05-10,NEFT/000045324064/Indiaforensic,0.0,1200000.0,,2018,5,10,CHECK_CASHING,1200000.0,M1846768700
20413,1196428',2018-05-10,FDRL/INTERNAL FUND TRANSFE,1000000.0,0.0,,2018,5,10,CASH_OUT,1000000.0,C1640747200
20414,1196428',2018-05-10,FDRL/INTERNAL FUND TRANSFE,1000000.0,0.0,,2018,5,10,CHECK_WITHDRAWAL,1000000.0,M1099038981
20415,1196428',2018-05-10,BEAT CSH PKP DEL UDYOG 64,0.0,307300.0,,2018,5,10,CHECK_CASHING,307300.0,C344610846
20416,1196428',2018-05-10,TRF FROM  Indiaforensic SERVICES,0.0,5000000.0,,2018,5,10,TRANSFER,5000000.0,C1919277981
20417,1196428',2018-05-10,TRF FROM  Indiaforensic SERVICES,0.0,1000000.0,,2018,5,10,TRANSFER,1000000.0,C2104652067
20418,1196428',2018-05-10,TRF FROM  Indiaforensic SERVICES,0.0,500000.0,,2018,5,10,TRANSFER,500000.0,C1092465037
20419,1196428',2018-05-10,FDRL/INTERNAL FUND TRANSFE,10000000.0,0.0,,2018,5,10,PAYEMENT,10000000.0,M995633719
20420,1196428',2018-05-10,FDRL/INTERNAL FUND TRANSFE,1000000.0,0.0,,2018,5,10,CHECK_WITHDRAWAL,1000000.0,M938465080
20421,1196428',2018-05-11,RTGS/HDFCH18131653572/BAT,0.0,275000.0,,2018,5,11,CHECK_CASHING,275000.0,M1834981639
20422,1196428',2018-05-11,NEFT/SBIN918131478482/NAR,0.0,81257.0,,2018,5,11,CHECK_CASHING,81257.0,M1775303360
20423,1196428',2018-05-11,FDRL/INTERNAL FUND TRANSFE,1000000.0,0.0,,2018,5,11,CASH_OUT,1000000.0,M261084274
20424,1196428',2018-05-11,RTGS/SBINH18131008866/Indfor,0.0,2000000.0,,2018,5,11,CASH_IN,2000000.0,M1007295516
20425,1196428',2018-05-11,FDRL/NATIONAL ELECTRONIC F,860900.0,0.0,,2018,5,11,CHECK_WITHDRAWAL,860900.0,M470234716
20426,1196428',2018-05-11,FDRL/INTERNAL FUND TRANSFE,1000000.0,0.0,,2018,5,11,CHECK_WITHDRAWAL,1000000.0,M905290562
20427,1196428',2018-05-11,NEFT/CBINH18131106237/JAM,0.0,50000.0,,2018,5,11,CASH_IN,50000.0,M798935213
20428,1196428',2018-05-11,FDRL/INTERNAL FUND TRANSFE,1000000.0,0.0,,2018,5,11,CHECK_WITHDRAWAL,1000000.0,M1932154134
20429,1196428',2018-05-11,NEFT/SAA133825063/BHAMBRA,0.0,25000.0,,2018,5,11,CHECK_CASHING,25000.0,M1426777731
20430,1196428',2018-05-11,IRTT00701814233,1188.2,0.0,,2018,5,11,CHECK_WITHDRAWAL,1188.2,M2001931511
20431,1196428',2018-05-11,"Indiaforensic USA, INC./USD/1335",0.0,892447.82,,2018,5,11,CASH_IN,892447.82,M1028639221
20432,1196428',2018-05-11,NEFT/N131180539654545/ASH,0.0,75997.0,,2018,5,11,CASH_IN,75997.0,M129965176
20433,1196428',2018-05-11,FDRL/INTERNAL FUND TRANSFE,1000000.0,0.0,,2018,5,11,CASH_OUT,1000000.0,M1666930496
20434,1196428',2018-05-11,NEFT/AXISP18131075543/ACC,0.0,13000000.0,,2018,5,11,CHECK_CASHING,13000000.0,M1348049534
20435,1196428',2018-05-11,FDRL/REAL TIME GROSS SETTL,10000000.0,0.0,,2018,5,11,CASH_OUT,10000000.0,M149861385
20436,1196428',2018-05-11,RTGS/DLXBH18131500604/KAD,0.0,200000.0,,2018,5,11,CASH_IN,200000.0,M1803845616
20437,1196428',2018-05-11,RTGS/PUNBH18131640131/PUN,0.0,200000.0,,2018,5,11,TRANSFER,200000.0,M396463835
20438,1196428',2018-05-11,FDRL/INTERNAL FUND TRANSFE,500000.0,0.0,,2018,5,11,CASH_OUT,500000.0,M1022045468
20439,1196428',2018-05-11,NEFT/SBIN918131920520/VB,0.0,25000.0,,2018,5,11,TRANSFER,25000.0,M1556446144
20440,1196428',2018-05-11,NEFT/N131180539747643/TEC,0.0,200000.0,,2018,5,11,CASH_IN,200000.0,M141959252
20441,1196428',2018-05-11,FDRL/INTERNAL FUND TRANSFE,1000000.0,0.0,,2018,5,11,CHECK_WITHDRAWAL,1000000.0,M1997459283
20442,1196428',2018-05-11,NEFT/N131180539911898/BAN,0.0,100.0,,2018,5,11,CHECK_CASHING,100.0,M539292855
20443,1196428',2018-05-11,TRF FROM  Indiaforensic SERVICES,0.0,15000000.0,,2018,5,11,CASH_IN,15000000.0,M878266233
20444,1196428',2018-05-11,TRF FROM  Indiaforensic SERVICES,0.0,10700000.0,,2018,5,11,TRANSFER,10700000.0,M1660780699
20445,1196428',2018-05-11,IMPS 813116269645 FROM SA,0.0,100000.0,,2018,5,11,TRANSFER,100000.0,M1242431450
20446,1196428',2018-05-11,FDRL/NATIONAL ELECTRONIC F,5000000.0,0.0,,2018,5,11,PAYEMENT,5000000.0,M2075133206
20447,1196428',2018-05-11,FDRL/NATIONAL ELECTRONIC F,15000000.0,0.0,,2018,5,11,DEBIT,15000000.0,M1651383848
20448,1196428',2018-05-11,NEFT/N131180539933159/BAN,0.0,500.0,,2018,5,11,CASH_IN,500.0,M1364290623
20449,1196428',2018-05-11,NEFT/SBIN118131160794/NAR,0.0,82137.0,,2018,5,11,TRANSFER,82137.0,M1119145556
20450,1196428',2018-05-11,FDRL/INTERNAL FUND TRANSFE,1000000.0,0.0,,2018,5,11,DEBIT,1000000.0,M552762676
20451,1196428',2018-05-11,NEFT/000045399863/Indiaforensic,0.0,1000000.0,,2018,5,11,CASH_IN,1000000.0,M1549335447
20452,1196428',2018-05-11,NEFT/000045399766/Indiaforensic,0.0,1400000.0,,2018,5,11,CASH_IN,1400000.0,M1407332998
20453,1196428',2018-05-11,BEAT CSH PKP DEL UDYOG 64,0.0,473000.0,,2018,5,11,CHECK_CASHING,473000.0,M575173490
20454,1196428',2018-05-11,TRF FROM  Indiaforensic SERVICES,0.0,6300000.0,,2018,5,11,CHECK_CASHING,6300000.0,M1463959599
20455,1196428',2018-05-11,FDRL/INTERNAL FUND TRANSFE,10000000.0,0.0,,2018,5,11,PAYEMENT,10000000.0,C191614132
20456,1196428',2018-05-11,FDRL/INTERNAL FUND TRANSFE,0.0,3000000.0,,2018,5,11,CASH_IN,3000000.0,C1885712019
20457,1196428',2018-05-11,FDRL/INTERNAL FUND TRANSFE,3000000.0,0.0,,2018,5,11,CASH_OUT,3000000.0,M1406881784
20458,1196428',2018-05-11,FDRL/INTERNAL FUND TRANSFE,3000000.0,0.0,,2018,5,11,CASH_OUT,3000000.0,C1161865950
20459,1196428',2018-05-11,FDRL/INTERNAL FUND TRANSFE,500000.0,0.0,,2018,5,11,CHECK_WITHDRAWAL,500000.0,M1558051277
20460,1196428',2018-05-11,FDRL/INTERNAL FUND TRANSFE,0.0,1000000.0,,2018,5,11,CHECK_CASHING,1000000.0,M1173085824
20461,1196428',2018-05-11,FDRL/INTERNAL FUND TRANSFE,3000000.0,0.0,,2018,5,11,DEBIT,3000000.0,M569018137
20462,1196428',2018-05-11,FDRL/INTERNAL FUND TRANSFE,1000000.0,0.0,,2018,5,11,DEBIT,1000000.0,M1770271962
20463,1196428',2018-05-14,RTGS/SBINH18134007437/Indfor,0.0,6500000.0,,2018,5,14,TRANSFER,6500000.0,M1586738337
20464,1196428',2018-05-14,Indiaforensic SERVICES INDIA PVT,0.0,261599.0,,2018,5,14,CASH_IN,261599.0,M1674738101
20465,1196428',2018-05-14,RTGS/UTIBH18134678509/PER,0.0,900000.0,,2018,5,14,TRANSFER,900000.0,C1590550415
20466,1196428',2018-05-14,NEFT/N134180540575294/BAT,0.0,100000.0,,2018,5,14,TRANSFER,100000.0,C705321061
20467,1196428',2018-05-14,NEFT/N134180540586608/TEC,0.0,200000.0,,2018,5,14,CASH_IN,200000.0,M873689156
20468,1196428',2018-05-14,NEFT/SBIN118134676657/NAR,0.0,51363.0,,2018,5,14,CASH_IN,51363.0,M1538317866
20469,1196428',2018-05-14,FDRL/NATIONAL ELECTRONIC F,2147379.0,0.0,,2018,5,14,CASH_OUT,2147379.0,C262828207
20470,1196428',2018-05-14,FDRL/NATIONAL ELECTRONIC F,1114584.0,0.0,,2018,5,14,PAYEMENT,1114584.0,C1222590577
20471,1196428',2018-05-14,FDRL/NATIONAL ELECTRONIC F,2592244.0,0.0,,2018,5,14,CHECK_WITHDRAWAL,2592244.0,M2089852906
20472,1196428',2018-05-14,FDRL/INTERNAL FUND TRANSFE,500000.0,0.0,,2018,5,14,CHECK_WITHDRAWAL,500000.0,M629502621
20473,1196428',2018-05-14,FDRL/INTERNAL FUND TRANSFE,1000000.0,0.0,,2018,5,14,DEBIT,1000000.0,M511596806
20474,1196428',2018-05-14,FDRL/INTERNAL FUND TRANSFE,300000.0,0.0,,2018,5,14,CASH_OUT,300000.0,M2079635991
20475,1196428',2018-05-14,CHQ DEP/118/OWDEL1/HDFC/J,0.0,11800.0,,2018,5,14,CASH_IN,11800.0,M1044456366
20476,1196428',2018-05-14,CHQ DEP/320665/OWDEL1/CLA,0.0,11800.0,,2018,5,14,CHECK_CASHING,11800.0,C1689840534
20477,1196428',2018-05-14,CHQ DEP/33078/OWDEL1/UBIN,0.0,11800.0,,2018,5,14,TRANSFER,11800.0,M1092817314
20478,1196428',2018-05-14,CHQ DEP/97302/OWDEL1/JAKA,0.0,11800.0,,2018,5,14,CHECK_CASHING,11800.0,C1475909248
20479,1196428',2018-05-14,CHQ DEP/45163/OWDEL1/JAKA,0.0,11800.0,,2018,5,14,CASH_IN,11800.0,M2040472550
20480,1196428',2018-05-14,CHQ DEP/154454/OWDEL1/JAK,0.0,11800.0,,2018,5,14,CHECK_CASHING,11800.0,C979719862
20481,1196428',2018-05-14,CHQ DEP/659235/OWDEL1/JAK,0.0,11800.0,,2018,5,14,TRANSFER,11800.0,C985934102
20482,1196428',2018-05-14,CHQ DEP/385876/OWDEL1/JAK,0.0,11800.0,,2018,5,14,TRANSFER,11800.0,C731253803
20483,1196428',2018-05-14,CHQ DEP/373093/OWDEL1/JAK,0.0,11800.0,,2018,5,14,TRANSFER,11800.0,C1609562230
20484,1196428',2018-05-14,CHQ DEP/166663/OWDEL1/JAK,0.0,11800.0,,2018,5,14,CASH_IN,11800.0,M1076923640
20485,1196428',2018-05-14,CHQ DEP/67922/OWDEL1/JAKA,0.0,11800.0,,2018,5,14,CASH_IN,11800.0,M1144262832
20486,1196428',2018-05-14,CHQ DEP/246717/OWDEL1/PUN,0.0,11800.0,,2018,5,14,CHECK_CASHING,11800.0,M942922351
20487,1196428',2018-05-14,CHQ DEP/1158/OWDEL1/PUNB/,0.0,11800.0,,2018,5,14,CHECK_CASHING,11800.0,M1582038853
20488,1196428',2018-05-14,CHQ DEP/625/OWDEL1/HDFC/Y,0.0,11800.0,,2018,5,14,CASH_IN,11800.0,M36034212
20489,1196428',2018-05-14,CHQ DEP/1321/OWDEL1/SBIN/,0.0,11800.0,,2018,5,14,TRANSFER,11800.0,M1326356346
20490,1196428',2018-05-14,CHQ DEP/232/OWDEL1/CORP/N,0.0,11800.0,,2018,5,14,TRANSFER,11800.0,C27489818
20491,1196428',2018-05-14,CHQ DEP/45256/OWDEL1/SBIN,0.0,11800.0,,2018,5,14,CHECK_CASHING,11800.0,C747979499
20492,1196428',2018-05-14,CHQ DEP/387493/OWDEL1/ICI,0.0,11800.0,,2018,5,14,TRANSFER,11800.0,C1660095722
20493,1196428',2018-05-14,CHQ DEP/19250/OWDEL1/IBKL,0.0,11800.0,,2018,5,14,CHECK_CASHING,11800.0,C372017580
20494,1196428',2018-05-14,CHQ DEP/85898/OWDEL1/CBIN,0.0,11800.0,,2018,5,14,TRANSFER,11800.0,M370179552
20495,1196428',2018-05-14,CHQ DEP/184883/OWDEL1/UTI,0.0,11800.0,,2018,5,14,TRANSFER,11800.0,C802935635
20496,1196428',2018-05-14,CHQ DEP/25626/OWDEL1/SYNB,0.0,11800.0,,2018,5,14,CHECK_CASHING,11800.0,M1523086740
20497,1196428',2018-05-14,CHQ DEP/217824/OWDEL1/ICI,0.0,11800.0,,2018,5,14,CASH_IN,11800.0,M902885640
20498,1196428',2018-05-14,CHQ DEP/430893/OWDEL1/ORB,0.0,11800.0,,2018,5,14,CHECK_CASHING,11800.0,C459172227
20499,1196428',2018-05-14,CHQ DEP/199727/OWDEL1/SBI,0.0,11800.0,,2018,5,14,TRANSFER,11800.0,C265108079
20500,1196428',2018-05-14,CHQ DEP/200641/OWDEL1/SBI,0.0,11800.0,,2018,5,14,CASH_IN,11800.0,C35126588
20501,1196428',2018-05-14,RTGS/PUNBH18134657076/PUN,0.0,600000.0,,2018,5,14,TRANSFER,600000.0,C1589477624
20502,1196428',2018-05-14,FDRL/INTERNAL FUND TRANSFE,500000.0,0.0,,2018,5,14,CHECK_WITHDRAWAL,500000.0,C1283595719
20503,1196428',2018-05-14,FDRL/INTERNAL FUND TRANSFE,500000.0,0.0,,2018,5,14,CHECK_WITHDRAWAL,500000.0,C101084405
20504,1196428',2018-05-14,NEFT/BARBQ18134208858/MAK,0.0,56780.0,,2018,5,14,CHECK_CASHING,56780.0,M7891579
20505,1196428',2018-05-14,CHQ DEPOSIT RETURN/659235,11800.0,0.0,,2018,5,14,DEBIT,11800.0,M150228660
20506,1196428',2018-05-14,CHQ DEPOSIT RETURN/246717,11800.0,0.0,,2018,5,14,CASH_OUT,11800.0,M190019040
20507,1196428',2018-05-14,CHQ DEPOSIT RETURN/217824,11800.0,0.0,,2018,5,14,PAYEMENT,11800.0,M1462909495
20508,1196428',2018-05-14,CHQ DEPOSIT RETURN/200641,11800.0,0.0,,2018,5,14,PAYEMENT,11800.0,C1192983708
20509,1196428',2018-05-14,TRF FROM  Indiaforensic SERVICES,0.0,15000000.0,,2018,5,14,CHECK_CASHING,15000000.0,M1730398598
20510,1196428',2018-05-14,TRF FROM  Indiaforensic SERVICES,0.0,15000000.0,,2018,5,14,CASH_IN,15000000.0,M1492635498
20511,1196428',2018-05-14,TRF FROM  Indiaforensic SERVICES,0.0,15000000.0,,2018,5,14,TRANSFER,15000000.0,M738483886
20512,1196428',2018-05-14,TRF FROM  Indiaforensic SERVICES,0.0,15000000.0,,2018,5,14,CASH_IN,15000000.0,M1583014678
20513,1196428',2018-05-14,FDRL/REAL TIME GROSS SETTL,15000000.0,0.0,,2018,5,14,PAYEMENT,15000000.0,C395114097
20514,1196428',2018-05-14,FDRL/REAL TIME GROSS SETTL,15000000.0,0.0,,2018,5,14,CHECK_WITHDRAWAL,15000000.0,M743943553
20515,1196428',2018-05-14,FDRL/REAL TIME GROSS SETTL,15000000.0,0.0,,2018,5,14,DEBIT,15000000.0,M2034445578
20516,1196428',2018-05-14,IMPS 813415445015 FROM SA,0.0,100000.0,,2018,5,14,TRANSFER,100000.0,C1383942363
20517,1196428',2018-05-14,FDRL/REAL TIME GROSS SETTL,10000000.0,0.0,,2018,5,14,CASH_OUT,10000000.0,M72285092
20518,1196428',2018-05-14,FDRL/INTERNAL FUND TRANSFE,500000.0,0.0,,2018,5,14,PAYEMENT,500000.0,M586185216
20519,1196428',2018-05-14,FDRL/INTERNAL FUND TRANSFE,500000.0,0.0,,2018,5,14,PAYEMENT,500000.0,M1378755468
20520,1196428',2018-05-14,FDRL/REAL TIME GROSS SETTL,1000000.0,0.0,,2018,5,14,CHECK_WITHDRAWAL,1000000.0,C765980478
20521,1196428',2018-05-14,FDRL/REAL TIME GROSS SETTL,1000000.0,0.0,,2018,5,14,CHECK_WITHDRAWAL,1000000.0,C1200314947
20522,1196428',2018-05-14,FDRL/REAL TIME GROSS SETTL,1000000.0,0.0,,2018,5,14,DEBIT,1000000.0,C1973491942
20523,1196428',2018-05-14,FDRL/NATIONAL ELECTRONIC F,11686.0,0.0,,2018,5,14,CASH_OUT,11686.0,C1689374891
20524,1196428',2018-05-14,FDRL/NATIONAL ELECTRONIC F,23212.0,0.0,,2018,5,14,CASH_OUT,23212.0,C2053639017
20525,1196428',2018-05-14,FDRL/NATIONAL ELECTRONIC F,13535.0,0.0,,2018,5,14,DEBIT,13535.0,C1654056127
20526,1196428',2018-05-14,Indiaforensic SERVICES INDIA PVT,0.0,582810.0,,2018,5,14,CHECK_CASHING,582810.0,C803368825
20527,1196428',2018-05-14,FDRL/INTERNAL FUND TRANSFE,500000.0,0.0,,2018,5,14,CASH_OUT,500000.0,C892686452
20528,1196428',2018-05-14,FDRL/INTERNAL FUND TRANSFE,500000.0,0.0,,2018,5,14,CASH_OUT,500000.0,C2031563133
20529,1196428',2018-05-14,NEFT/000045478633/Indiaforensic,0.0,2600000.0,,2018,5,14,TRANSFER,2600000.0,C1619402333
20530,1196428',2018-05-14,NEFT/000045478145/Indiaforensic,0.0,2900000.0,,2018,5,14,CASH_IN,2900000.0,C1149273771
20531,1196428',2018-05-14,TRF FROM  Indiaforensic SERVICES,0.0,5000000.0,,2018,5,14,CASH_IN,5000000.0,C2109470512
20532,1196428',2018-05-14,TRF FROM  Indiaforensic SERVICES,0.0,5000000.0,,2018,5,14,CHECK_CASHING,5000000.0,C1059781259
20533,1196428',2018-05-14,TRF FROM  Indiaforensic SERVICES,0.0,4000000.0,,2018,5,14,CASH_IN,4000000.0,C125722707
20534,1196428',2018-05-14,TRF FROM  Indiaforensic SERVICES,0.0,5000000.0,,2018,5,14,CHECK_CASHING,5000000.0,C1778300121
20535,1196428',2018-05-14,FDRL/INTERNAL FUND TRANSFE,3000000.0,0.0,,2018,5,14,CHECK_WITHDRAWAL,3000000.0,C313124964
20536,1196428',2018-05-14,FDRL/INTERNAL FUND TRANSFE,5000000.0,0.0,,2018,5,14,PAYEMENT,5000000.0,C1220897602
20537,1196428',2018-05-14,FDRL/INTERNAL FUND TRANSFE,5000000.0,0.0,,2018,5,14,CHECK_WITHDRAWAL,5000000.0,C1515704208
20538,1196428',2018-05-14,FDRL/INTERNAL FUND TRANSFE,2000000.0,0.0,,2018,5,14,CHECK_WITHDRAWAL,2000000.0,C1313534832
20539,1196428',2018-05-14,FDRL/INTERNAL FUND TRANSFE,2000000.0,0.0,,2018,5,14,CHECK_WITHDRAWAL,2000000.0,C1141137903
20540,1196428',2018-05-14,"DIGITAL PERSONA,INC./USD/",1138200.0,0.0,,2018,5,14,CHECK_WITHDRAWAL,1138200.0,C1869228744
20541,1196428',2018-05-14,IMAR00701802841,3283.73,0.0,,2018,5,14,DEBIT,3283.73,C2078250226
20542,1196428',2018-05-14,BEAT CSH PKP DEL GURG 643,0.0,531500.0,,2018,5,14,TRANSFER,531500.0,C1300519073
20543,1196428',2018-05-14,CHQ DEPOSIT RETURN/246717,100.0,0.0,,2018,5,14,DEBIT,100.0,M1808484670
20544,1196428',2018-05-14,CHQ DEPOSIT RETURN/246717,18.0,0.0,,2018,5,14,PAYEMENT,18.0,M829035073
20545,1196428',2018-05-14,CHQ DEPOSIT RETURN/217824,100.0,0.0,,2018,5,14,CASH_OUT,100.0,M1674174327
20546,1196428',2018-05-14,CHQ DEPOSIT RETURN/217824,18.0,0.0,,2018,5,14,DEBIT,18.0,M2135203084
20547,1196428',2018-05-14,CHQ DEPOSIT RETURN/200641,100.0,0.0,,2018,5,14,CHECK_WITHDRAWAL,100.0,C1673971173
20548,1196428',2018-05-14,CHQ DEPOSIT RETURN/200641,18.0,0.0,,2018,5,14,DEBIT,18.0,C339099861
20549,1196428',2018-05-15,FDRL/INTERNAL FUND TRANSFE,500000.0,0.0,,2018,5,15,CASH_OUT,500000.0,M2045422556
20550,1196428',2018-05-15,FDRL/REAL TIME GROSS SETTL,5000000.0,0.0,,2018,5,15,CHECK_WITHDRAWAL,5000000.0,C1266035080
20551,1196428',2018-05-15,FDRL/INTERNAL FUND TRANSFE,500000.0,0.0,,2018,5,15,DEBIT,500000.0,C1060041730
20552,1196428',2018-05-15,FDRL/INTERNAL FUND TRANSFE,500000.0,0.0,,2018,5,15,CASH_OUT,500000.0,C1475395523
20553,1196428',2018-05-15,FDRL/NATIONAL ELECTRONIC F,648836.0,0.0,,2018,5,15,CASH_OUT,648836.0,C265845794
20554,1196428',2018-05-15,NEFT/SBIN218135435803/NAR,0.0,52873.0,,2018,5,15,TRANSFER,52873.0,C58091972
20555,1196428',2018-05-15,IMPS 813513374903 FROM AS,0.0,199125.0,,2018,5,15,TRANSFER,199125.0,C193864812
20556,1196428',2018-05-15,FDRL/INTERNAL FUND TRANSFE,500000.0,0.0,,2018,5,15,CHECK_WITHDRAWAL,500000.0,C681835572
20557,1196428',2018-05-15,TRF FROM  Indiaforensic SERVICES,0.0,15000000.0,,2018,5,15,CASH_IN,15000000.0,C965197768
20558,1196428',2018-05-15,TRF FROM  Indiaforensic SERVICES,0.0,7900000.0,,2018,5,15,TRANSFER,7900000.0,C893038039
20559,1196428',2018-05-15,FDRL/REAL TIME GROSS SETTL,15000000.0,0.0,,2018,5,15,DEBIT,15000000.0,C1317731757
20560,1196428',2018-05-15,FDRL/REAL TIME GROSS SETTL,5000000.0,0.0,,2018,5,15,CHECK_WITHDRAWAL,5000000.0,C1373467808
20561,1196428',2018-05-15,FDRL/INTERNAL FUND TRANSFE,500000.0,0.0,,2018,5,15,CHECK_WITHDRAWAL,500000.0,C1318822808
20562,1196428',2018-05-15,NEFT/PUNBH18135266277/PUN,0.0,250000.0,,2018,5,15,CASH_IN,250000.0,C1424731356
20563,1196428',2018-05-15,Indiaforensic SERVICES INDIA PVT,0.0,242666.0,,2018,5,15,CHECK_CASHING,242666.0,C1439007204
20564,1196428',2018-05-15,NEFT/N135180541871965/Indfor,0.0,7000000.0,,2018,5,15,TRANSFER,7000000.0,C1116292004
20565,1196428',2018-05-15,FDRL/INTERNAL FUND TRANSFE,500000.0,0.0,,2018,5,15,CASH_OUT,500000.0,C638551812
20566,1196428',2018-05-15,NEFT/000045559795/Indiaforensic,0.0,1600000.0,,2018,5,15,TRANSFER,1600000.0,C193826743
20567,1196428',2018-05-15,NEFT/000045559460/Indiaforensic,0.0,1600000.0,,2018,5,15,CASH_IN,1600000.0,C309167705
20568,1196428',2018-05-15,TRF FROM  Indiaforensic SERVICES,0.0,1100000.0,,2018,5,15,TRANSFER,1100000.0,C811597470
20569,1196428',2018-05-15,TRF FROM  Indiaforensic SERVICES,0.0,7600000.0,,2018,5,15,CHECK_CASHING,7600000.0,C1014923261
20570,1196428',2018-05-15,"DIGITAL PERSONA INC,/USD/",2067150.06,0.0,,2018,5,15,CASH_OUT,2067150.06,C925574515
20571,1196428',2018-05-15,IMAR00701802872,4821.14,0.0,,2018,5,15,DEBIT,4821.14,C1988152146
20572,1196428',2018-05-15,IMPS 813519186287 FROM SA,0.0,50000.0,,2018,5,15,CHECK_CASHING,50000.0,C71555810
20573,1196428',2018-05-15,BEAT CSH PKP DEL GURG 643,0.0,137000.0,,2018,5,15,TRANSFER,137000.0,C1273939873
20574,1196428',2018-05-15,FDRL/INTERNAL FUND TRANSFE,4000000.0,0.0,,2018,5,15,CASH_OUT,4000000.0,C749672494
20575,1196428',2018-05-15,FDRL/INTERNAL FUND TRANSFE,6000000.0,0.0,,2018,5,15,DEBIT,6000000.0,C1504109395
20576,1196428',2018-05-15,FDRL/INTERNAL FUND TRANSFE,1000000.0,0.0,,2018,5,15,CHECK_WITHDRAWAL,1000000.0,C2107268831
20577,1196428',2018-05-15,FDRL/INTERNAL FUND TRANSFE,38159.0,0.0,,2018,5,15,CASH_OUT,38159.0,C1141137903
20578,1196428',2018-05-15,FDRL/INTERNAL FUND TRANSFE,22000.0,0.0,,2018,5,15,PAYEMENT,22000.0,M492166970
20579,1196428',2018-05-15,FDRL/INTERNAL FUND TRANSFE,38680.0,0.0,,2018,5,15,CASH_OUT,38680.0,C762570948
20580,1196428',2018-05-16,FDRL/NATIONAL ELECTRONIC F,11559.0,0.0,,2018,5,16,PAYEMENT,11559.0,C1440282299
20581,1196428',2018-05-16,FDRL/NATIONAL ELECTRONIC F,11737.0,0.0,,2018,5,16,PAYEMENT,11737.0,M1583639547
20582,1196428',2018-05-16,FDRL/NATIONAL ELECTRONIC F,39657.0,0.0,,2018,5,16,DEBIT,39657.0,M1476691574
20583,1196428',2018-05-16,FDRL/NATIONAL ELECTRONIC F,40552.0,0.0,,2018,5,16,CASH_OUT,40552.0,C893339434
20584,1196428',2018-05-16,FDRL/NATIONAL ELECTRONIC F,13084.0,0.0,,2018,5,16,CHECK_WITHDRAWAL,13084.0,M722806861
20585,1196428',2018-05-16,FDRL/NATIONAL ELECTRONIC F,11019.0,0.0,,2018,5,16,DEBIT,11019.0,C1150610696
20586,1196428',2018-05-16,FDRL/NATIONAL ELECTRONIC F,21933.0,0.0,,2018,5,16,DEBIT,21933.0,C1674899618
20587,1196428',2018-05-16,FDRL/NATIONAL ELECTRONIC F,45200.0,0.0,,2018,5,16,PAYEMENT,45200.0,M481126602
20588,1196428',2018-05-16,FDRL/NATIONAL ELECTRONIC F,27685.0,0.0,,2018,5,16,CHECK_WITHDRAWAL,27685.0,C1793325972
20589,1196428',2018-05-16,FDRL/NATIONAL ELECTRONIC F,33536.0,0.0,,2018,5,16,CHECK_WITHDRAWAL,33536.0,M132360639
20590,1196428',2018-05-16,FDRL/NATIONAL ELECTRONIC F,30250.0,0.0,,2018,5,16,PAYEMENT,30250.0,M2052092920
20591,1196428',2018-05-16,FDRL/NATIONAL ELECTRONIC F,25719.0,0.0,,2018,5,16,CHECK_WITHDRAWAL,25719.0,M236650472
20592,1196428',2018-05-16,FDRL/NATIONAL ELECTRONIC F,43093.0,0.0,,2018,5,16,PAYEMENT,43093.0,M2089634452
20593,1196428',2018-05-16,FDRL/NATIONAL ELECTRONIC F,48921.0,0.0,,2018,5,16,PAYEMENT,48921.0,M1097809105
20594,1196428',2018-05-16,FDRL/NATIONAL ELECTRONIC F,16061.0,0.0,,2018,5,16,CHECK_WITHDRAWAL,16061.0,C302025300
20595,1196428',2018-05-16,FDRL/NATIONAL ELECTRONIC F,16628.0,0.0,,2018,5,16,PAYEMENT,16628.0,M134742492
20596,1196428',2018-05-16,FDRL/NATIONAL ELECTRONIC F,36193.0,0.0,,2018,5,16,CHECK_WITHDRAWAL,36193.0,C1511785794
20597,1196428',2018-05-16,FDRL/NATIONAL ELECTRONIC F,11756.0,0.0,,2018,5,16,PAYEMENT,11756.0,M1604293868
20598,1196428',2018-05-16,FDRL/NATIONAL ELECTRONIC F,17508.0,0.0,,2018,5,16,CHECK_WITHDRAWAL,17508.0,M1853641629
20599,1196428',2018-05-16,FDRL/NATIONAL ELECTRONIC F,36171.0,0.0,,2018,5,16,CHECK_WITHDRAWAL,36171.0,M710600916
20600,1196428',2018-05-16,FDRL/NATIONAL ELECTRONIC F,26095.0,0.0,,2018,5,16,CHECK_WITHDRAWAL,26095.0,M985323561
20601,1196428',2018-05-16,FDRL/NATIONAL ELECTRONIC F,22826.0,0.0,,2018,5,16,DEBIT,22826.0,M1194715097
20602,1196428',2018-05-16,FDRL/NATIONAL ELECTRONIC F,12596.0,0.0,,2018,5,16,DEBIT,12596.0,M693684695
20603,1196428',2018-05-16,FDRL/NATIONAL ELECTRONIC F,15871.0,0.0,,2018,5,16,CHECK_WITHDRAWAL,15871.0,M1582319135
20604,1196428',2018-05-16,FDRL/NATIONAL ELECTRONIC F,10077.0,0.0,,2018,5,16,CHECK_WITHDRAWAL,10077.0,M227290600
20605,1196428',2018-05-16,FDRL/NATIONAL ELECTRONIC F,14551.0,0.0,,2018,5,16,CHECK_WITHDRAWAL,14551.0,M2089806029
20606,1196428',2018-05-16,FDRL/NATIONAL ELECTRONIC F,38346.0,0.0,,2018,5,16,DEBIT,38346.0,M1477278751
20607,1196428',2018-05-16,FDRL/NATIONAL ELECTRONIC F,26825.0,0.0,,2018,5,16,CASH_OUT,26825.0,M1650385017
20608,1196428',2018-05-16,FDRL/NATIONAL ELECTRONIC F,38582.0,0.0,,2018,5,16,PAYEMENT,38582.0,M1921059756
20609,1196428',2018-05-16,FDRL/NATIONAL ELECTRONIC F,28288.0,0.0,,2018,5,16,PAYEMENT,28288.0,M590434145
20610,1196428',2018-05-16,FDRL/NATIONAL ELECTRONIC F,43693.0,0.0,,2018,5,16,PAYEMENT,43693.0,M1671621366
20611,1196428',2018-05-16,FDRL/NATIONAL ELECTRONIC F,30359.0,0.0,,2018,5,16,CASH_OUT,30359.0,M899686935
20612,1196428',2018-05-16,FDRL/NATIONAL ELECTRONIC F,16989.0,0.0,,2018,5,16,PAYEMENT,16989.0,M2054039573
20613,1196428',2018-05-16,FDRL/NATIONAL ELECTRONIC F,15824.0,0.0,,2018,5,16,PAYEMENT,15824.0,M1271480561
20614,1196428',2018-05-16,FDRL/NATIONAL ELECTRONIC F,39550.0,0.0,,2018,5,16,CHECK_WITHDRAWAL,39550.0,C1259769769
20615,1196428',2018-05-16,FDRL/NATIONAL ELECTRONIC F,24293.0,0.0,,2018,5,16,DEBIT,24293.0,M649539827
20616,1196428',2018-05-16,FDRL/NATIONAL ELECTRONIC F,27120.0,0.0,,2018,5,16,DEBIT,27120.0,C893350828
20617,1196428',2018-05-16,FDRL/NATIONAL ELECTRONIC F,31468.0,0.0,,2018,5,16,PAYEMENT,31468.0,M20364107
20618,1196428',2018-05-16,FDRL/NATIONAL ELECTRONIC F,33900.0,0.0,,2018,5,16,CHECK_WITHDRAWAL,33900.0,M2023197227
20619,1196428',2018-05-16,FDRL/NATIONAL ELECTRONIC F,37511.0,0.0,,2018,5,16,CASH_OUT,37511.0,C232812328
20620,1196428',2018-05-16,FDRL/NATIONAL ELECTRONIC F,46314.0,0.0,,2018,5,16,DEBIT,46314.0,M902890505
20621,1196428',2018-05-16,FDRL/NATIONAL ELECTRONIC F,37221.0,0.0,,2018,5,16,CHECK_WITHDRAWAL,37221.0,M1465861273
20622,1196428',2018-05-16,FDRL/NATIONAL ELECTRONIC F,42043.0,0.0,,2018,5,16,CHECK_WITHDRAWAL,42043.0,M949506330
20623,1196428',2018-05-16,FDRL/NATIONAL ELECTRONIC F,40958.0,0.0,,2018,5,16,PAYEMENT,40958.0,M2084969506
20624,1196428',2018-05-16,FDRL/NATIONAL ELECTRONIC F,36552.0,0.0,,2018,5,16,CHECK_WITHDRAWAL,36552.0,M608038618
20625,1196428',2018-05-16,FDRL/NATIONAL ELECTRONIC F,34258.0,0.0,,2018,5,16,DEBIT,34258.0,M1041764081
20626,1196428',2018-05-16,FDRL/NATIONAL ELECTRONIC F,4394.0,0.0,,2018,5,16,PAYEMENT,4394.0,M277788688
20627,1196428',2018-05-16,FDRL/NATIONAL ELECTRONIC F,31595.0,0.0,,2018,5,16,DEBIT,31595.0,M31440957
20628,1196428',2018-05-16,FDRL/NATIONAL ELECTRONIC F,10641.0,0.0,,2018,5,16,DEBIT,10641.0,C1805162633
20629,1196428',2018-05-16,FDRL/NATIONAL ELECTRONIC F,30798.0,0.0,,2018,5,16,CASH_OUT,30798.0,M1201023997
20630,1196428',2018-05-16,FDRL/NATIONAL ELECTRONIC F,16809.0,0.0,,2018,5,16,DEBIT,16809.0,M1412743565
20631,1196428',2018-05-16,FDRL/NATIONAL ELECTRONIC F,22753.0,0.0,,2018,5,16,CASH_OUT,22753.0,M1887477561
20632,1196428',2018-05-16,FDRL/NATIONAL ELECTRONIC F,20491.0,0.0,,2018,5,16,CHECK_WITHDRAWAL,20491.0,C435161028
20633,1196428',2018-05-16,FDRL/NATIONAL ELECTRONIC F,19449.0,0.0,,2018,5,16,CASH_OUT,19449.0,M2126024846
20634,1196428',2018-05-16,FDRL/NATIONAL ELECTRONIC F,19252.0,0.0,,2018,5,16,DEBIT,19252.0,M885738476
20635,1196428',2018-05-16,FDRL/NATIONAL ELECTRONIC F,26227.0,0.0,,2018,5,16,DEBIT,26227.0,C1273939873
20636,1196428',2018-05-16,FDRL/NATIONAL ELECTRONIC F,23335.0,0.0,,2018,5,16,CHECK_WITHDRAWAL,23335.0,C464094472
20637,1196428',2018-05-16,FDRL/NATIONAL ELECTRONIC F,10610.0,0.0,,2018,5,16,CASH_OUT,10610.0,C1475998599
20638,1196428',2018-05-16,FDRL/NATIONAL ELECTRONIC F,23520.0,0.0,,2018,5,16,DEBIT,23520.0,C1789550256
20639,1196428',2018-05-16,FDRL/NATIONAL ELECTRONIC F,19373.0,0.0,,2018,5,16,DEBIT,19373.0,C1805445027
20640,1196428',2018-05-16,FDRL/NATIONAL ELECTRONIC F,6683.0,0.0,,2018,5,16,CHECK_WITHDRAWAL,6683.0,C968448640
20641,1196428',2018-05-16,FDRL/NATIONAL ELECTRONIC F,18092.0,0.0,,2018,5,16,DEBIT,18092.0,C691636444
20642,1196428',2018-05-16,FDRL/NATIONAL ELECTRONIC F,13697.0,0.0,,2018,5,16,DEBIT,13697.0,C1778801068
20643,1196428',2018-05-16,FDRL/NATIONAL ELECTRONIC F,18545.0,0.0,,2018,5,16,CASH_OUT,18545.0,C2029896123
20644,1196428',2018-05-16,FDRL/NATIONAL ELECTRONIC F,27734.0,0.0,,2018,5,16,CASH_OUT,27734.0,C1677727024
20645,1196428',2018-05-16,FDRL/NATIONAL ELECTRONIC F,12953.0,0.0,,2018,5,16,CHECK_WITHDRAWAL,12953.0,C1525944481
20646,1196428',2018-05-16,FDRL/NATIONAL ELECTRONIC F,22500.0,0.0,,2018,5,16,PAYEMENT,22500.0,C481402298
20647,1196428',2018-05-16,FDRL/NATIONAL ELECTRONIC F,24484.0,0.0,,2018,5,16,PAYEMENT,24484.0,C177457290
20648,1196428',2018-05-16,FDRL/NATIONAL ELECTRONIC F,22600.0,0.0,,2018,5,16,CHECK_WITHDRAWAL,22600.0,M1138171728
20649,1196428',2018-05-16,FDRL/NATIONAL ELECTRONIC F,9827.0,0.0,,2018,5,16,CHECK_WITHDRAWAL,9827.0,C1452722471
20650,1196428',2018-05-16,FDRL/NATIONAL ELECTRONIC F,29024.0,0.0,,2018,5,16,CASH_OUT,29024.0,C861958315
20651,1196428',2018-05-16,FDRL/NATIONAL ELECTRONIC F,9827.0,0.0,,2018,5,16,PAYEMENT,9827.0,M919438675
20652,1196428',2018-05-16,FDRL/NATIONAL ELECTRONIC F,11010.0,0.0,,2018,5,16,CHECK_WITHDRAWAL,11010.0,M1501022601
20653,1196428',2018-05-16,FDRL/NATIONAL ELECTRONIC F,28264.0,0.0,,2018,5,16,CASH_OUT,28264.0,M397708705
20654,1196428',2018-05-16,FDRL/NATIONAL ELECTRONIC F,14424.0,0.0,,2018,5,16,DEBIT,14424.0,M1092898377
20655,1196428',2018-05-16,FDRL/NATIONAL ELECTRONIC F,15333.0,0.0,,2018,5,16,DEBIT,15333.0,M1957947378
20656,1196428',2018-05-16,FDRL/NATIONAL ELECTRONIC F,14424.0,0.0,,2018,5,16,DEBIT,14424.0,C785703145
20657,1196428',2018-05-16,FDRL/NATIONAL ELECTRONIC F,13816.0,0.0,,2018,5,16,CHECK_WITHDRAWAL,13816.0,M2094125621
20658,1196428',2018-05-16,FDRL/NATIONAL ELECTRONIC F,17271.0,0.0,,2018,5,16,PAYEMENT,17271.0,M1918034019
20659,1196428',2018-05-16,FDRL/NATIONAL ELECTRONIC F,24090.0,0.0,,2018,5,16,PAYEMENT,24090.0,M745483242
20660,1196428',2018-05-16,FDRL/NATIONAL ELECTRONIC F,13244.0,0.0,,2018,5,16,PAYEMENT,13244.0,M1878714361
20661,1196428',2018-05-16,FDRL/NATIONAL ELECTRONIC F,10583.0,0.0,,2018,5,16,CHECK_WITHDRAWAL,10583.0,M203939387
20662,1196428',2018-05-16,FDRL/NATIONAL ELECTRONIC F,12101.0,0.0,,2018,5,16,PAYEMENT,12101.0,C382934088
20663,1196428',2018-05-16,FDRL/NATIONAL ELECTRONIC F,14814.0,0.0,,2018,5,16,CASH_OUT,14814.0,C158876320
20664,1196428',2018-05-16,FDRL/NATIONAL ELECTRONIC F,14316.0,0.0,,2018,5,16,CASH_OUT,14316.0,C732929236
20665,1196428',2018-05-16,FDRL/NATIONAL ELECTRONIC F,19069.0,0.0,,2018,5,16,CHECK_WITHDRAWAL,19069.0,C1554622120
20666,1196428',2018-05-16,FDRL/NATIONAL ELECTRONIC F,58443.0,0.0,,2018,5,16,CASH_OUT,58443.0,C1359484306
20667,1196428',2018-05-16,FDRL/NATIONAL ELECTRONIC F,61274.0,0.0,,2018,5,16,PAYEMENT,61274.0,C1782704802
20668,1196428',2018-05-16,FDRL/NATIONAL ELECTRONIC F,70159.0,0.0,,2018,5,16,CHECK_WITHDRAWAL,70159.0,C1609562230
20669,1196428',2018-05-16,FDRL/NATIONAL ELECTRONIC F,69693.0,0.0,,2018,5,16,CHECK_WITHDRAWAL,69693.0,C1220897602
20670,1196428',2018-05-16,FDRL/NATIONAL ELECTRONIC F,60961.0,0.0,,2018,5,16,PAYEMENT,60961.0,C1213257323
20671,1196428',2018-05-16,FDRL/NATIONAL ELECTRONIC F,82104.0,0.0,,2018,5,16,PAYEMENT,82104.0,C674913323
20672,1196428',2018-05-16,FDRL/NATIONAL ELECTRONIC F,72828.0,0.0,,2018,5,16,DEBIT,72828.0,C803116137
20673,1196428',2018-05-16,FDRL/NATIONAL ELECTRONIC F,56405.0,0.0,,2018,5,16,DEBIT,56405.0,C1450417897
20674,1196428',2018-05-16,FDRL/NATIONAL ELECTRONIC F,70548.0,0.0,,2018,5,16,PAYEMENT,70548.0,C826383690
20675,1196428',2018-05-16,FDRL/NATIONAL ELECTRONIC F,52466.0,0.0,,2018,5,16,DEBIT,52466.0,M1718920203
20676,1196428',2018-05-16,FDRL/NATIONAL ELECTRONIC F,62033.0,0.0,,2018,5,16,PAYEMENT,62033.0,M1002711260
20677,1196428',2018-05-16,FDRL/NATIONAL ELECTRONIC F,55743.0,0.0,,2018,5,16,CASH_OUT,55743.0,C545710008
20678,1196428',2018-05-16,FDRL/NATIONAL ELECTRONIC F,79803.0,0.0,,2018,5,16,CHECK_WITHDRAWAL,79803.0,C1838584624
20679,1196428',2018-05-16,FDRL/NATIONAL ELECTRONIC F,90990.0,0.0,,2018,5,16,PAYEMENT,90990.0,C1030706332
20680,1196428',2018-05-16,FDRL/NATIONAL ELECTRONIC F,59974.0,0.0,,2018,5,16,CHECK_WITHDRAWAL,59974.0,M2129060443
20681,1196428',2018-05-16,FDRL/NATIONAL ELECTRONIC F,98376.0,0.0,,2018,5,16,PAYEMENT,98376.0,C1195471589
20682,1196428',2018-05-16,FDRL/NATIONAL ELECTRONIC F,74582.0,0.0,,2018,5,16,PAYEMENT,74582.0,M1398128260
20683,1196428',2018-05-16,FDRL/NATIONAL ELECTRONIC F,89735.0,0.0,,2018,5,16,PAYEMENT,89735.0,C1856036778
20684,1196428',2018-05-16,FDRL/NATIONAL ELECTRONIC F,73200.0,0.0,,2018,5,16,CASH_OUT,73200.0,C2067546399
20685,1196428',2018-05-16,FDRL/NATIONAL ELECTRONIC F,57775.0,0.0,,2018,5,16,PAYEMENT,57775.0,C818570949
20686,1196428',2018-05-16,FDRL/NATIONAL ELECTRONIC F,68728.0,0.0,,2018,5,16,CASH_OUT,68728.0,M535878604
20687,1196428',2018-05-16,FDRL/NATIONAL ELECTRONIC F,91655.0,0.0,,2018,5,16,DEBIT,91655.0,C358945794
20688,1196428',2018-05-16,FDRL/NATIONAL ELECTRONIC F,64540.0,0.0,,2018,5,16,DEBIT,64540.0,C922511709
20689,1196428',2018-05-16,NEFT/N136180542216447/TEC,0.0,200000.0,,2018,5,16,TRANSFER,200000.0,C988138425
20690,1196428',2018-05-16,RTGS/UTIBH18136695510/PER,0.0,900000.0,,2018,5,16,CASH_IN,900000.0,C814900611
20691,1196428',2018-05-16,FDRL/NATIONAL ELECTRONIC F,3162488.77,0.0,,2018,5,16,PAYEMENT,3162488.77,C1467740330
20692,1196428',2018-05-16,CASHDEP/VIKASMARG/TP,0.0,182000.0,,2018,5,16,TRANSFER,182000.0,M858308953
20693,1196428',2018-05-16,FDRL/INTERNAL FUND TRANSFE,1000000.0,0.0,,2018,5,16,CASH_OUT,1000000.0,M1773085261
20694,1196428',2018-05-16,NEFT/IDFBH18136159916/FUN,0.0,29400.0,,2018,5,16,TRANSFER,29400.0,M472606308
20695,1196428',2018-05-16,FDRL/INTERNAL FUND TRANSFE,1000000.0,0.0,,2018,5,16,CASH_OUT,1000000.0,M51583809
20696,1196428',2018-05-16,FDRL/INTERNAL FUND TRANSFE,1000000.0,0.0,,2018,5,16,CASH_OUT,1000000.0,M1337700382
20697,1196428',2018-05-16,RTGS/PUNBH18136698436/PUN,0.0,250000.0,,2018,5,16,TRANSFER,250000.0,C1918034924
20698,1196428',2018-05-16,IMPS 813614621972 FROM SA,0.0,50000.0,,2018,5,16,CASH_IN,50000.0,M527477577
20699,1196428',2018-05-16,IMPS 813614640148 FROM SA,0.0,200000.0,,2018,5,16,TRANSFER,200000.0,M577217292
20700,1196428',2018-05-16,IMPS 813614649157 FROM SA,0.0,50000.0,,2018,5,16,TRANSFER,50000.0,C184253187
20701,1196428',2018-05-16,RTGS/DLXBH18136500554/KAD,0.0,200000.0,,2018,5,16,CHECK_CASHING,200000.0,C1778300121
20702,1196428',2018-05-16,RTGS/HDFCH18136359648/Indfor,0.0,5000000.0,,2018,5,16,TRANSFER,5000000.0,C667504652
20703,1196428',2018-05-16,TRF FROM  Indiaforensic SERVICES,0.0,15000000.0,,2018,5,16,CASH_IN,15000000.0,C638590716
20704,1196428',2018-05-16,TRF FROM  Indiaforensic SERVICES,0.0,10500000.0,,2018,5,16,CASH_IN,10500000.0,C1532153384
20705,1196428',2018-05-16,FDRL/REAL TIME GROSS SETTL,15000000.0,0.0,,2018,5,16,CHECK_WITHDRAWAL,15000000.0,C208427878
20706,1196428',2018-05-16,FDRL/REAL TIME GROSS SETTL,10000000.0,0.0,,2018,5,16,PAYEMENT,10000000.0,C1530086509
20707,1196428',2018-05-16,NEFT/SBIN318136666159/NAR,0.0,41239.0,,2018,5,16,CHECK_CASHING,41239.0,C703957828
20708,1196428',2018-05-16,FDRL/INTERNAL FUND TRANSFE,1000000.0,0.0,,2018,5,16,PAYEMENT,1000000.0,C891020651
20709,1196428',2018-05-16,Indiaforensic SERVICES INDIA PVT,0.0,213015.0,,2018,5,16,CASH_IN,213015.0,M1680032445
20710,1196428',2018-05-16,NEFT/000045632292/Indiaforensic,0.0,1100000.0,,2018,5,16,TRANSFER,1100000.0,C553264065
20711,1196428',2018-05-16,NEFT/000045631997/Indiaforensic,0.0,1100000.0,,2018,5,16,CHECK_CASHING,1100000.0,M1097298586
20712,1196428',2018-05-16,Repayment credit [7090032,0.0,27087142.41,,2018,5,16,CHECK_CASHING,27087142.41,M870026554
20713,1196428',2018-05-16,Repayment credit [7090041,0.0,52013.0,,2018,5,16,CASH_IN,52013.0,C695653925
20714,1196428',2018-05-16,Repayment credit [7090044,0.0,102218.0,,2018,5,16,CASH_IN,102218.0,M1248361658
20715,1196428',2018-05-16,Repayment credit [7090044,0.0,51249.0,,2018,5,16,TRANSFER,51249.0,C1689262323
20716,1196428',2018-05-16,TRF FROM  Indiaforensic SERVICES,0.0,6900000.0,,2018,5,16,CASH_IN,6900000.0,C1757877803
20717,1196428',2018-05-16,FDRL/INTERNAL FUND TRANSFE,0.0,2000000.0,,2018,5,16,CHECK_CASHING,2000000.0,C1849933855
20718,1196428',2018-05-16,FDRL/INTERNAL FUND TRANSFE,0.0,2000000.0,,2018,5,16,CASH_IN,2000000.0,C1753128715
20719,1196428',2018-05-16,FDRL/INTERNAL FUND TRANSFE,10000000.0,0.0,,2018,5,16,CHECK_WITHDRAWAL,10000000.0,C1527761090
20720,1196428',2018-05-16,FDRL/INTERNAL FUND TRANSFE,3000000.0,0.0,,2018,5,16,PAYEMENT,3000000.0,C1754722089
20721,1196428',2018-05-16,BEAT CSH PKP DEL GURG 643,0.0,150800.0,,2018,5,16,CASH_IN,150800.0,C1261039678
20722,1196428',2018-05-17,FDRL/NATIONAL ELECTRONIC F,2074035.0,0.0,,2018,5,17,PAYEMENT,2074035.0,C836514715
20723,1196428',2018-05-17,FDRL/INTERNAL FUND TRANSFE,500000.0,0.0,,2018,5,17,DEBIT,500000.0,C1640961071
20724,1196428',2018-05-17,FDRL/INTERNAL FUND TRANSFE,1000000.0,0.0,,2018,5,17,DEBIT,1000000.0,C1838584624
20725,1196428',2018-05-17,RTGS/UTIBH18137612159/PER,0.0,500000.0,,2018,5,17,CASH_IN,500000.0,C1209271652
20726,1196428',2018-05-17,FDRL/REAL TIME GROSS SETTL,5000000.0,0.0,,2018,5,17,DEBIT,5000000.0,C745740822
20727,1196428',2018-05-17,NEFT/N137180542960784/Indfor,0.0,3800000.0,,2018,5,17,CHECK_CASHING,3800000.0,C1401721023
20728,1196428',2018-05-17,CHQ DEP/268191/OWDEL1/SBI,0.0,11800.0,,2018,5,17,CHECK_CASHING,11800.0,C47827984
20729,1196428',2018-05-17,CHQ DEP/171707/OWDEL1/SBI,0.0,11800.0,,2018,5,17,TRANSFER,11800.0,C1849941462
20730,1196428',2018-05-17,CHQ DEP/138585/OWDEL1/COR,0.0,11800.0,,2018,5,17,CASH_IN,11800.0,C70895366
20731,1196428',2018-05-17,CHQ DEP/891176/OWDEL1/SBI,0.0,11800.0,,2018,5,17,TRANSFER,11800.0,C977993101
20732,1196428',2018-05-17,CHQ DEP/676302/OWDEL1/ORB,0.0,11800.0,,2018,5,17,CHECK_CASHING,11800.0,C2116873183
20733,1196428',2018-05-17,CHQ DEP/205545/OWDEL1/ORB,0.0,11800.0,,2018,5,17,CHECK_CASHING,11800.0,C892686452
20734,1196428',2018-05-17,CHQ DEP/12744/OWDEL1/BARB,0.0,11800.0,,2018,5,17,CASH_IN,11800.0,C1540270363
20735,1196428',2018-05-17,CHQ DEP/293/OWDEL1/ICIC/D,0.0,8260.0,,2018,5,17,TRANSFER,8260.0,C534662976
20736,1196428',2018-05-17,CHQ DEP/732027/OWDEL1/IDI,0.0,11800.0,,2018,5,17,CHECK_CASHING,11800.0,C30013970
20737,1196428',2018-05-17,CHQ DEP/644661/OWDEL1/PUN,0.0,11800.0,,2018,5,17,CASH_IN,11800.0,C1809373351
20738,1196428',2018-05-17,CHQ DEP/33821/OWDEL1/ORBC,0.0,11800.0,,2018,5,17,CHECK_CASHING,11800.0,C741431520
20739,1196428',2018-05-17,CHQ DEP/470782/OWDEL1/IOB,0.0,11800.0,,2018,5,17,TRANSFER,11800.0,C669771073
20740,1196428',2018-05-17,CHQ DEP/819497/OWDEL1/SBI,0.0,11800.0,,2018,5,17,TRANSFER,11800.0,C1915091057
20741,1196428',2018-05-17,CHQ DEP/6/OWDEL1/HDFC/CHA,0.0,11800.0,,2018,5,17,CHECK_CASHING,11800.0,C323287038
20742,1196428',2018-05-17,CHQ DEP/36/OWDEL1/HDFC/CH,0.0,11800.0,,2018,5,17,CASH_IN,11800.0,C1027992087
20743,1196428',2018-05-17,CHQ DEP/1476/OWDEL1/PSIB/,0.0,11800.0,,2018,5,17,CASH_IN,11800.0,C1435804085
20744,1196428',2018-05-17,CHQ DEP/712794/OWDEL1/IOB,0.0,11800.0,,2018,5,17,CHECK_CASHING,11800.0,C1153596299
20745,1196428',2018-05-17,CHQ DEP/141237/OWDEL1/SBI,0.0,11800.0,,2018,5,17,TRANSFER,11800.0,C1541743053
20746,1196428',2018-05-17,CHQ DEP/892683/OWDEL1/PUN,0.0,11800.0,,2018,5,17,CHECK_CASHING,11800.0,C1213257323
20747,1196428',2018-05-17,CHQ DEP/678503/OWDEL1/SBI,0.0,11800.0,,2018,5,17,TRANSFER,11800.0,C295081230
20748,1196428',2018-05-17,CHQ DEP/265433/OWDEL1/SBI,0.0,11800.0,,2018,5,17,CASH_IN,11800.0,C531511436
20749,1196428',2018-05-17,CHQ DEP/1026/OWDEL1/IOBA/,0.0,11800.0,,2018,5,17,CASH_IN,11800.0,C175291188
20750,1196428',2018-05-17,CHQ DEP/92754/OWDEL1/CORP,0.0,11800.0,,2018,5,17,CHECK_CASHING,11800.0,C1259769769
20751,1196428',2018-05-17,CHQ DEP/6/OWDEL1/PSIB/SEC,0.0,11800.0,,2018,5,17,TRANSFER,11800.0,C205300866
20752,1196428',2018-05-17,CHQ DEP/101/OWDEL1/HDFC/P,0.0,11800.0,,2018,5,17,TRANSFER,11800.0,C1297873690
20753,1196428',2018-05-17,NEFT/20539781271DC/ARTHAS,0.0,50000.0,,2018,5,17,CASH_IN,50000.0,C715819458
20754,1196428',2018-05-17,FDRL/INTERNAL FUND TRANSFE,1000000.0,0.0,,2018,5,17,CHECK_WITHDRAWAL,1000000.0,C18928637
20755,1196428',2018-05-17,RTGS/HDFCH18137490200/BAT,0.0,200000.0,,2018,5,17,CHECK_CASHING,200000.0,C1079343872
20756,1196428',2018-05-17,NEFT/PUNBH18137639298/PUN,0.0,330000.0,,2018,5,17,CASH_IN,330000.0,C99275333
20757,1196428',2018-05-17,IRTT00701814717,1317.7,0.0,,2018,5,17,DEBIT,1317.7,C1450828900
20758,1196428',2018-05-17,"Indiaforensic USA, INC./USD/1755",0.0,1181694.36,,2018,5,17,TRANSFER,1181694.36,C1339257929
20759,1196428',2018-05-17,TRF FROM  Indiaforensic SERVICES,0.0,15000000.0,,2018,5,17,TRANSFER,15000000.0,C893041125
20760,1196428',2018-05-17,TRF FROM  Indiaforensic SERVICES,0.0,9600000.0,,2018,5,17,TRANSFER,9600000.0,C380242442
20761,1196428',2018-05-17,FDRL/REAL TIME GROSS SETTL,10000000.0,0.0,,2018,5,17,PAYEMENT,10000000.0,C1220897602
20762,1196428',2018-05-17,FDRL/REAL TIME GROSS SETTL,10000000.0,0.0,,2018,5,17,DEBIT,10000000.0,C495071437
20763,1196428',2018-05-17,FDRL/INTERNAL FUND TRANSFE,1000000.0,0.0,,2018,5,17,DEBIT,1000000.0,C1753128715
20764,1196428',2018-05-17,FDRL/REAL TIME GROSS SETTL,1000000.0,0.0,,2018,5,17,DEBIT,1000000.0,C1387460501
20765,1196428',2018-05-17,FDRL/REAL TIME GROSS SETTL,1000000.0,0.0,,2018,5,17,DEBIT,1000000.0,C425987411
20766,1196428',2018-05-17,FDRL/REAL TIME GROSS SETTL,1000000.0,0.0,,2018,5,17,CHECK_WITHDRAWAL,1000000.0,C914293025
20767,1196428',2018-05-17,IMPS 813715325168 FROM AS,0.0,100175.0,,2018,5,17,TRANSFER,100175.0,C1765998352
20768,1196428',2018-05-17,RTGS/HDFCH18137527743/Indfor,0.0,7000000.0,,2018,5,17,TRANSFER,7000000.0,C1651144763
20769,1196428',2018-05-17,NEFT/N137180543340560/TEC,0.0,100000.0,,2018,5,17,CASH_IN,100000.0,C922871524
20770,1196428',2018-05-17,CHQ DEPOSIT RETURN/819497,11800.0,0.0,,2018,5,17,CASH_OUT,11800.0,C638590716
20771,1196428',2018-05-17,CHQ DEPOSIT RETURN/678503,11800.0,0.0,,2018,5,17,CHECK_WITHDRAWAL,11800.0,M1994309999
20772,1196428',2018-05-17,FDRL/INTERNAL FUND TRANSFE,1000000.0,0.0,,2018,5,17,CASH_OUT,1000000.0,C1335946878
20773,1196428',2018-05-17,Indiaforensic SERVICES INDIA PVT,0.0,179253.12,,2018,5,17,CHECK_CASHING,179253.12,M1726778819
20774,1196428',2018-05-17,NEFT/SBIN418137339546/FAT,0.0,19994.1,,2018,5,17,CHECK_CASHING,19994.1,C1619402333
20775,1196428',2018-05-17,FDRL/NATIONAL ELECTRONIC F,5000000.0,0.0,,2018,5,17,CASH_OUT,5000000.0,M622702525
20776,1196428',2018-05-17,FDRL/NATIONAL ELECTRONIC F,131495.0,0.0,,2018,5,17,CHECK_WITHDRAWAL,131495.0,C478124129
20777,1196428',2018-05-17,FDRL/NATIONAL ELECTRONIC F,110664.0,0.0,,2018,5,17,CHECK_WITHDRAWAL,110664.0,M1630310554
20778,1196428',2018-05-17,FDRL/NATIONAL ELECTRONIC F,143842.0,0.0,,2018,5,17,PAYEMENT,143842.0,C1298314970
20779,1196428',2018-05-17,FDRL/NATIONAL ELECTRONIC F,112985.0,0.0,,2018,5,17,CHECK_WITHDRAWAL,112985.0,M2010146523
20780,1196428',2018-05-17,FDRL/NATIONAL ELECTRONIC F,154073.0,0.0,,2018,5,17,CHECK_WITHDRAWAL,154073.0,C1948558238
20781,1196428',2018-05-17,FDRL/NATIONAL ELECTRONIC F,102097.0,0.0,,2018,5,17,PAYEMENT,102097.0,M278836947
20782,1196428',2018-05-17,FDRL/NATIONAL ELECTRONIC F,161920.0,0.0,,2018,5,17,PAYEMENT,161920.0,M2053690007
20783,1196428',2018-05-17,FDRL/NATIONAL ELECTRONIC F,15229.0,0.0,,2018,5,17,CHECK_WITHDRAWAL,15229.0,C1248712846
20784,1196428',2018-05-17,FDRL/NATIONAL ELECTRONIC F,18226.0,0.0,,2018,5,17,CASH_OUT,18226.0,C2034460325
20785,1196428',2018-05-17,FDRL/NATIONAL ELECTRONIC F,12397.0,0.0,,2018,5,17,PAYEMENT,12397.0,M549165100
20786,1196428',2018-05-17,FDRL/NATIONAL ELECTRONIC F,10763.0,0.0,,2018,5,17,CHECK_WITHDRAWAL,10763.0,M758526545
20787,1196428',2018-05-17,FDRL/NATIONAL ELECTRONIC F,7963.0,0.0,,2018,5,17,DEBIT,7963.0,M367379500
20788,1196428',2018-05-17,FDRL/NATIONAL ELECTRONIC F,5646.0,0.0,,2018,5,17,CHECK_WITHDRAWAL,5646.0,M1771766172
20789,1196428',2018-05-17,FDRL/NATIONAL ELECTRONIC F,8044.0,0.0,,2018,5,17,DEBIT,8044.0,C952219856
20790,1196428',2018-05-17,FDRL/NATIONAL ELECTRONIC F,12505.0,0.0,,2018,5,17,CHECK_WITHDRAWAL,12505.0,M1290410413
20791,1196428',2018-05-17,FDRL/NATIONAL ELECTRONIC F,14699.0,0.0,,2018,5,17,PAYEMENT,14699.0,C114720259
20792,1196428',2018-05-17,FDRL/NATIONAL ELECTRONIC F,12397.0,0.0,,2018,5,17,CASH_OUT,12397.0,C1166654566
20793,1196428',2018-05-17,FDRL/NATIONAL ELECTRONIC F,13719.0,0.0,,2018,5,17,DEBIT,13719.0,C1860513229
20794,1196428',2018-05-17,FDRL/NATIONAL ELECTRONIC F,22000.0,0.0,,2018,5,17,CASH_OUT,22000.0,M1068910562
20795,1196428',2018-05-17,FDRL/NATIONAL ELECTRONIC F,2000.0,0.0,,2018,5,17,PAYEMENT,2000.0,M1836459483
20796,1196428',2018-05-17,FDRL/NATIONAL ELECTRONIC F,2000.0,0.0,,2018,5,17,CASH_OUT,2000.0,M1957447701
20797,1196428',2018-05-17,FDRL/NATIONAL ELECTRONIC F,4000.0,0.0,,2018,5,17,PAYEMENT,4000.0,C1360913629
20798,1196428',2018-05-17,FDRL/NATIONAL ELECTRONIC F,29228.0,0.0,,2018,5,17,DEBIT,29228.0,M1571819088
20799,1196428',2018-05-17,FDRL/NATIONAL ELECTRONIC F,3750.0,0.0,,2018,5,17,CASH_OUT,3750.0,M408855261
20800,1196428',2018-05-17,FDRL/NATIONAL ELECTRONIC F,2000.0,0.0,,2018,5,17,CHECK_WITHDRAWAL,2000.0,M1866310330
20801,1196428',2018-05-17,FDRL/NATIONAL ELECTRONIC F,12785.0,0.0,,2018,5,17,CASH_OUT,12785.0,M427925708
20802,1196428',2018-05-17,IMPS 813718368002 FROM AS,0.0,60160.0,,2018,5,17,TRANSFER,60160.0,M1055749476
20803,1196428',2018-05-17,NEFT/000045701480/Indiaforensic,0.0,1200000.0,,2018,5,17,CHECK_CASHING,1200000.0,M2079141569
20804,1196428',2018-05-17,FDRL/INTERNAL FUND TRANSFE,500000.0,0.0,,2018,5,17,PAYEMENT,500000.0,M738046956
20805,1196428',2018-05-17,TRF FROM  Indiaforensic SERVICES,0.0,5000000.0,,2018,5,17,TRANSFER,5000000.0,M624408149
20806,1196428',2018-05-17,TRF FROM  Indiaforensic SERVICES,0.0,500000.0,,2018,5,17,CHECK_CASHING,500000.0,M1754185510
20807,1196428',2018-05-17,FDRL/INTERNAL FUND TRANSFE,5000000.0,0.0,,2018,5,17,PAYEMENT,5000000.0,M931188207
20808,1196428',2018-05-17,FDRL/INTERNAL FUND TRANSFE,5000000.0,0.0,,2018,5,17,PAYEMENT,5000000.0,M1423975840
20809,1196428',2018-05-17,FDRL/INTERNAL FUND TRANSFE,1000000.0,0.0,,2018,5,17,CHECK_WITHDRAWAL,1000000.0,M553389038
20810,1196428',2018-05-17,FDRL/INTERNAL FUND TRANSFE,500000.0,0.0,,2018,5,17,PAYEMENT,500000.0,M1792040881
20811,1196428',2018-05-17,FDRL/INTERNAL FUND TRANSFE,1000000.0,0.0,,2018,5,17,CASH_OUT,1000000.0,M697199104
20812,1196428',2018-05-17,BEAT CSH PKP DEL GURG 643,0.0,91500.0,,2018,5,17,CASH_IN,91500.0,M1006569781
20813,1196428',2018-05-17,CHQ DEPOSIT RETURN/819497,100.0,0.0,,2018,5,17,CHECK_WITHDRAWAL,100.0,C945960989
20814,1196428',2018-05-17,CHQ DEPOSIT RETURN/819497,18.0,0.0,,2018,5,17,DEBIT,18.0,M1629025354
20815,1196428',2018-05-17,CHQ DEPOSIT RETURN/678503,100.0,0.0,,2018,5,17,PAYEMENT,100.0,C175382361
20816,1196428',2018-05-17,CHQ DEPOSIT RETURN/678503,18.0,0.0,,2018,5,17,CHECK_WITHDRAWAL,18.0,M1560961265
20817,1196428',2018-05-18,NEFT/SBIN418138658917/NAR,0.0,41273.0,,2018,5,18,CHECK_CASHING,41273.0,C666410506
20818,1196428',2018-05-18,FDRL/NATIONAL ELECTRONIC F,1331189.0,0.0,,2018,5,18,CASH_OUT,1331189.0,C2020152163
20819,1196428',2018-05-18,NEFT/FDRLH18138559068/NEE,0.0,20213.0,,2018,5,18,CHECK_CASHING,20213.0,M715090532
20820,1196428',2018-05-18,FDRL/INTERNAL FUND TRANSFE,1000000.0,0.0,,2018,5,18,CASH_OUT,1000000.0,C657255537
20821,1196428',2018-05-18,FDRL/REAL TIME GROSS SETTL,5000000.0,0.0,,2018,5,18,DEBIT,5000000.0,C921866695
20822,1196428',2018-05-18,CHQ DEP/37799/OWDEL1/ORBC,0.0,11800.0,,2018,5,18,CASH_IN,11800.0,C627675433
20823,1196428',2018-05-18,CHQ DEP/520819/OWDEL1/SBI,0.0,11800.0,,2018,5,18,TRANSFER,11800.0,C36856762
20824,1196428',2018-05-18,CHQ DEP/492950/OWDEL1/CNR,0.0,11800.0,,2018,5,18,CHECK_CASHING,11800.0,M945656824
20825,1196428',2018-05-18,CHQ DEP/223831/OWDEL1/SBI,0.0,11800.0,,2018,5,18,CHECK_CASHING,11800.0,M85439519
20826,1196428',2018-05-18,CHQ DEP/249912/OWDEL1/PUN,0.0,11800.0,,2018,5,18,CASH_IN,11800.0,M84803524
20827,1196428',2018-05-18,CHQ DEP/877909/OWDEL1/PUN,0.0,11800.0,,2018,5,18,CHECK_CASHING,11800.0,M993121487
20828,1196428',2018-05-18,NEFT/IT36701805182739/FIX,0.0,140000.0,,2018,5,18,CHECK_CASHING,140000.0,M1536939082
20829,1196428',2018-05-18,NEFT/SBIN418138957355/MS,0.0,70000.0,,2018,5,18,TRANSFER,70000.0,M478824435
20830,1196428',2018-05-18,NEFT/AXISP18138045937/ACC,0.0,3000000.0,,2018,5,18,TRANSFER,3000000.0,M1063385584
20831,1196428',2018-05-18,TRF TO  Indiaforensic SERVICES I,1690492.0,0.0,,2018,5,18,CASH_OUT,1690492.0,M454404713
20832,1196428',2018-05-18,RTGS/DLXBH18138500522/KAD,0.0,200000.0,,2018,5,18,CASH_IN,200000.0,M2065549932
20833,1196428',2018-05-18,TRF FROM  Indiaforensic SERVICES,0.0,15000000.0,,2018,5,18,CASH_IN,15000000.0,M1853348326
20834,1196428',2018-05-18,TRF FROM  Indiaforensic SERVICES,0.0,8500000.0,,2018,5,18,CASH_IN,8500000.0,M685288551
20835,1196428',2018-05-18,FDRL/REAL TIME GROSS SETTL,15000000.0,0.0,,2018,5,18,PAYEMENT,15000000.0,M459758433
20836,1196428',2018-05-18,FDRL/REAL TIME GROSS SETTL,15000000.0,0.0,,2018,5,18,DEBIT,15000000.0,M1374506047
20837,1196428',2018-05-18,FDRL/REAL TIME GROSS SETTL,10000000.0,0.0,,2018,5,18,PAYEMENT,10000000.0,M1129597197
20838,1196428',2018-05-18,RTGS/PUNBH18138745498/PUN,0.0,400000.0,,2018,5,18,TRANSFER,400000.0,M522012686
20839,1196428',2018-05-18,CHQ DEPOSIT RETURN/223831,11800.0,0.0,,2018,5,18,DEBIT,11800.0,M1372975160
20840,1196428',2018-05-18,Indiaforensic SERVICES INDIA PVT,0.0,218875.0,,2018,5,18,TRANSFER,218875.0,C499085946
20841,1196428',2018-05-18,IMPS 813816376888 FROM AS,0.0,135135.0,,2018,5,18,CASH_IN,135135.0,C1915089150
20842,1196428',2018-05-18,NEFT/N138180544177644/Indfor,0.0,6800000.0,,2018,5,18,CHECK_CASHING,6800000.0,M1538046991
20843,1196428',2018-05-18,FDRL/NATIONAL ELECTRONIC F,2000000.0,0.0,,2018,5,18,DEBIT,2000000.0,M1832775256
20844,1196428',2018-05-18,FDRL/NATIONAL ELECTRONIC F,2000000.0,0.0,,2018,5,18,PAYEMENT,2000000.0,C824197891
20845,1196428',2018-05-18,FDRL/NATIONAL ELECTRONIC F,3000000.0,0.0,,2018,5,18,PAYEMENT,3000000.0,C1262822392
20846,1196428',2018-05-18,FDRL/NATIONAL ELECTRONIC F,3000000.0,0.0,,2018,5,18,CASH_OUT,3000000.0,C1173124659
20847,1196428',2018-05-18,NEFT/SBIN518138272710/TAR,0.0,1000.0,,2018,5,18,TRANSFER,1000.0,C2083562754
20848,1196428',2018-05-18,NEFT/SBIN518138308402/NAR,0.0,51473.0,,2018,5,18,CASH_IN,51473.0,C420561530
20849,1196428',2018-05-18,NEFT/N138180544347447/TEC,0.0,200000.0,,2018,5,18,CASH_IN,200000.0,C1486249495
20850,1196428',2018-05-18,IMPS 813818312215 FROM SA,0.0,100000.0,,2018,5,18,CASH_IN,100000.0,C681419196
20851,1196428',2018-05-18,NEFT/000045773345/Indiaforensic,0.0,800000.0,,2018,5,18,CASH_IN,800000.0,C1575675375
20852,1196428',2018-05-18,NEFT/000045773327/Indiaforensic,0.0,1900000.0,,2018,5,18,CHECK_CASHING,1900000.0,C1410669831
20853,1196428',2018-05-18,FDRL/INTERNAL FUND TRANSFE,100000.0,0.0,,2018,5,18,DEBIT,100000.0,C699679818
20854,1196428',2018-05-18,FDRL/INTERNAL FUND TRANSFE,100000.0,0.0,,2018,5,18,DEBIT,100000.0,C1076835071
20855,1196428',2018-05-18,FDRL/INTERNAL FUND TRANSFE,200000.0,0.0,,2018,5,18,CHECK_WITHDRAWAL,200000.0,C635371680
20856,1196428',2018-05-18,FDRL/INTERNAL FUND TRANSFE,200000.0,0.0,,2018,5,18,PAYEMENT,200000.0,C517653428
20857,1196428',2018-05-18,FDRL/INTERNAL FUND TRANSFE,200000.0,0.0,,2018,5,18,PAYEMENT,200000.0,C976133979
20858,1196428',2018-05-18,FDRL/INTERNAL FUND TRANSFE,200000.0,0.0,,2018,5,18,PAYEMENT,200000.0,C381605910
20859,1196428',2018-05-18,FDRL/INTERNAL FUND TRANSFE,200000.0,0.0,,2018,5,18,CHECK_WITHDRAWAL,200000.0,C1816757085
20860,1196428',2018-05-18,FDRL/INTERNAL FUND TRANSFE,200000.0,0.0,,2018,5,18,CHECK_WITHDRAWAL,200000.0,C1761291320
20861,1196428',2018-05-18,FDRL/INTERNAL FUND TRANSFE,300000.0,0.0,,2018,5,18,CASH_OUT,300000.0,C152254957
20862,1196428',2018-05-18,FDRL/INTERNAL FUND TRANSFE,200000.0,0.0,,2018,5,18,CASH_OUT,200000.0,C283923651
20863,1196428',2018-05-18,FDRL/INTERNAL FUND TRANSFE,200000.0,0.0,,2018,5,18,CASH_OUT,200000.0,C1262016786
20864,1196428',2018-05-18,FDRL/INTERNAL FUND TRANSFE,500000.0,0.0,,2018,5,18,DEBIT,500000.0,C599726537
20865,1196428',2018-05-18,TRF FROM  Indiaforensic SERVICES,0.0,6500000.0,,2018,5,18,CASH_IN,6500000.0,C395114097
20866,1196428',2018-05-18,FDRL/INTERNAL FUND TRANSFE,7000000.0,0.0,,2018,5,18,PAYEMENT,7000000.0,C1327282178
20867,1196428',2018-05-18,BEAT CSH PKP DEL GURG 643,0.0,182500.0,,2018,5,18,CHECK_CASHING,182500.0,C1089177065
20868,1196428',2018-05-18,CHQ DEPOSIT RETURN/223831,100.0,0.0,,2018,5,18,DEBIT,100.0,C81095635
20869,1196428',2018-05-18,CHQ DEPOSIT RETURN/223831,18.0,0.0,,2018,5,18,DEBIT,18.0,C2104652067
20870,1196428',2018-05-19,RTGS/SBINH18139007425/TAR,0.0,240000.0,,2018,5,19,CASH_IN,240000.0,C1383454473
20871,1196428',2018-05-19,RTGS/SBINH18139019792/Indfor,0.0,2400000.0,,2018,5,19,CASH_IN,2400000.0,C1359484306
20872,1196428',2018-05-19,FDRL/NATIONAL ELECTRONIC F,2730147.0,0.0,,2018,5,19,PAYEMENT,2730147.0,C534662976
20873,1196428',2018-05-19,NEFT/AXISP18139027360/ACC,0.0,10000000.0,,2018,5,19,CASH_IN,10000000.0,C251966229
20874,1196428',2018-05-19,FDRL/REAL TIME GROSS SETTL,10000000.0,0.0,,2018,5,19,CHECK_WITHDRAWAL,10000000.0,C278407008
20875,1196428',2018-05-19,IMPS 813914794948 FROM SA,0.0,200000.0,,2018,5,19,CASH_IN,200000.0,C1954751748
20876,1196428',2018-05-19,RTGS/PUNBH18139763104/PUN,0.0,250000.0,,2018,5,19,TRANSFER,250000.0,C570607919
20877,1196428',2018-05-19,TRF FROM  Indiaforensic SERVICES,0.0,10000000.0,,2018,5,19,CASH_IN,10000000.0,C1725025770
20878,1196428',2018-05-19,TRF FROM  Indiaforensic SERVICES,0.0,10000000.0,,2018,5,19,TRANSFER,10000000.0,C1237095816
20879,1196428',2018-05-19,FDRL/REAL TIME GROSS SETTL,10000000.0,0.0,,2018,5,19,PAYEMENT,10000000.0,C256902273
20880,1196428',2018-05-19,FDRL/REAL TIME GROSS SETTL,10000000.0,0.0,,2018,5,19,CASH_OUT,10000000.0,C1531333864
20881,1196428',2018-05-19,NEFT/N139180544760885/BAT,0.0,100000.0,,2018,5,19,CHECK_CASHING,100000.0,C1871196571
20882,1196428',2018-05-19,RTGS/HDFCH18139817863/Indfor,0.0,5000000.0,,2018,5,19,TRANSFER,5000000.0,C1818730877
20883,1196428',2018-05-19,FDRL/REAL TIME GROSS SETTL,5000000.0,0.0,,2018,5,19,PAYEMENT,5000000.0,C1255024717
20884,1196428',2018-05-19,FDRL/INTERNAL FUND TRANSFE,0.0,2000000.0,,2018,5,19,CHECK_CASHING,2000000.0,C1050991813
20885,1196428',2018-05-19,NEFT/SBIN618139064047/NAR,0.0,52875.0,,2018,5,19,CASH_IN,52875.0,C1545688642
20886,1196428',2018-05-19,NEFT/SBIN618139045043/NAR,0.0,547.0,,2018,5,19,CHECK_CASHING,547.0,C1888439681
20887,1196428',2018-05-19,NEFT/000045830425/Indiaforensic,0.0,500000.0,,2018,5,19,CASH_IN,500000.0,C1647809929
20888,1196428',2018-05-19,NEFT/N139180544795446/Indfor,0.0,500000.0,,2018,5,19,CHECK_CASHING,500000.0,C1734719138
20889,1196428',2018-05-19,NEFT/000045830603/Indiaforensic,0.0,500000.0,,2018,5,19,CHECK_CASHING,500000.0,C1066176965
20890,1196428',2018-05-19,TRF FROM  Indiaforensic SERVICES,0.0,500000.0,,2018,5,19,TRANSFER,500000.0,C405881980
20891,1196428',2018-05-19,TRF FROM  Indiaforensic SERVICES,0.0,3000000.0,,2018,5,19,CASH_IN,3000000.0,C1902797635
20892,1196428',2018-05-19,FDRL/INTERNAL FUND TRANSFE,500000.0,0.0,,2018,5,19,PAYEMENT,500000.0,C1436136891
20893,1196428',2018-05-19,FDRL/INTERNAL FUND TRANSFE,7000000.0,0.0,,2018,5,19,DEBIT,7000000.0,C966704622
20894,1196428',2018-05-19,BEAT CSH PKP DEL UDYOG 65,0.0,103500.0,,2018,5,19,TRANSFER,103500.0,C265845794
20895,1196428',2018-05-21,RTGS/UTIBH18141630408/PER,0.0,700000.0,,2018,5,21,CASH_IN,700000.0,C607702142
20896,1196428',2018-05-21,NEFT/SBIN618141204570/NAR,0.0,52774.0,,2018,5,21,TRANSFER,52774.0,C1348937989
20897,1196428',2018-05-21,NEFT/PUNBH18141163244/BAL,0.0,25000.0,,2018,5,21,CHECK_CASHING,25000.0,C1141049797
20898,1196428',2018-05-21,RTGS/SBINH18141003936/Indfor,0.0,3500000.0,,2018,5,21,TRANSFER,3500000.0,C900425684
20899,1196428',2018-05-21,FDRL/NATIONAL ELECTRONIC F,2497272.0,0.0,,2018,5,21,CHECK_WITHDRAWAL,2497272.0,M933161038
20900,1196428',2018-05-21,FDRL/NATIONAL ELECTRONIC F,2139224.0,0.0,,2018,5,21,CHECK_WITHDRAWAL,2139224.0,C1242586395
20901,1196428',2018-05-21,RTGS/SBINH18141023943/Indfor,0.0,2000000.0,,2018,5,21,TRANSFER,2000000.0,C1150936132
20902,1196428',2018-05-21,FDRL/INTERNAL FUND TRANSFE,500000.0,0.0,,2018,5,21,DEBIT,500000.0,M2139436356
20903,1196428',2018-05-21,CHQ DEP/328513/OWDEL1/PUN,0.0,11800.0,,2018,5,21,CHECK_CASHING,11800.0,M1340171179
20904,1196428',2018-05-21,CHQ DEP/962516/OWDEL1/SBI,0.0,11800.0,,2018,5,21,TRANSFER,11800.0,C1778801068
20905,1196428',2018-05-21,CHQ DEP/335/OWDEL1/ALLA/A,0.0,11800.0,,2018,5,21,CASH_IN,11800.0,C1570256460
20906,1196428',2018-05-21,CHQ DEP/27/OWDEL1/KKBK/NE,0.0,11800.0,,2018,5,21,CHECK_CASHING,11800.0,C423580937
20907,1196428',2018-05-21,CHQ DEP/217574/OWDEL1/SBI,0.0,11800.0,,2018,5,21,CASH_IN,11800.0,C802982068
20908,1196428',2018-05-21,CHQ DEP/72/OWDEL1/HDFC/,0.0,11800.0,,2018,5,21,CHECK_CASHING,11800.0,C97730845
20909,1196428',2018-05-21,CHQ DEP/875292/OWDEL1/SBI,0.0,11800.0,,2018,5,21,TRANSFER,11800.0,C1754722089
20910,1196428',2018-05-21,CHQ DEP/135941/OWDEL1/CBI,0.0,11800.0,,2018,5,21,CASH_IN,11800.0,C1787868648
20911,1196428',2018-05-21,CHQ DEP/143/OWDEL1/HDFC/J,0.0,11800.0,,2018,5,21,TRANSFER,11800.0,C131837504
20912,1196428',2018-05-21,CHQ DEP/902281/OWDEL1/SBI,0.0,11800.0,,2018,5,21,CASH_IN,11800.0,C1379031360
20913,1196428',2018-05-21,CHQ DEP/956516/OWDEL1/SBI,0.0,11800.0,,2018,5,21,CHECK_CASHING,11800.0,C1116292004
20914,1196428',2018-05-21,CHQ DEP/325478/OWDEL1/PUN,0.0,11800.0,,2018,5,21,CASH_IN,11800.0,C1034584766
20915,1196428',2018-05-21,CHQ DEP/22/OWDEL1/ESFB/,0.0,11800.0,,2018,5,21,CHECK_CASHING,11800.0,C1937294500
20916,1196428',2018-05-21,CHQ DEP/513953/OWDEL1/SBI,0.0,11800.0,,2018,5,21,CASH_IN,11800.0,C1674899618
20917,1196428',2018-05-21,CHQ DEP/41817/OWDEL1/CORP,0.0,11800.0,,2018,5,21,CASH_IN,11800.0,C732929122
20918,1196428',2018-05-21,CHQ DEP/833769/OWDEL1/ICI,0.0,11800.0,,2018,5,21,CHECK_CASHING,11800.0,C1354725727
20919,1196428',2018-05-21,CHQ DEP/381375/OWDEL1/SBI,0.0,11800.0,,2018,5,21,TRANSFER,11800.0,C374625527
20920,1196428',2018-05-21,CHQ DEP/124/OWDEL1/UCBA/A,0.0,11800.0,,2018,5,21,CHECK_CASHING,11800.0,C265845794
20921,1196428',2018-05-21,FDRL/INTERNAL FUND TRANSFE,500000.0,0.0,,2018,5,21,DEBIT,500000.0,C456538529
20922,1196428',2018-05-21,FDRL/INTERNAL FUND TRANSFE,500000.0,0.0,,2018,5,21,CASH_OUT,500000.0,C1805683209
20923,1196428',2018-05-21,FDRL/INTERNAL FUND TRANSFE,500000.0,0.0,,2018,5,21,DEBIT,500000.0,C1046160944
20924,1196428',2018-05-21,RTGS/PUNBH18141784926/PUN,0.0,350000.0,,2018,5,21,CHECK_CASHING,350000.0,C1046102247
20925,1196428',2018-05-21,NEFT/N141180545473924/BAT,0.0,100000.0,,2018,5,21,CASH_IN,100000.0,C63475121
20926,1196428',2018-05-21,TRF FROM  Indiaforensic SERVICES,0.0,1000000.0,,2018,5,21,CASH_IN,1000000.0,C977993101
20927,1196428',2018-05-21,Indiaforensic SERVICES INDIA PVT,0.0,453987.0,,2018,5,21,TRANSFER,453987.0,C2078250226
20928,1196428',2018-05-21,NEFT/SBIN618141632487/MS,0.0,25000.0,,2018,5,21,CASH_IN,25000.0,M666447136
20929,1196428',2018-05-21,TRF FROM  Indiaforensic SERVICES,0.0,15000000.0,,2018,5,21,TRANSFER,15000000.0,M2061351865
20930,1196428',2018-05-21,TRF FROM  Indiaforensic SERVICES,0.0,5000000.0,,2018,5,21,CASH_IN,5000000.0,M155877566
20931,1196428',2018-05-21,TRF FROM  Indiaforensic SERVICES,0.0,15000000.0,,2018,5,21,TRANSFER,15000000.0,M290137005
20932,1196428',2018-05-21,FDRL/NATIONAL ELECTRONIC F,15000000.0,0.0,,2018,5,21,PAYEMENT,15000000.0,M149119776
20933,1196428',2018-05-21,FDRL/NATIONAL ELECTRONIC F,15000000.0,0.0,,2018,5,21,DEBIT,15000000.0,M616598365
20934,1196428',2018-05-21,CHQ DEPOSIT RETURN/217574,11800.0,0.0,,2018,5,21,CHECK_WITHDRAWAL,11800.0,M1756732651
20935,1196428',2018-05-21,CHQ DEPOSIT RETURN/833769,11800.0,0.0,,2018,5,21,PAYEMENT,11800.0,M1351674621
20936,1196428',2018-05-21,FDRL/NATIONAL ELECTRONIC F,16926.0,0.0,,2018,5,21,DEBIT,16926.0,M261584881
20937,1196428',2018-05-21,FDRL/NATIONAL ELECTRONIC F,24031.0,0.0,,2018,5,21,DEBIT,24031.0,M2019778425
20938,1196428',2018-05-21,FDRL/INTERNAL FUND TRANSFE,500000.0,0.0,,2018,5,21,DEBIT,500000.0,M142597329
20939,1196428',2018-05-21,FDRL/INTERNAL FUND TRANSFE,500000.0,0.0,,2018,5,21,DEBIT,500000.0,M1497272943
20940,1196428',2018-05-21,"Indiaforensic USA, INC./USD/1274",0.0,863668.96,,2018,5,21,CHECK_CASHING,863668.96,M192204329
20941,1196428',2018-05-21,IRTT00701815023,1162.3,0.0,,2018,5,21,PAYEMENT,1162.3,M964217830
20942,1196428',2018-05-21,IMPS 814117307188 FROM AS,0.0,140995.0,,2018,5,21,CHECK_CASHING,140995.0,M831410953
20943,1196428',2018-05-21,NEFT/000045902247/Indiaforensic,0.0,1000000.0,,2018,5,21,CHECK_CASHING,1000000.0,M503936013
20944,1196428',2018-05-21,NEFT/000045901873/Indiaforensic,0.0,2000000.0,,2018,5,21,TRANSFER,2000000.0,M2001273004
20945,1196428',2018-05-21,PROCESSING_FEE_ODGEN,1200000.0,0.0,,2018,5,21,CASH_OUT,1200000.0,C2127862399
20946,1196428',2018-05-21,GOODS AND SERVICES TAX,216000.0,0.0,,2018,5,21,CASH_OUT,216000.0,C1976064650
20947,1196428',2018-05-21,TRF FROM  Indiaforensic SERVICES,0.0,8800000.0,,2018,5,21,TRANSFER,8800000.0,M634076256
20948,1196428',2018-05-21,BEAT CSH PKP DEL UDYOG 64,0.0,232500.0,,2018,5,21,CASH_IN,232500.0,M355765139
20949,1196428',2018-05-21,TELEPOWER COMMUNICATION C,1542450.0,0.0,,2018,5,21,CASH_OUT,1542450.0,M857598000
20950,1196428',2018-05-21,IMAR00701802997,3952.75,0.0,,2018,5,21,CHECK_WITHDRAWAL,3952.75,C1897050650
20951,1196428',2018-05-21,FDRL/INTERNAL FUND TRANSFE,500000.0,0.0,,2018,5,21,DEBIT,500000.0,C1566158153
20952,1196428',2018-05-21,FDRL/INTERNAL FUND TRANSFE,5000000.0,0.0,,2018,5,21,CASH_OUT,5000000.0,C549277650
20953,1196428',2018-05-21,FDRL/INTERNAL FUND TRANSFE,5000000.0,0.0,,2018,5,21,CASH_OUT,5000000.0,C294252921
20954,1196428',2018-05-21,FDRL/INTERNAL FUND TRANSFE,500000.0,0.0,,2018,5,21,CASH_OUT,500000.0,C507538622
20955,1196428',2018-05-21,FDRL/INTERNAL FUND TRANSFE,5000000.0,0.0,,2018,5,21,PAYEMENT,5000000.0,M1284176569
20956,1196428',2018-05-21,CHQ DEPOSIT RETURN/217574,100.0,0.0,,2018,5,21,PAYEMENT,100.0,M442490030
20957,1196428',2018-05-21,CHQ DEPOSIT RETURN/217574,18.0,0.0,,2018,5,21,CHECK_WITHDRAWAL,18.0,C1997859171
20958,1196428',2018-05-21,CHQ DEPOSIT RETURN/833769,100.0,0.0,,2018,5,21,CASH_OUT,100.0,M1604372534
20959,1196428',2018-05-21,CHQ DEPOSIT RETURN/833769,18.0,0.0,,2018,5,21,CHECK_WITHDRAWAL,18.0,M464947584
20960,1196428',2018-05-22,NEFT/N142180545774885/TEC,0.0,200000.0,,2018,5,22,TRANSFER,200000.0,M1517328234
20961,1196428',2018-05-22,RTGS/UTIBH18142637741/PER,0.0,900000.0,,2018,5,22,TRANSFER,900000.0,M943225029
20962,1196428',2018-05-22,RTGS/SBINH18142005756/Indfor,0.0,1000000.0,,2018,5,22,TRANSFER,1000000.0,M626303036
20963,1196428',2018-05-22,TRF FROM  Indiaforensic SERVICES,0.0,4000000.0,,2018,5,22,TRANSFER,4000000.0,C2029310301
20964,1196428',2018-05-22,FDRL/NATIONAL ELECTRONIC F,2037481.0,0.0,,2018,5,22,DEBIT,2037481.0,M1470236097
20965,1196428',2018-05-22,NEFT/SBIN718142021975/TAR,0.0,147000.0,,2018,5,22,TRANSFER,147000.0,C1034382650
20966,1196428',2018-05-22,NEFT/N142180545957288/JUN,0.0,100000.0,,2018,5,22,CASH_IN,100000.0,C1979563377
20967,1196428',2018-05-22,RTGS/HDFCH18142131035/GIL,0.0,301000.0,,2018,5,22,CHECK_CASHING,301000.0,C476402209
20968,1196428',2018-05-22,FDRL/NATIONAL ELECTRONIC F,2000000.0,0.0,,2018,5,22,PAYEMENT,2000000.0,C281656657
20969,1196428',2018-05-22,FDRL/NATIONAL ELECTRONIC F,2000000.0,0.0,,2018,5,22,PAYEMENT,2000000.0,M1169007312
20970,1196428',2018-05-22,CHQ DEP/906680/OWDEL2/PUN,0.0,11800.0,,2018,5,22,TRANSFER,11800.0,M1592919391
20971,1196428',2018-05-22,CHQ DEP/509474/OWDEL2/SBI,0.0,11800.0,,2018,5,22,CASH_IN,11800.0,C256902273
20972,1196428',2018-05-22,TRF FROM  Indiaforensic SERVICES,0.0,10000000.0,,2018,5,22,TRANSFER,10000000.0,C1406749291
20973,1196428',2018-05-22,TRF FROM  Indiaforensic SERVICES,0.0,10000000.0,,2018,5,22,TRANSFER,10000000.0,M1973701338
20974,1196428',2018-05-22,TRF FROM  Indiaforensic SERVICES,0.0,1000000.0,,2018,5,22,CHECK_CASHING,1000000.0,M1096930296
20975,1196428',2018-05-22,RTGS/ICICH18142602997/Indfor,0.0,4900000.0,,2018,5,22,CHECK_CASHING,4900000.0,M1042171045
20976,1196428',2018-05-22,FDRL/REAL TIME GROSS SETTL,10000000.0,0.0,,2018,5,22,PAYEMENT,10000000.0,C2131324576
20977,1196428',2018-05-22,FDRL/REAL TIME GROSS SETTL,15000000.0,0.0,,2018,5,22,DEBIT,15000000.0,M356924203
20978,1196428',2018-05-22,FDRL/REAL TIME GROSS SETTL,1000000.0,0.0,,2018,5,22,CASH_OUT,1000000.0,C1495761010
20979,1196428',2018-05-22,RTGS/HDFCH18142105680/Indfor,0.0,5700000.0,,2018,5,22,CHECK_CASHING,5700000.0,C1111747867
20980,1196428',2018-05-22,NEFT/P18052297873198/KADU,0.0,100000.0,,2018,5,22,TRANSFER,100000.0,C1609562230
20981,1196428',2018-05-22,RTGS/PUNBH18142804301/PUN,0.0,300000.0,,2018,5,22,CASH_IN,300000.0,M1869580438
20982,1196428',2018-05-22,NEFT/SBIN718142373847/MS,0.0,25000.0,,2018,5,22,TRANSFER,25000.0,M1995250173
20983,1196428',2018-05-22,IMPS 814216333499 FROM AS,0.0,145145.0,,2018,5,22,CHECK_CASHING,145145.0,M804480320
20984,1196428',2018-05-22,IMPS 814216334623 FROM AS,0.0,125105.0,,2018,5,22,TRANSFER,125105.0,M1882757289
20985,1196428',2018-05-22,FDRL/INTERNAL FUND TRANSFE,0.0,2000000.0,,2018,5,22,CASH_IN,2000000.0,M603070790
20986,1196428',2018-05-22,NEFT/SBIN718142497598/NAR,0.0,53178.0,,2018,5,22,CHECK_CASHING,53178.0,M1530977451
20987,1196428',2018-05-22,NEFT/000045973931/Indiaforensic,0.0,1500000.0,,2018,5,22,TRANSFER,1500000.0,M33707010
20988,1196428',2018-05-22,TRF FROM  Indiaforensic SERVICES,0.0,3000000.0,,2018,5,22,CHECK_CASHING,3000000.0,M2142436835
20989,1196428',2018-05-22,TRF FROM  Indiaforensic SERVICES,0.0,3000000.0,,2018,5,22,CHECK_CASHING,3000000.0,M451370126
20990,1196428',2018-05-22,TRF FROM  Indiaforensic SERVICES,0.0,500000.0,,2018,5,22,CHECK_CASHING,500000.0,M103289970
20991,1196428',2018-05-22,FDRL/INTERNAL FUND TRANSFE,7000000.0,0.0,,2018,5,22,CASH_OUT,7000000.0,M19205532
20992,1196428',2018-05-22,FDRL/INTERNAL FUND TRANSFE,8000000.0,0.0,,2018,5,22,CHECK_WITHDRAWAL,8000000.0,M1148918710
20993,1196428',2018-05-22,FDRL/INTERNAL FUND TRANSFE,500000.0,0.0,,2018,5,22,CASH_OUT,500000.0,M2109595035
20994,1196428',2018-05-22,FDRL/INTERNAL FUND TRANSFE,500000.0,0.0,,2018,5,22,CHECK_WITHDRAWAL,500000.0,M1403253872
20995,1196428',2018-05-22,FDRL/INTERNAL FUND TRANSFE,500000.0,0.0,,2018,5,22,DEBIT,500000.0,M2140670619
20996,1196428',2018-05-22,FDRL/INTERNAL FUND TRANSFE,500000.0,0.0,,2018,5,22,CHECK_WITHDRAWAL,500000.0,M868840338
20997,1196428',2018-05-22,BEAT CSH PKP DEL UDYOG 64,0.0,88500.0,,2018,5,22,TRANSFER,88500.0,M851582889
20998,1196428',2018-05-23,RTGS/UTIBH18143644461/PER,0.0,300000.0,,2018,5,23,CHECK_CASHING,300000.0,C1060563153
20999,1196428',2018-05-23,NEFT/SBIN718143683258/NAR,0.0,54273.0,,2018,5,23,CHECK_CASHING,54273.0,C1517552713
21000,1196428',2018-05-23,RTGS/SBINH18143003371/Indfor,0.0,2800000.0,,2018,5,23,TRANSFER,2800000.0,M987047626
21001,1196428',2018-05-23,FDRL/NATIONAL ELECTRONIC F,2696370.0,0.0,,2018,5,23,CHECK_WITHDRAWAL,2696370.0,C1249175309
21002,1196428',2018-05-23,FDRL/NATIONAL ELECTRONIC F,58419.0,0.0,,2018,5,23,PAYEMENT,58419.0,M1967141198
21003,1196428',2018-05-23,RTGS/HDFCH18143254881/Indfor,0.0,6100000.0,,2018,5,23,CHECK_CASHING,6100000.0,C1036138670
21004,1196428',2018-05-23,FDRL/NATIONAL ELECTRONIC F,2000000.0,0.0,,2018,5,23,CHECK_WITHDRAWAL,2000000.0,M2060591590
21005,1196428',2018-05-23,FDRL/INTERNAL FUND TRANSFE,2000000.0,0.0,,2018,5,23,CHECK_WITHDRAWAL,2000000.0,M1844264030
21006,1196428',2018-05-23,FDRL/REAL TIME GROSS SETTL,1000000.0,0.0,,2018,5,23,CHECK_WITHDRAWAL,1000000.0,M2072712233
21007,1196428',2018-05-23,FDRL/REAL TIME GROSS SETTL,1000000.0,0.0,,2018,5,23,DEBIT,1000000.0,C449775363
21008,1196428',2018-05-23,CHQ DEP/180/OWDEL2/PSIB/S,0.0,11800.0,,2018,5,23,CASH_IN,11800.0,M1782533518
21009,1196428',2018-05-23,CHQ DEP/154/OWDEL2/HDFC/S,0.0,11800.0,,2018,5,23,CASH_IN,11800.0,C1459757869
21010,1196428',2018-05-23,CHQ DEP/435/OWDEL2/HDFC/A,0.0,11800.0,,2018,5,23,CASH_IN,11800.0,M334189371
21011,1196428',2018-05-23,CHQ DEP/772/OWDEL2/HDFC/A,0.0,11800.0,,2018,5,23,CHECK_CASHING,11800.0,M2077489914
21012,1196428',2018-05-23,CHQ DEP/731/OWDEL2/HDFC/N,0.0,11800.0,,2018,5,23,TRANSFER,11800.0,M1393016403
21013,1196428',2018-05-23,CHQ DEP/4561/OWDEL2/CBIN/,0.0,11800.0,,2018,5,23,CHECK_CASHING,11800.0,C225769102
21014,1196428',2018-05-23,CHQ DEP/39503/OWDEL2/ORBC,0.0,11800.0,,2018,5,23,CHECK_CASHING,11800.0,C687292566
21015,1196428',2018-05-23,CHQ DEP/579/OWDEL2/HDFC/A,0.0,11800.0,,2018,5,23,CHECK_CASHING,11800.0,M1661495706
21016,1196428',2018-05-23,CHQ DEP/138228/OWDEL2/PUN,0.0,11800.0,,2018,5,23,TRANSFER,11800.0,C1675401022
21017,1196428',2018-05-23,CHQ DEP/70444/OWDEL2/SBIN,0.0,11800.0,,2018,5,23,CHECK_CASHING,11800.0,M372459601
21018,1196428',2018-05-23,CHQ DEP/289759/OWDEL2/UTI,0.0,11800.0,,2018,5,23,TRANSFER,11800.0,M574086177
21019,1196428',2018-05-23,CHQ DEP/25929/OWDEL2/SBIN,0.0,11800.0,,2018,5,23,CHECK_CASHING,11800.0,C2075521461
21020,1196428',2018-05-23,CHQ DEP/360302/OWDEL2/PUN,0.0,11800.0,,2018,5,23,TRANSFER,11800.0,M1971432842
21021,1196428',2018-05-23,CHQ DEP/260/OWDEL2/HDFC/A,0.0,11800.0,,2018,5,23,TRANSFER,11800.0,C1493513506
21022,1196428',2018-05-23,CHQ DEP/102/OWDEL2/PSIB/I,0.0,11800.0,,2018,5,23,TRANSFER,11800.0,C1793436274
21023,1196428',2018-05-23,CHQ DEP/29911/OWDEL2/ORBC,0.0,11800.0,,2018,5,23,CHECK_CASHING,11800.0,C1725025770
21024,1196428',2018-05-23,CHQ DEP/43724/OWDEL2/SBIN,0.0,11800.0,,2018,5,23,TRANSFER,11800.0,C170899621
21025,1196428',2018-05-23,CHQ DEP/775169/OWDEL2/PUN,0.0,11800.0,,2018,5,23,TRANSFER,11800.0,M1743011665
21026,1196428',2018-05-23,CHQ DEP/3830/OWDEL2/UTIB/,0.0,11800.0,,2018,5,23,CASH_IN,11800.0,M933931185
21027,1196428',2018-05-23,CHQ DEP/1017/OWDEL2/UTIB/,0.0,11800.0,,2018,5,23,CHECK_CASHING,11800.0,M1501049650
21028,1196428',2018-05-23,CHQ DEP/627130/OWDEL2/SBI,0.0,11800.0,,2018,5,23,CHECK_CASHING,11800.0,C295081230
21029,1196428',2018-05-23,CHQ DEP/318475/OWDEL2/PUN,0.0,11800.0,,2018,5,23,TRANSFER,11800.0,M1756565293
21030,1196428',2018-05-23,CHQ DEP/469275/OWDEL2/PUN,0.0,11800.0,,2018,5,23,CHECK_CASHING,11800.0,M68450555
21031,1196428',2018-05-23,CHQ DEP/688367/OWDEL1/SBI,0.0,11800.0,,2018,5,23,CASH_IN,11800.0,M211554634
21032,1196428',2018-05-23,CHQ DEP/654/OWDEL1/BARB/S,0.0,11800.0,,2018,5,23,CASH_IN,11800.0,M159758838
21033,1196428',2018-05-23,CHQ DEP/26569/OWDEL1/SBIN,0.0,11800.0,,2018,5,23,TRANSFER,11800.0,M747425492
21034,1196428',2018-05-23,CHQ DEP/420927/OWDEL1/PUN,0.0,11800.0,,2018,5,23,CHECK_CASHING,11800.0,C954225330
21035,1196428',2018-05-23,CHQ DEP/618682/OWDEL1/SBI,0.0,11800.0,,2018,5,23,CASH_IN,11800.0,C1271835801
21036,1196428',2018-05-23,CHQ DEP/928838/OWDEL1/SBI,0.0,11800.0,,2018,5,23,CASH_IN,11800.0,C1413055366
21037,1196428',2018-05-23,CHQ DEP/199065/OWDEL1/SBI,0.0,11800.0,,2018,5,23,TRANSFER,11800.0,C163453316
21038,1196428',2018-05-23,CHQ DEP/404326/OWDEL1/PUN,0.0,11800.0,,2018,5,23,TRANSFER,11800.0,C1014923261
21039,1196428',2018-05-23,CHQ DEP/1305/OWDEL1/BARB/,0.0,11800.0,,2018,5,23,CASH_IN,11800.0,C1315729466
21040,1196428',2018-05-23,CHQ DEP/978432/OWDEL1/SBI,0.0,11800.0,,2018,5,23,TRANSFER,11800.0,C1761861940
21041,1196428',2018-05-23,CHQ DEP/206041/OWDEL1/PUN,0.0,11800.0,,2018,5,23,TRANSFER,11800.0,C2137356424
21042,1196428',2018-05-23,CHQ DEP/199/OWDEL1/HDFC/K,0.0,11800.0,,2018,5,23,CHECK_CASHING,11800.0,C866356999
21043,1196428',2018-05-23,CHQ DEP/49072/OWDEL1/BKID,0.0,8260.0,,2018,5,23,CHECK_CASHING,8260.0,C9108707
21044,1196428',2018-05-23,CHQ DEP/6388/OWDEL1/ALLA/,0.0,8260.0,,2018,5,23,CHECK_CASHING,8260.0,C232812328
21045,1196428',2018-05-23,CHQ DEP/975/OWDEL1/PSIB/G,0.0,8260.0,,2018,5,23,TRANSFER,8260.0,C1685697739
21046,1196428',2018-05-23,CHQ DEP/10842/OWDEL1/PSIB,0.0,8260.0,,2018,5,23,TRANSFER,8260.0,C392292416
21047,1196428',2018-05-23,CHQ DEP/61518/OWDEL1/ORBC,0.0,8260.0,,2018,5,23,CHECK_CASHING,8260.0,C977993101
21048,1196428',2018-05-23,CHQ DEP/22446/OWDEL1/SBIN,0.0,8260.0,,2018,5,23,CHECK_CASHING,8260.0,C758888772
21049,1196428',2018-05-23,CHQ DEP/372737/OWDEL1/SBI,0.0,11800.0,,2018,5,23,CASH_IN,11800.0,C1205603525
21050,1196428',2018-05-23,CHQ DEP/96189/OWDEL1/PUNB,0.0,8260.0,,2018,5,23,TRANSFER,8260.0,C1373467808
21051,1196428',2018-05-23,CHQ DEP/337897/OWDEL1/SBI,0.0,11800.0,,2018,5,23,TRANSFER,11800.0,C1782113663
21052,1196428',2018-05-23,CHQ DEP/9/OWDEL1/UCBA/TRA,0.0,11800.0,,2018,5,23,CHECK_CASHING,11800.0,C1452722471
21053,1196428',2018-05-23,CHQ DEP/10380/OWDEL1/JAKA,0.0,11800.0,,2018,5,23,CASH_IN,11800.0,C938960722
21054,1196428',2018-05-23,CHQ DEP/25077/OWDEL1/JAKA,0.0,11800.0,,2018,5,23,CASH_IN,11800.0,C2128665553
21055,1196428',2018-05-23,CHQ DEP/21114/OWDEL1/CBIN,0.0,11800.0,,2018,5,23,CASH_IN,11800.0,C842729010
21056,1196428',2018-05-23,CHQ DEP/408503/OWDEL1/JAK,0.0,11800.0,,2018,5,23,CASH_IN,11800.0,C1705929636
21057,1196428',2018-05-23,CHQ DEP/56/OWDEL1/HDFC/GA,0.0,11800.0,,2018,5,23,TRANSFER,11800.0,C145581669
21058,1196428',2018-05-23,CHQ DEP/329870/OWDEL1/SBI,0.0,11800.0,,2018,5,23,CHECK_CASHING,11800.0,C932583850
21059,1196428',2018-05-23,CHQ DEP/276763/OWDEL1/JAK,0.0,11800.0,,2018,5,23,CHECK_CASHING,11800.0,C1997859171
21060,1196428',2018-05-23,CHQ DEP/39504/OWDEL1/JAKA,0.0,11800.0,,2018,5,23,CHECK_CASHING,11800.0,C545710008
21061,1196428',2018-05-23,CHQ DEP/178464/OWDEL1/JAK,0.0,11800.0,,2018,5,23,CHECK_CASHING,11800.0,C2135554589
21062,1196428',2018-05-23,RTGS/PUNBH18143815981/PUN,0.0,300000.0,,2018,5,23,TRANSFER,300000.0,C569675628
21063,1196428',2018-05-23,TRF FROM  Indiaforensic SERVICES,0.0,15000000.0,,2018,5,23,TRANSFER,15000000.0,C830831744
21064,1196428',2018-05-23,TRF FROM  Indiaforensic SERVICES,0.0,8200000.0,,2018,5,23,CHECK_CASHING,8200000.0,C861958315
21065,1196428',2018-05-23,FDRL/REAL TIME GROSS SETTL,10000000.0,0.0,,2018,5,23,CASH_OUT,10000000.0,C1556875182
21066,1196428',2018-05-23,FDRL/REAL TIME GROSS SETTL,10000000.0,0.0,,2018,5,23,CHECK_WITHDRAWAL,10000000.0,C599726537
21067,1196428',2018-05-23,FDRL/INTERNAL FUND TRANSFE,1000000.0,0.0,,2018,5,23,PAYEMENT,1000000.0,C1530856786
21068,1196428',2018-05-23,FDRL/INTERNAL FUND TRANSFE,500000.0,0.0,,2018,5,23,CASH_OUT,500000.0,C68113386
21069,1196428',2018-05-23,CHQ DEPOSIT RETURN/978432,11800.0,0.0,,2018,5,23,CHECK_WITHDRAWAL,11800.0,C1474120649
21070,1196428',2018-05-23,CHQ DEPOSIT RETURN/4561/F,11800.0,0.0,,2018,5,23,PAYEMENT,11800.0,C1233472915
21071,1196428',2018-05-23,FDRL/REAL TIME GROSS SETTL,1000000.0,0.0,,2018,5,23,DEBIT,1000000.0,C1558550579
21072,1196428',2018-05-23,FDRL/REAL TIME GROSS SETTL,1000000.0,0.0,,2018,5,23,CASH_OUT,1000000.0,C1034584766
21073,1196428',2018-05-23,NEFT/N143180547014658/BAT,0.0,100000.0,,2018,5,23,CASH_IN,100000.0,C1095666481
21074,1196428',2018-05-23,NEFT/000046031124/Indiaforensic,0.0,1000000.0,,2018,5,23,CASH_IN,1000000.0,C254871157
21075,1196428',2018-05-23,NEFT/000046027170/Indiaforensic,0.0,800000.0,,2018,5,23,CASH_IN,800000.0,C1695946783
21076,1196428',2018-05-23,NEFT/000046025614/Indiaforensic,0.0,1700000.0,,2018,5,23,CHECK_CASHING,1700000.0,C604555852
21077,1196428',2018-05-23,NEFT/IBKL180523147504/SAI,0.0,8000.0,,2018,5,23,TRANSFER,8000.0,C2010551794
21078,1196428',2018-05-23,NEFT/SAA56605839/RAGHUBAN,0.0,8000.0,,2018,5,23,TRANSFER,8000.0,C1298314970
21079,1196428',2018-05-23,NEFT/SBIN818143357626/NAR,0.0,53947.0,,2018,5,23,CHECK_CASHING,53947.0,C1970362900
21080,1196428',2018-05-23,NEFT/N143180547091590/TEC,0.0,300000.0,,2018,5,23,CASH_IN,300000.0,C1751073738
21081,1196428',2018-05-23,NEFT/AXISP18143081201/ACC,0.0,1000000.0,,2018,5,23,CASH_IN,1000000.0,C893548422
21082,1196428',2018-05-23,TRF FROM  Indiaforensic SERVICES,0.0,4900000.0,,2018,5,23,CASH_IN,4900000.0,C1383454473
21083,1196428',2018-05-23,NEFT/N143180547010844/Indfor,0.0,3000000.0,,2018,5,23,TRANSFER,3000000.0,C1875310223
21084,1196428',2018-05-23,"Indiaforensic USA, INC./USD/1565",0.0,1061722.1,,2018,5,23,TRANSFER,1061722.1,C1076496284
21085,1196428',2018-05-23,IRTT00701815322,1296.11,0.0,,2018,5,23,CASH_OUT,1296.11,C476800120
21086,1196428',2018-05-23,"Indiaforensic USA, INC./USD/1995",0.0,135300.9,,2018,5,23,CASH_IN,135300.9,C1538961175
21087,1196428',2018-05-23,IRTT00701815326,506.77,0.0,,2018,5,23,PAYEMENT,506.77,C977339684
21088,1196428',2018-05-23,BEAT CSH PKP DEL UDYOG 64,0.0,103400.0,,2018,5,23,CASH_IN,103400.0,C720442578
21089,1196428',2018-05-23,FDRL/INTERNAL FUND TRANSFE,5000000.0,0.0,,2018,5,23,CHECK_WITHDRAWAL,5000000.0,C1777285191
21090,1196428',2018-05-23,FDRL/INTERNAL FUND TRANSFE,5000000.0,0.0,,2018,5,23,PAYEMENT,5000000.0,M408500804
21091,1196428',2018-05-23,FDRL/INTERNAL FUND TRANSFE,1000000.0,0.0,,2018,5,23,CASH_OUT,1000000.0,M225887202
21092,1196428',2018-05-23,FDRL/INTERNAL FUND TRANSFE,500000.0,0.0,,2018,5,23,CASH_OUT,500000.0,M1791912714
21093,1196428',2018-05-23,FDRL/INTERNAL FUND TRANSFE,1000000.0,0.0,,2018,5,23,DEBIT,1000000.0,M386571943
21094,1196428',2018-05-23,DSB MUTI CSH 2000X1 21052,2000.0,0.0,,2018,5,23,CASH_OUT,2000.0,M308547825
21095,1196428',2018-05-23,CHQ DEPOSIT RETURN/978432,100.0,0.0,,2018,5,23,DEBIT,100.0,M1021660419
21096,1196428',2018-05-23,CHQ DEPOSIT RETURN/978432,18.0,0.0,,2018,5,23,DEBIT,18.0,M1483499080
21097,1196428',2018-05-23,CHQ DEPOSIT RETURN/4561/C,100.0,0.0,,2018,5,23,CASH_OUT,100.0,M2043051330
21098,1196428',2018-05-23,CHQ DEPOSIT RETURN/4561/G,18.0,0.0,,2018,5,23,CHECK_WITHDRAWAL,18.0,M1075809197
21099,1196428',2018-05-24,RTGS/UTIBH18144652547/PER,0.0,400000.0,,2018,5,24,TRANSFER,400000.0,M140578926
21100,1196428',2018-05-24,NEFT/SBIN818144555076/NAR,0.0,52873.0,,2018,5,24,TRANSFER,52873.0,M413968278
21101,1196428',2018-05-24,RTGS/SBINH18144005174/Indfor,0.0,1500000.0,,2018,5,24,TRANSFER,1500000.0,M1626977374
21102,1196428',2018-05-24,CASHDEP/VIKASMARG/TP,0.0,166000.0,,2018,5,24,TRANSFER,166000.0,M694220673
21103,1196428',2018-05-24,FDRL/NATIONAL ELECTRONIC F,4616148.0,0.0,,2018,5,24,DEBIT,4616148.0,M1030100180
21104,1196428',2018-05-24,NEFT/N144180547433956/USH,0.0,4000.0,,2018,5,24,CASH_IN,4000.0,C628739205
21105,1196428',2018-05-24,NEFT/SBIN818144683716/NEE,0.0,98780.1,,2018,5,24,CASH_IN,98780.1,C1760872167
21106,1196428',2018-05-24,TRF FROM  Indiaforensic SERVICES,0.0,15000000.0,,2018,5,24,CHECK_CASHING,15000000.0,C515132998
21107,1196428',2018-05-24,TRF FROM  Indiaforensic SERVICES,0.0,5600000.0,,2018,5,24,CASH_IN,5600000.0,C2078250226
21108,1196428',2018-05-24,FDRL/REAL TIME GROSS SETTL,10000000.0,0.0,,2018,5,24,DEBIT,10000000.0,C2016282692
21109,1196428',2018-05-24,FDRL/REAL TIME GROSS SETTL,10000000.0,0.0,,2018,5,24,CASH_OUT,10000000.0,C1805445027
21110,1196428',2018-05-24,FDRL/REAL TIME GROSS SETTL,1000000.0,0.0,,2018,5,24,PAYEMENT,1000000.0,C1046102247
21111,1196428',2018-05-24,RTGS/SCBLH18144004078/FIX,0.0,250000.0,,2018,5,24,TRANSFER,250000.0,C1659797072
21112,1196428',2018-05-24,RTGS/DLXBH18144500424/KAD,0.0,200000.0,,2018,5,24,CASH_IN,200000.0,C1022680775
21113,1196428',2018-05-24,Indiaforensic SERVICES INDIA PVT,0.0,346042.0,,2018,5,24,CHECK_CASHING,346042.0,C2025644484
21114,1196428',2018-05-24,NEFT/AXISP18144035772/ACC,0.0,4000000.0,,2018,5,24,CASH_IN,4000000.0,C611621587
21115,1196428',2018-05-24,IMPS 814415027554 FROM SU,0.0,100.0,,2018,5,24,CASH_IN,100.0,C361268035
21116,1196428',2018-05-24,NEFT/SBIN818144954295/TAR,0.0,150000.0,,2018,5,24,TRANSFER,150000.0,C970612443
21117,1196428',2018-05-24,RTGS/PUNBH18144845130/PUN,0.0,200000.0,,2018,5,24,CHECK_CASHING,200000.0,C1896985362
21118,1196428',2018-05-24,NEFT/N144180547744616/BAT,0.0,100000.0,,2018,5,24,CASH_IN,100000.0,C1983747920
21119,1196428',2018-05-24,IMPS 814416375795 FROM AS,0.0,145146.0,,2018,5,24,TRANSFER,145146.0,C2070626006
21120,1196428',2018-05-24,TRF FROM  Indiaforensic SERVICES,0.0,4000000.0,,2018,5,24,TRANSFER,4000000.0,C1407083386
21121,1196428',2018-05-24,TRF FROM  Indiaforensic SERVICES,0.0,500000.0,,2018,5,24,CHECK_CASHING,500000.0,C1983747920
21122,1196428',2018-05-24,NEFT/000046104587/Indiaforensic,0.0,940000.0,,2018,5,24,CASH_IN,940000.0,C1139794020
21123,1196428',2018-05-24,NEFT/000046104566/Indiaforensic,0.0,1840000.0,,2018,5,24,TRANSFER,1840000.0,C1095587424
21124,1196428',2018-05-24,FDRL/INTERNAL FUND TRANSFE,3000000.0,0.0,,2018,5,24,DEBIT,3000000.0,M340472190
21125,1196428',2018-05-24,FDRL/INTERNAL FUND TRANSFE,1000000.0,0.0,,2018,5,24,PAYEMENT,1000000.0,C1636786811
21126,1196428',2018-05-24,FDRL/INTERNAL FUND TRANSFE,3000000.0,0.0,,2018,5,24,CHECK_WITHDRAWAL,3000000.0,C346008447
21127,1196428',2018-05-24,FDRL/INTERNAL FUND TRANSFE,3000000.0,0.0,,2018,5,24,PAYEMENT,3000000.0,M279212390
21128,1196428',2018-05-24,IMPS 814419472710 FROM SA,0.0,40000.0,,2018,5,24,CASH_IN,40000.0,M1657763032
21129,1196428',2018-05-24,FDRL/INTERNAL FUND TRANSFE,1000000.0,0.0,,2018,5,24,DEBIT,1000000.0,M1203237204
21130,1196428',2018-05-24,FDRL/INTERNAL FUND TRANSFE,1000000.0,0.0,,2018,5,24,DEBIT,1000000.0,M232278971
21131,1196428',2018-05-24,BEAT CSH PKP DEL UDYOG 64,0.0,75000.0,,2018,5,24,TRANSFER,75000.0,C1808263951
21132,1196428',2018-05-24,FDRL/INTERNAL FUND TRANSFE,500000.0,0.0,,2018,5,24,DEBIT,500000.0,M231449116
21133,1196428',2018-05-25,NEFT/SBIN918145386824/NAR,0.0,58973.0,,2018,5,25,TRANSFER,58973.0,M1101853805
21134,1196428',2018-05-25,RTGS/SBINH18145002500/Indfor,0.0,2500000.0,,2018,5,25,CASH_IN,2500000.0,M1096363683
21135,1196428',2018-05-25,NEFT/N145180548020533/TEC,0.0,500000.0,,2018,5,25,TRANSFER,500000.0,M680678654
21136,1196428',2018-05-25,RTGS/UTIBH18145691101/PER,0.0,400000.0,,2018,5,25,TRANSFER,400000.0,M617525182
21137,1196428',2018-05-25,NEFT/SBIN918145421597/TAR,0.0,145000.0,,2018,5,25,TRANSFER,145000.0,C1248712846
21138,1196428',2018-05-25,FDRL/NATIONAL ELECTRONIC F,2178684.0,0.0,,2018,5,25,DEBIT,2178684.0,M923425236
21139,1196428',2018-05-25,RTGS/SCBLH18145002289/FIX,0.0,1100000.0,,2018,5,25,CHECK_CASHING,1100000.0,C330624590
21140,1196428',2018-05-25,NEFT/ALLAH18145700276/Mr.,0.0,79750.0,,2018,5,25,CASH_IN,79750.0,C691636444
21141,1196428',2018-05-25,RTGS/HDFCH18145585742/USH,0.0,700000.0,,2018,5,25,CHECK_CASHING,700000.0,M1165896138
21142,1196428',2018-05-25,NEFT/000049532433/SREE MA,0.0,5000.0,,2018,5,25,CASH_IN,5000.0,M1200047740
21143,1196428',2018-05-25,RTGS/HDFCH18145622400/BAT,0.0,200000.0,,2018,5,25,TRANSFER,200000.0,C573200870
21144,1196428',2018-05-25,NEFT/N145180548230505/ESS,0.0,100.0,,2018,5,25,TRANSFER,100.0,M389116741
21145,1196428',2018-05-25,TRF FROM  Indiaforensic SERVICES,0.0,15000000.0,,2018,5,25,CASH_IN,15000000.0,M1257226064
21146,1196428',2018-05-25,TRF FROM  Indiaforensic SERVICES,0.0,5600000.0,,2018,5,25,CASH_IN,5600000.0,M1611603171
21147,1196428',2018-05-25,NEFT/P18052543102639/MUNI,0.0,11800.0,,2018,5,25,CHECK_CASHING,11800.0,M2129095543
21148,1196428',2018-05-25,FDRL/REAL TIME GROSS SETTL,10000000.0,0.0,,2018,5,25,PAYEMENT,10000000.0,M1561297066
21149,1196428',2018-05-25,FDRL/REAL TIME GROSS SETTL,10000000.0,0.0,,2018,5,25,DEBIT,10000000.0,M2064723866
21150,1196428',2018-05-25,FDRL/REAL TIME GROSS SETTL,2000000.0,0.0,,2018,5,25,DEBIT,2000000.0,M1683803818
21151,1196428',2018-05-25,FDRL/REAL TIME GROSS SETTL,2000000.0,0.0,,2018,5,25,DEBIT,2000000.0,M1793612662
21152,1196428',2018-05-25,NEFT/PUNBH18145013470/PUN,0.0,150000.0,,2018,5,25,CHECK_CASHING,150000.0,C1407083386
21153,1196428',2018-05-25,NEFT/SBIN918145860714/NAR,0.0,40000.0,,2018,5,25,TRANSFER,40000.0,M858492023
21154,1196428',2018-05-25,RTGS/HDFCH18145700261/Indfor,0.0,5400000.0,,2018,5,25,CHECK_CASHING,5400000.0,M31119270
21155,1196428',2018-05-25,NEFT/SBIN918145905014/MS,0.0,20000.0,,2018,5,25,CHECK_CASHING,20000.0,M726476237
21156,1196428',2018-05-25,NEFT/AXISP18145070819/ACC,0.0,19000000.0,,2018,5,25,CASH_IN,19000000.0,M1698740254
21157,1196428',2018-05-25,Indiaforensic SERVICES INDIA PVT,0.0,311640.0,,2018,5,25,CHECK_CASHING,311640.0,C392292416
21158,1196428',2018-05-25,IMPS 814517110729 FROM KO,0.0,11800.0,,2018,5,25,TRANSFER,11800.0,C266912553
21159,1196428',2018-05-25,FDRL/NATIONAL ELECTRONIC F,1500000.0,0.0,,2018,5,25,CASH_OUT,1500000.0,C464094472
21160,1196428',2018-05-25,FDRL/NATIONAL ELECTRONIC F,505155.0,0.0,,2018,5,25,CASH_OUT,505155.0,C1247051677
21161,1196428',2018-05-25,FDRL/NATIONAL ELECTRONIC F,990000.0,0.0,,2018,5,25,PAYEMENT,990000.0,M690715528
21162,1196428',2018-05-25,FDRL/NATIONAL ELECTRONIC F,995000.0,0.0,,2018,5,25,DEBIT,995000.0,M1340966303
21163,1196428',2018-05-25,FDRL/NATIONAL ELECTRONIC F,482500.0,0.0,,2018,5,25,DEBIT,482500.0,C824009085
21164,1196428',2018-05-25,FDRL/NATIONAL ELECTRONIC F,1980000.0,0.0,,2018,5,25,PAYEMENT,1980000.0,C1700852615
21165,1196428',2018-05-25,FDRL/NATIONAL ELECTRONIC F,1485000.0,0.0,,2018,5,25,PAYEMENT,1485000.0,M2106602650
21166,1196428',2018-05-25,FDRL/NATIONAL ELECTRONIC F,500000.0,0.0,,2018,5,25,CASH_OUT,500000.0,M562113213
21167,1196428',2018-05-25,FDRL/NATIONAL ELECTRONIC F,500000.0,0.0,,2018,5,25,PAYEMENT,500000.0,C1361396394
21168,1196428',2018-05-25,FDRL/NATIONAL ELECTRONIC F,482500.0,0.0,,2018,5,25,DEBIT,482500.0,M613386595
21169,1196428',2018-05-25,FDRL/NATIONAL ELECTRONIC F,1000000.0,0.0,,2018,5,25,CHECK_WITHDRAWAL,1000000.0,M1083148329
21170,1196428',2018-05-25,NEFT/000039240378/BENEFIC,0.0,1500000.0,,2018,5,25,TRANSFER,1500000.0,M1861582010
21171,1196428',2018-05-25,NEFT/000046175162/Indiaforensic,0.0,850000.0,,2018,5,25,TRANSFER,850000.0,M1119403066
21172,1196428',2018-05-25,NEFT/000046175103/Indiaforensic,0.0,732000.0,,2018,5,25,TRANSFER,732000.0,C2011184385
21173,1196428',2018-05-25,TRF FROM  Indiaforensic SERVICES,0.0,5300000.0,,2018,5,25,CASH_IN,5300000.0,C1036454560
21174,1196428',2018-05-25,FDRL/INTERNAL FUND TRANSFE,10000000.0,0.0,,2018,5,25,PAYEMENT,10000000.0,M1422942723
21175,1196428',2018-05-25,FDRL/INTERNAL FUND TRANSFE,10000000.0,0.0,,2018,5,25,PAYEMENT,10000000.0,M1018209533
21176,1196428',2018-05-25,FDRL/INTERNAL FUND TRANSFE,3000000.0,0.0,,2018,5,25,DEBIT,3000000.0,C194988831
21177,1196428',2018-05-25,TRF FROM  Indiaforensic SERVICES,0.0,500000.0,,2018,5,25,TRANSFER,500000.0,C874023329
21178,1196428',2018-05-25,FDRL/INTERNAL FUND TRANSFE,500000.0,0.0,,2018,5,25,CASH_OUT,500000.0,M1163750953
21179,1196428',2018-05-25,FDRL/INTERNAL FUND TRANSFE,500000.0,0.0,,2018,5,25,CASH_OUT,500000.0,C593596322
21180,1196428',2018-05-25,BEAT CSH PKP DEL UDYOG 64,0.0,78000.0,,2018,5,25,CASH_IN,78000.0,C1725775569
21181,1196428',2018-05-26,IMPS 814612173644 FROM CE,0.0,2010.0,,2018,5,26,CHECK_CASHING,2010.0,M1613667542
21182,1196428',2018-05-26,IMPS 814613394498 FROM MA,0.0,8000.0,,2018,5,26,TRANSFER,8000.0,M5629855
21183,1196428',2018-05-26,IMPS 814615326852 FROM AS,0.0,136137.0,,2018,5,26,CASH_IN,136137.0,M1056386377
21184,1196428',2018-05-26,IMPS 814617357210 FROM AS,0.0,49997.0,,2018,5,26,TRANSFER,49997.0,C1435804085
21185,1196428',2018-05-28,NEFT/SBIN118148253295/NAR,0.0,52879.0,,2018,5,28,CASH_IN,52879.0,M1844246129
21186,1196428',2018-05-28,RTGS/UTIBH18148640251/PER,0.0,400000.0,,2018,5,28,CASH_IN,400000.0,M1298860432
21187,1196428',2018-05-28,RTGS/SBINH18148003595/Indfor,0.0,6000000.0,,2018,5,28,CASH_IN,6000000.0,M2088475755
21188,1196428',2018-05-28,NEFT/SBIN118148271176/TAR,0.0,170000.0,,2018,5,28,CHECK_CASHING,170000.0,M872076231
21189,1196428',2018-05-28,NEFT/SBIN118148276583/JAI,0.0,1000.0,,2018,5,28,CASH_IN,1000.0,M275941124
21190,1196428',2018-05-28,RTGS/SBINH18148010279/Indfor,0.0,2300000.0,,2018,5,28,CASH_IN,2300000.0,M278283714
21191,1196428',2018-05-28,NEFT/N148180549003806/SHA,0.0,11800.0,,2018,5,28,CHECK_CASHING,11800.0,M1914293974
21192,1196428',2018-05-28,CASHDEP/NERUL/,0.0,53000.0,,2018,5,28,CHECK_CASHING,53000.0,M469576646
21193,1196428',2018-05-28,FDRL/NATIONAL ELECTRONIC F,2967724.0,0.0,,2018,5,28,PAYEMENT,2967724.0,M1759235322
21194,1196428',2018-05-28,FDRL/NATIONAL ELECTRONIC F,3244997.0,0.0,,2018,5,28,CHECK_WITHDRAWAL,3244997.0,M501297438
21195,1196428',2018-05-28,FDRL/NATIONAL ELECTRONIC F,755045.0,0.0,,2018,5,28,CHECK_WITHDRAWAL,755045.0,M969894448
21196,1196428',2018-05-28,NEFT/N148180549040690/CEE,0.0,1090.0,,2018,5,28,TRANSFER,1090.0,M1187570185
21197,1196428',2018-05-28,NEFT/PUNBH18148177118/ARO,0.0,11800.0,,2018,5,28,CHECK_CASHING,11800.0,M631846369
21198,1196428',2018-05-28,INTEX TECHNOLOGIES INDIA,1000000.0,0.0,,2018,5,28,DEBIT,1000000.0,M1555638555
21199,1196428',2018-05-28,NEFT/SBIN118148650789/KSK,0.0,11800.0,,2018,5,28,CHECK_CASHING,11800.0,M2105898461
21200,1196428',2018-05-28,NEFT/N148180549234887/USH,0.0,65000.0,,2018,5,28,CHECK_CASHING,65000.0,M928935460
21201,1196428',2018-05-28,NEFT/IBKL180528429025/SRI,0.0,11800.0,,2018,5,28,CHECK_CASHING,11800.0,M180811656
21202,1196428',2018-05-28,RTGS/PUNBH18148880299/PUN,0.0,600000.0,,2018,5,28,TRANSFER,600000.0,M1060291706
21203,1196428',2018-05-28,FDRL/INTERNAL FUND TRANSFE,1000000.0,0.0,,2018,5,28,DEBIT,1000000.0,M77251189
21204,1196428',2018-05-28,FDRL/INTERNAL FUND TRANSFE,500000.0,0.0,,2018,5,28,CASH_OUT,500000.0,C982547576
21205,1196428',2018-05-28,FDRL/INTERNAL FUND TRANSFE,300000.0,0.0,,2018,5,28,CASH_OUT,300000.0,M1246864599
21206,1196428',2018-05-28,TRF FROM  Indiaforensic SERVICES,0.0,6800000.0,,2018,5,28,CHECK_CASHING,6800000.0,C1075238398
21207,1196428',2018-05-28,TRF FROM  Indiaforensic SERVICES,0.0,15000000.0,,2018,5,28,TRANSFER,15000000.0,C1257952957
21208,1196428',2018-05-28,TRF FROM  Indiaforensic SERVICES,0.0,15000000.0,,2018,5,28,CHECK_CASHING,15000000.0,M921885174
21209,1196428',2018-05-28,TRF FROM  Indiaforensic SERVICES,0.0,15000000.0,,2018,5,28,CASH_IN,15000000.0,C1590351968
21210,1196428',2018-05-28,FDRL/NATIONAL ELECTRONIC F,15000000.0,0.0,,2018,5,28,CHECK_WITHDRAWAL,15000000.0,C1921483039
21211,1196428',2018-05-28,FDRL/NATIONAL ELECTRONIC F,15000000.0,0.0,,2018,5,28,PAYEMENT,15000000.0,M1089243466
21212,1196428',2018-05-28,FDRL/NATIONAL ELECTRONIC F,15000000.0,0.0,,2018,5,28,PAYEMENT,15000000.0,C43924520
21213,1196428',2018-05-28,FDRL/NATIONAL ELECTRONIC F,3000000.0,0.0,,2018,5,28,CHECK_WITHDRAWAL,3000000.0,C1128238842
21214,1196428',2018-05-28,FDRL/NATIONAL ELECTRONIC F,3000000.0,0.0,,2018,5,28,PAYEMENT,3000000.0,M2059139271
21215,1196428',2018-05-28,"Indiaforensic USA, INC./USD/1026",0.0,688446.0,,2018,5,28,CHECK_CASHING,688446.0,C266418454
21216,1196428',2018-05-28,IRTT00701815696,1004.6,0.0,,2018,5,28,PAYEMENT,1004.6,C1434389049
21217,1196428',2018-05-28,IMPS 814817324357 FROM AS,0.0,99995.0,,2018,5,28,TRANSFER,99995.0,C1089993541
21218,1196428',2018-05-28,NEFT/N148180549552603/BAT,0.0,100000.0,,2018,5,28,TRANSFER,100000.0,C1022680775
21219,1196428',2018-05-28,TRF FROM  Indiaforensic SERVICES,0.0,15000000.0,,2018,5,28,CHECK_CASHING,15000000.0,C1234363215
21220,1196428',2018-05-28,BEAT CSH PKP DEL UDYOG 64,0.0,500000.0,,2018,5,28,TRANSFER,500000.0,C189429491
21221,1196428',2018-05-28,NEFT/000046259737/Indiaforensic,0.0,2900000.0,,2018,5,28,TRANSFER,2900000.0,C1334973394
21222,1196428',2018-05-28,NEFT/000046259923/Indiaforensic,0.0,1900000.0,,2018,5,28,CHECK_CASHING,1900000.0,C709091500
21223,1196428',2018-05-28,FDRL/INTERNAL FUND TRANSFE,15000000.0,0.0,,2018,5,28,CASH_OUT,15000000.0,C1866827563
21224,1196428',2018-05-28,FDRL/INTERNAL FUND TRANSFE,5000000.0,0.0,,2018,5,28,CHECK_WITHDRAWAL,5000000.0,C523154252
21225,1196428',2018-05-29,FDRL/NATIONAL ELECTRONIC F,226751.0,0.0,,2018,5,29,CASH_OUT,226751.0,M2109069115
21226,1196428',2018-05-29,FDRL/NATIONAL ELECTRONIC F,236739.0,0.0,,2018,5,29,CASH_OUT,236739.0,C1034382650
21227,1196428',2018-05-29,RTGS/HDFCH18149975104/Indfor,0.0,7200000.0,,2018,5,29,CHECK_CASHING,7200000.0,M391328666
21228,1196428',2018-05-29,FDRL/NATIONAL ELECTRONIC F,741977.0,0.0,,2018,5,29,PAYEMENT,741977.0,M1177342734
21229,1196428',2018-05-29,FDRL/REAL TIME GROSS SETTL,5000000.0,0.0,,2018,5,29,DEBIT,5000000.0,M1125615802
21230,1196428',2018-05-29,FDRL/REAL TIME GROSS SETTL,1000000.0,0.0,,2018,5,29,CASH_OUT,1000000.0,M1178109942
21231,1196428',2018-05-29,FDRL/REAL TIME GROSS SETTL,1000000.0,0.0,,2018,5,29,CASH_OUT,1000000.0,C748014372
21232,1196428',2018-05-29,FDRL/REAL TIME GROSS SETTL,1000000.0,0.0,,2018,5,29,PAYEMENT,1000000.0,M1134229208
21233,1196428',2018-05-29,UPI/814911872749/Indiaforensic T,0.0,1500.0,,2018,5,29,CHECK_CASHING,1500.0,C369851597
21234,1196428',2018-05-29,FDRL/NATIONAL ELECTRONIC F,135016.0,0.0,,2018,5,29,CHECK_WITHDRAWAL,135016.0,C843774579
21235,1196428',2018-05-29,CASHDEP/NERUL/,0.0,40000.0,,2018,5,29,CHECK_CASHING,40000.0,M1123349783
21236,1196428',2018-05-29,NEFT/N149180550047597/USH,0.0,145000.0,,2018,5,29,CASH_IN,145000.0,C1705929636
21237,1196428',2018-05-29,CHQ DEP/262/OWDEL1/ORBC/V,0.0,8260.0,,2018,5,29,CHECK_CASHING,8260.0,C1390121014
21238,1196428',2018-05-29,NEFT/P18052944593474/WEST,0.0,11800.0,,2018,5,29,TRANSFER,11800.0,M1707583366
21239,1196428',2018-05-29,Indiaforensic SERVICES INDIA PVT,0.0,312870.0,,2018,5,29,TRANSFER,312870.0,C2115055717
21240,1196428',2018-05-29,NEFT/N149180550203129/USH,0.0,99000.0,,2018,5,29,TRANSFER,99000.0,M900657051
21241,1196428',2018-05-29,TRF FROM  Indiaforensic SERVICES,0.0,15000000.0,,2018,5,29,TRANSFER,15000000.0,C1525147099
21242,1196428',2018-05-29,TRF FROM  Indiaforensic SERVICES,0.0,500000.0,,2018,5,29,CASH_IN,500000.0,C1805683209
21243,1196428',2018-05-29,TRF FROM  Indiaforensic SERVICES,0.0,3000000.0,,2018,5,29,TRANSFER,3000000.0,C531511436
21244,1196428',2018-05-29,TRF FROM  Indiaforensic SERVICES,0.0,2000000.0,,2018,5,29,CASH_IN,2000000.0,C1210180003
21245,1196428',2018-05-29,TRF FROM  Indiaforensic SERVICES,0.0,1000000.0,,2018,5,29,TRANSFER,1000000.0,C989898681
21246,1196428',2018-05-29,CASHDEP/NERUL/,0.0,48000.0,,2018,5,29,TRANSFER,48000.0,C1945802665
21247,1196428',2018-05-29,FDRL/REAL TIME GROSS SETTL,15000000.0,0.0,,2018,5,29,PAYEMENT,15000000.0,C1657769946
21248,1196428',2018-05-29,FDRL/REAL TIME GROSS SETTL,5000000.0,0.0,,2018,5,29,CHECK_WITHDRAWAL,5000000.0,C724821526
21249,1196428',2018-05-29,RTGS/PUNBH18149910265/PUN,0.0,200000.0,,2018,5,29,CHECK_CASHING,200000.0,C1805683209
21250,1196428',2018-05-29,NEFT/SBIN318149105051/TAR,0.0,190000.0,,2018,5,29,CHECK_CASHING,190000.0,C2096057945
21251,1196428',2018-05-29,RTGS/DLXBH18149500806/KAD,0.0,200000.0,,2018,5,29,CASH_IN,200000.0,C663202788
21252,1196428',2018-05-29,IMPS 814916133127 FROM SA,0.0,200000.0,,2018,5,29,TRANSFER,200000.0,C142538462
21253,1196428',2018-05-29,RTGS/HDFCH18149128872/Indfor,0.0,6400000.0,,2018,5,29,TRANSFER,6400000.0,C1360767589
21254,1196428',2018-05-29,FDRL/NATIONAL ELECTRONIC F,3000000.0,0.0,,2018,5,29,CHECK_WITHDRAWAL,3000000.0,C556812393
21255,1196428',2018-05-29,NEFT/SBIN318149128849/KAM,0.0,11794.1,,2018,5,29,CASH_IN,11794.1,C307531674
21256,1196428',2018-05-29,NEFT/BARBU18149892781/MAK,0.0,62500.0,,2018,5,29,CASH_IN,62500.0,C1962165946
21257,1196428',2018-05-29,Indiaforensic SERVICES INDIA PVT,0.0,167712.0,,2018,5,29,CHECK_CASHING,167712.0,C2009378486
21258,1196428',2018-05-29,TRF FROM  Indiaforensic SERVICES,0.0,4900000.0,,2018,5,29,TRANSFER,4900000.0,C1231842708
21259,1196428',2018-05-29,FDRL/INTERNAL FUND TRANSFE,10000000.0,0.0,,2018,5,29,DEBIT,10000000.0,C1469682037
21260,1196428',2018-05-29,FDRL/INTERNAL FUND TRANSFE,1000000.0,0.0,,2018,5,29,DEBIT,1000000.0,C1282745381
21261,1196428',2018-05-29,NEFT/000046338692/Indiaforensic,0.0,1400000.0,,2018,5,29,CASH_IN,1400000.0,C191614132
21262,1196428',2018-05-29,NEFT/000046339208/Indiaforensic,0.0,1800000.0,,2018,5,29,CASH_IN,1800000.0,C1196694338
21263,1196428',2018-05-29,BEAT CSH PKP DEL UDYOG 64,0.0,78200.0,,2018,5,29,TRANSFER,78200.0,C1885712019
21264,1196428',2018-05-30,NEFT/N150180550920360/USH,0.0,37000.0,,2018,5,30,TRANSFER,37000.0,C1155337528
21265,1196428',2018-05-30,FDRL/NATIONAL ELECTRONIC F,6130.0,0.0,,2018,5,30,CASH_OUT,6130.0,C25136566
21266,1196428',2018-05-30,FDRL/NATIONAL ELECTRONIC F,2079573.0,0.0,,2018,5,30,CHECK_WITHDRAWAL,2079573.0,C1540929793
21267,1196428',2018-05-30,RTGS/HDFCH18150202194/USH,0.0,370000.0,,2018,5,30,CASH_IN,370000.0,C93166806
21268,1196428',2018-05-30,NEFT/SBIN318150642172/LAL,0.0,10000.0,,2018,5,30,CASH_IN,10000.0,C1231842708
21269,1196428',2018-05-30,TRF FRM  Indiaforensic SERVICES,0.0,15000000.0,,2018,5,30,CASH_IN,15000000.0,C1883788127
21270,1196428',2018-05-30,TRF FRM  Indiaforensic SERVICES,0.0,6000000.0,,2018,5,30,CHECK_CASHING,6000000.0,C1096283470
21271,1196428',2018-05-30,RTGS/UTIBH18150660304/PER,0.0,400000.0,,2018,5,30,CHECK_CASHING,400000.0,C1326243087
21272,1196428',2018-05-30,FDRL/REAL TIME GROSS SETTL,1000000.0,0.0,,2018,5,30,DEBIT,1000000.0,C58333888
21273,1196428',2018-05-30,FDRL/REAL TIME GROSS SETTL,10000000.0,0.0,,2018,5,30,CASH_OUT,10000000.0,C1545688642
21274,1196428',2018-05-30,FDRL/REAL TIME GROSS SETTL,1000000.0,0.0,,2018,5,30,CHECK_WITHDRAWAL,1000000.0,C909295153
21275,1196428',2018-05-30,FDRL/REAL TIME GROSS SETTL,1000000.0,0.0,,2018,5,30,CASH_OUT,1000000.0,C1403808692
21276,1196428',2018-05-30,FDRL/REAL TIME GROSS SETTL,10000000.0,0.0,,2018,5,30,PAYEMENT,10000000.0,C978609035
21277,1196428',2018-05-30,IMPS 815014662155 FROM SH,0.0,1750.0,,2018,5,30,CASH_IN,1750.0,C1731824557
21278,1196428',2018-05-30,RTGS/HDFCH18150255957/Indfor,0.0,6100000.0,,2018,5,30,TRANSFER,6100000.0,C1446521801
21279,1196428',2018-05-30,FDRL/INTERNAL FUND TRANSFE,500000.0,0.0,,2018,5,30,CASH_OUT,500000.0,C875761527
21280,1196428',2018-05-30,FDRL/INTERNAL FUND TRANSFE,100000.0,0.0,,2018,5,30,CASH_OUT,100000.0,C2109097173
21281,1196428',2018-05-30,FDRL/INTERNAL FUND TRANSFE,300000.0,0.0,,2018,5,30,CHECK_WITHDRAWAL,300000.0,C650657798
21282,1196428',2018-05-30,Indiaforensic SERVICES INDIA PVT,0.0,182780.0,,2018,5,30,CHECK_CASHING,182780.0,C526035976
21283,1196428',2018-05-30,"Indiaforensic USA, INC./USD/1283",0.0,861556.62,,2018,5,30,CHECK_CASHING,861556.62,C7881234
21284,1196428',2018-05-30,IRTT00701815927,1160.4,0.0,,2018,5,30,PAYEMENT,1160.4,C1060563153
21285,1196428',2018-05-30,NEFT/N150180551401475/TEC,0.0,200000.0,,2018,5,30,TRANSFER,200000.0,C1389405694
21286,1196428',2018-05-30,IMPS 815017365144 FROM AS,0.0,115116.0,,2018,5,30,CASH_IN,115116.0,C2011904058
21287,1196428',2018-05-30,IMPS 815017368512 FROM AS,0.0,100101.0,,2018,5,30,TRANSFER,100101.0,C1987564320
21288,1196428',2018-05-30,NEFT/000046387732/Indiaforensic,0.0,1300000.0,,2018,5,30,CASH_IN,1300000.0,C204334828
21289,1196428',2018-05-30,NEFT/SBIN318150760681/NAR,0.0,40237.0,,2018,5,30,CHECK_CASHING,40237.0,C157191672
21290,1196428',2018-05-30,NEFT/000046389171/Indiaforensic,0.0,1200000.0,,2018,5,30,CASH_IN,1200000.0,M504844075
21291,1196428',2018-05-30,BEAT CSH PKP DEL UDYOG 64,0.0,104000.0,,2018,5,30,TRANSFER,104000.0,M8438143
21292,1196428',2018-05-30,FDRL/INTERNAL FUND TRANSFE,5000000.0,0.0,,2018,5,30,DEBIT,5000000.0,M937734683
21293,1196428',2018-05-30,FDRL/INTERNAL FUND TRANSFE,5000000.0,0.0,,2018,5,30,DEBIT,5000000.0,M515153670
21294,1196428',2018-05-30,TRF FROM  Indiaforensic SERVICES,0.0,3000000.0,,2018,5,30,CHECK_CASHING,3000000.0,M1767059660
21295,1196428',2018-05-30,FDRL/INTERNAL FUND TRANSFE,3000000.0,0.0,,2018,5,30,PAYEMENT,3000000.0,C367746789
21296,1196428',2018-05-31,RTGS/UTIBH18151668314/PER,0.0,400000.0,,2018,5,31,CASH_IN,400000.0,C1251935072
21297,1196428',2018-05-31,NEFT/AXIC181511761846/SAB,0.0,11800.0,,2018,5,31,CHECK_CASHING,11800.0,C1671386208
21298,1196428',2018-05-31,RTGS/SBINH18151002412/Indfor,0.0,4000000.0,,2018,5,31,TRANSFER,4000000.0,C536171536
21299,1196428',2018-05-31,FDRL/NATIONAL ELECTRONIC F,4329542.0,0.0,,2018,5,31,PAYEMENT,4329542.0,M766373959
21300,1196428',2018-05-31,NEFT/N151180551748439/USH,0.0,106890.0,,2018,5,31,CASH_IN,106890.0,M1906870830
21301,1196428',2018-05-31,NEFT/IOBAN18151450904/SHY,0.0,100000.0,,2018,5,31,CASH_IN,100000.0,C1247600089
21302,1196428',2018-05-31,CHQ DEP/764315/OWDEL1/SBI,0.0,11800.0,,2018,5,31,CASH_IN,11800.0,C875917495
21303,1196428',2018-05-31,CHQ DEP/2123/OWDEL1/BARB/,0.0,11800.0,,2018,5,31,CHECK_CASHING,11800.0,C1629687658
21304,1196428',2018-05-31,CHQ DEP/66977/OWDEL1/UBIN,0.0,11800.0,,2018,5,31,TRANSFER,11800.0,C1772085663
21305,1196428',2018-05-31,CHQ DEP/34726/OWDEL1/UBIN,0.0,11800.0,,2018,5,31,TRANSFER,11800.0,C1870237274
21306,1196428',2018-05-31,CHQ DEP/4646/OWDEL1/UBIN/,0.0,11800.0,,2018,5,31,CHECK_CASHING,11800.0,C296121376
21307,1196428',2018-05-31,CHQ DEP/322/OWDEL1/UCBA/J,0.0,11800.0,,2018,5,31,TRANSFER,11800.0,C2040603986
21308,1196428',2018-05-31,CHQ DEP/142801/OWDEL1/SBI,0.0,11800.0,,2018,5,31,CHECK_CASHING,11800.0,C294900736
21309,1196428',2018-05-31,CHQ DEP/245768/OWDEL1/IBK,0.0,11800.0,,2018,5,31,TRANSFER,11800.0,C1870237274
21310,1196428',2018-05-31,CHQ DEP/261/OWDEL1/UCBA/J,0.0,11800.0,,2018,5,31,TRANSFER,11800.0,C634440506
21311,1196428',2018-05-31,CHQ DEP/225166/OWDEL1/BKD,0.0,11800.0,,2018,5,31,TRANSFER,11800.0,C345603257
21312,1196428',2018-05-31,CHQ DEP/634937/OWDEL1/ICI,0.0,11800.0,,2018,5,31,CASH_IN,11800.0,C1076835071
21313,1196428',2018-05-31,CHQ DEP/827/OWDEL1/UCBA/R,0.0,11800.0,,2018,5,31,CASH_IN,11800.0,C1023714065
21314,1196428',2018-05-31,CHQ DEP/14817/OWDEL1/SCBL,0.0,8850.0,,2018,5,31,CASH_IN,8850.0,C1805683209
21315,1196428',2018-05-31,CHQ DEP/3230/OWDEL1/BARB/,0.0,11800.0,,2018,5,31,TRANSFER,11800.0,C214974969
21316,1196428',2018-05-31,CHQ DEP/277785/OWDEL1/VIJ,0.0,11800.0,,2018,5,31,CASH_IN,11800.0,C1515704208
21317,1196428',2018-05-31,CHQ DEP/731520/OWDEL1/SBI,0.0,11800.0,,2018,5,31,TRANSFER,11800.0,C444613285
21318,1196428',2018-05-31,CHQ DEP/958279/OWDEL1/SBI,0.0,8260.0,,2018,5,31,CASH_IN,8260.0,C451433836
21319,1196428',2018-05-31,CHQ DEP/813092/OWDEL1/SBI,0.0,11800.0,,2018,5,31,CHECK_CASHING,11800.0,C1414763289
21320,1196428',2018-05-31,NEFT/N151180551924482/USH,0.0,100350.0,,2018,5,31,CHECK_CASHING,100350.0,C476182975
21321,1196428',2018-05-31,TRF FROM  Indiaforensic SERVICES,0.0,15000000.0,,2018,5,31,TRANSFER,15000000.0,C1421496184
21322,1196428',2018-05-31,TRF FROM  Indiaforensic SERVICES,0.0,6000000.0,,2018,5,31,CHECK_CASHING,6000000.0,C1242584406
21323,1196428',2018-05-31,FDRL/REAL TIME GROSS SETTL,10000000.0,0.0,,2018,5,31,DEBIT,10000000.0,C187019413
21324,1196428',2018-05-31,FDRL/REAL TIME GROSS SETTL,10000000.0,0.0,,2018,5,31,DEBIT,10000000.0,C268402121
21325,1196428',2018-05-31,RTGS/HDFCH18151358094/Indfor,0.0,5400000.0,,2018,5,31,CHECK_CASHING,5400000.0,C503195940
21326,1196428',2018-05-31,IMPS 815115550969 FROM KA,0.0,2001.0,,2018,5,31,TRANSFER,2001.0,C46748390
21327,1196428',2018-05-31,NEFT/N151180552210702/BAT,0.0,90000.0,,2018,5,31,CHECK_CASHING,90000.0,C1907159141
21328,1196428',2018-05-31,CHQ DEPOSIT RETURN/66977/,11800.0,0.0,,2018,5,31,CHECK_WITHDRAWAL,11800.0,C1305075214
21329,1196428',2018-05-31,CHQ DEPOSIT RETURN/34726/,11800.0,0.0,,2018,5,31,CASH_OUT,11800.0,C885136436
21330,1196428',2018-05-31,CHQ DEPOSIT RETURN/4646/O,11800.0,0.0,,2018,5,31,CHECK_WITHDRAWAL,11800.0,C1196694338
21331,1196428',2018-05-31,CHQ DEPOSIT RETURN/322/OT,11800.0,0.0,,2018,5,31,DEBIT,11800.0,C2127862399
21332,1196428',2018-05-31,CHQ DEPOSIT RETURN/261/OT,11800.0,0.0,,2018,5,31,CASH_OUT,11800.0,C1406749291
21333,1196428',2018-05-31,CHQ DEPOSIT RETURN/225166,11800.0,0.0,,2018,5,31,PAYEMENT,11800.0,C725215101
21334,1196428',2018-05-31,CHQ DEPOSIT RETURN/827/OT,11800.0,0.0,,2018,5,31,PAYEMENT,11800.0,C1282745381
21335,1196428',2018-05-31,CHQ DEPOSIT RETURN/277785,11800.0,0.0,,2018,5,31,CHECK_WITHDRAWAL,11800.0,C2011996123
21336,1196428',2018-05-31,Indiaforensic SERVICES INDIA PVT,0.0,158699.0,,2018,5,31,CASH_IN,158699.0,C1308497108
21337,1196428',2018-05-31,NEFT/SBIN418151042550/NAR,0.0,51275.0,,2018,5,31,CASH_IN,51275.0,C1734719138
21338,1196428',2018-05-31,NEFT/AXISP18151139969/ACC,0.0,3000000.0,,2018,5,31,TRANSFER,3000000.0,C918485243
21339,1196428',2018-05-31,IMPS 815117998240 FROM MA,0.0,11800.0,,2018,5,31,CHECK_CASHING,11800.0,C712956349
21340,1196428',2018-05-31,NEFT/000046435304/Indiaforensic,0.0,349000.0,,2018,5,31,CASH_IN,349000.0,C2059996587
21341,1196428',2018-05-31,NEFT/000046435280/Indiaforensic,0.0,1024000.0,,2018,5,31,TRANSFER,1024000.0,C478793413
21342,1196428',2018-05-31,TRF FROM  Indiaforensic SERVICES,0.0,5000000.0,,2018,5,31,TRANSFER,5000000.0,C1277694634
21343,1196428',2018-05-31,FDRL/INTERNAL FUND TRANSFE,5000000.0,0.0,,2018,5,31,CASH_OUT,5000000.0,C599968109
21344,1196428',2018-05-31,FDRL/INTERNAL FUND TRANSFE,5000000.0,0.0,,2018,5,31,DEBIT,5000000.0,C386312539
21345,1196428',2018-05-31,FDRL/INTERNAL FUND TRANSFE,500000.0,0.0,,2018,5,31,CASH_OUT,500000.0,C1034584766
21346,1196428',2018-05-31,FDRL/INTERNAL FUND TRANSFE,1000000.0,0.0,,2018,5,31,CASH_OUT,1000000.0,C294900736
21347,1196428',2018-05-31,FDRL/INTERNAL FUND TRANSFE,1000000.0,0.0,,2018,5,31,DEBIT,1000000.0,C1459693562
21348,1196428',2018-05-31,BEAT CSH PKP DEL UDYOG 64,0.0,48500.0,,2018,5,31,CHECK_CASHING,48500.0,C323287038
21349,1196428',2018-05-31,1196428:Int.Coll:01-05-20,827851.0,0.0,,2018,5,31,CHECK_WITHDRAWAL,827851.0,C596299019
21350,1196428',2018-06-01,RTGS/SBINH18152002649/Indfor,0.0,1000000.0,,2018,6,1,CASH_IN,1000000.0,C506903242
21351,1196428',2018-06-01,FDRL/NATIONAL ELECTRONIC F,3424738.0,0.0,,2018,6,1,CHECK_WITHDRAWAL,3424738.0,M2072059657
21352,1196428',2018-06-01,FDRL/INTERNAL FUND TRANSFE,500000.0,0.0,,2018,6,1,CASH_OUT,500000.0,C304406966
21353,1196428',2018-06-01,NEFT/N152180552860038/USH,0.0,22050.0,,2018,6,1,CASH_IN,22050.0,C75629578
21354,1196428',2018-06-01,NEFT/N152180553005677/USH,0.0,99985.0,,2018,6,1,CASH_IN,99985.0,M1037398211
21355,1196428',2018-06-01,IMPS 815212235415 FROM SA,0.0,6000.0,,2018,6,1,CASH_IN,6000.0,C2072030256
21356,1196428',2018-06-01,TRF FROM  Indiaforensic SERVICES,0.0,15000000.0,,2018,6,1,CHECK_CASHING,15000000.0,C886888353
21357,1196428',2018-06-01,TRF FROM  Indiaforensic SERVICES,0.0,3900000.0,,2018,6,1,CASH_IN,3900000.0,C701279123
21358,1196428',2018-06-01,RTGS/SBINH18152037993/TAR,0.0,410000.0,,2018,6,1,CHECK_CASHING,410000.0,C864016033
21359,1196428',2018-06-01,Repayment credit [7090041,0.0,651618.0,,2018,6,1,TRANSFER,651618.0,C515442419
21360,1196428',2018-06-01,Repayment credit [7090041,0.0,104161.0,,2018,6,1,CHECK_CASHING,104161.0,M2127093801
21361,1196428',2018-06-01,Repayment credit [7090041,0.0,156086.0,,2018,6,1,CHECK_CASHING,156086.0,C1649686970
21362,1196428',2018-06-01,IMPS 815214365694 FROM AS,0.0,60161.0,,2018,6,1,TRANSFER,60161.0,C701855966
21363,1196428',2018-06-01,NEFT/AXISP18152864847/ACC,0.0,8000000.0,,2018,6,1,TRANSFER,8000000.0,C1505217516
21364,1196428',2018-06-01,RTGS/HDFCH18152513620/Indfor,0.0,4400000.0,,2018,6,1,CHECK_CASHING,4400000.0,M676875212
21365,1196428',2018-06-01,FDRL/REAL TIME GROSS SETTL,15000000.0,0.0,,2018,6,1,CASH_OUT,15000000.0,C681709819
21366,1196428',2018-06-01,FDRL/REAL TIME GROSS SETTL,15000000.0,0.0,,2018,6,1,CHECK_WITHDRAWAL,15000000.0,M1025042585
21367,1196428',2018-06-01,Indiaforensic SERVICES INDIA PVT,0.0,177287.0,,2018,6,1,CHECK_CASHING,177287.0,C807247901
21368,1196428',2018-06-01,NEFT/PUNBH18152788997/BAL,0.0,25000.0,,2018,6,1,CHECK_CASHING,25000.0,M18308448
21369,1196428',2018-06-01,RTGS/PUNBH18152936811/PUN,0.0,800000.0,,2018,6,1,CASH_IN,800000.0,M170030714
21370,1196428',2018-06-01,NEFT/SBIN518152679179/V B,0.0,50000.0,,2018,6,1,CHECK_CASHING,50000.0,M621155607
21371,1196428',2018-06-01,NEFT/SBIN518152744685/Mrs,0.0,25000.0,,2018,6,1,CASH_IN,25000.0,C1660095722
21372,1196428',2018-06-01,NEFT/N152180553908637/TEC,0.0,300000.0,,2018,6,1,TRANSFER,300000.0,M1571765149
21373,1196428',2018-06-01,RTGS/PUNBH18152941563/PUN,0.0,200000.0,,2018,6,1,TRANSFER,200000.0,C1663686815
21374,1196428',2018-06-01,NEFT/000046510416/Indiaforensic,0.0,980000.0,,2018,6,1,CHECK_CASHING,980000.0,M279824269
21375,1196428',2018-06-01,NEFT/SBIN618152042166/NAR,0.0,54273.0,,2018,6,1,CASH_IN,54273.0,M1570490488
21376,1196428',2018-06-01,NEFT/SBIN618152049582/JAI,0.0,50000.0,,2018,6,1,CHECK_CASHING,50000.0,M1063002743
21377,1196428',2018-06-01,NEFT/000046510187/Indiaforensic,0.0,1170000.0,,2018,6,1,CHECK_CASHING,1170000.0,M1530195938
21378,1196428',2018-06-01,BEAT CSH PKP DEL UDYOG 64,0.0,77000.0,,2018,6,1,TRANSFER,77000.0,C1883840933
21379,1196428',2018-06-01,TRF FROM  Indiaforensic SERVICES,0.0,8200000.0,,2018,6,1,CHECK_CASHING,8200000.0,M2097586567
21380,1196428',2018-06-01,FDRL/INTERNAL FUND TRANSFE,15000000.0,0.0,,2018,6,1,PAYEMENT,15000000.0,C1700852615
21381,1196428',2018-06-02,NEFT/IDIBH18152143031/PAL,0.0,20000.0,,2018,6,2,CASH_IN,20000.0,C1457728035
21382,1196428',2018-06-02,NEFT/SBIN618152192473/MAT,0.0,11799.1,,2018,6,2,CHECK_CASHING,11799.1,C47249488
21383,1196428',2018-06-02,RTGS/UTIBH18153646897/PER,0.0,900000.0,,2018,6,2,TRANSFER,900000.0,C33524623
21384,1196428',2018-06-02,NEFT/SBIN618153643761/M R,0.0,21000.0,,2018,6,2,CHECK_CASHING,21000.0,C2133591152
21385,1196428',2018-06-02,TATA AIG GENERAL INSURANC,1180000.0,0.0,,2018,6,2,DEBIT,1180000.0,C193864812
21386,1196428',2018-06-02,NEFT/N153180554429087/USH,0.0,119050.0,,2018,6,2,CHECK_CASHING,119050.0,C1058921154
21387,1196428',2018-06-02,CHQ DEP/277785/OWDEL1/VIJ,0.0,11800.0,,2018,6,2,CHECK_CASHING,11800.0,C798678484
21388,1196428',2018-06-02,CHQ DEP/66977/OWDEL1/UBIN,0.0,11800.0,,2018,6,2,TRANSFER,11800.0,C769342184
21389,1196428',2018-06-02,CHQ DEP/34726/OWDEL1/UBIN,0.0,11800.0,,2018,6,2,CHECK_CASHING,11800.0,C981198566
21390,1196428',2018-06-02,CHQ DEP/4646/OWDEL1/UBIN/,0.0,11800.0,,2018,6,2,CASH_IN,11800.0,C1281898359
21391,1196428',2018-06-02,CHQ DEP/322/OWDEL1/UCBA/J,0.0,11800.0,,2018,6,2,CHECK_CASHING,11800.0,C30013970
21392,1196428',2018-06-02,CHQ DEP/261/OWDEL1/UCBA/J,0.0,11800.0,,2018,6,2,CHECK_CASHING,11800.0,C31789747
21393,1196428',2018-06-02,CHQ DEP/225166/OWDEL1/BKD,0.0,11800.0,,2018,6,2,CASH_IN,11800.0,C93518808
21394,1196428',2018-06-02,CHQ DEP/827/OWDEL1/UCBA/R,0.0,11800.0,,2018,6,2,TRANSFER,11800.0,C2093546827
21395,1196428',2018-06-02,NEFT/SBIN618153714496/THA,0.0,10000.0,,2018,6,2,CHECK_CASHING,10000.0,C976133979
21396,1196428',2018-06-02,RTGS/SBINH18153035516/Indfor,0.0,1500000.0,,2018,6,2,TRANSFER,1500000.0,C849038219
21397,1196428',2018-06-02,NEFT/AXISP18153045854/ACC,0.0,8000000.0,,2018,6,2,CASH_IN,8000000.0,C1789550256
21398,1196428',2018-06-02,NEFT/BARBW18153507178/MAK,0.0,55555.0,,2018,6,2,CHECK_CASHING,55555.0,C363475076
21399,1196428',2018-06-02,TRF FROM  Indiaforensic SERVICES,0.0,500000.0,,2018,6,2,CHECK_CASHING,500000.0,C2110623348
21400,1196428',2018-06-02,TRF FROM  Indiaforensic SERVICES,0.0,2000000.0,,2018,6,2,CHECK_CASHING,2000000.0,C1161820020
21401,1196428',2018-06-02,TRF FROM  Indiaforensic SERVICES,0.0,10000000.0,,2018,6,2,CHECK_CASHING,10000000.0,C627675433
21402,1196428',2018-06-02,TRF FROM  Indiaforensic SERVICES,0.0,4000000.0,,2018,6,2,TRANSFER,4000000.0,C1145835418
21403,1196428',2018-06-02,TRF FROM  Indiaforensic SERVICES,0.0,3000000.0,,2018,6,2,CHECK_CASHING,3000000.0,C1778300121
21404,1196428',2018-06-02,TRF FROM  Indiaforensic SERVICES,0.0,3000000.0,,2018,6,2,CHECK_CASHING,3000000.0,C1325626015
21405,1196428',2018-06-02,RTGS/SBINH18153036777/Indfor,0.0,1500000.0,,2018,6,2,TRANSFER,1500000.0,C8733802
21406,1196428',2018-06-02,FDRL/REAL TIME GROSS SETTL,10000000.0,0.0,,2018,6,2,PAYEMENT,10000000.0,C990053853
21407,1196428',2018-06-02,FDRL/REAL TIME GROSS SETTL,15000000.0,0.0,,2018,6,2,PAYEMENT,15000000.0,C218193338
21408,1196428',2018-06-02,FDRL/NATIONAL ELECTRONIC F,2458646.0,0.0,,2018,6,2,DEBIT,2458646.0,M832073005
21409,1196428',2018-06-02,FDRL/NATIONAL ELECTRONIC F,2500.0,0.0,,2018,6,2,PAYEMENT,2500.0,M189083850
21410,1196428',2018-06-02,FDRL/NATIONAL ELECTRONIC F,2000.0,0.0,,2018,6,2,CHECK_WITHDRAWAL,2000.0,C103357744
21411,1196428',2018-06-02,FDRL/NATIONAL ELECTRONIC F,2000.0,0.0,,2018,6,2,CASH_OUT,2000.0,M1942890330
21412,1196428',2018-06-02,FDRL/NATIONAL ELECTRONIC F,8230.0,0.0,,2018,6,2,CHECK_WITHDRAWAL,8230.0,C2011941350
21413,1196428',2018-06-02,FDRL/NATIONAL ELECTRONIC F,12663.0,0.0,,2018,6,2,CASH_OUT,12663.0,C1505755152
21414,1196428',2018-06-02,FDRL/NATIONAL ELECTRONIC F,2500.0,0.0,,2018,6,2,CASH_OUT,2500.0,M1051118371
21415,1196428',2018-06-02,FDRL/NATIONAL ELECTRONIC F,2500.0,0.0,,2018,6,2,CHECK_WITHDRAWAL,2500.0,M1502077581
21416,1196428',2018-06-02,FDRL/NATIONAL ELECTRONIC F,3000.0,0.0,,2018,6,2,CHECK_WITHDRAWAL,3000.0,M1801625172
21417,1196428',2018-06-02,FDRL/NATIONAL ELECTRONIC F,5000.0,0.0,,2018,6,2,DEBIT,5000.0,C360898540
21418,1196428',2018-06-02,FDRL/NATIONAL ELECTRONIC F,2500.0,0.0,,2018,6,2,CHECK_WITHDRAWAL,2500.0,M1408738192
21419,1196428',2018-06-02,FDRL/NATIONAL ELECTRONIC F,2500.0,0.0,,2018,6,2,DEBIT,2500.0,C237594516
21420,1196428',2018-06-02,FDRL/NATIONAL ELECTRONIC F,2000.0,0.0,,2018,6,2,CASH_OUT,2000.0,M1645271006
21421,1196428',2018-06-02,FDRL/NATIONAL ELECTRONIC F,2000.0,0.0,,2018,6,2,DEBIT,2000.0,M1616707854
21422,1196428',2018-06-02,FDRL/NATIONAL ELECTRONIC F,2000.0,0.0,,2018,6,2,CHECK_WITHDRAWAL,2000.0,C1334973394
21423,1196428',2018-06-02,FDRL/NATIONAL ELECTRONIC F,2500.0,0.0,,2018,6,2,DEBIT,2500.0,M1547406846
21424,1196428',2018-06-02,FDRL/NATIONAL ELECTRONIC F,5000.0,0.0,,2018,6,2,PAYEMENT,5000.0,M51814511
21425,1196428',2018-06-02,FDRL/NATIONAL ELECTRONIC F,2000.0,0.0,,2018,6,2,CHECK_WITHDRAWAL,2000.0,M1679527434
21426,1196428',2018-06-02,FDRL/NATIONAL ELECTRONIC F,2000.0,0.0,,2018,6,2,CASH_OUT,2000.0,M858729243
21427,1196428',2018-06-02,FDRL/NATIONAL ELECTRONIC F,3000.0,0.0,,2018,6,2,CHECK_WITHDRAWAL,3000.0,M317858117
21428,1196428',2018-06-02,FDRL/NATIONAL ELECTRONIC F,2500.0,0.0,,2018,6,2,CASH_OUT,2500.0,M974232437
21429,1196428',2018-06-02,FDRL/NATIONAL ELECTRONIC F,10441.0,0.0,,2018,6,2,CASH_OUT,10441.0,M535001108
21430,1196428',2018-06-02,RTGS/IOBAH18153604348/ASH,0.0,200201.0,,2018,6,2,CHECK_CASHING,200201.0,M967799453
21431,1196428',2018-06-02,NEFT/BARBW18153531646/MAH,0.0,11800.0,,2018,6,2,CASH_IN,11800.0,M1704857178
21432,1196428',2018-06-02,NEFT/SBIN618153879616/NAR,0.0,52893.0,,2018,6,2,CASH_IN,52893.0,M888552844
21433,1196428',2018-06-02,UPI/815315118450/NO REMAR,0.0,10.0,,2018,6,2,TRANSFER,10.0,M257269635
21434,1196428',2018-06-02,NEFT/P18060298433713/KADU,0.0,100000.0,,2018,6,2,CHECK_CASHING,100000.0,C1305075214
21435,1196428',2018-06-02,IMPS 815316367048 FROM AS,0.0,150155.0,,2018,6,2,CASH_IN,150155.0,C1627965794
21436,1196428',2018-06-02,RTGS/HDFCH18153709856/Indfor,0.0,3000000.0,,2018,6,2,CHECK_CASHING,3000000.0,M1559676676
21437,1196428',2018-06-02,RTGS/HDFCH18153709529/Indfor,0.0,1000000.0,,2018,6,2,TRANSFER,1000000.0,C741431520
21438,1196428',2018-06-02,NEFT/N153180554668408/BAT,0.0,165000.0,,2018,6,2,CHECK_CASHING,165000.0,C2143477943
21439,1196428',2018-06-02,RTGS/PUNBH18153964063/PUN,0.0,300000.0,,2018,6,2,CHECK_CASHING,300000.0,C638551812
21440,1196428',2018-06-02,TRF FROM  Indiaforensic SERVICES,0.0,4000000.0,,2018,6,2,TRANSFER,4000000.0,C1027296777
21441,1196428',2018-06-02,NEFT/SBIN718153014192/TAR,0.0,350000.0,,2018,6,2,CHECK_CASHING,350000.0,C1554540309
21442,1196428',2018-06-02,CHQ DEPOSIT RETURN/322/OT,11800.0,0.0,,2018,6,2,DEBIT,11800.0,M2120427827
21443,1196428',2018-06-02,CHQ DEPOSIT RETURN/261/OT,11800.0,0.0,,2018,6,2,DEBIT,11800.0,C820910648
21444,1196428',2018-06-02,CHQ DEPOSIT RETURN/827/OT,11800.0,0.0,,2018,6,2,PAYEMENT,11800.0,M415456371
21445,1196428',2018-06-02,NEFT/000046571943/Indiaforensic,0.0,500000.0,,2018,6,2,CHECK_CASHING,500000.0,M598340030
21446,1196428',2018-06-02,NEFT/000046573670/Indiaforensic,0.0,500000.0,,2018,6,2,CHECK_CASHING,500000.0,C345679794
21447,1196428',2018-06-02,NEFT/000046572120/Indiaforensic,0.0,500000.0,,2018,6,2,CHECK_CASHING,500000.0,M1605050346
21448,1196428',2018-06-02,NEFT/000046572018/Indiaforensic,0.0,500000.0,,2018,6,2,TRANSFER,500000.0,C1144070975
21449,1196428',2018-06-02,FDRL/INTERNAL FUND TRANSFE,7000000.0,0.0,,2018,6,2,DEBIT,7000000.0,M639999796
21450,1196428',2018-06-02,FDRL/INTERNAL FUND TRANSFE,4000000.0,0.0,,2018,6,2,PAYEMENT,4000000.0,C343534938
21451,1196428',2018-06-02,FDRL/INTERNAL FUND TRANSFE,6000000.0,0.0,,2018,6,2,CHECK_WITHDRAWAL,6000000.0,M479872561
21452,1196428',2018-06-02,NEFT/000046569840/Indiaforensic,0.0,2000000.0,,2018,6,2,TRANSFER,2000000.0,M61732893
21453,1196428',2018-06-02,BEAT CSH PKP DEL UDYOG 64,0.0,105000.0,,2018,6,2,CASH_IN,105000.0,C160632822
21454,1196428',2018-06-02,FDRL/INTERNAL FUND TRANSFE,1000000.0,0.0,,2018,6,2,CASH_OUT,1000000.0,C1183266411
21455,1196428',2018-06-02,FDRL/INTERNAL FUND TRANSFE,500000.0,0.0,,2018,6,2,PAYEMENT,500000.0,M1328778262
21456,1196428',2018-06-02,FDRL/INTERNAL FUND TRANSFE,1000000.0,0.0,,2018,6,2,DEBIT,1000000.0,M704806959
21457,1196428',2018-06-04,RTGS/UTIBH18155680704/PER,0.0,600000.0,,2018,6,4,TRANSFER,600000.0,C229313132
21458,1196428',2018-06-04,NEFT/SBIN718155394186/NAR,0.0,52837.0,,2018,6,4,CASH_IN,52837.0,M325906300
21459,1196428',2018-06-04,RTGS/SBINH18155003453/Indfor,0.0,14900000.0,,2018,6,4,CHECK_CASHING,14900000.0,M1267748122
21460,1196428',2018-06-04,FDRL/NATIONAL ELECTRONIC F,3597006.0,0.0,,2018,6,4,CASH_OUT,3597006.0,M159739450
21461,1196428',2018-06-04,FDRL/NATIONAL ELECTRONIC F,3293625.0,0.0,,2018,6,4,CHECK_WITHDRAWAL,3293625.0,M1702289141
21462,1196428',2018-06-04,FDRL/REAL TIME GROSS SETTL,5000000.0,0.0,,2018,6,4,CHECK_WITHDRAWAL,5000000.0,C1200612373
21463,1196428',2018-06-04,FDRL/REAL TIME GROSS SETTL,1000000.0,0.0,,2018,6,4,DEBIT,1000000.0,C1840046890
21464,1196428',2018-06-04,FDRL/REAL TIME GROSS SETTL,2000000.0,0.0,,2018,6,4,DEBIT,2000000.0,M1261751850
21465,1196428',2018-06-04,NEFT/SBIN718155501742/THA,0.0,20000.0,,2018,6,4,TRANSFER,20000.0,M1535970431
21466,1196428',2018-06-04,NEFT/N155180555304942/USH,0.0,175595.0,,2018,6,4,CHECK_CASHING,175595.0,M524251983
21467,1196428',2018-06-04,RTGS/ICICH18155392126/Indfor,0.0,7500000.0,,2018,6,4,TRANSFER,7500000.0,C1406749291
21468,1196428',2018-06-04,CHQ DEP/462740/OWDEL2/SBI,0.0,11800.0,,2018,6,4,CHECK_CASHING,11800.0,C1415645767
21469,1196428',2018-06-04,CHQ DEP/21936/OWDEL2/CBIN,0.0,11800.0,,2018,6,4,TRANSFER,11800.0,M1816834020
21470,1196428',2018-06-04,CHQ DEP/966666/OWDEL2/ORB,0.0,11800.0,,2018,6,4,CASH_IN,11800.0,C1732292969
21471,1196428',2018-06-04,CHQ DEP/397106/OWDEL2/SBI,0.0,11800.0,,2018,6,4,CASH_IN,11800.0,M1739764490
21472,1196428',2018-06-04,NEFT/N155180555402507/USH,0.0,72800.0,,2018,6,4,CHECK_CASHING,72800.0,M1664129150
21473,1196428',2018-06-04,CHQ DEP/240723/OWDEL1/SBI,0.0,11800.0,,2018,6,4,CASH_IN,11800.0,M1128852062
21474,1196428',2018-06-04,CHQ DEP/73193/OWDEL1/SBIN,0.0,11800.0,,2018,6,4,TRANSFER,11800.0,M182471589
21475,1196428',2018-06-04,CHQ DEP/430/OWDEL1/UCBA/B,0.0,11800.0,,2018,6,4,TRANSFER,11800.0,M1056074872
21476,1196428',2018-06-04,CHQ DEP/168806/OWDEL1/ICI,0.0,11800.0,,2018,6,4,CHECK_CASHING,11800.0,M2106622700
21477,1196428',2018-06-04,CHQ DEP/456670/OWDEL1/PUN,0.0,11800.0,,2018,6,4,CHECK_CASHING,11800.0,M163766295
21478,1196428',2018-06-04,CHQ DEP/579514/OWDEL1/PUN,0.0,8260.0,,2018,6,4,TRANSFER,8260.0,M802332120
21479,1196428',2018-06-04,CHQ DEP/478249/OWDEL1/JAK,0.0,11800.0,,2018,6,4,CHECK_CASHING,11800.0,M1676185662
21480,1196428',2018-06-04,CHQ DEP/40775/OWDEL1/JAKA,0.0,11800.0,,2018,6,4,CASH_IN,11800.0,M1776427379
21481,1196428',2018-06-04,CHQ DEP/48511/OWDEL1/JAKA,0.0,11800.0,,2018,6,4,CASH_IN,11800.0,M334173295
21482,1196428',2018-06-04,CHQ DEP/878215/OWDEL1/JAK,0.0,11800.0,,2018,6,4,TRANSFER,11800.0,M330490124
21483,1196428',2018-06-04,CHQ DEP/52/OWDEL1/HDFC/HU,0.0,11800.0,,2018,6,4,CASH_IN,11800.0,M1154845973
21484,1196428',2018-06-04,CHQ DEP/5783/OWDEL1/SBIN/,0.0,11800.0,,2018,6,4,CASH_IN,11800.0,M911987264
21485,1196428',2018-06-04,CHQ DEP/382580/OWDEL1/JAK,0.0,11800.0,,2018,6,4,CHECK_CASHING,11800.0,M1680147473
21486,1196428',2018-06-04,CHQ DEP/270854/OWDEL1/JAK,0.0,11800.0,,2018,6,4,CHECK_CASHING,11800.0,M293659205
21487,1196428',2018-06-04,CHQ DEP/241961/OWDEL1/JAK,0.0,11800.0,,2018,6,4,CASH_IN,11800.0,M1432093328
21488,1196428',2018-06-04,NEFT/CSBKN18155003870/GAN,0.0,11800.0,,2018,6,4,CHECK_CASHING,11800.0,M901262414
21489,1196428',2018-06-04,FDRL/REAL TIME GROSS SETTL,2000000.0,0.0,,2018,6,4,CASH_OUT,2000000.0,M899962047
21490,1196428',2018-06-04,FDRL/REAL TIME GROSS SETTL,5000000.0,0.0,,2018,6,4,CASH_OUT,5000000.0,M32715716
21491,1196428',2018-06-04,NEFT/N155180555438996/VIJ,0.0,11800.0,,2018,6,4,CHECK_CASHING,11800.0,M1510311379
21492,1196428',2018-06-04,FDRL/REAL TIME GROSS SETTL,1000000.0,0.0,,2018,6,4,DEBIT,1000000.0,M1517206841
21493,1196428',2018-06-04,TRF FROM  Indiaforensic SERVICES,0.0,15000000.0,,2018,6,4,CHECK_CASHING,15000000.0,M2030024765
21494,1196428',2018-06-04,TRF FROM  Indiaforensic SERVICES,0.0,15000000.0,,2018,6,4,CASH_IN,15000000.0,M1267580132
21495,1196428',2018-06-04,TRF FROM  Indiaforensic SERVICES,0.0,2000000.0,,2018,6,4,CHECK_CASHING,2000000.0,C655391383
21496,1196428',2018-06-04,NEFT/N155180555523664/USH,0.0,115500.0,,2018,6,4,CASH_IN,115500.0,C2117215775
21497,1196428',2018-06-04,FDRL/REAL TIME GROSS SETTL,15000000.0,0.0,,2018,6,4,CHECK_WITHDRAWAL,15000000.0,C2106576360
21498,1196428',2018-06-04,FDRL/REAL TIME GROSS SETTL,15000000.0,0.0,,2018,6,4,PAYEMENT,15000000.0,M267789972
21499,1196428',2018-06-04,FDRL/REAL TIME GROSS SETTL,2000000.0,0.0,,2018,6,4,PAYEMENT,2000000.0,M292960678
21500,1196428',2018-06-04,NEFT/N155180555560266/TEC,0.0,200000.0,,2018,6,4,TRANSFER,200000.0,C1638372110
21501,1196428',2018-06-04,NEFT/N155180555589339/BAT,0.0,150000.0,,2018,6,4,CASH_IN,150000.0,C1377774115
21502,1196428',2018-06-04,"Indiaforensic USA, INC./USD/1090",0.0,726684.95,,2018,6,4,CHECK_CASHING,726684.95,M1877845145
21503,1196428',2018-06-04,IRTT00701816517,1039.02,0.0,,2018,6,4,CHECK_WITHDRAWAL,1039.02,M869149988
21504,1196428',2018-06-04,NEFT/BARBX18155030922/THE,0.0,11800.0,,2018,6,4,TRANSFER,11800.0,M1324498984
21505,1196428',2018-06-04,FDRL/INTERNAL FUND TRANSFE,500000.0,0.0,,2018,6,4,CASH_OUT,500000.0,C748014372
21506,1196428',2018-06-04,NEFT/SBIN718155931989/LAL,0.0,50000.0,,2018,6,4,CHECK_CASHING,50000.0,M1556526073
21507,1196428',2018-06-04,NEFT/N155180555724900/USH,0.0,30000.0,,2018,6,4,CASH_IN,30000.0,M1113797896
21508,1196428',2018-06-04,NEFT/SBIN718155990894/TAR,0.0,150000.0,,2018,6,4,CASH_IN,150000.0,M111103216
21509,1196428',2018-06-04,RTGS/PUNBH18155983028/PUN,0.0,400000.0,,2018,6,4,CASH_IN,400000.0,M402054040
21510,1196428',2018-06-04,NEFT/FDRLH18155769962/RAN,0.0,20000.0,,2018,6,4,CHECK_CASHING,20000.0,C1174935745
21511,1196428',2018-06-04,RTGS/HDFCH18155904353/Indfor,0.0,8000000.0,,2018,6,4,CASH_IN,8000000.0,M3128155
21512,1196428',2018-06-04,NEFT/N155180555951741/TEC,0.0,300000.0,,2018,6,4,CHECK_CASHING,300000.0,M804435874
21513,1196428',2018-06-04,NEFT/P18060437625709/K T,0.0,500.0,,2018,6,4,CHECK_CASHING,500.0,M22524150
21514,1196428',2018-06-04,BEAT CSH PKP DEL UDYOG 64,0.0,216000.0,,2018,6,4,TRANSFER,216000.0,C717951588
21515,1196428',2018-06-04,NEFT/000046649387/Indiaforensic,0.0,3700000.0,,2018,6,4,CASH_IN,3700000.0,M994429804
21516,1196428',2018-06-04,TRF FROM  Indiaforensic SERVICES,0.0,10600000.0,,2018,6,4,CASH_IN,10600000.0,M42960844
21517,1196428',2018-06-04,TRF TO  Indiaforensic SERVICES I,24000.0,0.0,,2018,6,4,DEBIT,24000.0,M117897905
21518,1196428',2018-06-04,FDRL/INTERNAL FUND TRANSFE,4000000.0,0.0,,2018,6,4,DEBIT,4000000.0,M919103236
21519,1196428',2018-06-04,FDRL/INTERNAL FUND TRANSFE,6000000.0,0.0,,2018,6,4,CHECK_WITHDRAWAL,6000000.0,M2117556230
21520,1196428',2018-06-04,FDRL/INTERNAL FUND TRANSFE,3000000.0,0.0,,2018,6,4,CASH_OUT,3000000.0,M2047174428
21521,1196428',2018-06-04,FDRL/INTERNAL FUND TRANSFE,1000000.0,0.0,,2018,6,4,CASH_OUT,1000000.0,M1468774738
21522,1196428',2018-06-04,FDRL/INTERNAL FUND TRANSFE,2000000.0,0.0,,2018,6,4,CHECK_WITHDRAWAL,2000000.0,M266577647
21523,1196428',2018-06-05,NEFT/PUNBH18156382119/BAL,0.0,50000.0,,2018,6,5,CHECK_CASHING,50000.0,M1474343674
21524,1196428',2018-06-05,FDRL/REAL TIME GROSS SETTL,5000000.0,0.0,,2018,6,5,CASH_OUT,5000000.0,M1664266643
21525,1196428',2018-06-05,FDRL/NATIONAL ELECTRONIC F,2806600.0,0.0,,2018,6,5,PAYEMENT,2806600.0,M842463018
21526,1196428',2018-06-05,Indiaforensic SERVICES INDIA PVT,0.0,496220.0,,2018,6,5,CHECK_CASHING,496220.0,M284325832
21527,1196428',2018-06-05,NEFT/N156180556241888/USH,0.0,77990.0,,2018,6,5,TRANSFER,77990.0,M1784760424
21528,1196428',2018-06-05,NEFT/P18060554128023/K T,0.0,100.0,,2018,6,5,CASH_IN,100.0,M1489026763
21529,1196428',2018-06-05,NEFT/N156180556323834/USH,0.0,99985.0,,2018,6,5,CHECK_CASHING,99985.0,C1800405372
21530,1196428',2018-06-05,RTGS/HDFCH18156973702/JUN,0.0,200000.0,,2018,6,5,TRANSFER,200000.0,C2071512077
21531,1196428',2018-06-05,RTGS/UTIBH18156644546/PER,0.0,900000.0,,2018,6,5,TRANSFER,900000.0,C1588635270
21532,1196428',2018-06-05,NEFT/SAA48180626/M K SYED,0.0,5000.0,,2018,6,5,CHECK_CASHING,5000.0,C1495001462
21533,1196428',2018-06-05,NEFT/N156180556386027/USH,0.0,55900.0,,2018,6,5,TRANSFER,55900.0,M84558619
21534,1196428',2018-06-05,NEFT/SBIN818156749278/THA,0.0,105000.0,,2018,6,5,CHECK_CASHING,105000.0,M113925453
21535,1196428',2018-06-05,CHQ DEP/322/OWDEL1/UCBA/J,0.0,11800.0,,2018,6,5,TRANSFER,11800.0,M645245228
21536,1196428',2018-06-05,CHQ DEP/261/OWDEL1/UCBA/J,0.0,11800.0,,2018,6,5,CASH_IN,11800.0,M636094317
21537,1196428',2018-06-05,CHQ DEP/827/OWDEL1/UCBA/R,0.0,11800.0,,2018,6,5,TRANSFER,11800.0,M1583961850
21538,1196428',2018-06-05,NEFT/BARBX18156414639/MAK,0.0,66666.0,,2018,6,5,CHECK_CASHING,66666.0,M708029389
21539,1196428',2018-06-05,TRF FROM  Indiaforensic SERVICES,0.0,10000000.0,,2018,6,5,TRANSFER,10000000.0,M508231066
21540,1196428',2018-06-05,TRF FROM  Indiaforensic SERVICES,0.0,10000000.0,,2018,6,5,CASH_IN,10000000.0,C1838491463
21541,1196428',2018-06-05,FDRL/REAL TIME GROSS SETTL,10000000.0,0.0,,2018,6,5,DEBIT,10000000.0,M1094448975
21542,1196428',2018-06-05,FDRL/REAL TIME GROSS SETTL,10000000.0,0.0,,2018,6,5,PAYEMENT,10000000.0,M717841651
21543,1196428',2018-06-05,FDRL/REAL TIME GROSS SETTL,1000000.0,0.0,,2018,6,5,PAYEMENT,1000000.0,M1954167102
21544,1196428',2018-06-05,FDRL/REAL TIME GROSS SETTL,2000000.0,0.0,,2018,6,5,CHECK_WITHDRAWAL,2000000.0,M1043087369
21545,1196428',2018-06-05,RTGS/PUNBH18156002190/PUN,0.0,450000.0,,2018,6,5,TRANSFER,450000.0,M1489610760
21546,1196428',2018-06-05,RTGS/HDFCH18156088475/Indfor,0.0,7900000.0,,2018,6,5,CHECK_CASHING,7900000.0,C1556875182
21547,1196428',2018-06-05,NEFT/SBIN918156132934/SAG,0.0,11800.0,,2018,6,5,TRANSFER,11800.0,M1109811596
21548,1196428',2018-06-05,NEFT/N156180556881463/TEC,0.0,300000.0,,2018,6,5,CHECK_CASHING,300000.0,C101571284
21549,1196428',2018-06-05,NEFT/000046708649/Indiaforensic,0.0,1400000.0,,2018,6,5,TRANSFER,1400000.0,M178952563
21550,1196428',2018-06-05,NEFT/000046708210/Indiaforensic,0.0,1300000.0,,2018,6,5,TRANSFER,1300000.0,M2081263541
21551,1196428',2018-06-05,FDRL/INTERNAL FUND TRANSFE,6000000.0,0.0,,2018,6,5,PAYEMENT,6000000.0,C2078250226
21552,1196428',2018-06-05,FDRL/INTERNAL FUND TRANSFE,5000000.0,0.0,,2018,6,5,CHECK_WITHDRAWAL,5000000.0,C1570256460
21553,1196428',2018-06-05,BEAT CSH PKP DEL UDYOG 64,0.0,184000.0,,2018,6,5,TRANSFER,184000.0,M441055416
21554,1196428',2018-06-05,TRF FROM  Indiaforensic SERVICES,0.0,6700000.0,,2018,6,5,TRANSFER,6700000.0,C2077098348
21555,1196428',2018-06-05,FDRL/INTERNAL FUND TRANSFE,6000000.0,0.0,,2018,6,5,CASH_OUT,6000000.0,C1062254208
21556,1196428',2018-06-06,FDRL/NATIONAL ELECTRONIC F,5342.0,0.0,,2018,6,6,CASH_OUT,5342.0,C1787868648
21557,1196428',2018-06-06,Indiaforensic SERVICES INDIA PVT,0.0,208556.0,,2018,6,6,CASH_IN,208556.0,C161140376
21558,1196428',2018-06-06,CASHDEP/VIKASMARG/TP,0.0,112000.0,,2018,6,6,TRANSFER,112000.0,M1471351873
21559,1196428',2018-06-06,NEFT/N157180557275818/USH,0.0,23000.0,,2018,6,6,CHECK_CASHING,23000.0,M1328437771
21560,1196428',2018-06-06,TRF FROM  Indiaforensic SERVICES,0.0,2000000.0,,2018,6,6,TRANSFER,2000000.0,M341537411
21561,1196428',2018-06-06,FDRL/NATIONAL ELECTRONIC F,2200497.0,0.0,,2018,6,6,CHECK_WITHDRAWAL,2200497.0,M1367049026
21562,1196428',2018-06-06,NEFT/N157180557295550/RAN,0.0,11800.0,,2018,6,6,CASH_IN,11800.0,C2029310301
21563,1196428',2018-06-06,CHQ DEP/500233/OWWEST1/PK,0.0,11800.0,,2018,6,6,CHECK_CASHING,11800.0,C1606699851
21564,1196428',2018-06-06,FDRL/INTERNAL FUND TRANSFE,500000.0,0.0,,2018,6,6,CASH_OUT,500000.0,C1103621993
21565,1196428',2018-06-06,FDRL/INTERNAL FUND TRANSFE,500000.0,0.0,,2018,6,6,DEBIT,500000.0,M34447014
21566,1196428',2018-06-06,TRF FROM  Indiaforensic SERVICES,0.0,15000000.0,,2018,6,6,CHECK_CASHING,15000000.0,C1428675504
21567,1196428',2018-06-06,TRF FROM  Indiaforensic SERVICES,0.0,4500000.0,,2018,6,6,TRANSFER,4500000.0,M1783999682
21568,1196428',2018-06-06,NEFT/SBIN118157005096/NAR,0.0,52923.0,,2018,6,6,TRANSFER,52923.0,C1247600089
21569,1196428',2018-06-06,RTGS/DLXBH18157500435/KAD,0.0,200000.0,,2018,6,6,CASH_IN,200000.0,M835388411
21570,1196428',2018-06-06,FDRL/REAL TIME GROSS SETTL,10000000.0,0.0,,2018,6,6,CASH_OUT,10000000.0,C404279307
21571,1196428',2018-06-06,FDRL/REAL TIME GROSS SETTL,10000000.0,0.0,,2018,6,6,CHECK_WITHDRAWAL,10000000.0,C278407008
21572,1196428',2018-06-06,NEFT/SBIN118157100850/BHO,0.0,11800.0,,2018,6,6,CASH_IN,11800.0,M1721234210
21573,1196428',2018-06-06,"Indiaforensic USA, INC./USD/1962",0.0,1309772.5,,2018,6,6,CASH_IN,1309772.5,M1576908104
21574,1196428',2018-06-06,IRTT00701816819,1340.76,0.0,,2018,6,6,DEBIT,1340.76,M1547162536
21575,1196428',2018-06-06,NEFT/N157180557714857/BAT,0.0,100000.0,,2018,6,6,CASH_IN,100000.0,M1057827479
21576,1196428',2018-06-06,RTGS/PUNBH18157022692/PUN,0.0,400000.0,,2018,6,6,CHECK_CASHING,400000.0,M1498878973
21577,1196428',2018-06-06,RTGS/SBINH18157061940/TAR,0.0,350000.0,,2018,6,6,CHECK_CASHING,350000.0,M1420281457
21578,1196428',2018-06-06,RTGS/HDFCH18157267409/Indfor,0.0,6800000.0,,2018,6,6,CASH_IN,6800000.0,M2000558609
21579,1196428',2018-06-06,IMPS 815716340352 FROM AS,0.0,100101.0,,2018,6,6,CHECK_CASHING,100101.0,M1598229594
21580,1196428',2018-06-06,NEFT/000046791552/Indiaforensic,0.0,1400000.0,,2018,6,6,TRANSFER,1400000.0,M2001514483
21581,1196428',2018-06-06,TRF TO  Indiaforensic SERVICES I,2140000.0,0.0,,2018,6,6,DEBIT,2140000.0,M1808413339
21582,1196428',2018-06-06,TRF FROM  Indiaforensic SERVICES,0.0,4000000.0,,2018,6,6,CHECK_CASHING,4000000.0,M662376084
21583,1196428',2018-06-06,TRF FROM  Indiaforensic SERVICES,0.0,500000.0,,2018,6,6,CASH_IN,500000.0,M1462583713
21584,1196428',2018-06-06,NEFT/AXISP18157128823/ACC,0.0,1000000.0,,2018,6,6,TRANSFER,1000000.0,M1292178703
21585,1196428',2018-06-06,NEFT/000046791356/Indiaforensic,0.0,1600000.0,,2018,6,6,CASH_IN,1600000.0,M1378894443
21586,1196428',2018-06-06,FDRL/INTERNAL FUND TRANSFE,6000000.0,0.0,,2018,6,6,CHECK_WITHDRAWAL,6000000.0,M671194471
21587,1196428',2018-06-06,FDRL/INTERNAL FUND TRANSFE,5000000.0,0.0,,2018,6,6,DEBIT,5000000.0,M2120887477
21588,1196428',2018-06-06,FDRL/INTERNAL FUND TRANSFE,1000000.0,0.0,,2018,6,6,DEBIT,1000000.0,M1565473666
21589,1196428',2018-06-06,BEAT CSH PKP DEL UDYOG 64,0.0,55000.0,,2018,6,6,CASH_IN,55000.0,M336600403
21590,1196428',2018-06-07,RTGS/UTIBH18158621094/PER,0.0,900000.0,,2018,6,7,CASH_IN,900000.0,M1108314788
21591,1196428',2018-06-07,FDRL/NATIONAL ELECTRONIC F,100000.0,0.0,,2018,6,7,CASH_OUT,100000.0,M1776708407
21592,1196428',2018-06-07,FDRL/NATIONAL ELECTRONIC F,3985017.0,0.0,,2018,6,7,DEBIT,3985017.0,M1886072816
21593,1196428',2018-06-07,NEFT/N158180558243822/USH,0.0,20000.0,,2018,6,7,CASH_IN,20000.0,M392269298
21594,1196428',2018-06-07,NEFT/SBIN118158681352/M R,0.0,31000.0,,2018,6,7,TRANSFER,31000.0,M240263357
21595,1196428',2018-06-07,"Indiaforensic USA, INC./USD/1249",0.0,83347.77,,2018,6,7,CASH_IN,83347.77,M2137827177
21596,1196428',2018-06-07,IRTT00701816890,445.03,0.0,,2018,6,7,PAYEMENT,445.03,M996688653
21597,1196428',2018-06-07,NEFT/IDIBH18158429441/PAL,0.0,20000.0,,2018,6,7,TRANSFER,20000.0,C1829831147
21598,1196428',2018-06-07,TRF FRM  Indiaforensic SERVICES,0.0,15000000.0,,2018,6,7,TRANSFER,15000000.0,M720435458
21599,1196428',2018-06-07,TRF FROM  Indiaforensic SERVICES,0.0,4000000.0,,2018,6,7,TRANSFER,4000000.0,M29096009
21600,1196428',2018-06-07,TRF FROM  Indiaforensic SERVICES,0.0,1000000.0,,2018,6,7,CASH_IN,1000000.0,M150995440
21601,1196428',2018-06-07,FDRL/REAL TIME GROSS SETTL,10000000.0,0.0,,2018,6,7,CHECK_WITHDRAWAL,10000000.0,M1241251535
21602,1196428',2018-06-07,FDRL/REAL TIME GROSS SETTL,10000000.0,0.0,,2018,6,7,CASH_OUT,10000000.0,M1254542588
21603,1196428',2018-06-07,RTGS/PUNBH18158037857/PUN,0.0,300000.0,,2018,6,7,TRANSFER,300000.0,M710538853
21604,1196428',2018-06-07,NEFT/SBIN118158965160/SRE,0.0,11800.0,,2018,6,7,CASH_IN,11800.0,M399672840
21605,1196428',2018-06-07,NEFT/N158180558776652/TEC,0.0,100000.0,,2018,6,7,TRANSFER,100000.0,M1566931514
21606,1196428',2018-06-07,RTGS/HDFCH18158434889/Indfor,0.0,6700000.0,,2018,6,7,CASH_IN,6700000.0,C1540270363
21607,1196428',2018-06-07,NEFT/AXISP18158093104/ACC,0.0,4500000.0,,2018,6,7,CHECK_CASHING,4500000.0,C900425684
21608,1196428',2018-06-07,NEFT/N158180558686482/BAT,0.0,13000.0,,2018,6,7,CHECK_CASHING,13000.0,M1361294362
21609,1196428',2018-06-07,FDRL/NATIONAL ELECTRONIC F,28602.0,0.0,,2018,6,7,CASH_OUT,28602.0,C264843581
21610,1196428',2018-06-07,FDRL/NATIONAL ELECTRONIC F,21102.0,0.0,,2018,6,7,CHECK_WITHDRAWAL,21102.0,M1897445965
21611,1196428',2018-06-07,FDRL/NATIONAL ELECTRONIC F,17068.0,0.0,,2018,6,7,PAYEMENT,17068.0,M345439288
21612,1196428',2018-06-07,FDRL/NATIONAL ELECTRONIC F,27696.0,0.0,,2018,6,7,PAYEMENT,27696.0,M2130477201
21613,1196428',2018-06-07,FDRL/NATIONAL ELECTRONIC F,501.0,0.0,,2018,6,7,CASH_OUT,501.0,M1516263359
21614,1196428',2018-06-07,FDRL/NATIONAL ELECTRONIC F,14521.0,0.0,,2018,6,7,PAYEMENT,14521.0,M508839235
21615,1196428',2018-06-07,FDRL/NATIONAL ELECTRONIC F,27860.0,0.0,,2018,6,7,CHECK_WITHDRAWAL,27860.0,M530611995
21616,1196428',2018-06-07,FDRL/NATIONAL ELECTRONIC F,27722.0,0.0,,2018,6,7,PAYEMENT,27722.0,C1761324386
21617,1196428',2018-06-07,FDRL/NATIONAL ELECTRONIC F,22961.0,0.0,,2018,6,7,CHECK_WITHDRAWAL,22961.0,C90486891
21618,1196428',2018-06-07,FDRL/NATIONAL ELECTRONIC F,29293.0,0.0,,2018,6,7,CASH_OUT,29293.0,C573200870
21619,1196428',2018-06-07,FDRL/NATIONAL ELECTRONIC F,1983.0,0.0,,2018,6,7,PAYEMENT,1983.0,C1825992554
21620,1196428',2018-06-07,FDRL/NATIONAL ELECTRONIC F,26350.0,0.0,,2018,6,7,CASH_OUT,26350.0,M1278682262
21621,1196428',2018-06-07,FDRL/NATIONAL ELECTRONIC F,22885.0,0.0,,2018,6,7,PAYEMENT,22885.0,M2009652577
21622,1196428',2018-06-07,FDRL/NATIONAL ELECTRONIC F,14986.0,0.0,,2018,6,7,PAYEMENT,14986.0,M1504904868
21623,1196428',2018-06-07,FDRL/NATIONAL ELECTRONIC F,29401.0,0.0,,2018,6,7,CASH_OUT,29401.0,C88226327
21624,1196428',2018-06-07,FDRL/NATIONAL ELECTRONIC F,24258.0,0.0,,2018,6,7,CHECK_WITHDRAWAL,24258.0,M203497386
21625,1196428',2018-06-07,FDRL/NATIONAL ELECTRONIC F,4464.0,0.0,,2018,6,7,CASH_OUT,4464.0,M1264078907
21626,1196428',2018-06-07,FDRL/NATIONAL ELECTRONIC F,26400.0,0.0,,2018,6,7,PAYEMENT,26400.0,M1870838648
21627,1196428',2018-06-07,FDRL/NATIONAL ELECTRONIC F,25626.0,0.0,,2018,6,7,CASH_OUT,25626.0,C1683963531
21628,1196428',2018-06-07,FDRL/NATIONAL ELECTRONIC F,25192.0,0.0,,2018,6,7,CHECK_WITHDRAWAL,25192.0,M620120832
21629,1196428',2018-06-07,FDRL/NATIONAL ELECTRONIC F,22311.0,0.0,,2018,6,7,PAYEMENT,22311.0,M37714710
21630,1196428',2018-06-07,FDRL/NATIONAL ELECTRONIC F,22703.0,0.0,,2018,6,7,DEBIT,22703.0,M1135370372
21631,1196428',2018-06-07,FDRL/NATIONAL ELECTRONIC F,19895.0,0.0,,2018,6,7,DEBIT,19895.0,C1700355047
21632,1196428',2018-06-07,FDRL/NATIONAL ELECTRONIC F,13452.0,0.0,,2018,6,7,PAYEMENT,13452.0,C1884600481
21633,1196428',2018-06-07,FDRL/NATIONAL ELECTRONIC F,22258.0,0.0,,2018,6,7,DEBIT,22258.0,C1105527690
21634,1196428',2018-06-07,FDRL/NATIONAL ELECTRONIC F,29480.0,0.0,,2018,6,7,CASH_OUT,29480.0,M714819629
21635,1196428',2018-06-07,FDRL/NATIONAL ELECTRONIC F,28594.0,0.0,,2018,6,7,CASH_OUT,28594.0,M722465639
21636,1196428',2018-06-07,FDRL/NATIONAL ELECTRONIC F,29076.0,0.0,,2018,6,7,DEBIT,29076.0,C801412408
21637,1196428',2018-06-07,FDRL/NATIONAL ELECTRONIC F,20529.0,0.0,,2018,6,7,CASH_OUT,20529.0,M1678349105
21638,1196428',2018-06-07,FDRL/NATIONAL ELECTRONIC F,56775.0,0.0,,2018,6,7,CASH_OUT,56775.0,C35534346
21639,1196428',2018-06-07,FDRL/NATIONAL ELECTRONIC F,18314.0,0.0,,2018,6,7,PAYEMENT,18314.0,C943166837
21640,1196428',2018-06-07,FDRL/NATIONAL ELECTRONIC F,26855.0,0.0,,2018,6,7,CASH_OUT,26855.0,M1063088470
21641,1196428',2018-06-07,FDRL/NATIONAL ELECTRONIC F,44543.0,0.0,,2018,6,7,CHECK_WITHDRAWAL,44543.0,M634480856
21642,1196428',2018-06-07,FDRL/NATIONAL ELECTRONIC F,19056.0,0.0,,2018,6,7,DEBIT,19056.0,M1229660324
21643,1196428',2018-06-07,FDRL/NATIONAL ELECTRONIC F,58685.0,0.0,,2018,6,7,CASH_OUT,58685.0,M1995775202
21644,1196428',2018-06-07,FDRL/NATIONAL ELECTRONIC F,66624.0,0.0,,2018,6,7,CHECK_WITHDRAWAL,66624.0,M982735022
21645,1196428',2018-06-07,FDRL/NATIONAL ELECTRONIC F,18802.0,0.0,,2018,6,7,PAYEMENT,18802.0,C1754722089
21646,1196428',2018-06-07,FDRL/NATIONAL ELECTRONIC F,35973.0,0.0,,2018,6,7,DEBIT,35973.0,M536571624
21647,1196428',2018-06-07,FDRL/NATIONAL ELECTRONIC F,58890.0,0.0,,2018,6,7,CASH_OUT,58890.0,C1498878963
21648,1196428',2018-06-07,FDRL/NATIONAL ELECTRONIC F,18552.0,0.0,,2018,6,7,DEBIT,18552.0,C1962165946
21649,1196428',2018-06-07,FDRL/NATIONAL ELECTRONIC F,31044.0,0.0,,2018,6,7,CHECK_WITHDRAWAL,31044.0,M1170462195
21650,1196428',2018-06-07,FDRL/NATIONAL ELECTRONIC F,84634.0,0.0,,2018,6,7,DEBIT,84634.0,C414205222
21651,1196428',2018-06-07,FDRL/NATIONAL ELECTRONIC F,46213.0,0.0,,2018,6,7,CASH_OUT,46213.0,M1229413386
21652,1196428',2018-06-07,FDRL/NATIONAL ELECTRONIC F,64007.0,0.0,,2018,6,7,PAYEMENT,64007.0,M712447692
21653,1196428',2018-06-07,FDRL/NATIONAL ELECTRONIC F,32713.0,0.0,,2018,6,7,PAYEMENT,32713.0,C269902384
21654,1196428',2018-06-07,FDRL/NATIONAL ELECTRONIC F,65108.0,0.0,,2018,6,7,CASH_OUT,65108.0,C955097010
21655,1196428',2018-06-07,FDRL/NATIONAL ELECTRONIC F,76348.0,0.0,,2018,6,7,DEBIT,76348.0,C1827996167
21656,1196428',2018-06-07,FDRL/NATIONAL ELECTRONIC F,33351.0,0.0,,2018,6,7,DEBIT,33351.0,M30162194
21657,1196428',2018-06-07,FDRL/NATIONAL ELECTRONIC F,35115.0,0.0,,2018,6,7,CHECK_WITHDRAWAL,35115.0,C1115240385
21658,1196428',2018-06-07,FDRL/NATIONAL ELECTRONIC F,35751.0,0.0,,2018,6,7,CHECK_WITHDRAWAL,35751.0,M1710595137
21659,1196428',2018-06-07,FDRL/NATIONAL ELECTRONIC F,62557.0,0.0,,2018,6,7,CASH_OUT,62557.0,M970087106
21660,1196428',2018-06-07,FDRL/NATIONAL ELECTRONIC F,56415.0,0.0,,2018,6,7,CHECK_WITHDRAWAL,56415.0,M561635968
21661,1196428',2018-06-07,FDRL/NATIONAL ELECTRONIC F,45123.0,0.0,,2018,6,7,CASH_OUT,45123.0,C440480434
21662,1196428',2018-06-07,FDRL/NATIONAL ELECTRONIC F,33900.0,0.0,,2018,6,7,DEBIT,33900.0,C46748390
21663,1196428',2018-06-07,FDRL/NATIONAL ELECTRONIC F,18552.0,0.0,,2018,6,7,DEBIT,18552.0,M976616410
21664,1196428',2018-06-07,FDRL/NATIONAL ELECTRONIC F,64422.0,0.0,,2018,6,7,PAYEMENT,64422.0,M1796408655
21665,1196428',2018-06-07,FDRL/NATIONAL ELECTRONIC F,57389.0,0.0,,2018,6,7,PAYEMENT,57389.0,M424513770
21666,1196428',2018-06-07,FDRL/NATIONAL ELECTRONIC F,33626.0,0.0,,2018,6,7,CHECK_WITHDRAWAL,33626.0,M1867357103
21667,1196428',2018-06-07,FDRL/NATIONAL ELECTRONIC F,30944.0,0.0,,2018,6,7,DEBIT,30944.0,M215680372
21668,1196428',2018-06-07,FDRL/NATIONAL ELECTRONIC F,73091.0,0.0,,2018,6,7,CHECK_WITHDRAWAL,73091.0,M764256713
21669,1196428',2018-06-07,FDRL/NATIONAL ELECTRONIC F,19795.0,0.0,,2018,6,7,CHECK_WITHDRAWAL,19795.0,M538413261
21670,1196428',2018-06-07,FDRL/NATIONAL ELECTRONIC F,25075.0,0.0,,2018,6,7,PAYEMENT,25075.0,M942160595
21671,1196428',2018-06-07,FDRL/NATIONAL ELECTRONIC F,15596.0,0.0,,2018,6,7,CHECK_WITHDRAWAL,15596.0,M1319156415
21672,1196428',2018-06-07,FDRL/NATIONAL ELECTRONIC F,29100.0,0.0,,2018,6,7,DEBIT,29100.0,M361847129
21673,1196428',2018-06-07,FDRL/NATIONAL ELECTRONIC F,18552.0,0.0,,2018,6,7,PAYEMENT,18552.0,C1790202239
21674,1196428',2018-06-07,FDRL/NATIONAL ELECTRONIC F,31632.0,0.0,,2018,6,7,CASH_OUT,31632.0,M955868325
21675,1196428',2018-06-07,FDRL/NATIONAL ELECTRONIC F,33228.0,0.0,,2018,6,7,CASH_OUT,33228.0,M1251133153
21676,1196428',2018-06-07,FDRL/NATIONAL ELECTRONIC F,59802.0,0.0,,2018,6,7,DEBIT,59802.0,M1854311181
21677,1196428',2018-06-07,FDRL/NATIONAL ELECTRONIC F,66767.0,0.0,,2018,6,7,PAYEMENT,66767.0,C928023753
21678,1196428',2018-06-07,FDRL/NATIONAL ELECTRONIC F,25929.0,0.0,,2018,6,7,DEBIT,25929.0,M771609335
21679,1196428',2018-06-07,FDRL/NATIONAL ELECTRONIC F,21094.0,0.0,,2018,6,7,CHECK_WITHDRAWAL,21094.0,C1452722471
21680,1196428',2018-06-07,FDRL/NATIONAL ELECTRONIC F,37037.0,0.0,,2018,6,7,CHECK_WITHDRAWAL,37037.0,M1625968481
21681,1196428',2018-06-07,FDRL/NATIONAL ELECTRONIC F,32644.0,0.0,,2018,6,7,DEBIT,32644.0,M458727925
21682,1196428',2018-06-07,FDRL/NATIONAL ELECTRONIC F,21094.0,0.0,,2018,6,7,PAYEMENT,21094.0,C111210112
21683,1196428',2018-06-07,FDRL/NATIONAL ELECTRONIC F,60578.0,0.0,,2018,6,7,CHECK_WITHDRAWAL,60578.0,C464246030
21684,1196428',2018-06-07,FDRL/NATIONAL ELECTRONIC F,80277.0,0.0,,2018,6,7,CASH_OUT,80277.0,M2080752777
21685,1196428',2018-06-07,FDRL/NATIONAL ELECTRONIC F,30448.0,0.0,,2018,6,7,CHECK_WITHDRAWAL,30448.0,M1357563045
21686,1196428',2018-06-07,FDRL/NATIONAL ELECTRONIC F,47050.0,0.0,,2018,6,7,PAYEMENT,47050.0,M68500741
21687,1196428',2018-06-07,FDRL/NATIONAL ELECTRONIC F,17364.0,0.0,,2018,6,7,CASH_OUT,17364.0,C1664330755
21688,1196428',2018-06-07,FDRL/NATIONAL ELECTRONIC F,65889.0,0.0,,2018,6,7,DEBIT,65889.0,C1823014131
21689,1196428',2018-06-07,FDRL/NATIONAL ELECTRONIC F,28264.0,0.0,,2018,6,7,DEBIT,28264.0,M1293355387
21690,1196428',2018-06-07,FDRL/NATIONAL ELECTRONIC F,50588.0,0.0,,2018,6,7,CHECK_WITHDRAWAL,50588.0,M34599177
21691,1196428',2018-06-07,FDRL/NATIONAL ELECTRONIC F,11010.0,0.0,,2018,6,7,PAYEMENT,11010.0,M685059787
21692,1196428',2018-06-07,FDRL/NATIONAL ELECTRONIC F,32835.0,0.0,,2018,6,7,CASH_OUT,32835.0,M376456946
21693,1196428',2018-06-07,FDRL/NATIONAL ELECTRONIC F,73253.0,0.0,,2018,6,7,CHECK_WITHDRAWAL,73253.0,M793798217
21694,1196428',2018-06-07,FDRL/NATIONAL ELECTRONIC F,30854.0,0.0,,2018,6,7,DEBIT,30854.0,C264685626
21695,1196428',2018-06-07,FDRL/NATIONAL ELECTRONIC F,36957.0,0.0,,2018,6,7,CASH_OUT,36957.0,M954243999
21696,1196428',2018-06-07,FDRL/NATIONAL ELECTRONIC F,45433.0,0.0,,2018,6,7,DEBIT,45433.0,C1816986148
21697,1196428',2018-06-07,FDRL/NATIONAL ELECTRONIC F,30156.0,0.0,,2018,6,7,PAYEMENT,30156.0,C1144527317
21698,1196428',2018-06-07,FDRL/NATIONAL ELECTRONIC F,33027.0,0.0,,2018,6,7,CASH_OUT,33027.0,C1790831319
21699,1196428',2018-06-07,FDRL/NATIONAL ELECTRONIC F,36665.0,0.0,,2018,6,7,PAYEMENT,36665.0,C571435580
21700,1196428',2018-06-07,FDRL/NATIONAL ELECTRONIC F,37394.0,0.0,,2018,6,7,PAYEMENT,37394.0,C1262016786
21701,1196428',2018-06-07,FDRL/NATIONAL ELECTRONIC F,31950.0,0.0,,2018,6,7,DEBIT,31950.0,C1287328228
21702,1196428',2018-06-07,FDRL/NATIONAL ELECTRONIC F,30870.0,0.0,,2018,6,7,PAYEMENT,30870.0,C329473339
21703,1196428',2018-06-07,FDRL/NATIONAL ELECTRONIC F,49392.0,0.0,,2018,6,7,DEBIT,49392.0,C1354725727
21704,1196428',2018-06-07,FDRL/NATIONAL ELECTRONIC F,31350.0,0.0,,2018,6,7,DEBIT,31350.0,C1300519073
21705,1196428',2018-06-07,FDRL/NATIONAL ELECTRONIC F,38267.0,0.0,,2018,6,7,PAYEMENT,38267.0,C2052185144
21706,1196428',2018-06-07,FDRL/NATIONAL ELECTRONIC F,33334.0,0.0,,2018,6,7,CASH_OUT,33334.0,C1485516154
21707,1196428',2018-06-07,FDRL/NATIONAL ELECTRONIC F,127500.0,0.0,,2018,6,7,DEBIT,127500.0,C2143477943
21708,1196428',2018-06-07,FDRL/NATIONAL ELECTRONIC F,42781.0,0.0,,2018,6,7,PAYEMENT,42781.0,C476402209
21709,1196428',2018-06-07,FDRL/NATIONAL ELECTRONIC F,24107.0,0.0,,2018,6,7,CHECK_WITHDRAWAL,24107.0,C1255024717
21710,1196428',2018-06-07,FDRL/NATIONAL ELECTRONIC F,1405.0,0.0,,2018,6,7,DEBIT,1405.0,C1870367457
21711,1196428',2018-06-07,FDRL/NATIONAL ELECTRONIC F,18806.0,0.0,,2018,6,7,CHECK_WITHDRAWAL,18806.0,C465257140
21712,1196428',2018-06-07,FDRL/NATIONAL ELECTRONIC F,14762.0,0.0,,2018,6,7,CHECK_WITHDRAWAL,14762.0,C745740822
21713,1196428',2018-06-07,FDRL/NATIONAL ELECTRONIC F,23112.0,0.0,,2018,6,7,CASH_OUT,23112.0,C1390121014
21714,1196428',2018-06-07,FDRL/NATIONAL ELECTRONIC F,28609.0,0.0,,2018,6,7,CHECK_WITHDRAWAL,28609.0,C1481851679
21715,1196428',2018-06-07,FDRL/NATIONAL ELECTRONIC F,28597.0,0.0,,2018,6,7,PAYEMENT,28597.0,C741431520
21716,1196428',2018-06-07,FDRL/NATIONAL ELECTRONIC F,28609.0,0.0,,2018,6,7,DEBIT,28609.0,C758888772
21717,1196428',2018-06-07,FDRL/NATIONAL ELECTRONIC F,14605.0,0.0,,2018,6,7,DEBIT,14605.0,C1001409363
21718,1196428',2018-06-07,FDRL/NATIONAL ELECTRONIC F,8976.0,0.0,,2018,6,7,DEBIT,8976.0,M1340854901
21719,1196428',2018-06-07,FDRL/NATIONAL ELECTRONIC F,28609.0,0.0,,2018,6,7,PAYEMENT,28609.0,M265997755
21720,1196428',2018-06-07,FDRL/NATIONAL ELECTRONIC F,28409.0,0.0,,2018,6,7,CASH_OUT,28409.0,M1257695233
21721,1196428',2018-06-07,FDRL/NATIONAL ELECTRONIC F,18352.0,0.0,,2018,6,7,CHECK_WITHDRAWAL,18352.0,C150309335
21722,1196428',2018-06-07,FDRL/NATIONAL ELECTRONIC F,23070.0,0.0,,2018,6,7,CHECK_WITHDRAWAL,23070.0,M1572611628
21723,1196428',2018-06-07,FDRL/NATIONAL ELECTRONIC F,26360.0,0.0,,2018,6,7,PAYEMENT,26360.0,M280183141
21724,1196428',2018-06-07,FDRL/NATIONAL ELECTRONIC F,28859.0,0.0,,2018,6,7,CASH_OUT,28859.0,M808540700
21725,1196428',2018-06-07,FDRL/NATIONAL ELECTRONIC F,18552.0,0.0,,2018,6,7,PAYEMENT,18552.0,M565481399
21726,1196428',2018-06-07,FDRL/NATIONAL ELECTRONIC F,19860.0,0.0,,2018,6,7,CHECK_WITHDRAWAL,19860.0,C842729010
21727,1196428',2018-06-07,FDRL/NATIONAL ELECTRONIC F,484.0,0.0,,2018,6,7,CASH_OUT,484.0,M178371442
21728,1196428',2018-06-07,FDRL/NATIONAL ELECTRONIC F,28859.0,0.0,,2018,6,7,CHECK_WITHDRAWAL,28859.0,M2076445832
21729,1196428',2018-06-07,FDRL/NATIONAL ELECTRONIC F,21746.0,0.0,,2018,6,7,PAYEMENT,21746.0,C599968109
21730,1196428',2018-06-07,FDRL/NATIONAL ELECTRONIC F,18802.0,0.0,,2018,6,7,PAYEMENT,18802.0,C599265282
21731,1196428',2018-06-07,FDRL/NATIONAL ELECTRONIC F,18552.0,0.0,,2018,6,7,DEBIT,18552.0,C669771073
21732,1196428',2018-06-07,FDRL/NATIONAL ELECTRONIC F,28609.0,0.0,,2018,6,7,PAYEMENT,28609.0,C2137848242
21733,1196428',2018-06-07,FDRL/NATIONAL ELECTRONIC F,18552.0,0.0,,2018,6,7,PAYEMENT,18552.0,M997986347
21734,1196428',2018-06-07,FDRL/NATIONAL ELECTRONIC F,15589.0,0.0,,2018,6,7,CASH_OUT,15589.0,M1063792159
21735,1196428',2018-06-07,FDRL/NATIONAL ELECTRONIC F,25110.0,0.0,,2018,6,7,PAYEMENT,25110.0,C22448303
21736,1196428',2018-06-07,FDRL/NATIONAL ELECTRONIC F,18552.0,0.0,,2018,6,7,CASH_OUT,18552.0,M315692635
21737,1196428',2018-06-07,FDRL/NATIONAL ELECTRONIC F,28609.0,0.0,,2018,6,7,PAYEMENT,28609.0,M803644277
21738,1196428',2018-06-07,FDRL/NATIONAL ELECTRONIC F,17316.0,0.0,,2018,6,7,CHECK_WITHDRAWAL,17316.0,M415913007
21739,1196428',2018-06-07,FDRL/NATIONAL ELECTRONIC F,16612.0,0.0,,2018,6,7,CASH_OUT,16612.0,M1344197461
21740,1196428',2018-06-07,FDRL/NATIONAL ELECTRONIC F,16758.0,0.0,,2018,6,7,CASH_OUT,16758.0,M132014623
21741,1196428',2018-06-07,FDRL/NATIONAL ELECTRONIC F,16612.0,0.0,,2018,6,7,PAYEMENT,16612.0,M577051450
21742,1196428',2018-06-07,FDRL/NATIONAL ELECTRONIC F,16612.0,0.0,,2018,6,7,PAYEMENT,16612.0,C1491676195
21743,1196428',2018-06-07,FDRL/NATIONAL ELECTRONIC F,15826.0,0.0,,2018,6,7,PAYEMENT,15826.0,C943166837
21744,1196428',2018-06-07,FDRL/NATIONAL ELECTRONIC F,16612.0,0.0,,2018,6,7,DEBIT,16612.0,M1402953791
21745,1196428',2018-06-07,FDRL/NATIONAL ELECTRONIC F,16612.0,0.0,,2018,6,7,DEBIT,16612.0,M1974589236
21746,1196428',2018-06-07,FDRL/NATIONAL ELECTRONIC F,16612.0,0.0,,2018,6,7,DEBIT,16612.0,C1701412896
21747,1196428',2018-06-07,FDRL/NATIONAL ELECTRONIC F,10772.0,0.0,,2018,6,7,DEBIT,10772.0,M1355606971
21748,1196428',2018-06-07,FDRL/NATIONAL ELECTRONIC F,10772.0,0.0,,2018,6,7,CASH_OUT,10772.0,M1037747072
21749,1196428',2018-06-07,FDRL/NATIONAL ELECTRONIC F,7344.0,0.0,,2018,6,7,CHECK_WITHDRAWAL,7344.0,M82220349
21750,1196428',2018-06-07,FDRL/NATIONAL ELECTRONIC F,10917.0,0.0,,2018,6,7,DEBIT,10917.0,M953439482
21751,1196428',2018-06-07,FDRL/NATIONAL ELECTRONIC F,10772.0,0.0,,2018,6,7,CHECK_WITHDRAWAL,10772.0,C1914282536
21752,1196428',2018-06-07,FDRL/NATIONAL ELECTRONIC F,10917.0,0.0,,2018,6,7,CASH_OUT,10917.0,C691636444
21753,1196428',2018-06-07,FDRL/NATIONAL ELECTRONIC F,14133.0,0.0,,2018,6,7,CASH_OUT,14133.0,C683605346
21754,1196428',2018-06-07,FDRL/NATIONAL ELECTRONIC F,10772.0,0.0,,2018,6,7,DEBIT,10772.0,M1967366965
21755,1196428',2018-06-07,FDRL/NATIONAL ELECTRONIC F,24500.0,0.0,,2018,6,7,DEBIT,24500.0,M508405148
21756,1196428',2018-06-07,FDRL/NATIONAL ELECTRONIC F,10917.0,0.0,,2018,6,7,CASH_OUT,10917.0,M1295579320
21757,1196428',2018-06-07,FDRL/NATIONAL ELECTRONIC F,12358.0,0.0,,2018,6,7,DEBIT,12358.0,M995168511
21758,1196428',2018-06-07,FDRL/NATIONAL ELECTRONIC F,23859.0,0.0,,2018,6,7,CASH_OUT,23859.0,M1102425439
21759,1196428',2018-06-07,FDRL/NATIONAL ELECTRONIC F,22129.0,0.0,,2018,6,7,PAYEMENT,22129.0,M590053012
21760,1196428',2018-06-07,FDRL/NATIONAL ELECTRONIC F,19016.0,0.0,,2018,6,7,CHECK_WITHDRAWAL,19016.0,M386886002
21761,1196428',2018-06-07,FDRL/NATIONAL ELECTRONIC F,28594.0,0.0,,2018,6,7,CHECK_WITHDRAWAL,28594.0,M227585143
21762,1196428',2018-06-07,FDRL/NATIONAL ELECTRONIC F,20045.0,0.0,,2018,6,7,CHECK_WITHDRAWAL,20045.0,M2105068287
21763,1196428',2018-06-07,FDRL/NATIONAL ELECTRONIC F,23501.0,0.0,,2018,6,7,PAYEMENT,23501.0,M1038116064
21764,1196428',2018-06-07,FDRL/NATIONAL ELECTRONIC F,25210.0,0.0,,2018,6,7,PAYEMENT,25210.0,M345805867
21765,1196428',2018-06-07,FDRL/NATIONAL ELECTRONIC F,9883.0,0.0,,2018,6,7,CASH_OUT,9883.0,M1128144161
21766,1196428',2018-06-07,FDRL/NATIONAL ELECTRONIC F,9666.0,0.0,,2018,6,7,CASH_OUT,9666.0,M1492172037
21767,1196428',2018-06-07,FDRL/NATIONAL ELECTRONIC F,24105.0,0.0,,2018,6,7,CASH_OUT,24105.0,M731603444
21768,1196428',2018-06-07,FDRL/NATIONAL ELECTRONIC F,11786.0,0.0,,2018,6,7,CASH_OUT,11786.0,M879683510
21769,1196428',2018-06-07,FDRL/NATIONAL ELECTRONIC F,11265.0,0.0,,2018,6,7,PAYEMENT,11265.0,M555126583
21770,1196428',2018-06-07,FDRL/NATIONAL ELECTRONIC F,18802.0,0.0,,2018,6,7,PAYEMENT,18802.0,M1344791022
21771,1196428',2018-06-07,FDRL/NATIONAL ELECTRONIC F,18061.0,0.0,,2018,6,7,DEBIT,18061.0,M40493588
21772,1196428',2018-06-07,FDRL/NATIONAL ELECTRONIC F,24090.0,0.0,,2018,6,7,CASH_OUT,24090.0,M1099885881
21773,1196428',2018-06-07,FDRL/NATIONAL ELECTRONIC F,18552.0,0.0,,2018,6,7,CHECK_WITHDRAWAL,18552.0,M107256650
21774,1196428',2018-06-07,FDRL/NATIONAL ELECTRONIC F,26110.0,0.0,,2018,6,7,CHECK_WITHDRAWAL,26110.0,M1410611700
21775,1196428',2018-06-07,FDRL/NATIONAL ELECTRONIC F,22360.0,0.0,,2018,6,7,CASH_OUT,22360.0,M954062800
21776,1196428',2018-06-07,FDRL/NATIONAL ELECTRONIC F,15596.0,0.0,,2018,6,7,CHECK_WITHDRAWAL,15596.0,M13013852
21777,1196428',2018-06-07,FDRL/NATIONAL ELECTRONIC F,17071.0,0.0,,2018,6,7,CASH_OUT,17071.0,M1101858256
21778,1196428',2018-06-07,FDRL/NATIONAL ELECTRONIC F,18316.0,0.0,,2018,6,7,CASH_OUT,18316.0,M1180862248
21779,1196428',2018-06-07,FDRL/NATIONAL ELECTRONIC F,15052.0,0.0,,2018,6,7,DEBIT,15052.0,M966462848
21780,1196428',2018-06-07,FDRL/NATIONAL ELECTRONIC F,26781.0,0.0,,2018,6,7,CASH_OUT,26781.0,M1284324188
21781,1196428',2018-06-07,FDRL/NATIONAL ELECTRONIC F,22735.0,0.0,,2018,6,7,DEBIT,22735.0,C374625527
21782,1196428',2018-06-07,FDRL/NATIONAL ELECTRONIC F,13065.0,0.0,,2018,6,7,DEBIT,13065.0,C1262822392
21783,1196428',2018-06-07,NEFT/000046850021/Indiaforensic,0.0,900000.0,,2018,6,7,CASH_IN,900000.0,C1671386208
21784,1196428',2018-06-07,NEFT/SBIN218158042580/MS,0.0,50000.0,,2018,6,7,CASH_IN,50000.0,C1869197498
21785,1196428',2018-06-07,PBGI01001800141:Bank Guar,11800.0,0.0,,2018,6,7,CASH_OUT,11800.0,C271488817
21786,1196428',2018-06-07,NEFT/N158180558940288/ASH,0.0,55555.0,,2018,6,7,CHECK_CASHING,55555.0,M1915909017
21787,1196428',2018-06-07,NEFT/000046848382/Indiaforensic,0.0,1500000.0,,2018,6,7,CASH_IN,1500000.0,C2052185144
21788,1196428',2018-06-07,TRF FROM  Indiaforensic SERVICES,0.0,4800000.0,,2018,6,7,CASH_IN,4800000.0,C646059443
21789,1196428',2018-06-07,TRF FROM  Indiaforensic SERVICES,0.0,250000.0,,2018,6,7,CASH_IN,250000.0,C1982591789
21790,1196428',2018-06-07,FDRL/INTERNAL FUND TRANSFE,5000000.0,0.0,,2018,6,7,DEBIT,5000000.0,C1977614404
21791,1196428',2018-06-07,FDRL/INTERNAL FUND TRANSFE,5000000.0,0.0,,2018,6,7,DEBIT,5000000.0,C1883840933
21792,1196428',2018-06-07,FDRL/INTERNAL FUND TRANSFE,5000000.0,0.0,,2018,6,7,PAYEMENT,5000000.0,C2007207148
21793,1196428',2018-06-07,NEFT/SBIN218158179996/TAR,0.0,200000.0,,2018,6,7,TRANSFER,200000.0,M1014644493
21794,1196428',2018-06-07,STAMP PAPER PURCHASE,100.0,0.0,,2018,6,7,DEBIT,100.0,C381605910
21795,1196428',2018-06-07,BEAT CSH PKP DEL UDYOG 64,0.0,56000.0,,2018,6,7,CASH_IN,56000.0,M1056752544
21796,1196428',2018-06-08,FT ZL1806082363710A PRAVE,0.0,100000.0,,2018,6,8,CHECK_CASHING,100000.0,M729567968
21797,1196428',2018-06-08,RTGS/SBINH18159006894/Indfor,0.0,4000000.0,,2018,6,8,CASH_IN,4000000.0,M1723507087
21798,1196428',2018-06-08,Indiaforensic SERVICES INDIA PVT,0.0,443554.0,,2018,6,8,TRANSFER,443554.0,C849038219
21799,1196428',2018-06-08,FDRL/NATIONAL ELECTRONIC F,4260632.0,0.0,,2018,6,8,PAYEMENT,4260632.0,C1038678108
21800,1196428',2018-06-08,RTGS/HDFCH18159507043/BAT,0.0,300000.0,,2018,6,8,CHECK_CASHING,300000.0,M1976340229
21801,1196428',2018-06-08,NEFT/PUNBH18159104934/BAL,0.0,30000.0,,2018,6,8,TRANSFER,30000.0,M693274483
21802,1196428',2018-06-08,NEFT/SBIN218159617000/THA,0.0,100000.0,,2018,6,8,CASH_IN,100000.0,M838050003
21803,1196428',2018-06-08,RTGS/UTIBH18159672860/PER,0.0,900000.0,,2018,6,8,CHECK_CASHING,900000.0,C1009972184
21804,1196428',2018-06-08,RTGS/HDFCH18159525519/JUN,0.0,300000.0,,2018,6,8,CHECK_CASHING,300000.0,C63475121
21805,1196428',2018-06-08,CHQ DEP/202261/OWDEL1/SBI,0.0,11800.0,,2018,6,8,TRANSFER,11800.0,C1130075212
21806,1196428',2018-06-08,NEFT/N159180559577505/USH,0.0,102990.0,,2018,6,8,CASH_IN,102990.0,C851316413
21807,1196428',2018-06-08,NEFT/SBIN218159752789/NAR,0.0,51973.0,,2018,6,8,CHECK_CASHING,51973.0,M718843573
21808,1196428',2018-06-08,TRF FRM  Indiaforensic SERVICES,0.0,15000000.0,,2018,6,8,CHECK_CASHING,15000000.0,M1217713614
21809,1196428',2018-06-08,TRF FRM  Indiaforensic SERVICES,0.0,500000.0,,2018,6,8,CASH_IN,500000.0,M706338650
21810,1196428',2018-06-08,TRF FRM  Indiaforensic SERVICES,0.0,4000000.0,,2018,6,8,CASH_IN,4000000.0,M995800830
21811,1196428',2018-06-08,FDRL/REAL TIME GROSS SETTL,2000000.0,0.0,,2018,6,8,CHECK_WITHDRAWAL,2000000.0,C1073259437
21812,1196428',2018-06-08,FDRL/REAL TIME GROSS SETTL,10000000.0,0.0,,2018,6,8,CASH_OUT,10000000.0,M1699315785
21813,1196428',2018-06-08,FDRL/REAL TIME GROSS SETTL,10000000.0,0.0,,2018,6,8,CHECK_WITHDRAWAL,10000000.0,M1163711030
21814,1196428',2018-06-08,IMPS 815914363688 FROM GU,0.0,500.0,,2018,6,8,TRANSFER,500.0,C320106510
21815,1196428',2018-06-08,NEFT/SBIN218159867918/SAR,0.0,11800.0,,2018,6,8,TRANSFER,11800.0,M597251930
21816,1196428',2018-06-08,NEFT/AXISP18159056923/ACC,0.0,13000000.0,,2018,6,8,TRANSFER,13000000.0,M1515100477
21817,1196428',2018-06-08,NEFT/N159180559704928/TEC,0.0,300000.0,,2018,6,8,CHECK_CASHING,300000.0,M1412315921
21818,1196428',2018-06-08,RTGS/DLXBH18159500472/KAD,0.0,200000.0,,2018,6,8,CASH_IN,200000.0,M1168923345
21819,1196428',2018-06-08,RTGS/PUNBH18159059939/PUN,0.0,550000.0,,2018,6,8,CASH_IN,550000.0,M2042700604
21820,1196428',2018-06-08,NEFT/PUNBH18159237568/OM,0.0,8000.0,,2018,6,8,TRANSFER,8000.0,C710481910
21821,1196428',2018-06-08,RTGS/HDFCH18159598392/Indfor,0.0,6900000.0,,2018,6,8,TRANSFER,6900000.0,M1474634841
21822,1196428',2018-06-08,NEFT/P18060855645639/PALA,0.0,60000.0,,2018,6,8,CASH_IN,60000.0,C669419693
21823,1196428',2018-06-08,NEFT/N159180559989783/USH,0.0,65193.0,,2018,6,8,CASH_IN,65193.0,C2095611317
21824,1196428',2018-06-08,IMPS 815917337987 FROM AS,0.0,70550.0,,2018,6,8,CASH_IN,70550.0,C1316560467
21825,1196428',2018-06-08,RTGS/SBINH18159070642/SHR,0.0,210000.0,,2018,6,8,TRANSFER,210000.0,M1572144334
21826,1196428',2018-06-08,IMPS 815917347298 FROM AS,0.0,60005.0,,2018,6,8,CASH_IN,60005.0,M593517569
21827,1196428',2018-06-08,FDRL/NATIONAL ELECTRONIC F,500000.0,0.0,,2018,6,8,PAYEMENT,500000.0,M558730564
21828,1196428',2018-06-08,FDRL/NATIONAL ELECTRONIC F,500000.0,0.0,,2018,6,8,DEBIT,500000.0,C736160330
21829,1196428',2018-06-08,FDRL/NATIONAL ELECTRONIC F,1000000.0,0.0,,2018,6,8,DEBIT,1000000.0,C417236208
21830,1196428',2018-06-08,FDRL/NATIONAL ELECTRONIC F,1000000.0,0.0,,2018,6,8,DEBIT,1000000.0,C931482420
21831,1196428',2018-06-08,FDRL/NATIONAL ELECTRONIC F,1000000.0,0.0,,2018,6,8,PAYEMENT,1000000.0,M405976415
21832,1196428',2018-06-08,FDRL/NATIONAL ELECTRONIC F,2000000.0,0.0,,2018,6,8,CASH_OUT,2000000.0,C208341157
21833,1196428',2018-06-08,FDRL/NATIONAL ELECTRONIC F,1000000.0,0.0,,2018,6,8,PAYEMENT,1000000.0,C382697424
21834,1196428',2018-06-08,FDRL/INTERNAL FUND TRANSFE,1000000.0,0.0,,2018,6,8,PAYEMENT,1000000.0,M875577692
21835,1196428',2018-06-08,NEFT/SBIN318159235915/TAR,0.0,180000.0,,2018,6,8,TRANSFER,180000.0,C1822578654
21836,1196428',2018-06-08,NEFT/000046941940/Indiaforensic,0.0,1719000.0,,2018,6,8,TRANSFER,1719000.0,M2022435822
21837,1196428',2018-06-08,IMPS 815918713912 FROM SA,0.0,200000.0,,2018,6,8,CHECK_CASHING,200000.0,M1867372125
21838,1196428',2018-06-08,TRF FRM  Indiaforensic SERVICES,0.0,5000000.0,,2018,6,8,CASH_IN,5000000.0,M556592378
21839,1196428',2018-06-08,TRF FRM  Indiaforensic SERVICES,0.0,500000.0,,2018,6,8,CHECK_CASHING,500000.0,C807072084
21840,1196428',2018-06-08,NEFT/000046941516/Indiaforensic,0.0,977000.0,,2018,6,8,CHECK_CASHING,977000.0,C2077098348
21841,1196428',2018-06-08,FDRL/INTERNAL FUND TRANSFE,15000000.0,0.0,,2018,6,8,DEBIT,15000000.0,M1751878963
21842,1196428',2018-06-08,FDRL/INTERNAL FUND TRANSFE,7000000.0,0.0,,2018,6,8,CASH_OUT,7000000.0,C1618278649
21843,1196428',2018-06-08,BEAT CSH PKP DEL UDYOG 64,0.0,324800.0,,2018,6,8,CASH_IN,324800.0,C1987564320
21844,1196428',2018-06-11,RTGS/UTIBH18162612082/PER,0.0,900000.0,,2018,6,11,CASH_IN,900000.0,M848162783
21845,1196428',2018-06-11,RTGS/HDFCH18162662438/BAT,0.0,200000.0,,2018,6,11,CASH_IN,200000.0,M347906624
21846,1196428',2018-06-11,RTGS/SBINH18162005823/Indfor,0.0,10000000.0,,2018,6,11,CASH_IN,10000000.0,M271658762
21847,1196428',2018-06-11,FDRL/INTERNAL FUND TRANSFE,300000.0,0.0,,2018,6,11,CASH_OUT,300000.0,M1403007770
21848,1196428',2018-06-11,FDRL/INTERNAL FUND TRANSFE,300000.0,0.0,,2018,6,11,CASH_OUT,300000.0,M2043631011
21849,1196428',2018-06-11,FDRL/NATIONAL ELECTRONIC F,27360.0,0.0,,2018,6,11,CASH_OUT,27360.0,C107095723
21850,1196428',2018-06-11,FDRL/NATIONAL ELECTRONIC F,4137690.0,0.0,,2018,6,11,PAYEMENT,4137690.0,C985934102
21851,1196428',2018-06-11,FDRL/NATIONAL ELECTRONIC F,301002.0,0.0,,2018,6,11,DEBIT,301002.0,C824197891
21852,1196428',2018-06-11,FDRL/NATIONAL ELECTRONIC F,1617762.11,0.0,,2018,6,11,CASH_OUT,1617762.11,C1696218625
21853,1196428',2018-06-11,FDRL/NATIONAL ELECTRONIC F,3408848.0,0.0,,2018,6,11,CHECK_WITHDRAWAL,3408848.0,M1817447589
21854,1196428',2018-06-11,IMPS 816211905641 FROM TH,0.0,16209.0,,2018,6,11,CASH_IN,16209.0,C168639687
21855,1196428',2018-06-11,NEFT/000040681409/ACCOUNT,0.0,301002.0,,2018,6,11,CASH_IN,301002.0,C1630293008
21856,1196428',2018-06-11,IMPS 816212305528 FROM AS,0.0,70070.0,,2018,6,11,CASH_IN,70070.0,C1577420620
21857,1196428',2018-06-11,RTGS/SCBLH18162003650/FIX,0.0,1000000.0,,2018,6,11,CHECK_CASHING,1000000.0,C35263828
21858,1196428',2018-06-11,NEFT/SBIN418162109855/NAR,0.0,53973.0,,2018,6,11,CHECK_CASHING,53973.0,M2014874822
21859,1196428',2018-06-11,FDRL/INTERNAL FUND TRANSFE,500000.0,0.0,,2018,6,11,CASH_OUT,500000.0,M1553772873
21860,1196428',2018-06-11,FDRL/INTERNAL FUND TRANSFE,500000.0,0.0,,2018,6,11,CASH_OUT,500000.0,C905650857
21861,1196428',2018-06-11,IMPS 816213333203 FROM SA,0.0,100000.0,,2018,6,11,TRANSFER,100000.0,C1502287290
21862,1196428',2018-06-11,NEFT/SAA136556101/K.T.S.,0.0,85000.0,,2018,6,11,CHECK_CASHING,85000.0,M1197564988
21863,1196428',2018-06-11,CHQ DEP/46016/OWDEL2/BKID,0.0,11800.0,,2018,6,11,CASH_IN,11800.0,M1843534160
21864,1196428',2018-06-11,CHQ DEP/11/OWDEL2/UCBA/PA,0.0,11800.0,,2018,6,11,TRANSFER,11800.0,C871895680
21865,1196428',2018-06-11,CHQ DEP/701476/OWDEL2/PUN,0.0,11800.0,,2018,6,11,CHECK_CASHING,11800.0,C1398530689
21866,1196428',2018-06-11,TRF FRM  Indiaforensic SERVICES,0.0,9200000.0,,2018,6,11,CASH_IN,9200000.0,M834859488
21867,1196428',2018-06-11,TRF FRM  Indiaforensic SERVICES,0.0,15000000.0,,2018,6,11,TRANSFER,15000000.0,M463880076
21868,1196428',2018-06-11,TRF FRM  Indiaforensic SERVICES,0.0,15000000.0,,2018,6,11,CHECK_CASHING,15000000.0,M1273091698
21869,1196428',2018-06-11,TRF FRM  Indiaforensic SERVICES,0.0,15000000.0,,2018,6,11,CHECK_CASHING,15000000.0,M134350609
21870,1196428',2018-06-11,FDRL/REAL TIME GROSS SETTL,5000000.0,0.0,,2018,6,11,CHECK_WITHDRAWAL,5000000.0,M1939822545
21871,1196428',2018-06-11,FDRL/REAL TIME GROSS SETTL,15000000.0,0.0,,2018,6,11,CASH_OUT,15000000.0,M1498010747
21872,1196428',2018-06-11,FDRL/REAL TIME GROSS SETTL,15000000.0,0.0,,2018,6,11,CASH_OUT,15000000.0,M615833646
21873,1196428',2018-06-11,FDRL/REAL TIME GROSS SETTL,15000000.0,0.0,,2018,6,11,CASH_OUT,15000000.0,M695601535
21874,1196428',2018-06-11,FDRL/INTERNAL FUND TRANSFE,100000.0,0.0,,2018,6,11,PAYEMENT,100000.0,M1741551200
21875,1196428',2018-06-11,FDRL/INTERNAL FUND TRANSFE,100000.0,0.0,,2018,6,11,PAYEMENT,100000.0,M533060514
21876,1196428',2018-06-11,IMPS 816214357815 FROM AS,0.0,80550.0,,2018,6,11,TRANSFER,80550.0,M763925237
21877,1196428',2018-06-11,NEFT/SBIN418162545577/SRI,0.0,11800.0,,2018,6,11,TRANSFER,11800.0,M309397793
21878,1196428',2018-06-11,Indiaforensic SERVICES INDIA PVT,0.0,200065.0,,2018,6,11,CASH_IN,200065.0,M786088183
21879,1196428',2018-06-11,RTGS/PUNBH18162080280/PUN,0.0,250000.0,,2018,6,11,CASH_IN,250000.0,M1362397723
21880,1196428',2018-06-11,NEFT/BARBZ18162514863/MAK,0.0,54444.0,,2018,6,11,CHECK_CASHING,54444.0,M166947904
21881,1196428',2018-06-11,NEFT/AXMB181626227834/POO,0.0,8000.0,,2018,6,11,CASH_IN,8000.0,M39384037
21882,1196428',2018-06-11,IMPS 816216893669 FROM SA,0.0,5000.0,,2018,6,11,TRANSFER,5000.0,M1475711030
21883,1196428',2018-06-11,NEFT/P18061156022891/M/S,0.0,30000.0,,2018,6,11,TRANSFER,30000.0,M727579419
21884,1196428',2018-06-11,FDRL/INTERNAL FUND TRANSFE,500000.0,0.0,,2018,6,11,DEBIT,500000.0,M654290745
21885,1196428',2018-06-11,CASHDEP/FARIDABAD/CASH,0.0,50000.0,,2018,6,11,CASH_IN,50000.0,C1559145228
21886,1196428',2018-06-11,FDRL/INTERNAL FUND TRANSFE,500000.0,0.0,,2018,6,11,PAYEMENT,500000.0,M688458571
21887,1196428',2018-06-11,TRF FRM  Indiaforensic SERVICES,0.0,15000000.0,,2018,6,11,CHECK_CASHING,15000000.0,M1895621189
21888,1196428',2018-06-11,TRF FRM  Indiaforensic SERVICES,0.0,800000.0,,2018,6,11,CHECK_CASHING,800000.0,M1516781526
21889,1196428',2018-06-11,NEFT/N162180561523529/BAT,0.0,100000.0,,2018,6,11,CASH_IN,100000.0,M409559965
21890,1196428',2018-06-11,NEFT/000047032731/Indiaforensic,0.0,3000000.0,,2018,6,11,CASH_IN,3000000.0,M1771169983
21891,1196428',2018-06-11,NEFT/N162180561474863/Indfor,0.0,10500000.0,,2018,6,11,CASH_IN,10500000.0,C470217116
21892,1196428',2018-06-11,NEFT/000047032837/Indiaforensic,0.0,2000000.0,,2018,6,11,CASH_IN,2000000.0,M585745963
21893,1196428',2018-06-11,FDRL/INTERNAL FUND TRANSFE,5000000.0,0.0,,2018,6,11,CHECK_WITHDRAWAL,5000000.0,M2096974885
21894,1196428',2018-06-11,FDRL/INTERNAL FUND TRANSFE,15000000.0,0.0,,2018,6,11,PAYEMENT,15000000.0,M1287228290
21895,1196428',2018-06-11,FDRL/INTERNAL FUND TRANSFE,3000000.0,0.0,,2018,6,11,PAYEMENT,3000000.0,M1178751818
21896,1196428',2018-06-11,FDRL/INTERNAL FUND TRANSFE,3000000.0,0.0,,2018,6,11,DEBIT,3000000.0,M145594829
21897,1196428',2018-06-11,FDRL/INTERNAL FUND TRANSFE,1000000.0,0.0,,2018,6,11,CASH_OUT,1000000.0,M1232351629
21898,1196428',2018-06-11,FDRL/INTERNAL FUND TRANSFE,1000000.0,0.0,,2018,6,11,DEBIT,1000000.0,M1656904340
21899,1196428',2018-06-11,BEAT CSH PKP DEL UDYOG 64,0.0,530000.0,,2018,6,11,TRANSFER,530000.0,C24404443
21900,1196428',2018-06-11,IMPS 816221108584 FROM SA,0.0,11800.0,,2018,6,11,CASH_IN,11800.0,C596299019
21901,1196428',2018-06-12,RTGS/UTIBH18163659625/PER,0.0,900000.0,,2018,6,12,CASH_IN,900000.0,C1983747920
21902,1196428',2018-06-12,NEFT/N163180561887058/USH,0.0,48275.0,,2018,6,12,CHECK_CASHING,48275.0,C696705647
21903,1196428',2018-06-12,FDRL/NATIONAL ELECTRONIC F,2389314.0,0.0,,2018,6,12,PAYEMENT,2389314.0,C1845765982
21904,1196428',2018-06-12,FDRL/NATIONAL ELECTRONIC F,16758.0,0.0,,2018,6,12,PAYEMENT,16758.0,M877365519
21905,1196428',2018-06-12,FDRL/NATIONAL ELECTRONIC F,23890.0,0.0,,2018,6,12,PAYEMENT,23890.0,C134604590
21906,1196428',2018-06-12,FDRL/NATIONAL ELECTRONIC F,11950.0,0.0,,2018,6,12,CASH_OUT,11950.0,M1053485132
21907,1196428',2018-06-12,FDRL/NATIONAL ELECTRONIC F,18552.0,0.0,,2018,6,12,DEBIT,18552.0,M1698378565
21908,1196428',2018-06-12,FDRL/NATIONAL ELECTRONIC F,11737.0,0.0,,2018,6,12,DEBIT,11737.0,M1418167825
21909,1196428',2018-06-12,FDRL/NATIONAL ELECTRONIC F,21933.0,0.0,,2018,6,12,DEBIT,21933.0,M915318947
21910,1196428',2018-06-12,FDRL/NATIONAL ELECTRONIC F,27685.0,0.0,,2018,6,12,PAYEMENT,27685.0,M1471526064
21911,1196428',2018-06-12,FDRL/NATIONAL ELECTRONIC F,13084.0,0.0,,2018,6,12,PAYEMENT,13084.0,C474166728
21912,1196428',2018-06-12,FDRL/NATIONAL ELECTRONIC F,25719.0,0.0,,2018,6,12,DEBIT,25719.0,M1777764920
21913,1196428',2018-06-12,FDRL/NATIONAL ELECTRONIC F,9432.0,0.0,,2018,6,12,CASH_OUT,9432.0,C1833549064
21914,1196428',2018-06-12,FDRL/NATIONAL ELECTRONIC F,12952.0,0.0,,2018,6,12,PAYEMENT,12952.0,M327804056
21915,1196428',2018-06-12,FDRL/NATIONAL ELECTRONIC F,18628.0,0.0,,2018,6,12,DEBIT,18628.0,M939893108
21916,1196428',2018-06-12,FDRL/NATIONAL ELECTRONIC F,26095.0,0.0,,2018,6,12,PAYEMENT,26095.0,C1938462589
21917,1196428',2018-06-12,FDRL/NATIONAL ELECTRONIC F,3228.0,0.0,,2018,6,12,CASH_OUT,3228.0,M974784761
21918,1196428',2018-06-12,FDRL/NATIONAL ELECTRONIC F,17508.0,0.0,,2018,6,12,PAYEMENT,17508.0,M209997138
21919,1196428',2018-06-12,FDRL/NATIONAL ELECTRONIC F,12596.0,0.0,,2018,6,12,PAYEMENT,12596.0,M359327148
21920,1196428',2018-06-12,FDRL/NATIONAL ELECTRONIC F,22826.0,0.0,,2018,6,12,CHECK_WITHDRAWAL,22826.0,C1519216494
21921,1196428',2018-06-12,FDRL/NATIONAL ELECTRONIC F,13436.0,0.0,,2018,6,12,CASH_OUT,13436.0,M142106520
21922,1196428',2018-06-12,FDRL/NATIONAL ELECTRONIC F,15871.0,0.0,,2018,6,12,CASH_OUT,15871.0,C1979080020
21923,1196428',2018-06-12,FDRL/NATIONAL ELECTRONIC F,15115.0,0.0,,2018,6,12,DEBIT,15115.0,C635281078
21924,1196428',2018-06-12,FDRL/NATIONAL ELECTRONIC F,15052.0,0.0,,2018,6,12,DEBIT,15052.0,C1866672043
21925,1196428',2018-06-12,FDRL/NATIONAL ELECTRONIC F,16307.0,0.0,,2018,6,12,DEBIT,16307.0,M155979068
21926,1196428',2018-06-12,FDRL/NATIONAL ELECTRONIC F,28467.0,0.0,,2018,6,12,DEBIT,28467.0,M111496179
21927,1196428',2018-06-12,FDRL/NATIONAL ELECTRONIC F,28288.0,0.0,,2018,6,12,CHECK_WITHDRAWAL,28288.0,M1472428747
21928,1196428',2018-06-12,FDRL/NATIONAL ELECTRONIC F,10958.0,0.0,,2018,6,12,CASH_OUT,10958.0,C1167813715
21929,1196428',2018-06-12,FDRL/NATIONAL ELECTRONIC F,26825.0,0.0,,2018,6,12,CASH_OUT,26825.0,M235839070
21930,1196428',2018-06-12,FDRL/NATIONAL ELECTRONIC F,16989.0,0.0,,2018,6,12,PAYEMENT,16989.0,M1881768592
21931,1196428',2018-06-12,FDRL/NATIONAL ELECTRONIC F,4950.0,0.0,,2018,6,12,PAYEMENT,4950.0,C185503802
21932,1196428',2018-06-12,FDRL/NATIONAL ELECTRONIC F,15824.0,0.0,,2018,6,12,PAYEMENT,15824.0,C403147759
21933,1196428',2018-06-12,FDRL/NATIONAL ELECTRONIC F,19252.0,0.0,,2018,6,12,PAYEMENT,19252.0,M1725462644
21934,1196428',2018-06-12,FDRL/NATIONAL ELECTRONIC F,25319.0,0.0,,2018,6,12,CASH_OUT,25319.0,M685639359
21935,1196428',2018-06-12,FDRL/NATIONAL ELECTRONIC F,27120.0,0.0,,2018,6,12,DEBIT,27120.0,M499928991
21936,1196428',2018-06-12,FDRL/NATIONAL ELECTRONIC F,24293.0,0.0,,2018,6,12,CHECK_WITHDRAWAL,24293.0,M960322367
21937,1196428',2018-06-12,FDRL/NATIONAL ELECTRONIC F,10821.0,0.0,,2018,6,12,CASH_OUT,10821.0,M1786085833
21938,1196428',2018-06-12,FDRL/NATIONAL ELECTRONIC F,20491.0,0.0,,2018,6,12,DEBIT,20491.0,M718103121
21939,1196428',2018-06-12,FDRL/NATIONAL ELECTRONIC F,19153.0,0.0,,2018,6,12,DEBIT,19153.0,M757687320
21940,1196428',2018-06-12,FDRL/NATIONAL ELECTRONIC F,19449.0,0.0,,2018,6,12,DEBIT,19449.0,M1144148971
21941,1196428',2018-06-12,FDRL/NATIONAL ELECTRONIC F,16809.0,0.0,,2018,6,12,CASH_OUT,16809.0,M1868505862
21942,1196428',2018-06-12,FDRL/NATIONAL ELECTRONIC F,26227.0,0.0,,2018,6,12,DEBIT,26227.0,M1608080402
21943,1196428',2018-06-12,FDRL/NATIONAL ELECTRONIC F,23520.0,0.0,,2018,6,12,PAYEMENT,23520.0,M1154038476
21944,1196428',2018-06-12,FDRL/NATIONAL ELECTRONIC F,23335.0,0.0,,2018,6,12,PAYEMENT,23335.0,M1325923139
21945,1196428',2018-06-12,FDRL/NATIONAL ELECTRONIC F,11368.0,0.0,,2018,6,12,CHECK_WITHDRAWAL,11368.0,M1396188238
21946,1196428',2018-06-12,FDRL/NATIONAL ELECTRONIC F,27734.0,0.0,,2018,6,12,PAYEMENT,27734.0,M554850979
21947,1196428',2018-06-12,FDRL/NATIONAL ELECTRONIC F,21006.0,0.0,,2018,6,12,CHECK_WITHDRAWAL,21006.0,M1055780232
21948,1196428',2018-06-12,FDRL/NATIONAL ELECTRONIC F,15623.0,0.0,,2018,6,12,DEBIT,15623.0,M662568271
21949,1196428',2018-06-12,FDRL/NATIONAL ELECTRONIC F,13697.0,0.0,,2018,6,12,CHECK_WITHDRAWAL,13697.0,C1649449847
21950,1196428',2018-06-12,FDRL/NATIONAL ELECTRONIC F,18545.0,0.0,,2018,6,12,PAYEMENT,18545.0,C1198167820
21951,1196428',2018-06-12,FDRL/NATIONAL ELECTRONIC F,18092.0,0.0,,2018,6,12,DEBIT,18092.0,C749672494
21952,1196428',2018-06-12,FDRL/NATIONAL ELECTRONIC F,12953.0,0.0,,2018,6,12,CASH_OUT,12953.0,C1423992712
21953,1196428',2018-06-12,FDRL/NATIONAL ELECTRONIC F,24484.0,0.0,,2018,6,12,CHECK_WITHDRAWAL,24484.0,C313124964
21954,1196428',2018-06-12,FDRL/NATIONAL ELECTRONIC F,22600.0,0.0,,2018,6,12,DEBIT,22600.0,C500153041
21955,1196428',2018-06-12,FDRL/NATIONAL ELECTRONIC F,11077.0,0.0,,2018,6,12,CHECK_WITHDRAWAL,11077.0,C728526866
21956,1196428',2018-06-12,FDRL/NATIONAL ELECTRONIC F,25791.0,0.0,,2018,6,12,PAYEMENT,25791.0,C40075281
21957,1196428',2018-06-12,FDRL/NATIONAL ELECTRONIC F,15825.0,0.0,,2018,6,12,DEBIT,15825.0,C456538529
21958,1196428',2018-06-12,FDRL/NATIONAL ELECTRONIC F,14424.0,0.0,,2018,6,12,PAYEMENT,14424.0,C2117043942
21959,1196428',2018-06-12,FDRL/NATIONAL ELECTRONIC F,24090.0,0.0,,2018,6,12,DEBIT,24090.0,C1838584624
21960,1196428',2018-06-12,FDRL/NATIONAL ELECTRONIC F,14424.0,0.0,,2018,6,12,PAYEMENT,14424.0,M1733424208
21961,1196428',2018-06-12,FDRL/NATIONAL ELECTRONIC F,17271.0,0.0,,2018,6,12,CHECK_WITHDRAWAL,17271.0,M1060393794
21962,1196428',2018-06-12,FDRL/NATIONAL ELECTRONIC F,10583.0,0.0,,2018,6,12,DEBIT,10583.0,M226593165
21963,1196428',2018-06-12,FDRL/NATIONAL ELECTRONIC F,13816.0,0.0,,2018,6,12,CASH_OUT,13816.0,M426584880
21964,1196428',2018-06-12,FDRL/NATIONAL ELECTRONIC F,12101.0,0.0,,2018,6,12,CASH_OUT,12101.0,C448155494
21965,1196428',2018-06-12,FDRL/NATIONAL ELECTRONIC F,19069.0,0.0,,2018,6,12,DEBIT,19069.0,M1594302764
21966,1196428',2018-06-12,FDRL/NATIONAL ELECTRONIC F,40150.0,0.0,,2018,6,12,CASH_OUT,40150.0,M271366306
21967,1196428',2018-06-12,FDRL/NATIONAL ELECTRONIC F,14814.0,0.0,,2018,6,12,PAYEMENT,14814.0,C348708793
21968,1196428',2018-06-12,FDRL/NATIONAL ELECTRONIC F,40552.0,0.0,,2018,6,12,CASH_OUT,40552.0,M462659391
21969,1196428',2018-06-12,FDRL/NATIONAL ELECTRONIC F,33536.0,0.0,,2018,6,12,PAYEMENT,33536.0,M547825235
21970,1196428',2018-06-12,FDRL/NATIONAL ELECTRONIC F,43093.0,0.0,,2018,6,12,PAYEMENT,43093.0,M1301971459
21971,1196428',2018-06-12,FDRL/NATIONAL ELECTRONIC F,9827.0,0.0,,2018,6,12,CASH_OUT,9827.0,M1155771218
21972,1196428',2018-06-12,FDRL/NATIONAL ELECTRONIC F,36325.0,0.0,,2018,6,12,PAYEMENT,36325.0,M734120998
21973,1196428',2018-06-12,FDRL/NATIONAL ELECTRONIC F,45200.0,0.0,,2018,6,12,CHECK_WITHDRAWAL,45200.0,M1404561012
21974,1196428',2018-06-12,FDRL/NATIONAL ELECTRONIC F,48949.0,0.0,,2018,6,12,CHECK_WITHDRAWAL,48949.0,M1376999853
21975,1196428',2018-06-12,FDRL/NATIONAL ELECTRONIC F,48745.0,0.0,,2018,6,12,DEBIT,48745.0,M255307196
21976,1196428',2018-06-12,FDRL/NATIONAL ELECTRONIC F,46957.0,0.0,,2018,6,12,CASH_OUT,46957.0,M11285367
21977,1196428',2018-06-12,FDRL/NATIONAL ELECTRONIC F,30359.0,0.0,,2018,6,12,CHECK_WITHDRAWAL,30359.0,M714914851
21978,1196428',2018-06-12,FDRL/NATIONAL ELECTRONIC F,45200.0,0.0,,2018,6,12,CHECK_WITHDRAWAL,45200.0,M1438724935
21979,1196428',2018-06-12,FDRL/NATIONAL ELECTRONIC F,35154.0,0.0,,2018,6,12,CASH_OUT,35154.0,M662472677
21980,1196428',2018-06-12,FDRL/NATIONAL ELECTRONIC F,33771.0,0.0,,2018,6,12,DEBIT,33771.0,M1932384587
21981,1196428',2018-06-12,FDRL/NATIONAL ELECTRONIC F,37667.0,0.0,,2018,6,12,CASH_OUT,37667.0,M719480872
21982,1196428',2018-06-12,FDRL/NATIONAL ELECTRONIC F,39550.0,0.0,,2018,6,12,CHECK_WITHDRAWAL,39550.0,M1278136570
21983,1196428',2018-06-12,FDRL/NATIONAL ELECTRONIC F,33900.0,0.0,,2018,6,12,CASH_OUT,33900.0,M148964727
21984,1196428',2018-06-12,FDRL/NATIONAL ELECTRONIC F,38881.0,0.0,,2018,6,12,PAYEMENT,38881.0,M1177742051
21985,1196428',2018-06-12,FDRL/NATIONAL ELECTRONIC F,42043.0,0.0,,2018,6,12,CHECK_WITHDRAWAL,42043.0,M724365571
21986,1196428',2018-06-12,FDRL/NATIONAL ELECTRONIC F,35221.0,0.0,,2018,6,12,CHECK_WITHDRAWAL,35221.0,M212535805
21987,1196428',2018-06-12,FDRL/NATIONAL ELECTRONIC F,47083.0,0.0,,2018,6,12,DEBIT,47083.0,M1596397541
21988,1196428',2018-06-12,FDRL/NATIONAL ELECTRONIC F,36552.0,0.0,,2018,6,12,DEBIT,36552.0,M713285225
21989,1196428',2018-06-12,FDRL/NATIONAL ELECTRONIC F,34258.0,0.0,,2018,6,12,PAYEMENT,34258.0,C2032389005
21990,1196428',2018-06-12,FDRL/NATIONAL ELECTRONIC F,40959.0,0.0,,2018,6,12,PAYEMENT,40959.0,M1156533869
21991,1196428',2018-06-12,FDRL/INTERNAL FUND TRANSFE,22000.0,0.0,,2018,6,12,DEBIT,22000.0,M105292474
21992,1196428',2018-06-12,FDRL/NATIONAL ELECTRONIC F,31595.0,0.0,,2018,6,12,CASH_OUT,31595.0,M1410438390
21993,1196428',2018-06-12,FDRL/INTERNAL FUND TRANSFE,40680.0,0.0,,2018,6,12,DEBIT,40680.0,M1257755465
21994,1196428',2018-06-12,FDRL/INTERNAL FUND TRANSFE,40159.0,0.0,,2018,6,12,DEBIT,40159.0,M1640401120
21995,1196428',2018-06-12,FDRL/NATIONAL ELECTRONIC F,30798.0,0.0,,2018,6,12,PAYEMENT,30798.0,M1399060771
21996,1196428',2018-06-12,FDRL/REAL TIME GROSS SETTL,5000000.0,0.0,,2018,6,12,PAYEMENT,5000000.0,C1262822392
21997,1196428',2018-06-12,Indiaforensic SERVICES INDIA PVT,0.0,323318.0,,2018,6,12,TRANSFER,323318.0,M148589770
21998,1196428',2018-06-12,FDRL/INTERNAL FUND TRANSFE,500000.0,0.0,,2018,6,12,PAYEMENT,500000.0,M984489239
21999,1196428',2018-06-12,FDRL/INTERNAL FUND TRANSFE,500000.0,0.0,,2018,6,12,CASH_OUT,500000.0,C2115055717
22000,1196428',2018-06-12,NEFT/N163180561950122/ESS,0.0,1000.0,,2018,6,12,TRANSFER,1000.0,C1166654566
22001,1196428',2018-06-12,TRF FROM  Indiaforensic SERVICES,0.0,15000000.0,,2018,6,12,CHECK_CASHING,15000000.0,M88042020
22002,1196428',2018-06-12,TRF FROM  Indiaforensic SERVICES,0.0,8500000.0,,2018,6,12,TRANSFER,8500000.0,M717278894
22003,1196428',2018-06-12,NEFT/SBIN518163990917/SUR,0.0,40000.0,,2018,6,12,CHECK_CASHING,40000.0,M129220812
22004,1196428',2018-06-12,NEFT/BARBZ18163891967/MAK,0.0,60666.0,,2018,6,12,CASH_IN,60666.0,M1015272304
22005,1196428',2018-06-12,NEFT/N163180562143808/USH,0.0,102475.0,,2018,6,12,TRANSFER,102475.0,C1007717381
22006,1196428',2018-06-12,NEFT/SBIN618163076443/CIT,0.0,11800.0,,2018,6,12,TRANSFER,11800.0,C1240091493
22007,1196428',2018-06-12,FDRL/REAL TIME GROSS SETTL,15000000.0,0.0,,2018,6,12,DEBIT,15000000.0,C1396297158
22008,1196428',2018-06-12,NEFT/BKIDN18163338678/M R,0.0,11800.0,,2018,6,12,CHECK_CASHING,11800.0,M705803524
22009,1196428',2018-06-12,FDRL/REAL TIME GROSS SETTL,5000000.0,0.0,,2018,6,12,DEBIT,5000000.0,C978740207
22010,1196428',2018-06-12,NEFT/P18061256622233/PALA,0.0,30000.0,,2018,6,12,CASH_IN,30000.0,C115885991
22011,1196428',2018-06-12,IMPS 816316327901 FROM AS,0.0,40099.0,,2018,6,12,CHECK_CASHING,40099.0,C587433505
22012,1196428',2018-06-12,TRF FROM  Indiaforensic SERVICES,0.0,9100000.0,,2018,6,12,TRANSFER,9100000.0,C1637186972
22013,1196428',2018-06-12,RTGS/HDFCH18163007308/Indfor,0.0,3500000.0,,2018,6,12,TRANSFER,3500000.0,M190739308
22014,1196428',2018-06-12,TRF FR 409000362497  IndforG,0.0,232507.0,,2018,6,12,CHECK_CASHING,232507.0,C778306577
22015,1196428',2018-06-12,FDRL/NATIONAL ELECTRONIC F,31468.0,0.0,,2018,6,12,DEBIT,31468.0,M1863711975
22016,1196428',2018-06-12,FDRL/NATIONAL ELECTRONIC F,9498.0,0.0,,2018,6,12,PAYEMENT,9498.0,M1469855297
22017,1196428',2018-06-12,NEFT/N163180562496923/TEC,0.0,200000.0,,2018,6,12,CASH_IN,200000.0,M794421806
22018,1196428',2018-06-12,NEFT/000047101240/Indiaforensic,0.0,2500000.0,,2018,6,12,TRANSFER,2500000.0,M1334051844
22019,1196428',2018-06-12,NEFT/000047102341/Indiaforensic,0.0,1700000.0,,2018,6,12,TRANSFER,1700000.0,M515450283
22020,1196428',2018-06-12,BEAT CSH PKP DEL UDYOG 64,0.0,236500.0,,2018,6,12,CHECK_CASHING,236500.0,M1747790771
22021,1196428',2018-06-12,FDRL/INTERNAL FUND TRANSFE,7000000.0,0.0,,2018,6,12,PAYEMENT,7000000.0,M1284135884
22022,1196428',2018-06-12,FDRL/INTERNAL FUND TRANSFE,7000000.0,0.0,,2018,6,12,DEBIT,7000000.0,C420561530
22023,1196428',2018-06-12,FDRL/INTERNAL FUND TRANSFE,7000000.0,0.0,,2018,6,12,PAYEMENT,7000000.0,M694158341
22024,1196428',2018-06-13,RTGS/UTIBH18164610656/PER,0.0,900000.0,,2018,6,13,CASH_IN,900000.0,C2046578329
22025,1196428',2018-06-13,RTGS/SBINH18164004728/Indfor,0.0,2800000.0,,2018,6,13,TRANSFER,2800000.0,M942812964
22026,1196428',2018-06-13,FDRL/NATIONAL ELECTRONIC F,4187441.0,0.0,,2018,6,13,DEBIT,4187441.0,M1977844832
22027,1196428',2018-06-13,NEFT/N164180562874540/ESS,0.0,10000.0,,2018,6,13,TRANSFER,10000.0,M1171276229
22028,1196428',2018-06-13,IMPS 816411542805 FROM TH,0.0,45000.0,,2018,6,13,CASH_IN,45000.0,M1741253456
22029,1196428',2018-06-13,NEFT/N164180562988042/USH,0.0,77308.0,,2018,6,13,TRANSFER,77308.0,M1549630173
22030,1196428',2018-06-13,PBGI01001600155:Bank Guar,35990.0,0.0,,2018,6,13,DEBIT,35990.0,C1548218207
22031,1196428',2018-06-13,RTGS/PUNBH18164119219/PUN,0.0,550000.0,,2018,6,13,CASH_IN,550000.0,C242559404
22032,1196428',2018-06-13,CHQ DEP/83121/OWDEL2/UBIN,0.0,11800.0,,2018,6,13,TRANSFER,11800.0,C1153596299
22033,1196428',2018-06-13,CHQ DEP/51/OWDEL2/HDFC/BA,0.0,11800.0,,2018,6,13,CHECK_CASHING,11800.0,M708011911
22034,1196428',2018-06-13,CHQ DEP/841979/OWDEL2/SBI,0.0,11800.0,,2018,6,13,CHECK_CASHING,11800.0,M1579526490
22035,1196428',2018-06-13,CHQ DEP/505349/OWDEL2/SBI,0.0,11800.0,,2018,6,13,CHECK_CASHING,11800.0,C1924874046
22036,1196428',2018-06-13,CHQ DEP/42857/OWDEL2/ORBC,0.0,11800.0,,2018,6,13,CHECK_CASHING,11800.0,C1079343872
22037,1196428',2018-06-13,CHQ DEP/191/OWDEL2/BARB/C,0.0,11800.0,,2018,6,13,CHECK_CASHING,11800.0,M1025387324
22038,1196428',2018-06-13,CHQ DEP/282/OWDEL1/HDFC/,0.0,11800.0,,2018,6,13,TRANSFER,11800.0,M2114990234
22039,1196428',2018-06-13,NEFT/P18061357023877/M/S,0.0,25000.0,,2018,6,13,CASH_IN,25000.0,M1843420945
22040,1196428',2018-06-13,TRF FROM  Indiaforensic SERVICES,0.0,15000000.0,,2018,6,13,TRANSFER,15000000.0,C863811613
22041,1196428',2018-06-13,TRF FROM  Indiaforensic SERVICES,0.0,10500000.0,,2018,6,13,CHECK_CASHING,10500000.0,M1539382844
22042,1196428',2018-06-13,NEFT/SBIN618164952575/NAR,0.0,54798.0,,2018,6,13,CASH_IN,54798.0,M1846768700
22043,1196428',2018-06-13,NEFT/N164180563159580/USH,0.0,71250.0,,2018,6,13,CHECK_CASHING,71250.0,C1640747200
22044,1196428',2018-06-13,FDRL/REAL TIME GROSS SETTL,10000000.0,0.0,,2018,6,13,PAYEMENT,10000000.0,M1099038981
22045,1196428',2018-06-13,FDRL/REAL TIME GROSS SETTL,15000000.0,0.0,,2018,6,13,DEBIT,15000000.0,C344610846
22046,1196428',2018-06-13,FDRL/INTERNAL FUND TRANSFE,500000.0,0.0,,2018,6,13,CASH_OUT,500000.0,C1919277981
22047,1196428',2018-06-13,NEFT/000047158616/ARTHASH,0.0,25000.0,,2018,6,13,CHECK_CASHING,25000.0,C2104652067
22048,1196428',2018-06-13,NEFT/BARBP18164448476/MAK,0.0,51111.0,,2018,6,13,CASH_IN,51111.0,C1092465037
22049,1196428',2018-06-13,NEFT/IOBAN18164674450/ASH,0.0,120090.0,,2018,6,13,CASH_IN,120090.0,M995633719
22050,1196428',2018-06-13,IMPS 816415638374 FROM M,0.0,5000.0,,2018,6,13,TRANSFER,5000.0,M938465080
22051,1196428',2018-06-13,IMPS 816415127375 FROM AS,0.0,45145.0,,2018,6,13,TRANSFER,45145.0,M1834981639
22052,1196428',2018-06-13,RTGS/HDFCH18164177286/Indfor,0.0,7000000.0,,2018,6,13,CHECK_CASHING,7000000.0,M1775303360
22053,1196428',2018-06-13,NEFT/AXISP18164082510/ACC,0.0,1000000.0,,2018,6,13,CHECK_CASHING,1000000.0,M261084274
22054,1196428',2018-06-13,NEFT/SBIN718164116352/MS,0.0,50000.0,,2018,6,13,TRANSFER,50000.0,M1007295516
22055,1196428',2018-06-13,NEFT/SBIN718164078197/M R,0.0,31000.0,,2018,6,13,CHECK_CASHING,31000.0,M470234716
22056,1196428',2018-06-13,NEFT/N164180563476519/TEC,0.0,200000.0,,2018,6,13,TRANSFER,200000.0,M905290562
22057,1196428',2018-06-13,NEFT/000047183938/Indiaforensic,0.0,1800000.0,,2018,6,13,TRANSFER,1800000.0,M798935213
22058,1196428',2018-06-13,NEFT/000047184051/Indiaforensic,0.0,1395000.0,,2018,6,13,CASH_IN,1395000.0,M1932154134
22059,1196428',2018-06-13,TRF FROM  Indiaforensic SERVICES,0.0,7300000.0,,2018,6,13,CHECK_CASHING,7300000.0,M1426777731
22060,1196428',2018-06-13,FDRL/INTERNAL FUND TRANSFE,500000.0,0.0,,2018,6,13,PAYEMENT,500000.0,M2001931511
22061,1196428',2018-06-13,BEAT CSH PKP DEL UDYOG 64,0.0,332500.0,,2018,6,13,CHECK_CASHING,332500.0,M1028639221
22062,1196428',2018-06-13,FDRL/INTERNAL FUND TRANSFE,15000000.0,0.0,,2018,6,13,CASH_OUT,15000000.0,M129965176
22063,1196428',2018-06-13,FDRL/INTERNAL FUND TRANSFE,1000000.0,0.0,,2018,6,13,PAYEMENT,1000000.0,M1666930496
22064,1196428',2018-06-13,FDRL/INTERNAL FUND TRANSFE,1000000.0,0.0,,2018,6,13,DEBIT,1000000.0,M1348049534
22065,1196428',2018-06-14,RTGS/UTIBH18165650333/PER,0.0,900000.0,,2018,6,14,TRANSFER,900000.0,M149861385
22066,1196428',2018-06-14,RTGS/SBINH18165003941/Indfor,0.0,500000.0,,2018,6,14,TRANSFER,500000.0,M1803845616
22067,1196428',2018-06-14,FDRL/NATIONAL ELECTRONIC F,3979556.0,0.0,,2018,6,14,PAYEMENT,3979556.0,M396463835
22068,1196428',2018-06-14,NEFT/N165180563721145/USH,0.0,96037.0,,2018,6,14,CASH_IN,96037.0,M1022045468
22069,1196428',2018-06-14,NEFT/SBIN718165499345/NAR,0.0,47250.0,,2018,6,14,CHECK_CASHING,47250.0,M1556446144
22070,1196428',2018-06-14,RTGS/SBINH18165015124/Indfor,0.0,1000000.0,,2018,6,14,CHECK_CASHING,1000000.0,M141959252
22071,1196428',2018-06-14,FDRL/INTERNAL FUND TRANSFE,1000000.0,0.0,,2018,6,14,DEBIT,1000000.0,M1997459283
22072,1196428',2018-06-14,CASHDEP/NOIDA/TP,0.0,200000.0,,2018,6,14,CHECK_CASHING,200000.0,M539292855
22073,1196428',2018-06-14,RTGS/HDFCH18165259993/JUN,0.0,300000.0,,2018,6,14,CHECK_CASHING,300000.0,M878266233
22074,1196428',2018-06-14,NEFT/SBIN718165632739/SUR,0.0,115000.0,,2018,6,14,TRANSFER,115000.0,M1660780699
22075,1196428',2018-06-14,NEFT/SDL34346414/SAINI FI,0.0,50000.0,,2018,6,14,CHECK_CASHING,50000.0,M1242431450
22076,1196428',2018-06-14,TRF FROM  Indiaforensic SERVICES,0.0,15000000.0,,2018,6,14,CASH_IN,15000000.0,M2075133206
22077,1196428',2018-06-14,TRF FROM  Indiaforensic SERVICES,0.0,7900000.0,,2018,6,14,CASH_IN,7900000.0,M1651383848
22078,1196428',2018-06-14,TRF TO  Indiaforensic SERVICES I,5000.0,0.0,,2018,6,14,CHECK_WITHDRAWAL,5000.0,M1364290623
22079,1196428',2018-06-14,FDRL/REAL TIME GROSS SETTL,10000000.0,0.0,,2018,6,14,DEBIT,10000000.0,M1119145556
22080,1196428',2018-06-14,FDRL/REAL TIME GROSS SETTL,10000000.0,0.0,,2018,6,14,CASH_OUT,10000000.0,M552762676
22081,1196428',2018-06-14,FDRL/REAL TIME GROSS SETTL,1000000.0,0.0,,2018,6,14,CHECK_WITHDRAWAL,1000000.0,M1549335447
22082,1196428',2018-06-14,FDRL/REAL TIME GROSS SETTL,2000000.0,0.0,,2018,6,14,PAYEMENT,2000000.0,M1407332998
22083,1196428',2018-06-14,Indiaforensic SERVICES INDIA PVT,0.0,199474.0,,2018,6,14,CASH_IN,199474.0,M575173490
22084,1196428',2018-06-14,NEFT/PUNBH18165147363/PUN,0.0,350000.0,,2018,6,14,TRANSFER,350000.0,M1463959599
22085,1196428',2018-06-14,RTGS/HDFCH18165309144/Indfor,0.0,5200000.0,,2018,6,14,CASH_IN,5200000.0,C191614132
22086,1196428',2018-06-14,NEFT/N165180563996279/USH,0.0,24000.0,,2018,6,14,CHECK_CASHING,24000.0,C1885712019
22087,1196428',2018-06-14,RTGS/HDFCH18165344393/BAT,0.0,200000.0,,2018,6,14,TRANSFER,200000.0,M1406881784
22088,1196428',2018-06-14,NEFT/N165180564130616/TEC,0.0,500000.0,,2018,6,14,TRANSFER,500000.0,C1161865950
22089,1196428',2018-06-14,NEFT/BARBP18165929047/MAK,0.0,68888.0,,2018,6,14,CASH_IN,68888.0,M1558051277
22090,1196428',2018-06-14,IMPS 816516320377 FROM AS,0.0,100150.0,,2018,6,14,CHECK_CASHING,100150.0,M1173085824
22091,1196428',2018-06-14,Indiaforensic SERVICES INDIA PVT,0.0,281233.0,,2018,6,14,TRANSFER,281233.0,M569018137
22092,1196428',2018-06-14,NEFT/SBIN818165031527/SRI,0.0,11800.0,,2018,6,14,TRANSFER,11800.0,M1770271962
22093,1196428',2018-06-14,NEFT/000047259144/Indiaforensic,0.0,500000.0,,2018,6,14,CHECK_CASHING,500000.0,M1586738337
22094,1196428',2018-06-14,NEFT/000047260843/Indiaforensic,0.0,1000000.0,,2018,6,14,CHECK_CASHING,1000000.0,M1674738101
22095,1196428',2018-06-14,NEFT/AXISP18165140005/ACC,0.0,17000000.0,,2018,6,14,TRANSFER,17000000.0,C1590550415
22096,1196428',2018-06-14,NEFT/000047261090/Indiaforensic,0.0,1000000.0,,2018,6,14,TRANSFER,1000000.0,C705321061
22097,1196428',2018-06-14,TRF FROM  Indiaforensic SERVICES,0.0,6100000.0,,2018,6,14,TRANSFER,6100000.0,M873689156
22098,1196428',2018-06-14,FDRL/INTERNAL FUND TRANSFE,15000000.0,0.0,,2018,6,14,PAYEMENT,15000000.0,M1538317866
22099,1196428',2018-06-14,FDRL/INTERNAL FUND TRANSFE,500000.0,0.0,,2018,6,14,PAYEMENT,500000.0,C262828207
22100,1196428',2018-06-14,STAMP PAPER PURCHASING,100.0,0.0,,2018,6,14,PAYEMENT,100.0,C1222590577
22101,1196428',2018-06-14,BEAT CSH PKP DEL UDYOG 64,0.0,198500.0,,2018,6,14,TRANSFER,198500.0,M2089852906
22102,1196428',2018-06-15,FDRL/REAL TIME GROSS SETTL,10000000.0,0.0,,2018,6,15,DEBIT,10000000.0,M629502621
22103,1196428',2018-06-15,FDRL/REAL TIME GROSS SETTL,1000000.0,0.0,,2018,6,15,CHECK_WITHDRAWAL,1000000.0,M511596806
22104,1196428',2018-06-15,FDRL/REAL TIME GROSS SETTL,1000000.0,0.0,,2018,6,15,CASH_OUT,1000000.0,M2079635991
22105,1196428',2018-06-15,FDRL/NATIONAL ELECTRONIC F,3440623.0,0.0,,2018,6,15,CHECK_WITHDRAWAL,3440623.0,M1044456366
22106,1196428',2018-06-15,CASHDEP/VIKASMARG/TP,0.0,309000.0,,2018,6,15,TRANSFER,309000.0,C1689840534
22107,1196428',2018-06-15,NEFT/P18061557742326/M/S,0.0,60000.0,,2018,6,15,CASH_IN,60000.0,M1092817314
22108,1196428',2018-06-15,NEFT/N166180564639099/BAT,0.0,100000.0,,2018,6,15,CHECK_CASHING,100000.0,C1475909248
22109,1196428',2018-06-15,"Indiaforensic USA, INC./USD/995/",0.0,67212.25,,2018,6,15,CASH_IN,67212.25,M2040472550
22110,1196428',2018-06-15,IRTT00701817692,415.98,0.0,,2018,6,15,CASH_OUT,415.98,C979719862
22111,1196428',2018-06-15,"Indiaforensic USA, INC./USD/5756",0.0,3888313.1,,2018,6,15,CHECK_CASHING,3888313.1,C985934102
22112,1196428',2018-06-15,IRTT00701817690,1804.9,0.0,,2018,6,15,CHECK_WITHDRAWAL,1804.9,C731253803
22113,1196428',2018-06-15,CHQ DEP/902618/OWDEL1/SBI,0.0,11800.0,,2018,6,15,TRANSFER,11800.0,C1609562230
22114,1196428',2018-06-15,RTGS/HDFCH18166449931/BAJ,0.0,200000.0,,2018,6,15,TRANSFER,200000.0,M1076923640
22115,1196428',2018-06-15,NEFT/N166180564721959/USH,0.0,95475.0,,2018,6,15,CASH_IN,95475.0,M1144262832
22116,1196428',2018-06-15,FDRL/REAL TIME GROSS SETTL,5000000.0,0.0,,2018,6,15,CASH_OUT,5000000.0,M942922351
22117,1196428',2018-06-15,NEFT/PUNBH18166360219/MAN,0.0,50000.0,,2018,6,15,CHECK_CASHING,50000.0,M1582038853
22118,1196428',2018-06-15,TRF FROM  Indiaforensic SERVICES,0.0,15000000.0,,2018,6,15,CASH_IN,15000000.0,M36034212
22119,1196428',2018-06-15,TRF FROM  Indiaforensic SERVICES,0.0,4000000.0,,2018,6,15,CASH_IN,4000000.0,M1326356346
22120,1196428',2018-06-15,TRF FROM  Indiaforensic SERVICES,0.0,4000000.0,,2018,6,15,CHECK_CASHING,4000000.0,C27489818
22121,1196428',2018-06-15,FDRL/REAL TIME GROSS SETTL,10000000.0,0.0,,2018,6,15,DEBIT,10000000.0,C747979499
22122,1196428',2018-06-15,FDRL/REAL TIME GROSS SETTL,15000000.0,0.0,,2018,6,15,CHECK_WITHDRAWAL,15000000.0,C1660095722
22123,1196428',2018-06-15,IMPS 816614358117 FROM AS,0.0,50150.0,,2018,6,15,CASH_IN,50150.0,C372017580
22124,1196428',2018-06-15,RTGS/PUNBH18166166908/PUN,0.0,350000.0,,2018,6,15,TRANSFER,350000.0,M370179552
22125,1196428',2018-06-15,CHQ DEPOSIT RETURN/902618,11800.0,0.0,,2018,6,15,PAYEMENT,11800.0,C802935635
22126,1196428',2018-06-15,RTGS/HDFCH18166514701/Indfor,0.0,5000000.0,,2018,6,15,CASH_IN,5000000.0,M1523086740
22127,1196428',2018-06-15,RTGS/HDFCH18166524830/Indfor,0.0,2000000.0,,2018,6,15,CHECK_CASHING,2000000.0,M902885640
22128,1196428',2018-06-15,NEFT/BARBQ18166374528/MAK,0.0,55666.0,,2018,6,15,CHECK_CASHING,55666.0,C459172227
22129,1196428',2018-06-15,NEFT/SBIN818166870817/PAR,0.0,10000.0,,2018,6,15,CHECK_CASHING,10000.0,C265108079
22130,1196428',2018-06-15,BEAT CSH PKP DEL UDYOG 64,0.0,151500.0,,2018,6,15,TRANSFER,151500.0,C35126588
22131,1196428',2018-06-15,NEFT/N166180565052451/BAT,0.0,30000.0,,2018,6,15,TRANSFER,30000.0,C1589477624
22132,1196428',2018-06-15,NEFT/000047330293/Indiaforensic,0.0,1000000.0,,2018,6,15,CHECK_CASHING,1000000.0,C1283595719
22133,1196428',2018-06-15,NEFT/000047330132/Indiaforensic,0.0,1000000.0,,2018,6,15,CASH_IN,1000000.0,C101084405
22134,1196428',2018-06-15,FDRL/INTERNAL FUND TRANSFE,1000000.0,0.0,,2018,6,15,PAYEMENT,1000000.0,M7891579
22135,1196428',2018-06-15,TRF FROM  Indiaforensic SERVICES,0.0,6300000.0,,2018,6,15,CHECK_CASHING,6300000.0,M150228660
22136,1196428',2018-06-15,FDRL/INTERNAL FUND TRANSFE,7000000.0,0.0,,2018,6,15,DEBIT,7000000.0,M190019040
22137,1196428',2018-06-15,FDRL/INTERNAL FUND TRANSFE,8000000.0,0.0,,2018,6,15,PAYEMENT,8000000.0,M1462909495
22138,1196428',2018-06-15,SHENZHEN JUSTTIDE TECH CO,14686.92,0.0,,2018,6,15,CHECK_WITHDRAWAL,14686.92,C1192983708
22139,1196428',2018-06-15,IMAR00701803599,930.0,0.0,,2018,6,15,PAYEMENT,930.0,M1730398598
22140,1196428',2018-06-15,CHQ DEPOSIT RETURN/902618,100.0,0.0,,2018,6,15,DEBIT,100.0,M1492635498
22141,1196428',2018-06-15,CHQ DEPOSIT RETURN/902618,18.0,0.0,,2018,6,15,CHECK_WITHDRAWAL,18.0,M738483886
22142,1196428',2018-06-16,IMPS 816715326968 FROM AS,0.0,100160.0,,2018,6,16,CHECK_CASHING,100160.0,M1583014678
22143,1196428',2018-06-16,IMPS 816716336964 FROM AS,0.0,120199.0,,2018,6,16,CHECK_CASHING,120199.0,C395114097
22144,1196428',2018-06-18,RTGS/UTIBH18169638987/PER,0.0,900000.0,,2018,6,18,CASH_IN,900000.0,M743943553
22145,1196428',2018-06-18,NEFT/PUNBH18169480156/BAL,0.0,50000.0,,2018,6,18,TRANSFER,50000.0,M2034445578
22146,1196428',2018-06-18,NEFT/SBIN918169201243/NAR,0.0,42937.0,,2018,6,18,CASH_IN,42937.0,C1383942363
22147,1196428',2018-06-18,FDRL/INTERNAL FUND TRANSFE,500000.0,0.0,,2018,6,18,PAYEMENT,500000.0,M72285092
22148,1196428',2018-06-18,FDRL/INTERNAL FUND TRANSFE,1000000.0,0.0,,2018,6,18,CASH_OUT,1000000.0,M586185216
22149,1196428',2018-06-18,RTGS/SBINH18169007780/Indfor,0.0,8500000.0,,2018,6,18,TRANSFER,8500000.0,M1378755468
22150,1196428',2018-06-18,FDRL/NATIONAL ELECTRONIC F,3193647.0,0.0,,2018,6,18,PAYEMENT,3193647.0,C765980478
22151,1196428',2018-06-18,FDRL/NATIONAL ELECTRONIC F,2267402.0,0.0,,2018,6,18,PAYEMENT,2267402.0,C1200314947
22152,1196428',2018-06-18,FDRL/NATIONAL ELECTRONIC F,2777491.0,0.0,,2018,6,18,PAYEMENT,2777491.0,C1973491942
22153,1196428',2018-06-18,NEFT/SBIN918169312344/THA,0.0,60000.0,,2018,6,18,TRANSFER,60000.0,C1689374891
22154,1196428',2018-06-18,RTGS/HDFCH18169599747/BAT,0.0,200000.0,,2018,6,18,CASH_IN,200000.0,C2053639017
22155,1196428',2018-06-18,NEFT/SBIN918169361831/SUR,0.0,120000.0,,2018,6,18,CHECK_CASHING,120000.0,C1654056127
22156,1196428',2018-06-18,IMPS 816912342652 FROM AS,0.0,150150.0,,2018,6,18,CHECK_CASHING,150150.0,C803368825
22157,1196428',2018-06-18,NEFT/N169180565556683/USH,0.0,99400.0,,2018,6,18,TRANSFER,99400.0,C892686452
22158,1196428',2018-06-18,RTGS/PUNBH18169179951/PUN,0.0,600000.0,,2018,6,18,CASH_IN,600000.0,C2031563133
22159,1196428',2018-06-18,"Indiaforensic USA, INC./USD/3046",0.0,2060991.26,,2018,6,18,TRANSFER,2060991.26,C1619402333
22160,1196428',2018-06-18,IRTT00701817826,1475.98,0.0,,2018,6,18,PAYEMENT,1475.98,C1149273771
22161,1196428',2018-06-18,IMPS 816912685443 FROM FO,0.0,200000.0,,2018,6,18,CHECK_CASHING,200000.0,C2109470512
22162,1196428',2018-06-18,RTGS/PUNBH18169181444/MAN,0.0,300000.0,,2018,6,18,TRANSFER,300000.0,C1059781259
22163,1196428',2018-06-18,NEFT/P18061858207420/M/S,0.0,30000.0,,2018,6,18,TRANSFER,30000.0,C125722707
22164,1196428',2018-06-18,NEFT/SBIN918169563234/TAR,0.0,190000.0,,2018,6,18,CASH_IN,190000.0,C1778300121
22165,1196428',2018-06-18,TRF FROM  Indiaforensic SERVICES,0.0,15000000.0,,2018,6,18,TRANSFER,15000000.0,C313124964
22166,1196428',2018-06-18,TRF FROM  Indiaforensic SERVICES,0.0,5000000.0,,2018,6,18,CASH_IN,5000000.0,C1220897602
22167,1196428',2018-06-18,TRF FROM  Indiaforensic SERVICES,0.0,5000000.0,,2018,6,18,CASH_IN,5000000.0,C1515704208
22168,1196428',2018-06-18,TRF FROM  Indiaforensic SERVICES,0.0,4000000.0,,2018,6,18,CHECK_CASHING,4000000.0,C1313534832
22169,1196428',2018-06-18,FDRL/REAL TIME GROSS SETTL,15000000.0,0.0,,2018,6,18,DEBIT,15000000.0,C1141137903
22170,1196428',2018-06-18,FDRL/REAL TIME GROSS SETTL,15000000.0,0.0,,2018,6,18,PAYEMENT,15000000.0,C1869228744
22171,1196428',2018-06-18,FDRL/REAL TIME GROSS SETTL,1000000.0,0.0,,2018,6,18,CHECK_WITHDRAWAL,1000000.0,C2078250226
22172,1196428',2018-06-18,FDRL/REAL TIME GROSS SETTL,1000000.0,0.0,,2018,6,18,CHECK_WITHDRAWAL,1000000.0,C1300519073
22173,1196428',2018-06-18,FDRL/REAL TIME GROSS SETTL,1000000.0,0.0,,2018,6,18,DEBIT,1000000.0,M1808484670
22174,1196428',2018-06-18,FDRL/NATIONAL ELECTRONIC F,2500.0,0.0,,2018,6,18,CASH_OUT,2500.0,M829035073
22175,1196428',2018-06-18,FDRL/NATIONAL ELECTRONIC F,2500.0,0.0,,2018,6,18,CHECK_WITHDRAWAL,2500.0,M1674174327
22176,1196428',2018-06-18,FDRL/NATIONAL ELECTRONIC F,2500.0,0.0,,2018,6,18,CASH_OUT,2500.0,M2135203084
22177,1196428',2018-06-18,FDRL/NATIONAL ELECTRONIC F,2500.0,0.0,,2018,6,18,DEBIT,2500.0,C1673971173
22178,1196428',2018-06-18,FDRL/NATIONAL ELECTRONIC F,3000.0,0.0,,2018,6,18,CASH_OUT,3000.0,C339099861
22179,1196428',2018-06-18,FDRL/NATIONAL ELECTRONIC F,3000.0,0.0,,2018,6,18,CHECK_WITHDRAWAL,3000.0,M2045422556
22180,1196428',2018-06-18,IMPS 816916308685 FROM AS,0.0,40040.0,,2018,6,18,CASH_IN,40040.0,C1266035080
22181,1196428',2018-06-18,RTGS/HDFCH18169725986/Indfor,0.0,7200000.0,,2018,6,18,CHECK_CASHING,7200000.0,C1060041730
22182,1196428',2018-06-18,Indiaforensic SERVICES INDIA PVT,0.0,525174.0,,2018,6,18,TRANSFER,525174.0,C1475395523
22183,1196428',2018-06-18,TRF FROM  Indiaforensic SERVICES,0.0,15000000.0,,2018,6,18,CHECK_CASHING,15000000.0,C265845794
22184,1196428',2018-06-18,TRF FROM  Indiaforensic SERVICES,0.0,6500000.0,,2018,6,18,CHECK_CASHING,6500000.0,C58091972
22185,1196428',2018-06-18,FDRL/NATIONAL ELECTRONIC F,15000000.0,0.0,,2018,6,18,CASH_OUT,15000000.0,C193864812
22186,1196428',2018-06-18,FDRL/NATIONAL ELECTRONIC F,4000000.0,0.0,,2018,6,18,PAYEMENT,4000000.0,C681835572
22187,1196428',2018-06-18,FDRL/NATIONAL ELECTRONIC F,4000000.0,0.0,,2018,6,18,CHECK_WITHDRAWAL,4000000.0,C965197768
22188,1196428',2018-06-18,NEFT/IOBAN18169653087/K,0.0,2500.0,,2018,6,18,TRANSFER,2500.0,C893038039
22189,1196428',2018-06-18,NEFT/AXISP18169144006/ACC,0.0,1000000.0,,2018,6,18,TRANSFER,1000000.0,C1317731757
22190,1196428',2018-06-18,TRF FROM  Indiaforensic SERVICES,0.0,15000000.0,,2018,6,18,TRANSFER,15000000.0,C1373467808
22191,1196428',2018-06-18,TRF FROM  Indiaforensic SERVICES,0.0,4000000.0,,2018,6,18,CASH_IN,4000000.0,C1318822808
22192,1196428',2018-06-18,NEFT/000047412726/Indiaforensic,0.0,1700000.0,,2018,6,18,TRANSFER,1700000.0,C1424731356
22193,1196428',2018-06-18,NEFT/IOBAN18169667912/K,0.0,2500.0,,2018,6,18,CHECK_CASHING,2500.0,C1439007204
22194,1196428',2018-06-18,NEFT/000047407423/Indiaforensic,0.0,3600000.0,,2018,6,18,TRANSFER,3600000.0,C1116292004
22195,1196428',2018-06-18,BEAT CSH PKP DEL GURGA 64,0.0,229000.0,,2018,6,18,TRANSFER,229000.0,C638551812
22196,1196428',2018-06-18,FDRL/INTERNAL FUND TRANSFE,5000000.0,0.0,,2018,6,18,PAYEMENT,5000000.0,C193826743
22197,1196428',2018-06-18,FDRL/INTERNAL FUND TRANSFE,3000000.0,0.0,,2018,6,18,CHECK_WITHDRAWAL,3000000.0,C309167705
22198,1196428',2018-06-18,FDRL/INTERNAL FUND TRANSFE,5000000.0,0.0,,2018,6,18,DEBIT,5000000.0,C811597470
22199,1196428',2018-06-19,NEFT/SBIN918170979409/NAR,0.0,45823.0,,2018,6,19,TRANSFER,45823.0,C1014923261
22200,1196428',2018-06-19,NEFT/PUNBH18170700592/BAL,0.0,50000.0,,2018,6,19,TRANSFER,50000.0,C925574515
22201,1196428',2018-06-19,FDRL/REAL TIME GROSS SETTL,10000000.0,0.0,,2018,6,19,DEBIT,10000000.0,C1988152146
22202,1196428',2018-06-19,FDRL/INTERNAL FUND TRANSFE,500000.0,0.0,,2018,6,19,CHECK_WITHDRAWAL,500000.0,C71555810
22203,1196428',2018-06-19,CASHDEP/NOIDA/TP,0.0,150000.0,,2018,6,19,TRANSFER,150000.0,C1273939873
22204,1196428',2018-06-19,FDRL/NATIONAL ELECTRONIC F,4880546.0,0.0,,2018,6,19,CHECK_WITHDRAWAL,4880546.0,C749672494
22205,1196428',2018-06-19,FDRL/NATIONAL ELECTRONIC F,82104.0,0.0,,2018,6,19,CASH_OUT,82104.0,C1504109395
22206,1196428',2018-06-19,FDRL/NATIONAL ELECTRONIC F,61274.0,0.0,,2018,6,19,DEBIT,61274.0,C2107268831
22207,1196428',2018-06-19,FDRL/NATIONAL ELECTRONIC F,68465.0,0.0,,2018,6,19,PAYEMENT,68465.0,C1141137903
22208,1196428',2018-06-19,FDRL/NATIONAL ELECTRONIC F,58444.0,0.0,,2018,6,19,CASH_OUT,58444.0,M492166970
22209,1196428',2018-06-19,FDRL/NATIONAL ELECTRONIC F,72828.0,0.0,,2018,6,19,CHECK_WITHDRAWAL,72828.0,C762570948
22210,1196428',2018-06-19,FDRL/NATIONAL ELECTRONIC F,53079.0,0.0,,2018,6,19,CASH_OUT,53079.0,C1440282299
22211,1196428',2018-06-19,FDRL/NATIONAL ELECTRONIC F,71164.0,0.0,,2018,6,19,PAYEMENT,71164.0,M1583639547
22212,1196428',2018-06-19,FDRL/NATIONAL ELECTRONIC F,62132.0,0.0,,2018,6,19,CASH_OUT,62132.0,M1476691574
22213,1196428',2018-06-19,FDRL/NATIONAL ELECTRONIC F,50218.0,0.0,,2018,6,19,CHECK_WITHDRAWAL,50218.0,C893339434
22214,1196428',2018-06-19,FDRL/NATIONAL ELECTRONIC F,52146.0,0.0,,2018,6,19,DEBIT,52146.0,M722806861
22215,1196428',2018-06-19,FDRL/NATIONAL ELECTRONIC F,90990.0,0.0,,2018,6,19,CASH_OUT,90990.0,C1150610696
22216,1196428',2018-06-19,FDRL/NATIONAL ELECTRONIC F,81803.0,0.0,,2018,6,19,PAYEMENT,81803.0,C1674899618
22217,1196428',2018-06-19,FDRL/NATIONAL ELECTRONIC F,74582.0,0.0,,2018,6,19,DEBIT,74582.0,M481126602
22218,1196428',2018-06-19,FDRL/NATIONAL ELECTRONIC F,57743.0,0.0,,2018,6,19,CHECK_WITHDRAWAL,57743.0,C1793325972
22219,1196428',2018-06-19,FDRL/NATIONAL ELECTRONIC F,67800.0,0.0,,2018,6,19,DEBIT,67800.0,M132360639
22220,1196428',2018-06-19,FDRL/NATIONAL ELECTRONIC F,98875.0,0.0,,2018,6,19,CHECK_WITHDRAWAL,98875.0,M2052092920
22221,1196428',2018-06-19,FDRL/NATIONAL ELECTRONIC F,69911.0,0.0,,2018,6,19,CHECK_WITHDRAWAL,69911.0,M236650472
22222,1196428',2018-06-19,FDRL/NATIONAL ELECTRONIC F,60006.0,0.0,,2018,6,19,CASH_OUT,60006.0,M2089634452
22223,1196428',2018-06-19,FDRL/NATIONAL ELECTRONIC F,93924.0,0.0,,2018,6,19,DEBIT,93924.0,M1097809105
22224,1196428',2018-06-19,FDRL/NATIONAL ELECTRONIC F,92162.0,0.0,,2018,6,19,DEBIT,92162.0,C302025300
22225,1196428',2018-06-19,FDRL/NATIONAL ELECTRONIC F,57748.0,0.0,,2018,6,19,CHECK_WITHDRAWAL,57748.0,M134742492
22226,1196428',2018-06-19,"Indiaforensic USA, INC./USD/3024",0.0,2047116.96,,2018,6,19,CASH_IN,2047116.96,C1511785794
22227,1196428',2018-06-19,IRTT00701817914,1473.48,0.0,,2018,6,19,PAYEMENT,1473.48,M1604293868
22228,1196428',2018-06-19,NEFT/SBIN118170117193/M R,0.0,50000.0,,2018,6,19,CASH_IN,50000.0,M1853641629
22229,1196428',2018-06-19,RTGS/HDFCH18170804926/BAT,0.0,225000.0,,2018,6,19,TRANSFER,225000.0,M710600916
22230,1196428',2018-06-19,RTGS/PUNBH18170199797/MAN,0.0,400000.0,,2018,6,19,CHECK_CASHING,400000.0,M985323561
22231,1196428',2018-06-19,NEFT/P18061958557237/M/S,0.0,30000.0,,2018,6,19,TRANSFER,30000.0,M1194715097
22232,1196428',2018-06-19,FDRL/REAL TIME GROSS SETTL,5000000.0,0.0,,2018,6,19,CASH_OUT,5000000.0,M693684695
22233,1196428',2018-06-19,NEFT/AXISP18170025645/ACC,0.0,2000000.0,,2018,6,19,CHECK_CASHING,2000000.0,M1582319135
22234,1196428',2018-06-19,TRF FROM  Indiaforensic SERVICES,0.0,15000000.0,,2018,6,19,CASH_IN,15000000.0,M227290600
22235,1196428',2018-06-19,TRF FROM  Indiaforensic SERVICES,0.0,5900000.0,,2018,6,19,CHECK_CASHING,5900000.0,M2089806029
22236,1196428',2018-06-19,NEFT/N170180566581725/USH,0.0,37000.0,,2018,6,19,CHECK_CASHING,37000.0,M1477278751
22237,1196428',2018-06-19,NEFT/N170180566618906/BAN,0.0,500.0,,2018,6,19,CHECK_CASHING,500.0,M1650385017
22238,1196428',2018-06-19,FDRL/REAL TIME GROSS SETTL,10000000.0,0.0,,2018,6,19,CASH_OUT,10000000.0,M1921059756
22239,1196428',2018-06-19,FDRL/REAL TIME GROSS SETTL,10000000.0,0.0,,2018,6,19,CHECK_WITHDRAWAL,10000000.0,M590434145
22240,1196428',2018-06-19,RTGS/HDFCH18170902118/Indfor,0.0,6000000.0,,2018,6,19,TRANSFER,6000000.0,M1671621366
22241,1196428',2018-06-19,FDRL/NATIONAL ELECTRONIC F,3000000.0,0.0,,2018,6,19,CASH_OUT,3000000.0,M899686935
22242,1196428',2018-06-19,IMPS 817016630014 FROM NA,0.0,2000.0,,2018,6,19,TRANSFER,2000.0,M2054039573
22243,1196428',2018-06-19,RTGS/ICICH18170498633/Indfor,0.0,1500000.0,,2018,6,19,CHECK_CASHING,1500000.0,M1271480561
22244,1196428',2018-06-19,IMPS 817017369677 FROM AS,0.0,50105.0,,2018,6,19,CHECK_CASHING,50105.0,C1259769769
22245,1196428',2018-06-19,NEFT/SBIN118170475338/TAR,0.0,150000.0,,2018,6,19,CHECK_CASHING,150000.0,M649539827
22246,1196428',2018-06-19,NEFT/N170180566687137/TEC,0.0,200000.0,,2018,6,19,TRANSFER,200000.0,C893350828
22247,1196428',2018-06-19,NEFT/000047478894/Indiaforensic,0.0,1700000.0,,2018,6,19,CHECK_CASHING,1700000.0,M20364107
22248,1196428',2018-06-19,NEFT/AXISP18170097661/ACC,0.0,1950000.0,,2018,6,19,CHECK_CASHING,1950000.0,M2023197227
22249,1196428',2018-06-19,TRF FROM  Indiaforensic SERVICES,0.0,8700000.0,,2018,6,19,TRANSFER,8700000.0,C232812328
22250,1196428',2018-06-19,FDRL/INTERNAL FUND TRANSFE,5000000.0,0.0,,2018,6,19,PAYEMENT,5000000.0,M902890505
22251,1196428',2018-06-19,FDRL/INTERNAL FUND TRANSFE,5000000.0,0.0,,2018,6,19,DEBIT,5000000.0,M1465861273
22252,1196428',2018-06-19,FDRL/INTERNAL FUND TRANSFE,500000.0,0.0,,2018,6,19,CASH_OUT,500000.0,M949506330
22253,1196428',2018-06-19,FDRL/INTERNAL FUND TRANSFE,3000000.0,0.0,,2018,6,19,PAYEMENT,3000000.0,M2084969506
22254,1196428',2018-06-19,NEFT/20582998411DC/ARTHAS,0.0,225000.0,,2018,6,19,CASH_IN,225000.0,M608038618
22255,1196428',2018-06-19,BEAT CSH PKP DEL GURGA 62,0.0,131500.0,,2018,6,19,CHECK_CASHING,131500.0,M1041764081
22256,1196428',2018-06-20,FDRL/NATIONAL ELECTRONIC F,105210.0,0.0,,2018,6,20,PAYEMENT,105210.0,M277788688
22257,1196428',2018-06-20,FDRL/NATIONAL ELECTRONIC F,133996.0,0.0,,2018,6,20,PAYEMENT,133996.0,M31440957
22258,1196428',2018-06-20,FDRL/NATIONAL ELECTRONIC F,143842.0,0.0,,2018,6,20,DEBIT,143842.0,C1805162633
22259,1196428',2018-06-20,FDRL/NATIONAL ELECTRONIC F,241950.0,0.0,,2018,6,20,CASH_OUT,241950.0,M1201023997
22260,1196428',2018-06-20,FDRL/NATIONAL ELECTRONIC F,148044.0,0.0,,2018,6,20,CHECK_WITHDRAWAL,148044.0,M1412743565
22261,1196428',2018-06-20,FDRL/NATIONAL ELECTRONIC F,118587.0,0.0,,2018,6,20,DEBIT,118587.0,M1887477561
22262,1196428',2018-06-20,FDRL/NATIONAL ELECTRONIC F,162629.0,0.0,,2018,6,20,DEBIT,162629.0,C435161028
22263,1196428',2018-06-20,FDRL/NATIONAL ELECTRONIC F,102326.0,0.0,,2018,6,20,DEBIT,102326.0,M2126024846
22264,1196428',2018-06-20,FDRL/NATIONAL ELECTRONIC F,112985.0,0.0,,2018,6,20,CHECK_WITHDRAWAL,112985.0,M885738476
22265,1196428',2018-06-20,FDRL/NATIONAL ELECTRONIC F,5571626.0,0.0,,2018,6,20,DEBIT,5571626.0,C1273939873
22266,1196428',2018-06-20,FDRL/INTERNAL FUND TRANSFE,500000.0,0.0,,2018,6,20,DEBIT,500000.0,C464094472
22267,1196428',2018-06-20,CASHDEP/CHITTORGAR/,0.0,19000.0,,2018,6,20,CHECK_CASHING,19000.0,C1475998599
22268,1196428',2018-06-20,CHQ DEP/914552/OWDEL1/CIT,0.0,11800.0,,2018,6,20,CASH_IN,11800.0,C1789550256
22269,1196428',2018-06-20,CHQ DEP/87132/OWDEL1/ORBC,0.0,11800.0,,2018,6,20,TRANSFER,11800.0,C1805445027
22270,1196428',2018-06-20,CHQ DEP/188598/OWDEL1/SBI,0.0,11800.0,,2018,6,20,TRANSFER,11800.0,C968448640
22271,1196428',2018-06-20,CHQ DEP/71092/OWDEL1/CLA-,0.0,11800.0,,2018,6,20,TRANSFER,11800.0,C691636444
22272,1196428',2018-06-20,CHQ DEP/648296/OWDEL1/UTB,0.0,11800.0,,2018,6,20,TRANSFER,11800.0,C1778801068
22273,1196428',2018-06-20,CHQ DEP/444213/OWDEL1/ORB,0.0,11800.0,,2018,6,20,TRANSFER,11800.0,C2029896123
22274,1196428',2018-06-20,CHQ DEP/152064/OWDEL1/SBI,0.0,11800.0,,2018,6,20,TRANSFER,11800.0,C1677727024
22275,1196428',2018-06-20,CHQ DEP/202028/OWDEL1/SBI,0.0,11800.0,,2018,6,20,TRANSFER,11800.0,C1525944481
22276,1196428',2018-06-20,CHQ DEP/1701/OWDEL1/BARB/,0.0,11800.0,,2018,6,20,TRANSFER,11800.0,C481402298
22277,1196428',2018-06-20,CHQ DEP/79261/OWDEL1/PUNB,0.0,11800.0,,2018,6,20,TRANSFER,11800.0,C177457290
22278,1196428',2018-06-20,CHQ DEP/905892/OWDEL1/IOB,0.0,11800.0,,2018,6,20,TRANSFER,11800.0,M1138171728
22279,1196428',2018-06-20,CHQ DEP/292/OWDEL1/HDFC/F,0.0,11800.0,,2018,6,20,CHECK_CASHING,11800.0,C1452722471
22280,1196428',2018-06-20,TRF  FROM Indiaforensic SERVICES,0.0,15000000.0,,2018,6,20,TRANSFER,15000000.0,C861958315
22281,1196428',2018-06-20,TRF  FROM Indiaforensic SERVICES,0.0,7200000.0,,2018,6,20,CHECK_CASHING,7200000.0,M919438675
22282,1196428',2018-06-20,TRF TO  Indiaforensic SERVICES I,374000.0,0.0,,2018,6,20,CHECK_WITHDRAWAL,374000.0,M1501022601
22283,1196428',2018-06-20,RTGS/UTIBH18171634768/PER,0.0,400000.0,,2018,6,20,CASH_IN,400000.0,M397708705
22284,1196428',2018-06-20,FDRL/REAL TIME GROSS SETTL,10000000.0,0.0,,2018,6,20,PAYEMENT,10000000.0,M1092898377
22285,1196428',2018-06-20,FDRL/REAL TIME GROSS SETTL,10000000.0,0.0,,2018,6,20,CHECK_WITHDRAWAL,10000000.0,M1957947378
22286,1196428',2018-06-20,FDRL/INTERNAL FUND TRANSFE,500000.0,0.0,,2018,6,20,CHECK_WITHDRAWAL,500000.0,C785703145
22287,1196428',2018-06-20,FDRL/INTERNAL FUND TRANSFE,400000.0,0.0,,2018,6,20,DEBIT,400000.0,M2094125621
22288,1196428',2018-06-20,Indiaforensic SERVICES INDIA PVT,0.0,188371.0,,2018,6,20,CASH_IN,188371.0,M1918034019
22289,1196428',2018-06-20,NEFT/N171180567113916/USH,0.0,161900.0,,2018,6,20,CHECK_CASHING,161900.0,M745483242
22290,1196428',2018-06-20,RTGS/PUNBH18171228843/PUN,0.0,500000.0,,2018,6,20,TRANSFER,500000.0,M1878714361
22291,1196428',2018-06-20,NEFT/N171180567098619/ASH,0.0,60160.0,,2018,6,20,CHECK_CASHING,60160.0,M203939387
22292,1196428',2018-06-20,RTGS/PUNBH18171220945/MAN,0.0,300000.0,,2018,6,20,TRANSFER,300000.0,C382934088
22293,1196428',2018-06-20,IMPS 817115376395 FROM AS,0.0,70170.0,,2018,6,20,CASH_IN,70170.0,C158876320
22294,1196428',2018-06-20,RTGS/HDFCH18171976880/BAT,0.0,250000.0,,2018,6,20,CASH_IN,250000.0,C732929236
22295,1196428',2018-06-20,NEFT/P18062058984681/M/S,0.0,30000.0,,2018,6,20,CASH_IN,30000.0,C1554622120
22296,1196428',2018-06-20,FDRL/REAL TIME GROSS SETTL,1000000.0,0.0,,2018,6,20,CASH_OUT,1000000.0,C1359484306
22297,1196428',2018-06-20,FDRL/REAL TIME GROSS SETTL,1000000.0,0.0,,2018,6,20,CASH_OUT,1000000.0,C1782704802
22298,1196428',2018-06-20,NEFT/AXISP18171043140/ACC,0.0,2000000.0,,2018,6,20,CHECK_CASHING,2000000.0,C1609562230
22299,1196428',2018-06-20,Indiaforensic SERVICES INDIA PVT,0.0,158168.0,,2018,6,20,CASH_IN,158168.0,C1220897602
22300,1196428',2018-06-20,FDRL/NATIONAL ELECTRONIC F,2000000.0,0.0,,2018,6,20,CHECK_WITHDRAWAL,2000000.0,C1213257323
22301,1196428',2018-06-20,NEFT/SBIN218171229284/SUR,0.0,80000.0,,2018,6,20,CASH_IN,80000.0,C674913323
22302,1196428',2018-06-20,NEFT/AXISP18171043138/ACC,0.0,3000000.0,,2018,6,20,CHECK_CASHING,3000000.0,C803116137
22303,1196428',2018-06-20,RTGS/HDFCH18171065823/Indfor,0.0,6000000.0,,2018,6,20,CHECK_CASHING,6000000.0,C1450417897
22304,1196428',2018-06-20,FDRL/NATIONAL ELECTRONIC F,3000000.0,0.0,,2018,6,20,CASH_OUT,3000000.0,C826383690
22305,1196428',2018-06-20,IMPS 817116647553 FROM SA,0.0,50000.0,,2018,6,20,CHECK_CASHING,50000.0,M1718920203
22306,1196428',2018-06-20,FDRL/NATIONAL ELECTRONIC F,3000000.0,0.0,,2018,6,20,PAYEMENT,3000000.0,M1002711260
22307,1196428',2018-06-20,NEFT/000047552366/Indiaforensic,0.0,2300000.0,,2018,6,20,CHECK_CASHING,2300000.0,C545710008
22308,1196428',2018-06-20,NEFT/000047553301/Indiaforensic,0.0,1600000.0,,2018,6,20,TRANSFER,1600000.0,C1838584624
22309,1196428',2018-06-20,TRF FROM  Indiaforensic SERVICES,0.0,6000000.0,,2018,6,20,CASH_IN,6000000.0,C1030706332
22310,1196428',2018-06-20,FDRL/INTERNAL FUND TRANSFE,5000000.0,0.0,,2018,6,20,PAYEMENT,5000000.0,M2129060443
22311,1196428',2018-06-20,FDRL/INTERNAL FUND TRANSFE,5000000.0,0.0,,2018,6,20,PAYEMENT,5000000.0,C1195471589
22312,1196428',2018-06-20,FDRL/INTERNAL FUND TRANSFE,1000000.0,0.0,,2018,6,20,PAYEMENT,1000000.0,M1398128260
22313,1196428',2018-06-20,FDRL/INTERNAL FUND TRANSFE,1000000.0,0.0,,2018,6,20,CHECK_WITHDRAWAL,1000000.0,C1856036778
22314,1196428',2018-06-20,BEAT CSH PKP DEL UDYOG 62,0.0,96000.0,,2018,6,20,TRANSFER,96000.0,C2067546399
22315,1196428',2018-06-21,NEFT/SBIN218172515314/NAR,0.0,38432.0,,2018,6,21,CASH_IN,38432.0,C818570949
22316,1196428',2018-06-21,RTGS/UTIBH18172675056/PER,0.0,400000.0,,2018,6,21,CHECK_CASHING,400000.0,M535878604
22317,1196428',2018-06-21,RTGS/SBINH18172005086/Indfor,0.0,3500000.0,,2018,6,21,CASH_IN,3500000.0,C358945794
22318,1196428',2018-06-21,FDRL/NATIONAL ELECTRONIC F,5317128.0,0.0,,2018,6,21,PAYEMENT,5317128.0,C922511709
22319,1196428',2018-06-21,CASHDEP/NOIDA/TP,0.0,100000.0,,2018,6,21,CASH_IN,100000.0,C988138425
22320,1196428',2018-06-21,FDRL/INTERNAL FUND TRANSFE,500000.0,0.0,,2018,6,21,CASH_OUT,500000.0,C814900611
22321,1196428',2018-06-21,NEFT/N172180567863680/BAJ,0.0,200000.0,,2018,6,21,CHECK_CASHING,200000.0,C1467740330
22322,1196428',2018-06-21,NEFT/PUNBH18172113467/BAL,0.0,100000.0,,2018,6,21,TRANSFER,100000.0,M858308953
22323,1196428',2018-06-21,TRF FROM  Indiaforensic SERVICES,0.0,1000000.0,,2018,6,21,CASH_IN,1000000.0,M1773085261
22324,1196428',2018-06-21,NEFT/N172180567965656/USH,0.0,69050.0,,2018,6,21,TRANSFER,69050.0,M472606308
22325,1196428',2018-06-21,CHQ DEP/178207/OWDEL1/KAR,0.0,11800.0,,2018,6,21,TRANSFER,11800.0,M51583809
22326,1196428',2018-06-21,CHQ DEP/83225/OWDEL1/SBIN,0.0,11800.0,,2018,6,21,CASH_IN,11800.0,M1337700382
22327,1196428',2018-06-21,CHQ DEP/600/OWDEL1/HDFC/S,0.0,11800.0,,2018,6,21,CHECK_CASHING,11800.0,C1918034924
22328,1196428',2018-06-21,CHQ DEP/2735/OWDEL1/SBIN/,0.0,11800.0,,2018,6,21,CASH_IN,11800.0,M527477577
22329,1196428',2018-06-21,CHQ DEP/649260/OWDEL1/IBK,0.0,11800.0,,2018,6,21,CASH_IN,11800.0,M577217292
22330,1196428',2018-06-21,CHQ DEP/535277/OWDEL1/SBI,0.0,11800.0,,2018,6,21,TRANSFER,11800.0,C184253187
22331,1196428',2018-06-21,CHQ DEP/173797/OWDEL1/SBI,0.0,11800.0,,2018,6,21,CASH_IN,11800.0,C1778300121
22332,1196428',2018-06-21,CHQ DEP/80670/OWDEL1/FDRL,0.0,11800.0,,2018,6,21,CHECK_CASHING,11800.0,C667504652
22333,1196428',2018-06-21,CHQ DEP/358/OWDEL1/HDFC/S,0.0,11800.0,,2018,6,21,CHECK_CASHING,11800.0,C638590716
22334,1196428',2018-06-21,CHQ DEP/69259/OWDEL1/CORP,0.0,11800.0,,2018,6,21,TRANSFER,11800.0,C1532153384
22335,1196428',2018-06-21,CHQ DEP/626/OWDEL1/ICIC/,0.0,11800.0,,2018,6,21,CASH_IN,11800.0,C208427878
22336,1196428',2018-06-21,CHQ DEP/430/OWDEL1/HDFC/B,0.0,11800.0,,2018,6,21,CASH_IN,11800.0,C1530086509
22337,1196428',2018-06-21,CHQ DEP/11441/OWDEL1/CORP,0.0,11800.0,,2018,6,21,CHECK_CASHING,11800.0,C703957828
22338,1196428',2018-06-21,CHQ DEP/16/OWDEL1/HDFC/28,0.0,11800.0,,2018,6,21,CHECK_CASHING,11800.0,C891020651
22339,1196428',2018-06-21,CHQ DEP/94063/OWDEL1/UTIB,0.0,11800.0,,2018,6,21,CHECK_CASHING,11800.0,M1680032445
22340,1196428',2018-06-21,CHQ DEP/73624/OWDEL1/HDFC,0.0,11800.0,,2018,6,21,CASH_IN,11800.0,C553264065
22341,1196428',2018-06-21,CHQ DEP/592/OWDEL1/ANDB/G,0.0,11800.0,,2018,6,21,CHECK_CASHING,11800.0,M1097298586
22342,1196428',2018-06-21,TRF FROM  Indiaforensic SERVICES,0.0,4600000.0,,2018,6,21,CHECK_CASHING,4600000.0,M870026554
22343,1196428',2018-06-21,NEFT/BARBR18172848867/MAK,0.0,55555.0,,2018,6,21,TRANSFER,55555.0,C695653925
22344,1196428',2018-06-21,FDRL/REAL TIME GROSS SETTL,1000000.0,0.0,,2018,6,21,DEBIT,1000000.0,M1248361658
22345,1196428',2018-06-21,FDRL/REAL TIME GROSS SETTL,5000000.0,0.0,,2018,6,21,DEBIT,5000000.0,C1689262323
22346,1196428',2018-06-21,RTGS/HDFCH18172218966/Indfor,0.0,6000000.0,,2018,6,21,TRANSFER,6000000.0,C1757877803
22347,1196428',2018-06-21,TRF FROM  Indiaforensic SERVICES,0.0,14900000.0,,2018,6,21,CHECK_CASHING,14900000.0,C1849933855
22348,1196428',2018-06-21,FDRL/REAL TIME GROSS SETTL,15000000.0,0.0,,2018,6,21,DEBIT,15000000.0,C1753128715
22349,1196428',2018-06-21,FDRL/REAL TIME GROSS SETTL,5000000.0,0.0,,2018,6,21,PAYEMENT,5000000.0,C1527761090
22350,1196428',2018-06-21,IMPS 817215772025 FROM SA,0.0,50000.0,,2018,6,21,CHECK_CASHING,50000.0,C1754722089
22351,1196428',2018-06-21,RTGS/PUNBH18172255700/PUN,0.0,450000.0,,2018,6,21,CASH_IN,450000.0,C1261039678
22352,1196428',2018-06-21,RTGS/ICICH18172731381/Indfor,0.0,5200000.0,,2018,6,21,CHECK_CASHING,5200000.0,C836514715
22353,1196428',2018-06-21,Indiaforensic SERVICES INDIA PVT,0.0,211633.0,,2018,6,21,TRANSFER,211633.0,C1640961071
22354,1196428',2018-06-21,CASHDEP/VIRAR-E/,0.0,28000.0,,2018,6,21,CASH_IN,28000.0,C1838584624
22355,1196428',2018-06-21,NEFT/P18062159306013/M/S,0.0,30000.0,,2018,6,21,CASH_IN,30000.0,C1209271652
22356,1196428',2018-06-21,NEFT/N172180568309713/TEC,0.0,200000.0,,2018,6,21,CHECK_CASHING,200000.0,C745740822
22357,1196428',2018-06-21,NEFT/SBIN318172298733/JAI,0.0,50000.0,,2018,6,21,CASH_IN,50000.0,C1401721023
22358,1196428',2018-06-21,BEAT CSH PKP DEL GURG 620,0.0,134600.0,,2018,6,21,CASH_IN,134600.0,C47827984
22359,1196428',2018-06-21,FDRL/INTERNAL FUND TRANSFE,8000000.0,0.0,,2018,6,21,CASH_OUT,8000000.0,C1849941462
22360,1196428',2018-06-21,TRF FROM  Indiaforensic SERVICES,0.0,7600000.0,,2018,6,21,CHECK_CASHING,7600000.0,C70895366
22361,1196428',2018-06-21,FDRL/INTERNAL FUND TRANSFE,6000000.0,0.0,,2018,6,21,DEBIT,6000000.0,C977993101
22362,1196428',2018-06-22,RTGS/UTIBH18173623276/PER,0.0,400000.0,,2018,6,22,CASH_IN,400000.0,C2116873183
22363,1196428',2018-06-22,NEFT/PUNBH18173296119/BAL,0.0,99000.0,,2018,6,22,CASH_IN,99000.0,C892686452
22364,1196428',2018-06-22,RTGS/SBINH18173000403/Indfor,0.0,3000000.0,,2018,6,22,CASH_IN,3000000.0,C1540270363
22365,1196428',2018-06-22,IMPS 817310368209 FROM AS,0.0,110110.0,,2018,6,22,TRANSFER,110110.0,C534662976
22366,1196428',2018-06-22,FDRL/NATIONAL ELECTRONIC F,4957712.0,0.0,,2018,6,22,DEBIT,4957712.0,C30013970
22367,1196428',2018-06-22,RTGS/PUNBH18173262512/MAN,0.0,300000.0,,2018,6,22,CHECK_CASHING,300000.0,C1809373351
22368,1196428',2018-06-22,NEFT/N173180568600929/USH,0.0,32000.0,,2018,6,22,CASH_IN,32000.0,C741431520
22369,1196428',2018-06-22,NEFT/SBIN318173413573/THA,0.0,22000.0,,2018,6,22,CASH_IN,22000.0,C669771073
22370,1196428',2018-06-22,IMPS 817312306666 FROM AS,0.0,55155.0,,2018,6,22,CHECK_CASHING,55155.0,C1915091057
22371,1196428',2018-06-22,NEFT/SBIN318173590866/MS,0.0,90000.0,,2018,6,22,CASH_IN,90000.0,C323287038
22372,1196428',2018-06-22,RTGS/PUNBH18173267503/PUN,0.0,450000.0,,2018,6,22,CASH_IN,450000.0,C1027992087
22373,1196428',2018-06-22,TRF FROM  Indiaforensic SERVICES,0.0,3800000.0,,2018,6,22,CHECK_CASHING,3800000.0,C1435804085
22374,1196428',2018-06-22,TRF FROM  Indiaforensic SERVICES,0.0,15000000.0,,2018,6,22,TRANSFER,15000000.0,C1153596299
22375,1196428',2018-06-22,NEFT/P18062259618254/M/S,0.0,80000.0,,2018,6,22,TRANSFER,80000.0,C1541743053
22376,1196428',2018-06-22,FDRL/REAL TIME GROSS SETTL,10000000.0,0.0,,2018,6,22,PAYEMENT,10000000.0,C1213257323
22377,1196428',2018-06-22,FDRL/REAL TIME GROSS SETTL,10000000.0,0.0,,2018,6,22,CHECK_WITHDRAWAL,10000000.0,C295081230
22378,1196428',2018-06-22,NEFT/N173180568775040/USH,0.0,80550.0,,2018,6,22,TRANSFER,80550.0,C531511436
22379,1196428',2018-06-22,NEFT/N173180568803458/PUB,0.0,40000.0,,2018,6,22,CASH_IN,40000.0,C175291188
22380,1196428',2018-06-22,NEFT/AXISP00000179537/ACC,0.0,5000000.0,,2018,6,22,TRANSFER,5000000.0,C1259769769
22381,1196428',2018-06-22,CASHDEP/OCUS TECH/,0.0,168500.0,,2018,6,22,CASH_IN,168500.0,C205300866
22382,1196428',2018-06-22,NEFT/SBIN318173722584/NAR,0.0,47235.0,,2018,6,22,TRANSFER,47235.0,C1297873690
22383,1196428',2018-06-22,NEFT/SBIN318173759762/LAX,0.0,100000.0,,2018,6,22,CHECK_CASHING,100000.0,C715819458
22384,1196428',2018-06-22,NEFT/SBIN318173797295/SUR,0.0,145000.0,,2018,6,22,CASH_IN,145000.0,C18928637
22385,1196428',2018-06-22,Indiaforensic SERVICES INDIA PVT,0.0,148984.0,,2018,6,22,CHECK_CASHING,148984.0,C1079343872
22386,1196428',2018-06-22,RTGS/ICICH18173856980/ART,0.0,5000000.0,,2018,6,22,CASH_IN,5000000.0,C99275333
22387,1196428',2018-06-22,FDRL/NATIONAL ELECTRONIC F,4000000.0,0.0,,2018,6,22,CASH_OUT,4000000.0,C1450828900
22388,1196428',2018-06-22,FDRL/NATIONAL ELECTRONIC F,1000000.0,0.0,,2018,6,22,PAYEMENT,1000000.0,C1339257929
22389,1196428',2018-06-22,NEFT/N173180569031089/TEC,0.0,200000.0,,2018,6,22,CHECK_CASHING,200000.0,C893041125
22390,1196428',2018-06-22,NEFT/SBIN318173936504/TAR,0.0,60000.0,,2018,6,22,CASH_IN,60000.0,C380242442
22391,1196428',2018-06-22,NEFT/000047697213/Indiaforensic,0.0,1000000.0,,2018,6,22,TRANSFER,1000000.0,C1220897602
22392,1196428',2018-06-22,NEFT/000047697617/Indiaforensic,0.0,2600000.0,,2018,6,22,TRANSFER,2600000.0,C495071437
22393,1196428',2018-06-22,NEFT/AXISP00000228545/ACC,0.0,4500000.0,,2018,6,22,TRANSFER,4500000.0,C1753128715
22394,1196428',2018-06-22,FDRL/NATIONAL ELECTRONIC F,495000.0,0.0,,2018,6,22,CASH_OUT,495000.0,C1387460501
22395,1196428',2018-06-22,FDRL/NATIONAL ELECTRONIC F,2000000.0,0.0,,2018,6,22,PAYEMENT,2000000.0,C425987411
22396,1196428',2018-06-22,FDRL/NATIONAL ELECTRONIC F,1485000.0,0.0,,2018,6,22,PAYEMENT,1485000.0,C914293025
22397,1196428',2018-06-22,FDRL/NATIONAL ELECTRONIC F,3000000.0,0.0,,2018,6,22,PAYEMENT,3000000.0,C1765998352
22398,1196428',2018-06-22,NEFT/N173180568954345/Indfor,0.0,5000000.0,,2018,6,22,CASH_IN,5000000.0,C1651144763
22399,1196428',2018-06-22,NEFT/AXISP00000228544/ACC,0.0,4000000.0,,2018,6,22,CASH_IN,4000000.0,C922871524
22400,1196428',2018-06-22,NEFT/AXISP00000228546/ACC,0.0,2500000.0,,2018,6,22,CHECK_CASHING,2500000.0,C854056805
22401,1196428',2018-06-22,NEFT/20587384081DC/ARTHAS,0.0,4000000.0,,2018,6,22,TRANSFER,4000000.0,C499052031
22402,1196428',2018-06-22,FDRL/INTERNAL FUND TRANSFE,500000.0,0.0,,2018,6,22,CHECK_WITHDRAWAL,500000.0,C1877059833
22403,1196428',2018-06-22,FDRL/INTERNAL FUND TRANSFE,1000000.0,0.0,,2018,6,22,CHECK_WITHDRAWAL,1000000.0,C769342184
22404,1196428',2018-06-22,TRF FROM  Indiaforensic SERVICES,0.0,7100000.0,,2018,6,22,TRANSFER,7100000.0,C265108079
22405,1196428',2018-06-22,FDRL/INTERNAL FUND TRANSFE,1000000.0,0.0,,2018,6,22,CASH_OUT,1000000.0,C1435804085
22406,1196428',2018-06-22,FDRL/INTERNAL FUND TRANSFE,200000.0,0.0,,2018,6,22,PAYEMENT,200000.0,C1997859171
22407,1196428',2018-06-22,TRF TO  Indiaforensic SERVICES I,10000000.0,0.0,,2018,6,22,CHECK_WITHDRAWAL,10000000.0,C480500119
22408,1196428',2018-06-22,FDRL/INTERNAL FUND TRANSFE,15000000.0,0.0,,2018,6,22,DEBIT,15000000.0,C1877976610
22409,1196428',2018-06-22,FDRL/INTERNAL FUND TRANSFE,2000000.0,0.0,,2018,6,22,DEBIT,2000000.0,C2078011503
22410,1196428',2018-06-22,BEAT CSH PKP DEL GURG 620,0.0,127000.0,,2018,6,22,CHECK_CASHING,127000.0,C176203926
22411,1196428',2018-06-22,TRF TO  Indiaforensic SERVICES I,10000000.0,0.0,,2018,6,22,CASH_OUT,10000000.0,C570588770
22412,1196428',2018-06-23,IMPS 817413356388 FROM AS,0.0,80995.0,,2018,6,23,CASH_IN,80995.0,C461905695
22413,1196428',2018-06-23,IMPS 817413357806 FROM AS,0.0,85005.0,,2018,6,23,CHECK_CASHING,85005.0,C1226372269
22414,1196428',2018-06-25,NEFT/SBIN418176225648/NAR,0.0,31536.0,,2018,6,25,TRANSFER,31536.0,C2078745453
22415,1196428',2018-06-25,NEFT/IDIBH18176283252/PVT,0.0,100000.0,,2018,6,25,CHECK_CASHING,100000.0,C2116873183
22416,1196428',2018-06-25,RTGS/UTIBH18176666356/PER,0.0,400000.0,,2018,6,25,CHECK_CASHING,400000.0,M1761540652
22417,1196428',2018-06-25,RTGS/HDFCH18176434500/BAT,0.0,200000.0,,2018,6,25,CHECK_CASHING,200000.0,C2078250226
22418,1196428',2018-06-25,RTGS/SBINH18176006147/Indfor,0.0,10000000.0,,2018,6,25,TRANSFER,10000000.0,M28362777
22419,1196428',2018-06-25,CASHDEP/NOIDA/TP,0.0,100000.0,,2018,6,25,TRANSFER,100000.0,M246493822
22420,1196428',2018-06-25,RTGS/HDFCH18176454969/USH,0.0,251050.0,,2018,6,25,CHECK_CASHING,251050.0,C276384108
22421,1196428',2018-06-25,RTGS/SBINH18176021053/Indfor,0.0,4100000.0,,2018,6,25,CASH_IN,4100000.0,C2071722626
22422,1196428',2018-06-25,RTGS/PUNBH18176286522/PUN,0.0,300000.0,,2018,6,25,TRANSFER,300000.0,C42519721
22423,1196428',2018-06-25,NEFT/ALLAH18176850707/Mr.,0.0,79750.0,,2018,6,25,CHECK_CASHING,79750.0,C26334874
22424,1196428',2018-06-25,CHQ DEP/974148/OWDEL2/SBI,0.0,11800.0,,2018,6,25,CHECK_CASHING,11800.0,M814297386
22425,1196428',2018-06-25,CHQ DEP/641047/OWDEL2/SBI,0.0,11800.0,,2018,6,25,TRANSFER,11800.0,C956986674
22426,1196428',2018-06-25,CHQ DEP/151194/OWDEL2/UBI,0.0,11800.0,,2018,6,25,CHECK_CASHING,11800.0,M1847065643
22427,1196428',2018-06-25,CHQ DEP/537399/OWDEL2/SBI,0.0,11800.0,,2018,6,25,CASH_IN,11800.0,M984618448
22428,1196428',2018-06-25,CHQ DEP/766281/OWDEL2/SBI,0.0,11800.0,,2018,6,25,CHECK_CASHING,11800.0,M3586073
22429,1196428',2018-06-25,CHQ DEP/503901/OWDEL2/SBI,0.0,11800.0,,2018,6,25,CHECK_CASHING,11800.0,M1494926351
22430,1196428',2018-06-25,CHQ DEP/920255/OWDEL2/SBI,0.0,11800.0,,2018,6,25,TRANSFER,11800.0,M848530779
22431,1196428',2018-06-25,CHQ DEP/653411/OWDEL2/SBI,0.0,11800.0,,2018,6,25,CHECK_CASHING,11800.0,M739284296
22432,1196428',2018-06-25,CHQ DEP/500312/OWDEL2/ICI,0.0,11800.0,,2018,6,25,TRANSFER,11800.0,M97446948
22433,1196428',2018-06-25,CHQ DEP/3679/OWDEL2/ALLA/,0.0,11800.0,,2018,6,25,CHECK_CASHING,11800.0,M651064363
22434,1196428',2018-06-25,CHQ DEP/430897/OWDEL2/PUN,0.0,11800.0,,2018,6,25,CHECK_CASHING,11800.0,M893498797
22435,1196428',2018-06-25,CHQ DEP/496457/OWDEL2/PUN,0.0,11800.0,,2018,6,25,CASH_IN,11800.0,M236623465
22436,1196428',2018-06-25,CHQ DEP/20/OWDEL2/HDFC/BI,0.0,11800.0,,2018,6,25,CASH_IN,11800.0,M394671208
22437,1196428',2018-06-25,NEFT/N176180569695598/USH,0.0,83750.0,,2018,6,25,TRANSFER,83750.0,M284726906
22438,1196428',2018-06-25,NEFT/SBIN418176490292/THA,0.0,300000.0,,2018,6,25,TRANSFER,300000.0,M152114681
22439,1196428',2018-06-25,IMPS 817614331160 FROM AS,0.0,80080.0,,2018,6,25,CHECK_CASHING,80080.0,M1213488634
22440,1196428',2018-06-25,NEFT/SBIN418176532913/NIB,0.0,11800.0,,2018,6,25,CASH_IN,11800.0,M1951189508
22441,1196428',2018-06-25,TRF FROM  Indiaforensic SERVICES,0.0,2800000.0,,2018,6,25,CASH_IN,2800000.0,M1485442629
22442,1196428',2018-06-25,NEFT/BARBS18176655881/MAK,0.0,50520.0,,2018,6,25,CHECK_CASHING,50520.0,M572783990
22443,1196428',2018-06-25,NEFT/P18062560136324/M/S,0.0,30000.0,,2018,6,25,TRANSFER,30000.0,C868288978
22444,1196428',2018-06-25,NEFT/SDL34620928/SAINI FI,0.0,160000.0,,2018,6,25,TRANSFER,160000.0,M428461112
22445,1196428',2018-06-25,CHQ DEPOSIT RETURN/151194,11800.0,0.0,,2018,6,25,DEBIT,11800.0,C1502143342
22446,1196428',2018-06-25,CHQ DEPOSIT RETURN/3679/E,11800.0,0.0,,2018,6,25,DEBIT,11800.0,C1271835801
22447,1196428',2018-06-25,NEFT/SBIN418176739651/SUR,0.0,85000.0,,2018,6,25,TRANSFER,85000.0,M2097661859
22448,1196428',2018-06-25,RTGS/ICICH18176311019/Indfor,0.0,2600000.0,,2018,6,25,TRANSFER,2600000.0,C1577420620
22449,1196428',2018-06-25,NEFT/PUNBH18176633338/PUN,0.0,100000.0,,2018,6,25,TRANSFER,100000.0,C749672494
22450,1196428',2018-06-25,RTGS/ICICH18176312408/Indfor,0.0,2000000.0,,2018,6,25,CASH_IN,2000000.0,C1880901678
22451,1196428',2018-06-25,NEFT/180625i171613671/JAY,0.0,56500.0,,2018,6,25,CHECK_CASHING,56500.0,C912252532
22452,1196428',2018-06-25,NEFT CHARGES AND GST/0000,29.5,0.0,,2018,6,25,PAYEMENT,29.5,C1326243087
22453,1196428',2018-06-25,NEFT/000041989305/INDIAN,4250056.0,0.0,,2018,6,25,DEBIT,4250056.0,C1746371201
22454,1196428',2018-06-25,NEFT/PUNBH18176646852/MAN,0.0,200000.0,,2018,6,25,CASH_IN,200000.0,C313124964
22455,1196428',2018-06-25,NEFT CHARGES AND GST/0000,29.5,0.0,,2018,6,25,PAYEMENT,29.5,C508000580
22456,1196428',2018-06-25,NEFT/000041990201/INDIAN,10904819.0,0.0,,2018,6,25,DEBIT,10904819.0,C254669696
22457,1196428',2018-06-25,TRF TO  Indiaforensic ONLINE SER,2000000.0,0.0,,2018,6,25,DEBIT,2000000.0,C1898859288
22458,1196428',2018-06-25,NEFT/N176180570033885/Indfor,0.0,8000000.0,,2018,6,25,TRANSFER,8000000.0,C1661355634
22459,1196428',2018-06-25,NEFT/SBIN418176977340/NAR,0.0,31853.0,,2018,6,25,CASH_IN,31853.0,C93166806
22460,1196428',2018-06-25,TRF TO  Indiaforensic SERVICES I,1000000.0,0.0,,2018,6,25,DEBIT,1000000.0,C708992245
22461,1196428',2018-06-25,TRF TO  Indiaforensic SERVICES I,500000.0,0.0,,2018,6,25,DEBIT,500000.0,C1778300121
22462,1196428',2018-06-25,BEAT CSH PKP DEL GURG 620,0.0,213500.0,,2018,6,25,TRANSFER,213500.0,C403649458
22463,1196428',2018-06-25,CHQ DEPOSIT RETURN/3679/C,100.0,0.0,,2018,6,25,CHECK_WITHDRAWAL,100.0,C173783788
22464,1196428',2018-06-25,CHQ DEPOSIT RETURN/3679/G,18.0,0.0,,2018,6,25,CHECK_WITHDRAWAL,18.0,C1128238842
22465,1196428',2018-06-26,RTGS/HDFCH18177636718/BAT,0.0,200000.0,,2018,6,26,CHECK_CASHING,200000.0,C1134266682
22466,1196428',2018-06-26,RTGS/UTIBH18177624178/PER,0.0,400000.0,,2018,6,26,TRANSFER,400000.0,C1450828900
22467,1196428',2018-06-26,Indiaforensic SERVICES INDIA PVT,0.0,437405.0,,2018,6,26,TRANSFER,437405.0,C58091972
22468,1196428',2018-06-26,NEFT/SBIN518177163725/SRI,0.0,100000.0,,2018,6,26,TRANSFER,100000.0,C497806226
22469,1196428',2018-06-26,CASHDEP/NOIDA/TP,0.0,136000.0,,2018,6,26,CASH_IN,136000.0,C1090263069
22470,1196428',2018-06-26,NEFT/IDIBH18177343415/PAL,0.0,30000.0,,2018,6,26,TRANSFER,30000.0,C851772371
22471,1196428',2018-06-26,NEFT/SBIN518177218595/NAR,0.0,32973.0,,2018,6,26,CASH_IN,32973.0,C1286084959
22472,1196428',2018-06-26,NEFT/N177180570492763/USH,0.0,113500.0,,2018,6,26,CASH_IN,113500.0,C2122200303
22473,1196428',2018-06-26,NEFT/N177180570544293/JUN,0.0,150000.0,,2018,6,26,TRANSFER,150000.0,C1030706332
22474,1196428',2018-06-26,RTGS/PUNBH18177314058/PUN,0.0,450000.0,,2018,6,26,TRANSFER,450000.0,C599726537
22475,1196428',2018-06-26,RTGS/YESBH18177600093/IND,5505709.0,0.0,,2018,6,26,DEBIT,5505709.0,C602874477
22476,1196428',2018-06-26,NEFT/SBIN518177464747/M R,0.0,31000.0,,2018,6,26,CHECK_CASHING,31000.0,C1295301356
22477,1196428',2018-06-26,RTGS/HDFCH18177775063/Indfor,0.0,9500000.0,,2018,6,26,TRANSFER,9500000.0,C1150610696
22478,1196428',2018-06-26,RTGS/YESBH18177609184/Indfor,8500000.0,0.0,,2018,6,26,CHECK_WITHDRAWAL,8500000.0,C2081595126
22479,1196428',2018-06-26,IMPS 817715498158 FROM SA,0.0,200000.0,,2018,6,26,CASH_IN,200000.0,C458582664
22480,1196428',2018-06-26,NEFT/SBIN518177562925/MS,0.0,50000.0,,2018,6,26,CASH_IN,50000.0,C712956349
22481,1196428',2018-06-26,NEFT/000137269339/KENDRAP,0.0,11800.0,,2018,6,26,CHECK_CASHING,11800.0,C48444237
22482,1196428',2018-06-26,NEFT/SBIN518177569173/Mr,0.0,11800.0,,2018,6,26,TRANSFER,11800.0,C30079792
22483,1196428',2018-06-26,RTGS/ICICH18177438576/Indfor,0.0,1500000.0,,2018,6,26,TRANSFER,1500000.0,C8733802
22484,1196428',2018-06-26,Indiaforensic SERVICES INDIA PVT,0.0,155889.0,,2018,6,26,CASH_IN,155889.0,C1257952957
22485,1196428',2018-06-26,IMPS 817717343279 FROM AS,0.0,55005.0,,2018,6,26,CHECK_CASHING,55005.0,C1698704934
22486,1196428',2018-06-26,NEFT/000047852155/Indiaforensic,0.0,1800000.0,,2018,6,26,TRANSFER,1800000.0,C1242584406
22487,1196428',2018-06-26,NEFT/FSFBH18177000066/FIN,0.0,123721.0,,2018,6,26,CHECK_CASHING,123721.0,C1802632685
22488,1196428',2018-06-26,TRF TO  Indiaforensic SERVICES I,1800000.0,0.0,,2018,6,26,DEBIT,1800000.0,C188246551
22489,1196428',2018-06-26,TRF TO  Indiaforensic SERVICES I,13700000.0,0.0,,2018,6,26,CHECK_WITHDRAWAL,13700000.0,C974088986
22490,1196428',2018-06-26,BEAT CSH PKP DEL GURG 620,0.0,74000.0,,2018,6,26,CASH_IN,74000.0,C1507516448
22491,1196428',2018-06-27,RTGS/UTIBH18178666144/PER,0.0,400000.0,,2018,6,27,CHECK_CASHING,400000.0,C470217116
22492,1196428',2018-06-27,IMPS 817809362283 FROM AS,0.0,110005.0,,2018,6,27,CASH_IN,110005.0,C2102040020
22493,1196428',2018-06-27,RTGS/SBINH18178006222/Indfor,0.0,7300000.0,,2018,6,27,CHECK_CASHING,7300000.0,C1059154409
22494,1196428',2018-06-27,RTGS/SBINH18178007307/Indfor,0.0,1100000.0,,2018,6,27,CASH_IN,1100000.0,C1545121117
22495,1196428',2018-06-27,CASHDEP/NOIDA/TP,0.0,90000.0,,2018,6,27,TRANSFER,90000.0,C1234776885
22496,1196428',2018-06-27,NEFT/N178180571052568/USH,0.0,160550.0,,2018,6,27,CASH_IN,160550.0,C2078250226
22497,1196428',2018-06-27,CASHDEP/GHATKOPAR/,0.0,10561.0,,2018,6,27,TRANSFER,10561.0,C1983747920
22498,1196428',2018-06-27,IW CLG/704233/INTEX TECHN,1000000.0,0.0,,2018,6,27,DEBIT,1000000.0,C310976964
22499,1196428',2018-06-27,IW CHQ RETURN/704233/EFFE,0.0,1000000.0,,2018,6,27,TRANSFER,1000000.0,C1815271991
22500,1196428',2018-06-27,RTGS/PUNBH18178332881/PUN,0.0,400000.0,,2018,6,27,CASH_IN,400000.0,C142211154
22501,1196428',2018-06-27,TRF FROM  Indiaforensic SERVICES,0.0,700000.0,,2018,6,27,TRANSFER,700000.0,C1745096940
22502,1196428',2018-06-27,TRF FROM  Indiaforensic SERVICES,0.0,9600000.0,,2018,6,27,CHECK_CASHING,9600000.0,C1426908073
22503,1196428',2018-06-27,RTGS/YESBH18178695621/IND,7229065.0,0.0,,2018,6,27,PAYEMENT,7229065.0,C665576141
22504,1196428',2018-06-27,NEFT/AXISP00000507812/ACC,0.0,1000000.0,,2018,6,27,TRANSFER,1000000.0,C671848738
22505,1196428',2018-06-27,NEFT/N178180571365923/BAT,0.0,100000.0,,2018,6,27,CHECK_CASHING,100000.0,C1805683209
22506,1196428',2018-06-27,NEFT/SBIN618178195281/SUR,0.0,85000.0,,2018,6,27,CHECK_CASHING,85000.0,C265108079
22507,1196428',2018-06-27,FDRL/NATIONAL ELECTRONIC F,2000000.0,0.0,,2018,6,27,DEBIT,2000000.0,M1434071015
22508,1196428',2018-06-27,NEFT/N178180571511190/TEC,0.0,500000.0,,2018,6,27,TRANSFER,500000.0,M2052251548
22509,1196428',2018-06-27,IMPS 817817191297 FROM AS,0.0,11800.0,,2018,6,27,CASH_IN,11800.0,M1402740973
22510,1196428',2018-06-27,NEFT/N178180571524311/Indfor,0.0,7000000.0,,2018,6,27,TRANSFER,7000000.0,M1872929363
22511,1196428',2018-06-27,TRF TO  Indiaforensic SERVICES I,2000000.0,0.0,,2018,6,27,PAYEMENT,2000000.0,M1676669980
22512,1196428',2018-06-27,NEFT/SBIN618178363693/NAR,0.0,23293.0,,2018,6,27,TRANSFER,23293.0,C1570256460
22513,1196428',2018-06-27,BEAT CSH PKP DEL GURG 620,0.0,217600.0,,2018,6,27,TRANSFER,217600.0,C740950652
22514,1196428',2018-06-27,IMPS 817821670892 FROM MR,0.0,25000.0,,2018,6,27,CASH_IN,25000.0,C269016862
22515,1196428',2018-06-27,INWARD CHQ RETURN/704233/,350.0,0.0,,2018,6,27,CASH_OUT,350.0,M210050593
22516,1196428',2018-06-27,INWARD CHQ RETURN/704233/,63.0,0.0,,2018,6,27,DEBIT,63.0,M941448888
22517,1196428',2018-06-28,RTGS/SBINH18179003304/Indfor,0.0,1500000.0,,2018,6,28,CHECK_CASHING,1500000.0,C1458121951
22518,1196428',2018-06-28,NEFT/SBIN618179480319/TAR,0.0,180000.0,,2018,6,28,TRANSFER,180000.0,C383296094
22519,1196428',2018-06-28,CASHDEP/NOIDA/TP,0.0,115000.0,,2018,6,28,TRANSFER,115000.0,M1440810997
22520,1196428',2018-06-28,NEFT/N179180571858367/USH,0.0,190650.0,,2018,6,28,CHECK_CASHING,190650.0,M1925755298
22521,1196428',2018-06-28,NEFT/N179180571880665/SAT,0.0,11800.0,,2018,6,28,CASH_IN,11800.0,M1942304864
22522,1196428',2018-06-28,CHQ DEP/184278/OWDEL1/PUN,0.0,11800.0,,2018,6,28,CHECK_CASHING,11800.0,M57325187
22523,1196428',2018-06-28,CHQ DEP/33302/OWDEL1/IOBA,0.0,11800.0,,2018,6,28,CHECK_CASHING,11800.0,C1982740534
22524,1196428',2018-06-28,CHQ DEP/795118/OWDEL1/SBI,0.0,11800.0,,2018,6,28,TRANSFER,11800.0,C257761496
22525,1196428',2018-06-28,CHQ DEP/60237/OWDEL1/SBIN,0.0,11800.0,,2018,6,28,TRANSFER,11800.0,C1038678108
22526,1196428',2018-06-28,CHQ DEP/241003/OWDEL1/SBI,0.0,11800.0,,2018,6,28,CASH_IN,11800.0,C662035758
22527,1196428',2018-06-28,CHQ DEP/457/OWDEL1/HDFC/P,0.0,11800.0,,2018,6,28,CASH_IN,11800.0,C1575675375
22528,1196428',2018-06-28,CHQ DEP/118207/OWDEL1/SBI,0.0,11800.0,,2018,6,28,CHECK_CASHING,11800.0,M1103954125
22529,1196428',2018-06-28,CHQ DEP/175615/OWDEL1/SBI,0.0,11800.0,,2018,6,28,CASH_IN,11800.0,M653465317
22530,1196428',2018-06-28,CHQ DEP/24141/OWDEL1/ORBC,0.0,11800.0,,2018,6,28,CASH_IN,11800.0,M1846813183
22531,1196428',2018-06-28,CHQ DEP/1104/OWDEL1/BARB/,0.0,11800.0,,2018,6,28,TRANSFER,11800.0,C163453316
22532,1196428',2018-06-28,CHQ DEP/678510/OWDEL1/SBI,0.0,11800.0,,2018,6,28,CASH_IN,11800.0,M751171445
22533,1196428',2018-06-28,CHQ DEP/160540/OWDEL1/SBI,0.0,11800.0,,2018,6,28,TRANSFER,11800.0,M2130228157
22534,1196428',2018-06-28,CHQ DEP/48774/OWDEL1/SBIN,0.0,11800.0,,2018,6,28,CASH_IN,11800.0,M223119530
22535,1196428',2018-06-28,CHQ DEP/335118/OWDEL1/UTI,0.0,11800.0,,2018,6,28,TRANSFER,11800.0,C934085675
22536,1196428',2018-06-28,CHQ DEP/397822/OWDEL1/SBI,0.0,11800.0,,2018,6,28,CASH_IN,11800.0,M1595876579
22537,1196428',2018-06-28,CHQ DEP/339531/OWDEL1/BKI,0.0,11800.0,,2018,6,28,TRANSFER,11800.0,M1511459435
22538,1196428',2018-06-28,CHQ DEP/31911/OWDEL1/ORBC,0.0,11800.0,,2018,6,28,CHECK_CASHING,11800.0,M1516573709
22539,1196428',2018-06-28,CHQ DEP/429872/OWDEL1/YES,0.0,11800.0,,2018,6,28,CASH_IN,11800.0,M1904666896
22540,1196428',2018-06-28,CHQ DEP/233718/OWDEL1/SBI,0.0,11800.0,,2018,6,28,CASH_IN,11800.0,M664056415
22541,1196428',2018-06-28,CHQ DEP/11/OWDEL1/BARB/V.,0.0,11800.0,,2018,6,28,TRANSFER,11800.0,M1967278181
22542,1196428',2018-06-28,CHQ DEP/22662/OWDEL1/PUNB,0.0,11800.0,,2018,6,28,CASH_IN,11800.0,M975500183
22543,1196428',2018-06-28,NEFT/SBIN618179700485/THA,0.0,15000.0,,2018,6,28,TRANSFER,15000.0,M967302698
22544,1196428',2018-06-28,RTGS/PUNBH18179352644/PUN,0.0,300000.0,,2018,6,28,CHECK_CASHING,300000.0,M433800899
22545,1196428',2018-06-28,NEFT/SAA137976429/BHAMBRA,0.0,100000.0,,2018,6,28,TRANSFER,100000.0,M1296006762
22546,1196428',2018-06-28,FDRL/NATIONAL ELECTRONIC F,8418871.0,0.0,,2018,6,28,CHECK_WITHDRAWAL,8418871.0,M2133996790
22547,1196428',2018-06-28,CHQ DEPOSIT RETURN/184278,11800.0,0.0,,2018,6,28,PAYEMENT,11800.0,M1986360419
22548,1196428',2018-06-28,CHQ DEPOSIT RETURN/241003,11800.0,0.0,,2018,6,28,CASH_OUT,11800.0,M1088234929
22549,1196428',2018-06-28,CHQ DEPOSIT RETURN/457/FU,11800.0,0.0,,2018,6,28,DEBIT,11800.0,M554977470
22550,1196428',2018-06-28,CHQ DEPOSIT RETURN/24141/,11800.0,0.0,,2018,6,28,CHECK_WITHDRAWAL,11800.0,C347696158
22551,1196428',2018-06-28,NEFT/P18062861209936/M/S,0.0,30000.0,,2018,6,28,CASH_IN,30000.0,C787033725
22552,1196428',2018-06-28,NEFT/N179180572271099/MAH,0.0,150000.0,,2018,6,28,TRANSFER,150000.0,C1141049797
22553,1196428',2018-06-28,NEFT/AXISP00000658509/ACC,0.0,2000000.0,,2018,6,28,TRANSFER,2000000.0,M103011325
22554,1196428',2018-06-28,IMPS 817915305757 FROM AS,0.0,65165.0,,2018,6,28,TRANSFER,65165.0,C644345897
22555,1196428',2018-06-28,NEFT/SBIN618179903376/APO,0.0,11800.0,,2018,6,28,CHECK_CASHING,11800.0,M1614615156
22556,1196428',2018-06-28,RTGS/HDFCH18179110418/BAT,0.0,200000.0,,2018,6,28,CHECK_CASHING,200000.0,M852772208
22557,1196428',2018-06-28,IMPS 817916311595 FROM AS,0.0,75075.0,,2018,6,28,TRANSFER,75075.0,C603904068
22558,1196428',2018-06-28,RTGS/HDFCH18179124251/Indfor,0.0,500000.0,,2018,6,28,CHECK_CASHING,500000.0,C1092318644
22559,1196428',2018-06-28,RTGS/HDFCH18179122427/Indfor,0.0,1000000.0,,2018,6,28,CHECK_CASHING,1000000.0,C1201057368
22560,1196428',2018-06-28,RTGS/HDFCH18179124798/Indfor,0.0,500000.0,,2018,6,28,TRANSFER,500000.0,C2020180625
22561,1196428',2018-06-28,RTGS/HDFCH18179119793/Indfor,0.0,1000000.0,,2018,6,28,CASH_IN,1000000.0,C699026377
22562,1196428',2018-06-28,NEFT/SBIN618179982800/SRI,0.0,100000.0,,2018,6,28,CASH_IN,100000.0,C1373172466
22563,1196428',2018-06-28,NEFT/20593796781DC/ARTHAS,0.0,50000.0,,2018,6,28,CHECK_CASHING,50000.0,M1098941419
22564,1196428',2018-06-28,Indiaforensic SERVICES INDIA PVT,0.0,326044.0,,2018,6,28,CASH_IN,326044.0,M1629393307
22565,1196428',2018-06-28,FDRL/NATIONAL ELECTRONIC F,257843.0,0.0,,2018,6,28,DEBIT,257843.0,C1019670582
22566,1196428',2018-06-28,PROCESSING_FEE_ODGEN,1200000.0,0.0,,2018,6,28,CASH_OUT,1200000.0,M996004198
22567,1196428',2018-06-28,GOODS AND SERVICES TAX,216000.0,0.0,,2018,6,28,CASH_OUT,216000.0,C1785360415
22568,1196428',2018-06-28,FDRL/NATIONAL ELECTRONIC F,673996.0,0.0,,2018,6,28,PAYEMENT,673996.0,C1645903235
22569,1196428',2018-06-28,FDRL/NATIONAL ELECTRONIC F,97539.0,0.0,,2018,6,28,PAYEMENT,97539.0,C348708793
22570,1196428',2018-06-28,FDRL/NATIONAL ELECTRONIC F,273933.0,0.0,,2018,6,28,DEBIT,273933.0,M306325441
22571,1196428',2018-06-28,IMPS 817917104606 FROM SA,0.0,100000.0,,2018,6,28,TRANSFER,100000.0,C1756732975
22572,1196428',2018-06-28,FDRL/INTERNAL FUND TRANSFE,3000000.0,0.0,,2018,6,28,CASH_OUT,3000000.0,C2011996123
22573,1196428',2018-06-28,FDRL/INTERNAL FUND TRANSFE,1000000.0,0.0,,2018,6,28,CHECK_WITHDRAWAL,1000000.0,M1032168096
22574,1196428',2018-06-28,FDRL/INTERNAL FUND TRANSFE,500000.0,0.0,,2018,6,28,CASH_OUT,500000.0,M1843853261
22575,1196428',2018-06-28,FDRL/INTERNAL FUND TRANSFE,200000.0,0.0,,2018,6,28,PAYEMENT,200000.0,M339830788
22576,1196428',2018-06-28,CHQ DEPOSIT RETURN/241003,100.0,0.0,,2018,6,28,CASH_OUT,100.0,C884262954
22577,1196428',2018-06-28,CHQ DEPOSIT RETURN/241003,18.0,0.0,,2018,6,28,DEBIT,18.0,C1891412311
22578,1196428',2018-06-28,CHQ DEPOSIT RETURN/457/CH,100.0,0.0,,2018,6,28,PAYEMENT,100.0,M663046011
22579,1196428',2018-06-28,CHQ DEPOSIT RETURN/457/GS,18.0,0.0,,2018,6,28,PAYEMENT,18.0,C1479091350
22580,1196428',2018-06-28,CHQ DEPOSIT RETURN/24141/,100.0,0.0,,2018,6,28,DEBIT,100.0,C1636786811
22581,1196428',2018-06-28,CHQ DEPOSIT RETURN/24141/,18.0,0.0,,2018,6,28,PAYEMENT,18.0,C1210315704
22582,1196428',2018-06-29,NEFT/SBIN718180341730/NAR,0.0,27512.0,,2018,6,29,TRANSFER,27512.0,C8290162
22583,1196428',2018-06-29,RTGS/SBINH18180004087/Indfor,0.0,5500000.0,,2018,6,29,CASH_IN,5500000.0,C341552838
22584,1196428',2018-06-29,CASHDEP/NOIDA/,0.0,130000.0,,2018,6,29,TRANSFER,130000.0,M1241654243
22585,1196428',2018-06-29,FDRL/REAL TIME GROSS SETTL,6055999.0,0.0,,2018,6,29,DEBIT,6055999.0,M815188323
22586,1196428',2018-06-29,TRF FROM  Indiaforensic SERVICES,0.0,2000000.0,,2018,6,29,CHECK_CASHING,2000000.0,M815006683
22587,1196428',2018-06-29,"Indiaforensic USA, INC./USD/1428",0.0,973977.16,,2018,6,29,CASH_IN,973977.16,M1630493678
22588,1196428',2018-06-29,IRTT00701819144,1261.58,0.0,,2018,6,29,DEBIT,1261.58,M190735418
22589,1196428',2018-06-29,NEFT/SBIN718180557999/THA,0.0,50000.0,,2018,6,29,TRANSFER,50000.0,M1431946667
22590,1196428',2018-06-29,FDRL/REAL TIME GROSS SETTL,1000000.0,0.0,,2018,6,29,PAYEMENT,1000000.0,M387111320
22591,1196428',2018-06-29,FDRL/REAL TIME GROSS SETTL,1000000.0,0.0,,2018,6,29,PAYEMENT,1000000.0,C1927159174
22592,1196428',2018-06-29,FDRL/REAL TIME GROSS SETTL,1000000.0,0.0,,2018,6,29,CHECK_WITHDRAWAL,1000000.0,M352402565
22593,1196428',2018-06-29,RTGS/PUNBH18180369156/MAN,0.0,300000.0,,2018,6,29,CASH_IN,300000.0,C1374063565
22594,1196428',2018-06-29,TRF FROM  Indiaforensic SERVICES,0.0,15000000.0,,2018,6,29,TRANSFER,15000000.0,M1884654731
22595,1196428',2018-06-29,TRF FROM  Indiaforensic SERVICES,0.0,1600000.0,,2018,6,29,CHECK_CASHING,1600000.0,M257733880
22596,1196428',2018-06-29,IMPS 818013366237 FROM AS,0.0,85085.0,,2018,6,29,CHECK_CASHING,85085.0,M377017996
22597,1196428',2018-06-29,FDRL/REAL TIME GROSS SETTL,15000000.0,0.0,,2018,6,29,PAYEMENT,15000000.0,M1943183108
22598,1196428',2018-06-29,FDRL/REAL TIME GROSS SETTL,1000000.0,0.0,,2018,6,29,DEBIT,1000000.0,M1080822505
22599,1196428',2018-06-29,FDRL/REAL TIME GROSS SETTL,1000000.0,0.0,,2018,6,29,PAYEMENT,1000000.0,M645812954
22600,1196428',2018-06-29,RTGS/ANDBH18180318162/SHI,0.0,500000.0,,2018,6,29,CHECK_CASHING,500000.0,M361776472
22601,1196428',2018-06-29,NEFT/AXISP00000815003/ACC,0.0,4000000.0,,2018,6,29,TRANSFER,4000000.0,M515508946
22602,1196428',2018-06-29,FDRL/INTERNAL FUND TRANSFE,500000.0,0.0,,2018,6,29,CASH_OUT,500000.0,M1696779121
22603,1196428',2018-06-29,FDRL/INTERNAL FUND TRANSFE,500000.0,0.0,,2018,6,29,PAYEMENT,500000.0,M1378993004
22604,1196428',2018-06-29,NEFT/P18062961639310/M/S,0.0,30000.0,,2018,6,29,CASH_IN,30000.0,M745452187
22605,1196428',2018-06-29,NEFT/SBIN818180257441/TAR,0.0,120000.0,,2018,6,29,TRANSFER,120000.0,M1908378560
22606,1196428',2018-06-29,NEFT/N180180573613090/Indfor,0.0,7000000.0,,2018,6,29,CHECK_CASHING,7000000.0,M1402552623
22607,1196428',2018-06-29,IMPS 818018757476 FROM SA,0.0,50000.0,,2018,6,29,TRANSFER,50000.0,M996435159
22608,1196428',2018-06-29,FDRL/INTERNAL FUND TRANSFE,8000000.0,0.0,,2018,6,29,DEBIT,8000000.0,M2123362524
22609,1196428',2018-06-29,FDRL/INTERNAL FUND TRANSFE,500000.0,0.0,,2018,6,29,CASH_OUT,500000.0,M283724477
22610,1196428',2018-06-30,NEFT/SBIN818181533775/NAR,0.0,31273.0,,2018,6,30,CHECK_CASHING,31273.0,M1142682593
22611,1196428',2018-06-30,RTGS/SBINH18181002904/Indfor,0.0,6900000.0,,2018,6,30,CHECK_CASHING,6900000.0,M150320202
22612,1196428',2018-06-30,FDRL/REAL TIME GROSS SETTL,5991324.55,0.0,,2018,6,30,PAYEMENT,5991324.55,C1022023283
22613,1196428',2018-06-30,IMPS 818112817592 FROM SR,0.0,5000.0,,2018,6,30,CHECK_CASHING,5000.0,M116088759
22614,1196428',2018-06-30,FDRL/REAL TIME GROSS SETTL,1000000.0,0.0,,2018,6,30,CASH_OUT,1000000.0,M887366342
22615,1196428',2018-06-30,FDRL/REAL TIME GROSS SETTL,1000000.0,0.0,,2018,6,30,CASH_OUT,1000000.0,M528920512
22616,1196428',2018-06-30,FDRL/REAL TIME GROSS SETTL,1000000.0,0.0,,2018,6,30,PAYEMENT,1000000.0,M1727197598
22617,1196428',2018-06-30,RTGS/SBINH18181020958/SRI,0.0,200000.0,,2018,6,30,CASH_IN,200000.0,C1375936066
22618,1196428',2018-06-30,NEFT/N181180574137748/USH,0.0,170250.0,,2018,6,30,CHECK_CASHING,170250.0,C731253803
22619,1196428',2018-06-30,NEFT/SDL34794507/SAINI FI,0.0,175000.0,,2018,6,30,TRANSFER,175000.0,M1203900451
22620,1196428',2018-06-30,NEFT/N181180574287895/BAT,0.0,25000.0,,2018,6,30,TRANSFER,25000.0,M2144612683
22621,1196428',2018-06-30,TRF FROM  Indiaforensic SERVICES,0.0,15000000.0,,2018,6,30,CASH_IN,15000000.0,C23211803
22622,1196428',2018-06-30,TRF FROM  Indiaforensic SERVICES,0.0,4000000.0,,2018,6,30,TRANSFER,4000000.0,M1463749413
22623,1196428',2018-06-30,TRF FROM  Indiaforensic SERVICES,0.0,500000.0,,2018,6,30,TRANSFER,500000.0,C1881246122
22624,1196428',2018-06-30,RTGS/PUNBH18181389973/PUN,0.0,250000.0,,2018,6,30,CHECK_CASHING,250000.0,C1915089150
22625,1196428',2018-06-30,IMPS 818114365797 FROM AS,0.0,110110.0,,2018,6,30,CHECK_CASHING,110110.0,M1408014260
22626,1196428',2018-06-30,NEFT/P18063062014368/M/S,0.0,60000.0,,2018,6,30,CHECK_CASHING,60000.0,C36856762
22627,1196428',2018-06-30,FDRL/NATIONAL ELECTRONIC F,301002.0,0.0,,2018,6,30,DEBIT,301002.0,C382934088
22628,1196428',2018-06-30,FDRL/NATIONAL ELECTRONIC F,296467.0,0.0,,2018,6,30,CASH_OUT,296467.0,C1475998599
22629,1196428',2018-06-30,FDRL/NATIONAL ELECTRONIC F,96000.0,0.0,,2018,6,30,CHECK_WITHDRAWAL,96000.0,C744708435
22630,1196428',2018-06-30,NEFT/SBIN818181885662/M R,0.0,51000.0,,2018,6,30,CHECK_CASHING,51000.0,C1883840933
22631,1196428',2018-06-30,FDRL/REAL TIME GROSS SETTL,15000000.0,0.0,,2018,6,30,CASH_OUT,15000000.0,M981457162
22632,1196428',2018-06-30,FDRL/INTERNAL FUND TRANSFE,500000.0,0.0,,2018,6,30,CASH_OUT,500000.0,M1252304327
22633,1196428',2018-06-30,FDRL/NATIONAL ELECTRONIC F,4000000.0,0.0,,2018,6,30,CHECK_WITHDRAWAL,4000000.0,C1220897602
22634,1196428',2018-06-30,NEFT/N181180574361903/PUB,0.0,21000.0,,2018,6,30,CASH_IN,21000.0,M1481618158
22635,1196428',2018-06-30,NEFT/AXISP00000976313/ACC,0.0,13000000.0,,2018,6,30,CASH_IN,13000000.0,M836526608
22636,1196428',2018-06-30,Indiaforensic SERVICES INDIA PVT,0.0,164890.0,,2018,6,30,CHECK_CASHING,164890.0,C2147195354
22637,1196428',2018-06-30,NEFT/SBIN918181013588/NAR,0.0,33135.0,,2018,6,30,TRANSFER,33135.0,M755733613
22638,1196428',2018-06-30,CASHDEP/NOIDA/,0.0,50000.0,,2018,6,30,CASH_IN,50000.0,M1240516706
22639,1196428',2018-06-30,FDRL/REAL TIME GROSS SETTL,5000000.0,0.0,,2018,6,30,DEBIT,5000000.0,C1651924497
22640,1196428',2018-06-30,IMPS 818115911310 FROM MR,0.0,25000.0,,2018,6,30,CHECK_CASHING,25000.0,M293185891
22641,1196428',2018-06-30,NEFT/SBIN918181108459/ALA,0.0,11800.0,,2018,6,30,TRANSFER,11800.0,M442159262
22642,1196428',2018-06-30,NEFT/000048093039/Indiaforensic,0.0,1000000.0,,2018,6,30,TRANSFER,1000000.0,C262911569
22643,1196428',2018-06-30,NEFT/KARBN18181378844/POU,0.0,11800.0,,2018,6,30,CHECK_CASHING,11800.0,M1240313636
22644,1196428',2018-06-30,NEFT/000048105304/Indiaforensic,0.0,500000.0,,2018,6,30,TRANSFER,500000.0,M1850391384
22645,1196428',2018-06-30,NEFT/000048092449/Indiaforensic,0.0,500000.0,,2018,6,30,CHECK_CASHING,500000.0,C118136684
22646,1196428',2018-06-30,TRF FROM  Indiaforensic SERVICES,0.0,4000000.0,,2018,6,30,CHECK_CASHING,4000000.0,C1938612885
22647,1196428',2018-06-30,TRF FROM  Indiaforensic SERVICES,0.0,500000.0,,2018,6,30,CASH_IN,500000.0,M1302106077
22648,1196428',2018-06-30,FDRL/NATIONAL ELECTRONIC F,2000000.0,0.0,,2018,6,30,PAYEMENT,2000000.0,M1777913544
22649,1196428',2018-06-30,FDRL/NATIONAL ELECTRONIC F,3000000.0,0.0,,2018,6,30,CASH_OUT,3000000.0,M228073029
22650,1196428',2018-06-30,NEFT/N181180574574445/Indfor,0.0,5000000.0,,2018,6,30,CHECK_CASHING,5000000.0,M924623273
22651,1196428',2018-06-30,FDRL/INTERNAL FUND TRANSFE,15000000.0,0.0,,2018,6,30,PAYEMENT,15000000.0,M1118533018
22652,1196428',2018-06-30,FDRL/INTERNAL FUND TRANSFE,500000.0,0.0,,2018,6,30,PAYEMENT,500000.0,M1706548091
22653,1196428',2018-06-30,1196428:Int.Coll:01-06-20,824061.0,0.0,,2018,6,30,DEBIT,824061.0,M311152880
22654,1196428',2018-07-02,NEFT/BARBV18183012507/MAK,0.0,70870.0,,2018,7,2,TRANSFER,70870.0,C506903242
22655,1196428',2018-07-02,RTGS/SBINH18183003765/Indfor,0.0,11000000.0,,2018,7,2,TRANSFER,11000000.0,M2072059657
22656,1196428',2018-07-02,FDRL/REAL TIME GROSS SETTL,6705214.95,0.0,,2018,7,2,CASH_OUT,6705214.95,C304406966
22657,1196428',2018-07-02,RTGS/SBINH18183007775/Indfor,0.0,400000.0,,2018,7,2,CHECK_CASHING,400000.0,C75629578
22658,1196428',2018-07-02,FDRL/REAL TIME GROSS SETTL,4105381.83,0.0,,2018,7,2,CASH_OUT,4105381.83,M1037398211
22659,1196428',2018-07-02,CASHDEP/VIKASMARG/TP,0.0,286500.0,,2018,7,2,CASH_IN,286500.0,C2072030256
22660,1196428',2018-07-02,RTGS/HDFCH18183537951/BAT,0.0,300000.0,,2018,7,2,CHECK_CASHING,300000.0,C886888353
22661,1196428',2018-07-02,NEFT/N183180575610950/USH,0.0,155950.0,,2018,7,2,TRANSFER,155950.0,C701279123
22662,1196428',2018-07-02,FDRL/INTERNAL FUND TRANSFE,500000.0,0.0,,2018,7,2,CHECK_WITHDRAWAL,500000.0,C864016033
22663,1196428',2018-07-02,TRF FROM  Indiaforensic SERVICES,0.0,15000000.0,,2018,7,2,CHECK_CASHING,15000000.0,C515442419
22664,1196428',2018-07-02,TRF FROM  Indiaforensic SERVICES,0.0,10000000.0,,2018,7,2,CASH_IN,10000000.0,M2127093801
22665,1196428',2018-07-02,TRF FROM  Indiaforensic SERVICES,0.0,3000000.0,,2018,7,2,CHECK_CASHING,3000000.0,C1649686970
22666,1196428',2018-07-02,FDRL/REAL TIME GROSS SETTL,15000000.0,0.0,,2018,7,2,CASH_OUT,15000000.0,C701855966
22667,1196428',2018-07-02,FDRL/REAL TIME GROSS SETTL,10000000.0,0.0,,2018,7,2,CASH_OUT,10000000.0,C1505217516
22668,1196428',2018-07-02,IMPS 818314372197 FROM AS,0.0,100099.0,,2018,7,2,CHECK_CASHING,100099.0,M676875212
22669,1196428',2018-07-02,FDRL/REAL TIME GROSS SETTL,1000000.0,0.0,,2018,7,2,DEBIT,1000000.0,C681709819
22670,1196428',2018-07-02,FDRL/REAL TIME GROSS SETTL,1000000.0,0.0,,2018,7,2,DEBIT,1000000.0,M1025042585
22671,1196428',2018-07-02,FDRL/REAL TIME GROSS SETTL,1000000.0,0.0,,2018,7,2,PAYEMENT,1000000.0,C807247901
22672,1196428',2018-07-02,FDRL/INTERNAL FUND TRANSFE,400000.0,0.0,,2018,7,2,CASH_OUT,400000.0,M18308448
22673,1196428',2018-07-02,NEFT/P18070262397892/M/S,0.0,30000.0,,2018,7,2,CHECK_CASHING,30000.0,M170030714
22674,1196428',2018-07-02,RTGS/HDFCH18183635801/Indfor,0.0,4500000.0,,2018,7,2,TRANSFER,4500000.0,M621155607
22675,1196428',2018-07-02,NEFT/N183180576110955/GIL,0.0,601000.0,,2018,7,2,CASH_IN,601000.0,C1660095722
22676,1196428',2018-07-02,NEFT/SBIN118183652301/SUR,0.0,45000.0,,2018,7,2,CHECK_CASHING,45000.0,M1571765149
22677,1196428',2018-07-02,TRF FROM  Indiaforensic SERVICES,0.0,500000.0,,2018,7,2,CASH_IN,500000.0,C1663686815
22678,1196428',2018-07-02,TRF FROM  Indiaforensic SERVICES,0.0,14900000.0,,2018,7,2,CHECK_CASHING,14900000.0,M279824269
22679,1196428',2018-07-02,FDRL/INTERNAL FUND TRANSFE,15000000.0,0.0,,2018,7,2,PAYEMENT,15000000.0,M1570490488
22680,1196428',2018-07-02,FDRL/INTERNAL FUND TRANSFE,500000.0,0.0,,2018,7,2,CASH_OUT,500000.0,M1063002743
22681,1196428',2018-07-02,FDRL/INTERNAL FUND TRANSFE,2000000.0,0.0,,2018,7,2,DEBIT,2000000.0,M1530195938
22682,1196428',2018-07-02,NEFT/SBIN218183007960/NAR,0.0,33273.0,,2018,7,2,TRANSFER,33273.0,C1883840933
22683,1196428',2018-07-02,BEAT CSH PKP DEL UDYOG 62,0.0,277500.0,,2018,7,2,CHECK_CASHING,277500.0,M2097586567
22684,1196428',2018-07-02,FDRL/INTERNAL FUND TRANSFE,500000.0,0.0,,2018,7,2,CHECK_WITHDRAWAL,500000.0,C1700852615
22685,1196428',2018-07-02,FDRL/INTERNAL FUND TRANSFE,500000.0,0.0,,2018,7,2,DEBIT,500000.0,C1457728035
22686,1196428',2018-07-03,FDRL/INTERNAL FUND TRANSFE,500000.0,0.0,,2018,7,3,CASH_OUT,500000.0,C47249488
22687,1196428',2018-07-03,RTGS/SBINH18184007827/Indfor,0.0,2100000.0,,2018,7,3,CASH_IN,2100000.0,C33524623
22688,1196428',2018-07-03,IMPS 818411317603 FROM AS,0.0,120120.0,,2018,7,3,TRANSFER,120120.0,C2133591152
22689,1196428',2018-07-03,RTGS/PUNBH18184421105/MAN,0.0,300000.0,,2018,7,3,TRANSFER,300000.0,C193864812
22690,1196428',2018-07-03,NEFT/SBIN218184209426/THA,0.0,62000.0,,2018,7,3,CASH_IN,62000.0,C1058921154
22691,1196428',2018-07-03,FDRL/REAL TIME GROSS SETTL,3943315.38,0.0,,2018,7,3,CHECK_WITHDRAWAL,3943315.38,C798678484
22692,1196428',2018-07-03,NEFT/PUNBH18184853799/RAT,0.0,19400.0,,2018,7,3,CASH_IN,19400.0,C769342184
22693,1196428',2018-07-03,NEFT/N184180576821984/USH,0.0,148690.0,,2018,7,3,CASH_IN,148690.0,C981198566
22694,1196428',2018-07-03,NEFT/P18070362865991/M/S,0.0,30000.0,,2018,7,3,CASH_IN,30000.0,C1281898359
22695,1196428',2018-07-03,NEFT/IDIBH18184259306/PVT,0.0,100000.0,,2018,7,3,TRANSFER,100000.0,C30013970
22696,1196428',2018-07-03,TRF FROM  Indiaforensic SERVICES,0.0,14800000.0,,2018,7,3,TRANSFER,14800000.0,C31789747
22697,1196428',2018-07-03,NEFT/SBIN218184422534/M S,0.0,100.0,,2018,7,3,TRANSFER,100.0,C93518808
22698,1196428',2018-07-03,NEFT/PUNBH18184882917/PUN,0.0,400000.0,,2018,7,3,CASH_IN,400000.0,C2093546827
22699,1196428',2018-07-03,FDRL/REAL TIME GROSS SETTL,15000000.0,0.0,,2018,7,3,CASH_OUT,15000000.0,C976133979
22700,1196428',2018-07-03,NEFT/BARBV18184854369/MAK,0.0,65450.0,,2018,7,3,CHECK_CASHING,65450.0,C849038219
22701,1196428',2018-07-03,FDRL/REAL TIME GROSS SETTL,1000000.0,0.0,,2018,7,3,CHECK_WITHDRAWAL,1000000.0,C1789550256
22702,1196428',2018-07-03,Indiaforensic SERVICES INDIA PVT,0.0,576254.0,,2018,7,3,CHECK_CASHING,576254.0,C363475076
22703,1196428',2018-07-03,"Indiaforensic USA, INC./USD/1641",0.0,1120392.0,,2018,7,3,TRANSFER,1120392.0,C2110623348
22704,1196428',2018-07-03,IRTT00701819523,1306.67,0.0,,2018,7,3,CHECK_WITHDRAWAL,1306.67,C1161820020
22705,1196428',2018-07-03,"Indiaforensic USA, INC./USD/1995",0.0,136158.75,,2018,7,3,CHECK_CASHING,136158.75,C627675433
22706,1196428',2018-07-03,IRTT00701819525,507.54,0.0,,2018,7,3,PAYEMENT,507.54,C1145835418
22707,1196428',2018-07-03,NEFT/N184180577166732/Indfor,0.0,6000000.0,,2018,7,3,TRANSFER,6000000.0,C1778300121
22708,1196428',2018-07-03,NEFT/N184180577326123/BAT,0.0,200000.0,,2018,7,3,CHECK_CASHING,200000.0,C1325626015
22709,1196428',2018-07-03,NEFT/SBIN218184969842/NAR,0.0,30153.0,,2018,7,3,CASH_IN,30153.0,C8733802
22710,1196428',2018-07-03,NEFT/SBIN318184015721/JAI,0.0,100000.0,,2018,7,3,TRANSFER,100000.0,C990053853
22711,1196428',2018-07-03,NEFT/000048266072/GGN/ICI,0.0,1900000.0,,2018,7,3,TRANSFER,1900000.0,C218193338
22712,1196428',2018-07-03,NEFT/000048266335/Indiaforensic,0.0,1200000.0,,2018,7,3,CHECK_CASHING,1200000.0,M832073005
22713,1196428',2018-07-03,TRF FROM  Indiaforensic SERVICES,0.0,5000000.0,,2018,7,3,CHECK_CASHING,5000000.0,M189083850
22714,1196428',2018-07-03,TRF FROM  Indiaforensic SERVICES,0.0,1000000.0,,2018,7,3,CHECK_CASHING,1000000.0,C103357744
22715,1196428',2018-07-03,TRF FROM  Indiaforensic SERVICES,0.0,500000.0,,2018,7,3,TRANSFER,500000.0,M1942890330
22716,1196428',2018-07-03,FDRL/INTERNAL FUND TRANSFE,3000000.0,0.0,,2018,7,3,CASH_OUT,3000000.0,C2011941350
22717,1196428',2018-07-03,FDRL/INTERNAL FUND TRANSFE,3000000.0,0.0,,2018,7,3,DEBIT,3000000.0,C1505755152
22718,1196428',2018-07-03,FDRL/INTERNAL FUND TRANSFE,3000000.0,0.0,,2018,7,3,CHECK_WITHDRAWAL,3000000.0,M1051118371
22719,1196428',2018-07-03,FDRL/INTERNAL FUND TRANSFE,3000000.0,0.0,,2018,7,3,CASH_OUT,3000000.0,M1502077581
22720,1196428',2018-07-03,FDRL/INTERNAL FUND TRANSFE,500000.0,0.0,,2018,7,3,CHECK_WITHDRAWAL,500000.0,M1801625172
22721,1196428',2018-07-03,BEAT CSH PKP DEL GURG 620,0.0,227100.0,,2018,7,3,CASH_IN,227100.0,C360898540
22722,1196428',2018-07-04,FDRL/INTERNAL FUND TRANSFE,1500000.0,0.0,,2018,7,4,DEBIT,1500000.0,M1408738192
22723,1196428',2018-07-04,FDRL/INTERNAL FUND TRANSFE,100000.0,0.0,,2018,7,4,PAYEMENT,100000.0,C237594516
22724,1196428',2018-07-04,RTGS/SBINH18185004561/Indfor,0.0,6400000.0,,2018,7,4,CHECK_CASHING,6400000.0,M1645271006
22725,1196428',2018-07-04,FDRL/REAL TIME GROSS SETTL,9811629.04,0.0,,2018,7,4,CHECK_WITHDRAWAL,9811629.04,M1616707854
22726,1196428',2018-07-04,NEFT/N185180577614630/USH,0.0,125500.0,,2018,7,4,TRANSFER,125500.0,C1334973394
22727,1196428',2018-07-04,NEFT/N185180577591867/USH,0.0,190850.0,,2018,7,4,CASH_IN,190850.0,M1547406846
22728,1196428',2018-07-04,CASHDEP/SELF/GHATKOPAR/,0.0,20561.0,,2018,7,4,TRANSFER,20561.0,M51814511
22729,1196428',2018-07-04,IMPS 818511752675 FROM SA,0.0,200000.0,,2018,7,4,CASH_IN,200000.0,M1679527434
22730,1196428',2018-07-04,IMPS 818513530541 FROM GO,0.0,1000.0,,2018,7,4,CASH_IN,1000.0,M858729243
22731,1196428',2018-07-04,NEFT/N185180577815084/ESS,0.0,100000.0,,2018,7,4,CHECK_CASHING,100000.0,M317858117
22732,1196428',2018-07-04,CHQ DEP/375/OWDEL2/ICIC/,0.0,11800.0,,2018,7,4,CHECK_CASHING,11800.0,M974232437
22733,1196428',2018-07-04,CHQ DEP/878794/OWDEL2/JAK,0.0,11800.0,,2018,7,4,CHECK_CASHING,11800.0,M535001108
22734,1196428',2018-07-04,CHQ DEP/142724/OWDEL2/JAK,0.0,11800.0,,2018,7,4,TRANSFER,11800.0,M967799453
22735,1196428',2018-07-04,CHQ DEP/761539/OWDEL2/JAK,0.0,11800.0,,2018,7,4,CASH_IN,11800.0,M1704857178
22736,1196428',2018-07-04,CHQ DEP/69514/OWDEL2/JAKA,0.0,11800.0,,2018,7,4,CASH_IN,11800.0,M888552844
22737,1196428',2018-07-04,CHQ DEP/287238/OWDEL2/SBI,0.0,11800.0,,2018,7,4,CASH_IN,11800.0,M257269635
22738,1196428',2018-07-04,CHQ DEP/165958/OWDEL2/JAK,0.0,11800.0,,2018,7,4,CHECK_CASHING,11800.0,C1305075214
22739,1196428',2018-07-04,CHQ DEP/729630/OWDEL2/JAK,0.0,11800.0,,2018,7,4,CASH_IN,11800.0,C1627965794
22740,1196428',2018-07-04,CHQ DEP/43177/OWDEL2/JAKA,0.0,11800.0,,2018,7,4,CHECK_CASHING,11800.0,M1559676676
22741,1196428',2018-07-04,CHQ DEP/374745/OWDEL2/JAK,0.0,11800.0,,2018,7,4,TRANSFER,11800.0,C741431520
22742,1196428',2018-07-04,FDRL/INTERNAL FUND TRANSFE,500000.0,0.0,,2018,7,4,PAYEMENT,500000.0,C2143477943
22743,1196428',2018-07-04,NEFT/N185180577878139/USH,0.0,49500.0,,2018,7,4,TRANSFER,49500.0,C638551812
22744,1196428',2018-07-04,TRF FROM  Indiaforensic SERVICES,0.0,15000000.0,,2018,7,4,CASH_IN,15000000.0,C1027296777
22745,1196428',2018-07-04,TRF FROM  Indiaforensic SERVICES,0.0,7000000.0,,2018,7,4,CASH_IN,7000000.0,C1554540309
22746,1196428',2018-07-04,TRF TO  Indiaforensic SERVICES I,97000.0,0.0,,2018,7,4,PAYEMENT,97000.0,M2120427827
22747,1196428',2018-07-04,RTGS/HDFCH18185899493/BAJ,0.0,200000.0,,2018,7,4,CASH_IN,200000.0,C820910648
22748,1196428',2018-07-04,FDRL/REAL TIME GROSS SETTL,15000000.0,0.0,,2018,7,4,PAYEMENT,15000000.0,M415456371
22749,1196428',2018-07-04,FDRL/REAL TIME GROSS SETTL,5000000.0,0.0,,2018,7,4,PAYEMENT,5000000.0,M598340030
22750,1196428',2018-07-04,FDRL/REAL TIME GROSS SETTL,1000000.0,0.0,,2018,7,4,CASH_OUT,1000000.0,C345679794
22751,1196428',2018-07-04,FDRL/REAL TIME GROSS SETTL,1000000.0,0.0,,2018,7,4,CASH_OUT,1000000.0,M1605050346
22752,1196428',2018-07-04,NEFT/AXISP00001936378/ACC,0.0,1000000.0,,2018,7,4,CHECK_CASHING,1000000.0,C1144070975
22753,1196428',2018-07-04,IMPS 818515314153 FROM AS,0.0,60160.0,,2018,7,4,CHECK_CASHING,60160.0,M639999796
22754,1196428',2018-07-04,NEFT/N185180578075161/USH,0.0,34600.0,,2018,7,4,CASH_IN,34600.0,C343534938
22755,1196428',2018-07-04,RTGS/HDFCH18185937937/Indfor,0.0,5500000.0,,2018,7,4,CASH_IN,5500000.0,M479872561
22756,1196428',2018-07-04,CHQ DEPOSIT RETURN/287238,11800.0,0.0,,2018,7,4,DEBIT,11800.0,M61732893
22757,1196428',2018-07-04,CHQ DEPOSIT RETURN/43177/,11800.0,0.0,,2018,7,4,DEBIT,11800.0,C160632822
22758,1196428',2018-07-04,NEFT/P18070463312513/M/S,0.0,30000.0,,2018,7,4,TRANSFER,30000.0,C1183266411
22759,1196428',2018-07-04,Indiaforensic SERVICES INDIA PVT,0.0,95164.0,,2018,7,4,CASH_IN,95164.0,M1328778262
22760,1196428',2018-07-04,IMPS 818516719068 FROM LA,0.0,150.0,,2018,7,4,CHECK_CASHING,150.0,M704806959
22761,1196428',2018-07-04,NEFT/000048329392/Indiaforensic,0.0,1500000.0,,2018,7,4,TRANSFER,1500000.0,C229313132
22762,1196428',2018-07-04,NEFT/000048329572/Indiaforensic,0.0,1400000.0,,2018,7,4,CHECK_CASHING,1400000.0,M325906300
22763,1196428',2018-07-04,NEFT/PUNBH18185184745/PUN,0.0,100000.0,,2018,7,4,CHECK_CASHING,100000.0,M1267748122
22764,1196428',2018-07-04,FDRL/INTERNAL FUND TRANSFE,500000.0,0.0,,2018,7,4,PAYEMENT,500000.0,M159739450
22765,1196428',2018-07-04,FDRL/INTERNAL FUND TRANSFE,300000.0,0.0,,2018,7,4,CASH_OUT,300000.0,M1702289141
22766,1196428',2018-07-04,NEFT/IDIBH18185360432/PVT,0.0,100000.0,,2018,7,4,CHECK_CASHING,100000.0,C1200612373
22767,1196428',2018-07-04,IMPS 818518968851 FROM SA,0.0,200000.0,,2018,7,4,CASH_IN,200000.0,C1840046890
22768,1196428',2018-07-04,NEFT/SBIN318185885847/NAR,0.0,45237.0,,2018,7,4,CASH_IN,45237.0,M1261751850
22769,1196428',2018-07-04,NEFT/SBIN318185905778/JAI,0.0,50000.0,,2018,7,4,CHECK_CASHING,50000.0,M1535970431
22770,1196428',2018-07-04,IMPS 818518024522 FROM SA,0.0,100000.0,,2018,7,4,CHECK_CASHING,100000.0,M524251983
22771,1196428',2018-07-04,FDRL/INTERNAL FUND TRANSFE,500000.0,0.0,,2018,7,4,CHECK_WITHDRAWAL,500000.0,C1406749291
22772,1196428',2018-07-04,TRF FROM  Indiaforensic SERVICES,0.0,6800000.0,,2018,7,4,CHECK_CASHING,6800000.0,C1415645767
22773,1196428',2018-07-04,FDRL/INTERNAL FUND TRANSFE,500000.0,0.0,,2018,7,4,CHECK_WITHDRAWAL,500000.0,M1816834020
22774,1196428',2018-07-04,FDRL/INTERNAL FUND TRANSFE,5000000.0,0.0,,2018,7,4,PAYEMENT,5000000.0,C1732292969
22775,1196428',2018-07-04,FDRL/INTERNAL FUND TRANSFE,5000000.0,0.0,,2018,7,4,DEBIT,5000000.0,M1739764490
22776,1196428',2018-07-04,FDRL/INTERNAL FUND TRANSFE,5000000.0,0.0,,2018,7,4,PAYEMENT,5000000.0,M1664129150
22777,1196428',2018-07-04,BEAT CSH PKP DEL UDYOG 62,0.0,125600.0,,2018,7,4,CASH_IN,125600.0,M1128852062
22778,1196428',2018-07-04,CHQ DEPOSIT RETURN/287238,100.0,0.0,,2018,7,4,DEBIT,100.0,M182471589
22779,1196428',2018-07-04,CHQ DEPOSIT RETURN/287238,18.0,0.0,,2018,7,4,CHECK_WITHDRAWAL,18.0,M1056074872
22780,1196428',2018-07-04,CHQ DEPOSIT RETURN/43177/,100.0,0.0,,2018,7,4,PAYEMENT,100.0,M2106622700
22781,1196428',2018-07-04,CHQ DEPOSIT RETURN/43177/,18.0,0.0,,2018,7,4,PAYEMENT,18.0,M163766295
22782,1196428',2018-07-05,RTGS/HDFCH18186970169/BAT,0.0,200000.0,,2018,7,5,CHECK_CASHING,200000.0,M802332120
22783,1196428',2018-07-05,CASHDEP/NOIDA/TP,0.0,101000.0,,2018,7,5,CHECK_CASHING,101000.0,M1676185662
22784,1196428',2018-07-05,RTGS/SBINH18186009435/Indfor,0.0,7600000.0,,2018,7,5,TRANSFER,7600000.0,M1776427379
22785,1196428',2018-07-05,FDRL/REAL TIME GROSS SETTL,8885051.06,0.0,,2018,7,5,DEBIT,8885051.06,M334173295
22786,1196428',2018-07-05,NEFT/N186180578720951/USH,0.0,170850.0,,2018,7,5,TRANSFER,170850.0,M330490124
22787,1196428',2018-07-05,NEFT/N186180578700071/USH,0.0,190550.0,,2018,7,5,CHECK_CASHING,190550.0,M1154845973
22788,1196428',2018-07-05,UPI/818612557603/NO REMAR,0.0,19000.0,,2018,7,5,CHECK_CASHING,19000.0,M911987264
22789,1196428',2018-07-05,CASHDEP/GHATKOPAR/20561,0.0,20561.0,,2018,7,5,TRANSFER,20561.0,M1680147473
22790,1196428',2018-07-05,NEFT/SBIN418186391144/HAR,0.0,10000.0,,2018,7,5,CASH_IN,10000.0,M293659205
22791,1196428',2018-07-05,NEFT/N186180578847947/JUN,0.0,150000.0,,2018,7,5,TRANSFER,150000.0,M1432093328
22792,1196428',2018-07-05,TRF FROM  Indiaforensic SERVICES,0.0,15000000.0,,2018,7,5,CHECK_CASHING,15000000.0,M901262414
22793,1196428',2018-07-05,IMPS 818614394284 FROM AS,0.0,100099.0,,2018,7,5,CHECK_CASHING,100099.0,M899962047
22794,1196428',2018-07-05,TRF FROM  Indiaforensic SERVICES,0.0,4300000.0,,2018,7,5,CHECK_CASHING,4300000.0,M32715716
22795,1196428',2018-07-05,NEFT/AXISP00002113991/ACC,0.0,4000000.0,,2018,7,5,TRANSFER,4000000.0,M1510311379
22796,1196428',2018-07-05,TRF FROM  Indiaforensic SERVICES,0.0,500000.0,,2018,7,5,TRANSFER,500000.0,M1517206841
22797,1196428',2018-07-05,FDRL/REAL TIME GROSS SETTL,15000000.0,0.0,,2018,7,5,DEBIT,15000000.0,M2030024765
22798,1196428',2018-07-05,FDRL/REAL TIME GROSS SETTL,5000000.0,0.0,,2018,7,5,PAYEMENT,5000000.0,M1267580132
22799,1196428',2018-07-05,FDRL/REAL TIME GROSS SETTL,1000000.0,0.0,,2018,7,5,CASH_OUT,1000000.0,C655391383
22800,1196428',2018-07-05,FDRL/REAL TIME GROSS SETTL,1000000.0,0.0,,2018,7,5,CHECK_WITHDRAWAL,1000000.0,C2117215775
22801,1196428',2018-07-05,FDRL/REAL TIME GROSS SETTL,1000000.0,0.0,,2018,7,5,DEBIT,1000000.0,C2106576360
22802,1196428',2018-07-05,FDRL/REAL TIME GROSS SETTL,1000000.0,0.0,,2018,7,5,DEBIT,1000000.0,M267789972
22803,1196428',2018-07-05,NEFT/N186180578987167/RAV,0.0,11800.0,,2018,7,5,CASH_IN,11800.0,M292960678
22804,1196428',2018-07-05,NEFT/N186180578973326/USH,0.0,65750.0,,2018,7,5,TRANSFER,65750.0,C1638372110
22805,1196428',2018-07-05,NEFT/SBIN418186520130/M S,0.0,100000.0,,2018,7,5,TRANSFER,100000.0,C1377774115
22806,1196428',2018-07-05,NEFT/IOBAN18186505788/ASH,0.0,140650.0,,2018,7,5,TRANSFER,140650.0,M1877845145
22807,1196428',2018-07-05,NEFT/N186180579024727/PUB,0.0,10000.0,,2018,7,5,CHECK_CASHING,10000.0,M869149988
22808,1196428',2018-07-05,RTGS/HDFCH18186080298/Indfor,0.0,5800000.0,,2018,7,5,CASH_IN,5800000.0,M1324498984
22809,1196428',2018-07-05,NEFT/ANDBN18223218046/KUM,0.0,11800.0,,2018,7,5,CHECK_CASHING,11800.0,C748014372
22810,1196428',2018-07-05,RTGS/PUNBH18186473377/PUN,0.0,200000.0,,2018,7,5,CASH_IN,200000.0,M1556526073
22811,1196428',2018-07-05,FDRL/INTERNAL FUND TRANSFE,500000.0,0.0,,2018,7,5,PAYEMENT,500000.0,M1113797896
22812,1196428',2018-07-05,NEFT/P18070563757906/M/S,0.0,30000.0,,2018,7,5,CASH_IN,30000.0,M111103216
22813,1196428',2018-07-05,NEFT/SBIN418186756596/TAR,0.0,190000.0,,2018,7,5,TRANSFER,190000.0,M402054040
22814,1196428',2018-07-05,Indiaforensic SERVICES INDIA PVT,0.0,162715.0,,2018,7,5,CASH_IN,162715.0,C1174935745
22815,1196428',2018-07-05,NEFT/000048400007/Indiaforensic,0.0,1000000.0,,2018,7,5,TRANSFER,1000000.0,M3128155
22816,1196428',2018-07-05,NEFT/000048400343/Indiaforensic,0.0,500000.0,,2018,7,5,TRANSFER,500000.0,M804435874
22817,1196428',2018-07-05,TRF TO  Indiaforensic SERVICES I,50000.0,0.0,,2018,7,5,DEBIT,50000.0,M22524150
22818,1196428',2018-07-05,TRF FROM  Indiaforensic SERVICES,0.0,6500000.0,,2018,7,5,TRANSFER,6500000.0,C717951588
22819,1196428',2018-07-05,FDRL/INTERNAL FUND TRANSFE,6000000.0,0.0,,2018,7,5,DEBIT,6000000.0,M994429804
22820,1196428',2018-07-05,FDRL/INTERNAL FUND TRANSFE,6000000.0,0.0,,2018,7,5,PAYEMENT,6000000.0,M42960844
22821,1196428',2018-07-05,FDRL/INTERNAL FUND TRANSFE,2000000.0,0.0,,2018,7,5,CASH_OUT,2000000.0,M117897905
22822,1196428',2018-07-05,FDRL/INTERNAL FUND TRANSFE,500000.0,0.0,,2018,7,5,CHECK_WITHDRAWAL,500000.0,M919103236
22823,1196428',2018-07-05,BEAT CSH PKP DEL UDYOG 62,0.0,157300.0,,2018,7,5,CHECK_CASHING,157300.0,M2117556230
22824,1196428',2018-07-06,NEFT/PUNBH18187444731/MOD,0.0,11800.0,,2018,7,6,CASH_IN,11800.0,M2047174428
22825,1196428',2018-07-06,RTGS/SBINH18187006618/Indfor,0.0,5500000.0,,2018,7,6,CHECK_CASHING,5500000.0,M1468774738
22826,1196428',2018-07-06,RTGS/SBINH18187012053/Indfor,0.0,1000000.0,,2018,7,6,CHECK_CASHING,1000000.0,M266577647
22827,1196428',2018-07-06,RTGS/SBINH18187014113/Indfor,0.0,1000000.0,,2018,7,6,CHECK_CASHING,1000000.0,M1474343674
22828,1196428',2018-07-06,FDRL/REAL TIME GROSS SETTL,6058364.61,0.0,,2018,7,6,CHECK_WITHDRAWAL,6058364.61,M1664266643
22829,1196428',2018-07-06,NEFT/SBIN518187324841/THA,0.0,450000.0,,2018,7,6,CASH_IN,450000.0,M842463018
22830,1196428',2018-07-06,CHQ DEP/219537/OWDEL1/SBI,0.0,11800.0,,2018,7,6,CASH_IN,11800.0,M284325832
22831,1196428',2018-07-06,CHQ DEP/542270/OWDEL1/CNR,0.0,11800.0,,2018,7,6,CASH_IN,11800.0,M1784760424
22832,1196428',2018-07-06,CHQ DEP/142638/OWDEL1/CNR,0.0,11800.0,,2018,7,6,CHECK_CASHING,11800.0,M1489026763
22833,1196428',2018-07-06,INTEX TECHNOLOGIES INDIA,1000000.0,0.0,,2018,7,6,CHECK_WITHDRAWAL,1000000.0,C1800405372
22834,1196428',2018-07-06,FDRL/INTERNAL FUND TRANSFE,500000.0,0.0,,2018,7,6,CASH_OUT,500000.0,C2071512077
22835,1196428',2018-07-06,TRF FROM  Indiaforensic SERVICES,0.0,15000000.0,,2018,7,6,TRANSFER,15000000.0,C1588635270
22836,1196428',2018-07-06,NEFT/SAA138950789/BHAMBRA,0.0,200000.0,,2018,7,6,TRANSFER,200000.0,C1495001462
22837,1196428',2018-07-06,NEFT/SBIN518187390401/JAI,0.0,112233.0,,2018,7,6,CASH_IN,112233.0,M84558619
22838,1196428',2018-07-06,NEFT/AXISP00002257201/ACC,0.0,5000000.0,,2018,7,6,CHECK_CASHING,5000000.0,M113925453
22839,1196428',2018-07-06,RTGS/HDFCH18187191706/Indfor,0.0,5500000.0,,2018,7,6,TRANSFER,5500000.0,M645245228
22840,1196428',2018-07-06,FDRL/REAL TIME GROSS SETTL,15000000.0,0.0,,2018,7,6,CASH_OUT,15000000.0,M636094317
22841,1196428',2018-07-06,FDRL/REAL TIME GROSS SETTL,10000000.0,0.0,,2018,7,6,PAYEMENT,10000000.0,M1583961850
22842,1196428',2018-07-06,FDRL/NATIONAL ELECTRONIC F,5769.0,0.0,,2018,7,6,DEBIT,5769.0,M708029389
22843,1196428',2018-07-06,FDRL/NATIONAL ELECTRONIC F,24185.0,0.0,,2018,7,6,PAYEMENT,24185.0,M508231066
22844,1196428',2018-07-06,FDRL/NATIONAL ELECTRONIC F,358.0,0.0,,2018,7,6,CHECK_WITHDRAWAL,358.0,C1838491463
22845,1196428',2018-07-06,FDRL/REAL TIME GROSS SETTL,1000000.0,0.0,,2018,7,6,CASH_OUT,1000000.0,M1094448975
22846,1196428',2018-07-06,NEFT/P18070664240803/M/S,0.0,30000.0,,2018,7,6,CHECK_CASHING,30000.0,M717841651
22847,1196428',2018-07-06,FDRL/INTERNAL FUND TRANSFE,500000.0,0.0,,2018,7,6,CASH_OUT,500000.0,M1954167102
22848,1196428',2018-07-06,TRF FROM  Indiaforensic SERVICES,0.0,3600000.0,,2018,7,6,TRANSFER,3600000.0,M1043087369
22849,1196428',2018-07-06,TRF FROM  Indiaforensic SERVICES,0.0,6500000.0,,2018,7,6,CASH_IN,6500000.0,M1489610760
22850,1196428',2018-07-06,BEAT CSH PKP DEL UDYOG 62,0.0,147000.0,,2018,7,6,TRANSFER,147000.0,C1556875182
22851,1196428',2018-07-06,RTGS/PUNBH18187489569/PUN,0.0,400000.0,,2018,7,6,CHECK_CASHING,400000.0,M1109811596
22852,1196428',2018-07-06,FDRL/INTERNAL FUND TRANSFE,1000000.0,0.0,,2018,7,6,CHECK_WITHDRAWAL,1000000.0,C101571284
22853,1196428',2018-07-06,TRF TO  Indiaforensic SERVICES I,70000.0,0.0,,2018,7,6,DEBIT,70000.0,M178952563
22854,1196428',2018-07-06,TRF FROM  Indiaforensic SERVICES,0.0,500000.0,,2018,7,6,TRANSFER,500000.0,M2081263541
22855,1196428',2018-07-06,TRF FROM  Indiaforensic SERVICES,0.0,5000000.0,,2018,7,6,CASH_IN,5000000.0,C2078250226
22856,1196428',2018-07-06,NEFT/SBIN518187765785/NAR,0.0,54273.0,,2018,7,6,CHECK_CASHING,54273.0,C1570256460
22857,1196428',2018-07-06,NEFT/N187180580203497/TEC,0.0,300000.0,,2018,7,6,CHECK_CASHING,300000.0,M441055416
22858,1196428',2018-07-06,FDRL/INTERNAL FUND TRANSFE,15000000.0,0.0,,2018,7,6,DEBIT,15000000.0,C2077098348
22859,1196428',2018-07-06,TRF FROM  Indiaforensic SERVICES,0.0,6400000.0,,2018,7,6,CHECK_CASHING,6400000.0,C1062254208
22860,1196428',2018-07-06,NEFT/000048472941/Indiaforensic,0.0,1000000.0,,2018,7,6,CHECK_CASHING,1000000.0,C1787868648
22861,1196428',2018-07-06,NEFT/000048472619/Indiaforensic,0.0,1700000.0,,2018,7,6,CASH_IN,1700000.0,C161140376
22862,1196428',2018-07-07,FDRL/NATIONAL ELECTRONIC F,2000000.0,0.0,,2018,7,7,PAYEMENT,2000000.0,M1471351873
22863,1196428',2018-07-07,FDRL/NATIONAL ELECTRONIC F,3000000.0,0.0,,2018,7,7,PAYEMENT,3000000.0,M1328437771
22864,1196428',2018-07-07,FDRL/NATIONAL ELECTRONIC F,4000000.0,0.0,,2018,7,7,CHECK_WITHDRAWAL,4000000.0,M341537411
22865,1196428',2018-07-07,RTGS/HDFCH18188271465/BAT,0.0,300000.0,,2018,7,7,CHECK_CASHING,300000.0,M1367049026
22866,1196428',2018-07-07,RTGS/SBINH18188006186/Indfor,0.0,7500000.0,,2018,7,7,CHECK_CASHING,7500000.0,C2029310301
22867,1196428',2018-07-07,FDRL/REAL TIME GROSS SETTL,8611725.02,0.0,,2018,7,7,CASH_OUT,8611725.02,C1606699851
22868,1196428',2018-07-07,NEFT/N188180580734938/USH,0.0,199550.0,,2018,7,7,CASH_IN,199550.0,C1103621993
22869,1196428',2018-07-07,NEFT/PUNBH18188649554/SAI,0.0,75000.0,,2018,7,7,TRANSFER,75000.0,M34447014
22870,1196428',2018-07-07,NEFT/SBIN618188216275/M S,0.0,100000.0,,2018,7,7,CASH_IN,100000.0,C1428675504
22871,1196428',2018-07-07,NEFT/N188180580797844/USH,0.0,70150.0,,2018,7,7,TRANSFER,70150.0,M1783999682
22872,1196428',2018-07-07,RTGS/ORBCH18188076169/BAJ,0.0,300000.0,,2018,7,7,CASH_IN,300000.0,C1247600089
22873,1196428',2018-07-07,RTGS/PUNBH18188498636/MAN,0.0,300000.0,,2018,7,7,CHECK_CASHING,300000.0,M835388411
22874,1196428',2018-07-07,FDRL/INTERNAL FUND TRANSFE,500000.0,0.0,,2018,7,7,CASH_OUT,500000.0,C404279307
22875,1196428',2018-07-07,NEFT/SBIN618188315633/M R,0.0,31000.0,,2018,7,7,CASH_IN,31000.0,C278407008
22876,1196428',2018-07-07,NEFT/AXISP00002425242/ACC,0.0,14000000.0,,2018,7,7,CHECK_CASHING,14000000.0,M1721234210
22877,1196428',2018-07-07,TRF FROM  Indiaforensic SERVICES,0.0,15000000.0,,2018,7,7,CHECK_CASHING,15000000.0,M1576908104
22878,1196428',2018-07-07,RTGS/HDFCH18188314793/Indfor,0.0,1000000.0,,2018,7,7,TRANSFER,1000000.0,M1547162536
22879,1196428',2018-07-07,FDRL/INTERNAL FUND TRANSFE,1000000.0,0.0,,2018,7,7,CHECK_WITHDRAWAL,1000000.0,M1057827479
22880,1196428',2018-07-07,TRF FROM  Indiaforensic SERVICES,0.0,500000.0,,2018,7,7,CASH_IN,500000.0,M1498878973
22881,1196428',2018-07-07,TRF FROM  Indiaforensic SERVICES,0.0,3000000.0,,2018,7,7,TRANSFER,3000000.0,M1420281457
22882,1196428',2018-07-07,FDRL/REAL TIME GROSS SETTL,15000000.0,0.0,,2018,7,7,CASH_OUT,15000000.0,M2000558609
22883,1196428',2018-07-07,FDRL/REAL TIME GROSS SETTL,15000000.0,0.0,,2018,7,7,PAYEMENT,15000000.0,M1598229594
22884,1196428',2018-07-07,RTGS/HDFCH18188314176/Indfor,0.0,5000000.0,,2018,7,7,TRANSFER,5000000.0,M2001514483
22885,1196428',2018-07-07,FDRL/REAL TIME GROSS SETTL,5000000.0,0.0,,2018,7,7,DEBIT,5000000.0,M1808413339
22886,1196428',2018-07-07,NEFT/N188180581020355/PUB,0.0,25000.0,,2018,7,7,CASH_IN,25000.0,M662376084
22887,1196428',2018-07-07,NEFT/N188180581005284/JUN,0.0,80000.0,,2018,7,7,CASH_IN,80000.0,M1462583713
22888,1196428',2018-07-07,NEFT/SDL35084598/SAINI FI,0.0,110000.0,,2018,7,7,CASH_IN,110000.0,M1292178703
22889,1196428',2018-07-07,RTGS/PUNBH18188507734/PUN,0.0,200000.0,,2018,7,7,CASH_IN,200000.0,M1378894443
22890,1196428',2018-07-07,IMPS 818816345914 FROM AS,0.0,114004.0,,2018,7,7,CASH_IN,114004.0,M671194471
22891,1196428',2018-07-07,TRF FROM  Indiaforensic SERVICES,0.0,3000000.0,,2018,7,7,TRANSFER,3000000.0,M2120887477
22892,1196428',2018-07-07,TRF FROM  Indiaforensic SERVICES,0.0,1000000.0,,2018,7,7,CHECK_CASHING,1000000.0,M1565473666
22893,1196428',2018-07-07,TRF FROM  Indiaforensic SERVICES,0.0,500000.0,,2018,7,7,CHECK_CASHING,500000.0,M336600403
22894,1196428',2018-07-07,NEFT/FSFBH18188000057/FIN,0.0,53537.0,,2018,7,7,TRANSFER,53537.0,M1108314788
22895,1196428',2018-07-07,FDRL/INTERNAL FUND TRANSFE,4000000.0,0.0,,2018,7,7,CHECK_WITHDRAWAL,4000000.0,M1776708407
22896,1196428',2018-07-07,FDRL/INTERNAL FUND TRANSFE,4000000.0,0.0,,2018,7,7,CHECK_WITHDRAWAL,4000000.0,M1886072816
22897,1196428',2018-07-07,BEAT CSH PKP DEL UDYOG 62,0.0,104500.0,,2018,7,7,TRANSFER,104500.0,M392269298
22898,1196428',2018-07-09,RTGS/SCBLH18190001344/FIX,0.0,400000.0,,2018,7,9,TRANSFER,400000.0,M240263357
22899,1196428',2018-07-09,NEFT/SBIN718190081287/NAR,0.0,31299.0,,2018,7,9,TRANSFER,31299.0,M2137827177
22900,1196428',2018-07-09,RTGS/SBINH18190003331/Indfor,0.0,7000000.0,,2018,7,9,TRANSFER,7000000.0,M996688653
22901,1196428',2018-07-09,FDRL/REAL TIME GROSS SETTL,7009315.5,0.0,,2018,7,9,DEBIT,7009315.5,C1829831147
22902,1196428',2018-07-09,IMPS 819010347959 FROM AS,0.0,98098.0,,2018,7,9,CASH_IN,98098.0,M720435458
22903,1196428',2018-07-09,FT ZL18070916BEA0B5 PRAVE,0.0,100000.0,,2018,7,9,TRANSFER,100000.0,M29096009
22904,1196428',2018-07-09,NEFT/N190180581647799/USH,0.0,145110.0,,2018,7,9,CHECK_CASHING,145110.0,M150995440
22905,1196428',2018-07-09,CASHDEP/NOIDA/TP,0.0,116000.0,,2018,7,9,CASH_IN,116000.0,M1241251535
22906,1196428',2018-07-09,RTGS/ICICH18190268065/Indfor,0.0,500000.0,,2018,7,9,CASH_IN,500000.0,M1254542588
22907,1196428',2018-07-09,RTGS/ICICH18190268599/Indfor,0.0,500000.0,,2018,7,9,TRANSFER,500000.0,M710538853
22908,1196428',2018-07-09,RTGS/ICICH18190265834/Indfor,0.0,500000.0,,2018,7,9,CASH_IN,500000.0,M399672840
22909,1196428',2018-07-09,RTGS/ICICH18190269689/Indfor,0.0,2000000.0,,2018,7,9,CASH_IN,2000000.0,M1566931514
22910,1196428',2018-07-09,FDRL/REAL TIME GROSS SETTL,4588820.27,0.0,,2018,7,9,PAYEMENT,4588820.27,C1540270363
22911,1196428',2018-07-09,RTGS/ICICH18190270727/Indfor,0.0,1000000.0,,2018,7,9,CHECK_CASHING,1000000.0,C900425684
22912,1196428',2018-07-09,NEFT/SBIN718190196988/THA,0.0,137500.0,,2018,7,9,CHECK_CASHING,137500.0,M1361294362
22913,1196428',2018-07-09,CHQ DEP/84268/OWDEL1/UTIB,0.0,8000.0,,2018,7,9,CHECK_CASHING,8000.0,C264843581
22914,1196428',2018-07-09,CHQ DEP/2/OWDEL1/PSIB/IBD,0.0,8000.0,,2018,7,9,CASH_IN,8000.0,M1897445965
22915,1196428',2018-07-09,CHQ DEP/82/OWDEL1/HDFC/VP,0.0,8000.0,,2018,7,9,CHECK_CASHING,8000.0,M345439288
22916,1196428',2018-07-09,CHQ DEP/163454/OWDEL1/CNR,0.0,8000.0,,2018,7,9,TRANSFER,8000.0,M2130477201
22917,1196428',2018-07-09,CHQ DEP/513833/OWDEL1/PUN,0.0,8260.0,,2018,7,9,CHECK_CASHING,8260.0,M1516263359
22918,1196428',2018-07-09,CHQ DEP/340216/OWDEL1/PUN,0.0,8260.0,,2018,7,9,CHECK_CASHING,8260.0,M508839235
22919,1196428',2018-07-09,CHQ DEP/206132/OWDEL1/PSI,0.0,8260.0,,2018,7,9,TRANSFER,8260.0,M530611995
22920,1196428',2018-07-09,CHQ DEP/489972/OWDEL1/CNR,0.0,8260.0,,2018,7,9,CHECK_CASHING,8260.0,C1761324386
22921,1196428',2018-07-09,CHQ DEP/746733/OWDEL1/IND,0.0,8260.0,,2018,7,9,TRANSFER,8260.0,C90486891
22922,1196428',2018-07-09,CHQ DEP/760325/OWDEL1/UCB,0.0,11800.0,,2018,7,9,CASH_IN,11800.0,C573200870
22923,1196428',2018-07-09,CHQ DEP/602770/OWDEL1/PUN,0.0,8260.0,,2018,7,9,TRANSFER,8260.0,C1825992554
22924,1196428',2018-07-09,CHQ DEP/238161/OWDEL1/SBI,0.0,11800.0,,2018,7,9,CASH_IN,11800.0,M1278682262
22925,1196428',2018-07-09,CHQ DEP/100/OWDEL1/PSIB/L,0.0,11800.0,,2018,7,9,CASH_IN,11800.0,M2009652577
22926,1196428',2018-07-09,CHQ DEP/571278/OWDEL1/SBI,0.0,11800.0,,2018,7,9,CASH_IN,11800.0,M1504904868
22927,1196428',2018-07-09,CHQ DEP/585078/OWDEL1/SBI,0.0,11800.0,,2018,7,9,CASH_IN,11800.0,C88226327
22928,1196428',2018-07-09,CHQ DEP/379/OWDEL1/HDFC/S,0.0,11800.0,,2018,7,9,CHECK_CASHING,11800.0,M203497386
22929,1196428',2018-07-09,CHQ DEP/233980/OWDEL1/CLA,0.0,11800.0,,2018,7,9,CASH_IN,11800.0,M1264078907
22930,1196428',2018-07-09,CHQ DEP/2207/OWDEL1/HDFC/,0.0,11800.0,,2018,7,9,TRANSFER,11800.0,M1870838648
22931,1196428',2018-07-09,CHQ DEP/948566/OWDEL1/SBI,0.0,11800.0,,2018,7,9,CHECK_CASHING,11800.0,C1683963531
22932,1196428',2018-07-09,CHQ DEP/471164/OWDEL1/UTB,0.0,11800.0,,2018,7,9,CHECK_CASHING,11800.0,M620120832
22933,1196428',2018-07-09,CHQ DEP/133776/OWDEL1/CLA,0.0,11800.0,,2018,7,9,CHECK_CASHING,11800.0,M37714710
22934,1196428',2018-07-09,CHQ DEP/645/OWDEL1/UCBA/R,0.0,11800.0,,2018,7,9,CASH_IN,11800.0,M1135370372
22935,1196428',2018-07-09,CHQ DEP/31322/OWDEL1/UTIB,0.0,8000.0,,2018,7,9,CHECK_CASHING,8000.0,C1700355047
22936,1196428',2018-07-09,CHQ DEP/9269/OWDEL1/MAHB/,0.0,8000.0,,2018,7,9,TRANSFER,8000.0,C1884600481
22937,1196428',2018-07-09,CHQ DEP/221892/OWDEL1/IOB,0.0,8000.0,,2018,7,9,TRANSFER,8000.0,C1105527690
22938,1196428',2018-07-09,CHQ DEP/616679/OWDEL1/PUN,0.0,8000.0,,2018,7,9,TRANSFER,8000.0,M714819629
22939,1196428',2018-07-09,CHQ DEP/237/OWDEL1/UCBA/,0.0,8260.0,,2018,7,9,TRANSFER,8260.0,M722465639
22940,1196428',2018-07-09,CHQ DEP/338869/OWDEL1/SBI,0.0,11800.0,,2018,7,9,TRANSFER,11800.0,C801412408
22941,1196428',2018-07-09,CHQ DEP/46584/OWDEL1/SBIN,0.0,11800.0,,2018,7,9,TRANSFER,11800.0,M1678349105
22942,1196428',2018-07-09,CHQ DEP/856829/OWDEL1/SBI,0.0,11800.0,,2018,7,9,CHECK_CASHING,11800.0,C35534346
22943,1196428',2018-07-09,CHQ DEP/826415/OWDEL1/PUN,0.0,11800.0,,2018,7,9,CHECK_CASHING,11800.0,C943166837
22944,1196428',2018-07-09,CHQ DEP/292033/OWDEL1/CNR,0.0,11800.0,,2018,7,9,TRANSFER,11800.0,M1063088470
22945,1196428',2018-07-09,CHQ DEP/269865/OWDEL1/SBI,0.0,11800.0,,2018,7,9,CASH_IN,11800.0,M634480856
22946,1196428',2018-07-09,CHQ DEP/733588/OWDEL1/SBI,0.0,8280.0,,2018,7,9,CASH_IN,8280.0,M1229660324
22947,1196428',2018-07-09,CHQ DEP/6171/OWDEL1/ORBC/,0.0,11800.0,,2018,7,9,CHECK_CASHING,11800.0,M1995775202
22948,1196428',2018-07-09,CHQ DEP/16389/OWDEL1/ORBC,0.0,11800.0,,2018,7,9,CHECK_CASHING,11800.0,M982735022
22949,1196428',2018-07-09,CHQ DEP/10/OWDEL1/DCBL/,0.0,11800.0,,2018,7,9,TRANSFER,11800.0,C1754722089
22950,1196428',2018-07-09,CHQ DEP/767638/OWDEL1/STB,0.0,11800.0,,2018,7,9,CHECK_CASHING,11800.0,M536571624
22951,1196428',2018-07-09,CHQ DEP/56653/OWDEL1/UBIN,0.0,8000.0,,2018,7,9,CASH_IN,8000.0,C1498878963
22952,1196428',2018-07-09,CHQ DEP/35502/OWDEL1/UBIN,0.0,8000.0,,2018,7,9,CASH_IN,8000.0,C1962165946
22953,1196428',2018-07-09,CHQ DEP/239849/OWDEL1/CLA,0.0,11800.0,,2018,7,9,CASH_IN,11800.0,M1170462195
22954,1196428',2018-07-09,CHQ DEP/89292/OWDEL1/PUNB,0.0,11800.0,,2018,7,9,CASH_IN,11800.0,C414205222
22955,1196428',2018-07-09,CHQ DEP/816/OWDEL1/BARB/S,0.0,11800.0,,2018,7,9,CASH_IN,11800.0,M1229413386
22956,1196428',2018-07-09,CHQ DEP/96884/OWDEL1/UBIN,0.0,11800.0,,2018,7,9,CHECK_CASHING,11800.0,M712447692
22957,1196428',2018-07-09,CHQ DEP/29234/OWDEL1/CNRB,0.0,11800.0,,2018,7,9,CHECK_CASHING,11800.0,C269902384
22958,1196428',2018-07-09,CHQ DEP/215/OWDEL1/PSIB/K,0.0,11800.0,,2018,7,9,TRANSFER,11800.0,C955097010
22959,1196428',2018-07-09,CHQ DEP/585747/OWDEL1/SBI,0.0,11800.0,,2018,7,9,CHECK_CASHING,11800.0,C1827996167
22960,1196428',2018-07-09,CHQ DEP/879388/OWDEL1/VIJ,0.0,11800.0,,2018,7,9,TRANSFER,11800.0,M30162194
22961,1196428',2018-07-09,CHQ DEP/212/OWDEL1/PSIB/D,0.0,11800.0,,2018,7,9,CASH_IN,11800.0,C1115240385
22962,1196428',2018-07-09,CHQ DEP/830117/OWDEL1/PUN,0.0,11800.0,,2018,7,9,CASH_IN,11800.0,M1710595137
22963,1196428',2018-07-09,CHQ DEP/22086/OWDEL1/CORP,0.0,11800.0,,2018,7,9,CASH_IN,11800.0,M970087106
22964,1196428',2018-07-09,CHQ DEP/19339/OWDEL1/MAHB,0.0,11800.0,,2018,7,9,CASH_IN,11800.0,M561635968
22965,1196428',2018-07-09,CHQ DEP/113/OWDEL1/HDFC/P,0.0,11800.0,,2018,7,9,CASH_IN,11800.0,C440480434
22966,1196428',2018-07-09,CHQ DEP/652973/OWDEL1/SBI,0.0,11800.0,,2018,7,9,TRANSFER,11800.0,C46748390
22967,1196428',2018-07-09,CHQ DEP/97798/OWDEL1/CBIN,0.0,8260.0,,2018,7,9,TRANSFER,8260.0,M976616410
22968,1196428',2018-07-09,CHQ DEP/408/OWDEL1/HDFC/K,0.0,11800.0,,2018,7,9,CASH_IN,11800.0,M1796408655
22969,1196428',2018-07-09,CHQ DEP/66/OWDEL1/UCBA/SH,0.0,11800.0,,2018,7,9,CASH_IN,11800.0,M424513770
22970,1196428',2018-07-09,CHQ DEP/2203/OWDEL1/BARB/,0.0,11800.0,,2018,7,9,CHECK_CASHING,11800.0,M1867357103
22971,1196428',2018-07-09,CHQ DEP/244543/OWDEL1/YES,0.0,11800.0,,2018,7,9,TRANSFER,11800.0,M215680372
22972,1196428',2018-07-09,CHQ DEP/172810/OWDEL1/PUN,0.0,11800.0,,2018,7,9,TRANSFER,11800.0,M764256713
22973,1196428',2018-07-09,CHQ DEP/454091/OWDEL1/SBI,0.0,11800.0,,2018,7,9,CASH_IN,11800.0,M538413261
22974,1196428',2018-07-09,CHQ DEP/982798/OWDEL1/PUN,0.0,11800.0,,2018,7,9,CASH_IN,11800.0,M942160595
22975,1196428',2018-07-09,CHQ DEP/82345/OWDEL1/SYNB,0.0,11800.0,,2018,7,9,CHECK_CASHING,11800.0,M1319156415
22976,1196428',2018-07-09,CHQ DEP/280745/OWDEL1/SBI,0.0,8260.0,,2018,7,9,TRANSFER,8260.0,M361847129
22977,1196428',2018-07-09,CHQ DEP/38200/OWDEL1/CBIN,0.0,8000.0,,2018,7,9,CHECK_CASHING,8000.0,C1790202239
22978,1196428',2018-07-09,CHQ DEP/275371/OWDEL1/SBI,0.0,8000.0,,2018,7,9,TRANSFER,8000.0,M955868325
22979,1196428',2018-07-09,CHQ DEP/274630/OWDEL1/SBI,0.0,8000.0,,2018,7,9,CASH_IN,8000.0,M1251133153
22980,1196428',2018-07-09,CHQ DEP/198/OWDEL1/PSIB/B,0.0,8000.0,,2018,7,9,TRANSFER,8000.0,M1854311181
22981,1196428',2018-07-09,CHQ DEP/221/OWDEL1/PSIB/B,0.0,8000.0,,2018,7,9,CHECK_CASHING,8000.0,C928023753
22982,1196428',2018-07-09,CHQ DEP/235/OWDEL1/PSIB/B,0.0,8000.0,,2018,7,9,CHECK_CASHING,8000.0,M771609335
22983,1196428',2018-07-09,CHQ DEP/348/OWDEL1/PSIB/B,0.0,8000.0,,2018,7,9,CHECK_CASHING,8000.0,C1452722471
22984,1196428',2018-07-09,TRF FROM  Indiaforensic SERVICES,0.0,500000.0,,2018,7,9,CHECK_CASHING,500000.0,M1625968481
22985,1196428',2018-07-09,CHQ DEP/44/OWDEL1/HDFC/KA,0.0,11800.0,,2018,7,9,CASH_IN,11800.0,M458727925
22986,1196428',2018-07-09,CHQ DEP/782925/OWDEL1/SBI,0.0,11800.0,,2018,7,9,TRANSFER,11800.0,C111210112
22987,1196428',2018-07-09,CHQ DEP/429918/OWDEL1/SBI,0.0,11800.0,,2018,7,9,CASH_IN,11800.0,C464246030
22988,1196428',2018-07-09,CHQ DEP/282848/OWDEL1/SBI,0.0,11800.0,,2018,7,9,TRANSFER,11800.0,M2080752777
22989,1196428',2018-07-09,CHQ DEP/34113/OWDEL1/IDIB,0.0,11800.0,,2018,7,9,CASH_IN,11800.0,M1357563045
22990,1196428',2018-07-09,CHQ DEP/539114/OWDEL1/SBI,0.0,11800.0,,2018,7,9,TRANSFER,11800.0,M68500741
22991,1196428',2018-07-09,CHQ DEP/14805/OWDEL1/ORBC,0.0,11800.0,,2018,7,9,CASH_IN,11800.0,C1664330755
22992,1196428',2018-07-09,CHQ DEP/690945/OWDEL1/PSI,0.0,11800.0,,2018,7,9,CHECK_CASHING,11800.0,C1823014131
22993,1196428',2018-07-09,CHQ DEP/1698/OWDEL1/ORBC/,0.0,11800.0,,2018,7,9,TRANSFER,11800.0,M1293355387
22994,1196428',2018-07-09,CHQ DEP/644883/OWDEL1/SBI,0.0,11800.0,,2018,7,9,CASH_IN,11800.0,M34599177
22995,1196428',2018-07-09,CHQ DEP/988265/OWDEL1/PUN,0.0,11800.0,,2018,7,9,CASH_IN,11800.0,M685059787
22996,1196428',2018-07-09,CHQ DEP/192/OWDEL1/HDFC/M,0.0,11800.0,,2018,7,9,CHECK_CASHING,11800.0,M376456946
22997,1196428',2018-07-09,CHQ DEP/459654/OWDEL1/SBI,0.0,11800.0,,2018,7,9,TRANSFER,11800.0,M793798217
22998,1196428',2018-07-09,CHQ DEP/604733/OWDEL1/SBI,0.0,11800.0,,2018,7,9,CHECK_CASHING,11800.0,C264685626
22999,1196428',2018-07-09,CHQ DEP/933600/OWDEL1/SBI,0.0,11800.0,,2018,7,9,CASH_IN,11800.0,M954243999
23000,1196428',2018-07-09,CHQ DEP/388761/OWDEL1/SBI,0.0,11800.0,,2018,7,9,CHECK_CASHING,11800.0,C1816986148
23001,1196428',2018-07-09,CHQ DEP/700556/OWDEL1/PUN,0.0,11800.0,,2018,7,9,CHECK_CASHING,11800.0,C1144527317
23002,1196428',2018-07-09,CHQ DEP/659724/OWDEL1/SBI,0.0,11800.0,,2018,7,9,CHECK_CASHING,11800.0,C1790831319
23003,1196428',2018-07-09,CHQ DEP/595549/OWDEL1/SBI,0.0,11800.0,,2018,7,9,TRANSFER,11800.0,C571435580
23004,1196428',2018-07-09,CHQ DEP/910784/OWDEL1/SBI,0.0,11800.0,,2018,7,9,CHECK_CASHING,11800.0,C1262016786
23005,1196428',2018-07-09,CHQ DEP/112334/OWDEL1/SYN,0.0,11800.0,,2018,7,9,CASH_IN,11800.0,C1287328228
23006,1196428',2018-07-09,CHQ DEP/890010/OWDEL1/SBI,0.0,11800.0,,2018,7,9,CASH_IN,11800.0,C329473339
23007,1196428',2018-07-09,CHQ DEP/88383/OWDEL1/SBIN,0.0,11800.0,,2018,7,9,CHECK_CASHING,11800.0,C1354725727
23008,1196428',2018-07-09,CHQ DEP/208/OWDEL1/HDFC/C,0.0,11800.0,,2018,7,9,CASH_IN,11800.0,C1300519073
23009,1196428',2018-07-09,CHQ DEP/12/OWDEL1/PSIB/Tu,0.0,11800.0,,2018,7,9,CASH_IN,11800.0,C2052185144
23010,1196428',2018-07-09,CHQ DEP/451957/OWDEL1/SBI,0.0,11800.0,,2018,7,9,CHECK_CASHING,11800.0,C1485516154
23011,1196428',2018-07-09,CHQ DEP/597/OWDEL1/HDFC/P,0.0,11800.0,,2018,7,9,CASH_IN,11800.0,C2143477943
23012,1196428',2018-07-09,CHQ DEP/3563/OWDEL1/ICIC/,0.0,11800.0,,2018,7,9,TRANSFER,11800.0,C476402209
23013,1196428',2018-07-09,CHQ DEP/529922/OWDEL1/STB,0.0,11800.0,,2018,7,9,CHECK_CASHING,11800.0,C1255024717
23014,1196428',2018-07-09,CHQ DEP/10323/OWDEL1/BKID,0.0,11800.0,,2018,7,9,CASH_IN,11800.0,C1870367457
23015,1196428',2018-07-09,CHQ DEP/21976/OWDEL1/SBIN,0.0,11800.0,,2018,7,9,TRANSFER,11800.0,C465257140
23016,1196428',2018-07-09,CHQ DEP/683938/OWDEL1/SBI,0.0,11800.0,,2018,7,9,CASH_IN,11800.0,C745740822
23017,1196428',2018-07-09,CHQ DEP/2326/OWDEL1/ALLA/,0.0,11800.0,,2018,7,9,CASH_IN,11800.0,C1390121014
23018,1196428',2018-07-09,CHQ DEP/438094/OWDEL1/SBI,0.0,11800.0,,2018,7,9,CASH_IN,11800.0,C1481851679
23019,1196428',2018-07-09,CHQ DEP/43841/OWDEL1/UTIB,0.0,11800.0,,2018,7,9,CHECK_CASHING,11800.0,C741431520
23020,1196428',2018-07-09,CHQ DEP/228/OWDEL1/HDFC/A,0.0,11800.0,,2018,7,9,CASH_IN,11800.0,C758888772
23021,1196428',2018-07-09,CHQ DEP/570418/OWDEL1/SBI,0.0,11800.0,,2018,7,9,TRANSFER,11800.0,C1001409363
23022,1196428',2018-07-09,CHQ DEP/884122/OWDEL1/UTI,0.0,11800.0,,2018,7,9,CASH_IN,11800.0,M1340854901
23023,1196428',2018-07-09,CHQ DEP/208041/OWDEL1/SBI,0.0,11800.0,,2018,7,9,CASH_IN,11800.0,M265997755
23024,1196428',2018-07-09,CHQ DEP/16202/OWDEL1/ORBC,0.0,11800.0,,2018,7,9,CASH_IN,11800.0,M1257695233
23025,1196428',2018-07-09,NEFT/PUNBH18190874079/RAT,0.0,30000.0,,2018,7,9,TRANSFER,30000.0,C150309335
23026,1196428',2018-07-09,RTGS/SBINH18190018345/Indfor,0.0,4900000.0,,2018,7,9,CASH_IN,4900000.0,M1572611628
23027,1196428',2018-07-09,NEFT/N190180581761761/JUN,0.0,190000.0,,2018,7,9,TRANSFER,190000.0,M280183141
23028,1196428',2018-07-09,NEFT/P18070965083376/M/S,0.0,60000.0,,2018,7,9,CHECK_CASHING,60000.0,M808540700
23029,1196428',2018-07-09,TRF FROM  Indiaforensic SERVICES,0.0,15000000.0,,2018,7,9,CASH_IN,15000000.0,M565481399
23030,1196428',2018-07-09,TRF FROM  Indiaforensic SERVICES,0.0,10000000.0,,2018,7,9,CASH_IN,10000000.0,C842729010
23031,1196428',2018-07-09,TRF FROM  Indiaforensic SERVICES,0.0,5000000.0,,2018,7,9,CASH_IN,5000000.0,M178371442
23032,1196428',2018-07-09,NEFT/N190180581964975/USH,0.0,147612.0,,2018,7,9,CHECK_CASHING,147612.0,M2076445832
23033,1196428',2018-07-09,FDRL/REAL TIME GROSS SETTL,15000000.0,0.0,,2018,7,9,PAYEMENT,15000000.0,C599968109
23034,1196428',2018-07-09,FDRL/REAL TIME GROSS SETTL,15000000.0,0.0,,2018,7,9,PAYEMENT,15000000.0,C599265282
23035,1196428',2018-07-09,NEFT/N190180581952826/BAT,0.0,140000.0,,2018,7,9,CHECK_CASHING,140000.0,C669771073
23036,1196428',2018-07-09,Indiaforensic SERVICES INDIA PVT,0.0,162512.0,,2018,7,9,CHECK_CASHING,162512.0,C2137848242
23037,1196428',2018-07-09,NEFT/N190180581984128/USH,0.0,120750.0,,2018,7,9,CHECK_CASHING,120750.0,M997986347
23038,1196428',2018-07-09,NEFT/SBIN718190473881/SRI,0.0,200000.0,,2018,7,9,TRANSFER,200000.0,M1063792159
23039,1196428',2018-07-09,NEFT/SBIN718190474783/SRI,0.0,125000.0,,2018,7,9,CASH_IN,125000.0,C22448303
23040,1196428',2018-07-09,FDRL/REAL TIME GROSS SETTL,5000000.0,0.0,,2018,7,9,DEBIT,5000000.0,M315692635
23041,1196428',2018-07-09,RTGS/HDFCH18190516075/Indfor,0.0,7000000.0,,2018,7,9,CASH_IN,7000000.0,M803644277
23042,1196428',2018-07-09,RTGS/HDFCH18190514154/Indfor,0.0,5200000.0,,2018,7,9,TRANSFER,5200000.0,M415913007
23043,1196428',2018-07-09,FDRL/NATIONAL ELECTRONIC F,2000000.0,0.0,,2018,7,9,CASH_OUT,2000000.0,M1344197461
23044,1196428',2018-07-09,TELEPOWER COMMUNICATION C,6233080.0,0.0,,2018,7,9,CASH_OUT,6233080.0,M132014623
23045,1196428',2018-07-09,IMAR00701804111,8421.95,0.0,,2018,7,9,CHECK_WITHDRAWAL,8421.95,M577051450
23046,1196428',2018-07-09,RTGS/ICICH18190343780/Indfor,0.0,300000.0,,2018,7,9,CHECK_CASHING,300000.0,C1491676195
23047,1196428',2018-07-09,FDRL/INTERNAL FUND TRANSFE,1000000.0,0.0,,2018,7,9,CHECK_WITHDRAWAL,1000000.0,C943166837
23048,1196428',2018-07-09,RTGS/ICICH18190343181/Indfor,0.0,1700000.0,,2018,7,9,CHECK_CASHING,1700000.0,M1402953791
23049,1196428',2018-07-09,RTGS/ICICH18190342397/Indfor,0.0,1300000.0,,2018,7,9,CHECK_CASHING,1300000.0,M1974589236
23050,1196428',2018-07-09,Indiaforensic SERVICES INDIA PVT,0.0,435624.0,,2018,7,9,TRANSFER,435624.0,C1701412896
23051,1196428',2018-07-09,TRF TO  Indiaforensic SERVICES I,150000.0,0.0,,2018,7,9,CASH_OUT,150000.0,M1355606971
23052,1196428',2018-07-09,NEFT/000048596758/Indiaforensic,0.0,500000.0,,2018,7,9,CHECK_CASHING,500000.0,M1037747072
23053,1196428',2018-07-09,CHQ DEPOSIT RETURN/539114,11800.0,0.0,,2018,7,9,PAYEMENT,11800.0,M82220349
23054,1196428',2018-07-09,CHQ DEPOSIT RETURN/700556,11800.0,0.0,,2018,7,9,DEBIT,11800.0,M953439482
23055,1196428',2018-07-09,CHQ DEPOSIT RETURN/239849,11800.0,0.0,,2018,7,9,PAYEMENT,11800.0,C1914282536
23056,1196428',2018-07-09,CHQ DEPOSIT RETURN/529922,11800.0,0.0,,2018,7,9,CASH_OUT,11800.0,C691636444
23057,1196428',2018-07-09,CHQ DEPOSIT RETURN/96884/,11800.0,0.0,,2018,7,9,DEBIT,11800.0,C683605346
23058,1196428',2018-07-09,CHQ DEPOSIT RETURN/113/FU,11800.0,0.0,,2018,7,9,CHECK_WITHDRAWAL,11800.0,M1967366965
23059,1196428',2018-07-09,CHQ DEPOSIT RETURN/982798,11800.0,0.0,,2018,7,9,DEBIT,11800.0,M508405148
23060,1196428',2018-07-09,CHQ DEPOSIT RETURN/2/FUND,8000.0,0.0,,2018,7,9,CASH_OUT,8000.0,M1295579320
23061,1196428',2018-07-09,CHQ DEPOSIT RETURN/340216,8260.0,0.0,,2018,7,9,CHECK_WITHDRAWAL,8260.0,M995168511
23062,1196428',2018-07-09,CHQ DEPOSIT RETURN/100/EX,11800.0,0.0,,2018,7,9,PAYEMENT,11800.0,M1102425439
23063,1196428',2018-07-09,CHQ DEPOSIT RETURN/10/FUN,11800.0,0.0,,2018,7,9,CHECK_WITHDRAWAL,11800.0,M590053012
23064,1196428',2018-07-09,CHQ DEPOSIT RETURN/767638,11800.0,0.0,,2018,7,9,PAYEMENT,11800.0,M386886002
23065,1196428',2018-07-09,NEFT/000048596310/Indiaforensic,0.0,500000.0,,2018,7,9,TRANSFER,500000.0,M227585143
23066,1196428',2018-07-09,TRF FROM  Indiaforensic SERVICES,0.0,3000000.0,,2018,7,9,TRANSFER,3000000.0,M2105068287
23067,1196428',2018-07-09,TRF FROM  Indiaforensic SERVICES,0.0,5000000.0,,2018,7,9,CASH_IN,5000000.0,M1038116064
23068,1196428',2018-07-09,TRF FROM  Indiaforensic SERVICES,0.0,2800000.0,,2018,7,9,TRANSFER,2800000.0,M345805867
23069,1196428',2018-07-09,TRF FROM  Indiaforensic SERVICES,0.0,400000.0,,2018,7,9,CHECK_CASHING,400000.0,M1128144161
23070,1196428',2018-07-09,FDRL/INTERNAL FUND TRANSFE,15000000.0,0.0,,2018,7,9,CHECK_WITHDRAWAL,15000000.0,M1492172037
23071,1196428',2018-07-09,TRF FROM  Indiaforensic SERVICES,0.0,3000000.0,,2018,7,9,CHECK_CASHING,3000000.0,M731603444
23072,1196428',2018-07-09,TRF FROM  Indiaforensic SERVICES,0.0,1000000.0,,2018,7,9,CASH_IN,1000000.0,M879683510
23073,1196428',2018-07-09,FDRL/INTERNAL FUND TRANSFE,500000.0,0.0,,2018,7,9,DEBIT,500000.0,M555126583
23074,1196428',2018-07-09,FDRL/INTERNAL FUND TRANSFE,5000000.0,0.0,,2018,7,9,CASH_OUT,5000000.0,M1344791022
23075,1196428',2018-07-09,BEAT CSH PKP DEL GURG 620,0.0,610000.0,,2018,7,9,CHECK_CASHING,610000.0,M40493588
23076,1196428',2018-07-09,CHQ DEPOSIT RETURN/539114,100.0,0.0,,2018,7,9,DEBIT,100.0,M1099885881
23077,1196428',2018-07-09,CHQ DEPOSIT RETURN/539114,18.0,0.0,,2018,7,9,PAYEMENT,18.0,M107256650
23078,1196428',2018-07-09,CHQ DEPOSIT RETURN/700556,100.0,0.0,,2018,7,9,CASH_OUT,100.0,M1410611700
23079,1196428',2018-07-09,CHQ DEPOSIT RETURN/700556,18.0,0.0,,2018,7,9,CASH_OUT,18.0,M954062800
23080,1196428',2018-07-09,CHQ DEPOSIT RETURN/113/CH,100.0,0.0,,2018,7,9,DEBIT,100.0,M13013852
23081,1196428',2018-07-09,CHQ DEPOSIT RETURN/113/GS,18.0,0.0,,2018,7,9,PAYEMENT,18.0,M1101858256
23082,1196428',2018-07-09,CHQ DEPOSIT RETURN/982798,100.0,0.0,,2018,7,9,DEBIT,100.0,M1180862248
23083,1196428',2018-07-09,CHQ DEPOSIT RETURN/982798,18.0,0.0,,2018,7,9,DEBIT,18.0,M966462848
23084,1196428',2018-07-09,CHQ DEPOSIT RETURN/2/CHAR,100.0,0.0,,2018,7,9,PAYEMENT,100.0,M1284324188
23085,1196428',2018-07-09,CHQ DEPOSIT RETURN/2/GST,18.0,0.0,,2018,7,9,CASH_OUT,18.0,C374625527
23086,1196428',2018-07-09,CHQ DEPOSIT RETURN/340216,100.0,0.0,,2018,7,9,CASH_OUT,100.0,C1262822392
23087,1196428',2018-07-09,CHQ DEPOSIT RETURN/340216,18.0,0.0,,2018,7,9,DEBIT,18.0,C1671386208
23088,1196428',2018-07-09,CHQ DEPOSIT RETURN/100/CH,100.0,0.0,,2018,7,9,CHECK_WITHDRAWAL,100.0,C1869197498
23089,1196428',2018-07-09,CHQ DEPOSIT RETURN/100/GS,18.0,0.0,,2018,7,9,PAYEMENT,18.0,C271488817
23090,1196428',2018-07-09,CHQ DEPOSIT RETURN/10/CHA,100.0,0.0,,2018,7,9,CHECK_WITHDRAWAL,100.0,M1915909017
23091,1196428',2018-07-09,CHQ DEPOSIT RETURN/10/GST,18.0,0.0,,2018,7,9,PAYEMENT,18.0,C2052185144
23092,1196428',2018-07-10,FDRL/REAL TIME GROSS SETTL,5835504.27,0.0,,2018,7,10,CHECK_WITHDRAWAL,5835504.27,C646059443
23093,1196428',2018-07-10,RTGS/SBINH18191005707/Indfor,0.0,4300000.0,,2018,7,10,CASH_IN,4300000.0,C1982591789
23094,1196428',2018-07-10,FDRL/NATIONAL ELECTRONIC F,15105.0,0.0,,2018,7,10,DEBIT,15105.0,C1977614404
23095,1196428',2018-07-10,FDRL/NATIONAL ELECTRONIC F,28565.0,0.0,,2018,7,10,CASH_OUT,28565.0,C1883840933
23096,1196428',2018-07-10,FDRL/NATIONAL ELECTRONIC F,26350.0,0.0,,2018,7,10,CHECK_WITHDRAWAL,26350.0,C2007207148
23097,1196428',2018-07-10,FDRL/NATIONAL ELECTRONIC F,18314.0,0.0,,2018,7,10,DEBIT,18314.0,M1014644493
23098,1196428',2018-07-10,FDRL/NATIONAL ELECTRONIC F,28602.0,0.0,,2018,7,10,PAYEMENT,28602.0,C381605910
23099,1196428',2018-07-10,FDRL/NATIONAL ELECTRONIC F,18314.0,0.0,,2018,7,10,CASH_OUT,18314.0,M1056752544
23100,1196428',2018-07-10,FDRL/NATIONAL ELECTRONIC F,28726.0,0.0,,2018,7,10,DEBIT,28726.0,M729567968
23101,1196428',2018-07-10,FDRL/NATIONAL ELECTRONIC F,16389.0,0.0,,2018,7,10,PAYEMENT,16389.0,M1723507087
23102,1196428',2018-07-10,FDRL/NATIONAL ELECTRONIC F,14909.0,0.0,,2018,7,10,CHECK_WITHDRAWAL,14909.0,C849038219
23103,1196428',2018-07-10,FDRL/NATIONAL ELECTRONIC F,20770.0,0.0,,2018,7,10,CASH_OUT,20770.0,C1038678108
23104,1196428',2018-07-10,FDRL/NATIONAL ELECTRONIC F,29893.0,0.0,,2018,7,10,CHECK_WITHDRAWAL,29893.0,M1976340229
23105,1196428',2018-07-10,FDRL/NATIONAL ELECTRONIC F,15418.0,0.0,,2018,7,10,CASH_OUT,15418.0,M693274483
23106,1196428',2018-07-10,FDRL/NATIONAL ELECTRONIC F,28602.0,0.0,,2018,7,10,PAYEMENT,28602.0,M838050003
23107,1196428',2018-07-10,FDRL/NATIONAL ELECTRONIC F,20895.0,0.0,,2018,7,10,DEBIT,20895.0,C1009972184
23108,1196428',2018-07-10,FDRL/NATIONAL ELECTRONIC F,21159.0,0.0,,2018,7,10,CHECK_WITHDRAWAL,21159.0,C63475121
23109,1196428',2018-07-10,FDRL/NATIONAL ELECTRONIC F,14521.0,0.0,,2018,7,10,CASH_OUT,14521.0,C1130075212
23110,1196428',2018-07-10,FDRL/NATIONAL ELECTRONIC F,17693.0,0.0,,2018,7,10,DEBIT,17693.0,C851316413
23111,1196428',2018-07-10,FDRL/NATIONAL ELECTRONIC F,20592.0,0.0,,2018,7,10,CASH_OUT,20592.0,M718843573
23112,1196428',2018-07-10,FDRL/NATIONAL ELECTRONIC F,29337.0,0.0,,2018,7,10,PAYEMENT,29337.0,M1217713614
23113,1196428',2018-07-10,FDRL/NATIONAL ELECTRONIC F,12155.0,0.0,,2018,7,10,DEBIT,12155.0,M706338650
23114,1196428',2018-07-10,FDRL/NATIONAL ELECTRONIC F,26110.0,0.0,,2018,7,10,DEBIT,26110.0,M995800830
23115,1196428',2018-07-10,FDRL/NATIONAL ELECTRONIC F,26350.0,0.0,,2018,7,10,DEBIT,26350.0,C1073259437
23116,1196428',2018-07-10,FDRL/NATIONAL ELECTRONIC F,9053.0,0.0,,2018,7,10,PAYEMENT,9053.0,M1699315785
23117,1196428',2018-07-10,FDRL/NATIONAL ELECTRONIC F,12529.0,0.0,,2018,7,10,DEBIT,12529.0,M1163711030
23118,1196428',2018-07-10,FDRL/NATIONAL ELECTRONIC F,28579.0,0.0,,2018,7,10,CASH_OUT,28579.0,C320106510
23119,1196428',2018-07-10,FDRL/NATIONAL ELECTRONIC F,14876.0,0.0,,2018,7,10,PAYEMENT,14876.0,M597251930
23120,1196428',2018-07-10,FDRL/NATIONAL ELECTRONIC F,26400.0,0.0,,2018,7,10,CHECK_WITHDRAWAL,26400.0,M1515100477
23121,1196428',2018-07-10,FDRL/NATIONAL ELECTRONIC F,25294.0,0.0,,2018,7,10,CASH_OUT,25294.0,M1412315921
23122,1196428',2018-07-10,FDRL/NATIONAL ELECTRONIC F,10378.0,0.0,,2018,7,10,PAYEMENT,10378.0,M1168923345
23123,1196428',2018-07-10,FDRL/NATIONAL ELECTRONIC F,17086.0,0.0,,2018,7,10,CHECK_WITHDRAWAL,17086.0,M2042700604
23124,1196428',2018-07-10,FDRL/NATIONAL ELECTRONIC F,18552.0,0.0,,2018,7,10,CHECK_WITHDRAWAL,18552.0,C710481910
23125,1196428',2018-07-10,FDRL/NATIONAL ELECTRONIC F,17764.0,0.0,,2018,7,10,CASH_OUT,17764.0,M1474634841
23126,1196428',2018-07-10,FDRL/NATIONAL ELECTRONIC F,28594.0,0.0,,2018,7,10,DEBIT,28594.0,C669419693
23127,1196428',2018-07-10,FDRL/NATIONAL ELECTRONIC F,23842.0,0.0,,2018,7,10,CHECK_WITHDRAWAL,23842.0,C2095611317
23128,1196428',2018-07-10,FDRL/NATIONAL ELECTRONIC F,12930.0,0.0,,2018,7,10,PAYEMENT,12930.0,C1316560467
23129,1196428',2018-07-10,FDRL/NATIONAL ELECTRONIC F,18564.0,0.0,,2018,7,10,PAYEMENT,18564.0,M1572144334
23130,1196428',2018-07-10,FDRL/NATIONAL ELECTRONIC F,27950.0,0.0,,2018,7,10,CHECK_WITHDRAWAL,27950.0,M593517569
23131,1196428',2018-07-10,FDRL/NATIONAL ELECTRONIC F,18314.0,0.0,,2018,7,10,DEBIT,18314.0,M558730564
23132,1196428',2018-07-10,FDRL/NATIONAL ELECTRONIC F,26855.0,0.0,,2018,7,10,PAYEMENT,26855.0,C736160330
23133,1196428',2018-07-10,FDRL/NATIONAL ELECTRONIC F,25740.0,0.0,,2018,7,10,DEBIT,25740.0,C417236208
23134,1196428',2018-07-10,FDRL/NATIONAL ELECTRONIC F,19056.0,0.0,,2018,7,10,CASH_OUT,19056.0,C931482420
23135,1196428',2018-07-10,FDRL/NATIONAL ELECTRONIC F,18802.0,0.0,,2018,7,10,CASH_OUT,18802.0,M405976415
23136,1196428',2018-07-10,FDRL/NATIONAL ELECTRONIC F,28610.0,0.0,,2018,7,10,CHECK_WITHDRAWAL,28610.0,C208341157
23137,1196428',2018-07-10,FDRL/NATIONAL ELECTRONIC F,18552.0,0.0,,2018,7,10,CHECK_WITHDRAWAL,18552.0,C382697424
23138,1196428',2018-07-10,FDRL/NATIONAL ELECTRONIC F,15596.0,0.0,,2018,7,10,CASH_OUT,15596.0,M875577692
23139,1196428',2018-07-10,FDRL/NATIONAL ELECTRONIC F,18552.0,0.0,,2018,7,10,CHECK_WITHDRAWAL,18552.0,C1822578654
23140,1196428',2018-07-10,FDRL/NATIONAL ELECTRONIC F,26350.0,0.0,,2018,7,10,PAYEMENT,26350.0,M2022435822
23141,1196428',2018-07-10,FDRL/NATIONAL ELECTRONIC F,26110.0,0.0,,2018,7,10,CASH_OUT,26110.0,M1867372125
23142,1196428',2018-07-10,FDRL/NATIONAL ELECTRONIC F,28610.0,0.0,,2018,7,10,DEBIT,28610.0,M556592378
23143,1196428',2018-07-10,FDRL/NATIONAL ELECTRONIC F,15596.0,0.0,,2018,7,10,PAYEMENT,15596.0,C807072084
23144,1196428',2018-07-10,FDRL/NATIONAL ELECTRONIC F,26350.0,0.0,,2018,7,10,PAYEMENT,26350.0,C2077098348
23145,1196428',2018-07-10,FDRL/NATIONAL ELECTRONIC F,18552.0,0.0,,2018,7,10,PAYEMENT,18552.0,M1751878963
23146,1196428',2018-07-10,FDRL/NATIONAL ELECTRONIC F,28179.0,0.0,,2018,7,10,CASH_OUT,28179.0,C1618278649
23147,1196428',2018-07-10,FDRL/NATIONAL ELECTRONIC F,18552.0,0.0,,2018,7,10,PAYEMENT,18552.0,C1987564320
23148,1196428',2018-07-10,FDRL/NATIONAL ELECTRONIC F,11010.0,0.0,,2018,7,10,DEBIT,11010.0,M848162783
23149,1196428',2018-07-10,FDRL/NATIONAL ELECTRONIC F,18802.0,0.0,,2018,7,10,CASH_OUT,18802.0,M347906624
23150,1196428',2018-07-10,FDRL/NATIONAL ELECTRONIC F,3134.0,0.0,,2018,7,10,DEBIT,3134.0,M271658762
23151,1196428',2018-07-10,FDRL/NATIONAL ELECTRONIC F,13516.0,0.0,,2018,7,10,CASH_OUT,13516.0,M1403007770
23152,1196428',2018-07-10,FDRL/NATIONAL ELECTRONIC F,56775.0,0.0,,2018,7,10,DEBIT,56775.0,M2043631011
23153,1196428',2018-07-10,FDRL/NATIONAL ELECTRONIC F,43359.0,0.0,,2018,7,10,CHECK_WITHDRAWAL,43359.0,C107095723
23154,1196428',2018-07-10,FDRL/NATIONAL ELECTRONIC F,38423.0,0.0,,2018,7,10,DEBIT,38423.0,C985934102
23155,1196428',2018-07-10,FDRL/NATIONAL ELECTRONIC F,70330.0,0.0,,2018,7,10,DEBIT,70330.0,C824197891
23156,1196428',2018-07-10,FDRL/NATIONAL ELECTRONIC F,67600.0,0.0,,2018,7,10,DEBIT,67600.0,C1696218625
23157,1196428',2018-07-10,FDRL/NATIONAL ELECTRONIC F,48291.0,0.0,,2018,7,10,PAYEMENT,48291.0,M1817447589
23158,1196428',2018-07-10,FDRL/NATIONAL ELECTRONIC F,35789.0,0.0,,2018,7,10,CASH_OUT,35789.0,C168639687
23159,1196428',2018-07-10,FDRL/NATIONAL ELECTRONIC F,30771.0,0.0,,2018,7,10,CASH_OUT,30771.0,C1630293008
23160,1196428',2018-07-10,FDRL/NATIONAL ELECTRONIC F,68775.0,0.0,,2018,7,10,DEBIT,68775.0,C1577420620
23161,1196428',2018-07-10,FDRL/NATIONAL ELECTRONIC F,60456.0,0.0,,2018,7,10,PAYEMENT,60456.0,C35263828
23162,1196428',2018-07-10,FDRL/NATIONAL ELECTRONIC F,44310.0,0.0,,2018,7,10,DEBIT,44310.0,M2014874822
23163,1196428',2018-07-10,FDRL/NATIONAL ELECTRONIC F,64007.0,0.0,,2018,7,10,PAYEMENT,64007.0,M1553772873
23164,1196428',2018-07-10,FDRL/NATIONAL ELECTRONIC F,69805.0,0.0,,2018,7,10,CHECK_WITHDRAWAL,69805.0,C905650857
23165,1196428',2018-07-10,FDRL/NATIONAL ELECTRONIC F,38510.0,0.0,,2018,7,10,CASH_OUT,38510.0,C1502287290
23166,1196428',2018-07-10,FDRL/NATIONAL ELECTRONIC F,43300.0,0.0,,2018,7,10,CHECK_WITHDRAWAL,43300.0,M1197564988
23167,1196428',2018-07-10,FDRL/NATIONAL ELECTRONIC F,51988.0,0.0,,2018,7,10,DEBIT,51988.0,M1843534160
23168,1196428',2018-07-10,FDRL/NATIONAL ELECTRONIC F,31282.0,0.0,,2018,7,10,CHECK_WITHDRAWAL,31282.0,C871895680
23169,1196428',2018-07-10,FDRL/NATIONAL ELECTRONIC F,62557.0,0.0,,2018,7,10,CHECK_WITHDRAWAL,62557.0,C1398530689
23170,1196428',2018-07-10,FDRL/NATIONAL ELECTRONIC F,73217.0,0.0,,2018,7,10,DEBIT,73217.0,M834859488
23171,1196428',2018-07-10,FDRL/NATIONAL ELECTRONIC F,75735.0,0.0,,2018,7,10,DEBIT,75735.0,M463880076
23172,1196428',2018-07-10,FDRL/NATIONAL ELECTRONIC F,33096.0,0.0,,2018,7,10,DEBIT,33096.0,M1273091698
23173,1196428',2018-07-10,FDRL/NATIONAL ELECTRONIC F,48114.0,0.0,,2018,7,10,CASH_OUT,48114.0,M134350609
23174,1196428',2018-07-10,FDRL/NATIONAL ELECTRONIC F,46537.0,0.0,,2018,7,10,CASH_OUT,46537.0,M1939822545
23175,1196428',2018-07-10,FDRL/NATIONAL ELECTRONIC F,35005.0,0.0,,2018,7,10,DEBIT,35005.0,M1498010747
23176,1196428',2018-07-10,FDRL/NATIONAL ELECTRONIC F,55499.0,0.0,,2018,7,10,CHECK_WITHDRAWAL,55499.0,M615833646
23177,1196428',2018-07-10,FDRL/NATIONAL ELECTRONIC F,91037.0,0.0,,2018,7,10,DEBIT,91037.0,M695601535
23178,1196428',2018-07-10,FDRL/NATIONAL ELECTRONIC F,61989.0,0.0,,2018,7,10,CHECK_WITHDRAWAL,61989.0,M1741551200
23179,1196428',2018-07-10,FDRL/NATIONAL ELECTRONIC F,32246.0,0.0,,2018,7,10,CASH_OUT,32246.0,M533060514
23180,1196428',2018-07-10,FDRL/NATIONAL ELECTRONIC F,34769.0,0.0,,2018,7,10,CASH_OUT,34769.0,M763925237
23181,1196428',2018-07-10,FDRL/NATIONAL ELECTRONIC F,66281.0,0.0,,2018,7,10,DEBIT,66281.0,M309397793
23182,1196428',2018-07-10,FDRL/NATIONAL ELECTRONIC F,36919.0,0.0,,2018,7,10,CASH_OUT,36919.0,M786088183
23183,1196428',2018-07-10,FDRL/NATIONAL ELECTRONIC F,59712.0,0.0,,2018,7,10,CHECK_WITHDRAWAL,59712.0,M1362397723
23184,1196428',2018-07-10,FDRL/NATIONAL ELECTRONIC F,30027.0,0.0,,2018,7,10,DEBIT,30027.0,M166947904
23185,1196428',2018-07-10,FDRL/NATIONAL ELECTRONIC F,30870.0,0.0,,2018,7,10,CASH_OUT,30870.0,M39384037
23186,1196428',2018-07-10,FDRL/NATIONAL ELECTRONIC F,76579.0,0.0,,2018,7,10,CHECK_WITHDRAWAL,76579.0,M1475711030
23187,1196428',2018-07-10,FDRL/NATIONAL ELECTRONIC F,58440.0,0.0,,2018,7,10,PAYEMENT,58440.0,M727579419
23188,1196428',2018-07-10,FDRL/NATIONAL ELECTRONIC F,57307.0,0.0,,2018,7,10,CHECK_WITHDRAWAL,57307.0,M654290745
23189,1196428',2018-07-10,FDRL/NATIONAL ELECTRONIC F,64220.0,0.0,,2018,7,10,CHECK_WITHDRAWAL,64220.0,C1559145228
23190,1196428',2018-07-10,FDRL/NATIONAL ELECTRONIC F,41075.0,0.0,,2018,7,10,DEBIT,41075.0,M688458571
23191,1196428',2018-07-10,FDRL/NATIONAL ELECTRONIC F,112020.0,0.0,,2018,7,10,CASH_OUT,112020.0,M1895621189
23192,1196428',2018-07-10,FDRL/NATIONAL ELECTRONIC F,72327.0,0.0,,2018,7,10,CHECK_WITHDRAWAL,72327.0,M1516781526
23193,1196428',2018-07-10,FDRL/NATIONAL ELECTRONIC F,15596.0,0.0,,2018,7,10,DEBIT,15596.0,M409559965
23194,1196428',2018-07-10,FDRL/NATIONAL ELECTRONIC F,18314.0,0.0,,2018,7,10,PAYEMENT,18314.0,M1771169983
23195,1196428',2018-07-10,FDRL/NATIONAL ELECTRONIC F,28579.0,0.0,,2018,7,10,PAYEMENT,28579.0,C470217116
23196,1196428',2018-07-10,FDRL/NATIONAL ELECTRONIC F,11950.0,0.0,,2018,7,10,CHECK_WITHDRAWAL,11950.0,M585745963
23197,1196428',2018-07-10,FDRL/NATIONAL ELECTRONIC F,24107.0,0.0,,2018,7,10,CHECK_WITHDRAWAL,24107.0,M2096974885
23198,1196428',2018-07-10,FDRL/NATIONAL ELECTRONIC F,28609.0,0.0,,2018,7,10,DEBIT,28609.0,M1287228290
23199,1196428',2018-07-10,FDRL/NATIONAL ELECTRONIC F,22047.0,0.0,,2018,7,10,PAYEMENT,22047.0,M1178751818
23200,1196428',2018-07-10,FDRL/NATIONAL ELECTRONIC F,28609.0,0.0,,2018,7,10,CHECK_WITHDRAWAL,28609.0,M145594829
23201,1196428',2018-07-10,FDRL/NATIONAL ELECTRONIC F,28597.0,0.0,,2018,7,10,PAYEMENT,28597.0,M1232351629
23202,1196428',2018-07-10,FDRL/NATIONAL ELECTRONIC F,26160.0,0.0,,2018,7,10,PAYEMENT,26160.0,M1656904340
23203,1196428',2018-07-10,FDRL/NATIONAL ELECTRONIC F,14605.0,0.0,,2018,7,10,CASH_OUT,14605.0,C24404443
23204,1196428',2018-07-10,FDRL/NATIONAL ELECTRONIC F,28859.0,0.0,,2018,7,10,CHECK_WITHDRAWAL,28859.0,C596299019
23205,1196428',2018-07-10,FDRL/NATIONAL ELECTRONIC F,18352.0,0.0,,2018,7,10,CHECK_WITHDRAWAL,18352.0,C1983747920
23206,1196428',2018-07-10,FDRL/NATIONAL ELECTRONIC F,28608.0,0.0,,2018,7,10,CASH_OUT,28608.0,C696705647
23207,1196428',2018-07-10,FDRL/NATIONAL ELECTRONIC F,1795.0,0.0,,2018,7,10,CHECK_WITHDRAWAL,1795.0,C1845765982
23208,1196428',2018-07-10,FDRL/NATIONAL ELECTRONIC F,10204.0,0.0,,2018,7,10,DEBIT,10204.0,M877365519
23209,1196428',2018-07-10,FDRL/NATIONAL ELECTRONIC F,18314.0,0.0,,2018,7,10,PAYEMENT,18314.0,C134604590
23210,1196428',2018-07-10,FDRL/NATIONAL ELECTRONIC F,18077.0,0.0,,2018,7,10,CHECK_WITHDRAWAL,18077.0,M1053485132
23211,1196428',2018-07-10,FDRL/NATIONAL ELECTRONIC F,18552.0,0.0,,2018,7,10,CASH_OUT,18552.0,M1698378565
23212,1196428',2018-07-10,FDRL/NATIONAL ELECTRONIC F,19860.0,0.0,,2018,7,10,DEBIT,19860.0,M1418167825
23213,1196428',2018-07-10,FDRL/NATIONAL ELECTRONIC F,28859.0,0.0,,2018,7,10,PAYEMENT,28859.0,M915318947
23214,1196428',2018-07-10,FDRL/NATIONAL ELECTRONIC F,15746.0,0.0,,2018,7,10,DEBIT,15746.0,M1471526064
23215,1196428',2018-07-10,FDRL/NATIONAL ELECTRONIC F,18552.0,0.0,,2018,7,10,CASH_OUT,18552.0,C474166728
23216,1196428',2018-07-10,FDRL/NATIONAL ELECTRONIC F,18602.0,0.0,,2018,7,10,CASH_OUT,18602.0,M1777764920
23217,1196428',2018-07-10,FDRL/NATIONAL ELECTRONIC F,15589.0,0.0,,2018,7,10,CASH_OUT,15589.0,C1833549064
23218,1196428',2018-07-10,FDRL/NATIONAL ELECTRONIC F,28609.0,0.0,,2018,7,10,CASH_OUT,28609.0,M327804056
23219,1196428',2018-07-10,FDRL/NATIONAL ELECTRONIC F,18552.0,0.0,,2018,7,10,CHECK_WITHDRAWAL,18552.0,M939893108
23220,1196428',2018-07-10,FDRL/NATIONAL ELECTRONIC F,17316.0,0.0,,2018,7,10,CASH_OUT,17316.0,C1938462589
23221,1196428',2018-07-10,FDRL/NATIONAL ELECTRONIC F,28609.0,0.0,,2018,7,10,CHECK_WITHDRAWAL,28609.0,M974784761
23222,1196428',2018-07-10,FDRL/NATIONAL ELECTRONIC F,24910.0,0.0,,2018,7,10,PAYEMENT,24910.0,M209997138
23223,1196428',2018-07-10,FDRL/NATIONAL ELECTRONIC F,28610.0,0.0,,2018,7,10,CASH_OUT,28610.0,M359327148
23224,1196428',2018-07-10,FDRL/NATIONAL ELECTRONIC F,28609.0,0.0,,2018,7,10,PAYEMENT,28609.0,C1519216494
23225,1196428',2018-07-10,FDRL/NATIONAL ELECTRONIC F,28659.0,0.0,,2018,7,10,PAYEMENT,28659.0,M142106520
23226,1196428',2018-07-10,FDRL/NATIONAL ELECTRONIC F,28609.0,0.0,,2018,7,10,CHECK_WITHDRAWAL,28609.0,C1979080020
23227,1196428',2018-07-10,FDRL/NATIONAL ELECTRONIC F,28609.0,0.0,,2018,7,10,CASH_OUT,28609.0,C635281078
23228,1196428',2018-07-10,FDRL/NATIONAL ELECTRONIC F,28609.0,0.0,,2018,7,10,CASH_OUT,28609.0,C1866672043
23229,1196428',2018-07-10,FDRL/NATIONAL ELECTRONIC F,28609.0,0.0,,2018,7,10,DEBIT,28609.0,M155979068
23230,1196428',2018-07-10,FDRL/NATIONAL ELECTRONIC F,18552.0,0.0,,2018,7,10,CHECK_WITHDRAWAL,18552.0,M111496179
23231,1196428',2018-07-10,FDRL/NATIONAL ELECTRONIC F,12648.0,0.0,,2018,7,10,CHECK_WITHDRAWAL,12648.0,M1472428747
23232,1196428',2018-07-10,FDRL/NATIONAL ELECTRONIC F,18602.0,0.0,,2018,7,10,CHECK_WITHDRAWAL,18602.0,C1167813715
23233,1196428',2018-07-10,FDRL/NATIONAL ELECTRONIC F,12335.0,0.0,,2018,7,10,DEBIT,12335.0,M235839070
23234,1196428',2018-07-10,FDRL/NATIONAL ELECTRONIC F,28659.0,0.0,,2018,7,10,CHECK_WITHDRAWAL,28659.0,M1881768592
23235,1196428',2018-07-10,FDRL/NATIONAL ELECTRONIC F,18552.0,0.0,,2018,7,10,PAYEMENT,18552.0,C185503802
23236,1196428',2018-07-10,FDRL/NATIONAL ELECTRONIC F,24140.0,0.0,,2018,7,10,CHECK_WITHDRAWAL,24140.0,C403147759
23237,1196428',2018-07-10,FDRL/NATIONAL ELECTRONIC F,18552.0,0.0,,2018,7,10,CASH_OUT,18552.0,M1725462644
23238,1196428',2018-07-10,FDRL/NATIONAL ELECTRONIC F,18802.0,0.0,,2018,7,10,CHECK_WITHDRAWAL,18802.0,M685639359
23239,1196428',2018-07-10,FDRL/NATIONAL ELECTRONIC F,13516.0,0.0,,2018,7,10,PAYEMENT,13516.0,M499928991
23240,1196428',2018-07-10,FDRL/NATIONAL ELECTRONIC F,25750.0,0.0,,2018,7,10,PAYEMENT,25750.0,M960322367
23241,1196428',2018-07-10,FDRL/NATIONAL ELECTRONIC F,25750.0,0.0,,2018,7,10,DEBIT,25750.0,M1786085833
23242,1196428',2018-07-10,FDRL/NATIONAL ELECTRONIC F,25750.0,0.0,,2018,7,10,DEBIT,25750.0,M718103121
23243,1196428',2018-07-10,FDRL/NATIONAL ELECTRONIC F,18552.0,0.0,,2018,7,10,PAYEMENT,18552.0,M757687320
23244,1196428',2018-07-10,FDRL/NATIONAL ELECTRONIC F,13602.0,0.0,,2018,7,10,CASH_OUT,13602.0,M1144148971
23245,1196428',2018-07-10,FDRL/NATIONAL ELECTRONIC F,25750.0,0.0,,2018,7,10,PAYEMENT,25750.0,M1868505862
23246,1196428',2018-07-10,FDRL/NATIONAL ELECTRONIC F,25750.0,0.0,,2018,7,10,CHECK_WITHDRAWAL,25750.0,M1608080402
23247,1196428',2018-07-10,FDRL/NATIONAL ELECTRONIC F,25550.0,0.0,,2018,7,10,CASH_OUT,25550.0,M1154038476
23248,1196428',2018-07-10,FDRL/NATIONAL ELECTRONIC F,25750.0,0.0,,2018,7,10,CHECK_WITHDRAWAL,25750.0,M1325923139
23249,1196428',2018-07-10,FDRL/NATIONAL ELECTRONIC F,29699.0,0.0,,2018,7,10,CHECK_WITHDRAWAL,29699.0,M1396188238
23250,1196428',2018-07-10,FDRL/NATIONAL ELECTRONIC F,25750.0,0.0,,2018,7,10,CHECK_WITHDRAWAL,25750.0,M554850979
23251,1196428',2018-07-10,FDRL/NATIONAL ELECTRONIC F,18998.0,0.0,,2018,7,10,PAYEMENT,18998.0,M1055780232
23252,1196428',2018-07-10,FDRL/NATIONAL ELECTRONIC F,18612.0,0.0,,2018,7,10,CHECK_WITHDRAWAL,18612.0,M662568271
23253,1196428',2018-07-10,FDRL/NATIONAL ELECTRONIC F,12358.0,0.0,,2018,7,10,PAYEMENT,12358.0,C1649449847
23254,1196428',2018-07-10,FDRL/NATIONAL ELECTRONIC F,18314.0,0.0,,2018,7,10,CASH_OUT,18314.0,C1198167820
23255,1196428',2018-07-10,FDRL/NATIONAL ELECTRONIC F,18314.0,0.0,,2018,7,10,CHECK_WITHDRAWAL,18314.0,C749672494
23256,1196428',2018-07-10,FDRL/NATIONAL ELECTRONIC F,18314.0,0.0,,2018,7,10,CASH_OUT,18314.0,C1423992712
23257,1196428',2018-07-10,FDRL/NATIONAL ELECTRONIC F,18014.0,0.0,,2018,7,10,CASH_OUT,18014.0,C313124964
23258,1196428',2018-07-10,FDRL/NATIONAL ELECTRONIC F,28594.0,0.0,,2018,7,10,PAYEMENT,28594.0,C500153041
23259,1196428',2018-07-10,FDRL/NATIONAL ELECTRONIC F,29650.0,0.0,,2018,7,10,PAYEMENT,29650.0,C728526866
23260,1196428',2018-07-10,FDRL/NATIONAL ELECTRONIC F,19543.0,0.0,,2018,7,10,DEBIT,19543.0,C40075281
23261,1196428',2018-07-10,FDRL/NATIONAL ELECTRONIC F,14036.0,0.0,,2018,7,10,CHECK_WITHDRAWAL,14036.0,C456538529
23262,1196428',2018-07-10,FDRL/NATIONAL ELECTRONIC F,29747.0,0.0,,2018,7,10,CHECK_WITHDRAWAL,29747.0,C2117043942
23263,1196428',2018-07-10,FDRL/NATIONAL ELECTRONIC F,21271.0,0.0,,2018,7,10,PAYEMENT,21271.0,C1838584624
23264,1196428',2018-07-10,FDRL/NATIONAL ELECTRONIC F,18564.0,0.0,,2018,7,10,CHECK_WITHDRAWAL,18564.0,M1733424208
23265,1196428',2018-07-10,FDRL/NATIONAL ELECTRONIC F,18802.0,0.0,,2018,7,10,DEBIT,18802.0,M1060393794
23266,1196428',2018-07-10,FDRL/NATIONAL ELECTRONIC F,24090.0,0.0,,2018,7,10,PAYEMENT,24090.0,M226593165
23267,1196428',2018-07-10,FDRL/NATIONAL ELECTRONIC F,6424.0,0.0,,2018,7,10,PAYEMENT,6424.0,M426584880
23268,1196428',2018-07-10,FDRL/NATIONAL ELECTRONIC F,14449.0,0.0,,2018,7,10,CHECK_WITHDRAWAL,14449.0,C448155494
23269,1196428',2018-07-10,FDRL/NATIONAL ELECTRONIC F,26110.0,0.0,,2018,7,10,PAYEMENT,26110.0,M1594302764
23270,1196428',2018-07-10,FDRL/NATIONAL ELECTRONIC F,11184.0,0.0,,2018,7,10,CHECK_WITHDRAWAL,11184.0,M271366306
23271,1196428',2018-07-10,NEFT/N191180582691200/USH,0.0,119500.0,,2018,7,10,CASH_IN,119500.0,C348708793
23272,1196428',2018-07-10,TRF FROM  Indiaforensic SERVICES,0.0,1000000.0,,2018,7,10,CASH_IN,1000000.0,M462659391
23273,1196428',2018-07-10,NEFT/SBIN818191299508/JAI,0.0,100000.0,,2018,7,10,CHECK_CASHING,100000.0,M547825235
23274,1196428',2018-07-10,FDRL/INTERNAL FUND TRANSFE,1000000.0,0.0,,2018,7,10,DEBIT,1000000.0,M1301971459
23275,1196428',2018-07-10,RTGS/PUNBH18191536568/MAN,0.0,400000.0,,2018,7,10,CASH_IN,400000.0,M1155771218
23276,1196428',2018-07-10,NEFT/N191180582843433/BAT,0.0,75000.0,,2018,7,10,CHECK_CASHING,75000.0,M734120998
23277,1196428',2018-07-10,FDRL/INTERNAL FUND TRANSFE,500000.0,0.0,,2018,7,10,DEBIT,500000.0,M1404561012
23278,1196428',2018-07-10,"Indiaforensic USA, INC./USD/6990",0.0,477766.5,,2018,7,10,TRANSFER,477766.5,M1376999853
23279,1196428',2018-07-10,IRTT00701820085,814.99,0.0,,2018,7,10,PAYEMENT,814.99,M255307196
23280,1196428',2018-07-10,CASHDEP/NOIDA/TP,0.0,90000.0,,2018,7,10,CASH_IN,90000.0,M11285367
23281,1196428',2018-07-10,NEFT/N191180582983910/PUB,0.0,15000.0,,2018,7,10,CHECK_CASHING,15000.0,M714914851
23282,1196428',2018-07-10,RTGS/HDFCH18191629233/Indfor,0.0,9600000.0,,2018,7,10,CHECK_CASHING,9600000.0,M1438724935
23283,1196428',2018-07-10,IMPS 819114311058 FROM AS,0.0,100099.0,,2018,7,10,CHECK_CASHING,100099.0,M662472677
23284,1196428',2018-07-10,NEFT/AXISP00002772973/ACC,0.0,3000000.0,,2018,7,10,CASH_IN,3000000.0,M1932384587
23285,1196428',2018-07-10,TRF FROM  Indiaforensic SERVICES,0.0,5000000.0,,2018,7,10,CHECK_CASHING,5000000.0,M719480872
23286,1196428',2018-07-10,TRF FROM  Indiaforensic SERVICES,0.0,5000000.0,,2018,7,10,CHECK_CASHING,5000000.0,M1278136570
23287,1196428',2018-07-10,TRF FROM  Indiaforensic SERVICES,0.0,5000000.0,,2018,7,10,CHECK_CASHING,5000000.0,M148964727
23288,1196428',2018-07-10,TRF FROM  Indiaforensic SERVICES,0.0,3000000.0,,2018,7,10,CHECK_CASHING,3000000.0,M1177742051
23289,1196428',2018-07-10,TRF FROM  Indiaforensic SERVICES,0.0,500000.0,,2018,7,10,TRANSFER,500000.0,M724365571
23290,1196428',2018-07-10,FDRL/REAL TIME GROSS SETTL,10000000.0,0.0,,2018,7,10,CHECK_WITHDRAWAL,10000000.0,M212535805
23291,1196428',2018-07-10,FDRL/REAL TIME GROSS SETTL,15000000.0,0.0,,2018,7,10,DEBIT,15000000.0,M1596397541
23292,1196428',2018-07-10,RTGS/ICICH18191440787/Indfor,0.0,1300000.0,,2018,7,10,CHECK_CASHING,1300000.0,M713285225
23293,1196428',2018-07-10,NEFT/BARBY18191751383/MAK,0.0,50550.0,,2018,7,10,CHECK_CASHING,50550.0,C2032389005
23294,1196428',2018-07-10,FDRL/REAL TIME GROSS SETTL,5000000.0,0.0,,2018,7,10,CHECK_WITHDRAWAL,5000000.0,M1156533869
23295,1196428',2018-07-10,FDRL/REAL TIME GROSS SETTL,1000000.0,0.0,,2018,7,10,DEBIT,1000000.0,M105292474
23296,1196428',2018-07-10,FDRL/REAL TIME GROSS SETTL,1000000.0,0.0,,2018,7,10,DEBIT,1000000.0,M1410438390
23297,1196428',2018-07-10,FDRL/REAL TIME GROSS SETTL,1000000.0,0.0,,2018,7,10,CASH_OUT,1000000.0,M1257755465
23298,1196428',2018-07-10,RTGS/ICICH18191440252/Indfor,0.0,500000.0,,2018,7,10,TRANSFER,500000.0,M1640401120
23299,1196428',2018-07-10,RTGS/ICICH18191439886/Indfor,0.0,500000.0,,2018,7,10,CASH_IN,500000.0,M1399060771
23300,1196428',2018-07-10,TRF FROM  Indiaforensic SERVICES,0.0,400000.0,,2018,7,10,TRANSFER,400000.0,C1262822392
23301,1196428',2018-07-10,TRF FROM  Indiaforensic SERVICES,0.0,7700000.0,,2018,7,10,CASH_IN,7700000.0,M148589770
23302,1196428',2018-07-10,TRF FROM  Indiaforensic SERVICES,0.0,500000.0,,2018,7,10,CASH_IN,500000.0,M984489239
23303,1196428',2018-07-10,FDRL/INTERNAL FUND TRANSFE,1000000.0,0.0,,2018,7,10,CASH_OUT,1000000.0,C2115055717
23304,1196428',2018-07-10,FDRL/INTERNAL FUND TRANSFE,500000.0,0.0,,2018,7,10,PAYEMENT,500000.0,C1166654566
23305,1196428',2018-07-10,FDRL/INTERNAL FUND TRANSFE,500000.0,0.0,,2018,7,10,CASH_OUT,500000.0,M88042020
23306,1196428',2018-07-10,BEAT CSH PKP DEL GURG 620,0.0,217500.0,,2018,7,10,CASH_IN,217500.0,M717278894
23307,1196428',2018-07-10,NEFT/AXISP00002870628/ACC,0.0,1000000.0,,2018,7,10,TRANSFER,1000000.0,M129220812
23308,1196428',2018-07-11,CASHDEP/NOIDA/TP,0.0,106000.0,,2018,7,11,CASH_IN,106000.0,M1015272304
23309,1196428',2018-07-11,RTGS/SBINH18192005374/Indfor,0.0,1500000.0,,2018,7,11,CASH_IN,1500000.0,C1007717381
23310,1196428',2018-07-11,FDRL/REAL TIME GROSS SETTL,10571493.32,0.0,,2018,7,11,CASH_OUT,10571493.32,C1240091493
23311,1196428',2018-07-11,Indiaforensic USA INC/USD/15056/,0.0,1031336.0,,2018,7,11,TRANSFER,1031336.0,C1396297158
23312,1196428',2018-07-11,IRTT00701820169,1290.64,0.0,,2018,7,11,CHECK_WITHDRAWAL,1290.64,M705803524
23313,1196428',2018-07-11,RTGS/HDFCH18192763951/JUN,0.0,200000.0,,2018,7,11,CHECK_CASHING,200000.0,C978740207
23314,1196428',2018-07-11,CHQ DEP/521347/OWDEL1/ORB,0.0,11800.0,,2018,7,11,CHECK_CASHING,11800.0,C115885991
23315,1196428',2018-07-11,CHQ DEP/643649/OWDEL1/PUN,0.0,11800.0,,2018,7,11,CHECK_CASHING,11800.0,C587433505
23316,1196428',2018-07-11,NEFT/P18071165925121/M/S,0.0,30000.0,,2018,7,11,CASH_IN,30000.0,C1637186972
23317,1196428',2018-07-11,FDRL/INTERNAL FUND TRANSFE,500000.0,0.0,,2018,7,11,DEBIT,500000.0,M190739308
23318,1196428',2018-07-11,NEFT/SBIN918192416092/HAR,0.0,37000.0,,2018,7,11,CASH_IN,37000.0,C778306577
23319,1196428',2018-07-11,NEFT/N192180584009736/USH,0.0,20920.0,,2018,7,11,CHECK_CASHING,20920.0,M1863711975
23320,1196428',2018-07-11,NEFT/SBIN918192434463/NAR,0.0,51273.0,,2018,7,11,CASH_IN,51273.0,M1469855297
23321,1196428',2018-07-11,FDRL/INTERNAL FUND TRANSFE,1000000.0,0.0,,2018,7,11,CASH_OUT,1000000.0,M794421806
23322,1196428',2018-07-11,RTGS/PUNBH18192557332/PUN,0.0,500000.0,,2018,7,11,CASH_IN,500000.0,M1334051844
23323,1196428',2018-07-11,TRF FROM  Indiaforensic SERVICES,0.0,15000000.0,,2018,7,11,CASH_IN,15000000.0,M515450283
23324,1196428',2018-07-11,TRF FROM  Indiaforensic SERVICES,0.0,5600000.0,,2018,7,11,CHECK_CASHING,5600000.0,M1747790771
23325,1196428',2018-07-11,FDRL/REAL TIME GROSS SETTL,10000000.0,0.0,,2018,7,11,PAYEMENT,10000000.0,M1284135884
23326,1196428',2018-07-11,FDRL/REAL TIME GROSS SETTL,10000000.0,0.0,,2018,7,11,DEBIT,10000000.0,C420561530
23327,1196428',2018-07-11,NEFT/SBIN918192455562/M s,0.0,11800.0,,2018,7,11,TRANSFER,11800.0,M694158341
23328,1196428',2018-07-11,NEFT/N192180584071717/PUB,0.0,20000.0,,2018,7,11,CASH_IN,20000.0,C2046578329
23329,1196428',2018-07-11,FDRL/REAL TIME GROSS SETTL,1000000.0,0.0,,2018,7,11,CHECK_WITHDRAWAL,1000000.0,M942812964
23330,1196428',2018-07-11,Indiaforensic SERVICES INDIA PVT,0.0,216217.0,,2018,7,11,TRANSFER,216217.0,M1977844832
23331,1196428',2018-07-11,RTGS/HDFCH18192822909/Indfor,0.0,6400000.0,,2018,7,11,TRANSFER,6400000.0,M1171276229
23332,1196428',2018-07-11,RTGS/ICICH18192560668/Indfor,0.0,1900000.0,,2018,7,11,TRANSFER,1900000.0,M1741253456
23333,1196428',2018-07-11,NEFT/AXISP00002973055/ACC,0.0,2000000.0,,2018,7,11,CHECK_CASHING,2000000.0,M1549630173
23334,1196428',2018-07-11,IMPS 819215352529 FROM AS,0.0,85085.0,,2018,7,11,CHECK_CASHING,85085.0,C1548218207
23335,1196428',2018-07-11,RTGS/ICICH18192563078/Indfor,0.0,500000.0,,2018,7,11,CHECK_CASHING,500000.0,C242559404
23336,1196428',2018-07-11,NEFT/SBIN918192713102/TAR,0.0,195000.0,,2018,7,11,TRANSFER,195000.0,C1153596299
23337,1196428',2018-07-11,FDRL/NATIONAL ELECTRONIC F,1000000.0,0.0,,2018,7,11,CHECK_WITHDRAWAL,1000000.0,M708011911
23338,1196428',2018-07-11,FDRL/NATIONAL ELECTRONIC F,1000000.0,0.0,,2018,7,11,PAYEMENT,1000000.0,M1579526490
23339,1196428',2018-07-11,IMPS 819216997172 FROM SA,0.0,50000.0,,2018,7,11,TRANSFER,50000.0,C1924874046
23340,1196428',2018-07-11,FDRL/NATIONAL ELECTRONIC F,28859.0,0.0,,2018,7,11,PAYEMENT,28859.0,C1079343872
23341,1196428',2018-07-11,FDRL/NATIONAL ELECTRONIC F,18552.0,0.0,,2018,7,11,CHECK_WITHDRAWAL,18552.0,M1025387324
23342,1196428',2018-07-11,FDRL/NATIONAL ELECTRONIC F,27360.0,0.0,,2018,7,11,PAYEMENT,27360.0,M2114990234
23343,1196428',2018-07-11,CASHDEP/GHATKOPAR/,0.0,116000.0,,2018,7,11,CASH_IN,116000.0,M1843420945
23344,1196428',2018-07-11,NEFT/P18071177225197/GUPT,0.0,11800.0,,2018,7,11,TRANSFER,11800.0,C863811613
23345,1196428',2018-07-11,FDRL/INTERNAL FUND TRANSFE,4000000.0,0.0,,2018,7,11,DEBIT,4000000.0,M1539382844
23346,1196428',2018-07-11,FDRL/INTERNAL FUND TRANSFE,500000.0,0.0,,2018,7,11,CASH_OUT,500000.0,M1846768700
23347,1196428',2018-07-11,FDRL/INTERNAL FUND TRANSFE,5000000.0,0.0,,2018,7,11,PAYEMENT,5000000.0,C1640747200
23348,1196428',2018-07-11,TRF TO  Indiaforensic SERVICES I,70000.0,0.0,,2018,7,11,CASH_OUT,70000.0,M1099038981
23349,1196428',2018-07-11,CHQ DEPOSIT RETURN/521347,11800.0,0.0,,2018,7,11,DEBIT,11800.0,C344610846
23350,1196428',2018-07-11,NEFT/000048742723/Indiaforensic,0.0,500000.0,,2018,7,11,CHECK_CASHING,500000.0,C1919277981
23351,1196428',2018-07-11,IMPS 819218307836 FROM SA,0.0,200000.0,,2018,7,11,CHECK_CASHING,200000.0,C2104652067
23352,1196428',2018-07-11,BEAT CSH PKP DEL GURG 620,0.0,305500.0,,2018,7,11,CASH_IN,305500.0,C1092465037
23353,1196428',2018-07-12,RTGS/SBINH18193003375/Indfor,0.0,5100000.0,,2018,7,12,CASH_IN,5100000.0,M995633719
23354,1196428',2018-07-12,FDRL/INTERNAL FUND TRANSFE,0.0,3000000.0,,2018,7,12,CHECK_CASHING,3000000.0,M938465080
23355,1196428',2018-07-12,FDRL/REAL TIME GROSS SETTL,8914928.81,0.0,,2018,7,12,CASH_OUT,8914928.81,M1834981639
23356,1196428',2018-07-12,CASHDEP/NOIDA/TP,0.0,140000.0,,2018,7,12,CASH_IN,140000.0,M1775303360
23357,1196428',2018-07-12,RTGS/HDFCH18193882850/BAT,0.0,300000.0,,2018,7,12,TRANSFER,300000.0,M261084274
23358,1196428',2018-07-12,NEFT/SBIN118193183727/SRI,0.0,100000.0,,2018,7,12,CASH_IN,100000.0,M1007295516
23359,1196428',2018-07-12,Indiaforensic SERVICES INDIA PVT,0.0,185143.0,,2018,7,12,CASH_IN,185143.0,M470234716
23360,1196428',2018-07-12,NEFT/SBIN118193242091/NAR,0.0,52873.0,,2018,7,12,CASH_IN,52873.0,M905290562
23361,1196428',2018-07-12,NEFT/PUNBH18193528604/RAT,0.0,22000.0,,2018,7,12,CASH_IN,22000.0,M798935213
23362,1196428',2018-07-12,CHQ DEP/62160/OWDEL1/SBIN,0.0,11800.0,,2018,7,12,TRANSFER,11800.0,M1932154134
23363,1196428',2018-07-12,CHQ DEP/652962/OWDEL1/PUN,0.0,11800.0,,2018,7,12,TRANSFER,11800.0,M1426777731
23364,1196428',2018-07-12,CHQ DEP/60261/OWDEL1/UTIB,0.0,11800.0,,2018,7,12,CASH_IN,11800.0,M2001931511
23365,1196428',2018-07-12,CHQ DEP/958756/OWDEL1/PUN,0.0,11800.0,,2018,7,12,CASH_IN,11800.0,M1028639221
23366,1196428',2018-07-12,CHQ DEP/572798/OWDEL1/SBI,0.0,11800.0,,2018,7,12,CHECK_CASHING,11800.0,M129965176
23367,1196428',2018-07-12,CHQ DEP/287/OWDEL1/ORBC/M,0.0,11800.0,,2018,7,12,TRANSFER,11800.0,M1666930496
23368,1196428',2018-07-12,CHQ DEP/26/OWDEL1/BARB/CH,0.0,11800.0,,2018,7,12,CHECK_CASHING,11800.0,M1348049534
23369,1196428',2018-07-12,CHQ DEP/650/OWDEL1/BARB/C,0.0,11800.0,,2018,7,12,CASH_IN,11800.0,M149861385
23370,1196428',2018-07-12,CHQ DEP/34783/OWDEL1/BKID,0.0,11800.0,,2018,7,12,CASH_IN,11800.0,M1803845616
23371,1196428',2018-07-12,CHQ DEP/502684/OWDEL1/PUN,0.0,11800.0,,2018,7,12,CASH_IN,11800.0,M396463835
23372,1196428',2018-07-12,CHQ DEP/301/OWDEL1/HDFC/A,0.0,8260.0,,2018,7,12,CASH_IN,8260.0,M1022045468
23373,1196428',2018-07-12,CHQ DEP/614702/OWDEL1/KAR,0.0,11800.0,,2018,7,12,TRANSFER,11800.0,M1556446144
23374,1196428',2018-07-12,RTGS/SBINH18193024348/SRI,0.0,300000.0,,2018,7,12,TRANSFER,300000.0,M141959252
23375,1196428',2018-07-12,FDRL/NATIONAL ELECTRONIC F,305445.0,0.0,,2018,7,12,PAYEMENT,305445.0,M1997459283
23376,1196428',2018-07-12,FDRL/NATIONAL ELECTRONIC F,328582.0,0.0,,2018,7,12,PAYEMENT,328582.0,M539292855
23377,1196428',2018-07-12,FDRL/NATIONAL ELECTRONIC F,70000.0,0.0,,2018,7,12,CASH_OUT,70000.0,M878266233
23378,1196428',2018-07-12,NEFT/AXISP00003069399/ACC,0.0,2000000.0,,2018,7,12,CHECK_CASHING,2000000.0,M1660780699
23379,1196428',2018-07-12,IMPS 819314306581 FROM AS,0.0,100070.0,,2018,7,12,CASH_IN,100070.0,M1242431450
23380,1196428',2018-07-12,NEFT/SBIN118193448667/HAR,0.0,49000.0,,2018,7,12,TRANSFER,49000.0,M2075133206
23381,1196428',2018-07-12,NEFT/P18071266375341/M/S,0.0,30000.0,,2018,7,12,CASH_IN,30000.0,M1651383848
23382,1196428',2018-07-12,IMPS 819314172752 FROM SA,0.0,10000.0,,2018,7,12,CHECK_CASHING,10000.0,M1364290623
23383,1196428',2018-07-12,FDRL/INTERNAL FUND TRANSFE,500000.0,0.0,,2018,7,12,PAYEMENT,500000.0,M1119145556
23384,1196428',2018-07-12,TRF FROM  Indiaforensic SERVICES,0.0,15000000.0,,2018,7,12,TRANSFER,15000000.0,M552762676
23385,1196428',2018-07-12,TRF FROM  Indiaforensic SERVICES,0.0,4000000.0,,2018,7,12,CASH_IN,4000000.0,M1549335447
23386,1196428',2018-07-12,FDRL/REAL TIME GROSS SETTL,15000000.0,0.0,,2018,7,12,CASH_OUT,15000000.0,M1407332998
23387,1196428',2018-07-12,FDRL/REAL TIME GROSS SETTL,5000000.0,0.0,,2018,7,12,CHECK_WITHDRAWAL,5000000.0,M575173490
23388,1196428',2018-07-12,FDRL/INTERNAL FUND TRANSFE,1000000.0,0.0,,2018,7,12,CHECK_WITHDRAWAL,1000000.0,M1463959599
23389,1196428',2018-07-12,CHQ DEPOSIT RETURN/958756,11800.0,0.0,,2018,7,12,PAYEMENT,11800.0,C191614132
23390,1196428',2018-07-12,CHQ DEPOSIT RETURN/650/EX,11800.0,0.0,,2018,7,12,CASH_OUT,11800.0,C1885712019
23391,1196428',2018-07-12,NEFT/SBIN118193602053/MS,0.0,100000.0,,2018,7,12,TRANSFER,100000.0,M1406881784
23392,1196428',2018-07-12,RTGS/HDFCH18193982734/Indfor,0.0,6700000.0,,2018,7,12,CHECK_CASHING,6700000.0,C1161865950
23393,1196428',2018-07-12,NEFT/SBIN118193657015/SHR,0.0,100000.0,,2018,7,12,CASH_IN,100000.0,M1558051277
23394,1196428',2018-07-12,NEFT/000048794966/Indiaforensic,0.0,2500000.0,,2018,7,12,CHECK_CASHING,2500000.0,M1173085824
23395,1196428',2018-07-12,NEFT/SBIN118193693937/MS,0.0,50000.0,,2018,7,12,TRANSFER,50000.0,M569018137
23396,1196428',2018-07-12,FBGI01001500077:Bank Guar,4168.8,0.0,,2018,7,12,CASH_OUT,4168.8,M1770271962
23397,1196428',2018-07-12,PBGI01001500089:Bank Guar,4168.8,0.0,,2018,7,12,PAYEMENT,4168.8,M1586738337
23398,1196428',2018-07-12,NEFT/SBIN118193779867/M S,0.0,10000.0,,2018,7,12,CASH_IN,10000.0,M1674738101
23399,1196428',2018-07-12,FDRL/INTERNAL FUND TRANSFE,500000.0,0.0,,2018,7,12,DEBIT,500000.0,C1590550415
23400,1196428',2018-07-12,FDRL/NXTXN_PAYMENT,0.0,73707.0,,2018,7,12,TRANSFER,73707.0,C705321061
23401,1196428',2018-07-12,FDRL/IndforSECURE_PAYMENT,0.0,20800.0,,2018,7,12,CASH_IN,20800.0,M873689156
23402,1196428',2018-07-12,FDRL/INTERNAL FUND TRANSFE,500000.0,0.0,,2018,7,12,CHECK_WITHDRAWAL,500000.0,M1538317866
23403,1196428',2018-07-12,FDRL/INTERNAL FUND TRANSFE,4000000.0,0.0,,2018,7,12,CHECK_WITHDRAWAL,4000000.0,C262828207
23404,1196428',2018-07-12,FDRL/INTERNAL FUND TRANSFE,5000000.0,0.0,,2018,7,12,CASH_OUT,5000000.0,C1222590577
23405,1196428',2018-07-12,TRF FROM  Indiaforensic SERVICES,0.0,100000.0,,2018,7,12,CHECK_CASHING,100000.0,M2089852906
23406,1196428',2018-07-12,TRF FROM  Indiaforensic SERVICES,0.0,100000.0,,2018,7,12,CASH_IN,100000.0,M629502621
23407,1196428',2018-07-12,TRF FROM  Indiaforensic SERVICES,0.0,4500000.0,,2018,7,12,TRANSFER,4500000.0,M511596806
23408,1196428',2018-07-12,PBGI01001800164:Bank Guar,11800.0,0.0,,2018,7,12,PAYEMENT,11800.0,M2079635991
23409,1196428',2018-07-12,BEAT CSH PKP DEL UDYOG 62,0.0,211000.0,,2018,7,12,CASH_IN,211000.0,M1044456366
23410,1196428',2018-07-12,TRF FROM  Indiaforensic SERVICES,0.0,2000000.0,,2018,7,12,TRANSFER,2000000.0,C1689840534
23411,1196428',2018-07-12,FDRL/INTERNAL FUND TRANSFE,5000000.0,0.0,,2018,7,12,CHECK_WITHDRAWAL,5000000.0,M1092817314
23412,1196428',2018-07-12,FDRL/INTERNAL FUND TRANSFE,500000.0,0.0,,2018,7,12,DEBIT,500000.0,C1475909248
23413,1196428',2018-07-12,FDRL/INTERNAL FUND TRANSFE,500000.0,0.0,,2018,7,12,PAYEMENT,500000.0,M2040472550
23414,1196428',2018-07-12,CHQ DEPOSIT RETURN/958756,100.0,0.0,,2018,7,12,CASH_OUT,100.0,C979719862
23415,1196428',2018-07-12,CHQ DEPOSIT RETURN/958756,18.0,0.0,,2018,7,12,DEBIT,18.0,C985934102
23416,1196428',2018-07-12,CHQ DEPOSIT RETURN/650/CH,100.0,0.0,,2018,7,12,DEBIT,100.0,C731253803
23417,1196428',2018-07-12,CHQ DEPOSIT RETURN/650/GS,18.0,0.0,,2018,7,12,PAYEMENT,18.0,C1609562230
23418,1196428',2018-07-13,CASHDEP/NOIDA/TP,0.0,202000.0,,2018,7,13,CASH_IN,202000.0,M1076923640
23419,1196428',2018-07-13,RTGS/HDFCH18194033789/BAT,0.0,200000.0,,2018,7,13,CASH_IN,200000.0,M1144262832
23420,1196428',2018-07-13,RTGS/SBINH18194014646/Indfor,0.0,6100000.0,,2018,7,13,CHECK_CASHING,6100000.0,M942922351
23421,1196428',2018-07-13,FDRL/INTERNAL FUND TRANSFE,0.0,1000000.0,,2018,7,13,CHECK_CASHING,1000000.0,M1582038853
23422,1196428',2018-07-13,FDRL/REAL TIME GROSS SETTL,7897589.78,0.0,,2018,7,13,PAYEMENT,7897589.78,M36034212
23423,1196428',2018-07-13,RTGS/SBINH18194024611/Indfor,0.0,500000.0,,2018,7,13,TRANSFER,500000.0,M1326356346
23424,1196428',2018-07-13,FDRL/INTERNAL FUND TRANSFE,400000.0,0.0,,2018,7,13,CASH_OUT,400000.0,C27489818
23425,1196428',2018-07-13,FDRL/INTERNAL FUND TRANSFE,400000.0,0.0,,2018,7,13,CASH_OUT,400000.0,C747979499
23426,1196428',2018-07-13,FDRL/INTERNAL FUND TRANSFE,200000.0,0.0,,2018,7,13,CHECK_WITHDRAWAL,200000.0,C1660095722
23427,1196428',2018-07-13,NEFT/SBIN218194434097/ANN,0.0,11800.0,,2018,7,13,CASH_IN,11800.0,C372017580
23428,1196428',2018-07-13,IMPS 819413367206 FROM AS,0.0,60065.0,,2018,7,13,TRANSFER,60065.0,M370179552
23429,1196428',2018-07-13,NEFT/N194180585718862/PUB,0.0,20000.0,,2018,7,13,TRANSFER,20000.0,C802935635
23430,1196428',2018-07-13,RTGS/PSIBH18194954267/SAI,0.0,280000.0,,2018,7,13,CHECK_CASHING,280000.0,M1523086740
23431,1196428',2018-07-13,TRF FROM  Indiaforensic SERVICES,0.0,15000000.0,,2018,7,13,CHECK_CASHING,15000000.0,M902885640
23432,1196428',2018-07-13,TRF FROM  Indiaforensic SERVICES,0.0,2300000.0,,2018,7,13,TRANSFER,2300000.0,C459172227
23433,1196428',2018-07-13,FDRL/REAL TIME GROSS SETTL,15000000.0,0.0,,2018,7,13,PAYEMENT,15000000.0,C265108079
23434,1196428',2018-07-13,FDRL/REAL TIME GROSS SETTL,1000000.0,0.0,,2018,7,13,DEBIT,1000000.0,C35126588
23435,1196428',2018-07-13,FDRL/REAL TIME GROSS SETTL,1000000.0,0.0,,2018,7,13,DEBIT,1000000.0,C1589477624
23436,1196428',2018-07-13,CHQ DEP/562058/OWDEL1/SYN,0.0,11800.0,,2018,7,13,CHECK_CASHING,11800.0,C1283595719
23437,1196428',2018-07-13,NEFT/PUNBH18194785799/SAI,0.0,55000.0,,2018,7,13,CASH_IN,55000.0,C101084405
23438,1196428',2018-07-13,NEFT/AXISP00003215758/ACC,0.0,15000000.0,,2018,7,13,CHECK_CASHING,15000000.0,M7891579
23439,1196428',2018-07-13,RTGS/ICICH18194788847/ART,0.0,5000000.0,,2018,7,13,CASH_IN,5000000.0,M150228660
23440,1196428',2018-07-13,FDRL/REAL TIME GROSS SETTL,15000000.0,0.0,,2018,7,13,CHECK_WITHDRAWAL,15000000.0,M190019040
23441,1196428',2018-07-13,FDRL/INTERNAL FUND TRANSFE,500000.0,0.0,,2018,7,13,DEBIT,500000.0,M1462909495
23442,1196428',2018-07-13,FDRL/INTERNAL FUND TRANSFE,500000.0,0.0,,2018,7,13,CHECK_WITHDRAWAL,500000.0,C1192983708
23443,1196428',2018-07-13,FDRL/INTERNAL FUND TRANSFE,200000.0,0.0,,2018,7,13,CASH_OUT,200000.0,M1730398598
23444,1196428',2018-07-13,FDRL/INTERNAL FUND TRANSFE,3000000.0,0.0,,2018,7,13,DEBIT,3000000.0,M1492635498
23445,1196428',2018-07-13,NEFT/SBIN218194596837/NAR,0.0,52973.0,,2018,7,13,CASH_IN,52973.0,M738483886
23446,1196428',2018-07-13,NEFT/P18071379559533/M/S,0.0,11800.0,,2018,7,13,TRANSFER,11800.0,M1583014678
23447,1196428',2018-07-13,Indiaforensic SERVICES INDIA PVT,0.0,175287.0,,2018,7,13,CHECK_CASHING,175287.0,C395114097
23448,1196428',2018-07-13,NEFT/PUNBH18194837947/BAL,0.0,75000.0,,2018,7,13,CHECK_CASHING,75000.0,M743943553
23449,1196428',2018-07-13,RTGS/HDFCH18194144338/Indfor,0.0,7300000.0,,2018,7,13,CASH_IN,7300000.0,M2034445578
23450,1196428',2018-07-13,Indiaforensic SERVICES INDIA PVT,0.0,209650.0,,2018,7,13,CASH_IN,209650.0,C1383942363
23451,1196428',2018-07-13,FDRL/INTERNAL FUND TRANSFE,300000.0,0.0,,2018,7,13,PAYEMENT,300000.0,M72285092
23452,1196428',2018-07-13,FDRL/NATIONAL ELECTRONIC F,16204.0,0.0,,2018,7,13,PAYEMENT,16204.0,M586185216
23453,1196428',2018-07-13,FDRL/INTERNAL FUND TRANSFE,1000000.0,0.0,,2018,7,13,PAYEMENT,1000000.0,M1378755468
23454,1196428',2018-07-13,NEFT/N194180586100815/TEC,0.0,300000.0,,2018,7,13,CHECK_CASHING,300000.0,C765980478
23455,1196428',2018-07-13,FDRL/INTERNAL FUND TRANSFE,4000000.0,0.0,,2018,7,13,DEBIT,4000000.0,C1200314947
23456,1196428',2018-07-13,FDRL/INTERNAL FUND TRANSFE,4000000.0,0.0,,2018,7,13,PAYEMENT,4000000.0,C1973491942
23457,1196428',2018-07-13,IMPS 819418167759 FROM PU,0.0,35000.0,,2018,7,13,CHECK_CASHING,35000.0,C1689374891
23458,1196428',2018-07-13,FDRL/INTERNAL FUND TRANSFE,500000.0,0.0,,2018,7,13,CHECK_WITHDRAWAL,500000.0,C2053639017
23459,1196428',2018-07-13,BEAT CSH PKP DEL UDYOG 62,0.0,156500.0,,2018,7,13,CHECK_CASHING,156500.0,C1654056127
23460,1196428',2018-07-14,IMPS 819516383482 FROM AS,0.0,70070.0,,2018,7,14,CHECK_CASHING,70070.0,C803368825
23461,1196428',2018-07-16,NEFT/SBIN318197194113/M S,0.0,150000.0,,2018,7,16,TRANSFER,150000.0,C892686452
23462,1196428',2018-07-16,NEFT/SBIN318197221603/NAR,0.0,52738.0,,2018,7,16,TRANSFER,52738.0,C2031563133
23463,1196428',2018-07-16,RTGS/HDFCH18197193727/Indfor,0.0,1000000.0,,2018,7,16,TRANSFER,1000000.0,C1619402333
23464,1196428',2018-07-16,RTGS/HDFCH18197208604/BAT,0.0,200000.0,,2018,7,16,TRANSFER,200000.0,C1149273771
23465,1196428',2018-07-16,CASHDEP/NOIDA/TP,0.0,213000.0,,2018,7,16,CASH_IN,213000.0,C2109470512
23466,1196428',2018-07-16,RTGS/PUNBH18197604962/MAN,0.0,400000.0,,2018,7,16,CHECK_CASHING,400000.0,C1059781259
23467,1196428',2018-07-16,RTGS/SBINH18197009904/Indfor,0.0,14600000.0,,2018,7,16,TRANSFER,14600000.0,C125722707
23468,1196428',2018-07-16,FDRL/REAL TIME GROSS SETTL,6877879.09,0.0,,2018,7,16,CASH_OUT,6877879.09,C1778300121
23469,1196428',2018-07-16,FDRL/REAL TIME GROSS SETTL,4596267.73,0.0,,2018,7,16,PAYEMENT,4596267.73,C313124964
23470,1196428',2018-07-16,FDRL/NATIONAL ELECTRONIC F,35250.0,0.0,,2018,7,16,CASH_OUT,35250.0,C1220897602
23471,1196428',2018-07-16,FDRL/REAL TIME GROSS SETTL,3499100.21,0.0,,2018,7,16,DEBIT,3499100.21,C1515704208
23472,1196428',2018-07-16,TRF FROM  Indiaforensic SERVICES,0.0,5000000.0,,2018,7,16,CASH_IN,5000000.0,C1313534832
23473,1196428',2018-07-16,RTGS/PUNBH18197609633/PUN,0.0,500000.0,,2018,7,16,TRANSFER,500000.0,C1141137903
23474,1196428',2018-07-16,TRF FROM  Indiaforensic SERVICES,0.0,1000000.0,,2018,7,16,CASH_IN,1000000.0,C1869228744
23475,1196428',2018-07-16,TRF FROM  Indiaforensic SERVICES,0.0,1000000.0,,2018,7,16,CASH_IN,1000000.0,C2078250226
23476,1196428',2018-07-16,NEFT/PUNBH18197963559/BAL,0.0,100000.0,,2018,7,16,TRANSFER,100000.0,C1300519073
23477,1196428',2018-07-16,NEFT/N197180586809753/USH,0.0,155850.0,,2018,7,16,TRANSFER,155850.0,M1808484670
23478,1196428',2018-07-16,FDRL/REAL TIME GROSS SETTL,1000000.0,0.0,,2018,7,16,DEBIT,1000000.0,M829035073
23479,1196428',2018-07-16,FDRL/REAL TIME GROSS SETTL,1000000.0,0.0,,2018,7,16,PAYEMENT,1000000.0,M1674174327
23480,1196428',2018-07-16,FDRL/REAL TIME GROSS SETTL,5000000.0,0.0,,2018,7,16,PAYEMENT,5000000.0,M2135203084
23481,1196428',2018-07-16,FDRL/REAL TIME GROSS SETTL,1000000.0,0.0,,2018,7,16,PAYEMENT,1000000.0,C1673971173
23482,1196428',2018-07-16,FDRL/REAL TIME GROSS SETTL,1000000.0,0.0,,2018,7,16,CASH_OUT,1000000.0,C339099861
23483,1196428',2018-07-16,FDRL/INTERNAL FUND TRANSFE,500000.0,0.0,,2018,7,16,CHECK_WITHDRAWAL,500000.0,M2045422556
23484,1196428',2018-07-16,IMPS 819715399573 FROM PU,0.0,10000.0,,2018,7,16,CHECK_CASHING,10000.0,C1266035080
23485,1196428',2018-07-16,FDRL/NATIONAL ELECTRONIC F,23890.0,0.0,,2018,7,16,DEBIT,23890.0,C1060041730
23486,1196428',2018-07-16,FDRL/NATIONAL ELECTRONIC F,16639.0,0.0,,2018,7,16,CHECK_WITHDRAWAL,16639.0,C1475395523
23487,1196428',2018-07-16,FDRL/NATIONAL ELECTRONIC F,19967.0,0.0,,2018,7,16,PAYEMENT,19967.0,C265845794
23488,1196428',2018-07-16,FDRL/NATIONAL ELECTRONIC F,12368.0,0.0,,2018,7,16,DEBIT,12368.0,C58091972
23489,1196428',2018-07-16,RTGS/HDFCH18197341476/Indfor,0.0,7000000.0,,2018,7,16,CASH_IN,7000000.0,C193864812
23490,1196428',2018-07-16,FDRL/REAL TIME GROSS SETTL,5000000.0,0.0,,2018,7,16,CHECK_WITHDRAWAL,5000000.0,C681835572
23491,1196428',2018-07-16,NEFT/P18071667202204/M/S,0.0,25000.0,,2018,7,16,CASH_IN,25000.0,C965197768
23492,1196428',2018-07-16,NEFT/SBIN318197504395/SAN,0.0,11800.0,,2018,7,16,CHECK_CASHING,11800.0,C893038039
23493,1196428',2018-07-16,NEFT/IOBAN18197663398/MAA,0.0,11800.0,,2018,7,16,CHECK_CASHING,11800.0,C1317731757
23494,1196428',2018-07-16,TRF FROM  Indiaforensic SERVICES,0.0,15000000.0,,2018,7,16,TRANSFER,15000000.0,C1373467808
23495,1196428',2018-07-16,"Indiaforensic USA, INC./USD/1268",0.0,865614.75,,2018,7,16,CHECK_CASHING,865614.75,C1318822808
23496,1196428',2018-07-16,IRTT00701820570,1164.05,0.0,,2018,7,16,CASH_OUT,1164.05,C1424731356
23497,1196428',2018-07-16,TRF FROM  Indiaforensic SERVICES,0.0,15000000.0,,2018,7,16,TRANSFER,15000000.0,C1439007204
23498,1196428',2018-07-16,TRF FROM  Indiaforensic SERVICES,0.0,15000000.0,,2018,7,16,CASH_IN,15000000.0,C1116292004
23499,1196428',2018-07-16,TRF FROM  Indiaforensic SERVICES,0.0,2000000.0,,2018,7,16,CHECK_CASHING,2000000.0,C638551812
23500,1196428',2018-07-16,NEFT/PNBH181977722745/Anu,0.0,16639.0,,2018,7,16,TRANSFER,16639.0,C193826743
23501,1196428',2018-07-16,FDRL/NATIONAL ELECTRONIC F,5000000.0,0.0,,2018,7,16,PAYEMENT,5000000.0,C309167705
23502,1196428',2018-07-16,FDRL/NATIONAL ELECTRONIC F,5000000.0,0.0,,2018,7,16,DEBIT,5000000.0,C811597470
23503,1196428',2018-07-16,FDRL/NATIONAL ELECTRONIC F,5000000.0,0.0,,2018,7,16,CASH_OUT,5000000.0,C1014923261
23504,1196428',2018-07-16,FDRL/NATIONAL ELECTRONIC F,5000000.0,0.0,,2018,7,16,CHECK_WITHDRAWAL,5000000.0,C925574515
23505,1196428',2018-07-16,FDRL/NATIONAL ELECTRONIC F,5000000.0,0.0,,2018,7,16,CHECK_WITHDRAWAL,5000000.0,C1988152146
23506,1196428',2018-07-16,FDRL/NATIONAL ELECTRONIC F,5000000.0,0.0,,2018,7,16,CASH_OUT,5000000.0,C71555810
23507,1196428',2018-07-16,FDRL/NATIONAL ELECTRONIC F,5000000.0,0.0,,2018,7,16,CASH_OUT,5000000.0,C1273939873
23508,1196428',2018-07-16,FDRL/NATIONAL ELECTRONIC F,5000000.0,0.0,,2018,7,16,CASH_OUT,5000000.0,C749672494
23509,1196428',2018-07-16,FDRL/NATIONAL ELECTRONIC F,5000000.0,0.0,,2018,7,16,CASH_OUT,5000000.0,C1504109395
23510,1196428',2018-07-16,FDRL/INTERNAL FUND TRANSFE,500000.0,0.0,,2018,7,16,CHECK_WITHDRAWAL,500000.0,C2107268831
23511,1196428',2018-07-16,NEFT/SBIN318197807646/CHA,0.0,11800.0,,2018,7,16,TRANSFER,11800.0,C1141137903
23512,1196428',2018-07-16,TRF FROM  Indiaforensic SERVICES,0.0,15000000.0,,2018,7,16,TRANSFER,15000000.0,M492166970
23513,1196428',2018-07-16,TRF FROM  Indiaforensic SERVICES,0.0,1000000.0,,2018,7,16,CASH_IN,1000000.0,C762570948
23514,1196428',2018-07-16,TRF FROM  Indiaforensic SERVICES,0.0,800000.0,,2018,7,16,CASH_IN,800000.0,C1440282299
23515,1196428',2018-07-16,BEAT CSH PKP DEL UDYOG 62,0.0,438500.0,,2018,7,16,CHECK_CASHING,438500.0,M1583639547
23516,1196428',2018-07-16,NEFT/SBIN318197876297/JAI,0.0,123456.0,,2018,7,16,TRANSFER,123456.0,M1476691574
23517,1196428',2018-07-16,NEFT/000048965859/Indiaforensic,0.0,1700000.0,,2018,7,16,TRANSFER,1700000.0,C893339434
23518,1196428',2018-07-16,NEFT/000048966040/Indiaforensic,0.0,2900000.0,,2018,7,16,TRANSFER,2900000.0,M722806861
23519,1196428',2018-07-17,FDRL/INTERNAL FUND TRANSFE,500000.0,0.0,,2018,7,17,PAYEMENT,500000.0,C1150610696
23520,1196428',2018-07-17,FDRL/INTERNAL FUND TRANSFE,500000.0,0.0,,2018,7,17,DEBIT,500000.0,C1674899618
23521,1196428',2018-07-17,FDRL/INTERNAL FUND TRANSFE,200000.0,0.0,,2018,7,17,DEBIT,200000.0,M481126602
23522,1196428',2018-07-17,FDRL/INTERNAL FUND TRANSFE,500000.0,0.0,,2018,7,17,CHECK_WITHDRAWAL,500000.0,C1793325972
23523,1196428',2018-07-17,IMPS 819810382802 FROM AS,0.0,99099.0,,2018,7,17,CHECK_CASHING,99099.0,M132360639
23524,1196428',2018-07-17,FDRL/REAL TIME GROSS SETTL,15000000.0,0.0,,2018,7,17,PAYEMENT,15000000.0,M2052092920
23525,1196428',2018-07-17,FDRL/REAL TIME GROSS SETTL,5020437.69,0.0,,2018,7,17,DEBIT,5020437.69,M236650472
23526,1196428',2018-07-17,FDRL/NATIONAL ELECTRONIC F,8673.0,0.0,,2018,7,17,PAYEMENT,8673.0,M2089634452
23527,1196428',2018-07-17,FDRL/NATIONAL ELECTRONIC F,15171.0,0.0,,2018,7,17,DEBIT,15171.0,M1097809105
23528,1196428',2018-07-17,FDRL/NATIONAL ELECTRONIC F,16628.0,0.0,,2018,7,17,CASH_OUT,16628.0,C302025300
23529,1196428',2018-07-17,FDRL/NATIONAL ELECTRONIC F,14424.0,0.0,,2018,7,17,PAYEMENT,14424.0,M134742492
23530,1196428',2018-07-17,FDRL/NATIONAL ELECTRONIC F,14353.0,0.0,,2018,7,17,PAYEMENT,14353.0,C1511785794
23531,1196428',2018-07-17,FDRL/NATIONAL ELECTRONIC F,8900.0,0.0,,2018,7,17,DEBIT,8900.0,M1604293868
23532,1196428',2018-07-17,FDRL/NATIONAL ELECTRONIC F,10452.0,0.0,,2018,7,17,DEBIT,10452.0,M1853641629
23533,1196428',2018-07-17,FDRL/NATIONAL ELECTRONIC F,13816.0,0.0,,2018,7,17,CASH_OUT,13816.0,M710600916
23534,1196428',2018-07-17,FDRL/NATIONAL ELECTRONIC F,19449.0,0.0,,2018,7,17,DEBIT,19449.0,M985323561
23535,1196428',2018-07-17,FDRL/NATIONAL ELECTRONIC F,26227.0,0.0,,2018,7,17,CASH_OUT,26227.0,M1194715097
23536,1196428',2018-07-17,FDRL/NATIONAL ELECTRONIC F,23520.0,0.0,,2018,7,17,CASH_OUT,23520.0,M693684695
23537,1196428',2018-07-17,FDRL/NATIONAL ELECTRONIC F,19239.0,0.0,,2018,7,17,CHECK_WITHDRAWAL,19239.0,M1582319135
23538,1196428',2018-07-17,FDRL/NATIONAL ELECTRONIC F,19146.0,0.0,,2018,7,17,CHECK_WITHDRAWAL,19146.0,M227290600
23539,1196428',2018-07-17,FDRL/NATIONAL ELECTRONIC F,28288.0,0.0,,2018,7,17,CHECK_WITHDRAWAL,28288.0,M2089806029
23540,1196428',2018-07-17,FDRL/NATIONAL ELECTRONIC F,13084.0,0.0,,2018,7,17,DEBIT,13084.0,M1477278751
23541,1196428',2018-07-17,FDRL/NATIONAL ELECTRONIC F,12953.0,0.0,,2018,7,17,PAYEMENT,12953.0,M1650385017
23542,1196428',2018-07-17,FDRL/NATIONAL ELECTRONIC F,12101.0,0.0,,2018,7,17,PAYEMENT,12101.0,M1921059756
23543,1196428',2018-07-17,FDRL/NATIONAL ELECTRONIC F,27685.0,0.0,,2018,7,17,CHECK_WITHDRAWAL,27685.0,M590434145
23544,1196428',2018-07-17,FDRL/NATIONAL ELECTRONIC F,21933.0,0.0,,2018,7,17,CHECK_WITHDRAWAL,21933.0,M1671621366
23545,1196428',2018-07-17,FDRL/NATIONAL ELECTRONIC F,29734.0,0.0,,2018,7,17,CASH_OUT,29734.0,M899686935
23546,1196428',2018-07-17,FDRL/NATIONAL ELECTRONIC F,6088.0,0.0,,2018,7,17,CHECK_WITHDRAWAL,6088.0,M2054039573
23547,1196428',2018-07-17,FDRL/NATIONAL ELECTRONIC F,10821.0,0.0,,2018,7,17,CHECK_WITHDRAWAL,10821.0,M1271480561
23548,1196428',2018-07-17,FDRL/NATIONAL ELECTRONIC F,10583.0,0.0,,2018,7,17,PAYEMENT,10583.0,C1259769769
23549,1196428',2018-07-17,FDRL/NATIONAL ELECTRONIC F,22600.0,0.0,,2018,7,17,PAYEMENT,22600.0,M649539827
23550,1196428',2018-07-17,FDRL/NATIONAL ELECTRONIC F,25791.0,0.0,,2018,7,17,PAYEMENT,25791.0,C893350828
23551,1196428',2018-07-17,FDRL/NATIONAL ELECTRONIC F,6072.0,0.0,,2018,7,17,CASH_OUT,6072.0,M20364107
23552,1196428',2018-07-17,FDRL/NATIONAL ELECTRONIC F,8641.0,0.0,,2018,7,17,DEBIT,8641.0,M2023197227
23553,1196428',2018-07-17,FDRL/NATIONAL ELECTRONIC F,27719.0,0.0,,2018,7,17,CASH_OUT,27719.0,C232812328
23554,1196428',2018-07-17,FDRL/NATIONAL ELECTRONIC F,19069.0,0.0,,2018,7,17,DEBIT,19069.0,M902890505
23555,1196428',2018-07-17,FDRL/NATIONAL ELECTRONIC F,10452.0,0.0,,2018,7,17,CASH_OUT,10452.0,M1465861273
23556,1196428',2018-07-17,FDRL/NATIONAL ELECTRONIC F,11368.0,0.0,,2018,7,17,CASH_OUT,11368.0,M949506330
23557,1196428',2018-07-17,FDRL/NATIONAL ELECTRONIC F,12596.0,0.0,,2018,7,17,CASH_OUT,12596.0,M2084969506
23558,1196428',2018-07-17,FDRL/NATIONAL ELECTRONIC F,15871.0,0.0,,2018,7,17,PAYEMENT,15871.0,M608038618
23559,1196428',2018-07-17,FDRL/NATIONAL ELECTRONIC F,17508.0,0.0,,2018,7,17,CASH_OUT,17508.0,M1041764081
23560,1196428',2018-07-17,FDRL/NATIONAL ELECTRONIC F,10958.0,0.0,,2018,7,17,CHECK_WITHDRAWAL,10958.0,M277788688
23561,1196428',2018-07-17,FDRL/NATIONAL ELECTRONIC F,12596.0,0.0,,2018,7,17,PAYEMENT,12596.0,M31440957
23562,1196428',2018-07-17,FDRL/NATIONAL ELECTRONIC F,12543.0,0.0,,2018,7,17,CHECK_WITHDRAWAL,12543.0,C1805162633
23563,1196428',2018-07-17,FDRL/NATIONAL ELECTRONIC F,26366.0,0.0,,2018,7,17,PAYEMENT,26366.0,M1201023997
23564,1196428',2018-07-17,FDRL/NATIONAL ELECTRONIC F,22340.0,0.0,,2018,7,17,CASH_OUT,22340.0,M1412743565
23565,1196428',2018-07-17,FDRL/NATIONAL ELECTRONIC F,26047.0,0.0,,2018,7,17,CASH_OUT,26047.0,M1887477561
23566,1196428',2018-07-17,FDRL/NATIONAL ELECTRONIC F,27120.0,0.0,,2018,7,17,PAYEMENT,27120.0,C435161028
23567,1196428',2018-07-17,FDRL/NATIONAL ELECTRONIC F,15781.0,0.0,,2018,7,17,CHECK_WITHDRAWAL,15781.0,M2126024846
23568,1196428',2018-07-17,FDRL/NATIONAL ELECTRONIC F,21049.0,0.0,,2018,7,17,PAYEMENT,21049.0,M885738476
23569,1196428',2018-07-17,FDRL/NATIONAL ELECTRONIC F,11010.0,0.0,,2018,7,17,CHECK_WITHDRAWAL,11010.0,C1273939873
23570,1196428',2018-07-17,FDRL/NATIONAL ELECTRONIC F,10959.0,0.0,,2018,7,17,PAYEMENT,10959.0,C464094472
23571,1196428',2018-07-17,FDRL/NATIONAL ELECTRONIC F,28264.0,0.0,,2018,7,17,PAYEMENT,28264.0,C1475998599
23572,1196428',2018-07-17,FDRL/NATIONAL ELECTRONIC F,23921.0,0.0,,2018,7,17,CHECK_WITHDRAWAL,23921.0,C1789550256
23573,1196428',2018-07-17,FDRL/NATIONAL ELECTRONIC F,23335.0,0.0,,2018,7,17,CHECK_WITHDRAWAL,23335.0,C1805445027
23574,1196428',2018-07-17,FDRL/NATIONAL ELECTRONIC F,24090.0,0.0,,2018,7,17,CHECK_WITHDRAWAL,24090.0,C968448640
23575,1196428',2018-07-17,FDRL/NATIONAL ELECTRONIC F,15333.0,0.0,,2018,7,17,CASH_OUT,15333.0,C691636444
23576,1196428',2018-07-17,FDRL/NATIONAL ELECTRONIC F,16809.0,0.0,,2018,7,17,PAYEMENT,16809.0,C1778801068
23577,1196428',2018-07-17,FDRL/NATIONAL ELECTRONIC F,13885.0,0.0,,2018,7,17,PAYEMENT,13885.0,C2029896123
23578,1196428',2018-07-17,FDRL/NATIONAL ELECTRONIC F,20491.0,0.0,,2018,7,17,CHECK_WITHDRAWAL,20491.0,C1677727024
23579,1196428',2018-07-17,FDRL/NATIONAL ELECTRONIC F,18092.0,0.0,,2018,7,17,PAYEMENT,18092.0,C1525944481
23580,1196428',2018-07-17,FDRL/NATIONAL ELECTRONIC F,19252.0,0.0,,2018,7,17,PAYEMENT,19252.0,C481402298
23581,1196428',2018-07-17,FDRL/NATIONAL ELECTRONIC F,13697.0,0.0,,2018,7,17,DEBIT,13697.0,C177457290
23582,1196428',2018-07-17,FDRL/NATIONAL ELECTRONIC F,10818.0,0.0,,2018,7,17,DEBIT,10818.0,M1138171728
23583,1196428',2018-07-17,FDRL/NATIONAL ELECTRONIC F,16061.0,0.0,,2018,7,17,DEBIT,16061.0,C1452722471
23584,1196428',2018-07-17,FDRL/NATIONAL ELECTRONIC F,24293.0,0.0,,2018,7,17,PAYEMENT,24293.0,C861958315
23585,1196428',2018-07-17,FDRL/NATIONAL ELECTRONIC F,20545.0,0.0,,2018,7,17,DEBIT,20545.0,M919438675
23586,1196428',2018-07-17,FDRL/NATIONAL ELECTRONIC F,17271.0,0.0,,2018,7,17,CASH_OUT,17271.0,M1501022601
23587,1196428',2018-07-17,FDRL/NATIONAL ELECTRONIC F,26825.0,0.0,,2018,7,17,CHECK_WITHDRAWAL,26825.0,M397708705
23588,1196428',2018-07-17,NEFT/AXIR181987463018/SAI,0.0,11800.0,,2018,7,17,TRANSFER,11800.0,M1092898377
23589,1196428',2018-07-17,CASHDEP/NOIDA/TP,0.0,96000.0,,2018,7,17,CASH_IN,96000.0,M1957947378
23590,1196428',2018-07-17,RTGS/SBINH18198014023/SRI,0.0,200000.0,,2018,7,17,TRANSFER,200000.0,C785703145
23591,1196428',2018-07-17,NEFT/SBIN418198193299/HAR,0.0,100000.0,,2018,7,17,CHECK_CASHING,100000.0,M2094125621
23592,1196428',2018-07-17,RTGS/HDFCH18198419716/JUN,0.0,220000.0,,2018,7,17,CASH_IN,220000.0,M1918034019
23593,1196428',2018-07-17,NEFT/PUNBH18198194380/RAT,0.0,19000.0,,2018,7,17,CHECK_CASHING,19000.0,M745483242
23594,1196428',2018-07-17,RTGS/PUNBH18198631025/MAN,0.0,400000.0,,2018,7,17,TRANSFER,400000.0,M1878714361
23595,1196428',2018-07-17,RTGS/PUNBH18198633197/PUN,0.0,500000.0,,2018,7,17,TRANSFER,500000.0,M203939387
23596,1196428',2018-07-17,RTGS/HDFCH18198463770/Indfor,0.0,7000000.0,,2018,7,17,CASH_IN,7000000.0,C382934088
23597,1196428',2018-07-17,FDRL/REAL TIME GROSS SETTL,5000000.0,0.0,,2018,7,17,DEBIT,5000000.0,C158876320
23598,1196428',2018-07-17,FDRL/REAL TIME GROSS SETTL,5000000.0,0.0,,2018,7,17,PAYEMENT,5000000.0,C732929236
23599,1196428',2018-07-17,TRF FROM  Indiaforensic SERVICES,0.0,15000000.0,,2018,7,17,CASH_IN,15000000.0,C1554622120
23600,1196428',2018-07-17,TRF FROM  Indiaforensic SERVICES,0.0,2200000.0,,2018,7,17,CASH_IN,2200000.0,C1359484306
23601,1196428',2018-07-17,FDRL/REAL TIME GROSS SETTL,5000000.0,0.0,,2018,7,17,DEBIT,5000000.0,C1782704802
23602,1196428',2018-07-17,FDRL/REAL TIME GROSS SETTL,5000000.0,0.0,,2018,7,17,DEBIT,5000000.0,C1609562230
23603,1196428',2018-07-17,RTGS/HDFCH18198504362/BAT,0.0,200000.0,,2018,7,17,CASH_IN,200000.0,C1220897602
23604,1196428',2018-07-17,NEFT/P18071767617760/M/S,0.0,25000.0,,2018,7,17,CASH_IN,25000.0,C1213257323
23605,1196428',2018-07-17,FDRL/REAL TIME GROSS SETTL,5000000.0,0.0,,2018,7,17,PAYEMENT,5000000.0,C674913323
23606,1196428',2018-07-17,FDRL/REAL TIME GROSS SETTL,1000000.0,0.0,,2018,7,17,CHECK_WITHDRAWAL,1000000.0,C803116137
23607,1196428',2018-07-17,FDRL/REAL TIME GROSS SETTL,1000000.0,0.0,,2018,7,17,PAYEMENT,1000000.0,C1450417897
23608,1196428',2018-07-17,FDRL/REAL TIME GROSS SETTL,1000000.0,0.0,,2018,7,17,DEBIT,1000000.0,C826383690
23609,1196428',2018-07-17,FDRL/INTERNAL FUND TRANSFE,500000.0,0.0,,2018,7,17,CHECK_WITHDRAWAL,500000.0,M1718920203
23610,1196428',2018-07-17,FDRL/INTERNAL FUND TRANSFE,200000.0,0.0,,2018,7,17,CHECK_WITHDRAWAL,200000.0,M1002711260
23611,1196428',2018-07-17,FDRL/INTERNAL FUND TRANSFE,200000.0,0.0,,2018,7,17,CHECK_WITHDRAWAL,200000.0,C545710008
23612,1196428',2018-07-17,TRF TO  Indiaforensic SERVICES I,109225.0,0.0,,2018,7,17,DEBIT,109225.0,C1838584624
23613,1196428',2018-07-17,FDRL/INTERNAL FUND TRANSFE,400000.0,0.0,,2018,7,17,CASH_OUT,400000.0,C1030706332
23614,1196428',2018-07-17,FDRL/INTERNAL FUND TRANSFE,300000.0,0.0,,2018,7,17,DEBIT,300000.0,M2129060443
23615,1196428',2018-07-17,CASHDEP/GHATKOPAR/,0.0,102000.0,,2018,7,17,CASH_IN,102000.0,C1195471589
23616,1196428',2018-07-17,NEFT/SBIN418198802236/NAR,0.0,30570.0,,2018,7,17,CHECK_CASHING,30570.0,M1398128260
23617,1196428',2018-07-17,NEFT/SBIN418198828254/M S,0.0,35000.0,,2018,7,17,TRANSFER,35000.0,C1856036778
23618,1196428',2018-07-17,NEFT/000049036323/Indiaforensic,0.0,800000.0,,2018,7,17,TRANSFER,800000.0,C2067546399
23619,1196428',2018-07-17,NEFT/000049037241/Indiaforensic,0.0,2500000.0,,2018,7,17,CASH_IN,2500000.0,C818570949
23620,1196428',2018-07-17,TRF FROM  Indiaforensic SERVICES,0.0,7600000.0,,2018,7,17,TRANSFER,7600000.0,M535878604
23621,1196428',2018-07-17,TRF TO  Indiaforensic SERVICES I,50000.0,0.0,,2018,7,17,CASH_OUT,50000.0,C358945794
23622,1196428',2018-07-17,STAMP PAPER PURCHASING,100.0,0.0,,2018,7,17,PAYEMENT,100.0,C922511709
23623,1196428',2018-07-17,BEAT CSH PKP DEL UDYOG 62,0.0,237500.0,,2018,7,17,CASH_IN,237500.0,C988138425
23624,1196428',2018-07-17,FDRL/INTERNAL FUND TRANSFE,500000.0,0.0,,2018,7,17,CHECK_WITHDRAWAL,500000.0,C814900611
23625,1196428',2018-07-17,FDRL/INTERNAL FUND TRANSFE,500000.0,0.0,,2018,7,17,DEBIT,500000.0,C1467740330
23626,1196428',2018-07-17,FDRL/INTERNAL FUND TRANSFE,500000.0,0.0,,2018,7,17,PAYEMENT,500000.0,M858308953
23627,1196428',2018-07-17,FDRL/INTERNAL FUND TRANSFE,500000.0,0.0,,2018,7,17,CHECK_WITHDRAWAL,500000.0,M1773085261
23628,1196428',2018-07-17,DSB MUTI CSH 100X1 130720,100.0,0.0,,2018,7,17,CASH_OUT,100.0,M472606308
23629,1196428',2018-07-18,NEFT/PUNBH18199395215/BAL,0.0,100000.0,,2018,7,18,CASH_IN,100000.0,M51583809
23630,1196428',2018-07-18,RTGS/SBINH18199006476/Indfor,0.0,1000000.0,,2018,7,18,TRANSFER,1000000.0,M1337700382
23631,1196428',2018-07-18,FDRL/REAL TIME GROSS SETTL,10245743.52,0.0,,2018,7,18,CHECK_WITHDRAWAL,10245743.52,C1918034924
23632,1196428',2018-07-18,RTGS/SBINH18199010026/SRI,0.0,340000.0,,2018,7,18,CHECK_CASHING,340000.0,M527477577
23633,1196428',2018-07-18,NEFT/SBIN518199046650/THA,0.0,25000.0,,2018,7,18,CHECK_CASHING,25000.0,M577217292
23634,1196428',2018-07-18,CASHDEP/NOIDA/TP,0.0,137000.0,,2018,7,18,TRANSFER,137000.0,C184253187
23635,1196428',2018-07-18,FDRL/INTERNAL FUND TRANSFE,500000.0,0.0,,2018,7,18,CHECK_WITHDRAWAL,500000.0,C1778300121
23636,1196428',2018-07-18,NEFT/N199180588483816/USH,0.0,156900.0,,2018,7,18,CHECK_CASHING,156900.0,C667504652
23637,1196428',2018-07-18,Indiaforensic SERVICES INDIA PVT,0.0,514919.0,,2018,7,18,CHECK_CASHING,514919.0,C638590716
23638,1196428',2018-07-18,RTGS/UCBAH18199091644/BHA,0.0,400000.0,,2018,7,18,TRANSFER,400000.0,C1532153384
23639,1196428',2018-07-18,NEFT/P18071868005881/M/S,0.0,25000.0,,2018,7,18,CASH_IN,25000.0,C208427878
23640,1196428',2018-07-18,NEFT/SBIN518199205483/M S,0.0,80000.0,,2018,7,18,CHECK_CASHING,80000.0,C1530086509
23641,1196428',2018-07-18,IMPS 819914115149 FROM PU,0.0,25000.0,,2018,7,18,TRANSFER,25000.0,C703957828
23642,1196428',2018-07-18,NEFT/AXISP00003629681/ACC,0.0,2000000.0,,2018,7,18,TRANSFER,2000000.0,C891020651
23643,1196428',2018-07-18,RTGS/HDFCH18199651578/Indfor,0.0,7000000.0,,2018,7,18,CASH_IN,7000000.0,M1680032445
23644,1196428',2018-07-18,FDRL/REAL TIME GROSS SETTL,5000000.0,0.0,,2018,7,18,DEBIT,5000000.0,C553264065
23645,1196428',2018-07-18,FDRL/REAL TIME GROSS SETTL,5000000.0,0.0,,2018,7,18,PAYEMENT,5000000.0,M1097298586
23646,1196428',2018-07-18,IMPS 819914327143 FROM AS,0.0,130030.0,,2018,7,18,CASH_IN,130030.0,M870026554
23647,1196428',2018-07-18,IMPS 819915328632 FROM AS,0.0,120020.0,,2018,7,18,CHECK_CASHING,120020.0,C695653925
23648,1196428',2018-07-18,TRF FROM  Indiaforensic SERVICES,0.0,15000000.0,,2018,7,18,TRANSFER,15000000.0,M1248361658
23649,1196428',2018-07-18,TRF FROM  Indiaforensic SERVICES,0.0,3500000.0,,2018,7,18,CASH_IN,3500000.0,C1689262323
23650,1196428',2018-07-18,RTGS/ICICH18199493596/Indfor,0.0,1900000.0,,2018,7,18,CASH_IN,1900000.0,C1757877803
23651,1196428',2018-07-18,RTGS/HDFCH18199654211/BAT,0.0,200000.0,,2018,7,18,CASH_IN,200000.0,C1849933855
23652,1196428',2018-07-18,RTGS/ICICH18199495262/Indfor,0.0,4300000.0,,2018,7,18,CASH_IN,4300000.0,C1753128715
23653,1196428',2018-07-18,RTGS/PUNBH18199660696/PUN,0.0,350000.0,,2018,7,18,CHECK_CASHING,350000.0,C1527761090
23654,1196428',2018-07-18,FDRL/REAL TIME GROSS SETTL,5000000.0,0.0,,2018,7,18,CASH_OUT,5000000.0,C1754722089
23655,1196428',2018-07-18,FDRL/REAL TIME GROSS SETTL,5000000.0,0.0,,2018,7,18,CASH_OUT,5000000.0,C1261039678
23656,1196428',2018-07-18,FDRL/REAL TIME GROSS SETTL,5000000.0,0.0,,2018,7,18,DEBIT,5000000.0,C836514715
23657,1196428',2018-07-18,NEFT/180718i174847659/JAY,0.0,40000.0,,2018,7,18,TRANSFER,40000.0,C1640961071
23658,1196428',2018-07-18,FDRL/INTERNAL FUND TRANSFE,200000.0,0.0,,2018,7,18,CHECK_WITHDRAWAL,200000.0,C1838584624
23659,1196428',2018-07-18,FDRL/INTERNAL FUND TRANSFE,500000.0,0.0,,2018,7,18,DEBIT,500000.0,C1209271652
23660,1196428',2018-07-18,FDRL/INTERNAL FUND TRANSFE,200000.0,0.0,,2018,7,18,DEBIT,200000.0,C745740822
23661,1196428',2018-07-18,FDRL/INTERNAL FUND TRANSFE,200000.0,0.0,,2018,7,18,DEBIT,200000.0,C1401721023
23662,1196428',2018-07-18,IMPS 819916147067 FROM SA,0.0,50000.0,,2018,7,18,CHECK_CASHING,50000.0,C47827984
23663,1196428',2018-07-18,FDRL/NATIONAL ELECTRONIC F,1000000.0,0.0,,2018,7,18,CHECK_WITHDRAWAL,1000000.0,C1849941462
23664,1196428',2018-07-18,FDRL/NATIONAL ELECTRONIC F,1000000.0,0.0,,2018,7,18,DEBIT,1000000.0,C70895366
23665,1196428',2018-07-18,TRF FROM  Indiaforensic SERVICES,0.0,7900000.0,,2018,7,18,CHECK_CASHING,7900000.0,C977993101
23666,1196428',2018-07-18,FDRL/INTERNAL FUND TRANSFE,4000000.0,0.0,,2018,7,18,DEBIT,4000000.0,C2116873183
23667,1196428',2018-07-18,FDRL/INTERNAL FUND TRANSFE,4000000.0,0.0,,2018,7,18,CHECK_WITHDRAWAL,4000000.0,C892686452
23668,1196428',2018-07-18,FDRL/INTERNAL FUND TRANSFE,4000000.0,0.0,,2018,7,18,PAYEMENT,4000000.0,C1540270363
23669,1196428',2018-07-18,FDRL/INTERNAL FUND TRANSFE,200000.0,0.0,,2018,7,18,PAYEMENT,200000.0,C534662976
23670,1196428',2018-07-18,FDRL/INTERNAL FUND TRANSFE,500000.0,0.0,,2018,7,18,PAYEMENT,500000.0,C30013970
23671,1196428',2018-07-18,BEAT CSH PKP DEL UDYOG 62,0.0,61500.0,,2018,7,18,CASH_IN,61500.0,C1809373351
23672,1196428',2018-07-19,CASHDEP/NOIDA/TP,0.0,69500.0,,2018,7,19,CASH_IN,69500.0,C741431520
23673,1196428',2018-07-19,RTGS/SBINH18200005034/Indfor,0.0,5500000.0,,2018,7,19,CASH_IN,5500000.0,C669771073
23674,1196428',2018-07-19,CASHDEP/VIKASMARG/TP,0.0,195000.0,,2018,7,19,TRANSFER,195000.0,C1915091057
23675,1196428',2018-07-19,NEFT/N200180589280483/USH,0.0,155750.0,,2018,7,19,TRANSFER,155750.0,C323287038
23676,1196428',2018-07-19,RTGS/SBINH18200011783/Indfor,0.0,2900000.0,,2018,7,19,TRANSFER,2900000.0,C1027992087
23677,1196428',2018-07-19,FDRL/REAL TIME GROSS SETTL,10640243.02,0.0,,2018,7,19,CASH_OUT,10640243.02,C1435804085
23678,1196428',2018-07-19,NEFT/SBIN518200850523/NAR,0.0,33195.0,,2018,7,19,CHECK_CASHING,33195.0,C1153596299
23679,1196428',2018-07-19,NEFT/SDL35555812/FRIENDS,0.0,11800.0,,2018,7,19,TRANSFER,11800.0,C1541743053
23680,1196428',2018-07-19,"Indiaforensic USA, INC./USD/1180",0.0,807735.6,,2018,7,19,CASH_IN,807735.6,C1213257323
23681,1196428',2018-07-19,IRTT00701820867,1111.96,0.0,,2018,7,19,DEBIT,1111.96,C295081230
23682,1196428',2018-07-19,FDRL/INTERNAL FUND TRANSFE,500000.0,0.0,,2018,7,19,CHECK_WITHDRAWAL,500000.0,C531511436
23683,1196428',2018-07-19,FDRL/REAL TIME GROSS SETTL,482500.0,0.0,,2018,7,19,PAYEMENT,482500.0,C175291188
23684,1196428',2018-07-19,FDRL/REAL TIME GROSS SETTL,482500.0,0.0,,2018,7,19,CASH_OUT,482500.0,C1259769769
23685,1196428',2018-07-19,TRF FROM  Indiaforensic SERVICES,0.0,15000000.0,,2018,7,19,CASH_IN,15000000.0,C205300866
23686,1196428',2018-07-19,TRF FROM  Indiaforensic SERVICES,0.0,5800000.0,,2018,7,19,TRANSFER,5800000.0,C1297873690
23687,1196428',2018-07-19,TRF FROM  Indiaforensic SERVICES,0.0,700000.0,,2018,7,19,CHECK_CASHING,700000.0,C715819458
23688,1196428',2018-07-19,FDRL/REAL TIME GROSS SETTL,15000000.0,0.0,,2018,7,19,CHECK_WITHDRAWAL,15000000.0,C18928637
23689,1196428',2018-07-19,FDRL/NATIONAL ELECTRONIC F,15824.0,0.0,,2018,7,19,DEBIT,15824.0,C1079343872
23690,1196428',2018-07-19,FDRL/NATIONAL ELECTRONIC F,16639.0,0.0,,2018,7,19,CHECK_WITHDRAWAL,16639.0,C99275333
23691,1196428',2018-07-19,NEFT/N200180589448982/USH,0.0,42820.0,,2018,7,19,CHECK_CASHING,42820.0,C1450828900
23692,1196428',2018-07-19,NEFT/N200180589488399/JUN,0.0,60000.0,,2018,7,19,TRANSFER,60000.0,C1339257929
23693,1196428',2018-07-19,RTGS/HDFCH18200828721/BAT,0.0,200000.0,,2018,7,19,CASH_IN,200000.0,C893041125
23694,1196428',2018-07-19,RTGS/HDFCH18200843322/Indfor,0.0,6500000.0,,2018,7,19,TRANSFER,6500000.0,C380242442
23695,1196428',2018-07-19,RTGS/PSIBH18200022858/SAI,0.0,600000.0,,2018,7,19,CASH_IN,600000.0,C1220897602
23696,1196428',2018-07-19,NEFT/P18071968504937/M/S,0.0,25000.0,,2018,7,19,CHECK_CASHING,25000.0,C495071437
23697,1196428',2018-07-19,NEFT/20624213391DC/ARTHAS,0.0,25000.0,,2018,7,19,CHECK_CASHING,25000.0,C1753128715
23698,1196428',2018-07-19,NEFT/AXISP00003735309/ACC,0.0,2000000.0,,2018,7,19,CHECK_CASHING,2000000.0,C1387460501
23699,1196428',2018-07-19,RTGS/ICICH18200626643/Indfor,0.0,1400000.0,,2018,7,19,CHECK_CASHING,1400000.0,C425987411
23700,1196428',2018-07-19,RTGS/ICICH18200627518/Indfor,0.0,900000.0,,2018,7,19,CHECK_CASHING,900000.0,C914293025
23701,1196428',2018-07-19,NEFT/BARBQ18200883803/MAK,0.0,50567.0,,2018,7,19,CHECK_CASHING,50567.0,C1765998352
23702,1196428',2018-07-19,FDRL/NATIONAL ELECTRONIC F,15000000.0,0.0,,2018,7,19,CASH_OUT,15000000.0,C1651144763
23703,1196428',2018-07-19,TRF TO  Indiaforensic SERVICES I,2400000.0,0.0,,2018,7,19,CASH_OUT,2400000.0,C922871524
23704,1196428',2018-07-19,FDRL/INTERNAL FUND TRANSFE,200000.0,0.0,,2018,7,19,PAYEMENT,200000.0,M933561624
23705,1196428',2018-07-19,FDRL/INTERNAL FUND TRANSFE,500000.0,0.0,,2018,7,19,CHECK_WITHDRAWAL,500000.0,M558351487
23706,1196428',2018-07-19,FDRL/INTERNAL FUND TRANSFE,200000.0,0.0,,2018,7,19,CASH_OUT,200000.0,M1327820281
23707,1196428',2018-07-19,BEAT CSH PKP DEL UDYOG 62,0.0,63000.0,,2018,7,19,CASH_IN,63000.0,M354864006
23708,1196428',2018-07-19,TRF TO  Indiaforensic SERVICES I,100000.0,0.0,,2018,7,19,DEBIT,100000.0,M414173666
23709,1196428',2018-07-20,FDRL/INTERNAL FUND TRANSFE,500000.0,0.0,,2018,7,20,DEBIT,500000.0,M1574535094
23710,1196428',2018-07-20,NEFT/PUNBH18201811589/BAL,0.0,100000.0,,2018,7,20,CHECK_CASHING,100000.0,M772788313
23711,1196428',2018-07-20,RTGS/HDFCH18201891994/BAJ,0.0,200000.0,,2018,7,20,TRANSFER,200000.0,C925936450
23712,1196428',2018-07-20,RTGS/SBINH18201007620/Indfor,0.0,7400000.0,,2018,7,20,CHECK_CASHING,7400000.0,C1177315507
23713,1196428',2018-07-20,NEFT/SBIN618201700827/M S,0.0,100000.0,,2018,7,20,CASH_IN,100000.0,C1030706332
23714,1196428',2018-07-20,"Indiaforensic USA, INC./USD/8402",0.0,576797.3,,2018,7,20,CHECK_CASHING,576797.3,M845618138
23715,1196428',2018-07-20,IRTT00701820989,904.12,0.0,,2018,7,20,DEBIT,904.12,C495650048
23716,1196428',2018-07-20,RTGS/SBINH18201018121/Indfor,0.0,2700000.0,,2018,7,20,CHECK_CASHING,2700000.0,C988138425
23717,1196428',2018-07-20,FDRL/REAL TIME GROSS SETTL,8857157.48,0.0,,2018,7,20,PAYEMENT,8857157.48,M555582297
23718,1196428',2018-07-20,CHQ DEP/689/OWDEL1/BARB/G,0.0,11800.0,,2018,7,20,TRANSFER,11800.0,C1287328228
23719,1196428',2018-07-20,CHQ DEP/160541/OWDEL1/ORB,0.0,11800.0,,2018,7,20,CHECK_CASHING,11800.0,M299235289
23720,1196428',2018-07-20,CHQ DEP/24203/OWDEL1/BKID,0.0,11800.0,,2018,7,20,CASH_IN,11800.0,M250394637
23721,1196428',2018-07-20,CHQ DEP/4372/OWDEL1/CBIN/,0.0,11800.0,,2018,7,20,CHECK_CASHING,11800.0,C1669546416
23722,1196428',2018-07-20,CHQ DEP/6/OWDEL1/HDFC/PUR,0.0,11800.0,,2018,7,20,CASH_IN,11800.0,C732398219
23723,1196428',2018-07-20,CHQ DEP/273338/OWDEL1/SBI,0.0,11800.0,,2018,7,20,CHECK_CASHING,11800.0,M69024767
23724,1196428',2018-07-20,CHQ DEP/596204/OWDEL1/SBI,0.0,11800.0,,2018,7,20,CASH_IN,11800.0,C1825174365
23725,1196428',2018-07-20,CHQ DEP/137186/OWDEL1/SBI,0.0,11800.0,,2018,7,20,CASH_IN,11800.0,M700360633
23726,1196428',2018-07-20,CHQ DEP/11821/OWDEL1/BKID,0.0,11800.0,,2018,7,20,CASH_IN,11800.0,C1192983708
23727,1196428',2018-07-20,CHQ DEP/635045/OWDEL1/SBI,0.0,11800.0,,2018,7,20,TRANSFER,11800.0,C624685600
23728,1196428',2018-07-20,CHQ DEP/30392/OWDEL1/CBIN,0.0,11800.0,,2018,7,20,CASH_IN,11800.0,C1428195532
23729,1196428',2018-07-20,CHQ DEP/4084/OWDEL1/SBIN/,0.0,11800.0,,2018,7,20,CHECK_CASHING,11800.0,M362710026
23730,1196428',2018-07-20,CHQ DEP/300310/OWDEL1/SBI,0.0,11800.0,,2018,7,20,CASH_IN,11800.0,C182755121
23731,1196428',2018-07-20,CHQ DEP/105903/OWDEL1/IDI,0.0,11800.0,,2018,7,20,CHECK_CASHING,11800.0,M839676356
23732,1196428',2018-07-20,CHQ DEP/19869/OWDEL1/CBIN,0.0,11800.0,,2018,7,20,CHECK_CASHING,11800.0,M1986311447
23733,1196428',2018-07-20,CHQ DEP/775193/OWDEL1/UTB,0.0,11800.0,,2018,7,20,CHECK_CASHING,11800.0,C728885526
23734,1196428',2018-07-20,CHQ DEP/872921/OWDEL1/SBI,0.0,11800.0,,2018,7,20,TRANSFER,11800.0,C1624533975
23735,1196428',2018-07-20,CHQ DEP/625555/OWDEL1/SBI,0.0,11800.0,,2018,7,20,CHECK_CASHING,11800.0,C348708793
23736,1196428',2018-07-20,CHQ DEP/14773/OWDEL1/CBIN,0.0,11800.0,,2018,7,20,CASH_IN,11800.0,C766681183
23737,1196428',2018-07-20,CHQ DEP/871418/OWDEL1/PUN,0.0,11800.0,,2018,7,20,CASH_IN,11800.0,C547644464
23738,1196428',2018-07-20,CHQ DEP/460808/OWDEL1/UTB,0.0,11800.0,,2018,7,20,CASH_IN,11800.0,C1493448513
23739,1196428',2018-07-20,CHQ DEP/223124/OWDEL1/SBI,0.0,11800.0,,2018,7,20,TRANSFER,11800.0,C2113748097
23740,1196428',2018-07-20,CHQ DEP/381294/OWDEL1/SBI,0.0,11800.0,,2018,7,20,CHECK_CASHING,11800.0,C1485516154
23741,1196428',2018-07-20,CHQ DEP/260930/OWDEL1/SBI,0.0,11800.0,,2018,7,20,TRANSFER,11800.0,C683605346
23742,1196428',2018-07-20,CHQ DEP/74694/OWDEL1/SBIN,0.0,11800.0,,2018,7,20,CHECK_CASHING,11800.0,C2013854563
23743,1196428',2018-07-20,CHQ DEP/51/OWDEL1/UCBA/KO,0.0,11800.0,,2018,7,20,TRANSFER,11800.0,C1529115495
23744,1196428',2018-07-20,CHQ DEP/437224/OWDEL1/SBI,0.0,11800.0,,2018,7,20,CASH_IN,11800.0,C1629911510
23745,1196428',2018-07-20,CHQ DEP/444277/OWDEL1/SBI,0.0,11800.0,,2018,7,20,CHECK_CASHING,11800.0,C1685697739
23746,1196428',2018-07-20,CHQ DEP/4112/OWDEL1/ALLA/,0.0,11800.0,,2018,7,20,CASH_IN,11800.0,C506903242
23747,1196428',2018-07-20,CHQ DEP/251561/OWDEL1/SBI,0.0,11800.0,,2018,7,20,TRANSFER,11800.0,M2072059657
23748,1196428',2018-07-20,CHQ DEP/356027/OWDEL1/SBI,0.0,11800.0,,2018,7,20,CHECK_CASHING,11800.0,C304406966
23749,1196428',2018-07-20,CHQ DEP/43557/OWDEL1/UBIN,0.0,11800.0,,2018,7,20,CHECK_CASHING,11800.0,C75629578
23750,1196428',2018-07-20,CHQ DEP/59016/OWDEL1/SBIN,0.0,11800.0,,2018,7,20,TRANSFER,11800.0,M1037398211
23751,1196428',2018-07-20,CHQ DEP/257122/OWDEL1/PUN,0.0,11800.0,,2018,7,20,CASH_IN,11800.0,C2072030256
23752,1196428',2018-07-20,CHQ DEP/579852/OWDEL1/SBI,0.0,11800.0,,2018,7,20,CHECK_CASHING,11800.0,C886888353
23753,1196428',2018-07-20,CHQ DEP/644265/OWDEL1/SBI,0.0,11800.0,,2018,7,20,TRANSFER,11800.0,C701279123
23754,1196428',2018-07-20,CHQ DEP/737431/OWDEL1/UCB,0.0,11800.0,,2018,7,20,CHECK_CASHING,11800.0,C864016033
23755,1196428',2018-07-20,CHQ DEP/5716/OWDEL1/CBIN/,0.0,11800.0,,2018,7,20,CHECK_CASHING,11800.0,C515442419
23756,1196428',2018-07-20,CHQ DEP/67473/OWDEL1/CNRB,0.0,11800.0,,2018,7,20,CASH_IN,11800.0,M2127093801
23757,1196428',2018-07-20,CHQ DEP/940102/OWDEL1/CNR,0.0,11800.0,,2018,7,20,TRANSFER,11800.0,C1649686970
23758,1196428',2018-07-20,CHQ DEP/23087/OWDEL1/CBIN,0.0,11800.0,,2018,7,20,CASH_IN,11800.0,C701855966
23759,1196428',2018-07-20,CHQ DEP/269282/OWDEL1/UCB,0.0,11800.0,,2018,7,20,CHECK_CASHING,11800.0,C1505217516
23760,1196428',2018-07-20,CHQ DEP/352/OWDEL1/BARB/P,0.0,11800.0,,2018,7,20,TRANSFER,11800.0,M676875212
23761,1196428',2018-07-20,CHQ DEP/112/OWDEL1/BARB/M,0.0,11800.0,,2018,7,20,CHECK_CASHING,11800.0,C681709819
23762,1196428',2018-07-20,CHQ DEP/54/OWDEL1/UCBA/KU,0.0,11800.0,,2018,7,20,TRANSFER,11800.0,M1025042585
23763,1196428',2018-07-20,CHQ DEP/55352/OWDEL1/SBIN,0.0,11800.0,,2018,7,20,CASH_IN,11800.0,C807247901
23764,1196428',2018-07-20,CHQ DEP/98424/OWDEL1/SBIN,0.0,11800.0,,2018,7,20,CHECK_CASHING,11800.0,M18308448
23765,1196428',2018-07-20,CHQ DEP/75478/OWDEL1/SBIN,0.0,11800.0,,2018,7,20,CASH_IN,11800.0,M170030714
23766,1196428',2018-07-20,CHQ DEP/583989/OWDEL1/SBI,0.0,11800.0,,2018,7,20,CHECK_CASHING,11800.0,M621155607
23767,1196428',2018-07-20,CHQ DEP/598/OWDEL1/HDFC/J,0.0,11800.0,,2018,7,20,CHECK_CASHING,11800.0,C1660095722
23768,1196428',2018-07-20,CHQ DEP/146397/OWDEL1/CBI,0.0,11800.0,,2018,7,20,CHECK_CASHING,11800.0,M1571765149
23769,1196428',2018-07-20,CHQ DEP/496/OWDEL1/BARB/C,0.0,11800.0,,2018,7,20,TRANSFER,11800.0,C1663686815
23770,1196428',2018-07-20,NEFT/SBIN618201774139/M R,0.0,50000.0,,2018,7,20,CASH_IN,50000.0,M279824269
23771,1196428',2018-07-20,FDRL/INTERNAL FUND TRANSFE,500000.0,0.0,,2018,7,20,CASH_OUT,500000.0,M1570490488
23772,1196428',2018-07-20,NEFT/SBIN618201775789/TAR,0.0,190000.0,,2018,7,20,CHECK_CASHING,190000.0,M1063002743
23773,1196428',2018-07-20,ADITYA BIRLA SUN LIFE INS,1667989.0,0.0,,2018,7,20,DEBIT,1667989.0,M1530195938
23774,1196428',2018-07-20,IMPS 820113199802 FROM PU,0.0,10000.0,,2018,7,20,CASH_IN,10000.0,C1883840933
23775,1196428',2018-07-20,NEFT/SBIN618201846361/NAR,0.0,36173.0,,2018,7,20,CASH_IN,36173.0,M2097586567
23776,1196428',2018-07-20,TRF FROM  Indiaforensic SERVICES,0.0,4000000.0,,2018,7,20,CASH_IN,4000000.0,C1700852615
23777,1196428',2018-07-20,TRF FROM  Indiaforensic SERVICES,0.0,3000000.0,,2018,7,20,TRANSFER,3000000.0,C1457728035
23778,1196428',2018-07-20,TRF FROM  Indiaforensic SERVICES,0.0,3000000.0,,2018,7,20,CHECK_CASHING,3000000.0,C47249488
23779,1196428',2018-07-20,TRF FROM  Indiaforensic SERVICES,0.0,3000000.0,,2018,7,20,CHECK_CASHING,3000000.0,C33524623
23780,1196428',2018-07-20,TRF FROM  Indiaforensic SERVICES,0.0,2000000.0,,2018,7,20,CASH_IN,2000000.0,C2133591152
23781,1196428',2018-07-20,FDRL/REAL TIME GROSS SETTL,5000000.0,0.0,,2018,7,20,PAYEMENT,5000000.0,C193864812
23782,1196428',2018-07-20,FDRL/REAL TIME GROSS SETTL,5000000.0,0.0,,2018,7,20,PAYEMENT,5000000.0,C1058921154
23783,1196428',2018-07-20,FDRL/REAL TIME GROSS SETTL,5000000.0,0.0,,2018,7,20,CASH_OUT,5000000.0,C798678484
23784,1196428',2018-07-20,RTGS/HDFCH18201990316/BAT,0.0,200000.0,,2018,7,20,TRANSFER,200000.0,C769342184
23785,1196428',2018-07-20,NEFT/BARBR18201204274/RAD,0.0,11800.0,,2018,7,20,CASH_IN,11800.0,C981198566
23786,1196428',2018-07-20,RTGS/HDFCH18201983232/Indfor,0.0,5000000.0,,2018,7,20,TRANSFER,5000000.0,C1281898359
23787,1196428',2018-07-20,Indiaforensic SERVICES INDIA PVT,230931.0,0.0,,2018,7,20,PAYEMENT,230931.0,C30013970
23788,1196428',2018-07-20,Indiaforensic SERVICES INDIA PVT,0.0,230931.0,,2018,7,20,CASH_IN,230931.0,C31789747
23789,1196428',2018-07-20,CHQ DEPOSIT RETURN/260930,11800.0,0.0,,2018,7,20,CHECK_WITHDRAWAL,11800.0,C93518808
23790,1196428',2018-07-20,CHQ DEPOSIT RETURN/4372/E,11800.0,0.0,,2018,7,20,CASH_OUT,11800.0,C2093546827
23791,1196428',2018-07-20,CHQ DEPOSIT RETURN/137186,11800.0,0.0,,2018,7,20,PAYEMENT,11800.0,C976133979
23792,1196428',2018-07-20,CHQ DEPOSIT RETURN/4084/F,11800.0,0.0,,2018,7,20,CHECK_WITHDRAWAL,11800.0,C849038219
23793,1196428',2018-07-20,CHQ DEPOSIT RETURN/737431,11800.0,0.0,,2018,7,20,CHECK_WITHDRAWAL,11800.0,C1789550256
23794,1196428',2018-07-20,CHQ DEPOSIT RETURN/251561,11800.0,0.0,,2018,7,20,DEBIT,11800.0,C363475076
23795,1196428',2018-07-20,CHQ DEPOSIT RETURN/352/FU,11800.0,0.0,,2018,7,20,CASH_OUT,11800.0,C2110623348
23796,1196428',2018-07-20,CHQ DEPOSIT RETURN/625555,11800.0,0.0,,2018,7,20,CASH_OUT,11800.0,C1161820020
23797,1196428',2018-07-20,NEFT/PUNBH18201926393/PUN,0.0,300000.0,,2018,7,20,CHECK_CASHING,300000.0,C627675433
23798,1196428',2018-07-20,NEFT/AXISP00003853650/ACC,0.0,10000000.0,,2018,7,20,TRANSFER,10000000.0,C1145835418
23799,1196428',2018-07-20,FDRL/REAL TIME GROSS SETTL,15000000.0,0.0,,2018,7,20,CASH_OUT,15000000.0,C1778300121
23800,1196428',2018-07-20,Indiaforensic SERVICES INDIA PVT,0.0,205990.0,,2018,7,20,TRANSFER,205990.0,C1325626015
23801,1196428',2018-07-20,NEFT/P18072068884326/M/S,0.0,25000.0,,2018,7,20,TRANSFER,25000.0,C8733802
23802,1196428',2018-07-20,FDRL/INTERNAL FUND TRANSFE,300000.0,0.0,,2018,7,20,PAYEMENT,300000.0,C990053853
23803,1196428',2018-07-20,FDRL/INTERNAL FUND TRANSFE,500000.0,0.0,,2018,7,20,PAYEMENT,500000.0,C218193338
23804,1196428',2018-07-20,Indiaforensic SERVICES INDIA PVT,0.0,230931.0,,2018,7,20,CHECK_CASHING,230931.0,M832073005
23805,1196428',2018-07-20,NEFT/SBIN718201031057/VB,0.0,50000.0,,2018,7,20,TRANSFER,50000.0,M189083850
23806,1196428',2018-07-20,NEFT/SBIN718201060761/UDA,0.0,100000.0,,2018,7,20,TRANSFER,100000.0,C103357744
23807,1196428',2018-07-20,NEFT/N201180590436892/TEC,0.0,300000.0,,2018,7,20,CASH_IN,300000.0,M1942890330
23808,1196428',2018-07-20,FDRL/NATIONAL ELECTRONIC F,25528.0,0.0,,2018,7,20,PAYEMENT,25528.0,C2011941350
23809,1196428',2018-07-20,FDRL/NATIONAL ELECTRONIC F,4000.0,0.0,,2018,7,20,CHECK_WITHDRAWAL,4000.0,C1505755152
23810,1196428',2018-07-20,NEFT/SBIN718201223069/NAR,0.0,51273.0,,2018,7,20,CASH_IN,51273.0,M1051118371
23811,1196428',2018-07-20,NEFT/000049254688/Indiaforensic,0.0,500000.0,,2018,7,20,CHECK_CASHING,500000.0,M1502077581
23812,1196428',2018-07-20,NEFT/000049254642/Indiaforensic,0.0,500000.0,,2018,7,20,TRANSFER,500000.0,M1801625172
23813,1196428',2018-07-20,NEFT/000049254703/Indiaforensic,0.0,500000.0,,2018,7,20,CHECK_CASHING,500000.0,C360898540
23814,1196428',2018-07-20,NEFT/000049254489/Indiaforensic,0.0,500000.0,,2018,7,20,TRANSFER,500000.0,M1408738192
23815,1196428',2018-07-20,BEAT CSH PKP DEL UDYOG 62,0.0,84000.0,,2018,7,20,CHECK_CASHING,84000.0,C237594516
23816,1196428',2018-07-20,TRF FROM  Indiaforensic SERVICES,0.0,5000000.0,,2018,7,20,CASH_IN,5000000.0,M1645271006
23817,1196428',2018-07-20,TRF FROM  Indiaforensic SERVICES,0.0,1000000.0,,2018,7,20,CASH_IN,1000000.0,M1616707854
23818,1196428',2018-07-20,TRF FROM  Indiaforensic SERVICES,0.0,1000000.0,,2018,7,20,TRANSFER,1000000.0,C1334973394
23819,1196428',2018-07-20,FDRL/INTERNAL FUND TRANSFE,8000000.0,0.0,,2018,7,20,DEBIT,8000000.0,M1547406846
23820,1196428',2018-07-20,FDRL/INTERNAL FUND TRANSFE,500000.0,0.0,,2018,7,20,CHECK_WITHDRAWAL,500000.0,M51814511
23821,1196428',2018-07-20,FDRL/INTERNAL FUND TRANSFE,500000.0,0.0,,2018,7,20,CHECK_WITHDRAWAL,500000.0,M1679527434
23822,1196428',2018-07-20,FDRL/INTERNAL FUND TRANSFE,500000.0,0.0,,2018,7,20,PAYEMENT,500000.0,M858729243
23823,1196428',2018-07-20,CHQ DEPOSIT RETURN/260930,100.0,0.0,,2018,7,20,PAYEMENT,100.0,M317858117
23824,1196428',2018-07-20,CHQ DEPOSIT RETURN/260930,18.0,0.0,,2018,7,20,CHECK_WITHDRAWAL,18.0,M974232437
23825,1196428',2018-07-20,CHQ DEPOSIT RETURN/4372/C,100.0,0.0,,2018,7,20,DEBIT,100.0,M535001108
23826,1196428',2018-07-20,CHQ DEPOSIT RETURN/4372/G,18.0,0.0,,2018,7,20,CHECK_WITHDRAWAL,18.0,M967799453
23827,1196428',2018-07-20,CHQ DEPOSIT RETURN/137186,100.0,0.0,,2018,7,20,CHECK_WITHDRAWAL,100.0,M1704857178
23828,1196428',2018-07-20,CHQ DEPOSIT RETURN/137186,18.0,0.0,,2018,7,20,DEBIT,18.0,M888552844
23829,1196428',2018-07-20,CHQ DEPOSIT RETURN/4084/C,100.0,0.0,,2018,7,20,CHECK_WITHDRAWAL,100.0,M257269635
23830,1196428',2018-07-20,CHQ DEPOSIT RETURN/4084/G,18.0,0.0,,2018,7,20,PAYEMENT,18.0,C1305075214
23831,1196428',2018-07-20,CHQ DEPOSIT RETURN/737431,100.0,0.0,,2018,7,20,CHECK_WITHDRAWAL,100.0,C1627965794
23832,1196428',2018-07-20,CHQ DEPOSIT RETURN/737431,18.0,0.0,,2018,7,20,CHECK_WITHDRAWAL,18.0,M1559676676
23833,1196428',2018-07-20,CHQ DEPOSIT RETURN/251561,100.0,0.0,,2018,7,20,CHECK_WITHDRAWAL,100.0,C741431520
23834,1196428',2018-07-20,CHQ DEPOSIT RETURN/251561,18.0,0.0,,2018,7,20,CASH_OUT,18.0,C2143477943
23835,1196428',2018-07-20,CHQ DEPOSIT RETURN/352/CH,100.0,0.0,,2018,7,20,DEBIT,100.0,C638551812
23836,1196428',2018-07-20,CHQ DEPOSIT RETURN/352/GS,18.0,0.0,,2018,7,20,CHECK_WITHDRAWAL,18.0,C1027296777
23837,1196428',2018-07-20,CHQ DEPOSIT RETURN/625555,100.0,0.0,,2018,7,20,DEBIT,100.0,C1554540309
23838,1196428',2018-07-20,CHQ DEPOSIT RETURN/625555,18.0,0.0,,2018,7,20,CHECK_WITHDRAWAL,18.0,M2120427827
23839,1196428',2018-07-21,CASHDEP/NOIDA/TP,0.0,95000.0,,2018,7,21,TRANSFER,95000.0,C820910648
23840,1196428',2018-07-21,NEFT/PUNBH18202014004/BAL,0.0,100000.0,,2018,7,21,TRANSFER,100000.0,M415456371
23841,1196428',2018-07-21,NEFT/SBIN718202414089/M S,0.0,100000.0,,2018,7,21,TRANSFER,100000.0,M598340030
23842,1196428',2018-07-21,RTGS/SBINH18202015608/Indfor,0.0,6000000.0,,2018,7,21,TRANSFER,6000000.0,C345679794
23843,1196428',2018-07-21,FDRL/REAL TIME GROSS SETTL,6852756.86,0.0,,2018,7,21,CASH_OUT,6852756.86,M1605050346
23844,1196428',2018-07-21,NEFT/SBIN718202438005/HAR,0.0,60518.0,,2018,7,21,CHECK_CASHING,60518.0,C1144070975
23845,1196428',2018-07-21,CASHPMT/GURGAON/SELF,49000.0,0.0,,2018,7,21,CASH_OUT,49000.0,M639999796
23846,1196428',2018-07-21,CHQ DEP/1638/OWDEL1/BARB/,0.0,11800.0,,2018,7,21,CASH_IN,11800.0,C343534938
23847,1196428',2018-07-21,CHQ DEP/938427/OWDEL1/SBI,0.0,11800.0,,2018,7,21,TRANSFER,11800.0,M479872561
23848,1196428',2018-07-21,CHQ DEP/597662/OWDEL1/ORB,0.0,8000.0,,2018,7,21,TRANSFER,8000.0,M61732893
23849,1196428',2018-07-21,CHQ DEP/344076/OWDEL1/SBI,0.0,11800.0,,2018,7,21,CHECK_CASHING,11800.0,C160632822
23850,1196428',2018-07-21,CHQ DEP/135640/OWDEL1/ORB,0.0,8000.0,,2018,7,21,CHECK_CASHING,8000.0,C1183266411
23851,1196428',2018-07-21,CHQ DEP/727117/OWDEL1/SBI,0.0,11800.0,,2018,7,21,CASH_IN,11800.0,M1328778262
23852,1196428',2018-07-21,CHQ DEP/719803/OWDEL1/SBI,0.0,11800.0,,2018,7,21,TRANSFER,11800.0,M704806959
23853,1196428',2018-07-21,CHQ DEP/103001/OWDEL1/UTI,0.0,8000.0,,2018,7,21,CHECK_CASHING,8000.0,C229313132
23854,1196428',2018-07-21,CHQ DEP/42/OWDEL1/HDFC/,0.0,11800.0,,2018,7,21,TRANSFER,11800.0,M325906300
23855,1196428',2018-07-21,CHQ DEP/333375/OWDEL1/SBI,0.0,11800.0,,2018,7,21,TRANSFER,11800.0,M1267748122
23856,1196428',2018-07-21,CHQ DEP/796/OWDEL1/BKDN/N,0.0,11800.0,,2018,7,21,CASH_IN,11800.0,M159739450
23857,1196428',2018-07-21,CHQ DEP/20699/OWDEL1/CBIN,0.0,11800.0,,2018,7,21,CHECK_CASHING,11800.0,M1702289141
23858,1196428',2018-07-21,CHQ DEP/20216/OWDEL1/CBIN,0.0,11800.0,,2018,7,21,CHECK_CASHING,11800.0,C1200612373
23859,1196428',2018-07-21,CHQ DEP/695081/OWDEL1/PUN,0.0,11800.0,,2018,7,21,CHECK_CASHING,11800.0,C1840046890
23860,1196428',2018-07-21,CHQ DEP/75953/OWDEL1/UCBA,0.0,11800.0,,2018,7,21,CASH_IN,11800.0,M1261751850
23861,1196428',2018-07-21,CHQ DEP/299010/OWDEL1/SBI,0.0,11800.0,,2018,7,21,CASH_IN,11800.0,M1535970431
23862,1196428',2018-07-21,CHQ DEP/248330/OWDEL1/SBI,0.0,11800.0,,2018,7,21,TRANSFER,11800.0,M524251983
23863,1196428',2018-07-21,CHQ DEP/552172/OWDEL1/PUN,0.0,11800.0,,2018,7,21,CHECK_CASHING,11800.0,C1406749291
23864,1196428',2018-07-21,CHQ DEP/423000/OWDEL1/SBI,0.0,11800.0,,2018,7,21,TRANSFER,11800.0,C1415645767
23865,1196428',2018-07-21,CHQ DEP/259562/OWDEL1/PUN,0.0,11800.0,,2018,7,21,CHECK_CASHING,11800.0,M1816834020
23866,1196428',2018-07-21,CHQ DEP/454408/OWDEL1/PUN,0.0,11800.0,,2018,7,21,CHECK_CASHING,11800.0,C1732292969
23867,1196428',2018-07-21,CHQ DEP/100/OWDEL1/HDFC/,0.0,11800.0,,2018,7,21,CASH_IN,11800.0,M1739764490
23868,1196428',2018-07-21,CHQ DEP/272912/OWDEL1/PUN,0.0,11800.0,,2018,7,21,TRANSFER,11800.0,M1664129150
23869,1196428',2018-07-21,CHQ DEP/663739/OWDEL1/SBI,0.0,11800.0,,2018,7,21,CASH_IN,11800.0,M1128852062
23870,1196428',2018-07-21,CHQ DEP/214/OWDEL1/HDFC/U,0.0,11800.0,,2018,7,21,TRANSFER,11800.0,M182471589
23871,1196428',2018-07-21,CHQ DEP/368615/OWDEL1/SBI,0.0,11800.0,,2018,7,21,CASH_IN,11800.0,M1056074872
23872,1196428',2018-07-21,CHQ DEP/396164/OWDEL1/SBI,0.0,11800.0,,2018,7,21,CASH_IN,11800.0,M2106622700
23873,1196428',2018-07-21,CHQ DEP/435276/OWDEL1/SBI,0.0,11800.0,,2018,7,21,CHECK_CASHING,11800.0,M163766295
23874,1196428',2018-07-21,CHQ DEP/103/OWDEL1/BARB/,0.0,11800.0,,2018,7,21,TRANSFER,11800.0,M802332120
23875,1196428',2018-07-21,CHQ DEP/714401/OWDEL1/HP,0.0,11800.0,,2018,7,21,CHECK_CASHING,11800.0,M1676185662
23876,1196428',2018-07-21,CHQ DEP/139236/OWDEL1/PUN,0.0,11800.0,,2018,7,21,TRANSFER,11800.0,M1776427379
23877,1196428',2018-07-21,CHQ DEP/172/OWDEL1/SBIN/D,0.0,11800.0,,2018,7,21,TRANSFER,11800.0,M334173295
23878,1196428',2018-07-21,CHQ DEP/640399/OWDEL1/SBI,0.0,11800.0,,2018,7,21,TRANSFER,11800.0,M330490124
23879,1196428',2018-07-21,NEFT/N202180590883437/USH,0.0,102650.0,,2018,7,21,TRANSFER,102650.0,M1154845973
23880,1196428',2018-07-21,IMPS 820213325058 FROM AS,0.0,140040.0,,2018,7,21,CASH_IN,140040.0,M911987264
23881,1196428',2018-07-21,IMPS 820213323711 FROM PU,0.0,27000.0,,2018,7,21,TRANSFER,27000.0,M1680147473
23882,1196428',2018-07-21,NEFT/AXISP00003942152/ACC,0.0,7000000.0,,2018,7,21,CASH_IN,7000000.0,M293659205
23883,1196428',2018-07-21,FDRL/INTERNAL FUND TRANSFE,500000.0,0.0,,2018,7,21,DEBIT,500000.0,M1432093328
23884,1196428',2018-07-21,FDRL/INTERNAL FUND TRANSFE,500000.0,0.0,,2018,7,21,CASH_OUT,500000.0,M901262414
23885,1196428',2018-07-21,FDRL/INTERNAL FUND TRANSFE,1000000.0,0.0,,2018,7,21,DEBIT,1000000.0,M899962047
23886,1196428',2018-07-21,FDRL/REAL TIME GROSS SETTL,5000000.0,0.0,,2018,7,21,CHECK_WITHDRAWAL,5000000.0,M32715716
23887,1196428',2018-07-21,IMPS 820215346821 FROM AS,0.0,120099.0,,2018,7,21,TRANSFER,120099.0,M1510311379
23888,1196428',2018-07-21,IMPS 820215819973 FROM SA,0.0,150000.0,,2018,7,21,TRANSFER,150000.0,M1517206841
23889,1196428',2018-07-21,TRF FROM  Indiaforensic SERVICES,0.0,2000000.0,,2018,7,21,CHECK_CASHING,2000000.0,M2030024765
23890,1196428',2018-07-21,TRF FROM  Indiaforensic SERVICES,0.0,15000000.0,,2018,7,21,TRANSFER,15000000.0,M1267580132
23891,1196428',2018-07-21,IMPS 820215862129 FROM SA,0.0,100000.0,,2018,7,21,CHECK_CASHING,100000.0,C655391383
23892,1196428',2018-07-21,FDRL/REAL TIME GROSS SETTL,15000000.0,0.0,,2018,7,21,CHECK_WITHDRAWAL,15000000.0,C2117215775
23893,1196428',2018-07-21,FDRL/REAL TIME GROSS SETTL,1000000.0,0.0,,2018,7,21,PAYEMENT,1000000.0,C2106576360
23894,1196428',2018-07-21,FDRL/REAL TIME GROSS SETTL,1000000.0,0.0,,2018,7,21,CASH_OUT,1000000.0,M267789972
23895,1196428',2018-07-21,FDRL/REAL TIME GROSS SETTL,1000000.0,0.0,,2018,7,21,PAYEMENT,1000000.0,M292960678
23896,1196428',2018-07-21,RTGS/HDFCH18202134392/Indfor,0.0,5000000.0,,2018,7,21,CHECK_CASHING,5000000.0,C1638372110
23897,1196428',2018-07-21,FDRL/REAL TIME GROSS SETTL,5000000.0,0.0,,2018,7,21,DEBIT,5000000.0,C1377774115
23898,1196428',2018-07-21,NEFT/P18072169106928/M/S,0.0,50000.0,,2018,7,21,TRANSFER,50000.0,M1877845145
23899,1196428',2018-07-21,TRF FROM  Indiaforensic SERVICES,0.0,5000000.0,,2018,7,21,CASH_IN,5000000.0,M869149988
23900,1196428',2018-07-21,FDRL/NATIONAL ELECTRONIC F,30798.0,0.0,,2018,7,21,CASH_OUT,30798.0,M1324498984
23901,1196428',2018-07-21,FDRL/NATIONAL ELECTRONIC F,40150.0,0.0,,2018,7,21,PAYEMENT,40150.0,C748014372
23902,1196428',2018-07-21,FDRL/NATIONAL ELECTRONIC F,48949.0,0.0,,2018,7,21,DEBIT,48949.0,M1556526073
23903,1196428',2018-07-21,FDRL/NATIONAL ELECTRONIC F,40958.0,0.0,,2018,7,21,CHECK_WITHDRAWAL,40958.0,M1113797896
23904,1196428',2018-07-21,FDRL/NATIONAL ELECTRONIC F,37667.0,0.0,,2018,7,21,PAYEMENT,37667.0,M111103216
23905,1196428',2018-07-21,FDRL/NATIONAL ELECTRONIC F,35221.0,0.0,,2018,7,21,PAYEMENT,35221.0,M402054040
23906,1196428',2018-07-21,FDRL/NATIONAL ELECTRONIC F,30250.0,0.0,,2018,7,21,DEBIT,30250.0,C1174935745
23907,1196428',2018-07-21,FDRL/NATIONAL ELECTRONIC F,40673.0,0.0,,2018,7,21,DEBIT,40673.0,M3128155
23908,1196428',2018-07-21,FDRL/NATIONAL ELECTRONIC F,42043.0,0.0,,2018,7,21,CHECK_WITHDRAWAL,42043.0,M804435874
23909,1196428',2018-07-21,FDRL/NATIONAL ELECTRONIC F,47083.0,0.0,,2018,7,21,CHECK_WITHDRAWAL,47083.0,M22524150
23910,1196428',2018-07-21,FDRL/NATIONAL ELECTRONIC F,46172.0,0.0,,2018,7,21,DEBIT,46172.0,C717951588
23911,1196428',2018-07-21,FDRL/NATIONAL ELECTRONIC F,36325.0,0.0,,2018,7,21,CHECK_WITHDRAWAL,36325.0,M994429804
23912,1196428',2018-07-21,FDRL/NATIONAL ELECTRONIC F,39550.0,0.0,,2018,7,21,CHECK_WITHDRAWAL,39550.0,M42960844
23913,1196428',2018-07-21,FDRL/NATIONAL ELECTRONIC F,33536.0,0.0,,2018,7,21,CASH_OUT,33536.0,M117897905
23914,1196428',2018-07-21,FDRL/NATIONAL ELECTRONIC F,33900.0,0.0,,2018,7,21,CASH_OUT,33900.0,M919103236
23915,1196428',2018-07-21,FDRL/NATIONAL ELECTRONIC F,43693.0,0.0,,2018,7,21,CHECK_WITHDRAWAL,43693.0,M2117556230
23916,1196428',2018-07-21,FDRL/NATIONAL ELECTRONIC F,41433.0,0.0,,2018,7,21,CHECK_WITHDRAWAL,41433.0,M2047174428
23917,1196428',2018-07-21,FDRL/NATIONAL ELECTRONIC F,45200.0,0.0,,2018,7,21,CHECK_WITHDRAWAL,45200.0,M1468774738
23918,1196428',2018-07-21,FDRL/NATIONAL ELECTRONIC F,34976.0,0.0,,2018,7,21,CASH_OUT,34976.0,M266577647
23919,1196428',2018-07-21,FDRL/NATIONAL ELECTRONIC F,36552.0,0.0,,2018,7,21,DEBIT,36552.0,M1474343674
23920,1196428',2018-07-21,FDRL/INTERNAL FUND TRANSFE,40159.0,0.0,,2018,7,21,DEBIT,40159.0,M1664266643
23921,1196428',2018-07-21,FDRL/NATIONAL ELECTRONIC F,31595.0,0.0,,2018,7,21,DEBIT,31595.0,M842463018
23922,1196428',2018-07-21,FDRL/NATIONAL ELECTRONIC F,47093.0,0.0,,2018,7,21,DEBIT,47093.0,M284325832
23923,1196428',2018-07-21,FDRL/INTERNAL FUND TRANSFE,40680.0,0.0,,2018,7,21,PAYEMENT,40680.0,M1784760424
23924,1196428',2018-07-21,FDRL/NATIONAL ELECTRONIC F,34258.0,0.0,,2018,7,21,CHECK_WITHDRAWAL,34258.0,M1489026763
23925,1196428',2018-07-21,CHQ DEPOSIT RETURN/597662,8000.0,0.0,,2018,7,21,CHECK_WITHDRAWAL,8000.0,C1800405372
23926,1196428',2018-07-21,CHQ DEPOSIT RETURN/103/FU,11800.0,0.0,,2018,7,21,CASH_OUT,11800.0,C2071512077
23927,1196428',2018-07-21,FDRL/INTERNAL FUND TRANSFE,0.0,2000000.0,,2018,7,21,TRANSFER,2000000.0,C1588635270
23928,1196428',2018-07-21,FDRL/INTERNAL FUND TRANSFE,0.0,3000000.0,,2018,7,21,CHECK_CASHING,3000000.0,C1495001462
23929,1196428',2018-07-21,FDRL/INTERNAL FUND TRANSFE,0.0,2000000.0,,2018,7,21,CASH_IN,2000000.0,M84558619
23930,1196428',2018-07-21,FDRL/INTERNAL FUND TRANSFE,1000000.0,0.0,,2018,7,21,CASH_OUT,1000000.0,M113925453
23931,1196428',2018-07-21,NEFT/SBIN718202852750/NAR,0.0,52713.0,,2018,7,21,CHECK_CASHING,52713.0,M645245228
23932,1196428',2018-07-21,NEFT/000049304776/Indiaforensic,0.0,1500000.0,,2018,7,21,CHECK_CASHING,1500000.0,M636094317
23933,1196428',2018-07-21,NEFT/000049304348/Indiaforensic,0.0,1500000.0,,2018,7,21,CHECK_CASHING,1500000.0,M1583961850
23934,1196428',2018-07-21,BEAT CSH PKP DEL UDYOG 62,0.0,66000.0,,2018,7,21,CHECK_CASHING,66000.0,M708029389
23935,1196428',2018-07-21,FDRL/INTERNAL FUND TRANSFE,7000000.0,0.0,,2018,7,21,CASH_OUT,7000000.0,M508231066
23936,1196428',2018-07-21,FDRL/INTERNAL FUND TRANSFE,6000000.0,0.0,,2018,7,21,PAYEMENT,6000000.0,C1838491463
23937,1196428',2018-07-21,FDRL/INTERNAL FUND TRANSFE,500000.0,0.0,,2018,7,21,CASH_OUT,500000.0,M1094448975
23938,1196428',2018-07-21,CHQ DEPOSIT RETURN/103/CH,100.0,0.0,,2018,7,21,PAYEMENT,100.0,M717841651
23939,1196428',2018-07-21,CHQ DEPOSIT RETURN/103/GS,18.0,0.0,,2018,7,21,DEBIT,18.0,M1954167102
23940,1196428',2018-07-23,NEFT/SBIN718204926021/M S,0.0,50000.0,,2018,7,23,TRANSFER,50000.0,M1043087369
23941,1196428',2018-07-23,CASHDEP/NOIDA/TP,0.0,84000.0,,2018,7,23,TRANSFER,84000.0,M1489610760
23942,1196428',2018-07-23,RTGS/SBINH18204003816/Indfor,0.0,2000000.0,,2018,7,23,CHECK_CASHING,2000000.0,C1556875182
23943,1196428',2018-07-23,RTGS/SBINH18204003802/Indfor,0.0,14900000.0,,2018,7,23,CHECK_CASHING,14900000.0,M1109811596
23944,1196428',2018-07-23,FDRL/NATIONAL ELECTRONIC F,12427655.6,0.0,,2018,7,23,DEBIT,12427655.6,C101571284
23945,1196428',2018-07-23,FDRL/NATIONAL ELECTRONIC F,4383072.68,0.0,,2018,7,23,CASH_OUT,4383072.68,M178952563
23946,1196428',2018-07-23,CASHDEP/GHATKOPAR/,0.0,116500.0,,2018,7,23,CHECK_CASHING,116500.0,M2081263541
23947,1196428',2018-07-23,FDRL/INTERNAL FUND TRANSFE,300000.0,0.0,,2018,7,23,DEBIT,300000.0,C2078250226
23948,1196428',2018-07-23,NEFT/N204180591354230/USH,0.0,178525.0,,2018,7,23,TRANSFER,178525.0,C1570256460
23949,1196428',2018-07-23,RTGS/SBINH18204014761/SRI,0.0,230000.0,,2018,7,23,CHECK_CASHING,230000.0,M441055416
23950,1196428',2018-07-23,Indiaforensic SERVICES INDIA PVT,0.0,201470.0,,2018,7,23,CHECK_CASHING,201470.0,C2077098348
23951,1196428',2018-07-23,FDRL/INTERNAL FUND TRANSFE,300000.0,0.0,,2018,7,23,CASH_OUT,300000.0,C1062254208
23952,1196428',2018-07-23,FDRL/INTERNAL FUND TRANSFE,200000.0,0.0,,2018,7,23,PAYEMENT,200000.0,C1787868648
23953,1196428',2018-07-23,TRF FROM  Indiaforensic SERVICES,0.0,15000000.0,,2018,7,23,TRANSFER,15000000.0,C161140376
23954,1196428',2018-07-23,TRF FROM  Indiaforensic SERVICES,0.0,7300000.0,,2018,7,23,CHECK_CASHING,7300000.0,M1471351873
23955,1196428',2018-07-23,TRF TO  Indiaforensic SERVICES I,50000.0,0.0,,2018,7,23,CASH_OUT,50000.0,M1328437771
23956,1196428',2018-07-23,FDRL/REAL TIME GROSS SETTL,15000000.0,0.0,,2018,7,23,CHECK_WITHDRAWAL,15000000.0,M341537411
23957,1196428',2018-07-23,RTGS/HDFCH18204232872/BAT,0.0,200000.0,,2018,7,23,CASH_IN,200000.0,M1367049026
23958,1196428',2018-07-23,FDRL/REAL TIME GROSS SETTL,1000000.0,0.0,,2018,7,23,DEBIT,1000000.0,C2029310301
23959,1196428',2018-07-23,FDRL/REAL TIME GROSS SETTL,5000000.0,0.0,,2018,7,23,DEBIT,5000000.0,C1606699851
23960,1196428',2018-07-23,FDRL/REAL TIME GROSS SETTL,1000000.0,0.0,,2018,7,23,CHECK_WITHDRAWAL,1000000.0,C1103621993
23961,1196428',2018-07-23,RTGS/HDFCH18204231930/Indfor,0.0,7000000.0,,2018,7,23,CASH_IN,7000000.0,M34447014
23962,1196428',2018-07-23,FDRL/REAL TIME GROSS SETTL,1000000.0,0.0,,2018,7,23,PAYEMENT,1000000.0,C1428675504
23963,1196428',2018-07-23,FDRL/REAL TIME GROSS SETTL,1000000.0,0.0,,2018,7,23,CASH_OUT,1000000.0,M1783999682
23964,1196428',2018-07-23,FDRL/REAL TIME GROSS SETTL,1000000.0,0.0,,2018,7,23,PAYEMENT,1000000.0,C1247600089
23965,1196428',2018-07-23,NEFT/SBIN818204214165/ADI,0.0,750.0,,2018,7,23,CASH_IN,750.0,M835388411
23966,1196428',2018-07-23,FDRL/REAL TIME GROSS SETTL,1000000.0,0.0,,2018,7,23,DEBIT,1000000.0,C404279307
23967,1196428',2018-07-23,FDRL/REAL TIME GROSS SETTL,1000000.0,0.0,,2018,7,23,CASH_OUT,1000000.0,C278407008
23968,1196428',2018-07-23,FDRL/REAL TIME GROSS SETTL,1000000.0,0.0,,2018,7,23,CHECK_WITHDRAWAL,1000000.0,M1721234210
23969,1196428',2018-07-23,RTGS/PUNBH18204732471/PUN,0.0,550000.0,,2018,7,23,CASH_IN,550000.0,M1576908104
23970,1196428',2018-07-23,Indiaforensic SERVICES INDIA PVT,0.0,414063.0,,2018,7,23,TRANSFER,414063.0,M1547162536
23971,1196428',2018-07-23,IMPS 820416146840 FROM PU,0.0,25000.0,,2018,7,23,CASH_IN,25000.0,M1057827479
23972,1196428',2018-07-23,FDRL/INTERNAL FUND TRANSFE,300000.0,0.0,,2018,7,23,DEBIT,300000.0,M1498878973
23973,1196428',2018-07-23,FDRL/INTERNAL FUND TRANSFE,200000.0,0.0,,2018,7,23,DEBIT,200000.0,M1420281457
23974,1196428',2018-07-23,FDRL/NATIONAL ELECTRONIC F,60339.0,0.0,,2018,7,23,DEBIT,60339.0,M2000558609
23975,1196428',2018-07-23,FDRL/NATIONAL ELECTRONIC F,61274.0,0.0,,2018,7,23,CASH_OUT,61274.0,M1598229594
23976,1196428',2018-07-23,FDRL/NATIONAL ELECTRONIC F,70922.0,0.0,,2018,7,23,PAYEMENT,70922.0,M2001514483
23977,1196428',2018-07-23,FDRL/NATIONAL ELECTRONIC F,82104.0,0.0,,2018,7,23,DEBIT,82104.0,M1808413339
23978,1196428',2018-07-23,FDRL/NATIONAL ELECTRONIC F,72828.0,0.0,,2018,7,23,PAYEMENT,72828.0,M662376084
23979,1196428',2018-07-23,FDRL/NATIONAL ELECTRONIC F,53079.0,0.0,,2018,7,23,PAYEMENT,53079.0,M1462583713
23980,1196428',2018-07-23,FDRL/NATIONAL ELECTRONIC F,90990.0,0.0,,2018,7,23,PAYEMENT,90990.0,M1292178703
23981,1196428',2018-07-23,FDRL/NATIONAL ELECTRONIC F,71164.0,0.0,,2018,7,23,PAYEMENT,71164.0,M1378894443
23982,1196428',2018-07-23,FDRL/NATIONAL ELECTRONIC F,50262.0,0.0,,2018,7,23,CHECK_WITHDRAWAL,50262.0,M671194471
23983,1196428',2018-07-23,FDRL/NATIONAL ELECTRONIC F,57743.0,0.0,,2018,7,23,DEBIT,57743.0,M2120887477
23984,1196428',2018-07-23,FDRL/NATIONAL ELECTRONIC F,75333.0,0.0,,2018,7,23,PAYEMENT,75333.0,M1565473666
23985,1196428',2018-07-23,FDRL/NATIONAL ELECTRONIC F,97268.0,0.0,,2018,7,23,PAYEMENT,97268.0,M336600403
23986,1196428',2018-07-23,FDRL/NATIONAL ELECTRONIC F,81803.0,0.0,,2018,7,23,CASH_OUT,81803.0,M1108314788
23987,1196428',2018-07-23,FDRL/NATIONAL ELECTRONIC F,67800.0,0.0,,2018,7,23,DEBIT,67800.0,M1776708407
23988,1196428',2018-07-23,FDRL/NATIONAL ELECTRONIC F,69911.0,0.0,,2018,7,23,DEBIT,69911.0,M1886072816
23989,1196428',2018-07-23,FDRL/NATIONAL ELECTRONIC F,84750.0,0.0,,2018,7,23,DEBIT,84750.0,M392269298
23990,1196428',2018-07-23,FDRL/NATIONAL ELECTRONIC F,60005.0,0.0,,2018,7,23,CASH_OUT,60005.0,M240263357
23991,1196428',2018-07-23,FDRL/NATIONAL ELECTRONIC F,57748.0,0.0,,2018,7,23,CASH_OUT,57748.0,M2137827177
23992,1196428',2018-07-23,FDRL/NATIONAL ELECTRONIC F,93924.0,0.0,,2018,7,23,PAYEMENT,93924.0,M996688653
23993,1196428',2018-07-23,NEFT/000049369536/Indiaforensic,0.0,1600000.0,,2018,7,23,CASH_IN,1600000.0,C1829831147
23994,1196428',2018-07-23,NEFT/000049368877/Indiaforensic,0.0,1100000.0,,2018,7,23,TRANSFER,1100000.0,M720435458
23995,1196428',2018-07-23,NEFT/FSFBH18204000080/FIN,0.0,45917.0,,2018,7,23,CHECK_CASHING,45917.0,M29096009
23996,1196428',2018-07-23,FDRL/INTERNAL FUND TRANSFE,500000.0,0.0,,2018,7,23,CHECK_WITHDRAWAL,500000.0,M150995440
23997,1196428',2018-07-23,TRF FROM  Indiaforensic SERVICES,0.0,600000.0,,2018,7,23,TRANSFER,600000.0,M1241251535
23998,1196428',2018-07-23,TRF FROM  Indiaforensic SERVICES,0.0,1000000.0,,2018,7,23,TRANSFER,1000000.0,M1254542588
23999,1196428',2018-07-23,TRF FROM  Indiaforensic SERVICES,0.0,8800000.0,,2018,7,23,TRANSFER,8800000.0,M710538853
24000,1196428',2018-07-23,FDRL/INTERNAL FUND TRANSFE,6000000.0,0.0,,2018,7,23,DEBIT,6000000.0,M399672840
24001,1196428',2018-07-23,FDRL/INTERNAL FUND TRANSFE,6000000.0,0.0,,2018,7,23,CHECK_WITHDRAWAL,6000000.0,M1566931514
24002,1196428',2018-07-23,FDRL/INTERNAL FUND TRANSFE,500000.0,0.0,,2018,7,23,CASH_OUT,500000.0,C1540270363
24003,1196428',2018-07-23,BEAT CSH PKP DEL UDYOG 62,0.0,202200.0,,2018,7,23,TRANSFER,202200.0,C900425684
24004,1196428',2018-07-24,FDRL/INTERNAL FUND TRANSFE,300000.0,0.0,,2018,7,24,PAYEMENT,300000.0,M1361294362
24005,1196428',2018-07-24,CASHDEP/GHATKOPAR/,0.0,92000.0,,2018,7,24,CHECK_CASHING,92000.0,C264843581
24006,1196428',2018-07-24,CASHDEP/NOIDA/TP,0.0,93000.0,,2018,7,24,CASH_IN,93000.0,M1897445965
24007,1196428',2018-07-24,TRF FROM  Indiaforensic SERVICES,0.0,5000000.0,,2018,7,24,TRANSFER,5000000.0,M345439288
24008,1196428',2018-07-24,RTGS/SBINH18205008337/Indfor,0.0,8000000.0,,2018,7,24,CHECK_CASHING,8000000.0,M2130477201
24009,1196428',2018-07-24,FDRL/REAL TIME GROSS SETTL,7370891.5,0.0,,2018,7,24,DEBIT,7370891.5,M1516263359
24010,1196428',2018-07-24,FDRL/REAL TIME GROSS SETTL,1000000.0,0.0,,2018,7,24,CASH_OUT,1000000.0,M508839235
24011,1196428',2018-07-24,FDRL/REAL TIME GROSS SETTL,1000000.0,0.0,,2018,7,24,CHECK_WITHDRAWAL,1000000.0,M530611995
24012,1196428',2018-07-24,FDRL/REAL TIME GROSS SETTL,1000000.0,0.0,,2018,7,24,DEBIT,1000000.0,C1761324386
24013,1196428',2018-07-24,FDRL/REAL TIME GROSS SETTL,1000000.0,0.0,,2018,7,24,PAYEMENT,1000000.0,C90486891
24014,1196428',2018-07-24,FDRL/REAL TIME GROSS SETTL,1000000.0,0.0,,2018,7,24,CHECK_WITHDRAWAL,1000000.0,C573200870
24015,1196428',2018-07-24,RTGS/HDFCH18205363444/JUN,0.0,300000.0,,2018,7,24,CHECK_CASHING,300000.0,C1825992554
24016,1196428',2018-07-24,FDRL/INTERNAL FUND TRANSFE,500000.0,0.0,,2018,7,24,DEBIT,500000.0,M1278682262
24017,1196428',2018-07-24,CHQ DEP/354268/OWDEL2/SBI,0.0,11800.0,,2018,7,24,CHECK_CASHING,11800.0,M2009652577
24018,1196428',2018-07-24,CHQ DEP/737482/OWDEL2/SBI,0.0,11800.0,,2018,7,24,CHECK_CASHING,11800.0,M1504904868
24019,1196428',2018-07-24,CHQ DEP/65938/OWDEL2/SBIN,0.0,11800.0,,2018,7,24,CHECK_CASHING,11800.0,C88226327
24020,1196428',2018-07-24,CHQ DEP/373521/OWDEL2/SBI,0.0,11800.0,,2018,7,24,CHECK_CASHING,11800.0,M203497386
24021,1196428',2018-07-24,NEFT/SBIN818205715319/HAR,0.0,40120.0,,2018,7,24,CASH_IN,40120.0,M1264078907
24022,1196428',2018-07-24,RTGS/UCBAH18205053696/BHA,0.0,300000.0,,2018,7,24,CHECK_CASHING,300000.0,M1870838648
24023,1196428',2018-07-24,FDRL/REAL TIME GROSS SETTL,1000000.0,0.0,,2018,7,24,CASH_OUT,1000000.0,C1683963531
24024,1196428',2018-07-24,TRF FROM  Indiaforensic SERVICES,0.0,15000000.0,,2018,7,24,TRANSFER,15000000.0,M620120832
24025,1196428',2018-07-24,TRF FROM  Indiaforensic SERVICES,0.0,1000000.0,,2018,7,24,TRANSFER,1000000.0,M37714710
24026,1196428',2018-07-24,TRF FROM  Indiaforensic SERVICES,0.0,500000.0,,2018,7,24,TRANSFER,500000.0,M1135370372
24027,1196428',2018-07-24,NEFT/N205180592258061/USH,0.0,185075.0,,2018,7,24,CASH_IN,185075.0,C1700355047
24028,1196428',2018-07-24,FDRL/REAL TIME GROSS SETTL,15000000.0,0.0,,2018,7,24,DEBIT,15000000.0,C1884600481
24029,1196428',2018-07-24,NEFT/AXISP00004154051/ACC,0.0,3000000.0,,2018,7,24,TRANSFER,3000000.0,C1105527690
24030,1196428',2018-07-24,IMPS 820515346055 FROM AS,0.0,140099.0,,2018,7,24,TRANSFER,140099.0,M714819629
24031,1196428',2018-07-24,NEFT/N205180592408087/BAT,0.0,150000.0,,2018,7,24,CASH_IN,150000.0,M722465639
24032,1196428',2018-07-24,Indiaforensic SERVICES INDIA PVT,0.0,171307.0,,2018,7,24,CASH_IN,171307.0,C801412408
24033,1196428',2018-07-24,CHQ DEPOSIT RETURN/354268,11800.0,0.0,,2018,7,24,DEBIT,11800.0,M1678349105
24034,1196428',2018-07-24,NEFT/SBIN918205000776/TAR,0.0,140000.0,,2018,7,24,CASH_IN,140000.0,C35534346
24035,1196428',2018-07-24,NEFT/000049430308/Indiaforensic,0.0,500000.0,,2018,7,24,CASH_IN,500000.0,C943166837
24036,1196428',2018-07-24,FDRL/INTERNAL FUND TRANSFE,300000.0,0.0,,2018,7,24,PAYEMENT,300000.0,M1063088470
24037,1196428',2018-07-24,FDRL/INTERNAL FUND TRANSFE,400000.0,0.0,,2018,7,24,PAYEMENT,400000.0,M634480856
24038,1196428',2018-07-24,TRF FROM  Indiaforensic SERVICES,0.0,5000000.0,,2018,7,24,CHECK_CASHING,5000000.0,M1229660324
24039,1196428',2018-07-24,TRF FROM  Indiaforensic SERVICES,0.0,2000000.0,,2018,7,24,TRANSFER,2000000.0,M1995775202
24040,1196428',2018-07-24,TRF FROM  Indiaforensic SERVICES,0.0,500000.0,,2018,7,24,CASH_IN,500000.0,M982735022
24041,1196428',2018-07-24,NEFT/000049429485/Indiaforensic,0.0,3400000.0,,2018,7,24,CASH_IN,3400000.0,C1754722089
24042,1196428',2018-07-24,NEFT/000049429425/Indiaforensic,0.0,1000000.0,,2018,7,24,TRANSFER,1000000.0,M536571624
24043,1196428',2018-07-24,FDRL/INTERNAL FUND TRANSFE,4000000.0,0.0,,2018,7,24,PAYEMENT,4000000.0,C1498878963
24044,1196428',2018-07-24,FDRL/INTERNAL FUND TRANSFE,6000000.0,0.0,,2018,7,24,DEBIT,6000000.0,C1962165946
24045,1196428',2018-07-24,FDRL/INTERNAL FUND TRANSFE,500000.0,0.0,,2018,7,24,DEBIT,500000.0,M1170462195
24046,1196428',2018-07-24,BEAT CSH PKP DEL GURG 620,0.0,68400.0,,2018,7,24,TRANSFER,68400.0,C414205222
24047,1196428',2018-07-24,CHQ DEPOSIT RETURN/354268,100.0,0.0,,2018,7,24,DEBIT,100.0,M1229413386
24048,1196428',2018-07-24,CHQ DEPOSIT RETURN/354268,18.0,0.0,,2018,7,24,CASH_OUT,18.0,M712447692
24049,1196428',2018-07-25,CASHDEP/GHATKOPAR/,0.0,67000.0,,2018,7,25,TRANSFER,67000.0,C269902384
24050,1196428',2018-07-25,RTGS/SBINH18206006655/Indfor,0.0,4000000.0,,2018,7,25,CASH_IN,4000000.0,C955097010
24051,1196428',2018-07-25,CASHDEP/NOIDA/TP,0.0,106000.0,,2018,7,25,CASH_IN,106000.0,C1827996167
24052,1196428',2018-07-25,FDRL/NATIONAL ELECTRONIC F,49990.0,0.0,,2018,7,25,CHECK_WITHDRAWAL,49990.0,M30162194
24053,1196428',2018-07-25,FDRL/NATIONAL ELECTRONIC F,31468.0,0.0,,2018,7,25,CASH_OUT,31468.0,C1115240385
24054,1196428',2018-07-25,FDRL/REAL TIME GROSS SETTL,9987596.66,0.0,,2018,7,25,CHECK_WITHDRAWAL,9987596.66,M1710595137
24055,1196428',2018-07-25,FDRL/INTERNAL FUND TRANSFE,500000.0,0.0,,2018,7,25,CHECK_WITHDRAWAL,500000.0,M970087106
24056,1196428',2018-07-25,NEFT/SBIN918206318928/THA,0.0,35000.0,,2018,7,25,CASH_IN,35000.0,M561635968
24057,1196428',2018-07-25,NEFT/PUNBH18206599255/BAL,0.0,100000.0,,2018,7,25,CASH_IN,100000.0,C440480434
24058,1196428',2018-07-25,NEFT/N206180592895024/USH,0.0,166775.0,,2018,7,25,CASH_IN,166775.0,C46748390
24059,1196428',2018-07-25,RTGS/HDFCH18206519826/Indfor,0.0,6000000.0,,2018,7,25,CASH_IN,6000000.0,M976616410
24060,1196428',2018-07-25,FDRL/REAL TIME GROSS SETTL,5000000.0,0.0,,2018,7,25,DEBIT,5000000.0,M1796408655
24061,1196428',2018-07-25,TRF FROM  Indiaforensic SERVICES,0.0,15000000.0,,2018,7,25,CHECK_CASHING,15000000.0,M424513770
24062,1196428',2018-07-25,FDRL/REAL TIME GROSS SETTL,15000000.0,0.0,,2018,7,25,CHECK_WITHDRAWAL,15000000.0,M1867357103
24063,1196428',2018-07-25,CHQ DEP/789154/OWDEL1/SYN,0.0,11800.0,,2018,7,25,CHECK_CASHING,11800.0,M215680372
24064,1196428',2018-07-25,CHQ DEP/204303/OWDEL1/SBI,0.0,11800.0,,2018,7,25,TRANSFER,11800.0,M764256713
24065,1196428',2018-07-25,CHQ DEP/175076/OWDEL1/SBI,0.0,11800.0,,2018,7,25,CHECK_CASHING,11800.0,M538413261
24066,1196428',2018-07-25,CHQ DEP/10053/OWDEL1/ALLA,0.0,11800.0,,2018,7,25,CASH_IN,11800.0,M942160595
24067,1196428',2018-07-25,CHQ DEP/580716/OWDEL1/SBI,0.0,11800.0,,2018,7,25,CASH_IN,11800.0,M1319156415
24068,1196428',2018-07-25,CHQ DEP/617903/OWDEL1/PUN,0.0,11800.0,,2018,7,25,TRANSFER,11800.0,M361847129
24069,1196428',2018-07-25,CHQ DEP/260431/OWDEL1/PUN,0.0,11800.0,,2018,7,25,TRANSFER,11800.0,C1790202239
24070,1196428',2018-07-25,CHQ DEP/960349/OWDEL1/HP,0.0,11800.0,,2018,7,25,TRANSFER,11800.0,M955868325
24071,1196428',2018-07-25,CHQ DEP/1567/OWDEL1/SBIN/,0.0,11800.0,,2018,7,25,CHECK_CASHING,11800.0,M1251133153
24072,1196428',2018-07-25,CHQ DEP/707046/OWDEL1/PUN,0.0,11800.0,,2018,7,25,TRANSFER,11800.0,M1854311181
24073,1196428',2018-07-25,CHQ DEP/651956/OWDEL1/SBI,0.0,11800.0,,2018,7,25,CHECK_CASHING,11800.0,C928023753
24074,1196428',2018-07-25,CHQ DEP/388953/OWDEL1/SBI,0.0,11800.0,,2018,7,25,CHECK_CASHING,11800.0,M771609335
24075,1196428',2018-07-25,CHQ DEP/175/OWDEL1/UCBA/P,0.0,11800.0,,2018,7,25,TRANSFER,11800.0,C1452722471
24076,1196428',2018-07-25,CHQ DEP/890/OWDEL1/ICIC/N,0.0,11800.0,,2018,7,25,CASH_IN,11800.0,M1625968481
24077,1196428',2018-07-25,CHQ DEP/414883/OWDEL1/SBI,0.0,11800.0,,2018,7,25,CASH_IN,11800.0,M458727925
24078,1196428',2018-07-25,CHQ DEP/477060/OWDEL1/SBI,0.0,11800.0,,2018,7,25,CHECK_CASHING,11800.0,C111210112
24079,1196428',2018-07-25,CHQ DEP/657508/OWDEL1/HP,0.0,11800.0,,2018,7,25,TRANSFER,11800.0,C464246030
24080,1196428',2018-07-25,CHQ DEP/522/OWDEL1/UCBA/P,0.0,11800.0,,2018,7,25,TRANSFER,11800.0,M2080752777
24081,1196428',2018-07-25,CHQ DEP/434/OWDEL1/UCBA/,0.0,11800.0,,2018,7,25,CHECK_CASHING,11800.0,M1357563045
24082,1196428',2018-07-25,CHQ DEP/28/OWDEL1/HDFC/,0.0,11800.0,,2018,7,25,TRANSFER,11800.0,M68500741
24083,1196428',2018-07-25,CHQ DEP/217655/OWDEL1/PUN,0.0,11800.0,,2018,7,25,TRANSFER,11800.0,C1664330755
24084,1196428',2018-07-25,CHQ DEP/360/OWDEL1/HDFC/S,0.0,11800.0,,2018,7,25,TRANSFER,11800.0,C1823014131
24085,1196428',2018-07-25,CHQ DEP/935/OWDEL1/HDFC/S,0.0,11800.0,,2018,7,25,CASH_IN,11800.0,M1293355387
24086,1196428',2018-07-25,CHQ DEP/405179/OWDEL1/SBI,0.0,11800.0,,2018,7,25,TRANSFER,11800.0,M34599177
24087,1196428',2018-07-25,CHQ DEP/843241/OWDEL1/PUN,0.0,11800.0,,2018,7,25,CHECK_CASHING,11800.0,M685059787
24088,1196428',2018-07-25,NEFT/P18072570126341/M/S,0.0,25000.0,,2018,7,25,CHECK_CASHING,25000.0,M376456946
24089,1196428',2018-07-25,CHQ DEPOSIT RETURN/360/EX,11800.0,0.0,,2018,7,25,PAYEMENT,11800.0,M793798217
24090,1196428',2018-07-25,RTGS/PUNBH18206768153/PUN,0.0,350000.0,,2018,7,25,CHECK_CASHING,350000.0,C264685626
24091,1196428',2018-07-25,NEFT/SBIN918206670213/MS,0.0,100000.0,,2018,7,25,CASH_IN,100000.0,M954243999
24092,1196428',2018-07-25,IMPS 820616177242 FROM PU,0.0,25000.0,,2018,7,25,TRANSFER,25000.0,C1816986148
24093,1196428',2018-07-25,PBGI01001500089 IDBI BANK,4360.0,0.0,,2018,7,25,CHECK_WITHDRAWAL,4360.0,C1144527317
24094,1196428',2018-07-25,PBGI01001500079 IDBI BANK,4360.0,0.0,,2018,7,25,CHECK_WITHDRAWAL,4360.0,C1790831319
24095,1196428',2018-07-25,FDRL/INTERNAL FUND TRANSFE,100000.0,0.0,,2018,7,25,CHECK_WITHDRAWAL,100000.0,C571435580
24096,1196428',2018-07-25,FDRL/INTERNAL FUND TRANSFE,100000.0,0.0,,2018,7,25,CASH_OUT,100000.0,C1262016786
24097,1196428',2018-07-25,TRF FROM  Indiaforensic SERVICES,0.0,1300000.0,,2018,7,25,CASH_IN,1300000.0,C1287328228
24098,1196428',2018-07-25,NEFT/000049490744/Indiaforensic,0.0,1700000.0,,2018,7,25,CHECK_CASHING,1700000.0,C329473339
24099,1196428',2018-07-25,NEFT/AXISP00004294725/ACC,0.0,2000000.0,,2018,7,25,TRANSFER,2000000.0,C1354725727
24100,1196428',2018-07-25,NEFT/000049491048/Indiaforensic,0.0,1600000.0,,2018,7,25,CHECK_CASHING,1600000.0,C1300519073
24101,1196428',2018-07-25,IRTT00701821479,952.34,0.0,,2018,7,25,CHECK_WITHDRAWAL,952.34,C2052185144
24102,1196428',2018-07-25,"Indiaforensic USA, INC./USD/9216",0.0,630374.4,,2018,7,25,TRANSFER,630374.4,C1485516154
24103,1196428',2018-07-25,PBGI01001800164:Bank Guar,1475.0,0.0,,2018,7,25,DEBIT,1475.0,C2143477943
24104,1196428',2018-07-25,STAMP PAPER PURCHASING,100.0,0.0,,2018,7,25,DEBIT,100.0,C476402209
24105,1196428',2018-07-25,FDRL/INTERNAL FUND TRANSFE,300000.0,0.0,,2018,7,25,DEBIT,300000.0,C1255024717
24106,1196428',2018-07-25,FDRL/INTERNAL FUND TRANSFE,300000.0,0.0,,2018,7,25,CASH_OUT,300000.0,C1870367457
24107,1196428',2018-07-25,FDRL/INTERNAL FUND TRANSFE,500000.0,0.0,,2018,7,25,PAYEMENT,500000.0,C465257140
24108,1196428',2018-07-25,FDRL/INTERNAL FUND TRANSFE,4000000.0,0.0,,2018,7,25,PAYEMENT,4000000.0,C745740822
24109,1196428',2018-07-25,FDRL/INTERNAL FUND TRANSFE,4000000.0,0.0,,2018,7,25,CHECK_WITHDRAWAL,4000000.0,C1390121014
24110,1196428',2018-07-25,TRF FROM  Indiaforensic SERVICES,0.0,5000000.0,,2018,7,25,CASH_IN,5000000.0,C1481851679
24111,1196428',2018-07-25,TRF FROM  Indiaforensic SERVICES,0.0,2000000.0,,2018,7,25,TRANSFER,2000000.0,C741431520
24112,1196428',2018-07-25,TRF FROM  Indiaforensic SERVICES,0.0,500000.0,,2018,7,25,CHECK_CASHING,500000.0,C758888772
24113,1196428',2018-07-25,BEAT CSH PKP DEL UDYO 620,0.0,138400.0,,2018,7,25,CASH_IN,138400.0,C1001409363
24114,1196428',2018-07-25,FDRL/INTERNAL FUND TRANSFE,500000.0,0.0,,2018,7,25,DEBIT,500000.0,M1340854901
24115,1196428',2018-07-25,FDRL/INTERNAL FUND TRANSFE,2000000.0,0.0,,2018,7,25,CHECK_WITHDRAWAL,2000000.0,M265997755
24116,1196428',2018-07-25,CHQ DEPOSIT RETURN/360/CH,100.0,0.0,,2018,7,25,DEBIT,100.0,M1257695233
24117,1196428',2018-07-25,CHQ DEPOSIT RETURN/360/GS,18.0,0.0,,2018,7,25,CHECK_WITHDRAWAL,18.0,C150309335
24118,1196428',2018-07-26,RTGS/SBINH18207005129/Indfor,0.0,5300000.0,,2018,7,26,CASH_IN,5300000.0,M1572611628
24119,1196428',2018-07-26,FDRL/REAL TIME GROSS SETTL,9061683.18,0.0,,2018,7,26,CHECK_WITHDRAWAL,9061683.18,M280183141
24120,1196428',2018-07-26,FDRL/REAL TIME GROSS SETTL,1000000.0,0.0,,2018,7,26,CASH_OUT,1000000.0,M808540700
24121,1196428',2018-07-26,NEFT/SBIN918207943073/THA,0.0,55000.0,,2018,7,26,CASH_IN,55000.0,M565481399
24122,1196428',2018-07-26,FDRL/INTERNAL FUND TRANSFE,500000.0,0.0,,2018,7,26,DEBIT,500000.0,C842729010
24123,1196428',2018-07-26,TRF FROM  Indiaforensic SERVICES,0.0,14900000.0,,2018,7,26,CASH_IN,14900000.0,M178371442
24124,1196428',2018-07-26,NEFT/SBIN118207226262/PRA,0.0,11800.0,,2018,7,26,TRANSFER,11800.0,M2076445832
24125,1196428',2018-07-26,NEFT/N207180593688982/JUN,0.0,100000.0,,2018,7,26,CHECK_CASHING,100000.0,C599968109
24126,1196428',2018-07-26,FDRL/REAL TIME GROSS SETTL,15000000.0,0.0,,2018,7,26,CASH_OUT,15000000.0,C599265282
24127,1196428',2018-07-26,NEFT/P18072670488400/M/S,0.0,25000.0,,2018,7,26,CHECK_CASHING,25000.0,C669771073
24128,1196428',2018-07-26,NEFT/AXISP00004346699/ACC,0.0,6000000.0,,2018,7,26,CASH_IN,6000000.0,C2137848242
24129,1196428',2018-07-26,RTGS/HDFCH18207735370/BAT,0.0,200000.0,,2018,7,26,CASH_IN,200000.0,M997986347
24130,1196428',2018-07-26,CHQ DEP/74016/OWDEL1/SBIN,0.0,11800.0,,2018,7,26,CASH_IN,11800.0,M1063792159
24131,1196428',2018-07-26,CHQ DEP/694430/OWDEL1/UTB,0.0,11800.0,,2018,7,26,TRANSFER,11800.0,C22448303
24132,1196428',2018-07-26,CHQ DEP/637592/OWDEL1/SBI,0.0,11800.0,,2018,7,26,TRANSFER,11800.0,M315692635
24133,1196428',2018-07-26,CHQ DEP/19251/OWDEL1/UTIB,0.0,11800.0,,2018,7,26,CHECK_CASHING,11800.0,M803644277
24134,1196428',2018-07-26,CHQ DEP/385231/OWDEL1/SBI,0.0,11800.0,,2018,7,26,CASH_IN,11800.0,M415913007
24135,1196428',2018-07-26,CHQ DEP/633389/OWDEL1/SBI,0.0,11800.0,,2018,7,26,CASH_IN,11800.0,M1344197461
24136,1196428',2018-07-26,CHQ DEP/987121/OWDEL1/SBI,0.0,11800.0,,2018,7,26,CASH_IN,11800.0,M132014623
24137,1196428',2018-07-26,CHQ DEP/101786/OWDEL1/IDI,0.0,11800.0,,2018,7,26,TRANSFER,11800.0,M577051450
24138,1196428',2018-07-26,CHQ DEP/845928/OWDEL1/SBI,0.0,11800.0,,2018,7,26,CASH_IN,11800.0,C1491676195
24139,1196428',2018-07-26,CHQ DEP/159849/OWDEL1/SBI,0.0,11800.0,,2018,7,26,TRANSFER,11800.0,C943166837
24140,1196428',2018-07-26,CHQ DEP/891918/OWDEL1/SBI,0.0,11800.0,,2018,7,26,CHECK_CASHING,11800.0,M1402953791
24141,1196428',2018-07-26,CHQ DEP/39889/OWDEL1/CBIN,0.0,11800.0,,2018,7,26,CHECK_CASHING,11800.0,M1974589236
24142,1196428',2018-07-26,CHQ DEP/826739/OWDEL1/ICI,0.0,11800.0,,2018,7,26,CASH_IN,11800.0,C1701412896
24143,1196428',2018-07-26,CHQ DEP/63191/OWDEL1/SBIN,0.0,11800.0,,2018,7,26,TRANSFER,11800.0,M1355606971
24144,1196428',2018-07-26,CHQ DEP/266098/OWDEL1/SBI,0.0,11800.0,,2018,7,26,CHECK_CASHING,11800.0,M1037747072
24145,1196428',2018-07-26,CHQ DEP/836182/OWDEL1/CLA,0.0,11800.0,,2018,7,26,CASH_IN,11800.0,M82220349
24146,1196428',2018-07-26,CHQ DEP/712632/OWDEL1/SBI,0.0,11800.0,,2018,7,26,CASH_IN,11800.0,M953439482
24147,1196428',2018-07-26,CHQ DEP/834089/OWDEL1/PUN,0.0,11800.0,,2018,7,26,CASH_IN,11800.0,C1914282536
24148,1196428',2018-07-26,CHQ DEP/127368/OWDEL1/PUN,0.0,11000.0,,2018,7,26,TRANSFER,11000.0,C691636444
24149,1196428',2018-07-26,CHQ DEP/463372/OWDEL1/CLA,0.0,11800.0,,2018,7,26,CHECK_CASHING,11800.0,C683605346
24150,1196428',2018-07-26,CHQ DEP/253643/OWDEL1/PUN,0.0,11800.0,,2018,7,26,CASH_IN,11800.0,M1967366965
24151,1196428',2018-07-26,CHQ DEP/345083/OWDEL1/PUN,0.0,11800.0,,2018,7,26,CASH_IN,11800.0,M508405148
24152,1196428',2018-07-26,CHQ DEP/604425/OWDEL1/SBI,0.0,11800.0,,2018,7,26,CHECK_CASHING,11800.0,M1295579320
24153,1196428',2018-07-26,CHQ DEP/166206/OWDEL1/CLA,0.0,11800.0,,2018,7,26,TRANSFER,11800.0,M995168511
24154,1196428',2018-07-26,CHQ DEP/18492/OWDEL1/CLA-,0.0,11800.0,,2018,7,26,TRANSFER,11800.0,M1102425439
24155,1196428',2018-07-26,CHQ DEP/83/OWDEL1/UCBA/HO,0.0,11800.0,,2018,7,26,CHECK_CASHING,11800.0,M590053012
24156,1196428',2018-07-26,CHQ DEP/10485/OWDEL1/BKID,0.0,11800.0,,2018,7,26,CHECK_CASHING,11800.0,M386886002
24157,1196428',2018-07-26,CHQ DEP/995265/OWDEL1/BAR,0.0,11800.0,,2018,7,26,TRANSFER,11800.0,M227585143
24158,1196428',2018-07-26,CHQ DEP/147018/OWDEL1/SBI,0.0,11800.0,,2018,7,26,CASH_IN,11800.0,M2105068287
24159,1196428',2018-07-26,CHQ DEP/555346/OWDEL1/SBB,0.0,11800.0,,2018,7,26,CASH_IN,11800.0,M1038116064
24160,1196428',2018-07-26,CHQ DEP/117896/OWDEL1/SBI,0.0,11800.0,,2018,7,26,CHECK_CASHING,11800.0,M345805867
24161,1196428',2018-07-26,CHQ DEP/2/OWDEL1/BARB/NAW,0.0,11800.0,,2018,7,26,CHECK_CASHING,11800.0,M1128144161
24162,1196428',2018-07-26,CHQ DEP/41666/OWDEL1/SBIN,0.0,11800.0,,2018,7,26,CASH_IN,11800.0,M1492172037
24163,1196428',2018-07-26,CHQ DEP/638093/OWDEL1/SBI,0.0,11800.0,,2018,7,26,CHECK_CASHING,11800.0,M731603444
24164,1196428',2018-07-26,NEFT/SBIN118207354102/NAR,0.0,61473.0,,2018,7,26,CASH_IN,61473.0,M879683510
24165,1196428',2018-07-26,FDRL/REAL TIME GROSS SETTL,5000000.0,0.0,,2018,7,26,PAYEMENT,5000000.0,M555126583
24166,1196428',2018-07-26,CHQ DEPOSIT RETURN/74016/,11800.0,0.0,,2018,7,26,CHECK_WITHDRAWAL,11800.0,M1344791022
24167,1196428',2018-07-26,CHQ DEPOSIT RETURN/891918,11800.0,0.0,,2018,7,26,CASH_OUT,11800.0,M40493588
24168,1196428',2018-07-26,CHQ DEPOSIT RETURN/826739,11800.0,0.0,,2018,7,26,CASH_OUT,11800.0,M1099885881
24169,1196428',2018-07-26,CHQ DEPOSIT RETURN/63191/,11800.0,0.0,,2018,7,26,PAYEMENT,11800.0,M107256650
24170,1196428',2018-07-26,CHQ DEPOSIT RETURN/166206,11800.0,0.0,,2018,7,26,CHECK_WITHDRAWAL,11800.0,M1410611700
24171,1196428',2018-07-26,CHQ DEPOSIT RETURN/18492/,11800.0,0.0,,2018,7,26,DEBIT,11800.0,M954062800
24172,1196428',2018-07-26,CHQ DEPOSIT RETURN/117896,11800.0,0.0,,2018,7,26,DEBIT,11800.0,M13013852
24173,1196428',2018-07-26,CHQ DEPOSIT RETURN/2/ACCO,11800.0,0.0,,2018,7,26,CASH_OUT,11800.0,M1101858256
24174,1196428',2018-07-26,CHQ DEPOSIT RETURN/638093,11800.0,0.0,,2018,7,26,CHECK_WITHDRAWAL,11800.0,M1180862248
24175,1196428',2018-07-26,RTGS/ICICH18207586812/Indfor,0.0,1400000.0,,2018,7,26,TRANSFER,1400000.0,M966462848
24176,1196428',2018-07-26,Indiaforensic SERVICES INDIA PVT,0.0,323072.0,,2018,7,26,TRANSFER,323072.0,M1284324188
24177,1196428',2018-07-26,RTGS/ICICH18207586309/Indfor,0.0,500000.0,,2018,7,26,TRANSFER,500000.0,C374625527
24178,1196428',2018-07-26,NEFT/SDL35831736/SAINI FI,0.0,650000.0,,2018,7,26,TRANSFER,650000.0,C1262822392
24179,1196428',2018-07-26,CASHDEP/NOIDA/TP,0.0,69000.0,,2018,7,26,CHECK_CASHING,69000.0,C1671386208
24180,1196428',2018-07-26,NEFT/CSBKN18207008789/Indfor,0.0,700000.0,,2018,7,26,CHECK_CASHING,700000.0,C1869197498
24181,1196428',2018-07-26,NEFT/SBIN118207555838/SUR,0.0,93000.0,,2018,7,26,CASH_IN,93000.0,C271488817
24182,1196428',2018-07-26,FDRL/INTERNAL FUND TRANSFE,200000.0,0.0,,2018,7,26,PAYEMENT,200000.0,M1915909017
24183,1196428',2018-07-26,FDRL/INTERNAL FUND TRANSFE,300000.0,0.0,,2018,7,26,DEBIT,300000.0,C2052185144
24184,1196428',2018-07-26,FDRL/INTERNAL FUND TRANSFE,1500000.0,0.0,,2018,7,26,PAYEMENT,1500000.0,C646059443
24185,1196428',2018-07-26,FDRL/INTERNAL FUND TRANSFE,300000.0,0.0,,2018,7,26,CHECK_WITHDRAWAL,300000.0,C1982591789
24186,1196428',2018-07-26,TRF FROM  Indiaforensic SERVICES,0.0,2000000.0,,2018,7,26,CHECK_CASHING,2000000.0,C1977614404
24187,1196428',2018-07-26,BEAT CSH PKP DEL UDYOG 62,0.0,107000.0,,2018,7,26,CASH_IN,107000.0,C1883840933
24188,1196428',2018-07-26,FDRL/INTERNAL FUND TRANSFE,5000000.0,0.0,,2018,7,26,PAYEMENT,5000000.0,C2007207148
24189,1196428',2018-07-26,TRF FROM  Indiaforensic SERVICES,0.0,4600000.0,,2018,7,26,CASH_IN,4600000.0,M1014644493
24190,1196428',2018-07-26,FDRL/INTERNAL FUND TRANSFE,4000000.0,0.0,,2018,7,26,DEBIT,4000000.0,C381605910
24191,1196428',2018-07-26,CHQ DEPOSIT RETURN/74016/,100.0,0.0,,2018,7,26,CASH_OUT,100.0,M1056752544
24192,1196428',2018-07-26,CHQ DEPOSIT RETURN/74016/,18.0,0.0,,2018,7,26,CHECK_WITHDRAWAL,18.0,M729567968
24193,1196428',2018-07-26,CHQ DEPOSIT RETURN/891918,100.0,0.0,,2018,7,26,DEBIT,100.0,M1723507087
24194,1196428',2018-07-26,CHQ DEPOSIT RETURN/891918,18.0,0.0,,2018,7,26,DEBIT,18.0,C849038219
24195,1196428',2018-07-26,CHQ DEPOSIT RETURN/18492/,100.0,0.0,,2018,7,26,CASH_OUT,100.0,C1038678108
24196,1196428',2018-07-26,CHQ DEPOSIT RETURN/18492/,18.0,0.0,,2018,7,26,PAYEMENT,18.0,M1976340229
24197,1196428',2018-07-26,CHQ DEPOSIT RETURN/117896,100.0,0.0,,2018,7,26,CASH_OUT,100.0,M693274483
24198,1196428',2018-07-26,CHQ DEPOSIT RETURN/117896,18.0,0.0,,2018,7,26,CHECK_WITHDRAWAL,18.0,M838050003
24199,1196428',2018-07-26,CHQ DEPOSIT RETURN/638093,100.0,0.0,,2018,7,26,PAYEMENT,100.0,C1009972184
24200,1196428',2018-07-26,CHQ DEPOSIT RETURN/638093,18.0,0.0,,2018,7,26,CHECK_WITHDRAWAL,18.0,C63475121
24201,1196428',2018-07-27,NEFT/PUNBH18208932019/BAL,0.0,100000.0,,2018,7,27,TRANSFER,100000.0,C1130075212
24202,1196428',2018-07-27,RTGS/SBINH18208004785/M S,0.0,500000.0,,2018,7,27,TRANSFER,500000.0,C851316413
24203,1196428',2018-07-27,RTGS/SBINH18208008516/Indfor,0.0,6400000.0,,2018,7,27,CHECK_CASHING,6400000.0,M718843573
24204,1196428',2018-07-27,NEFT/P18072770764876/M/S,0.0,25000.0,,2018,7,27,CASH_IN,25000.0,M1217713614
24205,1196428',2018-07-27,NEFT/PUNBH18208949399/RAT,0.0,30000.0,,2018,7,27,CHECK_CASHING,30000.0,M706338650
24206,1196428',2018-07-27,RTGS/SBINH18208022180/Indfor,0.0,1600000.0,,2018,7,27,CASH_IN,1600000.0,M995800830
24207,1196428',2018-07-27,FDRL/REAL TIME GROSS SETTL,9395779.5,0.0,,2018,7,27,CHECK_WITHDRAWAL,9395779.5,C1073259437
24208,1196428',2018-07-27,NEFT/000059448754/JYOTHI,0.0,11800.0,,2018,7,27,CHECK_CASHING,11800.0,M1699315785
24209,1196428',2018-07-27,CHQ DEP/826739/OWDEL1/ICI,0.0,11800.0,,2018,7,27,CHECK_CASHING,11800.0,M1163711030
24210,1196428',2018-07-27,CHQ DEP/818729/OWDEL1/SBI,0.0,11800.0,,2018,7,27,CASH_IN,11800.0,C320106510
24211,1196428',2018-07-27,CHQ DEP/429438/OWDEL1/SBI,0.0,11800.0,,2018,7,27,CASH_IN,11800.0,M597251930
24212,1196428',2018-07-27,CHQ DEP/423781/OWDEL1/SBI,0.0,11800.0,,2018,7,27,CHECK_CASHING,11800.0,M1515100477
24213,1196428',2018-07-27,CHQ DEP/1749/OWDEL1/ALLA/,0.0,11800.0,,2018,7,27,CASH_IN,11800.0,M1412315921
24214,1196428',2018-07-27,CHQ DEP/463835/OWDEL1/SBI,0.0,11800.0,,2018,7,27,CASH_IN,11800.0,M1168923345
24215,1196428',2018-07-27,CHQ DEP/285032/OWDEL1/SBI,0.0,11800.0,,2018,7,27,CASH_IN,11800.0,M2042700604
24216,1196428',2018-07-27,CHQ DEP/393099/OWDEL1/SBI,0.0,11800.0,,2018,7,27,CHECK_CASHING,11800.0,C710481910
24217,1196428',2018-07-27,CHQ DEP/35/OWDEL1/HDFC/IR,0.0,11800.0,,2018,7,27,CASH_IN,11800.0,M1474634841
24218,1196428',2018-07-27,CHQ DEP/312095/OWDEL1/SBI,0.0,11800.0,,2018,7,27,CASH_IN,11800.0,C669419693
24219,1196428',2018-07-27,CHQ DEP/41115/OWDEL1/BKID,0.0,11800.0,,2018,7,27,CASH_IN,11800.0,C2095611317
24220,1196428',2018-07-27,CHQ DEP/254/OWDEL1/UCBA/T,0.0,11800.0,,2018,7,27,CASH_IN,11800.0,C1316560467
24221,1196428',2018-07-27,CHQ DEP/313256/OWDEL1/SBI,0.0,11800.0,,2018,7,27,TRANSFER,11800.0,M1572144334
24222,1196428',2018-07-27,CHQ DEP/565967/OWDEL1/UCB,0.0,11800.0,,2018,7,27,CASH_IN,11800.0,M593517569
24223,1196428',2018-07-27,CHQ DEP/401945/OWDEL1/UCB,0.0,11800.0,,2018,7,27,CHECK_CASHING,11800.0,M558730564
24224,1196428',2018-07-27,CHQ DEP/238044/OWDEL1/SBI,0.0,11800.0,,2018,7,27,CHECK_CASHING,11800.0,C736160330
24225,1196428',2018-07-27,CHQ DEP/671328/OWDEL1/PUN,0.0,11800.0,,2018,7,27,TRANSFER,11800.0,C417236208
24226,1196428',2018-07-27,CHQ DEP/164/OWDEL1/BKID/,0.0,11800.0,,2018,7,27,TRANSFER,11800.0,C931482420
24227,1196428',2018-07-27,CHQ DEP/617949/OWDEL1/PUN,0.0,11800.0,,2018,7,27,CASH_IN,11800.0,M405976415
24228,1196428',2018-07-27,CHQ DEP/184740/OWDEL1/SBI,0.0,11800.0,,2018,7,27,CHECK_CASHING,11800.0,C208341157
24229,1196428',2018-07-27,CHQ DEP/190769/OWDEL1/SBI,0.0,11800.0,,2018,7,27,CHECK_CASHING,11800.0,C382697424
24230,1196428',2018-07-27,CHQ DEP/64327/OWDEL1/SBIN,0.0,11800.0,,2018,7,27,TRANSFER,11800.0,M875577692
24231,1196428',2018-07-27,CHQ DEP/864133/OWDEL1/SBI,0.0,11800.0,,2018,7,27,TRANSFER,11800.0,C1822578654
24232,1196428',2018-07-27,CHQ DEP/592278/OWDEL1/SBI,0.0,11800.0,,2018,7,27,CHECK_CASHING,11800.0,M2022435822
24233,1196428',2018-07-27,CHQ DEP/15/OWDEL1/UCBA/,0.0,11800.0,,2018,7,27,TRANSFER,11800.0,M1867372125
24234,1196428',2018-07-27,CHQ DEP/105/OWDEL1/UCBA/T,0.0,11800.0,,2018,7,27,TRANSFER,11800.0,M556592378
24235,1196428',2018-07-27,CHQ DEP/615311/OWDEL1/SBI,0.0,11800.0,,2018,7,27,CASH_IN,11800.0,C807072084
24236,1196428',2018-07-27,CHQ DEP/974082/OWDEL1/SBI,0.0,11800.0,,2018,7,27,CASH_IN,11800.0,C2077098348
24237,1196428',2018-07-27,CHQ DEP/266598/OWDEL1/BKI,0.0,11800.0,,2018,7,27,CASH_IN,11800.0,M1751878963
24238,1196428',2018-07-27,CHQ DEP/15114/OWDEL1/UBIN,0.0,11800.0,,2018,7,27,CHECK_CASHING,11800.0,C1618278649
24239,1196428',2018-07-27,CHQ DEP/26038/OWDEL1/SBIN,0.0,11800.0,,2018,7,27,CHECK_CASHING,11800.0,C1987564320
24240,1196428',2018-07-27,CHQ DEP/32/OWDEL1/UCBA/MO,0.0,11800.0,,2018,7,27,CASH_IN,11800.0,M848162783
24241,1196428',2018-07-27,CHQ DEP/553849/OWDEL1/SBI,0.0,11800.0,,2018,7,27,CHECK_CASHING,11800.0,M347906624
24242,1196428',2018-07-27,CHQ DEP/3043/OWDEL1/BKID/,0.0,11800.0,,2018,7,27,CHECK_CASHING,11800.0,M271658762
24243,1196428',2018-07-27,CHQ DEP/1579/OWDEL1/CBIN/,0.0,11800.0,,2018,7,27,CHECK_CASHING,11800.0,M1403007770
24244,1196428',2018-07-27,CHQ DEP/887098/OWDEL1/SBI,0.0,11800.0,,2018,7,27,CHECK_CASHING,11800.0,M2043631011
24245,1196428',2018-07-27,CHQ DEP/875809/OWDEL1/SBI,0.0,11800.0,,2018,7,27,CASH_IN,11800.0,C107095723
24246,1196428',2018-07-27,CHQ DEP/695172/OWDEL1/SBI,0.0,11800.0,,2018,7,27,TRANSFER,11800.0,C985934102
24247,1196428',2018-07-27,CHQ DEP/199865/OWDEL1/SBI,0.0,11800.0,,2018,7,27,CHECK_CASHING,11800.0,C824197891
24248,1196428',2018-07-27,CHQ DEP/56/OWDEL1/HDFC/MA,0.0,11800.0,,2018,7,27,CHECK_CASHING,11800.0,C1696218625
24249,1196428',2018-07-27,RTGS/HDFCH18208842676/Indfor,0.0,6000000.0,,2018,7,27,TRANSFER,6000000.0,M1817447589
24250,1196428',2018-07-27,NEFT/BARBT18208232364/MAK,0.0,50850.0,,2018,7,27,CASH_IN,50850.0,C168639687
24251,1196428',2018-07-27,FDRL/REAL TIME GROSS SETTL,5000000.0,0.0,,2018,7,27,DEBIT,5000000.0,C1630293008
24252,1196428',2018-07-27,IMPS 820814410703 FROM SA,0.0,200000.0,,2018,7,27,TRANSFER,200000.0,C1577420620
24253,1196428',2018-07-27,TRF FROM  Indiaforensic SERVICES,0.0,14100000.0,,2018,7,27,TRANSFER,14100000.0,C35263828
24254,1196428',2018-07-27,FDRL/REAL TIME GROSS SETTL,15000000.0,0.0,,2018,7,27,CASH_OUT,15000000.0,M2014874822
24255,1196428',2018-07-27,FDRL/INTERNAL FUND TRANSFE,300000.0,0.0,,2018,7,27,DEBIT,300000.0,M1553772873
24256,1196428',2018-07-27,FDRL/INTERNAL FUND TRANSFE,200000.0,0.0,,2018,7,27,CASH_OUT,200000.0,C905650857
24257,1196428',2018-07-27,IMPS 820814365924 FROM MA,0.0,1000.0,,2018,7,27,CHECK_CASHING,1000.0,C1502287290
24258,1196428',2018-07-27,CASHDEP/NOIDA/TP,0.0,54000.0,,2018,7,27,CHECK_CASHING,54000.0,M1197564988
24259,1196428',2018-07-27,IMPS 820815315357 FROM AS,0.0,140095.0,,2018,7,27,CHECK_CASHING,140095.0,M1843534160
24260,1196428',2018-07-27,IMPS 820815317633 FROM AS,0.0,150099.0,,2018,7,27,CHECK_CASHING,150099.0,C871895680
24261,1196428',2018-07-27,IMPS 820815319390 FROM PU,0.0,32000.0,,2018,7,27,TRANSFER,32000.0,C1398530689
24262,1196428',2018-07-27,Indiaforensic SERVICES INDIA PVT,0.0,137530.0,,2018,7,27,TRANSFER,137530.0,M834859488
24263,1196428',2018-07-27,NEFT/SBIN218208120383/TAR,0.0,195000.0,,2018,7,27,TRANSFER,195000.0,M463880076
24264,1196428',2018-07-27,RTGS/ICICH18208694102/Indfor,0.0,1500000.0,,2018,7,27,CHECK_CASHING,1500000.0,M1273091698
24265,1196428',2018-07-27,RTGS/ICICH18208692273/Indfor,0.0,600000.0,,2018,7,27,TRANSFER,600000.0,M134350609
24266,1196428',2018-07-27,NEFT/SBIN218208146054/MS,0.0,100000.0,,2018,7,27,CASH_IN,100000.0,M1939822545
24267,1196428',2018-07-27,NEFT/PUNBH18208083631/BAL,0.0,75000.0,,2018,7,27,TRANSFER,75000.0,M1498010747
24268,1196428',2018-07-27,NEFT/N208180594708837/USH,0.0,80500.0,,2018,7,27,TRANSFER,80500.0,M615833646
24269,1196428',2018-07-27,NEFT/SBIN218208230859/JAI,0.0,112233.0,,2018,7,27,CASH_IN,112233.0,M695601535
24270,1196428',2018-07-27,FDRL/NATIONAL ELECTRONIC F,133995.0,0.0,,2018,7,27,DEBIT,133995.0,M1741551200
24271,1196428',2018-07-27,FDRL/NATIONAL ELECTRONIC F,143842.0,0.0,,2018,7,27,CHECK_WITHDRAWAL,143842.0,M533060514
24272,1196428',2018-07-27,FDRL/NATIONAL ELECTRONIC F,112985.0,0.0,,2018,7,27,CASH_OUT,112985.0,M763925237
24273,1196428',2018-07-27,FDRL/NATIONAL ELECTRONIC F,166950.0,0.0,,2018,7,27,CHECK_WITHDRAWAL,166950.0,M309397793
24274,1196428',2018-07-27,FDRL/NATIONAL ELECTRONIC F,130116.0,0.0,,2018,7,27,DEBIT,130116.0,M786088183
24275,1196428',2018-07-27,FDRL/NATIONAL ELECTRONIC F,162629.0,0.0,,2018,7,27,PAYEMENT,162629.0,M1362397723
24276,1196428',2018-07-27,FDRL/NATIONAL ELECTRONIC F,106441.0,0.0,,2018,7,27,PAYEMENT,106441.0,M166947904
24277,1196428',2018-07-27,CHQ DEPOSIT RETURN/401945,11800.0,0.0,,2018,7,27,DEBIT,11800.0,M39384037
24278,1196428',2018-07-27,CHQ DEPOSIT RETURN/184740,11800.0,0.0,,2018,7,27,CASH_OUT,11800.0,M1475711030
24279,1196428',2018-07-27,CHQ DEPOSIT RETURN/1579/E,11800.0,0.0,,2018,7,27,PAYEMENT,11800.0,M727579419
24280,1196428',2018-07-27,CHQ DEPOSIT RETURN/826739,11800.0,0.0,,2018,7,27,CHECK_WITHDRAWAL,11800.0,M654290745
24281,1196428',2018-07-27,NEFT/N208180594787607/TEC,0.0,200000.0,,2018,7,27,CHECK_CASHING,200000.0,C1559145228
24282,1196428',2018-07-27,NEFT/SBIN218208269708/NAR,0.0,54973.0,,2018,7,27,TRANSFER,54973.0,M688458571
24283,1196428',2018-07-27,FDRL/NATIONAL ELECTRONIC F,290062.0,0.0,,2018,7,27,CASH_OUT,290062.0,M1895621189
24284,1196428',2018-07-27,CASHDEP/GHATKOPAR/,0.0,130500.0,,2018,7,27,CASH_IN,130500.0,M1516781526
24285,1196428',2018-07-27,FDRL/NATIONAL ELECTRONIC F,2000000.0,0.0,,2018,7,27,PAYEMENT,2000000.0,M409559965
24286,1196428',2018-07-27,NEFT/AXISP00004513919/ACC,0.0,15000000.0,,2018,7,27,CASH_IN,15000000.0,M1771169983
24287,1196428',2018-07-27,PROCESSING_FEE_ODSEC,900000.0,0.0,,2018,7,27,PAYEMENT,900000.0,C470217116
24288,1196428',2018-07-27,GOODS AND SERVICES TAX,162000.0,0.0,,2018,7,27,PAYEMENT,162000.0,M585745963
24289,1196428',2018-07-27,FDRL/NATIONAL ELECTRONIC F,332160.0,0.0,,2018,7,27,DEBIT,332160.0,M2096974885
24290,1196428',2018-07-27,FDRL/NATIONAL ELECTRONIC F,2000000.0,0.0,,2018,7,27,PAYEMENT,2000000.0,M1287228290
24291,1196428',2018-07-27,FDRL/INTERNAL FUND TRANSFE,0.0,2000000.0,,2018,7,27,CHECK_CASHING,2000000.0,M1178751818
24292,1196428',2018-07-27,BEAT CSH PKP DEL UDYO 620,0.0,121000.0,,2018,7,27,CHECK_CASHING,121000.0,M145594829
24293,1196428',2018-07-27,TRF FROM  Indiaforensic SERVICES,0.0,2000000.0,,2018,7,27,CHECK_CASHING,2000000.0,M1232351629
24294,1196428',2018-07-27,TRF FROM  Indiaforensic SERVICES,0.0,9000000.0,,2018,7,27,CASH_IN,9000000.0,M1656904340
24295,1196428',2018-07-27,TRF FROM Indiaforensic SERVICES,0.0,3000000.0,,2018,7,27,TRANSFER,3000000.0,C24404443
24296,1196428',2018-07-27,TRF FROM Indiaforensic SERVICES,0.0,1000000.0,,2018,7,27,CHECK_CASHING,1000000.0,C596299019
24297,1196428',2018-07-27,TRF FROM Indiaforensic SERVICES,0.0,1000000.0,,2018,7,27,CASH_IN,1000000.0,C1983747920
24298,1196428',2018-07-27,FDRL/INTERNAL FUND TRANSFE,2000000.0,0.0,,2018,7,27,CASH_OUT,2000000.0,C696705647
24299,1196428',2018-07-27,FDRL/INTERNAL FUND TRANSFE,15000000.0,0.0,,2018,7,27,PAYEMENT,15000000.0,C1845765982
24300,1196428',2018-07-27,FDRL/INTERNAL FUND TRANSFE,5000000.0,0.0,,2018,7,27,PAYEMENT,5000000.0,M877365519
24301,1196428',2018-07-27,FDRL/INTERNAL FUND TRANSFE,1000000.0,0.0,,2018,7,27,CASH_OUT,1000000.0,C134604590
24302,1196428',2018-07-27,CHQ DEPOSIT RETURN/1579/C,100.0,0.0,,2018,7,27,PAYEMENT,100.0,M1053485132
24303,1196428',2018-07-27,CHQ DEPOSIT RETURN/1579/G,18.0,0.0,,2018,7,27,CASH_OUT,18.0,M1698378565
24304,1196428',2018-07-30,RTGS/SBINH18211001970/M S,0.0,480000.0,,2018,7,30,CASH_IN,480000.0,M1418167825
24305,1196428',2018-07-30,NEFT/SBIN218211515874/NAR,0.0,54937.0,,2018,7,30,TRANSFER,54937.0,M915318947
24306,1196428',2018-07-30,RTGS/SBINH18211008051/Indfor,0.0,10000000.0,,2018,7,30,TRANSFER,10000000.0,M1471526064
24307,1196428',2018-07-30,FDRL/REAL TIME GROSS SETTL,7496462.82,0.0,,2018,7,30,PAYEMENT,7496462.82,C474166728
24308,1196428',2018-07-30,FDRL/REAL TIME GROSS SETTL,7802049.05,0.0,,2018,7,30,PAYEMENT,7802049.05,M1777764920
24309,1196428',2018-07-30,RTGS/HDFCH18211990381/BAT,0.0,200000.0,,2018,7,30,CHECK_CASHING,200000.0,C1833549064
24310,1196428',2018-07-30,RTGS/SBINH18211016300/Indfor,0.0,1000000.0,,2018,7,30,TRANSFER,1000000.0,M327804056
24311,1196428',2018-07-30,FDRL/REAL TIME GROSS SETTL,3631735.97,0.0,,2018,7,30,CASH_OUT,3631735.97,M939893108
24312,1196428',2018-07-30,NEFT/N211180595336047/USH,0.0,199275.0,,2018,7,30,CHECK_CASHING,199275.0,C1938462589
24313,1196428',2018-07-30,CHQ DEP/704909/OWDEL1/SBI,0.0,11800.0,,2018,7,30,TRANSFER,11800.0,M974784761
24314,1196428',2018-07-30,CHQ DEP/787965/OWDEL1/SBI,0.0,11800.0,,2018,7,30,TRANSFER,11800.0,M209997138
24315,1196428',2018-07-30,CHQ DEP/928526/OWDEL1/IOB,0.0,11800.0,,2018,7,30,TRANSFER,11800.0,M359327148
24316,1196428',2018-07-30,CHQ DEP/450375/OWDEL1/SBI,0.0,11800.0,,2018,7,30,CASH_IN,11800.0,C1519216494
24317,1196428',2018-07-30,CHQ DEP/157/OWDEL1/HDFC/S,0.0,11800.0,,2018,7,30,TRANSFER,11800.0,M142106520
24318,1196428',2018-07-30,CHQ DEP/539510/OWDEL1/SBI,0.0,11800.0,,2018,7,30,CHECK_CASHING,11800.0,C1979080020
24319,1196428',2018-07-30,CHQ DEP/575621/OWDEL1/SBI,0.0,11800.0,,2018,7,30,TRANSFER,11800.0,C635281078
24320,1196428',2018-07-30,CHQ DEP/997434/OWDEL1/SBI,0.0,11800.0,,2018,7,30,CASH_IN,11800.0,C1866672043
24321,1196428',2018-07-30,CHQ DEP/79845/OWDEL1/UBIN,0.0,11800.0,,2018,7,30,CASH_IN,11800.0,M155979068
24322,1196428',2018-07-30,CHQ DEP/194134/OWDEL1/SBI,0.0,11800.0,,2018,7,30,CHECK_CASHING,11800.0,M111496179
24323,1196428',2018-07-30,CHQ DEP/455832/OWDEL1/SBI,0.0,11800.0,,2018,7,30,CHECK_CASHING,11800.0,M1472428747
24324,1196428',2018-07-30,CHQ DEP/182/OWDEL1/HDFC/K,0.0,11800.0,,2018,7,30,CHECK_CASHING,11800.0,C1167813715
24325,1196428',2018-07-30,CHQ DEP/210276/OWDEL1/CLA,0.0,11800.0,,2018,7,30,CASH_IN,11800.0,M235839070
24326,1196428',2018-07-30,CHQ DEP/572056/OWDEL1/SBI,0.0,11800.0,,2018,7,30,CHECK_CASHING,11800.0,M1881768592
24327,1196428',2018-07-30,CHQ DEP/184288/OWDEL1/SBI,0.0,11800.0,,2018,7,30,CASH_IN,11800.0,C185503802
24328,1196428',2018-07-30,CHQ DEP/172361/OWDEL1/SBI,0.0,11800.0,,2018,7,30,TRANSFER,11800.0,C403147759
24329,1196428',2018-07-30,CHQ DEP/704372/OWDEL1/PUN,0.0,11800.0,,2018,7,30,CHECK_CASHING,11800.0,M1725462644
24330,1196428',2018-07-30,CHQ DEP/849830/OWDEL1/SBI,0.0,11800.0,,2018,7,30,CHECK_CASHING,11800.0,M685639359
24331,1196428',2018-07-30,CHQ DEP/931124/OWDEL1/SBI,0.0,11800.0,,2018,7,30,CHECK_CASHING,11800.0,M499928991
24332,1196428',2018-07-30,CHQ DEP/748984/OWDEL1/SBI,0.0,11800.0,,2018,7,30,CHECK_CASHING,11800.0,M960322367
24333,1196428',2018-07-30,CHQ DEP/295/OWDEL1/ORBC/A,0.0,11800.0,,2018,7,30,CHECK_CASHING,11800.0,M1786085833
24334,1196428',2018-07-30,CHQ DEP/289/OWDEL1/PSIB/T,0.0,11800.0,,2018,7,30,CHECK_CASHING,11800.0,M718103121
24335,1196428',2018-07-30,CHQ DEP/238/OWDEL1/PSIB/H,0.0,11800.0,,2018,7,30,CASH_IN,11800.0,M757687320
24336,1196428',2018-07-30,CHQ DEP/4311/OWDEL1/SBIN/,0.0,11800.0,,2018,7,30,CHECK_CASHING,11800.0,M1144148971
24337,1196428',2018-07-30,CHQ DEP/936/OWDEL1/ANDB/T,0.0,11800.0,,2018,7,30,TRANSFER,11800.0,M1868505862
24338,1196428',2018-07-30,CHQ DEP/649414/OWDEL1/SBI,0.0,11800.0,,2018,7,30,CHECK_CASHING,11800.0,M1608080402
24339,1196428',2018-07-30,CHQ DEP/900324/OWDEL1/CNR,0.0,11800.0,,2018,7,30,TRANSFER,11800.0,M1154038476
24340,1196428',2018-07-30,CHQ DEP/106/OWDEL1/HDFC/D,0.0,11800.0,,2018,7,30,CASH_IN,11800.0,M1325923139
24341,1196428',2018-07-30,CHQ DEP/34124/OWDEL1/ORBC,0.0,11800.0,,2018,7,30,CHECK_CASHING,11800.0,M1396188238
24342,1196428',2018-07-30,CHQ DEP/259075/OWDEL1/SBI,0.0,11800.0,,2018,7,30,TRANSFER,11800.0,M554850979
24343,1196428',2018-07-30,TRF FROM Indiaforensic SERVICES,0.0,15000000.0,,2018,7,30,CASH_IN,15000000.0,M1055780232
24344,1196428',2018-07-30,TRF FROM Indiaforensic SERVICES,0.0,15000000.0,,2018,7,30,CHECK_CASHING,15000000.0,M662568271
24345,1196428',2018-07-30,TRF FROM Indiaforensic SERVICES,0.0,5300000.0,,2018,7,30,TRANSFER,5300000.0,C1649449847
24346,1196428',2018-07-30,CASHDEP/VIKASMARG/TP,0.0,189000.0,,2018,7,30,TRANSFER,189000.0,C1198167820
24347,1196428',2018-07-30,FDRL/REAL TIME GROSS SETTL,15000000.0,0.0,,2018,7,30,DEBIT,15000000.0,C749672494
24348,1196428',2018-07-30,FDRL/REAL TIME GROSS SETTL,15000000.0,0.0,,2018,7,30,CHECK_WITHDRAWAL,15000000.0,C1423992712
24349,1196428',2018-07-30,FDRL/REAL TIME GROSS SETTL,4000000.0,0.0,,2018,7,30,DEBIT,4000000.0,C313124964
24350,1196428',2018-07-30,RTGS/YESBH18211812266/DAK,743223.0,0.0,,2018,7,30,PAYEMENT,743223.0,C500153041
24351,1196428',2018-07-30,TRF TO  Indiaforensic SERVICES I,60000.0,0.0,,2018,7,30,CHECK_WITHDRAWAL,60000.0,C728526866
24352,1196428',2018-07-30,CHQ DEPOSIT RETURN/79845/,11800.0,0.0,,2018,7,30,CHECK_WITHDRAWAL,11800.0,C40075281
24353,1196428',2018-07-30,CHQ DEPOSIT RETURN/704372,11800.0,0.0,,2018,7,30,CASH_OUT,11800.0,C456538529
24354,1196428',2018-07-30,CHQ DEPOSIT RETURN/849830,11800.0,0.0,,2018,7,30,DEBIT,11800.0,C2117043942
24355,1196428',2018-07-30,CHQ DEPOSIT RETURN/295/EX,11800.0,0.0,,2018,7,30,CHECK_WITHDRAWAL,11800.0,C1838584624
24356,1196428',2018-07-30,RTGS/ICICH18211841706/Indfor,0.0,3700000.0,,2018,7,30,CASH_IN,3700000.0,M1733424208
24357,1196428',2018-07-30,RTGS/ICICH18211842965/Indfor,0.0,1700000.0,,2018,7,30,CASH_IN,1700000.0,M1060393794
24358,1196428',2018-07-30,NEFT/SBIN218211941018/TAR,0.0,125000.0,,2018,7,30,CHECK_CASHING,125000.0,M226593165
24359,1196428',2018-07-30,NEFT/P18073071302449/M/S,0.0,25000.0,,2018,7,30,CHECK_CASHING,25000.0,M426584880
24360,1196428',2018-07-30,NEFT/SBIN318211022969/NAR,0.0,44756.0,,2018,7,30,TRANSFER,44756.0,C448155494
24361,1196428',2018-07-30,FDRL/NATIONAL ELECTRONIC F,3000000.0,0.0,,2018,7,30,DEBIT,3000000.0,M1594302764
24362,1196428',2018-07-30,FDRL/NATIONAL ELECTRONIC F,3000000.0,0.0,,2018,7,30,PAYEMENT,3000000.0,M271366306
24363,1196428',2018-07-30,NEFT/SBIN318211145868/SUR,0.0,50000.0,,2018,7,30,CASH_IN,50000.0,C348708793
24364,1196428',2018-07-30,TRF FROM  Indiaforensic SERVICES,0.0,5000000.0,,2018,7,30,TRANSFER,5000000.0,M462659391
24365,1196428',2018-07-30,FDRL/INTERNAL FUND TRANSFE,300000.0,0.0,,2018,7,30,PAYEMENT,300000.0,M547825235
24366,1196428',2018-07-30,FDRL/INTERNAL FUND TRANSFE,300000.0,0.0,,2018,7,30,PAYEMENT,300000.0,M1301971459
24367,1196428',2018-07-30,TRF FROM  Indiaforensic SERVICES,0.0,11200000.0,,2018,7,30,CHECK_CASHING,11200000.0,M1155771218
24368,1196428',2018-07-30,TRF FROM  Indiaforensic SERVICES,0.0,3000000.0,,2018,7,30,CASH_IN,3000000.0,M734120998
24369,1196428',2018-07-30,NEFT/PUNBH18211333078/PUN,0.0,100000.0,,2018,7,30,CASH_IN,100000.0,M1404561012
24370,1196428',2018-07-30,FDRL/INTERNAL FUND TRANSFE,1000000.0,0.0,,2018,7,30,DEBIT,1000000.0,M1376999853
24371,1196428',2018-07-30,FDRL/INTERNAL FUND TRANSFE,15000000.0,0.0,,2018,7,30,CASH_OUT,15000000.0,M255307196
24372,1196428',2018-07-30,FDRL/INTERNAL FUND TRANSFE,3000000.0,0.0,,2018,7,30,CASH_OUT,3000000.0,M11285367
24373,1196428',2018-07-30,BEAT CSH PKP DEL UDYO 620,0.0,288400.0,,2018,7,30,CASH_IN,288400.0,M714914851
24374,1196428',2018-07-30,CHQ DEPOSIT RETURN/704372,100.0,0.0,,2018,7,30,PAYEMENT,100.0,M1438724935
24375,1196428',2018-07-30,CHQ DEPOSIT RETURN/704372,18.0,0.0,,2018,7,30,PAYEMENT,18.0,M662472677
24376,1196428',2018-07-30,CHQ DEPOSIT RETURN/849830,100.0,0.0,,2018,7,30,CASH_OUT,100.0,M1932384587
24377,1196428',2018-07-30,CHQ DEPOSIT RETURN/849830,18.0,0.0,,2018,7,30,CASH_OUT,18.0,M719480872
24378,1196428',2018-07-30,CHQ DEPOSIT RETURN/295/CH,100.0,0.0,,2018,7,30,PAYEMENT,100.0,M1278136570
24379,1196428',2018-07-30,CHQ DEPOSIT RETURN/295/GS,18.0,0.0,,2018,7,30,PAYEMENT,18.0,M148964727
24380,1196428',2018-07-31,RTGS/SBINH18212013060/Indfor,0.0,6300000.0,,2018,7,31,CHECK_CASHING,6300000.0,M1177742051
24381,1196428',2018-07-31,FDRL/REAL TIME GROSS SETTL,7252371.81,0.0,,2018,7,31,PAYEMENT,7252371.81,M724365571
24382,1196428',2018-07-31,RTGS/SBINH18212015522/Indfor,0.0,900000.0,,2018,7,31,TRANSFER,900000.0,M212535805
24383,1196428',2018-07-31,"Indiaforensic USA, INC./USD/7922",0.0,540914.16,,2018,7,31,CASH_IN,540914.16,M1596397541
24384,1196428',2018-07-31,IRTT00701822008,871.82,0.0,,2018,7,31,DEBIT,871.82,M713285225
24385,1196428',2018-07-31,RTGS/HDFCH18212218640/Indfor,0.0,8500000.0,,2018,7,31,CASH_IN,8500000.0,C2032389005
24386,1196428',2018-07-31,NEFT/SBIN318212761516/THA,0.0,32000.0,,2018,7,31,CASH_IN,32000.0,M1156533869
24387,1196428',2018-07-31,NEFT/N212180596681085/USH,0.0,99960.0,,2018,7,31,TRANSFER,99960.0,M105292474
24388,1196428',2018-07-31,NEFT/N212180596758391/JUN,0.0,170000.0,,2018,7,31,CHECK_CASHING,170000.0,M1410438390
24389,1196428',2018-07-31,"Indiaforensic USA, INC./USD/1012",0.0,691198.44,,2018,7,31,CASH_IN,691198.44,M1257755465
24390,1196428',2018-07-31,IRTT00701822022,1007.08,0.0,,2018,7,31,CASH_OUT,1007.08,M1640401120
24391,1196428',2018-07-31,IRTT00701822024,424.17,0.0,,2018,7,31,CASH_OUT,424.17,M1399060771
24392,1196428',2018-07-31,"Indiaforensic USA, INC./USD/1051",0.0,71762.28,,2018,7,31,CASH_IN,71762.28,C1262822392
24393,1196428',2018-07-31,FDRL/INTERNAL FUND TRANSFE,200000.0,0.0,,2018,7,31,DEBIT,200000.0,M148589770
24394,1196428',2018-07-31,FDRL/INTERNAL FUND TRANSFE,400000.0,0.0,,2018,7,31,CASH_OUT,400000.0,M984489239
24395,1196428',2018-07-31,FDRL/REAL TIME GROSS SETTL,4000000.0,0.0,,2018,7,31,PAYEMENT,4000000.0,C2115055717
24396,1196428',2018-07-31,FDRL/REAL TIME GROSS SETTL,4000000.0,0.0,,2018,7,31,PAYEMENT,4000000.0,C1166654566
24397,1196428',2018-07-31,INTEX TECHNOLOGIES INDIA,1000000.0,0.0,,2018,7,31,DEBIT,1000000.0,M88042020
24398,1196428',2018-07-31,CHQ DEP/936902/OWDEL1/SBI,0.0,11800.0,,2018,7,31,CHECK_CASHING,11800.0,M717278894
24399,1196428',2018-07-31,CHQ DEP/1092/OWDEL1/HDFC/,0.0,11800.0,,2018,7,31,CHECK_CASHING,11800.0,M129220812
24400,1196428',2018-07-31,CHQ DEP/257891/OWDEL1/PUN,0.0,8000.0,,2018,7,31,CHECK_CASHING,8000.0,M1015272304
24401,1196428',2018-07-31,CHQ DEP/306/OWDEL1/PSIB/P,0.0,8000.0,,2018,7,31,TRANSFER,8000.0,C1007717381
24402,1196428',2018-07-31,CHQ DEP/311655/OWDEL1/SBI,0.0,8000.0,,2018,7,31,CASH_IN,8000.0,C1240091493
24403,1196428',2018-07-31,CHQ DEP/294131/OWDEL1/SBI,0.0,8000.0,,2018,7,31,TRANSFER,8000.0,C1396297158
24404,1196428',2018-07-31,CHQ DEP/698302/OWDEL1/PUN,0.0,11800.0,,2018,7,31,TRANSFER,11800.0,M705803524
24405,1196428',2018-07-31,CHQ DEP/681712/OWDEL1/PUN,0.0,11800.0,,2018,7,31,TRANSFER,11800.0,C978740207
24406,1196428',2018-07-31,TRF FROM  Indiaforensic SERVICES,0.0,13300000.0,,2018,7,31,CHECK_CASHING,13300000.0,C115885991
24407,1196428',2018-07-31,FDRL/REAL TIME GROSS SETTL,4000000.0,0.0,,2018,7,31,DEBIT,4000000.0,C587433505
24408,1196428',2018-07-31,FDRL/REAL TIME GROSS SETTL,10000000.0,0.0,,2018,7,31,PAYEMENT,10000000.0,C1637186972
24409,1196428',2018-07-31,RTGS/UCBAH18212021211/BHA,0.0,300000.0,,2018,7,31,TRANSFER,300000.0,M190739308
24410,1196428',2018-07-31,NEFT/N212180596951793/BAT,0.0,70000.0,,2018,7,31,CASH_IN,70000.0,C778306577
24411,1196428',2018-07-31,IB:TPFT0074109711 3090027,0.0,1000.0,,2018,7,31,CASH_IN,1000.0,M1863711975
24412,1196428',2018-07-31,NEFT/P18073171795150/M/S,0.0,25000.0,,2018,7,31,CHECK_CASHING,25000.0,M1469855297
24413,1196428',2018-07-31,FDRL/REAL TIME GROSS SETTL,1000000.0,0.0,,2018,7,31,PAYEMENT,1000000.0,M794421806
24414,1196428',2018-07-31,NEFT/P18073178340532/PRAB,0.0,11800.0,,2018,7,31,TRANSFER,11800.0,M1334051844
24415,1196428',2018-07-31,Indiaforensic SERVICES INDIA PVT,0.0,634801.0,,2018,7,31,CASH_IN,634801.0,M515450283
24416,1196428',2018-07-31,IMPS 821216392236 FROM AS,0.0,100090.0,,2018,7,31,CASH_IN,100090.0,M1747790771
24417,1196428',2018-07-31,FDRL/NATIONAL ELECTRONIC F,2500.0,0.0,,2018,7,31,CASH_OUT,2500.0,M1284135884
24418,1196428',2018-07-31,FDRL/NATIONAL ELECTRONIC F,2000.0,0.0,,2018,7,31,PAYEMENT,2000.0,C420561530
24419,1196428',2018-07-31,FDRL/NATIONAL ELECTRONIC F,2500.0,0.0,,2018,7,31,PAYEMENT,2500.0,M694158341
24420,1196428',2018-07-31,FDRL/NATIONAL ELECTRONIC F,2000.0,0.0,,2018,7,31,CASH_OUT,2000.0,C2046578329
24421,1196428',2018-07-31,FDRL/NATIONAL ELECTRONIC F,2500.0,0.0,,2018,7,31,PAYEMENT,2500.0,M942812964
24422,1196428',2018-07-31,FDRL/NATIONAL ELECTRONIC F,2500.0,0.0,,2018,7,31,CHECK_WITHDRAWAL,2500.0,M1977844832
24423,1196428',2018-07-31,FDRL/NATIONAL ELECTRONIC F,2500.0,0.0,,2018,7,31,PAYEMENT,2500.0,M1171276229
24424,1196428',2018-07-31,FDRL/NATIONAL ELECTRONIC F,5000.0,0.0,,2018,7,31,CASH_OUT,5000.0,M1741253456
24425,1196428',2018-07-31,FDRL/NATIONAL ELECTRONIC F,3000.0,0.0,,2018,7,31,CASH_OUT,3000.0,M1549630173
24426,1196428',2018-07-31,FDRL/NATIONAL ELECTRONIC F,2000.0,0.0,,2018,7,31,CASH_OUT,2000.0,C1548218207
24427,1196428',2018-07-31,FDRL/NATIONAL ELECTRONIC F,3000.0,0.0,,2018,7,31,CHECK_WITHDRAWAL,3000.0,C242559404
24428,1196428',2018-07-31,FDRL/NATIONAL ELECTRONIC F,2500.0,0.0,,2018,7,31,CHECK_WITHDRAWAL,2500.0,C1153596299
24429,1196428',2018-07-31,FDRL/NATIONAL ELECTRONIC F,2000.0,0.0,,2018,7,31,PAYEMENT,2000.0,M708011911
24430,1196428',2018-07-31,FDRL/NATIONAL ELECTRONIC F,2500.0,0.0,,2018,7,31,DEBIT,2500.0,M1579526490
24431,1196428',2018-07-31,FDRL/NATIONAL ELECTRONIC F,2500.0,0.0,,2018,7,31,CHECK_WITHDRAWAL,2500.0,C1924874046
24432,1196428',2018-07-31,FDRL/NATIONAL ELECTRONIC F,2500.0,0.0,,2018,7,31,CHECK_WITHDRAWAL,2500.0,C1079343872
24433,1196428',2018-07-31,FDRL/NATIONAL ELECTRONIC F,2500.0,0.0,,2018,7,31,DEBIT,2500.0,M1025387324
24434,1196428',2018-07-31,FDRL/NATIONAL ELECTRONIC F,2500.0,0.0,,2018,7,31,DEBIT,2500.0,M2114990234
24435,1196428',2018-07-31,FDRL/NATIONAL ELECTRONIC F,2000.0,0.0,,2018,7,31,CASH_OUT,2000.0,M1843420945
24436,1196428',2018-07-31,FDRL/NATIONAL ELECTRONIC F,3000.0,0.0,,2018,7,31,CASH_OUT,3000.0,C863811613
24437,1196428',2018-07-31,FDRL/NATIONAL ELECTRONIC F,5000.0,0.0,,2018,7,31,CASH_OUT,5000.0,M1539382844
24438,1196428',2018-07-31,FDRL/NATIONAL ELECTRONIC F,5000.0,0.0,,2018,7,31,CASH_OUT,5000.0,M1846768700
24439,1196428',2018-07-31,FDRL/NATIONAL ELECTRONIC F,2500.0,0.0,,2018,7,31,PAYEMENT,2500.0,C1640747200
24440,1196428',2018-07-31,FDRL/NATIONAL ELECTRONIC F,3000.0,0.0,,2018,7,31,CHECK_WITHDRAWAL,3000.0,M1099038981
24441,1196428',2018-07-31,FDRL/NATIONAL ELECTRONIC F,249351.0,0.0,,2018,7,31,CHECK_WITHDRAWAL,249351.0,C344610846
24442,1196428',2018-07-31,NEFT/IOBAN18212593158/K,0.0,2500.0,,2018,7,31,TRANSFER,2500.0,C1919277981
24443,1196428',2018-07-31,NEFT/IOBAN18212596448/K A,0.0,2500.0,,2018,7,31,CHECK_CASHING,2500.0,C2104652067
24444,1196428',2018-07-31,TRF FRM  Indiaforensic SERVICES,0.0,9900000.0,,2018,7,31,CHECK_CASHING,9900000.0,C1092465037
24445,1196428',2018-07-31,NEFT/000049778784/Indiaforensic,0.0,2700000.0,,2018,7,31,CASH_IN,2700000.0,M995633719
24446,1196428',2018-07-31,NEFT/000049778292/Indiaforensic,0.0,1300000.0,,2018,7,31,TRANSFER,1300000.0,M938465080
24447,1196428',2018-07-31,FDRL/INTERNAL FUND TRANSFE,200000.0,0.0,,2018,7,31,PAYEMENT,200000.0,M1834981639
24448,1196428',2018-07-31,FDRL/INTERNAL FUND TRANSFE,400000.0,0.0,,2018,7,31,CHECK_WITHDRAWAL,400000.0,M1775303360
24449,1196428',2018-07-31,FDRL/INTERNAL FUND TRANSFE,300000.0,0.0,,2018,7,31,CASH_OUT,300000.0,M261084274
24450,1196428',2018-07-31,BEAT CSH PKP DEL UDYO 620,0.0,79000.0,,2018,7,31,CHECK_CASHING,79000.0,M1007295516
24451,1196428',2018-07-31,FDRL/INTERNAL FUND TRANSFE,3000000.0,0.0,,2018,7,31,PAYEMENT,3000000.0,M470234716
24452,1196428',2018-07-31,FDRL/INTERNAL FUND TRANSFE,3000000.0,0.0,,2018,7,31,DEBIT,3000000.0,M905290562
24453,1196428',2018-07-31,FDRL/INTERNAL FUND TRANSFE,3000000.0,0.0,,2018,7,31,CASH_OUT,3000000.0,M798935213
24454,1196428',2018-07-31,1196428:Int.Coll:01-07-20,954623.0,0.0,,2018,7,31,CASH_OUT,954623.0,M1932154134
24455,1196428',2018-08-01,NEFT/SBIN518213089708/NAR,0.0,34981.0,,2018,8,1,TRANSFER,34981.0,M1426777731
24456,1196428',2018-08-01,RTGS/SBINH18213005054/Indfor,0.0,7000000.0,,2018,8,1,TRANSFER,7000000.0,M2001931511
24457,1196428',2018-08-01,FDRL/REAL TIME GROSS SETTL,10574065.9,0.0,,2018,8,1,DEBIT,10574065.9,M1028639221
24458,1196428',2018-08-01,NEFT/CBINH18213110015/R K,0.0,11800.0,,2018,8,1,CASH_IN,11800.0,M129965176
24459,1196428',2018-08-01,CHQ DEP/950121/OWDEL1/PUN,0.0,8000.0,,2018,8,1,CASH_IN,8000.0,M1666930496
24460,1196428',2018-08-01,CHQ DEP/1842/OWDEL1/SCBL/,0.0,50000.0,,2018,8,1,CHECK_CASHING,50000.0,M1348049534
24461,1196428',2018-08-01,CHQ DEP/13012/OWDEL1/ORBC,0.0,11800.0,,2018,8,1,CASH_IN,11800.0,M149861385
24462,1196428',2018-08-01,CHQ DEP/528044/OWDEL1/PUN,0.0,11800.0,,2018,8,1,CHECK_CASHING,11800.0,M1803845616
24463,1196428',2018-08-01,CHQ DEP/38822/OWDEL1/BKID,0.0,11800.0,,2018,8,1,TRANSFER,11800.0,M396463835
24464,1196428',2018-08-01,CHQ DEP/68/OWDEL1/HDFC/BI,0.0,11800.0,,2018,8,1,CHECK_CASHING,11800.0,M1022045468
24465,1196428',2018-08-01,CHQ DEP/176/OWDEL1/HDFC/S,0.0,11800.0,,2018,8,1,TRANSFER,11800.0,M1556446144
24466,1196428',2018-08-01,CHQ DEP/202/OWDEL1/HDFC/S,0.0,11800.0,,2018,8,1,TRANSFER,11800.0,M141959252
24467,1196428',2018-08-01,CHQ DEP/362/OWDEL1/HDFC/,0.0,11800.0,,2018,8,1,CHECK_CASHING,11800.0,M1997459283
24468,1196428',2018-08-01,CHQ DEP/988470/OWDEL1/SBI,0.0,11800.0,,2018,8,1,CASH_IN,11800.0,M539292855
24469,1196428',2018-08-01,CHQ DEP/297/OWDEL1/HDFC/B,0.0,11800.0,,2018,8,1,CHECK_CASHING,11800.0,M878266233
24470,1196428',2018-08-01,CHQ DEP/215/OWDEL1/HDFC/B,0.0,11800.0,,2018,8,1,CASH_IN,11800.0,M1660780699
24471,1196428',2018-08-01,CHQ DEP/114151/OWDEL1/SBI,0.0,11800.0,,2018,8,1,CHECK_CASHING,11800.0,M1242431450
24472,1196428',2018-08-01,CHQ DEP/58/OWDEL1/PSIB/IB,0.0,11800.0,,2018,8,1,CHECK_CASHING,11800.0,M2075133206
24473,1196428',2018-08-01,CHQ DEP/410354/OWDEL1/SBI,0.0,11800.0,,2018,8,1,CHECK_CASHING,11800.0,M1651383848
24474,1196428',2018-08-01,TRF FROM  Indiaforensic SERVICES,0.0,4000000.0,,2018,8,1,CASH_IN,4000000.0,M1364290623
24475,1196428',2018-08-01,TRF FROM  Indiaforensic SERVICES,0.0,10000000.0,,2018,8,1,CASH_IN,10000000.0,M1119145556
24476,1196428',2018-08-01,NEFT/P18080172247281/M/S,0.0,25000.0,,2018,8,1,CHECK_CASHING,25000.0,M552762676
24477,1196428',2018-08-01,FDRL/REAL TIME GROSS SETTL,1000000.0,0.0,,2018,8,1,CHECK_WITHDRAWAL,1000000.0,M1549335447
24478,1196428',2018-08-01,FDRL/REAL TIME GROSS SETTL,10000000.0,0.0,,2018,8,1,CHECK_WITHDRAWAL,10000000.0,M1407332998
24479,1196428',2018-08-01,FDRL/REAL TIME GROSS SETTL,1000000.0,0.0,,2018,8,1,PAYEMENT,1000000.0,M575173490
24480,1196428',2018-08-01,FDRL/REAL TIME GROSS SETTL,1000000.0,0.0,,2018,8,1,CASH_OUT,1000000.0,M1463959599
24481,1196428',2018-08-01,FDRL/INTERNAL FUND TRANSFE,300000.0,0.0,,2018,8,1,CASH_OUT,300000.0,C191614132
24482,1196428',2018-08-01,FDRL/INTERNAL FUND TRANSFE,300000.0,0.0,,2018,8,1,PAYEMENT,300000.0,C1885712019
24483,1196428',2018-08-01,IMPS 821315375819 FROM SA,0.0,50000.0,,2018,8,1,TRANSFER,50000.0,M1406881784
24484,1196428',2018-08-01,CHQ DEPOSIT RETURN/13012/,11800.0,0.0,,2018,8,1,CHECK_WITHDRAWAL,11800.0,C1161865950
24485,1196428',2018-08-01,CHQ DEPOSIT RETURN/528044,11800.0,0.0,,2018,8,1,DEBIT,11800.0,M1558051277
24486,1196428',2018-08-01,CHQ DEPOSIT RETURN/58/FUN,11800.0,0.0,,2018,8,1,PAYEMENT,11800.0,M1173085824
24487,1196428',2018-08-01,CHQ DEPOSIT RETURN/950121,8000.0,0.0,,2018,8,1,CHECK_WITHDRAWAL,8000.0,M569018137
24488,1196428',2018-08-01,Indiaforensic SERVICES INDIA PVT,0.0,190416.0,,2018,8,1,TRANSFER,190416.0,M1770271962
24489,1196428',2018-08-01,NEFT/AXISP00005568327/ACC,0.0,2000000.0,,2018,8,1,CHECK_CASHING,2000000.0,M1586738337
24490,1196428',2018-08-01,NEFT/N213180599021728/BAT,0.0,240000.0,,2018,8,1,CHECK_CASHING,240000.0,M1674738101
24491,1196428',2018-08-01,NEFT/000049847870/Indiaforensic,0.0,1300000.0,,2018,8,1,CASH_IN,1300000.0,C1590550415
24492,1196428',2018-08-01,NEFT/000049847708/Indiaforensic,0.0,2000000.0,,2018,8,1,TRANSFER,2000000.0,C705321061
24493,1196428',2018-08-01,TRF FRM  Indiaforensic SERVICES,0.0,1600000.0,,2018,8,1,CASH_IN,1600000.0,M873689156
24494,1196428',2018-08-01,BEAT CSH PKP DEL UDYO 620,0.0,85000.0,,2018,8,1,TRANSFER,85000.0,M1538317866
24495,1196428',2018-08-01,TRF FRM  Indiaforensic SERVICES,0.0,4000000.0,,2018,8,1,TRANSFER,4000000.0,C262828207
24496,1196428',2018-08-01,TRF FRM  Indiaforensic SERVICES,0.0,2000000.0,,2018,8,1,CASH_IN,2000000.0,C1222590577
24497,1196428',2018-08-01,TRF FRM  Indiaforensic SERVICES,0.0,500000.0,,2018,8,1,CASH_IN,500000.0,M2089852906
24498,1196428',2018-08-01,FDRL/INTERNAL FUND TRANSFE,5000000.0,0.0,,2018,8,1,CHECK_WITHDRAWAL,5000000.0,M629502621
24499,1196428',2018-08-01,FDRL/INTERNAL FUND TRANSFE,5000000.0,0.0,,2018,8,1,DEBIT,5000000.0,M511596806
24500,1196428',2018-08-01,FDRL/INTERNAL FUND TRANSFE,3000000.0,0.0,,2018,8,1,CASH_OUT,3000000.0,M2079635991
24501,1196428',2018-08-01,FDRL/INTERNAL FUND TRANSFE,300000.0,0.0,,2018,8,1,CHECK_WITHDRAWAL,300000.0,M1044456366
24502,1196428',2018-08-01,CHQ DEPOSIT RETURN/13012/,100.0,0.0,,2018,8,1,CASH_OUT,100.0,C1689840534
24503,1196428',2018-08-01,CHQ DEPOSIT RETURN/13012/,18.0,0.0,,2018,8,1,PAYEMENT,18.0,M1092817314
24504,1196428',2018-08-01,CHQ DEPOSIT RETURN/528044,100.0,0.0,,2018,8,1,DEBIT,100.0,C1475909248
24505,1196428',2018-08-01,CHQ DEPOSIT RETURN/528044,18.0,0.0,,2018,8,1,CASH_OUT,18.0,M2040472550
24506,1196428',2018-08-01,CHQ DEPOSIT RETURN/58/CHA,100.0,0.0,,2018,8,1,CHECK_WITHDRAWAL,100.0,C979719862
24507,1196428',2018-08-01,CHQ DEPOSIT RETURN/58/GST,18.0,0.0,,2018,8,1,CHECK_WITHDRAWAL,18.0,C985934102
24508,1196428',2018-08-02,NEFT/SBIN618214343653/NAR,0.0,41273.0,,2018,8,2,CASH_IN,41273.0,C731253803
24509,1196428',2018-08-02,FDRL/INTERNAL FUND TRANSFE,300000.0,0.0,,2018,8,2,DEBIT,300000.0,C1609562230
24510,1196428',2018-08-02,RTGS/SBINH18214004033/Indfor,0.0,7000000.0,,2018,8,2,TRANSFER,7000000.0,M1076923640
24511,1196428',2018-08-02,FDRL/REAL TIME GROSS SETTL,8076487.26,0.0,,2018,8,2,PAYEMENT,8076487.26,M1144262832
24512,1196428',2018-08-02,IMPS 821411913800 FROM SA,0.0,25000.0,,2018,8,2,CASH_IN,25000.0,M942922351
24513,1196428',2018-08-02,IMPS 821411393002 FROM AS,0.0,100085.0,,2018,8,2,CASH_IN,100085.0,M1582038853
24514,1196428',2018-08-02,FDRL/INTERNAL FUND TRANSFE,400000.0,0.0,,2018,8,2,CHECK_WITHDRAWAL,400000.0,M36034212
24515,1196428',2018-08-02,NEFT/SBIN618214501708/HAR,0.0,29120.0,,2018,8,2,CHECK_CASHING,29120.0,M1326356346
24516,1196428',2018-08-02,CHQ DEP/694665/OWDEL3/PUN,0.0,11800.0,,2018,8,2,CASH_IN,11800.0,C27489818
24517,1196428',2018-08-02,CHQ DEP/327619/OWDEL3/UCB,0.0,11800.0,,2018,8,2,CHECK_CASHING,11800.0,C747979499
24518,1196428',2018-08-02,CHQ DEP/144477/OWDEL3/SBI,0.0,8000.0,,2018,8,2,TRANSFER,8000.0,C1660095722
24519,1196428',2018-08-02,NEFT/SBIN618214512923/THA,0.0,35000.0,,2018,8,2,CHECK_CASHING,35000.0,C372017580
24520,1196428',2018-08-02,RTGS/PUNBH18214871861/MAN,0.0,400000.0,,2018,8,2,TRANSFER,400000.0,M370179552
24521,1196428',2018-08-02,CASHDEP/BOISAR/,0.0,4000.0,,2018,8,2,CHECK_CASHING,4000.0,C802935635
24522,1196428',2018-08-02,CHQ DEPOSIT RETURN/144477,8000.0,0.0,,2018,8,2,CASH_OUT,8000.0,M1523086740
24523,1196428',2018-08-02,FDRL/NATIONAL ELECTRONIC F,373996.0,0.0,,2018,8,2,CHECK_WITHDRAWAL,373996.0,M902885640
24524,1196428',2018-08-02,CHQ DEP/189677/OWDEL1/SBI,0.0,11800.0,,2018,8,2,CHECK_CASHING,11800.0,C459172227
24525,1196428',2018-08-02,TRF FRM  Indiaforensic SERVICES,0.0,14600000.0,,2018,8,2,TRANSFER,14600000.0,C265108079
24526,1196428',2018-08-02,FDRL/REAL TIME GROSS SETTL,4000000.0,0.0,,2018,8,2,PAYEMENT,4000000.0,C35126588
24527,1196428',2018-08-02,FDRL/REAL TIME GROSS SETTL,4000000.0,0.0,,2018,8,2,PAYEMENT,4000000.0,C1589477624
24528,1196428',2018-08-02,FDRL/INTERNAL FUND TRANSFE,500000.0,0.0,,2018,8,2,CASH_OUT,500000.0,C1283595719
24529,1196428',2018-08-02,IMPS 821416192448 FROM PU,0.0,32000.0,,2018,8,2,CASH_IN,32000.0,C101084405
24530,1196428',2018-08-02,CASHDEP/GHATKOPAR/,0.0,62000.0,,2018,8,2,CHECK_CASHING,62000.0,M7891579
24531,1196428',2018-08-02,RTGS/PUNBH18214883998/PUN,0.0,300000.0,,2018,8,2,CHECK_CASHING,300000.0,M150228660
24532,1196428',2018-08-02,NEFT/SBIN618214855923/NAR,0.0,65937.0,,2018,8,2,CASH_IN,65937.0,M190019040
24533,1196428',2018-08-02,FDRL/NATIONAL ELECTRONIC F,2000000.0,0.0,,2018,8,2,DEBIT,2000000.0,M1462909495
24534,1196428',2018-08-02,FDRL/NATIONAL ELECTRONIC F,3000000.0,0.0,,2018,8,2,DEBIT,3000000.0,C1192983708
24535,1196428',2018-08-02,NEFT/AXISP00005744948/ACC,0.0,3000000.0,,2018,8,2,CHECK_CASHING,3000000.0,M1730398598
24536,1196428',2018-08-02,TRF FRM  Indiaforensic SERVICES,0.0,7200000.0,,2018,8,2,CASH_IN,7200000.0,M1492635498
24537,1196428',2018-08-02,NEFT/000049917157/Indiaforensic,0.0,500000.0,,2018,8,2,CASH_IN,500000.0,M738483886
24538,1196428',2018-08-02,NEFT/000049917061/Indiaforensic,0.0,1300000.0,,2018,8,2,TRANSFER,1300000.0,M1583014678
24539,1196428',2018-08-02,FDRL/INTERNAL FUND TRANSFE,400000.0,0.0,,2018,8,2,CASH_OUT,400000.0,C395114097
24540,1196428',2018-08-02,FDRL/INTERNAL FUND TRANSFE,300000.0,0.0,,2018,8,2,CHECK_WITHDRAWAL,300000.0,M743943553
24541,1196428',2018-08-02,FDRL/INTERNAL FUND TRANSFE,6000000.0,0.0,,2018,8,2,PAYEMENT,6000000.0,M2034445578
24542,1196428',2018-08-02,FDRL/INTERNAL FUND TRANSFE,300000.0,0.0,,2018,8,2,PAYEMENT,300000.0,C1383942363
24543,1196428',2018-08-02,BEAT CSH PKP DEL UDYO 620,0.0,60000.0,,2018,8,2,CASH_IN,60000.0,M72285092
24544,1196428',2018-08-02,CHQ DEPOSIT RETURN/144477,100.0,0.0,,2018,8,2,DEBIT,100.0,M586185216
24545,1196428',2018-08-02,CHQ DEPOSIT RETURN/144477,18.0,0.0,,2018,8,2,PAYEMENT,18.0,M1378755468
24546,1196428',2018-08-03,NEFT/SBIN718214186072/M S,0.0,136000.0,,2018,8,3,CHECK_CASHING,136000.0,C765980478
24547,1196428',2018-08-03,FDRL/INTERNAL FUND TRANSFE,100000.0,0.0,,2018,8,3,PAYEMENT,100000.0,C1200314947
24548,1196428',2018-08-03,FDRL/INTERNAL FUND TRANSFE,200000.0,0.0,,2018,8,3,DEBIT,200000.0,C1973491942
24549,1196428',2018-08-03,FDRL/INTERNAL FUND TRANSFE,200000.0,0.0,,2018,8,3,DEBIT,200000.0,C1689374891
24550,1196428',2018-08-03,FDRL/INTERNAL FUND TRANSFE,100000.0,0.0,,2018,8,3,CASH_OUT,100000.0,C2053639017
24551,1196428',2018-08-03,FDRL/INTERNAL FUND TRANSFE,200000.0,0.0,,2018,8,3,CHECK_WITHDRAWAL,200000.0,C1654056127
24552,1196428',2018-08-03,RTGS/PUNBH18215885514/BAL,0.0,200000.0,,2018,8,3,TRANSFER,200000.0,C803368825
24553,1196428',2018-08-03,RTGS/SBINH18215006098/Indfor,0.0,5000000.0,,2018,8,3,CHECK_CASHING,5000000.0,C892686452
24554,1196428',2018-08-03,FDRL/REAL TIME GROSS SETTL,10125009.32,0.0,,2018,8,3,PAYEMENT,10125009.32,C2031563133
24555,1196428',2018-08-03,NEFT/N215180600479777/ESS,0.0,100000.0,,2018,8,3,TRANSFER,100000.0,C1619402333
24556,1196428',2018-08-03,TRF FROM  Indiaforensic SERVICES,0.0,3000000.0,,2018,8,3,TRANSFER,3000000.0,C1149273771
24557,1196428',2018-08-03,FDRL/REAL TIME GROSS SETTL,4000000.0,0.0,,2018,8,3,DEBIT,4000000.0,C2109470512
24558,1196428',2018-08-03,FDRL/INTERNAL FUND TRANSFE,200000.0,0.0,,2018,8,3,CHECK_WITHDRAWAL,200000.0,C1059781259
24559,1196428',2018-08-03,RTGS/HDFCH18215749345/BAT,0.0,200000.0,,2018,8,3,CASH_IN,200000.0,C125722707
24560,1196428',2018-08-03,NEFT/SBIN718215375877/M R,0.0,100000.0,,2018,8,3,TRANSFER,100000.0,C1778300121
24561,1196428',2018-08-03,Indiaforensic SERVICES INDIA PVT,0.0,193585.0,,2018,8,3,CASH_IN,193585.0,C313124964
24562,1196428',2018-08-03,FDRL/INTERNAL FUND TRANSFE,500000.0,0.0,,2018,8,3,CASH_OUT,500000.0,C1220897602
24563,1196428',2018-08-03,NEFT/P18080373074172/M/S,0.0,25000.0,,2018,8,3,CHECK_CASHING,25000.0,C1515704208
24564,1196428',2018-08-03,NEFT/20643776021DC/ARTHAS,0.0,25000.0,,2018,8,3,CHECK_CASHING,25000.0,C1313534832
24565,1196428',2018-08-03,TRF FRM  Indiaforensic SERVICES,0.0,15000000.0,,2018,8,3,CHECK_CASHING,15000000.0,C1141137903
24566,1196428',2018-08-03,NEFT/N215180600728991/USH,0.0,158490.0,,2018,8,3,CASH_IN,158490.0,C1869228744
24567,1196428',2018-08-03,FDRL/REAL TIME GROSS SETTL,15000000.0,0.0,,2018,8,3,DEBIT,15000000.0,C2078250226
24568,1196428',2018-08-03,NEFT/SBIN718215605956/NAR,0.0,58973.0,,2018,8,3,CHECK_CASHING,58973.0,C1300519073
24569,1196428',2018-08-03,RTGS/HDFCH18215799032/JUN,0.0,200000.0,,2018,8,3,TRANSFER,200000.0,M1808484670
24570,1196428',2018-08-03,RTGS/PUNBH18215898062/PUN,0.0,400000.0,,2018,8,3,TRANSFER,400000.0,M829035073
24571,1196428',2018-08-03,RTGS/PSIBH18215165387/SAI,0.0,300000.0,,2018,8,3,CASH_IN,300000.0,M1674174327
24572,1196428',2018-08-03,FDRL/REAL TIME GROSS SETTL,1000000.0,0.0,,2018,8,3,PAYEMENT,1000000.0,M2135203084
24573,1196428',2018-08-03,NEFT/AXISP00005881723/ACC,0.0,10000000.0,,2018,8,3,TRANSFER,10000000.0,C1673971173
24574,1196428',2018-08-03,FDRL/NATIONAL ELECTRONIC F,3000000.0,0.0,,2018,8,3,CASH_OUT,3000000.0,C339099861
24575,1196428',2018-08-03,FDRL/NATIONAL ELECTRONIC F,3000000.0,0.0,,2018,8,3,DEBIT,3000000.0,M2045422556
24576,1196428',2018-08-03,FDRL/NATIONAL ELECTRONIC F,2000000.0,0.0,,2018,8,3,PAYEMENT,2000000.0,C1266035080
24577,1196428',2018-08-03,FDRL/NATIONAL ELECTRONIC F,2000000.0,0.0,,2018,8,3,PAYEMENT,2000000.0,C1060041730
24578,1196428',2018-08-03,CASHDEP/GHATKOPAR/,0.0,28000.0,,2018,8,3,CHECK_CASHING,28000.0,C1475395523
24579,1196428',2018-08-03,FDRL/INTERNAL FUND TRANSFE,200000.0,0.0,,2018,8,3,DEBIT,200000.0,C265845794
24580,1196428',2018-08-03,TRF FRM  Indiaforensic SERVICES,0.0,8500000.0,,2018,8,3,TRANSFER,8500000.0,C58091972
24581,1196428',2018-08-03,TRF FRM  Indiaforensic SERVICES,0.0,300000.0,,2018,8,3,TRANSFER,300000.0,C193864812
24582,1196428',2018-08-03,NEFT/N215180601142543/TEC,0.0,100000.0,,2018,8,3,CASH_IN,100000.0,C681835572
24583,1196428',2018-08-03,NEFT/000049985851/Indiaforensic,0.0,1600000.0,,2018,8,3,TRANSFER,1600000.0,C965197768
24584,1196428',2018-08-03,FDRL/INTERNAL FUND TRANSFE,500000.0,0.0,,2018,8,3,CHECK_WITHDRAWAL,500000.0,C893038039
24585,1196428',2018-08-03,NEFT/000049986142/Indiaforensic,0.0,1800000.0,,2018,8,3,TRANSFER,1800000.0,C1317731757
24586,1196428',2018-08-03,FDRL/INTERNAL FUND TRANSFE,7000000.0,0.0,,2018,8,3,CASH_OUT,7000000.0,C1373467808
24587,1196428',2018-08-03,FDRL/INTERNAL FUND TRANSFE,2000000.0,0.0,,2018,8,3,DEBIT,2000000.0,C1318822808
24588,1196428',2018-08-03,Indiaforensic USA  INC/USD/7019/,0.0,479748.65,,2018,8,3,CHECK_CASHING,479748.65,C1424731356
24589,1196428',2018-08-03,IRTT00701822654,816.77,0.0,,2018,8,3,CASH_OUT,816.77,C1439007204
24590,1196428',2018-08-04,NEFT/SBIN818216371969/NAR,0.0,51973.0,,2018,8,4,CHECK_CASHING,51973.0,C1116292004
24591,1196428',2018-08-04,Indiaforensic SERVICES INDIA PVT,0.0,234241.0,,2018,8,4,CASH_IN,234241.0,C638551812
24592,1196428',2018-08-04,RTGS/SBINH18216009561/Indfor,0.0,6000000.0,,2018,8,4,CHECK_CASHING,6000000.0,C193826743
24593,1196428',2018-08-04,RTGS/HDFCH18216882890/BAT,0.0,200000.0,,2018,8,4,CHECK_CASHING,200000.0,C309167705
24594,1196428',2018-08-04,FDRL/INTERNAL FUND TRANSFE,500000.0,0.0,,2018,8,4,PAYEMENT,500000.0,C811597470
24595,1196428',2018-08-04,FDRL/INTERNAL FUND TRANSFE,500000.0,0.0,,2018,8,4,CHECK_WITHDRAWAL,500000.0,C1014923261
24596,1196428',2018-08-04,NEFT/PUNBH18216251456/BAL,0.0,150000.0,,2018,8,4,CHECK_CASHING,150000.0,C925574515
24597,1196428',2018-08-04,CHQ DEP/958756/OWDEL1/PUN,0.0,11800.0,,2018,8,4,CHECK_CASHING,11800.0,C1988152146
24598,1196428',2018-08-04,CHQ DEP/164224/OWDEL1/SBI,0.0,11800.0,,2018,8,4,TRANSFER,11800.0,C71555810
24599,1196428',2018-08-04,RTGS/UTIBH18216629228/Indfor,0.0,4500000.0,,2018,8,4,CASH_IN,4500000.0,C1273939873
24600,1196428',2018-08-04,FDRL/REAL TIME GROSS SETTL,13389116.89,0.0,,2018,8,4,CASH_OUT,13389116.89,C749672494
24601,1196428',2018-08-04,TRF FROM  Indiaforensic SERVICES,0.0,15000000.0,,2018,8,4,CHECK_CASHING,15000000.0,C1504109395
24602,1196428',2018-08-04,RTGS/PUNBH18216910189/MAN,0.0,200000.0,,2018,8,4,CHECK_CASHING,200000.0,C2107268831
24603,1196428',2018-08-04,IMPS 821613155396 FROM PU,0.0,26000.0,,2018,8,4,CHECK_CASHING,26000.0,C1141137903
24604,1196428',2018-08-04,FDRL/REAL TIME GROSS SETTL,15000000.0,0.0,,2018,8,4,CHECK_WITHDRAWAL,15000000.0,M492166970
24605,1196428',2018-08-04,NEFT/AXISP00006046498/ACC,0.0,4000000.0,,2018,8,4,CASH_IN,4000000.0,C762570948
24606,1196428',2018-08-04,NEFT/AXISP00006046497/ACC,0.0,2000000.0,,2018,8,4,TRANSFER,2000000.0,C1440282299
24607,1196428',2018-08-04,RTGS/ICICH18216722776/Indfor,0.0,1000000.0,,2018,8,4,CASH_IN,1000000.0,M1583639547
24608,1196428',2018-08-04,FDRL/REAL TIME GROSS SETTL,5000000.0,0.0,,2018,8,4,CASH_OUT,5000000.0,M1476691574
24609,1196428',2018-08-04,NEFT/P18080473549930/M/S,0.0,50000.0,,2018,8,4,CHECK_CASHING,50000.0,C893339434
24610,1196428',2018-08-04,RTGS/ICICH18216722021/Indfor,0.0,1000000.0,,2018,8,4,TRANSFER,1000000.0,M722806861
24611,1196428',2018-08-04,NEFT/SBIN818216875967/MS,0.0,100000.0,,2018,8,4,CASH_IN,100000.0,C1150610696
24612,1196428',2018-08-04,NEFT/N216180601921838/USH,0.0,170500.0,,2018,8,4,CASH_IN,170500.0,C1674899618
24613,1196428',2018-08-04,TRF FROM  Indiaforensic SERVICES,0.0,4000000.0,,2018,8,4,CASH_IN,4000000.0,M481126602
24614,1196428',2018-08-04,TRF FROM  Indiaforensic SERVICES,0.0,2000000.0,,2018,8,4,CHECK_CASHING,2000000.0,C1793325972
24615,1196428',2018-08-04,TRF FROM  Indiaforensic SERVICES,0.0,500000.0,,2018,8,4,CASH_IN,500000.0,M132360639
24616,1196428',2018-08-04,TRF FROM  Indiaforensic SERVICES,0.0,500000.0,,2018,8,4,TRANSFER,500000.0,M2052092920
24617,1196428',2018-08-04,FDRL/INTERNAL FUND TRANSFE,300000.0,0.0,,2018,8,4,CHECK_WITHDRAWAL,300000.0,M236650472
24618,1196428',2018-08-04,BEAT CSH PKP DEL UDYO 620,0.0,89700.0,,2018,8,4,TRANSFER,89700.0,M2089634452
24619,1196428',2018-08-04,FDRL/INTERNAL FUND TRANSFE,6000000.0,0.0,,2018,8,4,DEBIT,6000000.0,M1097809105
24620,1196428',2018-08-04,FDRL/INTERNAL FUND TRANSFE,4000000.0,0.0,,2018,8,4,PAYEMENT,4000000.0,C302025300
24621,1196428',2018-08-04,FDRL/INTERNAL FUND TRANSFE,400000.0,0.0,,2018,8,4,CASH_OUT,400000.0,M134742492
24622,1196428',2018-08-06,NEFT/PUNBH18218434313/BAL,0.0,100000.0,,2018,8,6,TRANSFER,100000.0,C1511785794
24623,1196428',2018-08-06,CASHDEP/GHATKOPAR/,0.0,99000.0,,2018,8,6,CHECK_CASHING,99000.0,M1604293868
24624,1196428',2018-08-06,NEFT/N218180602268121/TEC,0.0,200000.0,,2018,8,6,TRANSFER,200000.0,M1853641629
24625,1196428',2018-08-06,RTGS/SBINH18218005340/Indfor,0.0,14900000.0,,2018,8,6,CASH_IN,14900000.0,M710600916
24626,1196428',2018-08-06,FDRL/REAL TIME GROSS SETTL,5719508.11,0.0,,2018,8,6,PAYEMENT,5719508.11,M985323561
24627,1196428',2018-08-06,FDRL/REAL TIME GROSS SETTL,9051076.42,0.0,,2018,8,6,CASH_OUT,9051076.42,M1194715097
24628,1196428',2018-08-06,RTGS/HDFCH18218020402/JUN,0.0,250000.0,,2018,8,6,CASH_IN,250000.0,M693684695
24629,1196428',2018-08-06,CHQ DEP/893834/OWDEL1/SBI,0.0,11800.0,,2018,8,6,CHECK_CASHING,11800.0,M1582319135
24630,1196428',2018-08-06,CHQ DEP/361738/OWDEL1/SBI,0.0,11800.0,,2018,8,6,CHECK_CASHING,11800.0,M227290600
24631,1196428',2018-08-06,CHQ DEP/820531/OWDEL1/UCB,0.0,11800.0,,2018,8,6,CASH_IN,11800.0,M2089806029
24632,1196428',2018-08-06,CHQ DEP/752103/OWDEL1/PUN,0.0,11800.0,,2018,8,6,CASH_IN,11800.0,M1477278751
24633,1196428',2018-08-06,CHQ DEP/843064/OWDEL1/SBI,0.0,11800.0,,2018,8,6,CASH_IN,11800.0,M1650385017
24634,1196428',2018-08-06,CHQ DEP/442331/OWDEL1/SBI,0.0,11800.0,,2018,8,6,CHECK_CASHING,11800.0,M1921059756
24635,1196428',2018-08-06,CHQ DEP/351406/OWDEL1/UCB,0.0,11800.0,,2018,8,6,CHECK_CASHING,11800.0,M590434145
24636,1196428',2018-08-06,CHQ DEP/400/OWDEL1/BARB/K,0.0,11800.0,,2018,8,6,CHECK_CASHING,11800.0,M1671621366
24637,1196428',2018-08-06,CHQ DEP/52/OWDEL1/BARB/AR,0.0,11800.0,,2018,8,6,CHECK_CASHING,11800.0,M899686935
24638,1196428',2018-08-06,CHQ DEP/51/OWDEL1/BARB/AR,0.0,11800.0,,2018,8,6,CASH_IN,11800.0,M2054039573
24639,1196428',2018-08-06,CHQ DEP/956551/OWDEL1/SBI,0.0,11800.0,,2018,8,6,CASH_IN,11800.0,M1271480561
24640,1196428',2018-08-06,CHQ DEP/831897/OWDEL1/SBI,0.0,11800.0,,2018,8,6,TRANSFER,11800.0,C1259769769
24641,1196428',2018-08-06,CHQ DEP/484189/OWDEL1/SBI,0.0,11800.0,,2018,8,6,CASH_IN,11800.0,M649539827
24642,1196428',2018-08-06,CHQ DEP/927889/OWDEL1/SBI,0.0,11800.0,,2018,8,6,TRANSFER,11800.0,C893350828
24643,1196428',2018-08-06,CHQ DEP/651392/OWDEL1/SBI,0.0,11800.0,,2018,8,6,CASH_IN,11800.0,M20364107
24644,1196428',2018-08-06,CHQ DEP/890175/OWDEL1/SBI,0.0,11800.0,,2018,8,6,CASH_IN,11800.0,M2023197227
24645,1196428',2018-08-06,CHQ DEP/342849/OWDEL1/SBI,0.0,11800.0,,2018,8,6,CHECK_CASHING,11800.0,C232812328
24646,1196428',2018-08-06,CHQ DEP/577596/OWDEL1/SBI,0.0,11800.0,,2018,8,6,CASH_IN,11800.0,M902890505
24647,1196428',2018-08-06,FDRL/INTERNAL FUND TRANSFE,500000.0,0.0,,2018,8,6,CASH_OUT,500000.0,M1465861273
24648,1196428',2018-08-06,RTGS/PUNBH18218925803/PUN,0.0,400000.0,,2018,8,6,TRANSFER,400000.0,M949506330
24649,1196428',2018-08-06,TRF FRM  Indiaforensic SERVICES,0.0,15000000.0,,2018,8,6,CASH_IN,15000000.0,M2084969506
24650,1196428',2018-08-06,TRF FRM  Indiaforensic SERVICES,0.0,8100000.0,,2018,8,6,TRANSFER,8100000.0,M608038618
24651,1196428',2018-08-06,NEFT/AXISP00006181765/ACC,0.0,1000000.0,,2018,8,6,TRANSFER,1000000.0,M1041764081
24652,1196428',2018-08-06,NEFT/P18080673816433/M/S,0.0,30000.0,,2018,8,6,TRANSFER,30000.0,M277788688
24653,1196428',2018-08-06,NEFT/AXISP00006180028/ACC,0.0,1000000.0,,2018,8,6,CASH_IN,1000000.0,M31440957
24654,1196428',2018-08-06,FDRL/REAL TIME GROSS SETTL,15000000.0,0.0,,2018,8,6,CHECK_WITHDRAWAL,15000000.0,C1805162633
24655,1196428',2018-08-06,FDRL/REAL TIME GROSS SETTL,4000000.0,0.0,,2018,8,6,PAYEMENT,4000000.0,M1201023997
24656,1196428',2018-08-06,RTGS/HDFCH18218109951/BAT,0.0,320000.0,,2018,8,6,TRANSFER,320000.0,M1412743565
24657,1196428',2018-08-06,IMPS 821815018338 FROM SA,0.0,200000.0,,2018,8,6,TRANSFER,200000.0,M1887477561
24658,1196428',2018-08-06,IMPS 821815318844 FROM AS,0.0,110099.0,,2018,8,6,CASH_IN,110099.0,C435161028
24659,1196428',2018-08-06,IMPS 821815320593 FROM AS,0.0,70099.0,,2018,8,6,TRANSFER,70099.0,M2126024846
24660,1196428',2018-08-06,NEFT/SBIN918218696837/NAR,0.0,51273.0,,2018,8,6,CASH_IN,51273.0,M885738476
24661,1196428',2018-08-06,CHQ DEPOSIT RETURN/843064,11800.0,0.0,,2018,8,6,CASH_OUT,11800.0,C1273939873
24662,1196428',2018-08-06,CHQ DEPOSIT RETURN/956551,11800.0,0.0,,2018,8,6,DEBIT,11800.0,C464094472
24663,1196428',2018-08-06,RTGS/ICICH18218863985/Indfor,0.0,2500000.0,,2018,8,6,TRANSFER,2500000.0,C1475998599
24664,1196428',2018-08-06,RTGS/ICICH18218863243/Indfor,0.0,1100000.0,,2018,8,6,CASH_IN,1100000.0,C1789550256
24665,1196428',2018-08-06,UPI/821816836625/DEPOSIT/,0.0,1000.0,,2018,8,6,TRANSFER,1000.0,C1805445027
24666,1196428',2018-08-06,FDRL/NATIONAL ELECTRONIC F,2000000.0,0.0,,2018,8,6,CASH_OUT,2000000.0,C968448640
24667,1196428',2018-08-06,FDRL/NATIONAL ELECTRONIC F,3000000.0,0.0,,2018,8,6,CASH_OUT,3000000.0,C691636444
24668,1196428',2018-08-06,FDRL/NATIONAL ELECTRONIC F,3000000.0,0.0,,2018,8,6,CASH_OUT,3000000.0,C1778801068
24669,1196428',2018-08-06,FDRL/NATIONAL ELECTRONIC F,3000000.0,0.0,,2018,8,6,CHECK_WITHDRAWAL,3000000.0,C2029896123
24670,1196428',2018-08-06,NEFT/P18080603315346/S B,0.0,500.0,,2018,8,6,CASH_IN,500.0,C1677727024
24671,1196428',2018-08-06,TRF FRM  Indiaforensic SERVICES,0.0,10000000.0,,2018,8,6,CASH_IN,10000000.0,C1525944481
24672,1196428',2018-08-06,TRF FRM  Indiaforensic SERVICES,0.0,7800000.0,,2018,8,6,CHECK_CASHING,7800000.0,C481402298
24673,1196428',2018-08-06,BEAT CSH PKP DEL UDYO 620,0.0,124900.0,,2018,8,6,TRANSFER,124900.0,C177457290
24674,1196428',2018-08-06,FUJIAN NEWLAND PAYMENT TE,5777764.8,0.0,,2018,8,6,PAYEMENT,5777764.8,M1138171728
24675,1196428',2018-08-06,IMAR00701804766,8340.0,0.0,,2018,8,6,CHECK_WITHDRAWAL,8340.0,C1452722471
24676,1196428',2018-08-06,FDRL/INTERNAL FUND TRANSFE,4000000.0,0.0,,2018,8,6,PAYEMENT,4000000.0,C861958315
24677,1196428',2018-08-06,FDRL/INTERNAL FUND TRANSFE,6000000.0,0.0,,2018,8,6,DEBIT,6000000.0,M919438675
24678,1196428',2018-08-06,FDRL/INTERNAL FUND TRANSFE,1000000.0,0.0,,2018,8,6,CHECK_WITHDRAWAL,1000000.0,M1501022601
24679,1196428',2018-08-06,FDRL/INTERNAL FUND TRANSFE,1000000.0,0.0,,2018,8,6,PAYEMENT,1000000.0,M397708705
24680,1196428',2018-08-06,CHQ DEPOSIT RETURN/843064,100.0,0.0,,2018,8,6,DEBIT,100.0,M1092898377
24681,1196428',2018-08-06,CHQ DEPOSIT RETURN/843064,18.0,0.0,,2018,8,6,DEBIT,18.0,M1957947378
24682,1196428',2018-08-06,CHQ DEPOSIT RETURN/956551,100.0,0.0,,2018,8,6,CASH_OUT,100.0,C785703145
24683,1196428',2018-08-06,CHQ DEPOSIT RETURN/956551,18.0,0.0,,2018,8,6,CHECK_WITHDRAWAL,18.0,M2094125621
24684,1196428',2018-08-07,FDRL/INTERNAL FUND TRANSFE,500000.0,0.0,,2018,8,7,CHECK_WITHDRAWAL,500000.0,M1918034019
24685,1196428',2018-08-07,NEFT/SBIN118219163404/NAR,0.0,47135.0,,2018,8,7,CHECK_CASHING,47135.0,M745483242
24686,1196428',2018-08-07,RTGS/SBINH18219011429/Indfor,0.0,7300000.0,,2018,8,7,CASH_IN,7300000.0,M1878714361
24687,1196428',2018-08-07,FDRL/REAL TIME GROSS SETTL,7205638.75,0.0,,2018,8,7,CHECK_WITHDRAWAL,7205638.75,M203939387
24688,1196428',2018-08-07,IB:TPFT000075012871309006,0.0,150.0,,2018,8,7,CHECK_CASHING,150.0,C382934088
24689,1196428',2018-08-07,TRF FRM  Indiaforensic SERVICES,0.0,14200000.0,,2018,8,7,CASH_IN,14200000.0,C158876320
24690,1196428',2018-08-07,FDRL/REAL TIME GROSS SETTL,4000000.0,0.0,,2018,8,7,DEBIT,4000000.0,C732929236
24691,1196428',2018-08-07,FDRL/REAL TIME GROSS SETTL,10000000.0,0.0,,2018,8,7,CHECK_WITHDRAWAL,10000000.0,C1554622120
24692,1196428',2018-08-07,"Indiaforensic USA, INC./USD/9207",0.0,631188.52,,2018,8,7,CASH_IN,631188.52,C1359484306
24693,1196428',2018-08-07,IRTT00701822870,953.07,0.0,,2018,8,7,PAYEMENT,953.07,C1782704802
24694,1196428',2018-08-07,NEFT/FSFBH18219000078/FIN,0.0,64203.0,,2018,8,7,CHECK_CASHING,64203.0,C1609562230
24695,1196428',2018-08-07,NEFT/P18080774339131/M/S,0.0,30000.0,,2018,8,7,CASH_IN,30000.0,C1220897602
24696,1196428',2018-08-07,IMPS 821917115162 FROM PU,0.0,8000.0,,2018,8,7,CASH_IN,8000.0,C1213257323
24697,1196428',2018-08-07,FDRL/INTERNAL FUND TRANSFE,500000.0,0.0,,2018,8,7,CASH_OUT,500000.0,C674913323
24698,1196428',2018-08-07,TRF FRM  Indiaforensic SERVICES,0.0,6400000.0,,2018,8,7,CASH_IN,6400000.0,C803116137
24699,1196428',2018-08-07,TRF TO  Indiaforensic SERVICES I,1475000.0,0.0,,2018,8,7,CHECK_WITHDRAWAL,1475000.0,C1450417897
24700,1196428',2018-08-07,NEFT/AXISP00006501657/ACC,0.0,2000000.0,,2018,8,7,CHECK_CASHING,2000000.0,C826383690
24701,1196428',2018-08-07,FDRL/INTERNAL FUND TRANSFE,6000000.0,0.0,,2018,8,7,PAYEMENT,6000000.0,M1718920203
24702,1196428',2018-08-07,FDRL/INTERNAL FUND TRANSFE,300000.0,0.0,,2018,8,7,PAYEMENT,300000.0,M1002711260
24703,1196428',2018-08-07,FDRL/INTERNAL FUND TRANSFE,300000.0,0.0,,2018,8,7,PAYEMENT,300000.0,C545710008
24704,1196428',2018-08-07,FDRL/INTERNAL FUND TRANSFE,300000.0,0.0,,2018,8,7,DEBIT,300000.0,C1838584624
24705,1196428',2018-08-07,FDRL/INTERNAL FUND TRANSFE,300000.0,0.0,,2018,8,7,CASH_OUT,300000.0,C1030706332
24706,1196428',2018-08-08,NEFT/P18080805321702/SHED,0.0,11800.0,,2018,8,8,CHECK_CASHING,11800.0,M2129060443
24707,1196428',2018-08-08,RTGS/UTIBH18220643737/Indfor,0.0,5000000.0,,2018,8,8,TRANSFER,5000000.0,C1195471589
24708,1196428',2018-08-08,RTGS/SBINH18220014427/Indfor,0.0,6900000.0,,2018,8,8,CASH_IN,6900000.0,M1398128260
24709,1196428',2018-08-08,FDRL/REAL TIME GROSS SETTL,11358187.84,0.0,,2018,8,8,DEBIT,11358187.84,C1856036778
24710,1196428',2018-08-08,NEFT/PUNBH18220856504/BAL,0.0,99950.0,,2018,8,8,CASH_IN,99950.0,C2067546399
24711,1196428',2018-08-08,RTGS/HDFCH18220361782/JUN,0.0,250000.0,,2018,8,8,CASH_IN,250000.0,C818570949
24712,1196428',2018-08-08,NEFT/SBIN218220318366/SHR,0.0,100000.0,,2018,8,8,TRANSFER,100000.0,M535878604
24713,1196428',2018-08-08,CHQ DEP/73/OWDEL1/HDFC/DC,0.0,11800.0,,2018,8,8,CHECK_CASHING,11800.0,C358945794
24714,1196428',2018-08-08,CHQ DEP/884105/OWDEL1/SBI,0.0,11800.0,,2018,8,8,TRANSFER,11800.0,C922511709
24715,1196428',2018-08-08,CHQ DEP/16056/OWDEL1/BKID,0.0,11800.0,,2018,8,8,CASH_IN,11800.0,C988138425
24716,1196428',2018-08-08,CHQ DEP/514846/OWDEL1/SBI,0.0,11800.0,,2018,8,8,CHECK_CASHING,11800.0,C814900611
24717,1196428',2018-08-08,CHQ DEP/49118/OWDEL1/UTIB,0.0,11800.0,,2018,8,8,TRANSFER,11800.0,C1467740330
24718,1196428',2018-08-08,CHQ DEP/186/OWDEL1/PSIB/F,0.0,11800.0,,2018,8,8,TRANSFER,11800.0,M858308953
24719,1196428',2018-08-08,CHQ DEP/25310/OWDEL1/JAKA,0.0,11800.0,,2018,8,8,CHECK_CASHING,11800.0,M1773085261
24720,1196428',2018-08-08,CHQ DEP/265333/OWDEL1/SBI,0.0,11800.0,,2018,8,8,CASH_IN,11800.0,M472606308
24721,1196428',2018-08-08,CHQ DEP/12147/OWDEL1/IBKL,0.0,11800.0,,2018,8,8,CASH_IN,11800.0,M51583809
24722,1196428',2018-08-08,CHQ DEP/74/OWDEL1/HDFC/NE,0.0,11800.0,,2018,8,8,CASH_IN,11800.0,M1337700382
24723,1196428',2018-08-08,CHQ DEP/144/OWDEL1/HDFC/N,0.0,11800.0,,2018,8,8,TRANSFER,11800.0,C1918034924
24724,1196428',2018-08-08,CHQ DEP/8272/OWDEL1/ALLA/,0.0,11800.0,,2018,8,8,TRANSFER,11800.0,M527477577
24725,1196428',2018-08-08,CHQ DEP/572133/OWDEL1/SBI,0.0,11800.0,,2018,8,8,CASH_IN,11800.0,M577217292
24726,1196428',2018-08-08,CHQ DEP/67782/OWDEL1/JAKA,0.0,11800.0,,2018,8,8,CASH_IN,11800.0,C184253187
24727,1196428',2018-08-08,CHQ DEP/630392/OWDEL1/SBI,0.0,11800.0,,2018,8,8,TRANSFER,11800.0,C1778300121
24728,1196428',2018-08-08,CHQ DEP/185/OWDEL1/HDFC/H,0.0,11800.0,,2018,8,8,CHECK_CASHING,11800.0,C667504652
24729,1196428',2018-08-08,CHQ DEP/464/OWDEL1/BARB/F,0.0,11800.0,,2018,8,8,CASH_IN,11800.0,C638590716
24730,1196428',2018-08-08,CHQ DEP/79/OWDEL1/HDFC/NE,0.0,11800.0,,2018,8,8,TRANSFER,11800.0,C1532153384
24731,1196428',2018-08-08,CHQ DEP/951473/OWDEL1/SBI,0.0,11800.0,,2018,8,8,CHECK_CASHING,11800.0,C208427878
24732,1196428',2018-08-08,CHQ DEP/398105/OWDEL1/PUN,0.0,11800.0,,2018,8,8,CASH_IN,11800.0,C1530086509
24733,1196428',2018-08-08,CHQ DEP/238709/OWDEL1/UTB,0.0,11800.0,,2018,8,8,TRANSFER,11800.0,C703957828
24734,1196428',2018-08-08,CHQ DEP/913403/OWDEL1/SBI,0.0,11800.0,,2018,8,8,TRANSFER,11800.0,C891020651
24735,1196428',2018-08-08,CHQ DEP/351878/OWDEL1/SBI,0.0,11800.0,,2018,8,8,CASH_IN,11800.0,M1680032445
24736,1196428',2018-08-08,CHQ DEP/72836/OWDEL1/JAKA,0.0,11800.0,,2018,8,8,TRANSFER,11800.0,C553264065
24737,1196428',2018-08-08,CHQ DEP/40914/OWDEL1/ORBC,0.0,8260.0,,2018,8,8,TRANSFER,8260.0,M1097298586
24738,1196428',2018-08-08,CHQ DEP/51965/OWDEL1/BKID,0.0,11800.0,,2018,8,8,TRANSFER,11800.0,M870026554
24739,1196428',2018-08-08,CHQ DEP/22141/OWDEL1/BKID,0.0,11800.0,,2018,8,8,CHECK_CASHING,11800.0,C695653925
24740,1196428',2018-08-08,CHQ DEP/1528/OWDEL1/UTIB/,0.0,11800.0,,2018,8,8,TRANSFER,11800.0,M1248361658
24741,1196428',2018-08-08,CHQ DEP/897980/OWDEL1/BKI,0.0,11200.0,,2018,8,8,CASH_IN,11200.0,C1689262323
24742,1196428',2018-08-08,CHQ DEP/118838/OWDEL1/SBI,0.0,11800.0,,2018,8,8,CASH_IN,11800.0,C1757877803
24743,1196428',2018-08-08,CHQ DEP/492675/OWDEL1/SBI,0.0,11800.0,,2018,8,8,TRANSFER,11800.0,C1849933855
24744,1196428',2018-08-08,CHQ DEP/768426/OWDEL1/SBI,0.0,11800.0,,2018,8,8,TRANSFER,11800.0,C1753128715
24745,1196428',2018-08-08,CHQ DEP/14679/OWDEL1/ORBC,0.0,11800.0,,2018,8,8,TRANSFER,11800.0,C1527761090
24746,1196428',2018-08-08,CHQ DEP/738/OWDEL1/ORBC/,0.0,11800.0,,2018,8,8,CASH_IN,11800.0,C1754722089
24747,1196428',2018-08-08,CHQ DEP/808616/OWDEL1/SBI,0.0,11800.0,,2018,8,8,TRANSFER,11800.0,C1261039678
24748,1196428',2018-08-08,CHQ DEP/18992/OWDEL1/JAKA,0.0,11800.0,,2018,8,8,CHECK_CASHING,11800.0,C836514715
24749,1196428',2018-08-08,CHQ DEP/188412/OWDEL1/SBI,0.0,11800.0,,2018,8,8,CHECK_CASHING,11800.0,C1640961071
24750,1196428',2018-08-08,CHQ DEP/205747/OWDEL1/SBI,0.0,11800.0,,2018,8,8,CASH_IN,11800.0,C1838584624
24751,1196428',2018-08-08,CHQ DEP/14529/OWDEL1/BKID,0.0,11800.0,,2018,8,8,CASH_IN,11800.0,C1209271652
24752,1196428',2018-08-08,CHQ DEP/191749/OWDEL1/SBI,0.0,11800.0,,2018,8,8,CASH_IN,11800.0,C745740822
24753,1196428',2018-08-08,CHQ DEP/28774/OWDEL1/CBIN,0.0,11800.0,,2018,8,8,CHECK_CASHING,11800.0,C1401721023
24754,1196428',2018-08-08,CHQ DEP/32212/OWDEL1/ORBC,0.0,11800.0,,2018,8,8,CHECK_CASHING,11800.0,C47827984
24755,1196428',2018-08-08,CHQ DEP/5730/OWDEL1/BKID/,0.0,11800.0,,2018,8,8,TRANSFER,11800.0,C1849941462
24756,1196428',2018-08-08,CHQ DEP/80664/OWDEL1/IDIB,0.0,11800.0,,2018,8,8,CHECK_CASHING,11800.0,C70895366
24757,1196428',2018-08-08,CHQ DEP/12065/OWDEL1/BKID,0.0,11800.0,,2018,8,8,CASH_IN,11800.0,C977993101
24758,1196428',2018-08-08,CHQ DEP/951812/OWDEL1/SBI,0.0,8260.0,,2018,8,8,CHECK_CASHING,8260.0,C2116873183
24759,1196428',2018-08-08,CHQ DEP/231195/OWDEL1/SBI,0.0,11800.0,,2018,8,8,CHECK_CASHING,11800.0,C892686452
24760,1196428',2018-08-08,CHQ DEP/249/OWDEL1/PSIB/I,0.0,11800.0,,2018,8,8,TRANSFER,11800.0,C1540270363
24761,1196428',2018-08-08,CHQ DEP/313/OWDEL1/HDFC/D,0.0,11800.0,,2018,8,8,CHECK_CASHING,11800.0,C534662976
24762,1196428',2018-08-08,CHQ DEP/108689/OWDEL1/COR,0.0,11800.0,,2018,8,8,CASH_IN,11800.0,C30013970
24763,1196428',2018-08-08,CHQ DEP/60462/OWDEL1/ORBC,0.0,11800.0,,2018,8,8,CASH_IN,11800.0,C1809373351
24764,1196428',2018-08-08,CHQ DEP/710756/OWDEL1/SBI,0.0,11800.0,,2018,8,8,CHECK_CASHING,11800.0,C741431520
24765,1196428',2018-08-08,CHQ DEP/153694/OWDEL1/SBI,0.0,11800.0,,2018,8,8,TRANSFER,11800.0,C669771073
24766,1196428',2018-08-08,CHQ DEP/900052/OWDEL1/SBI,0.0,11800.0,,2018,8,8,TRANSFER,11800.0,C1915091057
24767,1196428',2018-08-08,CHQ DEP/28571/OWDEL1/UTIB,0.0,11800.0,,2018,8,8,CHECK_CASHING,11800.0,C323287038
24768,1196428',2018-08-08,CHQ DEP/10773/OWDEL1/UTIB,0.0,11800.0,,2018,8,8,CASH_IN,11800.0,C1027992087
24769,1196428',2018-08-08,CHQ DEP/120/OWDEL1/PSIB/G,0.0,10000.0,,2018,8,8,TRANSFER,10000.0,C1435804085
24770,1196428',2018-08-08,CHQ DEP/76273/OWDEL1/SBIN,0.0,11800.0,,2018,8,8,TRANSFER,11800.0,C1153596299
24771,1196428',2018-08-08,CHQ DEP/5/OWDEL1/UCBA/VIJ,0.0,11800.0,,2018,8,8,CASH_IN,11800.0,C1541743053
24772,1196428',2018-08-08,CHQ DEP/184747/OWDEL1/SBI,0.0,11800.0,,2018,8,8,CASH_IN,11800.0,C1213257323
24773,1196428',2018-08-08,CHQ DEP/471234/OWDEL1/ORB,0.0,11800.0,,2018,8,8,CASH_IN,11800.0,C295081230
24774,1196428',2018-08-08,CHQ DEP/89/OWDEL1/HDFC/,0.0,11800.0,,2018,8,8,CASH_IN,11800.0,C531511436
24775,1196428',2018-08-08,FDRL/INTERNAL FUND TRANSFE,500000.0,0.0,,2018,8,8,DEBIT,500000.0,C175291188
24776,1196428',2018-08-08,FDRL/INTERNAL FUND TRANSFE,500000.0,0.0,,2018,8,8,PAYEMENT,500000.0,C1259769769
24777,1196428',2018-08-08,TRF FROM  Indiaforensic SERVICES,0.0,10000000.0,,2018,8,8,CHECK_CASHING,10000000.0,C205300866
24778,1196428',2018-08-08,TRF FROM  Indiaforensic SERVICES,0.0,4000000.0,,2018,8,8,TRANSFER,4000000.0,C1297873690
24779,1196428',2018-08-08,TRF FROM  Indiaforensic SERVICES,0.0,500000.0,,2018,8,8,CHECK_CASHING,500000.0,C715819458
24780,1196428',2018-08-08,FDRL/REAL TIME GROSS SETTL,4000000.0,0.0,,2018,8,8,CASH_OUT,4000000.0,C18928637
24781,1196428',2018-08-08,FDRL/REAL TIME GROSS SETTL,4000000.0,0.0,,2018,8,8,CASH_OUT,4000000.0,C1079343872
24782,1196428',2018-08-08,FDRL/REAL TIME GROSS SETTL,5000000.0,0.0,,2018,8,8,CHECK_WITHDRAWAL,5000000.0,C99275333
24783,1196428',2018-08-08,RTGS/HDFCH18220426121/BAT,0.0,250000.0,,2018,8,8,TRANSFER,250000.0,C1450828900
24784,1196428',2018-08-08,FDRL/REAL TIME GROSS SETTL,1000000.0,0.0,,2018,8,8,DEBIT,1000000.0,C1339257929
24785,1196428',2018-08-08,IMPS 822015384920 FROM AS,0.0,120170.0,,2018,8,8,CASH_IN,120170.0,C893041125
24786,1196428',2018-08-08,IMPS 822015931891 FROM SA,0.0,100000.0,,2018,8,8,CHECK_CASHING,100000.0,C380242442
24787,1196428',2018-08-08,IMPS 822016103185 FROM PU,0.0,20000.0,,2018,8,8,TRANSFER,20000.0,C1220897602
24788,1196428',2018-08-08,CHQ DEPOSIT RETURN/73/FUN,11800.0,0.0,,2018,8,8,PAYEMENT,11800.0,C495071437
24789,1196428',2018-08-08,CHQ DEPOSIT RETURN/884105,11800.0,0.0,,2018,8,8,PAYEMENT,11800.0,C1753128715
24790,1196428',2018-08-08,CHQ DEPOSIT RETURN/25310/,11800.0,0.0,,2018,8,8,DEBIT,11800.0,C1387460501
24791,1196428',2018-08-08,CHQ DEPOSIT RETURN/188412,11800.0,0.0,,2018,8,8,PAYEMENT,11800.0,C425987411
24792,1196428',2018-08-08,CHQ DEPOSIT RETURN/265333,11800.0,0.0,,2018,8,8,CASH_OUT,11800.0,C914293025
24793,1196428',2018-08-08,CHQ DEPOSIT RETURN/191749,11800.0,0.0,,2018,8,8,DEBIT,11800.0,C1765998352
24794,1196428',2018-08-08,CHQ DEPOSIT RETURN/74/FUN,11800.0,0.0,,2018,8,8,CASH_OUT,11800.0,C1651144763
24795,1196428',2018-08-08,CHQ DEPOSIT RETURN/22141/,11800.0,0.0,,2018,8,8,CHECK_WITHDRAWAL,11800.0,C922871524
24796,1196428',2018-08-08,TRF FRM  Indiaforensic SERVICES,0.0,10000000.0,,2018,8,8,TRANSFER,10000000.0,M1020220407
24797,1196428',2018-08-08,NEFT/PUNBH18220955519/PUN,0.0,100000.0,,2018,8,8,CASH_IN,100000.0,M1544335221
24798,1196428',2018-08-08,FDRL/NATIONAL ELECTRONIC F,2500.0,0.0,,2018,8,8,CHECK_WITHDRAWAL,2500.0,M574675842
24799,1196428',2018-08-08,FDRL/NATIONAL ELECTRONIC F,2500.0,0.0,,2018,8,8,CHECK_WITHDRAWAL,2500.0,M2059590476
24800,1196428',2018-08-08,FDRL/NATIONAL ELECTRONIC F,2000.0,0.0,,2018,8,8,PAYEMENT,2000.0,M152825009
24801,1196428',2018-08-08,FDRL/NATIONAL ELECTRONIC F,2500.0,0.0,,2018,8,8,DEBIT,2500.0,M1138689668
24802,1196428',2018-08-08,FDRL/NATIONAL ELECTRONIC F,5000.0,0.0,,2018,8,8,DEBIT,5000.0,M630592991
24803,1196428',2018-08-08,FDRL/NATIONAL ELECTRONIC F,3000.0,0.0,,2018,8,8,CASH_OUT,3000.0,M1822124448
24804,1196428',2018-08-08,FDRL/NATIONAL ELECTRONIC F,2000.0,0.0,,2018,8,8,CASH_OUT,2000.0,M2055237744
24805,1196428',2018-08-08,FDRL/NATIONAL ELECTRONIC F,2000.0,0.0,,2018,8,8,CASH_OUT,2000.0,M1205273698
24806,1196428',2018-08-08,FDRL/NATIONAL ELECTRONIC F,2500.0,0.0,,2018,8,8,PAYEMENT,2500.0,M1019711240
24807,1196428',2018-08-08,FDRL/NATIONAL ELECTRONIC F,2500.0,0.0,,2018,8,8,DEBIT,2500.0,M101888437
24808,1196428',2018-08-08,FDRL/NATIONAL ELECTRONIC F,3000.0,0.0,,2018,8,8,CHECK_WITHDRAWAL,3000.0,C221632586
24809,1196428',2018-08-08,FDRL/NATIONAL ELECTRONIC F,2500.0,0.0,,2018,8,8,CHECK_WITHDRAWAL,2500.0,M465727914
24810,1196428',2018-08-08,FDRL/NATIONAL ELECTRONIC F,5000.0,0.0,,2018,8,8,DEBIT,5000.0,M567135922
24811,1196428',2018-08-08,FDRL/NATIONAL ELECTRONIC F,2000000.0,0.0,,2018,8,8,CHECK_WITHDRAWAL,2000000.0,M2070113567
24812,1196428',2018-08-08,FDRL/NATIONAL ELECTRONIC F,2000000.0,0.0,,2018,8,8,CASH_OUT,2000000.0,M1267133803
24813,1196428',2018-08-08,FDRL/NATIONAL ELECTRONIC F,2000000.0,0.0,,2018,8,8,CASH_OUT,2000000.0,M2020949871
24814,1196428',2018-08-08,NEFT/IOBAN18220632252/K,0.0,2500.0,,2018,8,8,CASH_IN,2500.0,M146906367
24815,1196428',2018-08-08,NEFT/000050251357/Indiaforensic,0.0,1000000.0,,2018,8,8,CASH_IN,1000000.0,M888820495
24816,1196428',2018-08-08,NEFT/000050251603/Indiaforensic,0.0,2800000.0,,2018,8,8,CASH_IN,2800000.0,M1118771427
24817,1196428',2018-08-08,TRF FRM  Indiaforensic SERVICES,0.0,300000.0,,2018,8,8,CASH_IN,300000.0,M1836304353
24818,1196428',2018-08-08,TRF FRM  Indiaforensic SERVICES,0.0,600000.0,,2018,8,8,CHECK_CASHING,600000.0,M2073372839
24819,1196428',2018-08-08,BEAT CSH PKP DEL UDYOG 62,0.0,212400.0,,2018,8,8,CHECK_CASHING,212400.0,M1058529298
24820,1196428',2018-08-08,FDRL/INTERNAL FUND TRANSFE,4000000.0,0.0,,2018,8,8,CHECK_WITHDRAWAL,4000000.0,M384434958
24821,1196428',2018-08-08,FDRL/INTERNAL FUND TRANSFE,6000000.0,0.0,,2018,8,8,CASH_OUT,6000000.0,M420461209
24822,1196428',2018-08-08,FDRL/INTERNAL FUND TRANSFE,500000.0,0.0,,2018,8,8,PAYEMENT,500000.0,M1569218941
24823,1196428',2018-08-08,IMPS 822020019718 FROM OX,0.0,100000.0,,2018,8,8,CHECK_CASHING,100000.0,M1720099622
24824,1196428',2018-08-08,FDRL/INTERNAL FUND TRANSFE,500000.0,0.0,,2018,8,8,CHECK_WITHDRAWAL,500000.0,M79710837
24825,1196428',2018-08-08,CHQ DEPOSIT RETURN/73/CHA,100.0,0.0,,2018,8,8,PAYEMENT,100.0,M489416788
24826,1196428',2018-08-08,CHQ DEPOSIT RETURN/73/GST,18.0,0.0,,2018,8,8,PAYEMENT,18.0,M1796069260
24827,1196428',2018-08-08,CHQ DEPOSIT RETURN/188412,100.0,0.0,,2018,8,8,DEBIT,100.0,M1482289927
24828,1196428',2018-08-08,CHQ DEPOSIT RETURN/188412,18.0,0.0,,2018,8,8,PAYEMENT,18.0,M1962954466
24829,1196428',2018-08-08,CHQ DEPOSIT RETURN/191749,100.0,0.0,,2018,8,8,DEBIT,100.0,M1856132252
24830,1196428',2018-08-08,CHQ DEPOSIT RETURN/191749,18.0,0.0,,2018,8,8,PAYEMENT,18.0,M1265785739
24831,1196428',2018-08-08,CHQ DEPOSIT RETURN/74/CHA,100.0,0.0,,2018,8,8,PAYEMENT,100.0,C1647754924
24832,1196428',2018-08-08,CHQ DEPOSIT RETURN/74/GST,18.0,0.0,,2018,8,8,PAYEMENT,18.0,C1411451832
24833,1196428',2018-08-08,CHQ DEPOSIT RETURN/22141/,100.0,0.0,,2018,8,8,PAYEMENT,100.0,M439056122
24834,1196428',2018-08-08,CHQ DEPOSIT RETURN/22141/,18.0,0.0,,2018,8,8,PAYEMENT,18.0,C1058634310
24835,1196428',2018-08-09,CASHDEP/GHATKOPAR/,0.0,90000.0,,2018,8,9,TRANSFER,90000.0,C771303504
24836,1196428',2018-08-09,RTGS/SBINH18221008849/Indfor,0.0,8800000.0,,2018,8,9,TRANSFER,8800000.0,M1472579608
24837,1196428',2018-08-09,FDRL/REAL TIME GROSS SETTL,7591956.0,0.0,,2018,8,9,DEBIT,7591956.0,M1471780050
24838,1196428',2018-08-09,FDRL/INTERNAL FUND TRANSFE,1000000.0,0.0,,2018,8,9,CHECK_WITHDRAWAL,1000000.0,M2131253156
24839,1196428',2018-08-09,CASHDEP/VIKASMARG/TP,0.0,180000.0,,2018,8,9,CASH_IN,180000.0,M1194159327
24840,1196428',2018-08-09,FT ZL18080999287628 PRAVE,0.0,100000.0,,2018,8,9,TRANSFER,100000.0,C664038638
24841,1196428',2018-08-09,NEFT/N221180605748336/USH,0.0,117575.0,,2018,8,9,CHECK_CASHING,117575.0,M1308122424
24842,1196428',2018-08-09,RTGS/HDFCH18221519552/BAJ,0.0,200000.0,,2018,8,9,CASH_IN,200000.0,M1347091004
24843,1196428',2018-08-09,NEFT/P18080906900061/S B,0.0,199500.0,,2018,8,9,TRANSFER,199500.0,M360912328
24844,1196428',2018-08-09,CHQ DEP/37909/OWDEL1/ORBC,0.0,11800.0,,2018,8,9,TRANSFER,11800.0,M256097650
24845,1196428',2018-08-09,CHQ DEP/1043/OWDEL1/KVBL/,0.0,11800.0,,2018,8,9,CHECK_CASHING,11800.0,C1850042097
24846,1196428',2018-08-09,CHQ DEP/200660/OWDEL1/SBI,0.0,11800.0,,2018,8,9,TRANSFER,11800.0,M85791725
24847,1196428',2018-08-09,CHQ DEP/24874/OWDEL1/BKID,0.0,11800.0,,2018,8,9,CHECK_CASHING,11800.0,C1501701470
24848,1196428',2018-08-09,CHQ DEP/163/OWDEL1/HDFC/M,0.0,11800.0,,2018,8,9,CHECK_CASHING,11800.0,C657255537
24849,1196428',2018-08-09,CHQ DEP/469771/OWDEL1/SBI,0.0,11800.0,,2018,8,9,CASH_IN,11800.0,M1960546519
24850,1196428',2018-08-09,CHQ DEP/679720/OWDEL1/SBI,0.0,11800.0,,2018,8,9,CASH_IN,11800.0,C1234776885
24851,1196428',2018-08-09,CHQ DEP/258536/OWDEL1/SBI,0.0,11800.0,,2018,8,9,CASH_IN,11800.0,M700825953
24852,1196428',2018-08-09,TRF FROM  Indiaforensic SERVICES,0.0,15000000.0,,2018,8,9,CASH_IN,15000000.0,M1720382412
24853,1196428',2018-08-09,TRF FROM  Indiaforensic SERVICES,0.0,1800000.0,,2018,8,9,CHECK_CASHING,1800000.0,M826154386
24854,1196428',2018-08-09,NEFT/N221180606022350/USH,0.0,61050.0,,2018,8,9,CASH_IN,61050.0,C332911016
24855,1196428',2018-08-09,RTGS/PUNBH18221981915/PUN,0.0,200000.0,,2018,8,9,CHECK_CASHING,200000.0,C205091536
24856,1196428',2018-08-09,FDRL/REAL TIME GROSS SETTL,4000000.0,0.0,,2018,8,9,DEBIT,4000000.0,C1007717381
24857,1196428',2018-08-09,FDRL/REAL TIME GROSS SETTL,10000000.0,0.0,,2018,8,9,CHECK_WITHDRAWAL,10000000.0,M1192804665
24858,1196428',2018-08-09,RTGS/HDFCH18221590737/BAT,0.0,275000.0,,2018,8,9,CHECK_CASHING,275000.0,C1029472813
24859,1196428',2018-08-09,FDRL/NATIONAL ELECTRONIC F,35695.0,0.0,,2018,8,9,CASH_OUT,35695.0,M220361855
24860,1196428',2018-08-09,FDRL/NATIONAL ELECTRONIC F,37341.0,0.0,,2018,8,9,CASH_OUT,37341.0,C655381473
24861,1196428',2018-08-09,FDRL/NATIONAL ELECTRONIC F,42601.0,0.0,,2018,8,9,DEBIT,42601.0,M1565242025
24862,1196428',2018-08-09,FDRL/NATIONAL ELECTRONIC F,18602.0,0.0,,2018,8,9,CASH_OUT,18602.0,C462877022
24863,1196428',2018-08-09,FDRL/NATIONAL ELECTRONIC F,12648.0,0.0,,2018,8,9,CASH_OUT,12648.0,M448133058
24864,1196428',2018-08-09,FDRL/NATIONAL ELECTRONIC F,18552.0,0.0,,2018,8,9,PAYEMENT,18552.0,C1994035663
24865,1196428',2018-08-09,FDRL/NATIONAL ELECTRONIC F,18552.0,0.0,,2018,8,9,CASH_OUT,18552.0,C1219273867
24866,1196428',2018-08-09,FDRL/NATIONAL ELECTRONIC F,42167.0,0.0,,2018,8,9,DEBIT,42167.0,M656061712
24867,1196428',2018-08-09,FDRL/NATIONAL ELECTRONIC F,30870.0,0.0,,2018,8,9,DEBIT,30870.0,M1872990299
24868,1196428',2018-08-09,FDRL/NATIONAL ELECTRONIC F,18602.0,0.0,,2018,8,9,CASH_OUT,18602.0,M766295381
24869,1196428',2018-08-09,FDRL/NATIONAL ELECTRONIC F,18552.0,0.0,,2018,8,9,PAYEMENT,18552.0,M605100547
24870,1196428',2018-08-09,FDRL/NATIONAL ELECTRONIC F,37410.0,0.0,,2018,8,9,CHECK_WITHDRAWAL,37410.0,C885837397
24871,1196428',2018-08-09,FDRL/NATIONAL ELECTRONIC F,47693.0,0.0,,2018,8,9,DEBIT,47693.0,M511822021
24872,1196428',2018-08-09,FDRL/NATIONAL ELECTRONIC F,31350.0,0.0,,2018,8,9,CASH_OUT,31350.0,C578294406
24873,1196428',2018-08-09,FDRL/NATIONAL ELECTRONIC F,27254.0,0.0,,2018,8,9,PAYEMENT,27254.0,M139989607
24874,1196428',2018-08-09,FDRL/NATIONAL ELECTRONIC F,34350.0,0.0,,2018,8,9,PAYEMENT,34350.0,M1257321444
24875,1196428',2018-08-09,FDRL/NATIONAL ELECTRONIC F,31656.0,0.0,,2018,8,9,CASH_OUT,31656.0,M69890205
24876,1196428',2018-08-09,FDRL/NATIONAL ELECTRONIC F,28610.0,0.0,,2018,8,9,CHECK_WITHDRAWAL,28610.0,C392292416
24877,1196428',2018-08-09,FDRL/NATIONAL ELECTRONIC F,24140.0,0.0,,2018,8,9,CHECK_WITHDRAWAL,24140.0,C718985478
24878,1196428',2018-08-09,FDRL/NATIONAL ELECTRONIC F,28610.0,0.0,,2018,8,9,DEBIT,28610.0,C418964192
24879,1196428',2018-08-09,FDRL/NATIONAL ELECTRONIC F,28610.0,0.0,,2018,8,9,PAYEMENT,28610.0,C1401316767
24880,1196428',2018-08-09,FDRL/NATIONAL ELECTRONIC F,15113.0,0.0,,2018,8,9,CHECK_WITHDRAWAL,15113.0,C536171536
24881,1196428',2018-08-09,FDRL/NATIONAL ELECTRONIC F,28610.0,0.0,,2018,8,9,CHECK_WITHDRAWAL,28610.0,C593596322
24882,1196428',2018-08-09,FDRL/NATIONAL ELECTRONIC F,28610.0,0.0,,2018,8,9,DEBIT,28610.0,C499052031
24883,1196428',2018-08-09,FDRL/NATIONAL ELECTRONIC F,15596.0,0.0,,2018,8,9,DEBIT,15596.0,C406477119
24884,1196428',2018-08-09,FDRL/NATIONAL ELECTRONIC F,28610.0,0.0,,2018,8,9,PAYEMENT,28610.0,C1898885237
24885,1196428',2018-08-09,FDRL/NATIONAL ELECTRONIC F,24918.0,0.0,,2018,8,9,CHECK_WITHDRAWAL,24918.0,M345104268
24886,1196428',2018-08-09,FDRL/NATIONAL ELECTRONIC F,14363.0,0.0,,2018,8,9,CHECK_WITHDRAWAL,14363.0,C157591472
24887,1196428',2018-08-09,FDRL/NATIONAL ELECTRONIC F,23326.0,0.0,,2018,8,9,CASH_OUT,23326.0,C510382951
24888,1196428',2018-08-09,FDRL/NATIONAL ELECTRONIC F,10772.0,0.0,,2018,8,9,CASH_OUT,10772.0,M815778566
24889,1196428',2018-08-09,FDRL/NATIONAL ELECTRONIC F,28410.0,0.0,,2018,8,9,CHECK_WITHDRAWAL,28410.0,M14429501
24890,1196428',2018-08-09,FDRL/NATIONAL ELECTRONIC F,20303.0,0.0,,2018,8,9,CASH_OUT,20303.0,M615795640
24891,1196428',2018-08-09,FDRL/NATIONAL ELECTRONIC F,21219.0,0.0,,2018,8,9,CHECK_WITHDRAWAL,21219.0,M487613113
24892,1196428',2018-08-09,FDRL/NATIONAL ELECTRONIC F,10772.0,0.0,,2018,8,9,PAYEMENT,10772.0,M445847391
24893,1196428',2018-08-09,FDRL/NATIONAL ELECTRONIC F,13167.0,0.0,,2018,8,9,CASH_OUT,13167.0,M1484672206
24894,1196428',2018-08-09,FDRL/NATIONAL ELECTRONIC F,5985.0,0.0,,2018,8,9,PAYEMENT,5985.0,M635515029
24895,1196428',2018-08-09,FDRL/NATIONAL ELECTRONIC F,16343.0,0.0,,2018,8,9,CASH_OUT,16343.0,M1720174511
24896,1196428',2018-08-09,FDRL/NATIONAL ELECTRONIC F,13476.0,0.0,,2018,8,9,DEBIT,13476.0,M979565177
24897,1196428',2018-08-09,FDRL/NATIONAL ELECTRONIC F,21949.0,0.0,,2018,8,9,CASH_OUT,21949.0,M25211632
24898,1196428',2018-08-09,FDRL/NATIONAL ELECTRONIC F,18469.0,0.0,,2018,8,9,PAYEMENT,18469.0,M1649718222
24899,1196428',2018-08-09,FDRL/NATIONAL ELECTRONIC F,14766.0,0.0,,2018,8,9,CASH_OUT,14766.0,M714065669
24900,1196428',2018-08-09,FDRL/NATIONAL ELECTRONIC F,9575.0,0.0,,2018,8,9,PAYEMENT,9575.0,C1491213790
24901,1196428',2018-08-09,FDRL/NATIONAL ELECTRONIC F,9037.0,0.0,,2018,8,9,CHECK_WITHDRAWAL,9037.0,M719481438
24902,1196428',2018-08-09,FDRL/NATIONAL ELECTRONIC F,12922.0,0.0,,2018,8,9,DEBIT,12922.0,C21069748
24903,1196428',2018-08-09,FDRL/NATIONAL ELECTRONIC F,20313.0,0.0,,2018,8,9,CHECK_WITHDRAWAL,20313.0,C1144527317
24904,1196428',2018-08-09,FDRL/NATIONAL ELECTRONIC F,21147.0,0.0,,2018,8,9,PAYEMENT,21147.0,M1757812211
24905,1196428',2018-08-09,FDRL/NATIONAL ELECTRONIC F,22050.0,0.0,,2018,8,9,PAYEMENT,22050.0,M1459407357
24906,1196428',2018-08-09,FDRL/NATIONAL ELECTRONIC F,11161.0,0.0,,2018,8,9,CASH_OUT,11161.0,C1725775569
24907,1196428',2018-08-09,FDRL/NATIONAL ELECTRONIC F,26108.0,0.0,,2018,8,9,CASH_OUT,26108.0,C1413677222
24908,1196428',2018-08-09,FDRL/NATIONAL ELECTRONIC F,22900.0,0.0,,2018,8,9,DEBIT,22900.0,C929286459
24909,1196428',2018-08-09,FDRL/NATIONAL ELECTRONIC F,18457.0,0.0,,2018,8,9,PAYEMENT,18457.0,M306018824
24910,1196428',2018-08-09,FDRL/NATIONAL ELECTRONIC F,19543.0,0.0,,2018,8,9,PAYEMENT,19543.0,M2092453592
24911,1196428',2018-08-09,FDRL/NATIONAL ELECTRONIC F,19262.0,0.0,,2018,8,9,PAYEMENT,19262.0,M1907731340
24912,1196428',2018-08-09,FDRL/NATIONAL ELECTRONIC F,29131.0,0.0,,2018,8,9,CHECK_WITHDRAWAL,29131.0,M850601250
24913,1196428',2018-08-09,FDRL/NATIONAL ELECTRONIC F,18802.0,0.0,,2018,8,9,DEBIT,18802.0,M1841948315
24914,1196428',2018-08-09,FDRL/NATIONAL ELECTRONIC F,20533.0,0.0,,2018,8,9,DEBIT,20533.0,M1368107802
24915,1196428',2018-08-09,FDRL/NATIONAL ELECTRONIC F,26108.0,0.0,,2018,8,9,DEBIT,26108.0,M610845553
24916,1196428',2018-08-09,FDRL/NATIONAL ELECTRONIC F,7415.0,0.0,,2018,8,9,CHECK_WITHDRAWAL,7415.0,C657255537
24917,1196428',2018-08-09,FDRL/NATIONAL ELECTRONIC F,14210.0,0.0,,2018,8,9,DEBIT,14210.0,M1014260373
24918,1196428',2018-08-09,FDRL/NATIONAL ELECTRONIC F,22473.0,0.0,,2018,8,9,CHECK_WITHDRAWAL,22473.0,M1203569540
24919,1196428',2018-08-09,FDRL/NATIONAL ELECTRONIC F,22003.0,0.0,,2018,8,9,CHECK_WITHDRAWAL,22003.0,C1601211078
24920,1196428',2018-08-09,FDRL/NATIONAL ELECTRONIC F,18322.0,0.0,,2018,8,9,PAYEMENT,18322.0,M1140964858
24921,1196428',2018-08-09,FDRL/NATIONAL ELECTRONIC F,18552.0,0.0,,2018,8,9,PAYEMENT,18552.0,M1920591935
24922,1196428',2018-08-09,FDRL/NATIONAL ELECTRONIC F,19607.0,0.0,,2018,8,9,CASH_OUT,19607.0,C77635419
24923,1196428',2018-08-09,FDRL/NATIONAL ELECTRONIC F,20770.0,0.0,,2018,8,9,PAYEMENT,20770.0,M1382745386
24924,1196428',2018-08-09,FDRL/NATIONAL ELECTRONIC F,18352.0,0.0,,2018,8,9,PAYEMENT,18352.0,C1566158153
24925,1196428',2018-08-09,FDRL/NATIONAL ELECTRONIC F,18314.0,0.0,,2018,8,9,DEBIT,18314.0,C1023714065
24926,1196428',2018-08-09,FDRL/NATIONAL ELECTRONIC F,28602.0,0.0,,2018,8,9,CASH_OUT,28602.0,M274816456
24927,1196428',2018-08-09,FDRL/NATIONAL ELECTRONIC F,14521.0,0.0,,2018,8,9,CASH_OUT,14521.0,C1975607158
24928,1196428',2018-08-09,FDRL/NATIONAL ELECTRONIC F,27133.0,0.0,,2018,8,9,PAYEMENT,27133.0,C838924005
24929,1196428',2018-08-09,FDRL/NATIONAL ELECTRONIC F,22741.0,0.0,,2018,8,9,PAYEMENT,22741.0,C501402989
24930,1196428',2018-08-09,FDRL/NATIONAL ELECTRONIC F,15244.0,0.0,,2018,8,9,DEBIT,15244.0,M1462244624
24931,1196428',2018-08-09,FDRL/NATIONAL ELECTRONIC F,20592.0,0.0,,2018,8,9,CHECK_WITHDRAWAL,20592.0,M911106960
24932,1196428',2018-08-09,FDRL/NATIONAL ELECTRONIC F,20970.0,0.0,,2018,8,9,CASH_OUT,20970.0,M137169799
24933,1196428',2018-08-09,FDRL/NATIONAL ELECTRONIC F,26350.0,0.0,,2018,8,9,CASH_OUT,26350.0,C560041895
24934,1196428',2018-08-09,FDRL/NATIONAL ELECTRONIC F,9132.0,0.0,,2018,8,9,PAYEMENT,9132.0,M935374589
24935,1196428',2018-08-09,FDRL/NATIONAL ELECTRONIC F,24850.0,0.0,,2018,8,9,CHECK_WITHDRAWAL,24850.0,C1907159141
24936,1196428',2018-08-09,FDRL/NATIONAL ELECTRONIC F,29328.0,0.0,,2018,8,9,PAYEMENT,29328.0,C1727331144
24937,1196428',2018-08-09,FDRL/NATIONAL ELECTRONIC F,17627.0,0.0,,2018,8,9,DEBIT,17627.0,M495829763
24938,1196428',2018-08-09,FDRL/NATIONAL ELECTRONIC F,11497.0,0.0,,2018,8,9,PAYEMENT,11497.0,M1208251262
24939,1196428',2018-08-09,FDRL/NATIONAL ELECTRONIC F,20279.0,0.0,,2018,8,9,CASH_OUT,20279.0,M1430158683
24940,1196428',2018-08-09,FDRL/NATIONAL ELECTRONIC F,14362.0,0.0,,2018,8,9,PAYEMENT,14362.0,C1298316171
24941,1196428',2018-08-09,FDRL/NATIONAL ELECTRONIC F,15359.0,0.0,,2018,8,9,DEBIT,15359.0,C1782113663
24942,1196428',2018-08-09,FDRL/NATIONAL ELECTRONIC F,26400.0,0.0,,2018,8,9,PAYEMENT,26400.0,C1465813088
24943,1196428',2018-08-09,FDRL/NATIONAL ELECTRONIC F,5212.0,0.0,,2018,8,9,PAYEMENT,5212.0,C121488263
24944,1196428',2018-08-09,FDRL/NATIONAL ELECTRONIC F,2449.0,0.0,,2018,8,9,CASH_OUT,2449.0,M2027041535
24945,1196428',2018-08-09,FDRL/NATIONAL ELECTRONIC F,26826.0,0.0,,2018,8,9,PAYEMENT,26826.0,C647675234
24946,1196428',2018-08-09,FDRL/NATIONAL ELECTRONIC F,25215.0,0.0,,2018,8,9,CHECK_WITHDRAWAL,25215.0,M1937161224
24947,1196428',2018-08-09,FDRL/NATIONAL ELECTRONIC F,24045.0,0.0,,2018,8,9,CHECK_WITHDRAWAL,24045.0,M1173086138
24948,1196428',2018-08-09,FDRL/NATIONAL ELECTRONIC F,29785.0,0.0,,2018,8,9,PAYEMENT,29785.0,M869412951
24949,1196428',2018-08-09,FDRL/NATIONAL ELECTRONIC F,21491.0,0.0,,2018,8,9,CASH_OUT,21491.0,M1671705963
24950,1196428',2018-08-09,FDRL/NATIONAL ELECTRONIC F,19329.0,0.0,,2018,8,9,PAYEMENT,19329.0,C1178471274
24951,1196428',2018-08-09,FDRL/NATIONAL ELECTRONIC F,22986.0,0.0,,2018,8,9,DEBIT,22986.0,C673068808
24952,1196428',2018-08-09,FDRL/NATIONAL ELECTRONIC F,27493.0,0.0,,2018,8,9,PAYEMENT,27493.0,M1440229269
24953,1196428',2018-08-09,FDRL/NATIONAL ELECTRONIC F,12452.0,0.0,,2018,8,9,CASH_OUT,12452.0,M1633441356
24954,1196428',2018-08-09,FDRL/NATIONAL ELECTRONIC F,4528.0,0.0,,2018,8,9,CASH_OUT,4528.0,M1220496330
24955,1196428',2018-08-09,FDRL/NATIONAL ELECTRONIC F,53267.0,0.0,,2018,8,9,CASH_OUT,53267.0,M2045049014
24956,1196428',2018-08-09,FDRL/NATIONAL ELECTRONIC F,20615.0,0.0,,2018,8,9,CHECK_WITHDRAWAL,20615.0,M1854402683
24957,1196428',2018-08-09,FDRL/NATIONAL ELECTRONIC F,21991.0,0.0,,2018,8,9,DEBIT,21991.0,M62827943
24958,1196428',2018-08-09,FDRL/NATIONAL ELECTRONIC F,21991.0,0.0,,2018,8,9,DEBIT,21991.0,M785007313
24959,1196428',2018-08-09,FDRL/NATIONAL ELECTRONIC F,2769.0,0.0,,2018,8,9,CASH_OUT,2769.0,M184710968
24960,1196428',2018-08-09,FDRL/NATIONAL ELECTRONIC F,6596.0,0.0,,2018,8,9,CASH_OUT,6596.0,M1932692521
24961,1196428',2018-08-09,FDRL/NATIONAL ELECTRONIC F,28609.0,0.0,,2018,8,9,CHECK_WITHDRAWAL,28609.0,M789025860
24962,1196428',2018-08-09,FDRL/NATIONAL ELECTRONIC F,9822.0,0.0,,2018,8,9,CASH_OUT,9822.0,M1407469336
24963,1196428',2018-08-09,FDRL/NATIONAL ELECTRONIC F,25880.0,0.0,,2018,8,9,CASH_OUT,25880.0,C665576141
24964,1196428',2018-08-09,FDRL/NATIONAL ELECTRONIC F,19860.0,0.0,,2018,8,9,CHECK_WITHDRAWAL,19860.0,C1089177065
24965,1196428',2018-08-09,FDRL/NATIONAL ELECTRONIC F,34082.0,0.0,,2018,8,9,CASH_OUT,34082.0,M283666381
24966,1196428',2018-08-09,FDRL/NATIONAL ELECTRONIC F,39241.0,0.0,,2018,8,9,CHECK_WITHDRAWAL,39241.0,C1828047633
24967,1196428',2018-08-09,FDRL/NATIONAL ELECTRONIC F,33623.0,0.0,,2018,8,9,DEBIT,33623.0,C864078397
24968,1196428',2018-08-09,FDRL/NATIONAL ELECTRONIC F,39829.0,0.0,,2018,8,9,DEBIT,39829.0,C116289363
24969,1196428',2018-08-09,FDRL/NATIONAL ELECTRONIC F,20279.0,0.0,,2018,8,9,CASH_OUT,20279.0,C2087040347
24970,1196428',2018-08-09,FDRL/NATIONAL ELECTRONIC F,21991.0,0.0,,2018,8,9,DEBIT,21991.0,C1257117293
24971,1196428',2018-08-09,FDRL/NATIONAL ELECTRONIC F,47810.0,0.0,,2018,8,9,CASH_OUT,47810.0,M390111306
24972,1196428',2018-08-09,FDRL/NATIONAL ELECTRONIC F,44310.0,0.0,,2018,8,9,PAYEMENT,44310.0,C1393428647
24973,1196428',2018-08-09,FDRL/NATIONAL ELECTRONIC F,34432.0,0.0,,2018,8,9,CHECK_WITHDRAWAL,34432.0,C2049813033
24974,1196428',2018-08-09,FDRL/NATIONAL ELECTRONIC F,21546.0,0.0,,2018,8,9,PAYEMENT,21546.0,M1043884407
24975,1196428',2018-08-09,FDRL/NATIONAL ELECTRONIC F,31110.0,0.0,,2018,8,9,CASH_OUT,31110.0,M395604532
24976,1196428',2018-08-09,FDRL/NATIONAL ELECTRONIC F,33808.0,0.0,,2018,8,9,CHECK_WITHDRAWAL,33808.0,C705480294
24977,1196428',2018-08-09,FDRL/NATIONAL ELECTRONIC F,18552.0,0.0,,2018,8,9,DEBIT,18552.0,M1963453455
24978,1196428',2018-08-09,FDRL/NATIONAL ELECTRONIC F,18602.0,0.0,,2018,8,9,CHECK_WITHDRAWAL,18602.0,C196702015
24979,1196428',2018-08-09,FDRL/NATIONAL ELECTRONIC F,28859.0,0.0,,2018,8,9,DEBIT,28859.0,M1230517565
24980,1196428',2018-08-09,FDRL/NATIONAL ELECTRONIC F,41350.0,0.0,,2018,8,9,DEBIT,41350.0,M1939418839
24981,1196428',2018-08-09,FDRL/NATIONAL ELECTRONIC F,39388.0,0.0,,2018,8,9,PAYEMENT,39388.0,M107969734
24982,1196428',2018-08-09,FDRL/NATIONAL ELECTRONIC F,38206.0,0.0,,2018,8,9,DEBIT,38206.0,M287223305
24983,1196428',2018-08-09,FDRL/NATIONAL ELECTRONIC F,30550.0,0.0,,2018,8,9,CASH_OUT,30550.0,C1383454473
24984,1196428',2018-08-09,FDRL/NATIONAL ELECTRONIC F,4525.0,0.0,,2018,8,9,CASH_OUT,4525.0,M627052128
24985,1196428',2018-08-09,FDRL/NATIONAL ELECTRONIC F,39030.0,0.0,,2018,8,9,CASH_OUT,39030.0,M914865165
24986,1196428',2018-08-09,FDRL/NATIONAL ELECTRONIC F,24910.0,0.0,,2018,8,9,PAYEMENT,24910.0,M1072844781
24987,1196428',2018-08-09,FDRL/NATIONAL ELECTRONIC F,28609.0,0.0,,2018,8,9,CHECK_WITHDRAWAL,28609.0,M569417520
24988,1196428',2018-08-09,FDRL/NATIONAL ELECTRONIC F,39209.0,0.0,,2018,8,9,DEBIT,39209.0,M883093798
24989,1196428',2018-08-09,FDRL/NATIONAL ELECTRONIC F,38301.0,0.0,,2018,8,9,DEBIT,38301.0,M1511314985
24990,1196428',2018-08-09,FDRL/NATIONAL ELECTRONIC F,33793.0,0.0,,2018,8,9,CASH_OUT,33793.0,M1926480195
24991,1196428',2018-08-09,FDRL/NATIONAL ELECTRONIC F,28609.0,0.0,,2018,8,9,DEBIT,28609.0,M938798461
24992,1196428',2018-08-09,FDRL/NATIONAL ELECTRONIC F,6584.0,0.0,,2018,8,9,PAYEMENT,6584.0,M1402925738
24993,1196428',2018-08-09,FDRL/NATIONAL ELECTRONIC F,28610.0,0.0,,2018,8,9,PAYEMENT,28610.0,M1717836772
24994,1196428',2018-08-09,FDRL/NATIONAL ELECTRONIC F,31350.0,0.0,,2018,8,9,CASH_OUT,31350.0,M573466360
24995,1196428',2018-08-09,FDRL/NATIONAL ELECTRONIC F,28609.0,0.0,,2018,8,9,PAYEMENT,28609.0,M1323857318
24996,1196428',2018-08-09,FDRL/NATIONAL ELECTRONIC F,35005.0,0.0,,2018,8,9,CHECK_WITHDRAWAL,35005.0,M391150745
24997,1196428',2018-08-09,FDRL/NATIONAL ELECTRONIC F,28609.0,0.0,,2018,8,9,CHECK_WITHDRAWAL,28609.0,M1024062031
24998,1196428',2018-08-09,FDRL/NATIONAL ELECTRONIC F,28659.0,0.0,,2018,8,9,PAYEMENT,28659.0,M703154453
24999,1196428',2018-08-09,FDRL/NATIONAL ELECTRONIC F,28659.0,0.0,,2018,8,9,DEBIT,28659.0,M1692102619
25000,1196428',2018-08-09,FDRL/NATIONAL ELECTRONIC F,42353.0,0.0,,2018,8,9,CHECK_WITHDRAWAL,42353.0,M1884543633
25001,1196428',2018-08-09,FDRL/NATIONAL ELECTRONIC F,42483.0,0.0,,2018,8,9,CASH_OUT,42483.0,M1243132083
25002,1196428',2018-08-09,FDRL/NATIONAL ELECTRONIC F,28609.0,0.0,,2018,8,9,DEBIT,28609.0,M994019246
25003,1196428',2018-08-09,FDRL/NATIONAL ELECTRONIC F,33993.0,0.0,,2018,8,9,CASH_OUT,33993.0,M1420561310
25004,1196428',2018-08-09,FDRL/NATIONAL ELECTRONIC F,28609.0,0.0,,2018,8,9,CASH_OUT,28609.0,M1956516366
25005,1196428',2018-08-09,FDRL/NATIONAL ELECTRONIC F,34421.0,0.0,,2018,8,9,CHECK_WITHDRAWAL,34421.0,M1851866347
25006,1196428',2018-08-09,FDRL/NATIONAL ELECTRONIC F,28609.0,0.0,,2018,8,9,CHECK_WITHDRAWAL,28609.0,M114630189
25007,1196428',2018-08-09,FDRL/NATIONAL ELECTRONIC F,39565.0,0.0,,2018,8,9,CASH_OUT,39565.0,C1573730841
25008,1196428',2018-08-09,FDRL/NATIONAL ELECTRONIC F,37285.0,0.0,,2018,8,9,DEBIT,37285.0,C478793413
25009,1196428',2018-08-09,FDRL/NATIONAL ELECTRONIC F,33793.0,0.0,,2018,8,9,CASH_OUT,33793.0,M1161362855
25010,1196428',2018-08-09,FDRL/NATIONAL ELECTRONIC F,22670.0,0.0,,2018,8,9,DEBIT,22670.0,M768606822
25011,1196428',2018-08-09,NEFT/000046388644/ACCOUNT,0.0,20303.0,,2018,8,9,CHECK_CASHING,20303.0,M1365203383
25012,1196428',2018-08-09,RTGS/ICICH18221501140/Indfor,0.0,1100000.0,,2018,8,9,CHECK_CASHING,1100000.0,M415355750
25013,1196428',2018-08-09,RTGS/ICICH18221500352/Indfor,0.0,1100000.0,,2018,8,9,TRANSFER,1100000.0,C1931451243
25014,1196428',2018-08-09,NEFT/AXISP00006887785/ACC,0.0,3000000.0,,2018,8,9,CHECK_CASHING,3000000.0,M1849378579
25015,1196428',2018-08-09,FDRL/INTERNAL FUND TRANSFE,1000000.0,0.0,,2018,8,9,PAYEMENT,1000000.0,C522632546
25016,1196428',2018-08-09,FDRL/INTERNAL FUND TRANSFE,1000000.0,0.0,,2018,8,9,CHECK_WITHDRAWAL,1000000.0,M406675239
25017,1196428',2018-08-09,IMPS 822117199754 FROM PU,0.0,26000.0,,2018,8,9,TRANSFER,26000.0,M1805681495
25018,1196428',2018-08-09,FDRL/NATIONAL ELECTRONIC F,18552.0,0.0,,2018,8,9,CASH_OUT,18552.0,M1583495635
25019,1196428',2018-08-09,FDRL/NATIONAL ELECTRONIC F,33090.0,0.0,,2018,8,9,PAYEMENT,33090.0,M1229114045
25020,1196428',2018-08-09,FDRL/NATIONAL ELECTRONIC F,4673.0,0.0,,2018,8,9,CHECK_WITHDRAWAL,4673.0,C1469084143
25021,1196428',2018-08-09,FDRL/NATIONAL ELECTRONIC F,31857.0,0.0,,2018,8,9,PAYEMENT,31857.0,C1804424410
25022,1196428',2018-08-09,FDRL/NATIONAL ELECTRONIC F,5385.0,0.0,,2018,8,9,DEBIT,5385.0,M1295954752
25023,1196428',2018-08-09,FDRL/NATIONAL ELECTRONIC F,4851.0,0.0,,2018,8,9,PAYEMENT,4851.0,M446693857
25024,1196428',2018-08-09,FDRL/NATIONAL ELECTRONIC F,28859.0,0.0,,2018,8,9,CASH_OUT,28859.0,M71851217
25025,1196428',2018-08-09,FDRL/NATIONAL ELECTRONIC F,28859.0,0.0,,2018,8,9,CASH_OUT,28859.0,C1251935072
25026,1196428',2018-08-09,FDRL/NATIONAL ELECTRONIC F,11523.0,0.0,,2018,8,9,CHECK_WITHDRAWAL,11523.0,M1319429652
25027,1196428',2018-08-09,FDRL/NATIONAL ELECTRONIC F,6179.0,0.0,,2018,8,9,CHECK_WITHDRAWAL,6179.0,M893079756
25028,1196428',2018-08-09,FDRL/NATIONAL ELECTRONIC F,7872.0,0.0,,2018,8,9,CHECK_WITHDRAWAL,7872.0,C47228838
25029,1196428',2018-08-09,FDRL/NATIONAL ELECTRONIC F,1000000.0,0.0,,2018,8,9,CHECK_WITHDRAWAL,1000000.0,C1287328228
25030,1196428',2018-08-09,FDRL/NATIONAL ELECTRONIC F,1000000.0,0.0,,2018,8,9,CASH_OUT,1000000.0,C1610505085
25031,1196428',2018-08-09,FDRL/NATIONAL ELECTRONIC F,1000000.0,0.0,,2018,8,9,CHECK_WITHDRAWAL,1000000.0,C2008913953
25032,1196428',2018-08-09,FDRL/NATIONAL ELECTRONIC F,33811.0,0.0,,2018,8,9,DEBIT,33811.0,M1380300444
25033,1196428',2018-08-09,FDRL/NATIONAL ELECTRONIC F,7447.0,0.0,,2018,8,9,CHECK_WITHDRAWAL,7447.0,M700030032
25034,1196428',2018-08-09,TRF FRM  Indiaforensic SERVICES,0.0,7900000.0,,2018,8,9,TRANSFER,7900000.0,C195600860
25035,1196428',2018-08-09,FDRL/INTERNAL FUND TRANSFE,100000.0,0.0,,2018,8,9,CASH_OUT,100000.0,C1149788645
25036,1196428',2018-08-09,BEAT CSH PKP DEL UDYOG 62,0.0,100700.0,,2018,8,9,CHECK_CASHING,100700.0,M1655844522
25037,1196428',2018-08-09,FDRL/INTERNAL FUND TRANSFE,8000000.0,0.0,,2018,8,9,DEBIT,8000000.0,C1305075214
25038,1196428',2018-08-09,FDRL/INTERNAL FUND TRANSFE,500000.0,0.0,,2018,8,9,CASH_OUT,500000.0,M211881770
25039,1196428',2018-08-10,FDRL/INTERNAL FUND TRANSFE,200000.0,0.0,,2018,8,10,DEBIT,200000.0,M755260123
25040,1196428',2018-08-10,NEFT/BKIDN18222257402/PRE,0.0,11800.0,,2018,8,10,TRANSFER,11800.0,M1233557566
25041,1196428',2018-08-10,RTGS/SBINH18222010563/Indfor,0.0,7800000.0,,2018,8,10,TRANSFER,7800000.0,C1269336757
25042,1196428',2018-08-10,NEFT/PUNBH18222220027/BAL,0.0,150000.0,,2018,8,10,TRANSFER,150000.0,M165147207
25043,1196428',2018-08-10,RTGS/HDFCH18222671757/JUN,0.0,330000.0,,2018,8,10,TRANSFER,330000.0,M958282869
25044,1196428',2018-08-10,NEFT/N222180606830312/USH,0.0,76450.0,,2018,8,10,TRANSFER,76450.0,C97725839
25045,1196428',2018-08-10,FDRL/REAL TIME GROSS SETTL,7501051.48,0.0,,2018,8,10,CASH_OUT,7501051.48,M1034543932
25046,1196428',2018-08-10,NEFT/AXISP00006996764/ACC,0.0,16000000.0,,2018,8,10,TRANSFER,16000000.0,M120892281
25047,1196428',2018-08-10,FDRL/REAL TIME GROSS SETTL,15000000.0,0.0,,2018,8,10,CASH_OUT,15000000.0,C505528357
25048,1196428',2018-08-10,Indiaforensic SERVICES INDIA PVT,0.0,924395.0,,2018,8,10,CASH_IN,924395.0,C1304345230
25049,1196428',2018-08-10,FDRL/REAL TIME GROSS SETTL,1000000.0,0.0,,2018,8,10,PAYEMENT,1000000.0,M507591917
25050,1196428',2018-08-10,TRF FRM  Indiaforensic SERVICES,0.0,900000.0,,2018,8,10,CASH_IN,900000.0,M2032292761
25051,1196428',2018-08-10,TRF FRM  Indiaforensic SERVICES,0.0,15000000.0,,2018,8,10,CHECK_CASHING,15000000.0,C814886797
25052,1196428',2018-08-10,FDRL/REAL TIME GROSS SETTL,15000000.0,0.0,,2018,8,10,DEBIT,15000000.0,C1956871313
25053,1196428',2018-08-10,FDRL/REAL TIME GROSS SETTL,2000000.0,0.0,,2018,8,10,CASH_OUT,2000000.0,C1493513506
25054,1196428',2018-08-10,RTGS/ICICH18222593024/Indfor,0.0,500000.0,,2018,8,10,CASH_IN,500000.0,C9108707
25055,1196428',2018-08-10,RTGS/ICICH18222591821/Indfor,0.0,1300000.0,,2018,8,10,CHECK_CASHING,1300000.0,C897209100
25056,1196428',2018-08-10,RTGS/HDFCH18222734809/BAT,0.0,250000.0,,2018,8,10,TRANSFER,250000.0,C1933965693
25057,1196428',2018-08-10,RTGS/PSIBH18222239093/SAI,0.0,250000.0,,2018,8,10,CASH_IN,250000.0,C683605346
25058,1196428',2018-08-10,FDRL/INTERNAL FUND TRANSFE,1000000.0,0.0,,2018,8,10,CASH_OUT,1000000.0,C727209127
25059,1196428',2018-08-10,NEFT/N222180607155828/TEC,0.0,100000.0,,2018,8,10,CASH_IN,100000.0,C669419693
25060,1196428',2018-08-10,Indiaforensic SERVICES INDIA PVT,0.0,368968.0,,2018,8,10,CHECK_CASHING,368968.0,C559485820
25061,1196428',2018-08-10,"Indiaforensic USA, INC./USD/4562",0.0,312497.0,,2018,8,10,CASH_IN,312497.0,C1774531247
25062,1196428',2018-08-10,IRTT00701823328,666.25,0.0,,2018,8,10,CASH_OUT,666.25,C717951588
25063,1196428',2018-08-10,TRF FRM  Indiaforensic SERVICES,0.0,8900000.0,,2018,8,10,TRANSFER,8900000.0,C386312539
25064,1196428',2018-08-10,NEFT/P18081075710952/M/S,0.0,20000.0,,2018,8,10,TRANSFER,20000.0,C588779235
25065,1196428',2018-08-10,BEAT CSH PKP DEL UDYOG 62,0.0,330500.0,,2018,8,10,TRANSFER,330500.0,C503195940
25066,1196428',2018-08-10,NEFT/N222180607425961/Indfor,0.0,5000000.0,,2018,8,10,TRANSFER,5000000.0,M405609475
25067,1196428',2018-08-10,FDRL/INTERNAL FUND TRANSFE,15000000.0,0.0,,2018,8,10,CASH_OUT,15000000.0,C388286025
25068,1196428',2018-08-10,FDRL/INTERNAL FUND TRANSFE,1000000.0,0.0,,2018,8,10,DEBIT,1000000.0,C388583042
25069,1196428',2018-08-10,FDRL/INTERNAL FUND TRANSFE,1000000.0,0.0,,2018,8,10,CHECK_WITHDRAWAL,1000000.0,C341156724
25070,1196428',2018-08-11,IMPS 822313371789 FROM AS,0.0,120080.0,,2018,8,11,CHECK_CASHING,120080.0,C701279123
25071,1196428',2018-08-11,IMPS 822313378635 FROM AS,0.0,70085.0,,2018,8,11,CHECK_CASHING,70085.0,C1256728724
25072,1196428',2018-08-13,NEFT/P18081309514163/S B,0.0,199500.0,,2018,8,13,CASH_IN,199500.0,C619068319
25073,1196428',2018-08-13,NEFT/SBIN518225121505/TAR,0.0,190000.0,,2018,8,13,TRANSFER,190000.0,C1590550415
25074,1196428',2018-08-13,CASHDEP/GHATKOPAR/,0.0,209000.0,,2018,8,13,CHECK_CASHING,209000.0,M1313626970
25075,1196428',2018-08-13,RTGS/SBINH18225010580/Indfor,0.0,8100000.0,,2018,8,13,CHECK_CASHING,8100000.0,M128469338
25076,1196428',2018-08-13,FDRL/REAL TIME GROSS SETTL,4405900.8,0.0,,2018,8,13,CHECK_WITHDRAWAL,4405900.8,M1590636294
25077,1196428',2018-08-13,RTGS/SBINH18225010582/Indfor,0.0,14900000.0,,2018,8,13,CASH_IN,14900000.0,C1575114306
25078,1196428',2018-08-13,FDRL/REAL TIME GROSS SETTL,8284227.64,0.0,,2018,8,13,CASH_OUT,8284227.64,M1580558824
25079,1196428',2018-08-13,FDRL/REAL TIME GROSS SETTL,10559755.32,0.0,,2018,8,13,CASH_OUT,10559755.32,C1060041730
25080,1196428',2018-08-13,FDRL/INTERNAL FUND TRANSFE,500000.0,0.0,,2018,8,13,CASH_OUT,500000.0,C343534938
25081,1196428',2018-08-13,NEFT/P18081310255056/S B,0.0,199500.0,,2018,8,13,TRANSFER,199500.0,M1919746821
25082,1196428',2018-08-13,RTGS/PUNBH18225015131/MAN,0.0,400000.0,,2018,8,13,CHECK_CASHING,400000.0,M1945180999
25083,1196428',2018-08-13,NEFT/P18081376233627/M/S,0.0,30000.0,,2018,8,13,TRANSFER,30000.0,C1049228732
25084,1196428',2018-08-13,RTGS/HDFCH18225906717/BAT,0.0,300000.0,,2018,8,13,TRANSFER,300000.0,C866710867
25085,1196428',2018-08-13,FDRL/INTERNAL FUND TRANSFE,500000.0,0.0,,2018,8,13,PAYEMENT,500000.0,M1451217869
25086,1196428',2018-08-13,FDRL/INTERNAL FUND TRANSFE,500000.0,0.0,,2018,8,13,CASH_OUT,500000.0,C404775810
25087,1196428',2018-08-13,CHQ DEP/220021/OWDEL1/SBI,0.0,8260.0,,2018,8,13,CHECK_CASHING,8260.0,C1851668139
25088,1196428',2018-08-13,CHQ DEP/388358/OWDEL1/SBI,0.0,8260.0,,2018,8,13,TRANSFER,8260.0,C2067546399
25089,1196428',2018-08-13,CHQ DEP/216346/OWDEL1/SBI,0.0,8260.0,,2018,8,13,CHECK_CASHING,8260.0,C2018975718
25090,1196428',2018-08-13,CHQ DEP/404/OWDEL1/HDFC/M,0.0,11800.0,,2018,8,13,CASH_IN,11800.0,C564160838
25091,1196428',2018-08-13,CHQ DEP/101/OWDEL1/HDFC/V,0.0,8260.0,,2018,8,13,CHECK_CASHING,8260.0,C653593128
25092,1196428',2018-08-13,CHQ DEP/71245/OWDEL1/CLA-,0.0,11800.0,,2018,8,13,CHECK_CASHING,11800.0,C63387985
25093,1196428',2018-08-13,CHQ DEP/183/OWDEL1/PSIB/I,0.0,8260.0,,2018,8,13,CHECK_CASHING,8260.0,C1909597726
25094,1196428',2018-08-13,CHQ DEP/851784/OWDEL1/SBI,0.0,11800.0,,2018,8,13,CASH_IN,11800.0,C1060041730
25095,1196428',2018-08-13,CHQ DEP/585132/OWDEL1/SBI,0.0,11800.0,,2018,8,13,TRANSFER,11800.0,C1834186423
25096,1196428',2018-08-13,CHQ DEP/530916/OWDEL1/SBI,0.0,11800.0,,2018,8,13,CASH_IN,11800.0,C1918034924
25097,1196428',2018-08-13,CHQ DEP/947742/OWDEL1/SBI,0.0,11800.0,,2018,8,13,CHECK_CASHING,11800.0,C256902273
25098,1196428',2018-08-13,CHQ DEP/947691/OWDEL1/SBI,0.0,11800.0,,2018,8,13,TRANSFER,11800.0,C929266212
25099,1196428',2018-08-13,CHQ DEP/2442/OWDEL1/UTIB/,0.0,11800.0,,2018,8,13,TRANSFER,11800.0,C1197606915
25100,1196428',2018-08-13,CHQ DEP/41889/OWDEL1/CLA-,0.0,11800.0,,2018,8,13,CASH_IN,11800.0,C33574809
25101,1196428',2018-08-13,CHQ DEP/38427/OWDEL1/ORBC,0.0,11800.0,,2018,8,13,CHECK_CASHING,11800.0,C1459757869
25102,1196428',2018-08-13,CHQ DEP/3033/OWDEL1/ORBC/,0.0,11800.0,,2018,8,13,TRANSFER,11800.0,C981765041
25103,1196428',2018-08-13,CHQ DEP/77455/OWDEL1/SBIN,0.0,11800.0,,2018,8,13,CASH_IN,11800.0,C1963862935
25104,1196428',2018-08-13,CHQ DEP/378411/OWDEL1/SBI,0.0,11800.0,,2018,8,13,CHECK_CASHING,11800.0,C1804883318
25105,1196428',2018-08-13,CHQ DEP/9258/OWDEL1/SBIN/,0.0,8260.0,,2018,8,13,CHECK_CASHING,8260.0,C1539556581
25106,1196428',2018-08-13,CHQ DEP/9435/OWDEL1/SBIN/,0.0,8260.0,,2018,8,13,CHECK_CASHING,8260.0,C343534938
25107,1196428',2018-08-13,CHQ DEP/118994/OWDEL1/SBI,0.0,8260.0,,2018,8,13,TRANSFER,8260.0,C715819458
25108,1196428',2018-08-13,CHQ DEP/239878/OWDEL1/SBI,0.0,8260.0,,2018,8,13,CASH_IN,8260.0,C1049312121
25109,1196428',2018-08-13,CHQ DEP/513027/OWDEL1/AND,0.0,11800.0,,2018,8,13,CHECK_CASHING,11800.0,C586727036
25110,1196428',2018-08-13,CHQ DEP/477959/OWDEL1/SBI,0.0,11800.0,,2018,8,13,TRANSFER,11800.0,C885951223
25111,1196428',2018-08-13,CHQ DEP/406841/OWDEL1/SBI,0.0,11800.0,,2018,8,13,CHECK_CASHING,11800.0,C51626955
25112,1196428',2018-08-13,CHQ DEP/727719/OWDEL1/PUN,0.0,11800.0,,2018,8,13,TRANSFER,11800.0,C1626759869
25113,1196428',2018-08-13,CHQ DEP/141965/OWDEL1/SBI,0.0,11800.0,,2018,8,13,TRANSFER,11800.0,C1639464943
25114,1196428',2018-08-13,CHQ DEP/659293/OWDEL1/SBI,0.0,11800.0,,2018,8,13,CASH_IN,11800.0,C2109097173
25115,1196428',2018-08-13,CHQ DEP/614541/OWDEL1/SBI,0.0,11800.0,,2018,8,13,CHECK_CASHING,11800.0,C91463800
25116,1196428',2018-08-13,CHQ DEP/9634/OWDEL1/VASAI,0.0,11800.0,,2018,8,13,TRANSFER,11800.0,C596626170
25117,1196428',2018-08-13,CHQ DEP/178509/OWDEL1/SBI,0.0,11800.0,,2018,8,13,CHECK_CASHING,11800.0,C1320217924
25118,1196428',2018-08-13,CHQ DEP/6221/OWDEL1/BKID/,0.0,11800.0,,2018,8,13,TRANSFER,11800.0,C101571284
25119,1196428',2018-08-13,CHQ DEP/539117/OWDEL1/SBI,0.0,11800.0,,2018,8,13,TRANSFER,11800.0,C323287038
25120,1196428',2018-08-13,CHQ DEP/209349/OWDEL1/SBI,0.0,11800.0,,2018,8,13,TRANSFER,11800.0,C51626955
25121,1196428',2018-08-13,CHQ DEP/63440/OWDEL1/SBIN,0.0,11800.0,,2018,8,13,TRANSFER,11800.0,C705321061
25122,1196428',2018-08-13,CHQ DEP/38577/OWDEL1/ORBC,0.0,11800.0,,2018,8,13,CASH_IN,11800.0,C2032389005
25123,1196428',2018-08-13,CHQ DEP/687840/OWDEL1/SBI,0.0,11800.0,,2018,8,13,CASH_IN,11800.0,C414205222
25124,1196428',2018-08-13,CHQ DEP/61/OWDEL1/HDFC/BA,0.0,11800.0,,2018,8,13,CHECK_CASHING,11800.0,C874023329
25125,1196428',2018-08-13,CHQ DEP/216552/OWDEL1/SBI,0.0,11800.0,,2018,8,13,CHECK_CASHING,11800.0,C557041912
25126,1196428',2018-08-13,CHQ DEP/570341/OWDEL1/SBI,0.0,11800.0,,2018,8,13,CASH_IN,11800.0,C762570948
25127,1196428',2018-08-13,CHQ DEP/772979/OWDEL1/SBI,0.0,11800.0,,2018,8,13,CASH_IN,11800.0,C978740207
25128,1196428',2018-08-13,CHQ DEP/235907/OWDEL1/SBI,0.0,11800.0,,2018,8,13,CHECK_CASHING,11800.0,C1511785794
25129,1196428',2018-08-13,CHQ DEP/517069/OWDEL1/SBI,0.0,8000.0,,2018,8,13,TRANSFER,8000.0,C644345897
25130,1196428',2018-08-13,CHQ DEP/308/OWDEL1/HDFC/M,0.0,11000.0,,2018,8,13,TRANSFER,11000.0,C1549086472
25131,1196428',2018-08-13,CHQ DEP/41491/OWDEL1/ORBC,0.0,8267.0,,2018,8,13,TRANSFER,8267.0,C1930040331
25132,1196428',2018-08-13,CHQ DEP/40700/OWDEL1/ORBC,0.0,8260.0,,2018,8,13,TRANSFER,8260.0,C450960851
25133,1196428',2018-08-13,CHQ DEP/18093/OWDEL1/ORBC,0.0,11800.0,,2018,8,13,CASH_IN,11800.0,C441599944
25134,1196428',2018-08-13,CHQ DEP/329963/OWDEL1/SBI,0.0,11800.0,,2018,8,13,TRANSFER,11800.0,C1469261298
25135,1196428',2018-08-13,CHQ DEP/116303/OWDEL1/SBI,0.0,11800.0,,2018,8,13,CASH_IN,11800.0,C424954008
25136,1196428',2018-08-13,CHQ DEP/858059/OWDEL1/SBI,0.0,11800.0,,2018,8,13,TRANSFER,11800.0,C141458554
25137,1196428',2018-08-13,CHQ DEP/103/OWDEL1/HDFC/D,0.0,11800.0,,2018,8,13,CASH_IN,11800.0,C1321530272
25138,1196428',2018-08-13,CHQ DEP/389/OWDEL1/HDFC/,0.0,11800.0,,2018,8,13,TRANSFER,11800.0,C1079554968
25139,1196428',2018-08-13,CHQ DEP/6/OWDEL1/ASFB/  J,0.0,11800.0,,2018,8,13,CHECK_CASHING,11800.0,C2057394816
25140,1196428',2018-08-13,CHQ DEP/900/OWDEL1/SBIN/,0.0,11800.0,,2018,8,13,TRANSFER,11800.0,C287711177
25141,1196428',2018-08-13,CHQ DEP/502070/OWDEL1/SBI,0.0,11800.0,,2018,8,13,TRANSFER,11800.0,C726752092
25142,1196428',2018-08-13,CHQ DEP/311/OWDEL1/BARB/S,0.0,11800.0,,2018,8,13,CASH_IN,11800.0,C1292435170
25143,1196428',2018-08-13,CHQ DEP/1986/OWDEL1/BARB/,0.0,11800.0,,2018,8,13,CHECK_CASHING,11800.0,C1104197405
25144,1196428',2018-08-13,CHQ DEP/1029/OWDEL1/BARB/,0.0,11800.0,,2018,8,13,TRANSFER,11800.0,C74288440
25145,1196428',2018-08-13,CHQ DEP/154448/OWDEL1/SBI,0.0,11800.0,,2018,8,13,CASH_IN,11800.0,C988705496
25146,1196428',2018-08-13,CHQ DEP/3641/OWDEL1/BARB/,0.0,11800.0,,2018,8,13,CASH_IN,11800.0,C1150043970
25147,1196428',2018-08-13,CHQ DEP/575669/OWDEL1/SBI,0.0,11800.0,,2018,8,13,CASH_IN,11800.0,C1494895909
25148,1196428',2018-08-13,CHQ DEP/671613/OWDEL1/SBI,0.0,11800.0,,2018,8,13,TRANSFER,11800.0,C591824146
25149,1196428',2018-08-13,CHQ DEP/801098/OWDEL1/SBI,0.0,11800.0,,2018,8,13,CASH_IN,11800.0,C1359484306
25150,1196428',2018-08-13,TRF FRM  Indiaforensic SERVICES,0.0,10000000.0,,2018,8,13,CHECK_CASHING,10000000.0,C683605346
25151,1196428',2018-08-13,TRF FRM  Indiaforensic SERVICES,0.0,10000000.0,,2018,8,13,CASH_IN,10000000.0,C957388291
25152,1196428',2018-08-13,TRF FRM  Indiaforensic SERVICES,0.0,5000000.0,,2018,8,13,TRANSFER,5000000.0,C1188392295
25153,1196428',2018-08-13,TRF FRM  Indiaforensic SERVICES,0.0,15000000.0,,2018,8,13,CHECK_CASHING,15000000.0,C646059443
25154,1196428',2018-08-13,IB:TPFT0075732001 3090027,0.0,5000.0,,2018,8,13,CASH_IN,5000.0,C1771190979
25155,1196428',2018-08-13,RTGS/ICICH18225700528/Indfor,0.0,2900000.0,,2018,8,13,TRANSFER,2900000.0,C1786622318
25156,1196428',2018-08-13,CHQ DEP/699823/OWMUM5/IND,0.0,11800.0,,2018,8,13,CASH_IN,11800.0,M634348486
25157,1196428',2018-08-13,CHQ DEP/36270/OWMUM5/SBIN,0.0,11800.0,,2018,8,13,CHECK_CASHING,11800.0,M444741171
25158,1196428',2018-08-13,RTGS/ICICH18225701839/Indfor,0.0,800000.0,,2018,8,13,TRANSFER,800000.0,M1769360230
25159,1196428',2018-08-13,FDRL/REAL TIME GROSS SETTL,15000000.0,0.0,,2018,8,13,DEBIT,15000000.0,M1005563137
25160,1196428',2018-08-13,FDRL/REAL TIME GROSS SETTL,10000000.0,0.0,,2018,8,13,CASH_OUT,10000000.0,C66497191
25161,1196428',2018-08-13,FDRL/REAL TIME GROSS SETTL,15000000.0,0.0,,2018,8,13,CASH_OUT,15000000.0,C875761527
25162,1196428',2018-08-13,FDRL/REAL TIME GROSS SETTL,3000000.0,0.0,,2018,8,13,CHECK_WITHDRAWAL,3000000.0,C803116137
25163,1196428',2018-08-13,CASHPMT/GURGAON/SELF,49000.0,0.0,,2018,8,13,DEBIT,49000.0,C711278951
25164,1196428',2018-08-13,Indiaforensic SERVICES INDIA PVT,0.0,435566.0,,2018,8,13,CHECK_CASHING,435566.0,C1172042998
25165,1196428',2018-08-13,CHQ DEPOSIT RETURN/9634/O,11800.0,0.0,,2018,8,13,CASH_OUT,11800.0,C367746789
25166,1196428',2018-08-13,CHQ DEPOSIT RETURN/178509,11800.0,0.0,,2018,8,13,DEBIT,11800.0,C1647754924
25167,1196428',2018-08-13,CHQ DEPOSIT RETURN/389/FU,11800.0,0.0,,2018,8,13,CASH_OUT,11800.0,M1926514433
25168,1196428',2018-08-13,CHQ DEPOSIT RETURN/311/FU,11800.0,0.0,,2018,8,13,CHECK_WITHDRAWAL,11800.0,C885951223
25169,1196428',2018-08-13,FDRL/INTERNAL FUND TRANSFE,500000.0,0.0,,2018,8,13,DEBIT,500000.0,M353468628
25170,1196428',2018-08-13,NEFT/PUNBH18225530217/BAL,0.0,130000.0,,2018,8,13,CASH_IN,130000.0,M1437951936
25171,1196428',2018-08-13,NEFT/SBIN518225741853/MS,0.0,159982.3,,2018,8,13,CASH_IN,159982.3,C1043984524
25172,1196428',2018-08-13,IMPS 822518067345 FROM SA,0.0,200000.0,,2018,8,13,CASH_IN,200000.0,C1167813715
25173,1196428',2018-08-13,TRF FRM  Indiaforensic SERVICES,0.0,4000000.0,,2018,8,13,CHECK_CASHING,4000000.0,C254871157
25174,1196428',2018-08-13,TRF FRM  Indiaforensic SERVICES,0.0,2000000.0,,2018,8,13,CHECK_CASHING,2000000.0,M618546568
25175,1196428',2018-08-13,NEFT/SBIN518225789360/M R,0.0,50000.0,,2018,8,13,CHECK_CASHING,50000.0,M1310977056
25176,1196428',2018-08-13,FDRL/INTERNAL FUND TRANSFE,200000.0,0.0,,2018,8,13,CHECK_WITHDRAWAL,200000.0,M215473896
25177,1196428',2018-08-13,FDRL/INTERNAL FUND TRANSFE,300000.0,0.0,,2018,8,13,DEBIT,300000.0,M685340304
25178,1196428',2018-08-13,BEAT CSH PKP DEL UDYO 620,0.0,480000.0,,2018,8,13,TRANSFER,480000.0,M1508558915
25179,1196428',2018-08-13,TRF FRM  Indiaforensic SERVICES,0.0,4000000.0,,2018,8,13,TRANSFER,4000000.0,M364533956
25180,1196428',2018-08-13,OCC/CHQ231581/DEP/FREEDOM,0.0,11800.0,,2018,8,13,CASH_IN,11800.0,M840416311
25181,1196428',2018-08-13,NEFT/N225180608839367/TEC,0.0,200000.0,,2018,8,13,CHECK_CASHING,200000.0,M631443475
25182,1196428',2018-08-13,FDRL/INTERNAL FUND TRANSFE,5000000.0,0.0,,2018,8,13,CHECK_WITHDRAWAL,5000000.0,C1311325237
25183,1196428',2018-08-13,FDRL/INTERNAL FUND TRANSFE,4000000.0,0.0,,2018,8,13,DEBIT,4000000.0,C579802590
25184,1196428',2018-08-13,CHQ DEPOSIT RETURN/178509,100.0,0.0,,2018,8,13,CASH_OUT,100.0,M237639235
25185,1196428',2018-08-13,CHQ DEPOSIT RETURN/178509,18.0,0.0,,2018,8,13,PAYEMENT,18.0,C801142660
25186,1196428',2018-08-13,CHQ DEPOSIT RETURN/389/CH,100.0,0.0,,2018,8,13,CHECK_WITHDRAWAL,100.0,C1615804266
25187,1196428',2018-08-13,CHQ DEPOSIT RETURN/389/GS,18.0,0.0,,2018,8,13,DEBIT,18.0,M111479970
25188,1196428',2018-08-13,CHQ DEPOSIT RETURN/311/CH,100.0,0.0,,2018,8,13,PAYEMENT,100.0,C259915853
25189,1196428',2018-08-13,CHQ DEPOSIT RETURN/311/GS,18.0,0.0,,2018,8,13,CHECK_WITHDRAWAL,18.0,C1548218207
25190,1196428',2018-08-14,IMPS 822610559126 FROM LV,0.0,11800.0,,2018,8,14,CASH_IN,11800.0,M806385042
25191,1196428',2018-08-14,FDRL/NATIONAL ELECTRONIC F,43359.0,0.0,,2018,8,14,DEBIT,43359.0,M298046464
25192,1196428',2018-08-14,FDRL/NATIONAL ELECTRONIC F,90167.0,0.0,,2018,8,14,PAYEMENT,90167.0,M1225689934
25193,1196428',2018-08-14,FDRL/NATIONAL ELECTRONIC F,73217.0,0.0,,2018,8,14,DEBIT,73217.0,C1678035039
25194,1196428',2018-08-14,FDRL/NATIONAL ELECTRONIC F,63425.0,0.0,,2018,8,14,PAYEMENT,63425.0,C524804429
25195,1196428',2018-08-14,FDRL/NATIONAL ELECTRONIC F,82224.0,0.0,,2018,8,14,PAYEMENT,82224.0,C2014517831
25196,1196428',2018-08-14,FDRL/NATIONAL ELECTRONIC F,58484.0,0.0,,2018,8,14,CASH_OUT,58484.0,M303589274
25197,1196428',2018-08-14,FDRL/NATIONAL ELECTRONIC F,74993.0,0.0,,2018,8,14,CASH_OUT,74993.0,M295337938
25198,1196428',2018-08-14,FDRL/NATIONAL ELECTRONIC F,73008.0,0.0,,2018,8,14,DEBIT,73008.0,C189963646
25199,1196428',2018-08-14,FDRL/NATIONAL ELECTRONIC F,68180.0,0.0,,2018,8,14,CASH_OUT,68180.0,M816393784
25200,1196428',2018-08-14,FDRL/NATIONAL ELECTRONIC F,59895.0,0.0,,2018,8,14,PAYEMENT,59895.0,M1891543748
25201,1196428',2018-08-14,FDRL/NATIONAL ELECTRONIC F,65568.0,0.0,,2018,8,14,DEBIT,65568.0,C1934837365
25202,1196428',2018-08-14,FDRL/NATIONAL ELECTRONIC F,58682.0,0.0,,2018,8,14,PAYEMENT,58682.0,M2039503101
25203,1196428',2018-08-14,FDRL/NATIONAL ELECTRONIC F,65790.0,0.0,,2018,8,14,PAYEMENT,65790.0,M1027346327
25204,1196428',2018-08-14,FDRL/NATIONAL ELECTRONIC F,32107.0,0.0,,2018,8,14,DEBIT,32107.0,M2000256250
25205,1196428',2018-08-14,FDRL/NATIONAL ELECTRONIC F,62454.0,0.0,,2018,8,14,CASH_OUT,62454.0,M1063286222
25206,1196428',2018-08-14,FDRL/NATIONAL ELECTRONIC F,11950.0,0.0,,2018,8,14,DEBIT,11950.0,C2011996123
25207,1196428',2018-08-14,FDRL/NATIONAL ELECTRONIC F,17271.0,0.0,,2018,8,14,PAYEMENT,17271.0,M761298760
25208,1196428',2018-08-14,FDRL/NATIONAL ELECTRONIC F,97210.0,0.0,,2018,8,14,CHECK_WITHDRAWAL,97210.0,M772550276
25209,1196428',2018-08-14,FDRL/NATIONAL ELECTRONIC F,26825.0,0.0,,2018,8,14,CHECK_WITHDRAWAL,26825.0,C582410861
25210,1196428',2018-08-14,FDRL/NATIONAL ELECTRONIC F,67736.0,0.0,,2018,8,14,CASH_OUT,67736.0,M351890044
25211,1196428',2018-08-14,FDRL/NATIONAL ELECTRONIC F,541.0,0.0,,2018,8,14,CASH_OUT,541.0,C306285887
25212,1196428',2018-08-14,FDRL/NATIONAL ELECTRONIC F,62568.0,0.0,,2018,8,14,PAYEMENT,62568.0,M1357144153
25213,1196428',2018-08-14,FDRL/NATIONAL ELECTRONIC F,18092.0,0.0,,2018,8,14,DEBIT,18092.0,C964931693
25214,1196428',2018-08-14,FDRL/NATIONAL ELECTRONIC F,13697.0,0.0,,2018,8,14,DEBIT,13697.0,M1871212187
25215,1196428',2018-08-14,FDRL/NATIONAL ELECTRONIC F,24293.0,0.0,,2018,8,14,CHECK_WITHDRAWAL,24293.0,C787040724
25216,1196428',2018-08-14,FDRL/NATIONAL ELECTRONIC F,15824.0,0.0,,2018,8,14,CASH_OUT,15824.0,C439917369
25217,1196428',2018-08-14,FDRL/NATIONAL ELECTRONIC F,19252.0,0.0,,2018,8,14,CASH_OUT,19252.0,M680867145
25218,1196428',2018-08-14,FDRL/NATIONAL ELECTRONIC F,14424.0,0.0,,2018,8,14,CASH_OUT,14424.0,C30516998
25219,1196428',2018-08-14,FDRL/NATIONAL ELECTRONIC F,70343.0,0.0,,2018,8,14,PAYEMENT,70343.0,M250044739
25220,1196428',2018-08-14,FDRL/NATIONAL ELECTRONIC F,15171.0,0.0,,2018,8,14,CASH_OUT,15171.0,C214774813
25221,1196428',2018-08-14,FDRL/NATIONAL ELECTRONIC F,18545.0,0.0,,2018,8,14,CASH_OUT,18545.0,C895798008
25222,1196428',2018-08-14,FDRL/NATIONAL ELECTRONIC F,16061.0,0.0,,2018,8,14,CASH_OUT,16061.0,C408304912
25223,1196428',2018-08-14,FDRL/NATIONAL ELECTRONIC F,16628.0,0.0,,2018,8,14,PAYEMENT,16628.0,C1740764606
25224,1196428',2018-08-14,FDRL/NATIONAL ELECTRONIC F,14353.0,0.0,,2018,8,14,CHECK_WITHDRAWAL,14353.0,M744452139
25225,1196428',2018-08-14,FDRL/NATIONAL ELECTRONIC F,11737.0,0.0,,2018,8,14,DEBIT,11737.0,M1564198243
25226,1196428',2018-08-14,FDRL/NATIONAL ELECTRONIC F,13816.0,0.0,,2018,8,14,CASH_OUT,13816.0,C1998741793
25227,1196428',2018-08-14,FDRL/NATIONAL ELECTRONIC F,10452.0,0.0,,2018,8,14,DEBIT,10452.0,M114126120
25228,1196428',2018-08-14,FDRL/NATIONAL ELECTRONIC F,28288.0,0.0,,2018,8,14,CASH_OUT,28288.0,C1044117371
25229,1196428',2018-08-14,FDRL/NATIONAL ELECTRONIC F,19449.0,0.0,,2018,8,14,PAYEMENT,19449.0,C518334273
25230,1196428',2018-08-14,FDRL/NATIONAL ELECTRONIC F,10452.0,0.0,,2018,8,14,CASH_OUT,10452.0,C1619489362
25231,1196428',2018-08-14,FDRL/NATIONAL ELECTRONIC F,14424.0,0.0,,2018,8,14,DEBIT,14424.0,M3081338
25232,1196428',2018-08-14,FDRL/NATIONAL ELECTRONIC F,16989.0,0.0,,2018,8,14,CHECK_WITHDRAWAL,16989.0,M2076866837
25233,1196428',2018-08-14,FDRL/NATIONAL ELECTRONIC F,12101.0,0.0,,2018,8,14,PAYEMENT,12101.0,M1797439027
25234,1196428',2018-08-14,FDRL/NATIONAL ELECTRONIC F,19146.0,0.0,,2018,8,14,DEBIT,19146.0,M768958618
25235,1196428',2018-08-14,FDRL/NATIONAL ELECTRONIC F,27685.0,0.0,,2018,8,14,DEBIT,27685.0,M1940466750
25236,1196428',2018-08-14,FDRL/NATIONAL ELECTRONIC F,21933.0,0.0,,2018,8,14,DEBIT,21933.0,M233179469
25237,1196428',2018-08-14,FDRL/NATIONAL ELECTRONIC F,10821.0,0.0,,2018,8,14,CHECK_WITHDRAWAL,10821.0,C1799587714
25238,1196428',2018-08-14,FDRL/NATIONAL ELECTRONIC F,10735.0,0.0,,2018,8,14,CASH_OUT,10735.0,C1004780164
25239,1196428',2018-08-14,FDRL/NATIONAL ELECTRONIC F,25791.0,0.0,,2018,8,14,DEBIT,25791.0,M555162906
25240,1196428',2018-08-14,FDRL/NATIONAL ELECTRONIC F,13084.0,0.0,,2018,8,14,CASH_OUT,13084.0,M189722401
25241,1196428',2018-08-14,FDRL/NATIONAL ELECTRONIC F,12953.0,0.0,,2018,8,14,CHECK_WITHDRAWAL,12953.0,C1504217374
25242,1196428',2018-08-14,FDRL/NATIONAL ELECTRONIC F,10583.0,0.0,,2018,8,14,CHECK_WITHDRAWAL,10583.0,C1006094903
25243,1196428',2018-08-14,FDRL/NATIONAL ELECTRONIC F,25719.0,0.0,,2018,8,14,DEBIT,25719.0,M66754707
25244,1196428',2018-08-14,FDRL/NATIONAL ELECTRONIC F,22600.0,0.0,,2018,8,14,CASH_OUT,22600.0,M721626159
25245,1196428',2018-08-14,FDRL/NATIONAL ELECTRONIC F,28425.0,0.0,,2018,8,14,PAYEMENT,28425.0,M160683887
25246,1196428',2018-08-14,FDRL/NATIONAL ELECTRONIC F,19069.0,0.0,,2018,8,14,PAYEMENT,19069.0,M614001445
25247,1196428',2018-08-14,FDRL/NATIONAL ELECTRONIC F,15814.0,0.0,,2018,8,14,CASH_OUT,15814.0,C1684776894
25248,1196428',2018-08-14,FDRL/NATIONAL ELECTRONIC F,12596.0,0.0,,2018,8,14,PAYEMENT,12596.0,C1876351111
25249,1196428',2018-08-14,FDRL/NATIONAL ELECTRONIC F,2473.0,0.0,,2018,8,14,PAYEMENT,2473.0,C836903727
25250,1196428',2018-08-14,FDRL/NATIONAL ELECTRONIC F,27120.0,0.0,,2018,8,14,DEBIT,27120.0,C1127705091
25251,1196428',2018-08-14,FDRL/NATIONAL ELECTRONIC F,26366.0,0.0,,2018,8,14,PAYEMENT,26366.0,C358945794
25252,1196428',2018-08-14,FDRL/NATIONAL ELECTRONIC F,15871.0,0.0,,2018,8,14,DEBIT,15871.0,M328302161
25253,1196428',2018-08-14,FDRL/NATIONAL ELECTRONIC F,17769.0,0.0,,2018,8,14,PAYEMENT,17769.0,M1970290561
25254,1196428',2018-08-14,FDRL/NATIONAL ELECTRONIC F,9168.0,0.0,,2018,8,14,PAYEMENT,9168.0,C1379289710
25255,1196428',2018-08-14,FDRL/NATIONAL ELECTRONIC F,12596.0,0.0,,2018,8,14,DEBIT,12596.0,C75629578
25256,1196428',2018-08-14,FDRL/NATIONAL ELECTRONIC F,10959.0,0.0,,2018,8,14,CASH_OUT,10959.0,C1424731356
25257,1196428',2018-08-14,FDRL/NATIONAL ELECTRONIC F,11010.0,0.0,,2018,8,14,CHECK_WITHDRAWAL,11010.0,C1796712971
25258,1196428',2018-08-14,FDRL/NATIONAL ELECTRONIC F,28264.0,0.0,,2018,8,14,CASH_OUT,28264.0,C1359484306
25259,1196428',2018-08-14,FDRL/NATIONAL ELECTRONIC F,22340.0,0.0,,2018,8,14,CHECK_WITHDRAWAL,22340.0,C1493513506
25260,1196428',2018-08-14,FDRL/NATIONAL ELECTRONIC F,26047.0,0.0,,2018,8,14,CASH_OUT,26047.0,C801142660
25261,1196428',2018-08-14,FDRL/NATIONAL ELECTRONIC F,27891.0,0.0,,2018,8,14,CASH_OUT,27891.0,C571435580
25262,1196428',2018-08-14,FDRL/NATIONAL ELECTRONIC F,14839.0,0.0,,2018,8,14,CHECK_WITHDRAWAL,14839.0,M325494866
25263,1196428',2018-08-14,FDRL/NATIONAL ELECTRONIC F,20303.0,0.0,,2018,8,14,PAYEMENT,20303.0,C439078113
25264,1196428',2018-08-14,FDRL/NATIONAL ELECTRONIC F,24090.0,0.0,,2018,8,14,DEBIT,24090.0,M1803503350
25265,1196428',2018-08-14,FDRL/NATIONAL ELECTRONIC F,18552.0,0.0,,2018,8,14,DEBIT,18552.0,M258774292
25266,1196428',2018-08-14,FDRL/NATIONAL ELECTRONIC F,16460.0,0.0,,2018,8,14,CASH_OUT,16460.0,C476441699
25267,1196428',2018-08-14,FDRL/NATIONAL ELECTRONIC F,23335.0,0.0,,2018,8,14,DEBIT,23335.0,C712956349
25268,1196428',2018-08-14,FDRL/NATIONAL ELECTRONIC F,32453.0,0.0,,2018,8,14,CASH_OUT,32453.0,M1832182497
25269,1196428',2018-08-14,FDRL/NATIONAL ELECTRONIC F,23569.0,0.0,,2018,8,14,PAYEMENT,23569.0,C801156385
25270,1196428',2018-08-14,FDRL/NATIONAL ELECTRONIC F,28660.0,0.0,,2018,8,14,CHECK_WITHDRAWAL,28660.0,M1873607804
25271,1196428',2018-08-14,RTGS/SBINH18226012665/Indfor,0.0,8800000.0,,2018,8,14,CHECK_CASHING,8800000.0,M321860265
25272,1196428',2018-08-14,FDRL/REAL TIME GROSS SETTL,9094287.54,0.0,,2018,8,14,CHECK_WITHDRAWAL,9094287.54,C619120762
25273,1196428',2018-08-14,FDRL/INTERNAL FUND TRANSFE,400000.0,0.0,,2018,8,14,CHECK_WITHDRAWAL,400000.0,C227998366
25274,1196428',2018-08-14,RTGS/PUNBH18226031472/MAN,0.0,300000.0,,2018,8,14,CASH_IN,300000.0,C1588901702
25275,1196428',2018-08-14,RTGS/ICICH18226858463/Indfor,0.0,3000000.0,,2018,8,14,TRANSFER,3000000.0,M2106154382
25276,1196428',2018-08-14,FDRL/INTERNAL FUND TRANSFE,1000000.0,0.0,,2018,8,14,CASH_OUT,1000000.0,C1615804266
25277,1196428',2018-08-14,IMPS 822613123575 FROM PU,0.0,34000.0,,2018,8,14,CHECK_CASHING,34000.0,C371271246
25278,1196428',2018-08-14,RTGS/HDFCH18226105076/Indfor,0.0,3800000.0,,2018,8,14,CHECK_CASHING,3800000.0,M787109639
25279,1196428',2018-08-14,FDRL/REAL TIME GROSS SETTL,5000000.0,0.0,,2018,8,14,PAYEMENT,5000000.0,M1961729238
25280,1196428',2018-08-14,TRF FROM  Indiaforensic SERVICES,0.0,15000000.0,,2018,8,14,CASH_IN,15000000.0,M1371988489
25281,1196428',2018-08-14,TRF FROM  Indiaforensic SERVICES,0.0,1300000.0,,2018,8,14,CHECK_CASHING,1300000.0,C42519721
25282,1196428',2018-08-14,FDRL/REAL TIME GROSS SETTL,15000000.0,0.0,,2018,8,14,CHECK_WITHDRAWAL,15000000.0,M684044363
25283,1196428',2018-08-14,FDRL/REAL TIME GROSS SETTL,2000000.0,0.0,,2018,8,14,DEBIT,2000000.0,M230156739
25284,1196428',2018-08-14,RTGS/SBINH18226049453/MS,0.0,340000.0,,2018,8,14,CASH_IN,340000.0,M1245838525
25285,1196428',2018-08-14,RTGS/HDFCH18226171720/BAT,0.0,295000.0,,2018,8,14,TRANSFER,295000.0,M407931709
25286,1196428',2018-08-14,NEFT/AXISP00007407257/ACC,0.0,2500000.0,,2018,8,14,CASH_IN,2500000.0,M137383920
25287,1196428',2018-08-14,Indiaforensic SERVICES INDIA PVT,0.0,189543.0,,2018,8,14,TRANSFER,189543.0,C214774813
25288,1196428',2018-08-14,FDRL/INTERNAL FUND TRANSFE,100000.0,0.0,,2018,8,14,CHECK_WITHDRAWAL,100000.0,M551444637
25289,1196428',2018-08-14,NEFT/PUNBH18226825624/PUN,0.0,100000.0,,2018,8,14,CASH_IN,100000.0,C1191985342
25290,1196428',2018-08-14,CASHDEP/GHATKOPAR/,0.0,100500.0,,2018,8,14,TRANSFER,100500.0,C2071722626
25291,1196428',2018-08-14,NEFT/P18081487189208/ILAG,0.0,11800.0,,2018,8,14,CASH_IN,11800.0,C58642425
25292,1196428',2018-08-14,IRTT00701823610,957.52,0.0,,2018,8,14,PAYEMENT,957.52,M995588714
25293,1196428',2018-08-14,"Indiaforensic USA, INC./USD/9153",0.0,636133.5,,2018,8,14,TRANSFER,636133.5,M1693397348
25294,1196428',2018-08-14,FDRL/INTERNAL FUND TRANSFE,300000.0,0.0,,2018,8,14,CHECK_WITHDRAWAL,300000.0,C1531333864
25295,1196428',2018-08-14,FDRL/INTERNAL FUND TRANSFE,500000.0,0.0,,2018,8,14,DEBIT,500000.0,M1873768248
25296,1196428',2018-08-14,FDRL/INTERNAL FUND TRANSFE,200000.0,0.0,,2018,8,14,CHECK_WITHDRAWAL,200000.0,M580623663
25297,1196428',2018-08-14,NEFT/000050554302/Indiaforensic,0.0,1600000.0,,2018,8,14,TRANSFER,1600000.0,C114720259
25298,1196428',2018-08-14,BEAT CSH PKP DEL UDYO 620,0.0,133700.0,,2018,8,14,CHECK_CASHING,133700.0,C815121481
25299,1196428',2018-08-14,NEFT/000050554543/Indiaforensic,0.0,900000.0,,2018,8,14,CASH_IN,900000.0,M2133823778
25300,1196428',2018-08-14,NEFT/N226180609813382/Indfor,0.0,3100000.0,,2018,8,14,CHECK_CASHING,3100000.0,M2029111797
25301,1196428',2018-08-14,TRF FROM  Indiaforensic SERVICES,0.0,8900000.0,,2018,8,14,TRANSFER,8900000.0,C965614152
25302,1196428',2018-08-14,OCC/CHQ950121/DEP/PUNJABG,0.0,8000.0,,2018,8,14,TRANSFER,8000.0,M1463850358
25303,1196428',2018-08-14,FDRL/INTERNAL FUND TRANSFE,15000000.0,0.0,,2018,8,14,DEBIT,15000000.0,C1700355047
25304,1196428',2018-08-14,FDRL/INTERNAL FUND TRANSFE,2000000.0,0.0,,2018,8,14,DEBIT,2000000.0,M198927302
25305,1196428',2018-08-14,FDRL/INTERNAL FUND TRANSFE,1000000.0,0.0,,2018,8,14,CASH_OUT,1000000.0,M998817784
25306,1196428',2018-08-16,RTGS/PUNBH18228048448/BAL,0.0,200000.0,,2018,8,16,CHECK_CASHING,200000.0,M1535646894
25307,1196428',2018-08-16,RTGS/SBINH18228004920/Indfor,0.0,14900000.0,,2018,8,16,CASH_IN,14900000.0,M1623213219
25308,1196428',2018-08-16,FDRL/REAL TIME GROSS SETTL,9748491.05,0.0,,2018,8,16,PAYEMENT,9748491.05,M479647126
25309,1196428',2018-08-16,RTGS/SBINH18228006662/Indfor,0.0,2500000.0,,2018,8,16,TRANSFER,2500000.0,M720598959
25310,1196428',2018-08-16,NEFT/N228180610212280/ESS,0.0,100000.0,,2018,8,16,CHECK_CASHING,100000.0,M19397064
25311,1196428',2018-08-16,FDRL/REAL TIME GROSS SETTL,7961169.12,0.0,,2018,8,16,PAYEMENT,7961169.12,M1593334981
25312,1196428',2018-08-16,FDRL/NATIONAL ELECTRONIC F,10270.0,0.0,,2018,8,16,CHECK_WITHDRAWAL,10270.0,C1337741679
25313,1196428',2018-08-16,FDRL/NATIONAL ELECTRONIC F,23890.0,0.0,,2018,8,16,CHECK_WITHDRAWAL,23890.0,M557899162
25314,1196428',2018-08-16,FDRL/NATIONAL ELECTRONIC F,24712.0,0.0,,2018,8,16,CHECK_WITHDRAWAL,24712.0,C252837416
25315,1196428',2018-08-16,FDRL/NATIONAL ELECTRONIC F,8558.0,0.0,,2018,8,16,DEBIT,8558.0,M962208856
25316,1196428',2018-08-16,RTGS/HDFCH18228232856/BAT,0.0,300000.0,,2018,8,16,CHECK_CASHING,300000.0,C1438780049
25317,1196428',2018-08-16,IMPS 822812300414 FROM SA,0.0,50000.0,,2018,8,16,CASH_IN,50000.0,M1057051578
25318,1196428',2018-08-16,RTGS/SCBLH18228004339/FIX,0.0,200000.0,,2018,8,16,CHECK_CASHING,200000.0,M1162196562
25319,1196428',2018-08-16,TRF TO  Indiaforensic SERVICES I,105000.0,0.0,,2018,8,16,CHECK_WITHDRAWAL,105000.0,C820920634
25320,1196428',2018-08-16,TRF FRM  Indiaforensic SERVICES,0.0,3000000.0,,2018,8,16,CASH_IN,3000000.0,M82443838
25321,1196428',2018-08-16,NEFT/FDRL890331561/SARVATR,0.0,50000.0,,2018,8,16,CHECK_CASHING,50000.0,M2120653260
25322,1196428',2018-08-16,NEFT/N228180610427406/JUN,0.0,70000.0,,2018,8,16,TRANSFER,70000.0,C430297016
25323,1196428',2018-08-16,CHQ DEP/360241/OWDEL1/CNR,0.0,11800.0,,2018,8,16,CHECK_CASHING,11800.0,M129341357
25324,1196428',2018-08-16,CHQ DEP/212123/OWDEL1/SBI,0.0,11800.0,,2018,8,16,CASH_IN,11800.0,M1154510556
25325,1196428',2018-08-16,NEFT/AXISP00007557241/ACC,0.0,7000000.0,,2018,8,16,TRANSFER,7000000.0,C1143894549
25326,1196428',2018-08-16,FDRL/REAL TIME GROSS SETTL,10000000.0,0.0,,2018,8,16,CASH_OUT,10000000.0,M1178841218
25327,1196428',2018-08-16,TRF FRM  Indiaforensic SERVICES,0.0,2000000.0,,2018,8,16,TRANSFER,2000000.0,C896393489
25328,1196428',2018-08-16,IMPS 822814194494 FROM PU,0.0,30000.0,,2018,8,16,CHECK_CASHING,30000.0,M890345418
25329,1196428',2018-08-16,TRF FROM  Indiaforensic SERVICES,0.0,3000000.0,,2018,8,16,CASH_IN,3000000.0,M2075822547
25330,1196428',2018-08-16,TRF FROM  Indiaforensic SERVICES,0.0,10000000.0,,2018,8,16,TRANSFER,10000000.0,M1165930496
25331,1196428',2018-08-16,TRF FROM  Indiaforensic SERVICES,0.0,10000000.0,,2018,8,16,CASH_IN,10000000.0,M1805339673
25332,1196428',2018-08-16,FDRL/REAL TIME GROSS SETTL,15000000.0,0.0,,2018,8,16,CASH_OUT,15000000.0,M1631290931
25333,1196428',2018-08-16,FDRL/REAL TIME GROSS SETTL,10000000.0,0.0,,2018,8,16,CHECK_WITHDRAWAL,10000000.0,C382068653
25334,1196428',2018-08-16,RTGS/SBINH18228052354/SAI,0.0,530000.0,,2018,8,16,TRANSFER,530000.0,M1852168781
25335,1196428',2018-08-16,FDRL/NATIONAL ELECTRONIC F,45247.0,0.0,,2018,8,16,CHECK_WITHDRAWAL,45247.0,M1947118497
25336,1196428',2018-08-16,FDRL/NATIONAL ELECTRONIC F,2020.0,0.0,,2018,8,16,CASH_OUT,2020.0,C653745564
25337,1196428',2018-08-16,Indiaforensic SERVICES INDIA PVT,0.0,306527.0,,2018,8,16,CHECK_CASHING,306527.0,M886801281
25338,1196428',2018-08-16,FDRL/INTERNAL FUND TRANSFE,400000.0,0.0,,2018,8,16,PAYEMENT,400000.0,M935255260
25339,1196428',2018-08-16,FDRL/INTERNAL FUND TRANSFE,400000.0,0.0,,2018,8,16,CASH_OUT,400000.0,M624366199
25340,1196428',2018-08-16,IMPS 822817996255 FROM AR,0.0,25000.0,,2018,8,16,CHECK_CASHING,25000.0,M443674097
25341,1196428',2018-08-16,TRF FROM  Indiaforensic SERVICES,0.0,1000000.0,,2018,8,16,CHECK_CASHING,1000000.0,C219416103
25342,1196428',2018-08-16,TRF FROM  Indiaforensic SERVICES,0.0,1000000.0,,2018,8,16,TRANSFER,1000000.0,M386235314
25343,1196428',2018-08-16,NEFT/000050641732/Indiaforensic,0.0,2700000.0,,2018,8,16,TRANSFER,2700000.0,M1425963918
25344,1196428',2018-08-16,BEAT CSH PKP DEL UDYOG 62,0.0,176000.0,,2018,8,16,TRANSFER,176000.0,M1810225003
25345,1196428',2018-08-16,TRF FROM  Indiaforensic SERVICES,0.0,10000000.0,,2018,8,16,CASH_IN,10000000.0,M1049283143
25346,1196428',2018-08-16,TRF FROM  Indiaforensic SERVICES,0.0,1000000.0,,2018,8,16,TRANSFER,1000000.0,C1753295732
25347,1196428',2018-08-16,FDRL/INTERNAL FUND TRANSFE,7000000.0,0.0,,2018,8,16,CASH_OUT,7000000.0,M1162902886
25348,1196428',2018-08-16,NEFT/000050641362/Indiaforensic,0.0,800000.0,,2018,8,16,TRANSFER,800000.0,M1697140475
25349,1196428',2018-08-16,FDRL/INTERNAL FUND TRANSFE,500000.0,0.0,,2018,8,16,DEBIT,500000.0,C211753297
25350,1196428',2018-08-16,FDRL/INTERNAL FUND TRANSFE,500000.0,0.0,,2018,8,16,DEBIT,500000.0,C291600495
25351,1196428',2018-08-17,FDRL/REAL TIME GROSS SETTL,7171568.26,0.0,,2018,8,17,DEBIT,7171568.26,M2025376018
25352,1196428',2018-08-17,TRF FROM  Indiaforensic SERVICES,0.0,500000.0,,2018,8,17,CASH_IN,500000.0,M1366006911
25353,1196428',2018-08-17,TRF FROM  Indiaforensic SERVICES,0.0,500000.0,,2018,8,17,CHECK_CASHING,500000.0,M820417016
25354,1196428',2018-08-17,FDRL/INTERNAL FUND TRANSFE,500000.0,0.0,,2018,8,17,CASH_OUT,500000.0,M1014146946
25355,1196428',2018-08-17,FDRL/INTERNAL FUND TRANSFE,500000.0,0.0,,2018,8,17,CHECK_WITHDRAWAL,500000.0,M2008284193
25356,1196428',2018-08-17,IMPS 822913324865 FROM AS,0.0,100199.0,,2018,8,17,CASH_IN,100199.0,C1949430968
25357,1196428',2018-08-17,NEFT/N229180611353714/BAT,0.0,160000.0,,2018,8,17,CASH_IN,160000.0,M1355360957
25358,1196428',2018-08-17,NEFT/N229180611442580/TEC,0.0,100000.0,,2018,8,17,TRANSFER,100000.0,M1347550799
25359,1196428',2018-08-17,TRF FROM  Indiaforensic SERVICES,0.0,14600000.0,,2018,8,17,CHECK_CASHING,14600000.0,C1276424637
25360,1196428',2018-08-17,FDRL/REAL TIME GROSS SETTL,10000000.0,0.0,,2018,8,17,CHECK_WITHDRAWAL,10000000.0,C224063653
25361,1196428',2018-08-17,FDRL/REAL TIME GROSS SETTL,5000000.0,0.0,,2018,8,17,DEBIT,5000000.0,C1805683209
25362,1196428',2018-08-17,FDRL/INTERNAL FUND TRANSFE,400000.0,0.0,,2018,8,17,DEBIT,400000.0,C862584412
25363,1196428',2018-08-17,FDRL/NATIONAL ELECTRONIC F,30798.0,0.0,,2018,8,17,CHECK_WITHDRAWAL,30798.0,C999544948
25364,1196428',2018-08-17,FDRL/NATIONAL ELECTRONIC F,40959.0,0.0,,2018,8,17,CHECK_WITHDRAWAL,40959.0,C24404443
25365,1196428',2018-08-17,FDRL/NATIONAL ELECTRONIC F,37667.0,0.0,,2018,8,17,DEBIT,37667.0,M1094627494
25366,1196428',2018-08-17,FDRL/NATIONAL ELECTRONIC F,36264.0,0.0,,2018,8,17,CASH_OUT,36264.0,M1958061979
25367,1196428',2018-08-17,FDRL/NATIONAL ELECTRONIC F,48949.0,0.0,,2018,8,17,CHECK_WITHDRAWAL,48949.0,M929521607
25368,1196428',2018-08-17,FDRL/NATIONAL ELECTRONIC F,30250.0,0.0,,2018,8,17,CASH_OUT,30250.0,M1552646732
25369,1196428',2018-08-17,FDRL/NATIONAL ELECTRONIC F,37221.0,0.0,,2018,8,17,DEBIT,37221.0,C2007221780
25370,1196428',2018-08-17,FDRL/NATIONAL ELECTRONIC F,43359.0,0.0,,2018,8,17,PAYEMENT,43359.0,M1328982440
25371,1196428',2018-08-17,FDRL/NATIONAL ELECTRONIC F,33536.0,0.0,,2018,8,17,CASH_OUT,33536.0,C283471273
25372,1196428',2018-08-17,FDRL/NATIONAL ELECTRONIC F,42043.0,0.0,,2018,8,17,DEBIT,42043.0,M1702416360
25373,1196428',2018-08-17,FDRL/NATIONAL ELECTRONIC F,32107.0,0.0,,2018,8,17,PAYEMENT,32107.0,M775481794
25374,1196428',2018-08-17,FDRL/NATIONAL ELECTRONIC F,39550.0,0.0,,2018,8,17,CASH_OUT,39550.0,C1303868418
25375,1196428',2018-08-17,FDRL/NATIONAL ELECTRONIC F,36325.0,0.0,,2018,8,17,CHECK_WITHDRAWAL,36325.0,M811675558
25376,1196428',2018-08-17,FDRL/NATIONAL ELECTRONIC F,31595.0,0.0,,2018,8,17,DEBIT,31595.0,C111636207
25377,1196428',2018-08-17,FDRL/NATIONAL ELECTRONIC F,45200.0,0.0,,2018,8,17,PAYEMENT,45200.0,C339099861
25378,1196428',2018-08-17,FDRL/NATIONAL ELECTRONIC F,46658.0,0.0,,2018,8,17,DEBIT,46658.0,C1632716597
25379,1196428',2018-08-17,FDRL/NATIONAL ELECTRONIC F,34976.0,0.0,,2018,8,17,PAYEMENT,34976.0,C470217116
25380,1196428',2018-08-17,FDRL/NATIONAL ELECTRONIC F,45200.0,0.0,,2018,8,17,CASH_OUT,45200.0,C547644464
25381,1196428',2018-08-17,FDRL/NATIONAL ELECTRONIC F,41433.0,0.0,,2018,8,17,CHECK_WITHDRAWAL,41433.0,C992713622
25382,1196428',2018-08-17,FDRL/INTERNAL FUND TRANSFE,40680.0,0.0,,2018,8,17,CASH_OUT,40680.0,C265108079
25383,1196428',2018-08-17,FDRL/NATIONAL ELECTRONIC F,34258.0,0.0,,2018,8,17,PAYEMENT,34258.0,C1198167820
25384,1196428',2018-08-17,FDRL/NATIONAL ELECTRONIC F,26227.0,0.0,,2018,8,17,DEBIT,26227.0,M1417822573
25385,1196428',2018-08-17,FDRL/NATIONAL ELECTRONIC F,16268.0,0.0,,2018,8,17,CASH_OUT,16268.0,M1183168110
25386,1196428',2018-08-17,FDRL/NATIONAL ELECTRONIC F,33900.0,0.0,,2018,8,17,CASH_OUT,33900.0,M77235930
25387,1196428',2018-08-17,FDRL/NATIONAL ELECTRONIC F,36552.0,0.0,,2018,8,17,CHECK_WITHDRAWAL,36552.0,C892981061
25388,1196428',2018-08-17,FDRL/INTERNAL FUND TRANSFE,40680.0,0.0,,2018,8,17,CHECK_WITHDRAWAL,40680.0,M896703427
25389,1196428',2018-08-17,TRF FRM  Indiaforensic SERVICES,0.0,1700000.0,,2018,8,17,CASH_IN,1700000.0,M1782369681
25390,1196428',2018-08-17,NEFT/AXISP00007743734/ACC,0.0,5000000.0,,2018,8,17,CASH_IN,5000000.0,M1080721081
25391,1196428',2018-08-17,BEAT CSH PKP DEL UDYOG 62,0.0,132000.0,,2018,8,17,CHECK_CASHING,132000.0,M1519499063
25392,1196428',2018-08-17,FDRL/INTERNAL FUND TRANSFE,7000000.0,0.0,,2018,8,17,PAYEMENT,7000000.0,M307226978
25393,1196428',2018-08-18,Indiaforensic SERVICES INDIA PVT,0.0,165659.0,,2018,8,18,CHECK_CASHING,165659.0,M2122825086
25394,1196428',2018-08-18,RTGS/SBINH18230010300/Indfor,0.0,10400000.0,,2018,8,18,TRANSFER,10400000.0,M212888243
25395,1196428',2018-08-18,FDRL/INTERNAL FUND TRANSFE,500000.0,0.0,,2018,8,18,DEBIT,500000.0,M586252803
25396,1196428',2018-08-18,FDRL/INTERNAL FUND TRANSFE,500000.0,0.0,,2018,8,18,CASH_OUT,500000.0,M3637991
25397,1196428',2018-08-18,NEFT/N230180611827933/USH,0.0,133500.0,,2018,8,18,TRANSFER,133500.0,M977975940
25398,1196428',2018-08-18,FDRL/NATIONAL ELECTRONIC F,60042.0,0.0,,2018,8,18,PAYEMENT,60042.0,M1699364619
25399,1196428',2018-08-18,FDRL/REAL TIME GROSS SETTL,7256597.49,0.0,,2018,8,18,CHECK_WITHDRAWAL,7256597.49,M806882919
25400,1196428',2018-08-18,FDRL/REAL TIME GROSS SETTL,3000000.0,0.0,,2018,8,18,DEBIT,3000000.0,M1758932400
25401,1196428',2018-08-18,TRF FROM  Indiaforensic SERVICES,0.0,3000000.0,,2018,8,18,CASH_IN,3000000.0,M255735466
25402,1196428',2018-08-18,TRF FROM  Indiaforensic SERVICES,0.0,10000000.0,,2018,8,18,CHECK_CASHING,10000000.0,M231551825
25403,1196428',2018-08-18,RTGS/PUNBH18230088249/PUN,0.0,500000.0,,2018,8,18,CASH_IN,500000.0,M661245316
25404,1196428',2018-08-18,FDRL/REAL TIME GROSS SETTL,10000000.0,0.0,,2018,8,18,PAYEMENT,10000000.0,M787454975
25405,1196428',2018-08-18,FDRL/REAL TIME GROSS SETTL,3000000.0,0.0,,2018,8,18,PAYEMENT,3000000.0,M2138886145
25406,1196428',2018-08-18,IMPS 823013159348 FROM PU,0.0,28000.0,,2018,8,18,TRANSFER,28000.0,M77182701
25407,1196428',2018-08-18,FDRL/INTERNAL FUND TRANSFE,500000.0,0.0,,2018,8,18,CHECK_WITHDRAWAL,500000.0,M179187614
25408,1196428',2018-08-18,NEFT/AXISP00007781067/ACC,0.0,3000000.0,,2018,8,18,TRANSFER,3000000.0,M1246156733
25409,1196428',2018-08-18,NEFT/AXISP00007781066/ACC,0.0,5000000.0,,2018,8,18,TRANSFER,5000000.0,M2049321170
25410,1196428',2018-08-18,RTGS/HDFCH18230573133/BAT,0.0,300000.0,,2018,8,18,CASH_IN,300000.0,M213222415
25411,1196428',2018-08-18,NEFT/SBIN818230959156/M.R,0.0,100000.0,,2018,8,18,TRANSFER,100000.0,M1061471337
25412,1196428',2018-08-18,RTGS/ICICH18230525795/Indfor,0.0,1000000.0,,2018,8,18,CHECK_CASHING,1000000.0,M2102747587
25413,1196428',2018-08-18,RTGS/ICICH18230539016/Indfor,0.0,4000000.0,,2018,8,18,TRANSFER,4000000.0,C1282155635
25414,1196428',2018-08-18,NEFT/SBIN918230098806/VB,0.0,50000.0,,2018,8,18,CHECK_CASHING,50000.0,M905773216
25415,1196428',2018-08-18,FDRL/NATIONAL ELECTRONIC F,2000000.0,0.0,,2018,8,18,CASH_OUT,2000000.0,M93126017
25416,1196428',2018-08-18,FDRL/NATIONAL ELECTRONIC F,2000000.0,0.0,,2018,8,18,DEBIT,2000000.0,M1357642831
25417,1196428',2018-08-18,TRF FRM  Indiaforensic SERVICES,0.0,500000.0,,2018,8,18,CASH_IN,500000.0,C717951588
25418,1196428',2018-08-18,TRF FRM  Indiaforensic SERVICES,0.0,5000000.0,,2018,8,18,CASH_IN,5000000.0,M768075564
25419,1196428',2018-08-18,FDRL/INTERNAL FUND TRANSFE,500000.0,0.0,,2018,8,18,PAYEMENT,500000.0,M1974845323
25420,1196428',2018-08-18,FDRL/INTERNAL FUND TRANSFE,500000.0,0.0,,2018,8,18,CASH_OUT,500000.0,M1187047003
25421,1196428',2018-08-18,FDRL/INTERNAL FUND TRANSFE,500000.0,0.0,,2018,8,18,DEBIT,500000.0,M927162829
25422,1196428',2018-08-18,FDRL/INTERNAL FUND TRANSFE,500000.0,0.0,,2018,8,18,CASH_OUT,500000.0,M1187484134
25423,1196428',2018-08-18,FDRL/INTERNAL FUND TRANSFE,500000.0,0.0,,2018,8,18,PAYEMENT,500000.0,M329224404
25424,1196428',2018-08-18,FDRL/INTERNAL FUND TRANSFE,500000.0,0.0,,2018,8,18,CHECK_WITHDRAWAL,500000.0,C35782637
25425,1196428',2018-08-18,FDRL/INTERNAL FUND TRANSFE,500000.0,0.0,,2018,8,18,CHECK_WITHDRAWAL,500000.0,M96441530
25426,1196428',2018-08-18,FDRL/INTERNAL FUND TRANSFE,4000000.0,0.0,,2018,8,18,CHECK_WITHDRAWAL,4000000.0,C1028574311
25427,1196428',2018-08-18,FDRL/INTERNAL FUND TRANSFE,7000000.0,0.0,,2018,8,18,PAYEMENT,7000000.0,C1781062023
25428,1196428',2018-08-18,TRF FROM  Indiaforensic SERVICES,0.0,500000.0,,2018,8,18,TRANSFER,500000.0,M2122926449
25429,1196428',2018-08-18,TRF FROM  Indiaforensic SERVICES,0.0,500000.0,,2018,8,18,TRANSFER,500000.0,C1742312978
25430,1196428',2018-08-18,FDRL/INTERNAL FUND TRANSFE,500000.0,0.0,,2018,8,18,CHECK_WITHDRAWAL,500000.0,C152254957
25431,1196428',2018-08-18,FDRL/INTERNAL FUND TRANSFE,500000.0,0.0,,2018,8,18,CHECK_WITHDRAWAL,500000.0,M1326000969
25432,1196428',2018-08-18,FDRL/INTERNAL FUND TRANSFE,500000.0,0.0,,2018,8,18,PAYEMENT,500000.0,M831039199
25433,1196428',2018-08-18,BEAT CSH PKP DEL UDYOG 62,0.0,172000.0,,2018,8,18,CASH_IN,172000.0,M891081276
25434,1196428',2018-08-18,NEFT/000050728315/Indiaforensic,0.0,500000.0,,2018,8,18,CHECK_CASHING,500000.0,M940402077
25435,1196428',2018-08-20,IMPS 823209755724 FROM TA,0.0,10.0,,2018,8,20,CHECK_CASHING,10.0,M398795746
25436,1196428',2018-08-20,RTGS/PUNBH18232099533/BAL,0.0,200000.0,,2018,8,20,CHECK_CASHING,200000.0,C1355326338
25437,1196428',2018-08-20,FDRL/INTERNAL FUND TRANSFE,500000.0,0.0,,2018,8,20,CHECK_WITHDRAWAL,500000.0,M742710479
25438,1196428',2018-08-20,NEFT/N232180612469440/SHA,0.0,11800.0,,2018,8,20,TRANSFER,11800.0,C1657688673
25439,1196428',2018-08-20,RTGS/SBINH18232007312/Indfor,0.0,1000000.0,,2018,8,20,CHECK_CASHING,1000000.0,M1418952594
25440,1196428',2018-08-20,RTGS/SBINH18232005992/Indfor,0.0,14900000.0,,2018,8,20,CASH_IN,14900000.0,M1301044410
25441,1196428',2018-08-20,FDRL/REAL TIME GROSS SETTL,7766926.39,0.0,,2018,8,20,DEBIT,7766926.39,C927008541
25442,1196428',2018-08-20,FDRL/REAL TIME GROSS SETTL,7878765.18,0.0,,2018,8,20,PAYEMENT,7878765.18,M1277764371
25443,1196428',2018-08-20,TRF FROM  Indiaforensic SERVICES,0.0,2500000.0,,2018,8,20,CASH_IN,2500000.0,C1004780164
25444,1196428',2018-08-20,FDRL/REAL TIME GROSS SETTL,3000000.0,0.0,,2018,8,20,CASH_OUT,3000000.0,C1615443145
25445,1196428',2018-08-20,CASHDEP/GHATKOPAR/,0.0,83000.0,,2018,8,20,TRANSFER,83000.0,C627675433
25446,1196428',2018-08-20,"Indiaforensic USA, INC./USD/6387",0.0,442299.75,,2018,8,20,TRANSFER,442299.75,C679235222
25447,1196428',2018-08-20,IRTT00701823881,783.07,0.0,,2018,8,20,DEBIT,783.07,C2078011503
25448,1196428',2018-08-20,NEFT/SBIN918232738691/TAR,0.0,198000.0,,2018,8,20,CHECK_CASHING,198000.0,C715819458
25449,1196428',2018-08-20,TRF FRM  Indiaforensic SERVICES,0.0,14800000.0,,2018,8,20,CASH_IN,14800000.0,M1703639109
25450,1196428',2018-08-20,TRF FRM  Indiaforensic SERVICES,0.0,5800000.0,,2018,8,20,TRANSFER,5800000.0,M1505031405
25451,1196428',2018-08-20,NEFT/N232180612657155/K P,0.0,11800.0,,2018,8,20,CHECK_CASHING,11800.0,M365109650
25452,1196428',2018-08-20,RTGS/PUNBH18232109539/PUN,0.0,500000.0,,2018,8,20,CASH_IN,500000.0,M140246424
25453,1196428',2018-08-20,FDRL/INTERNAL FUND TRANSFE,500000.0,0.0,,2018,8,20,DEBIT,500000.0,M248118325
25454,1196428',2018-08-20,FDRL/REAL TIME GROSS SETTL,5000000.0,0.0,,2018,8,20,CASH_OUT,5000000.0,M473644297
25455,1196428',2018-08-20,FDRL/REAL TIME GROSS SETTL,10000000.0,0.0,,2018,8,20,DEBIT,10000000.0,M194832860
25456,1196428',2018-08-20,FDRL/REAL TIME GROSS SETTL,4000000.0,0.0,,2018,8,20,CHECK_WITHDRAWAL,4000000.0,M1488058038
25457,1196428',2018-08-20,NEFT/AXISP00007909700/ACC,0.0,2000000.0,,2018,8,20,CASH_IN,2000000.0,M1383835482
25458,1196428',2018-08-20,IMPS 823214377807 FROM AS,0.0,100090.0,,2018,8,20,CHECK_CASHING,100090.0,M582221316
25459,1196428',2018-08-20,RTGS/HDFCH18232775029/BAT,0.0,300000.0,,2018,8,20,TRANSFER,300000.0,M947328540
25460,1196428',2018-08-20,FDRL/INTERNAL FUND TRANSFE,500000.0,0.0,,2018,8,20,CASH_OUT,500000.0,M1963689324
25461,1196428',2018-08-20,PF+ST OF SME & FIGU & PAY,4030290.0,0.0,,2018,8,20,PAYEMENT,4030290.0,M188592776
25462,1196428',2018-08-20,TRF FRM  Indiaforensic SERVICES,0.0,10000000.0,,2018,8,20,TRANSFER,10000000.0,M1118618235
25463,1196428',2018-08-20,NEFT/BARBR18232059953/MAK,0.0,85650.0,,2018,8,20,CASH_IN,85650.0,M2069266944
25464,1196428',2018-08-20,Indiaforensic SERVICES INDIA PVT,0.0,381654.0,,2018,8,20,TRANSFER,381654.0,M478143531
25465,1196428',2018-08-20,NEFT/KVGBN18232057474/SHI,0.0,11800.0,,2018,8,20,CASH_IN,11800.0,M15361809
25466,1196428',2018-08-20,TRF FROM  Indiaforensic ONLINE S,0.0,317.0,,2018,8,20,CHECK_CASHING,317.0,M2040243967
25467,1196428',2018-08-20,NEFT/000050831208/Indiaforensic,0.0,1000000.0,,2018,8,20,CASH_IN,1000000.0,M2021159792
25468,1196428',2018-08-20,NEFT/000050828454/Indiaforensic,0.0,500000.0,,2018,8,20,TRANSFER,500000.0,M1959246940
25469,1196428',2018-08-20,NEFT/N232180613126696/TEC,0.0,300000.0,,2018,8,20,TRANSFER,300000.0,M777541077
25470,1196428',2018-08-20,NEFT/000050830876/Indiaforensic,0.0,2000000.0,,2018,8,20,CHECK_CASHING,2000000.0,M1307976989
25471,1196428',2018-08-20,FDRL/INTERNAL FUND TRANSFE,6000000.0,0.0,,2018,8,20,CASH_OUT,6000000.0,M910484561
25472,1196428',2018-08-20,FDRL/INTERNAL FUND TRANSFE,4000000.0,0.0,,2018,8,20,DEBIT,4000000.0,M474890214
25473,1196428',2018-08-20,FDRL/INTERNAL FUND TRANSFE,2000000.0,0.0,,2018,8,20,CASH_OUT,2000000.0,M552315703
25474,1196428',2018-08-20,FDRL/INTERNAL FUND TRANSFE,500000.0,0.0,,2018,8,20,DEBIT,500000.0,M1289453744
25475,1196428',2018-08-20,BEAT CSH PKP DEL UDYO 620,0.0,96800.0,,2018,8,20,CHECK_CASHING,96800.0,M1701179724
25476,1196428',2018-08-20,NEFT/P18082018227388/S B,0.0,199500.0,,2018,8,20,TRANSFER,199500.0,M1843858030
25477,1196428',2018-08-20,TRF FROM  Indiaforensic SERVICES,0.0,10800000.0,,2018,8,20,CHECK_CASHING,10800000.0,M1840871210
25478,1196428',2018-08-21,FDRL/INTERNAL FUND TRANSFE,400000.0,0.0,,2018,8,21,CHECK_WITHDRAWAL,400000.0,C1902797635
25479,1196428',2018-08-21,FDRL/INTERNAL FUND TRANSFE,500000.0,0.0,,2018,8,21,CASH_OUT,500000.0,M1277859572
25480,1196428',2018-08-21,FDRL/INTERNAL FUND TRANSFE,500000.0,0.0,,2018,8,21,PAYEMENT,500000.0,C2007792854
25481,1196428',2018-08-21,FDRL/REAL TIME GROSS SETTL,7767298.35,0.0,,2018,8,21,PAYEMENT,7767298.35,C1642244192
25482,1196428',2018-08-21,FDRL/REAL TIME GROSS SETTL,4000000.0,0.0,,2018,8,21,CHECK_WITHDRAWAL,4000000.0,C506903242
25483,1196428',2018-08-21,NEFT/SBIN118233382645/MR,0.0,100000.0,,2018,8,21,CHECK_CASHING,100000.0,M2072059657
25484,1196428',2018-08-21,IMPS 823312391420 FROM AS,0.0,120099.0,,2018,8,21,CHECK_CASHING,120099.0,C304406966
25485,1196428',2018-08-21,RTGS/HDFCH18233877108/JUN,0.0,200000.0,,2018,8,21,CHECK_CASHING,200000.0,C75629578
25486,1196428',2018-08-21,FDRL/INTERNAL FUND TRANSFE,500000.0,0.0,,2018,8,21,PAYEMENT,500000.0,M1037398211
25487,1196428',2018-08-21,NEFT/PUNBH18233707012/BAL,0.0,100000.0,,2018,8,21,CHECK_CASHING,100000.0,C2072030256
25488,1196428',2018-08-21,TRF FROM  Indiaforensic SERVICES,0.0,10000000.0,,2018,8,21,CASH_IN,10000000.0,C886888353
25489,1196428',2018-08-21,FDRL/REAL TIME GROSS SETTL,10000000.0,0.0,,2018,8,21,CASH_OUT,10000000.0,C701279123
25490,1196428',2018-08-21,RTGS/HDFCH18233956447/BAT,0.0,325000.0,,2018,8,21,TRANSFER,325000.0,C864016033
25491,1196428',2018-08-21,NEFT/N233180613765906/USH,0.0,102425.0,,2018,8,21,CHECK_CASHING,102425.0,C515442419
25492,1196428',2018-08-21,FDRL/INTERNAL FUND TRANSFE,100000.0,0.0,,2018,8,21,DEBIT,100000.0,M2127093801
25493,1196428',2018-08-21,NEFT/AXISP00008064101/ACC,0.0,5000000.0,,2018,8,21,CHECK_CASHING,5000000.0,C1649686970
25494,1196428',2018-08-21,Indiaforensic SERVICES INDIA PVT,0.0,158359.0,,2018,8,21,TRANSFER,158359.0,C701855966
25495,1196428',2018-08-21,CASHDEP/GHATKOPAR/,0.0,100000.0,,2018,8,21,CASH_IN,100000.0,C1505217516
25496,1196428',2018-08-21,FDRL/NATIONAL ELECTRONIC F,3000000.0,0.0,,2018,8,21,DEBIT,3000000.0,M676875212
25497,1196428',2018-08-21,FDRL/NATIONAL ELECTRONIC F,2000000.0,0.0,,2018,8,21,CHECK_WITHDRAWAL,2000000.0,C681709819
25498,1196428',2018-08-21,FDRL/INTERNAL FUND TRANSFE,500000.0,0.0,,2018,8,21,DEBIT,500000.0,M1025042585
25499,1196428',2018-08-21,TRF FROM  Indiaforensic SERVICES,0.0,6300000.0,,2018,8,21,CHECK_CASHING,6300000.0,C807247901
25500,1196428',2018-08-21,"Indiaforensic USA, INC./USD/7635",0.0,527578.5,,2018,8,21,CASH_IN,527578.5,M18308448
25501,1196428',2018-08-21,IRTT00701824197,859.82,0.0,,2018,8,21,CASH_OUT,859.82,M170030714
25502,1196428',2018-08-21,TRF FROM  Indiaforensic SERVICES,0.0,2600000.0,,2018,8,21,CHECK_CASHING,2600000.0,M621155607
25503,1196428',2018-08-21,TRF FROM  Indiaforensic SERVICES,0.0,200000.0,,2018,8,21,TRANSFER,200000.0,C1660095722
25504,1196428',2018-08-21,NEFT/PUNBH18233863447/PUN,0.0,100000.0,,2018,8,21,TRANSFER,100000.0,M1571765149
25505,1196428',2018-08-21,NEFT/000050912080/Indiaforensic,0.0,1500000.0,,2018,8,21,CASH_IN,1500000.0,C1663686815
25506,1196428',2018-08-21,NEFT/000050911772/Indiaforensic,0.0,1900000.0,,2018,8,21,CHECK_CASHING,1900000.0,M279824269
25507,1196428',2018-08-21,BEAT CSH PKP DEL UDYOG 62,0.0,216500.0,,2018,8,21,CHECK_CASHING,216500.0,M1570490488
25508,1196428',2018-08-21,FDRL/INTERNAL FUND TRANSFE,500000.0,0.0,,2018,8,21,CHECK_WITHDRAWAL,500000.0,M1063002743
25509,1196428',2018-08-21,FDRL/INTERNAL FUND TRANSFE,500000.0,0.0,,2018,8,21,PAYEMENT,500000.0,M1530195938
25510,1196428',2018-08-21,FDRL/INTERNAL FUND TRANSFE,500000.0,0.0,,2018,8,21,CHECK_WITHDRAWAL,500000.0,C1883840933
25511,1196428',2018-08-21,FDRL/INTERNAL FUND TRANSFE,500000.0,0.0,,2018,8,21,CASH_OUT,500000.0,M2097586567
25512,1196428',2018-08-21,FDRL/INTERNAL FUND TRANSFE,500000.0,0.0,,2018,8,21,CASH_OUT,500000.0,C1700852615
25513,1196428',2018-08-21,FDRL/INTERNAL FUND TRANSFE,8000000.0,0.0,,2018,8,21,DEBIT,8000000.0,C1457728035
25514,1196428',2018-08-21,FDRL/INTERNAL FUND TRANSFE,3000000.0,0.0,,2018,8,21,CHECK_WITHDRAWAL,3000000.0,C47249488
25515,1196428',2018-08-22,IMPS 823411535054 FROM SA,0.0,200000.0,,2018,8,22,TRANSFER,200000.0,C33524623
25516,1196428',2018-08-23,NEFT/SBIN218234196066/MS,0.0,200000.0,,2018,8,23,TRANSFER,200000.0,C2133591152
25517,1196428',2018-08-23,FDRL/INTERNAL FUND TRANSFE,400000.0,0.0,,2018,8,23,CHECK_WITHDRAWAL,400000.0,C193864812
25518,1196428',2018-08-23,RTGS/UTIBH18235685203/Indfor,0.0,500000.0,,2018,8,23,TRANSFER,500000.0,C1058921154
25519,1196428',2018-08-23,FDRL/INTERNAL FUND TRANSFE,400000.0,0.0,,2018,8,23,DEBIT,400000.0,C798678484
25520,1196428',2018-08-23,RTGS/SBINH18235012851/Indfor,0.0,14600000.0,,2018,8,23,CHECK_CASHING,14600000.0,C769342184
25521,1196428',2018-08-23,FDRL/REAL TIME GROSS SETTL,10892584.47,0.0,,2018,8,23,CHECK_WITHDRAWAL,10892584.47,C981198566
25522,1196428',2018-08-23,FDRL/INTERNAL FUND TRANSFE,500000.0,0.0,,2018,8,23,DEBIT,500000.0,C1281898359
25523,1196428',2018-08-23,TRF FROM  Indiaforensic SERVICES,0.0,700000.0,,2018,8,23,TRANSFER,700000.0,C30013970
25524,1196428',2018-08-23,CASHDEP/GHATKOPAR/,0.0,10561.0,,2018,8,23,CHECK_CASHING,10561.0,C31789747
25525,1196428',2018-08-23,RTGS/PUNBH18235154132/PUN,0.0,200000.0,,2018,8,23,CHECK_CASHING,200000.0,C93518808
25526,1196428',2018-08-23,FDRL/INTERNAL FUND TRANSFE,500000.0,0.0,,2018,8,23,PAYEMENT,500000.0,C2093546827
25527,1196428',2018-08-23,NEFT/N235180614609403/USH,0.0,175850.0,,2018,8,23,CHECK_CASHING,175850.0,C976133979
25528,1196428',2018-08-23,RTGS/SCBLH18235005478/FIX,0.0,250000.0,,2018,8,23,TRANSFER,250000.0,C849038219
25529,1196428',2018-08-23,TTRF FROM  Indiaforensic SERVICE,0.0,5800000.0,,2018,8,23,CASH_IN,5800000.0,C1789550256
25530,1196428',2018-08-23,RTGS/HDFCH18235147070/Indfor,0.0,7100000.0,,2018,8,23,CASH_IN,7100000.0,C363475076
25531,1196428',2018-08-23,FDRL/REAL TIME GROSS SETTL,9007025.91,0.0,,2018,8,23,DEBIT,9007025.91,C2110623348
25532,1196428',2018-08-23,TRF FROM  Indiaforensic SERVICES,0.0,15000000.0,,2018,8,23,CASH_IN,15000000.0,C1161820020
25533,1196428',2018-08-23,FDRL/REAL TIME GROSS SETTL,4000000.0,0.0,,2018,8,23,PAYEMENT,4000000.0,C627675433
25534,1196428',2018-08-23,FDRL/REAL TIME GROSS SETTL,4000000.0,0.0,,2018,8,23,CASH_OUT,4000000.0,C1145835418
25535,1196428',2018-08-23,FDRL/REAL TIME GROSS SETTL,15000000.0,0.0,,2018,8,23,CHECK_WITHDRAWAL,15000000.0,C1778300121
25536,1196428',2018-08-23,RTGS/ICICH18235243486/Indfor,0.0,1200000.0,,2018,8,23,CASH_IN,1200000.0,C1325626015
25537,1196428',2018-08-23,RTGS/ICICH18235244105/Indfor,0.0,2500000.0,,2018,8,23,TRANSFER,2500000.0,C8733802
25538,1196428',2018-08-23,Indiaforensic SERVICES INDIA PVT,0.0,270285.0,,2018,8,23,TRANSFER,270285.0,C990053853
25539,1196428',2018-08-23,RTGS/SBINH18235071649/SAI,0.0,1500000.0,,2018,8,23,CHECK_CASHING,1500000.0,C218193338
25540,1196428',2018-08-23,TRF FRM  Indiaforensic SERVICES,0.0,8700000.0,,2018,8,23,CHECK_CASHING,8700000.0,M832073005
25541,1196428',2018-08-23,FDRL/REAL TIME GROSS SETTL,4000000.0,0.0,,2018,8,23,DEBIT,4000000.0,M189083850
25542,1196428',2018-08-23,FDRL/REAL TIME GROSS SETTL,1000000.0,0.0,,2018,8,23,CHECK_WITHDRAWAL,1000000.0,C103357744
25543,1196428',2018-08-23,FDRL/REAL TIME GROSS SETTL,4000000.0,0.0,,2018,8,23,DEBIT,4000000.0,M1942890330
25544,1196428',2018-08-23,FDRL/REAL TIME GROSS SETTL,1000000.0,0.0,,2018,8,23,CHECK_WITHDRAWAL,1000000.0,C2011941350
25545,1196428',2018-08-23,FDRL/NATIONAL ELECTRONIC F,2000000.0,0.0,,2018,8,23,CHECK_WITHDRAWAL,2000000.0,C1505755152
25546,1196428',2018-08-23,FDRL/NATIONAL ELECTRONIC F,2000000.0,0.0,,2018,8,23,PAYEMENT,2000000.0,M1051118371
25547,1196428',2018-08-23,CASHDEP/GHATKOPAR/,0.0,116500.0,,2018,8,23,TRANSFER,116500.0,M1502077581
25548,1196428',2018-08-23,TRF FROM  Indiaforensic SERVICES,0.0,5900000.0,,2018,8,23,TRANSFER,5900000.0,M1801625172
25549,1196428',2018-08-23,TRF FROM  Indiaforensic SERVICES,0.0,1000000.0,,2018,8,23,CASH_IN,1000000.0,C360898540
25550,1196428',2018-08-23,NEFT/SBIN218235984258/HUS,0.0,11797.05,,2018,8,23,CHECK_CASHING,11797.05,M1408738192
25551,1196428',2018-08-23,FDRL/INTERNAL FUND TRANSFE,500000.0,0.0,,2018,8,23,DEBIT,500000.0,C237594516
25552,1196428',2018-08-23,FDRL/NATIONAL ELECTRONIC F,9452.0,0.0,,2018,8,23,DEBIT,9452.0,M1645271006
25553,1196428',2018-08-23,NEFT/AXISP00008295387/ACC,0.0,2000000.0,,2018,8,23,CASH_IN,2000000.0,M1616707854
25554,1196428',2018-08-23,TRF FROM  Indiaforensic SERVICES,0.0,5700000.0,,2018,8,23,TRANSFER,5700000.0,C1334973394
25555,1196428',2018-08-23,FDRL/INTERNAL FUND TRANSFE,400000.0,0.0,,2018,8,23,CASH_OUT,400000.0,M1547406846
25556,1196428',2018-08-23,FDRL/INTERNAL FUND TRANSFE,500000.0,0.0,,2018,8,23,PAYEMENT,500000.0,M51814511
25557,1196428',2018-08-23,FDRL/INTERNAL FUND TRANSFE,8000000.0,0.0,,2018,8,23,CHECK_WITHDRAWAL,8000000.0,M1679527434
25558,1196428',2018-08-23,FDRL/INTERNAL FUND TRANSFE,500000.0,0.0,,2018,8,23,CASH_OUT,500000.0,M858729243
25559,1196428',2018-08-23,FDRL/INTERNAL FUND TRANSFE,2000000.0,0.0,,2018,8,23,PAYEMENT,2000000.0,M317858117
25560,1196428',2018-08-23,BEAT CSH PKP DEL UDYOG 62,0.0,270800.0,,2018,8,23,CASH_IN,270800.0,M974232437
25561,1196428',2018-08-23,TRF TO  Indiaforensic SERVICES I,2000000.0,0.0,,2018,8,23,PAYEMENT,2000000.0,M535001108
25562,1196428',2018-08-23,TRF FROM  Indiaforensic SERVICES,0.0,500000.0,,2018,8,23,TRANSFER,500000.0,M967799453
25563,1196428',2018-08-23,FUJIAN NEW LAND PAYMENT T,1495953.6,0.0,,2018,8,23,CHECK_WITHDRAWAL,1495953.6,M1704857178
25564,1196428',2018-08-23,IMAR00701805085,3875.8,0.0,,2018,8,23,CASH_OUT,3875.8,M888552844
25565,1196428',2018-08-24,IB:TPFT000076806831309006,0.0,500.0,,2018,8,24,CASH_IN,500.0,M257269635
25566,1196428',2018-08-24,RTGS/SBINH18236009329/Indfor,0.0,6900000.0,,2018,8,24,CHECK_CASHING,6900000.0,C1305075214
25567,1196428',2018-08-24,RTGS/HDFCH18236283250/BAT,0.0,250000.0,,2018,8,24,CHECK_CASHING,250000.0,C1627965794
25568,1196428',2018-08-24,NEFT/N236180615546756/SRI,0.0,11800.0,,2018,8,24,CHECK_CASHING,11800.0,M1559676676
25569,1196428',2018-08-24,RTGS/SBINH18236018368/Indfor,0.0,1500000.0,,2018,8,24,CHECK_CASHING,1500000.0,C741431520
25570,1196428',2018-08-24,FDRL/REAL TIME GROSS SETTL,8735553.14,0.0,,2018,8,24,DEBIT,8735553.14,C2143477943
25571,1196428',2018-08-24,RTGS/UTIBH18236658090/Indfor,0.0,300000.0,,2018,8,24,TRANSFER,300000.0,C638551812
25572,1196428',2018-08-24,FDRL/INTERNAL FUND TRANSFE,500000.0,0.0,,2018,8,24,DEBIT,500000.0,C1027296777
25573,1196428',2018-08-24,NEFT/SBIN318236552817/M R,0.0,80000.0,,2018,8,24,CASH_IN,80000.0,C1554540309
25574,1196428',2018-08-24,CASHDEP/BOISAR/,0.0,6000.0,,2018,8,24,CASH_IN,6000.0,M2120427827
25575,1196428',2018-08-24,CASHDEP/GHATKOPAR/,0.0,86000.0,,2018,8,24,CHECK_CASHING,86000.0,C820910648
25576,1196428',2018-08-24,"Indiaforensic USA, INC./USD/1495",0.0,104500.5,,2018,8,24,CASH_IN,104500.5,M415456371
25577,1196428',2018-08-24,IRTT00701824414,479.05,0.0,,2018,8,24,PAYEMENT,479.05,M598340030
25578,1196428',2018-08-24,TRF FRM  Indiaforensic SERVICES,0.0,11500000.0,,2018,8,24,CHECK_CASHING,11500000.0,C345679794
25579,1196428',2018-08-24,FDRL/REAL TIME GROSS SETTL,10000000.0,0.0,,2018,8,24,CASH_OUT,10000000.0,M1605050346
25580,1196428',2018-08-24,FDRL/REAL TIME GROSS SETTL,1000000.0,0.0,,2018,8,24,CHECK_WITHDRAWAL,1000000.0,C1144070975
25581,1196428',2018-08-24,"Indiaforensic USA, INC./USD/9034",0.0,631476.6,,2018,8,24,CASH_IN,631476.6,M639999796
25582,1196428',2018-08-24,IRTT00701824424,953.33,0.0,,2018,8,24,DEBIT,953.33,C343534938
25583,1196428',2018-08-24,IMPS 823615378199 FROM AS,0.0,150099.0,,2018,8,24,CASH_IN,150099.0,M479872561
25584,1196428',2018-08-24,RTGS/ICICH18236403739/Indfor,0.0,1500000.0,,2018,8,24,TRANSFER,1500000.0,M61732893
25585,1196428',2018-08-24,RTGS/ICICH18236403316/Indfor,0.0,1500000.0,,2018,8,24,CHECK_CASHING,1500000.0,C160632822
25586,1196428',2018-08-24,NEFT/AXISP00008383859/ACC,0.0,10000000.0,,2018,8,24,CHECK_CASHING,10000000.0,C1183266411
25587,1196428',2018-08-24,FDRL/REAL TIME GROSS SETTL,10000000.0,0.0,,2018,8,24,CASH_OUT,10000000.0,M1328778262
25588,1196428',2018-08-24,FDRL/REAL TIME GROSS SETTL,4000000.0,0.0,,2018,8,24,PAYEMENT,4000000.0,M704806959
25589,1196428',2018-08-24,Indiaforensic SERVICES INDIA PVT,0.0,149259.0,,2018,8,24,TRANSFER,149259.0,C229313132
25590,1196428',2018-08-24,NEFT/SBIN318236851368/JAV,0.0,11800.0,,2018,8,24,TRANSFER,11800.0,M325906300
25591,1196428',2018-08-24,NEFT/SBIN318236876573/MS,0.0,200000.0,,2018,8,24,CASH_IN,200000.0,M1267748122
25592,1196428',2018-08-24,TRF FRM  Indiaforensic SERVICES,0.0,5500000.0,,2018,8,24,TRANSFER,5500000.0,M159739450
25593,1196428',2018-08-24,NEFT/000051073630/Indiaforensic,0.0,450000.0,,2018,8,24,CASH_IN,450000.0,M1702289141
25594,1196428',2018-08-24,FDRL/INTERNAL FUND TRANSFE,500000.0,0.0,,2018,8,24,PAYEMENT,500000.0,C1200612373
25595,1196428',2018-08-24,FDRL/INTERNAL FUND TRANSFE,500000.0,0.0,,2018,8,24,DEBIT,500000.0,C1840046890
25596,1196428',2018-08-24,NEFT/N236180616008043/TEC,0.0,200000.0,,2018,8,24,CASH_IN,200000.0,M1261751850
25597,1196428',2018-08-24,FDRL/INTERNAL FUND TRANSFE,400000.0,0.0,,2018,8,24,CHECK_WITHDRAWAL,400000.0,M1535970431
25598,1196428',2018-08-24,IMPS 823618572890 FROM SA,0.0,50000.0,,2018,8,24,CASH_IN,50000.0,M524251983
25599,1196428',2018-08-24,NEFT/000051073145/Indiaforensic,0.0,300000.0,,2018,8,24,TRANSFER,300000.0,C1406749291
25600,1196428',2018-08-24,NEFT/N236180616116884/Indfor,0.0,1200000.0,,2018,8,24,CHECK_CASHING,1200000.0,C1415645767
25601,1196428',2018-08-24,BEAT CSH PKP DEL UDYOG 62,0.0,31500.0,,2018,8,24,CASH_IN,31500.0,M1816834020
25602,1196428',2018-08-24,TRF FROM  Indiaforensic SERVICES,0.0,3180000.0,,2018,8,24,TRANSFER,3180000.0,C1732292969
25603,1196428',2018-08-24,FDRL/INTERNAL FUND TRANSFE,2000000.0,0.0,,2018,8,24,CHECK_WITHDRAWAL,2000000.0,M1739764490
25604,1196428',2018-08-24,FDRL/INTERNAL FUND TRANSFE,500000.0,0.0,,2018,8,24,DEBIT,500000.0,M1664129150
25605,1196428',2018-08-24,FDRL/INTERNAL FUND TRANSFE,2000000.0,0.0,,2018,8,24,CASH_OUT,2000000.0,M1128852062
25606,1196428',2018-08-24,FDRL/INTERNAL FUND TRANSFE,500000.0,0.0,,2018,8,24,PAYEMENT,500000.0,M182471589
25607,1196428',2018-08-24,PBGI01001800230:Bank Guar,11800.0,0.0,,2018,8,24,DEBIT,11800.0,M1056074872
25608,1196428',2018-08-24,FDRL/INTERNAL FUND TRANSFE,5000000.0,0.0,,2018,8,24,DEBIT,5000000.0,M2106622700
25609,1196428',2018-08-24,STAMP PAPER PURCHSE  stam,100.0,0.0,,2018,8,24,DEBIT,100.0,M163766295
25610,1196428',2018-08-24,FDRL/INTERNAL FUND TRANSFE,400000.0,0.0,,2018,8,24,CHECK_WITHDRAWAL,400000.0,M802332120
25611,1196428',2018-08-27,RTGS/HDFCH18239469265/JUN,0.0,350000.0,,2018,8,27,TRANSFER,350000.0,M1676185662
25612,1196428',2018-08-27,CASHDEP/GHATKOPAR/,0.0,125500.0,,2018,8,27,TRANSFER,125500.0,M1776427379
25613,1196428',2018-08-27,RTGS/SBINH18239010031/Indfor,0.0,14900000.0,,2018,8,27,CHECK_CASHING,14900000.0,M334173295
25614,1196428',2018-08-27,FDRL/REAL TIME GROSS SETTL,6156569.78,0.0,,2018,8,27,CHECK_WITHDRAWAL,6156569.78,M330490124
25615,1196428',2018-08-27,FDRL/REAL TIME GROSS SETTL,8195804.64,0.0,,2018,8,27,PAYEMENT,8195804.64,M1154845973
25616,1196428',2018-08-27,FDRL/INTERNAL FUND TRANSFE,400000.0,0.0,,2018,8,27,CHECK_WITHDRAWAL,400000.0,M911987264
25617,1196428',2018-08-27,NEFT/P18082723366727/S B,0.0,199500.0,,2018,8,27,TRANSFER,199500.0,M1680147473
25618,1196428',2018-08-27,RTGS/HDFCH18239515828/BAT,0.0,300000.0,,2018,8,27,TRANSFER,300000.0,M293659205
25619,1196428',2018-08-27,FDRL/INTERNAL FUND TRANSFE,500000.0,0.0,,2018,8,27,DEBIT,500000.0,M1432093328
25620,1196428',2018-08-27,TRF FRM  Indiaforensic SERVICES,0.0,15000000.0,,2018,8,27,CHECK_CASHING,15000000.0,M901262414
25621,1196428',2018-08-27,RTGS/PUNBH18239199418/PUN,0.0,400000.0,,2018,8,27,CASH_IN,400000.0,M899962047
25622,1196428',2018-08-27,IMPS 823914857318 FROM SA,0.0,100000.0,,2018,8,27,CASH_IN,100000.0,M32715716
25623,1196428',2018-08-27,FDRL/REAL TIME GROSS SETTL,9859647.22,0.0,,2018,8,27,DEBIT,9859647.22,M1510311379
25624,1196428',2018-08-27,TRF FRM  Indiaforensic SERVICES,0.0,14300000.0,,2018,8,27,CHECK_CASHING,14300000.0,M1517206841
25625,1196428',2018-08-27,FDRL/REAL TIME GROSS SETTL,5000000.0,0.0,,2018,8,27,PAYEMENT,5000000.0,M2030024765
25626,1196428',2018-08-27,FDRL/REAL TIME GROSS SETTL,15000000.0,0.0,,2018,8,27,DEBIT,15000000.0,M1267580132
25627,1196428',2018-08-27,FDRL/INTERNAL FUND TRANSFE,500000.0,0.0,,2018,8,27,CASH_OUT,500000.0,C655391383
25628,1196428',2018-08-27,RTGS/PUNBH18239201343/MAN,0.0,400000.0,,2018,8,27,CHECK_CASHING,400000.0,C2117215775
25629,1196428',2018-08-27,Indiaforensic SERVICES INDIA PVT,0.0,365840.0,,2018,8,27,TRANSFER,365840.0,C2106576360
25630,1196428',2018-08-27,FDRL/IndforSECURE_PAYMENT,0.0,10400.0,,2018,8,27,TRANSFER,10400.0,M267789972
25631,1196428',2018-08-27,FDRL/NXTXN_PAYMENT,0.0,36849.0,,2018,8,27,CASH_IN,36849.0,M292960678
25632,1196428',2018-08-27,FDRL/INTERNAL FUND TRANSFE,500000.0,0.0,,2018,8,27,DEBIT,500000.0,C1638372110
25633,1196428',2018-08-27,BEAT CSH PKP DEL UDYOG 62,0.0,226000.0,,2018,8,27,CHECK_CASHING,226000.0,C1377774115
25634,1196428',2018-08-27,FDRL/INTERNAL FUND TRANSFE,400000.0,0.0,,2018,8,27,CASH_OUT,400000.0,M1877845145
25635,1196428',2018-08-27,RTGS/ICICH18239570054/Indfor,0.0,1000000.0,,2018,8,27,TRANSFER,1000000.0,M869149988
25636,1196428',2018-08-27,RTGS/ICICH18239567123/Indfor,0.0,500000.0,,2018,8,27,CHECK_CASHING,500000.0,M1324498984
25637,1196428',2018-08-27,RTGS/ICICH18239568820/Indfor,0.0,2600000.0,,2018,8,27,TRANSFER,2600000.0,C748014372
25638,1196428',2018-08-27,TRF FRM  Indiaforensic SERVICES,0.0,15000000.0,,2018,8,27,TRANSFER,15000000.0,M1556526073
25639,1196428',2018-08-27,TRF FRM  Indiaforensic SERVICES,0.0,9700000.0,,2018,8,27,CHECK_CASHING,9700000.0,M1113797896
25640,1196428',2018-08-27,FDRL/INTERNAL FUND TRANSFE,6000000.0,0.0,,2018,8,27,CASH_OUT,6000000.0,M111103216
25641,1196428',2018-08-27,FDRL/INTERNAL FUND TRANSFE,1000000.0,0.0,,2018,8,27,CHECK_WITHDRAWAL,1000000.0,M402054040
25642,1196428',2018-08-28,FDRL/INTERNAL FUND TRANSFE,1000000.0,0.0,,2018,8,28,DEBIT,1000000.0,C1174935745
25643,1196428',2018-08-28,FDRL/NATIONAL ELECTRONIC F,696358.0,0.0,,2018,8,28,CASH_OUT,696358.0,M3128155
25644,1196428',2018-08-28,FDRL/REAL TIME GROSS SETTL,9073146.29,0.0,,2018,8,28,CHECK_WITHDRAWAL,9073146.29,M804435874
25645,1196428',2018-08-28,FDRL/NATIONAL ELECTRONIC F,310995.0,0.0,,2018,8,28,PAYEMENT,310995.0,M22524150
25646,1196428',2018-08-28,FDRL/NATIONAL ELECTRONIC F,35000.0,0.0,,2018,8,28,CASH_OUT,35000.0,C717951588
25647,1196428',2018-08-28,FDRL/REAL TIME GROSS SETTL,5000000.0,0.0,,2018,8,28,PAYEMENT,5000000.0,M994429804
25648,1196428',2018-08-28,FDRL/REAL TIME GROSS SETTL,2000000.0,0.0,,2018,8,28,CHECK_WITHDRAWAL,2000000.0,M42960844
25649,1196428',2018-08-28,NEFT/SBIN518240421744/MR,0.0,100000.0,,2018,8,28,CHECK_CASHING,100000.0,M117897905
25650,1196428',2018-08-28,NEFT/N240180617645766/JUN,0.0,60000.0,,2018,8,28,TRANSFER,60000.0,M919103236
25651,1196428',2018-08-28,IRTT00701824732,1315.85,0.0,,2018,8,28,PAYEMENT,1315.85,M2117556230
25652,1196428',2018-08-28,"Indiaforensic USA, INC./USD/1685",0.0,1171382.52,,2018,8,28,CASH_IN,1171382.52,M2047174428
25653,1196428',2018-08-28,INTEX TECHNOLOGIES INDIA,1000000.0,0.0,,2018,8,28,PAYEMENT,1000000.0,M1468774738
25654,1196428',2018-08-28,RTGS/SCBLH18240004028/FIX,0.0,300000.0,,2018,8,28,CASH_IN,300000.0,M266577647
25655,1196428',2018-08-28,TRF FROM  Indiaforensic SERVICES,0.0,5000000.0,,2018,8,28,CASH_IN,5000000.0,M1474343674
25656,1196428',2018-08-28,TRF FROM  Indiaforensic SERVICES,0.0,5000000.0,,2018,8,28,CHECK_CASHING,5000000.0,M1664266643
25657,1196428',2018-08-28,FDRL/REAL TIME GROSS SETTL,10000000.0,0.0,,2018,8,28,CHECK_WITHDRAWAL,10000000.0,M842463018
25658,1196428',2018-08-28,IB:TPFT000077204471309006,0.0,500.0,,2018,8,28,TRANSFER,500.0,M284325832
25659,1196428',2018-08-28,FDRL/INTERNAL FUND TRANSFE,1000000.0,0.0,,2018,8,28,CHECK_WITHDRAWAL,1000000.0,M1784760424
25660,1196428',2018-08-28,FDRL/INTERNAL FUND TRANSFE,1000000.0,0.0,,2018,8,28,PAYEMENT,1000000.0,M1489026763
25661,1196428',2018-08-28,FDRL/INTERNAL FUND TRANSFE,500000.0,0.0,,2018,8,28,CHECK_WITHDRAWAL,500000.0,C1800405372
25662,1196428',2018-08-28,FDRL/REAL TIME GROSS SETTL,2000000.0,0.0,,2018,8,28,DEBIT,2000000.0,C2071512077
25663,1196428',2018-08-28,NEFT/20679450181DC/ARTHAS,0.0,25000.0,,2018,8,28,TRANSFER,25000.0,C1588635270
25664,1196428',2018-08-28,NEFT/AXISP00008717396/ACC,0.0,2000000.0,,2018,8,28,TRANSFER,2000000.0,C1495001462
25665,1196428',2018-08-28,NEFT/FSFBH18240000084/FIN,0.0,89530.0,,2018,8,28,CASH_IN,89530.0,M84558619
25666,1196428',2018-08-28,FDRL/INTERNAL FUND TRANSFE,400000.0,0.0,,2018,8,28,DEBIT,400000.0,M113925453
25667,1196428',2018-08-28,FDRL/NATIONAL ELECTRONIC F,10000.0,0.0,,2018,8,28,PAYEMENT,10000.0,M645245228
25668,1196428',2018-08-28,TRF FROM  Indiaforensic SERVICES,0.0,9000000.0,,2018,8,28,CASH_IN,9000000.0,M636094317
25669,1196428',2018-08-28,FDRL/NATIONAL ELECTRONIC F,2000000.0,0.0,,2018,8,28,CHECK_WITHDRAWAL,2000000.0,M1583961850
25670,1196428',2018-08-28,FDRL/NATIONAL ELECTRONIC F,3000000.0,0.0,,2018,8,28,DEBIT,3000000.0,M708029389
25671,1196428',2018-08-28,FDRL/INTERNAL FUND TRANSFE,5000000.0,0.0,,2018,8,28,CHECK_WITHDRAWAL,5000000.0,M508231066
25672,1196428',2018-08-28,NEFT/N240180618091832/TEC,0.0,200000.0,,2018,8,28,TRANSFER,200000.0,C1838491463
25673,1196428',2018-08-28,BEAT CSH PKP DEL UDYOG 62,0.0,83500.0,,2018,8,28,CHECK_CASHING,83500.0,M1094448975
25674,1196428',2018-08-28,NEFT/000051235352/Indiaforensic,0.0,1600000.0,,2018,8,28,CHECK_CASHING,1600000.0,M717841651
25675,1196428',2018-08-28,NEFT/000051235859/Indiaforensic,0.0,2600000.0,,2018,8,28,TRANSFER,2600000.0,M1954167102
25676,1196428',2018-08-28,FDRL/INTERNAL FUND TRANSFE,1000000.0,0.0,,2018,8,28,PAYEMENT,1000000.0,M1043087369
25677,1196428',2018-08-28,FDRL/INTERNAL FUND TRANSFE,1000000.0,0.0,,2018,8,28,CASH_OUT,1000000.0,M1489610760
25678,1196428',2018-08-29,FDRL/INTERNAL FUND TRANSFE,1000000.0,0.0,,2018,8,29,CASH_OUT,1000000.0,C1556875182
25679,1196428',2018-08-29,Indiaforensic SERVICES INDIA PVT,0.0,149560.0,,2018,8,29,CASH_IN,149560.0,M1109811596
25680,1196428',2018-08-29,RTGS/HDFCH18241876823/Indfor,0.0,6600000.0,,2018,8,29,CASH_IN,6600000.0,C101571284
25681,1196428',2018-08-29,RTGS/SBINH18241025425/SAI,0.0,515000.0,,2018,8,29,CASH_IN,515000.0,M178952563
25682,1196428',2018-08-29,FDRL/INTERNAL FUND TRANSFE,1000000.0,0.0,,2018,8,29,CASH_OUT,1000000.0,M2081263541
25683,1196428',2018-08-29,CHQ DEP/792/OWDEL1/HDFC/V,0.0,11800.0,,2018,8,29,TRANSFER,11800.0,C2078250226
25684,1196428',2018-08-29,CHQ DEP/11389/OWDEL1/CORP,0.0,11800.0,,2018,8,29,CHECK_CASHING,11800.0,C1570256460
25685,1196428',2018-08-29,CHQ DEP/471928/OWDEL1/SBI,0.0,11800.0,,2018,8,29,TRANSFER,11800.0,M441055416
25686,1196428',2018-08-29,CHQ DEP/21771/OWDEL1/CORP,0.0,11800.0,,2018,8,29,CHECK_CASHING,11800.0,C2077098348
25687,1196428',2018-08-29,CHQ DEP/21850/OWDEL1/CORP,0.0,11800.0,,2018,8,29,CASH_IN,11800.0,C1062254208
25688,1196428',2018-08-29,CHQ DEP/40240/OWDEL1/UBIN,0.0,11800.0,,2018,8,29,CASH_IN,11800.0,C1787868648
25689,1196428',2018-08-29,CHQ DEP/753930/OWDEL1/VIJ,0.0,11800.0,,2018,8,29,CASH_IN,11800.0,C161140376
25690,1196428',2018-08-29,CHQ DEP/59/OWDEL1/HDFC/,0.0,11800.0,,2018,8,29,CASH_IN,11800.0,M1471351873
25691,1196428',2018-08-29,RTGS/UTIBH18241628254/Indfor,0.0,5000000.0,,2018,8,29,TRANSFER,5000000.0,M1328437771
25692,1196428',2018-08-29,FDRL/REAL TIME GROSS SETTL,12535395.58,0.0,,2018,8,29,PAYEMENT,12535395.58,M341537411
25693,1196428',2018-08-29,NEFT/AXISP00008878082/ACC,0.0,3000000.0,,2018,8,29,CHECK_CASHING,3000000.0,M1367049026
25694,1196428',2018-08-29,TRF FROM  Indiaforensic SERVICES,0.0,5000000.0,,2018,8,29,CASH_IN,5000000.0,C2029310301
25695,1196428',2018-08-29,TRF FROM  Indiaforensic SERVICES,0.0,5000000.0,,2018,8,29,TRANSFER,5000000.0,C1606699851
25696,1196428',2018-08-29,TRF FROM  Indiaforensic SERVICES,0.0,1000000.0,,2018,8,29,CASH_IN,1000000.0,C1103621993
25697,1196428',2018-08-29,FDRL/REAL TIME GROSS SETTL,10000000.0,0.0,,2018,8,29,PAYEMENT,10000000.0,M34447014
25698,1196428',2018-08-29,FDRL/REAL TIME GROSS SETTL,2000000.0,0.0,,2018,8,29,DEBIT,2000000.0,C1428675504
25699,1196428',2018-08-29,FDRL/REAL TIME GROSS SETTL,2000000.0,0.0,,2018,8,29,PAYEMENT,2000000.0,M1783999682
25700,1196428',2018-08-29,FDRL/INTERNAL FUND TRANSFE,1000000.0,0.0,,2018,8,29,DEBIT,1000000.0,C1247600089
25701,1196428',2018-08-29,IMPS 824115360855 FROM AS,0.0,100085.0,,2018,8,29,TRANSFER,100085.0,M835388411
25702,1196428',2018-08-29,CHQ DEPOSIT RETURN/792/FU,11800.0,0.0,,2018,8,29,CASH_OUT,11800.0,C404279307
25703,1196428',2018-08-29,TRF FROM  Indiaforensic SERVICES,0.0,8700000.0,,2018,8,29,CHECK_CASHING,8700000.0,C278407008
25704,1196428',2018-08-29,TRF TO  Indiaforensic SERVICES I,60000.0,0.0,,2018,8,29,PAYEMENT,60000.0,M1721234210
25705,1196428',2018-08-29,NEFT/N241180618779787/BAT,0.0,550000.0,,2018,8,29,CHECK_CASHING,550000.0,M1576908104
25706,1196428',2018-08-29,NEFT/AXIC182410646448/Indfor,0.0,5000000.0,,2018,8,29,CASH_IN,5000000.0,M1547162536
25707,1196428',2018-08-29,FDRL/NATIONAL ELECTRONIC F,868500.0,0.0,,2018,8,29,CASH_OUT,868500.0,M1057827479
25708,1196428',2018-08-29,FDRL/NATIONAL ELECTRONIC F,288495.0,0.0,,2018,8,29,PAYEMENT,288495.0,M1498878973
25709,1196428',2018-08-29,FDRL/NATIONAL ELECTRONIC F,1000000.0,0.0,,2018,8,29,CASH_OUT,1000000.0,M1420281457
25710,1196428',2018-08-29,FDRL/NATIONAL ELECTRONIC F,500000.0,0.0,,2018,8,29,CASH_OUT,500000.0,M2000558609
25711,1196428',2018-08-29,FDRL/NATIONAL ELECTRONIC F,500000.0,0.0,,2018,8,29,CASH_OUT,500000.0,M1598229594
25712,1196428',2018-08-29,FDRL/NATIONAL ELECTRONIC F,300000.0,0.0,,2018,8,29,CHECK_WITHDRAWAL,300000.0,M2001514483
25713,1196428',2018-08-29,FDRL/NATIONAL ELECTRONIC F,675500.0,0.0,,2018,8,29,CASH_OUT,675500.0,M1808413339
25714,1196428',2018-08-29,FDRL/NATIONAL ELECTRONIC F,1584000.0,0.0,,2018,8,29,DEBIT,1584000.0,M662376084
25715,1196428',2018-08-29,FDRL/NATIONAL ELECTRONIC F,499999.5,0.0,,2018,8,29,PAYEMENT,499999.5,M1462583713
25716,1196428',2018-08-29,FDRL/NATIONAL ELECTRONIC F,400000.0,0.0,,2018,8,29,CASH_OUT,400000.0,M1292178703
25717,1196428',2018-08-29,FDRL/NATIONAL ELECTRONIC F,294336.0,0.0,,2018,8,29,CASH_OUT,294336.0,M1378894443
25718,1196428',2018-08-29,FDRL/INTERNAL FUND TRANSFE,500000.0,0.0,,2018,8,29,PAYEMENT,500000.0,M671194471
25719,1196428',2018-08-29,FDRL/INTERNAL FUND TRANSFE,5000000.0,0.0,,2018,8,29,DEBIT,5000000.0,M2120887477
25720,1196428',2018-08-29,FDRL/INTERNAL FUND TRANSFE,400000.0,0.0,,2018,8,29,PAYEMENT,400000.0,M1565473666
25721,1196428',2018-08-29,CHQ DEPOSIT RETURN/792/CH,100.0,0.0,,2018,8,29,DEBIT,100.0,M336600403
25722,1196428',2018-08-29,CHQ DEPOSIT RETURN/792/GS,18.0,0.0,,2018,8,29,DEBIT,18.0,M1108314788
25723,1196428',2018-08-30,NEFT/PUNBH18242949198/BAL,0.0,150000.0,,2018,8,30,CASH_IN,150000.0,M1776708407
25724,1196428',2018-08-30,FDRL/INTERNAL FUND TRANSFE,1000000.0,0.0,,2018,8,30,CHECK_WITHDRAWAL,1000000.0,M1886072816
25725,1196428',2018-08-30,RTGS/PUNBH18242248554/MAN,0.0,400000.0,,2018,8,30,TRANSFER,400000.0,M392269298
25726,1196428',2018-08-30,RTGS/SBINH18242017230/Indfor,0.0,7600000.0,,2018,8,30,TRANSFER,7600000.0,M240263357
25727,1196428',2018-08-30,RTGS/HDFCH18242091453/JUN,0.0,250000.0,,2018,8,30,CHECK_CASHING,250000.0,M2137827177
25728,1196428',2018-08-30,RTGS/UTIBH18242663884/Indfor,0.0,2700000.0,,2018,8,30,TRANSFER,2700000.0,M996688653
25729,1196428',2018-08-30,FDRL/REAL TIME GROSS SETTL,10961598.96,0.0,,2018,8,30,CHECK_WITHDRAWAL,10961598.96,C1829831147
25730,1196428',2018-08-30,RTGS/HDFCH18242125350/Indfor,0.0,4500000.0,,2018,8,30,TRANSFER,4500000.0,M720435458
25731,1196428',2018-08-30,FDRL/REAL TIME GROSS SETTL,5000000.0,0.0,,2018,8,30,PAYEMENT,5000000.0,M29096009
25732,1196428',2018-08-30,NEFT/AXISP00009004151/ACC,0.0,900000.0,,2018,8,30,TRANSFER,900000.0,M150995440
25733,1196428',2018-08-30,NEFT/AXISP00009004150/ACC,0.0,1000000.0,,2018,8,30,CASH_IN,1000000.0,M1241251535
25734,1196428',2018-08-30,RTGS/HDFCH18242178133/BAT,0.0,250000.0,,2018,8,30,TRANSFER,250000.0,M1254542588
25735,1196428',2018-08-30,Indiaforensic SERVICES INDIA PVT,0.0,172055.0,,2018,8,30,CASH_IN,172055.0,M710538853
25736,1196428',2018-08-30,TRF FROM  Indiaforensic SERVICES,0.0,10600000.0,,2018,8,30,CHECK_CASHING,10600000.0,M399672840
25737,1196428',2018-08-30,FDRL/REAL TIME GROSS SETTL,10000000.0,0.0,,2018,8,30,CHECK_WITHDRAWAL,10000000.0,M1566931514
25738,1196428',2018-08-30,FDRL/REAL TIME GROSS SETTL,1000000.0,0.0,,2018,8,30,DEBIT,1000000.0,C1540270363
25739,1196428',2018-08-30,FDRL/REAL TIME GROSS SETTL,1000000.0,0.0,,2018,8,30,DEBIT,1000000.0,C900425684
25740,1196428',2018-08-30,FDRL/INTERNAL FUND TRANSFE,1000000.0,0.0,,2018,8,30,PAYEMENT,1000000.0,M1361294362
25741,1196428',2018-08-30,NEFT/000051372425/Indiaforensic,0.0,4400000.0,,2018,8,30,TRANSFER,4400000.0,C264843581
25742,1196428',2018-08-30,NEFT/000051372791/Indiaforensic,0.0,500000.0,,2018,8,30,CHECK_CASHING,500000.0,M1897445965
25743,1196428',2018-08-30,TRF FROM  Indiaforensic SERVICES,0.0,9100000.0,,2018,8,30,TRANSFER,9100000.0,M345439288
25744,1196428',2018-08-30,NEFT/AXISP00009068135/ACC,0.0,1100000.0,,2018,8,30,CHECK_CASHING,1100000.0,M2130477201
25745,1196428',2018-08-30,FDRL/INTERNAL FUND TRANSFE,500000.0,0.0,,2018,8,30,CASH_OUT,500000.0,M1516263359
25746,1196428',2018-08-30,FDRL/INTERNAL FUND TRANSFE,1000000.0,0.0,,2018,8,30,CHECK_WITHDRAWAL,1000000.0,M508839235
25747,1196428',2018-08-30,FDRL/INTERNAL FUND TRANSFE,1000000.0,0.0,,2018,8,30,CASH_OUT,1000000.0,M530611995
25748,1196428',2018-08-30,FDRL/INTERNAL FUND TRANSFE,1000000.0,0.0,,2018,8,30,DEBIT,1000000.0,C1761324386
25749,1196428',2018-08-30,FDRL/INTERNAL FUND TRANSFE,5000000.0,0.0,,2018,8,30,DEBIT,5000000.0,C90486891
25750,1196428',2018-08-30,FDRL/INTERNAL FUND TRANSFE,1000000.0,0.0,,2018,8,30,PAYEMENT,1000000.0,C573200870
25751,1196428',2018-08-30,BEAT CSH PKP DEL UDYOG 72,0.0,174000.0,,2018,8,30,TRANSFER,174000.0,C1825992554
25752,1196428',2018-08-30,TRF FROM  Indiaforensic SERVICES,0.0,600000.0,,2018,8,30,TRANSFER,600000.0,M1278682262
25753,1196428',2018-08-31,FDRL/NATIONAL ELECTRONIC F,82104.0,0.0,,2018,8,31,DEBIT,82104.0,M2009652577
25754,1196428',2018-08-31,FDRL/NATIONAL ELECTRONIC F,50263.0,0.0,,2018,8,31,DEBIT,50263.0,M1504904868
25755,1196428',2018-08-31,FDRL/NATIONAL ELECTRONIC F,91515.0,0.0,,2018,8,31,DEBIT,91515.0,C88226327
25756,1196428',2018-08-31,FDRL/NATIONAL ELECTRONIC F,97933.0,0.0,,2018,8,31,DEBIT,97933.0,M203497386
25757,1196428',2018-08-31,FDRL/NATIONAL ELECTRONIC F,69694.0,0.0,,2018,8,31,CASH_OUT,69694.0,M1264078907
25758,1196428',2018-08-31,FDRL/NATIONAL ELECTRONIC F,93924.0,0.0,,2018,8,31,CASH_OUT,93924.0,M1870838648
25759,1196428',2018-08-31,FDRL/NATIONAL ELECTRONIC F,60748.0,0.0,,2018,8,31,DEBIT,60748.0,C1683963531
25760,1196428',2018-08-31,FDRL/NATIONAL ELECTRONIC F,60006.0,0.0,,2018,8,31,DEBIT,60006.0,M620120832
25761,1196428',2018-08-31,FDRL/NATIONAL ELECTRONIC F,81803.0,0.0,,2018,8,31,DEBIT,81803.0,M37714710
25762,1196428',2018-08-31,FDRL/NATIONAL ELECTRONIC F,72828.0,0.0,,2018,8,31,CHECK_WITHDRAWAL,72828.0,M1135370372
25763,1196428',2018-08-31,FDRL/NATIONAL ELECTRONIC F,84750.0,0.0,,2018,8,31,CHECK_WITHDRAWAL,84750.0,C1700355047
25764,1196428',2018-08-31,FDRL/NATIONAL ELECTRONIC F,11720.0,0.0,,2018,8,31,PAYEMENT,11720.0,C1884600481
25765,1196428',2018-08-31,FDRL/INTERNAL FUND TRANSFE,1000000.0,0.0,,2018,8,31,CASH_OUT,1000000.0,C1105527690
25766,1196428',2018-08-31,RTGS/SBINH18243014825/Indfor,0.0,6100000.0,,2018,8,31,CHECK_CASHING,6100000.0,M714819629
25767,1196428',2018-08-31,FDRL/REAL TIME GROSS SETTL,10369438.71,0.0,,2018,8,31,CHECK_WITHDRAWAL,10369438.71,M722465639
25768,1196428',2018-08-31,IMPS 824311623382 FROM SA,0.0,200000.0,,2018,8,31,CHECK_CASHING,200000.0,C801412408
25769,1196428',2018-08-31,FDRL/NATIONAL ELECTRONIC F,14418.0,0.0,,2018,8,31,PAYEMENT,14418.0,M1678349105
25770,1196428',2018-08-31,IMPS 824313102950 FROM PU,0.0,27000.0,,2018,8,31,TRANSFER,27000.0,C35534346
25771,1196428',2018-08-31,TRF FROM  Indiaforensic SERVICES,0.0,11300000.0,,2018,8,31,CASH_IN,11300000.0,C943166837
25772,1196428',2018-08-31,IMPS 824314315090 FROM AS,0.0,119090.0,,2018,8,31,CASH_IN,119090.0,M1063088470
25773,1196428',2018-08-31,FDRL/REAL TIME GROSS SETTL,1000000.0,0.0,,2018,8,31,CHECK_WITHDRAWAL,1000000.0,M634480856
25774,1196428',2018-08-31,FDRL/REAL TIME GROSS SETTL,10000000.0,0.0,,2018,8,31,DEBIT,10000000.0,M1229660324
25775,1196428',2018-08-31,"Indiaforensic USA, INC./USD/1042",0.0,731905.2,,2018,8,31,TRANSFER,731905.2,M1995775202
25776,1196428',2018-08-31,IRTT00701825223,1043.71,0.0,,2018,8,31,DEBIT,1043.71,M982735022
25777,1196428',2018-08-31,NEFT/AXISP00009138006/ACC,0.0,5000000.0,,2018,8,31,CHECK_CASHING,5000000.0,C1754722089
25778,1196428',2018-08-31,FDRL/REAL TIME GROSS SETTL,5000000.0,0.0,,2018,8,31,CHECK_WITHDRAWAL,5000000.0,M536571624
25779,1196428',2018-08-31,RTGS/ICICH18243378222/Indfor,0.0,2000000.0,,2018,8,31,CHECK_CASHING,2000000.0,C1498878963
25780,1196428',2018-08-31,FDRL/REAL TIME GROSS SETTL,1000000.0,0.0,,2018,8,31,PAYEMENT,1000000.0,C1962165946
25781,1196428',2018-08-31,FDRL/REAL TIME GROSS SETTL,2000000.0,0.0,,2018,8,31,CHECK_WITHDRAWAL,2000000.0,M1170462195
25782,1196428',2018-08-31,RTGS/ICICH18243376969/Indfor,0.0,1000000.0,,2018,8,31,TRANSFER,1000000.0,C414205222
25783,1196428',2018-08-31,FDRL/INTERNAL FUND TRANSFE,1000000.0,0.0,,2018,8,31,DEBIT,1000000.0,M1229413386
25784,1196428',2018-08-31,Indiaforensic SERVICES INDIA PVT,0.0,111524.0,,2018,8,31,CHECK_CASHING,111524.0,M712447692
25785,1196428',2018-08-31,FDRL/INTERNAL FUND TRANSFE,300000.0,0.0,,2018,8,31,DEBIT,300000.0,C269902384
25786,1196428',2018-08-31,FDRL/INTERNAL FUND TRANSFE,500000.0,0.0,,2018,8,31,CHECK_WITHDRAWAL,500000.0,C955097010
25787,1196428',2018-08-31,FUNDS TRF  Indiaforensic SERVICE,0.0,8300000.0,,2018,8,31,TRANSFER,8300000.0,C1827996167
25788,1196428',2018-08-31,FDRL/INTERNAL FUND TRANSFE,500000.0,0.0,,2018,8,31,CHECK_WITHDRAWAL,500000.0,M30162194
25789,1196428',2018-08-31,FDRL/INTERNAL FUND TRANSFE,500000.0,0.0,,2018,8,31,PAYEMENT,500000.0,C1115240385
25790,1196428',2018-08-31,FDRL/INTERNAL FUND TRANSFE,5000000.0,0.0,,2018,8,31,PAYEMENT,5000000.0,M1710595137
25791,1196428',2018-08-31,FDRL/INTERNAL FUND TRANSFE,500000.0,0.0,,2018,8,31,CASH_OUT,500000.0,M970087106
25792,1196428',2018-08-31,FDRL/INTERNAL FUND TRANSFE,500000.0,0.0,,2018,8,31,PAYEMENT,500000.0,M561635968
25793,1196428',2018-08-31,TRF FROM  Indiaforensic SERVICES,0.0,600000.0,,2018,8,31,CASH_IN,600000.0,C440480434
25794,1196428',2018-08-31,BEAT CSH PKP DEL UDYOG 72,0.0,170000.0,,2018,8,31,TRANSFER,170000.0,C46748390
25795,1196428',2018-08-31,NEFT/N243180621219388/TEC,0.0,200000.0,,2018,8,31,CHECK_CASHING,200000.0,M976616410
25796,1196428',2018-08-31,1196428:Int.Coll:01-08-20,836022.0,0.0,,2018,8,31,CASH_OUT,836022.0,M1796408655
25797,1196428',2018-09-01,CHQ DEP/243906/OWDEL1/SBI,0.0,11800.0,,2018,9,1,CASH_IN,11800.0,M424513770
25798,1196428',2018-09-01,CHQ DEP/759010/OWDEL1/SBI,0.0,11800.0,,2018,9,1,CHECK_CASHING,11800.0,M1867357103
25799,1196428',2018-09-01,CHQ DEP/656672/OWDEL1/SBI,0.0,11800.0,,2018,9,1,CASH_IN,11800.0,M215680372
25800,1196428',2018-09-01,CHQ DEP/83528/OWDEL1/UTIB,0.0,11800.0,,2018,9,1,CASH_IN,11800.0,M764256713
25801,1196428',2018-09-01,CHQ DEP/687035/OWDEL1/SBI,0.0,11800.0,,2018,9,1,CHECK_CASHING,11800.0,M538413261
25802,1196428',2018-09-01,CHQ DEP/47/OWDEL1/BARB/FA,0.0,11800.0,,2018,9,1,CHECK_CASHING,11800.0,M942160595
25803,1196428',2018-09-01,CHQ DEP/692644/OWDEL1/SBI,0.0,11800.0,,2018,9,1,CASH_IN,11800.0,M1319156415
25804,1196428',2018-09-01,CHQ DEP/320933/OWDEL1/SBI,0.0,11800.0,,2018,9,1,CASH_IN,11800.0,M361847129
25805,1196428',2018-09-01,CHQ DEP/406267/OWDEL1/PSI,0.0,11800.0,,2018,9,1,TRANSFER,11800.0,C1790202239
25806,1196428',2018-09-01,CHQ DEP/990/OWDEL1/ORBC/,0.0,11800.0,,2018,9,1,CASH_IN,11800.0,M955868325
25807,1196428',2018-09-01,CHQ DEP/828248/OWDEL1/CNR,0.0,11800.0,,2018,9,1,TRANSFER,11800.0,M1251133153
25808,1196428',2018-09-01,CHQ DEP/459683/OWDEL1/COR,0.0,11800.0,,2018,9,1,CHECK_CASHING,11800.0,M1854311181
25809,1196428',2018-09-01,CHQ DEP/81097/OWDEL1/UTIB,0.0,11800.0,,2018,9,1,CHECK_CASHING,11800.0,C928023753
25810,1196428',2018-09-01,CHQ DEP/865867/OWDEL1/SBI,0.0,11800.0,,2018,9,1,CHECK_CASHING,11800.0,M771609335
25811,1196428',2018-09-01,CHQ DEP/829/OWDEL1/HDFC/M,0.0,11800.0,,2018,9,1,CASH_IN,11800.0,C1452722471
25812,1196428',2018-09-01,CHQ DEP/114/OWDEL1/PSIB/I,0.0,11800.0,,2018,9,1,TRANSFER,11800.0,M1625968481
25813,1196428',2018-09-01,CHQ DEP/1487/OWDEL1/ORBC/,0.0,11800.0,,2018,9,1,TRANSFER,11800.0,M458727925
25814,1196428',2018-09-01,CHQ DEP/29550/OWDEL1/BKID,0.0,11800.0,,2018,9,1,TRANSFER,11800.0,C111210112
25815,1196428',2018-09-01,CHQ DEP/714776/OWDEL1/SBI,0.0,11800.0,,2018,9,1,TRANSFER,11800.0,C464246030
25816,1196428',2018-09-01,CHQ DEP/105125/OWDEL1/SBI,0.0,11800.0,,2018,9,1,CHECK_CASHING,11800.0,M2080752777
25817,1196428',2018-09-01,CHQ DEP/174034/OWDEL1/PUN,0.0,11800.0,,2018,9,1,CASH_IN,11800.0,M1357563045
25818,1196428',2018-09-01,CHQ DEP/801636/OWDEL1/PUN,0.0,11800.0,,2018,9,1,CHECK_CASHING,11800.0,M68500741
25819,1196428',2018-09-01,CHQ DEP/286824/OWDEL1/SBI,0.0,11800.0,,2018,9,1,TRANSFER,11800.0,C1664330755
25820,1196428',2018-09-01,TRF FROM  Indiaforensic SERVICES,0.0,10000000.0,,2018,9,1,CHECK_CASHING,10000000.0,C1823014131
25821,1196428',2018-09-01,RTGS/UTIBH18244667121/Indfor,0.0,1500000.0,,2018,9,1,CHECK_CASHING,1500000.0,M1293355387
25822,1196428',2018-09-01,FDRL/REAL TIME GROSS SETTL,12689532.43,0.0,,2018,9,1,PAYEMENT,12689532.43,M34599177
25823,1196428',2018-09-01,TRF FROM  Indiaforensic SERVICES,0.0,1000000.0,,2018,9,1,TRANSFER,1000000.0,M685059787
25824,1196428',2018-09-01,CASHDEP/GHATKOPAR/,0.0,116300.0,,2018,9,1,CASH_IN,116300.0,M376456946
25825,1196428',2018-09-01,IMPS 824415170382 FROM PU,0.0,10000.0,,2018,9,1,TRANSFER,10000.0,M793798217
25826,1196428',2018-09-01,RTGS/SBINH18244050102/Indfor,0.0,7400000.0,,2018,9,1,TRANSFER,7400000.0,C264685626
25827,1196428',2018-09-01,FDRL/NATIONAL ELECTRONIC F,1000000.0,0.0,,2018,9,1,CASH_OUT,1000000.0,M954243999
25828,1196428',2018-09-01,FDRL/NATIONAL ELECTRONIC F,1000000.0,0.0,,2018,9,1,CHECK_WITHDRAWAL,1000000.0,C1816986148
25829,1196428',2018-09-01,FDRL/NATIONAL ELECTRONIC F,1000000.0,0.0,,2018,9,1,DEBIT,1000000.0,C1144527317
25830,1196428',2018-09-01,FDRL/NATIONAL ELECTRONIC F,1000000.0,0.0,,2018,9,1,CHECK_WITHDRAWAL,1000000.0,C1790831319
25831,1196428',2018-09-01,FDRL/NATIONAL ELECTRONIC F,1000000.0,0.0,,2018,9,1,CHECK_WITHDRAWAL,1000000.0,C571435580
25832,1196428',2018-09-01,FDRL/NATIONAL ELECTRONIC F,1000000.0,0.0,,2018,9,1,CHECK_WITHDRAWAL,1000000.0,C1262016786
25833,1196428',2018-09-01,FDRL/NATIONAL ELECTRONIC F,1000000.0,0.0,,2018,9,1,CHECK_WITHDRAWAL,1000000.0,C1287328228
25834,1196428',2018-09-01,CHQ DEPOSIT RETURN/759010,11800.0,0.0,,2018,9,1,PAYEMENT,11800.0,C329473339
25835,1196428',2018-09-01,CHQ DEPOSIT RETURN/83528/,11800.0,0.0,,2018,9,1,CASH_OUT,11800.0,C1354725727
25836,1196428',2018-09-01,CHQ DEPOSIT RETURN/687035,11800.0,0.0,,2018,9,1,CHECK_WITHDRAWAL,11800.0,C1300519073
25837,1196428',2018-09-01,CHQ DEPOSIT RETURN/1487/F,11800.0,0.0,,2018,9,1,PAYEMENT,11800.0,C2052185144
25838,1196428',2018-09-01,CHQ DEPOSIT RETURN/286824,11800.0,0.0,,2018,9,1,DEBIT,11800.0,C1485516154
25839,1196428',2018-09-01,FDRL/INTERNAL FUND TRANSFE,400000.0,0.0,,2018,9,1,CHECK_WITHDRAWAL,400000.0,C2143477943
25840,1196428',2018-09-01,FDRL/INTERNAL FUND TRANSFE,400000.0,0.0,,2018,9,1,CASH_OUT,400000.0,C476402209
25841,1196428',2018-09-01,FDRL/NATIONAL ELECTRONIC F,1000000.0,0.0,,2018,9,1,CASH_OUT,1000000.0,C1255024717
25842,1196428',2018-09-01,TRF FROM  Indiaforensic SERVICES,0.0,2000000.0,,2018,9,1,CASH_IN,2000000.0,C1870367457
25843,1196428',2018-09-01,TRF FROM  Indiaforensic SERVICES,0.0,3000000.0,,2018,9,1,CHECK_CASHING,3000000.0,C465257140
25844,1196428',2018-09-01,TRF FROM  Indiaforensic SERVICES,0.0,500000.0,,2018,9,1,TRANSFER,500000.0,C745740822
25845,1196428',2018-09-01,FDRL/NATIONAL ELECTRONIC F,1000000.0,0.0,,2018,9,1,CASH_OUT,1000000.0,C1390121014
25846,1196428',2018-09-01,FDRL/NATIONAL ELECTRONIC F,1000000.0,0.0,,2018,9,1,CHECK_WITHDRAWAL,1000000.0,C1481851679
25847,1196428',2018-09-01,FDRL/NATIONAL ELECTRONIC F,1000000.0,0.0,,2018,9,1,CASH_OUT,1000000.0,C741431520
25848,1196428',2018-09-01,NEFT/000051516185/Indiaforensic,0.0,500000.0,,2018,9,1,CHECK_CASHING,500000.0,C758888772
25849,1196428',2018-09-01,NEFT/N244180622445928/BAT,0.0,265000.0,,2018,9,1,CASH_IN,265000.0,C1001409363
25850,1196428',2018-09-01,NEFT/000051518675/Indiaforensic,0.0,500000.0,,2018,9,1,TRANSFER,500000.0,M1340854901
25851,1196428',2018-09-01,TRF FROM  Indiaforensic SERVICES,0.0,500000.0,,2018,9,1,CASH_IN,500000.0,M265997755
25852,1196428',2018-09-01,NEFT/SBIN118244570408/TAR,0.0,185000.0,,2018,9,1,CHECK_CASHING,185000.0,M1257695233
25853,1196428',2018-09-01,NEFT/000051516641/Indiaforensic,0.0,2000000.0,,2018,9,1,TRANSFER,2000000.0,C150309335
25854,1196428',2018-09-01,FDRL/INTERNAL FUND TRANSFE,500000.0,0.0,,2018,9,1,DEBIT,500000.0,M1572611628
25855,1196428',2018-09-01,NEFT/AXISP00009846499/ACC,0.0,5000000.0,,2018,9,1,CASH_IN,5000000.0,M280183141
25856,1196428',2018-09-01,FDRL/INTERNAL FUND TRANSFE,3000000.0,0.0,,2018,9,1,DEBIT,3000000.0,M808540700
25857,1196428',2018-09-01,FDRL/INTERNAL FUND TRANSFE,500000.0,0.0,,2018,9,1,DEBIT,500000.0,M565481399
25858,1196428',2018-09-01,FDRL/INTERNAL FUND TRANSFE,5000000.0,0.0,,2018,9,1,PAYEMENT,5000000.0,C842729010
25859,1196428',2018-09-01,FDRL/INTERNAL FUND TRANSFE,300000.0,0.0,,2018,9,1,DEBIT,300000.0,M178371442
25860,1196428',2018-09-01,FDRL/INTERNAL FUND TRANSFE,300000.0,0.0,,2018,9,1,CASH_OUT,300000.0,M2076445832
25861,1196428',2018-09-01,FDRL/INTERNAL FUND TRANSFE,1000000.0,0.0,,2018,9,1,CHECK_WITHDRAWAL,1000000.0,C599968109
25862,1196428',2018-09-01,FDRL/INTERNAL FUND TRANSFE,1000000.0,0.0,,2018,9,1,PAYEMENT,1000000.0,C599265282
25863,1196428',2018-09-01,BEAT CSH PKP DEL GURG 727,0.0,98000.0,,2018,9,1,CASH_IN,98000.0,C669771073
25864,1196428',2018-09-01,CHQ DEPOSIT RETURN/759010,100.0,0.0,,2018,9,1,DEBIT,100.0,C2137848242
25865,1196428',2018-09-01,CHQ DEPOSIT RETURN/759010,18.0,0.0,,2018,9,1,PAYEMENT,18.0,M997986347
25866,1196428',2018-09-01,CHQ DEPOSIT RETURN/83528/,100.0,0.0,,2018,9,1,CHECK_WITHDRAWAL,100.0,M1063792159
25867,1196428',2018-09-01,CHQ DEPOSIT RETURN/83528/,18.0,0.0,,2018,9,1,CASH_OUT,18.0,C22448303
25868,1196428',2018-09-01,CHQ DEPOSIT RETURN/687035,100.0,0.0,,2018,9,1,DEBIT,100.0,M315692635
25869,1196428',2018-09-01,CHQ DEPOSIT RETURN/687035,18.0,0.0,,2018,9,1,CASH_OUT,18.0,M803644277
25870,1196428',2018-09-01,CHQ DEPOSIT RETURN/1487/C,100.0,0.0,,2018,9,1,CASH_OUT,100.0,M415913007
25871,1196428',2018-09-01,CHQ DEPOSIT RETURN/1487/G,18.0,0.0,,2018,9,1,CASH_OUT,18.0,M1344197461
25872,1196428',2018-09-01,CHQ DEPOSIT RETURN/286824,100.0,0.0,,2018,9,1,CHECK_WITHDRAWAL,100.0,M132014623
25873,1196428',2018-09-01,CHQ DEPOSIT RETURN/286824,18.0,0.0,,2018,9,1,CHECK_WITHDRAWAL,18.0,M577051450
25874,1196428',2018-09-03,RTGS/SBINH18246002667/Indfor,0.0,700000.0,,2018,9,3,CHECK_CASHING,700000.0,C1491676195
25875,1196428',2018-09-03,FDRL/INTERNAL FUND TRANSFE,200000.0,0.0,,2018,9,3,CASH_OUT,200000.0,C943166837
25876,1196428',2018-09-03,FDRL/INTERNAL FUND TRANSFE,200000.0,0.0,,2018,9,3,CASH_OUT,200000.0,M1402953791
25877,1196428',2018-09-03,TATA COMMUNICATION LTD,426456.0,0.0,,2018,9,3,CASH_OUT,426456.0,M1974589236
25878,1196428',2018-09-03,RTGS/HDFCH18246604731/BAT,0.0,400000.0,,2018,9,3,TRANSFER,400000.0,C1701412896
25879,1196428',2018-09-03,TRF FRM  Indiaforensic SERVICES,0.0,10000000.0,,2018,9,3,CHECK_CASHING,10000000.0,M1355606971
25880,1196428',2018-09-03,TRF FRM  Indiaforensic SERVICES,0.0,1000000.0,,2018,9,3,CHECK_CASHING,1000000.0,M1037747072
25881,1196428',2018-09-03,FDRL/INTERNAL FUND TRANSFE,200000.0,0.0,,2018,9,3,PAYEMENT,200000.0,M82220349
25882,1196428',2018-09-03,FDRL/INTERNAL FUND TRANSFE,200000.0,0.0,,2018,9,3,DEBIT,200000.0,M953439482
25883,1196428',2018-09-03,TRF FRM  Indiaforensic SERVICES,0.0,7800000.0,,2018,9,3,CASH_IN,7800000.0,C1914282536
25884,1196428',2018-09-03,TRF FRM  Indiaforensic SERVICES,0.0,1000000.0,,2018,9,3,TRANSFER,1000000.0,C691636444
25885,1196428',2018-09-03,FDRL/REAL TIME GROSS SETTL,7256956.84,0.0,,2018,9,3,CASH_OUT,7256956.84,C683605346
25886,1196428',2018-09-03,FDRL/REAL TIME GROSS SETTL,11949381.86,0.0,,2018,9,3,DEBIT,11949381.86,M1967366965
25887,1196428',2018-09-03,RTGS/HDFCH18246589806/Indfor,0.0,5500000.0,,2018,9,3,CHECK_CASHING,5500000.0,M508405148
25888,1196428',2018-09-03,FDRL/REAL TIME GROSS SETTL,2000000.0,0.0,,2018,9,3,DEBIT,2000000.0,M1295579320
25889,1196428',2018-09-03,FDRL/REAL TIME GROSS SETTL,3000000.0,0.0,,2018,9,3,DEBIT,3000000.0,M995168511
25890,1196428',2018-09-03,FDRL/INTERNAL FUND TRANSFE,200000.0,0.0,,2018,9,3,CHECK_WITHDRAWAL,200000.0,M1102425439
25891,1196428',2018-09-03,FDRL/INTERNAL FUND TRANSFE,300000.0,0.0,,2018,9,3,CHECK_WITHDRAWAL,300000.0,M590053012
25892,1196428',2018-09-03,CASHDEP/VIKASMARG/TP,0.0,50000.0,,2018,9,3,TRANSFER,50000.0,M386886002
25893,1196428',2018-09-03,NEFT/N246180623249403/JUN,0.0,100000.0,,2018,9,3,CHECK_CASHING,100000.0,M227585143
25894,1196428',2018-09-03,NEFT/P18090331880498/S B,0.0,199500.0,,2018,9,3,CHECK_CASHING,199500.0,M2105068287
25895,1196428',2018-09-03,FDRL/INTERNAL FUND TRANSFE,1000000.0,0.0,,2018,9,3,DEBIT,1000000.0,M1038116064
25896,1196428',2018-09-03,TRF FROM  Indiaforensic SERVICES,0.0,10000000.0,,2018,9,3,CASH_IN,10000000.0,M345805867
25897,1196428',2018-09-03,TRF FROM  Indiaforensic SERVICES,0.0,10000000.0,,2018,9,3,CHECK_CASHING,10000000.0,M1128144161
25898,1196428',2018-09-03,TRF FROM  Indiaforensic SERVICES,0.0,1000000.0,,2018,9,3,TRANSFER,1000000.0,M1492172037
25899,1196428',2018-09-03,TRF FROM  Indiaforensic SERVICES,0.0,500000.0,,2018,9,3,TRANSFER,500000.0,M731603444
25900,1196428',2018-09-03,FDRL/NATIONAL ELECTRONIC F,15000000.0,0.0,,2018,9,3,CASH_OUT,15000000.0,M879683510
25901,1196428',2018-09-03,FDRL/INTERNAL FUND TRANSFE,200000.0,0.0,,2018,9,3,CASH_OUT,200000.0,M555126583
25902,1196428',2018-09-03,FDRL/INTERNAL FUND TRANSFE,400000.0,0.0,,2018,9,3,CASH_OUT,400000.0,M1344791022
25903,1196428',2018-09-03,FDRL/INTERNAL FUND TRANSFE,400000.0,0.0,,2018,9,3,CHECK_WITHDRAWAL,400000.0,M40493588
25904,1196428',2018-09-03,FDRL/NATIONAL ELECTRONIC F,143843.0,0.0,,2018,9,3,DEBIT,143843.0,M1099885881
25905,1196428',2018-09-03,FDRL/NATIONAL ELECTRONIC F,112020.0,0.0,,2018,9,3,DEBIT,112020.0,M107256650
25906,1196428',2018-09-03,FDRL/NATIONAL ELECTRONIC F,130116.0,0.0,,2018,9,3,DEBIT,130116.0,M1410611700
25907,1196428',2018-09-03,FDRL/NATIONAL ELECTRONIC F,133996.0,0.0,,2018,9,3,CHECK_WITHDRAWAL,133996.0,M954062800
25908,1196428',2018-09-03,FDRL/NATIONAL ELECTRONIC F,171950.0,0.0,,2018,9,3,DEBIT,171950.0,M13013852
25909,1196428',2018-09-03,FDRL/NATIONAL ELECTRONIC F,112985.0,0.0,,2018,9,3,DEBIT,112985.0,M1101858256
25910,1196428',2018-09-03,FDRL/NATIONAL ELECTRONIC F,113000.0,0.0,,2018,9,3,CHECK_WITHDRAWAL,113000.0,M1180862248
25911,1196428',2018-09-03,FDRL/NATIONAL ELECTRONIC F,28836.0,0.0,,2018,9,3,DEBIT,28836.0,M966462848
25912,1196428',2018-09-03,FDRL/INTERNAL FUND TRANSFE,500000.0,0.0,,2018,9,3,CHECK_WITHDRAWAL,500000.0,M1284324188
25913,1196428',2018-09-03,FDRL/INTERNAL FUND TRANSFE,1000000.0,0.0,,2018,9,3,PAYEMENT,1000000.0,C374625527
25914,1196428',2018-09-03,FDRL/INTERNAL FUND TRANSFE,3000000.0,0.0,,2018,9,3,DEBIT,3000000.0,C1262822392
25915,1196428',2018-09-03,TRF FROM  Indiaforensic SERVICES,0.0,500000.0,,2018,9,3,TRANSFER,500000.0,C1671386208
25916,1196428',2018-09-03,FDRL/INTERNAL FUND TRANSFE,500000.0,0.0,,2018,9,3,CASH_OUT,500000.0,C1869197498
25917,1196428',2018-09-03,NEFT/BARBW18246164505/MAK,0.0,50100.0,,2018,9,3,TRANSFER,50100.0,C271488817
25918,1196428',2018-09-04,RTGS/SBINH18247015533/Indfor,0.0,5600000.0,,2018,9,4,CHECK_CASHING,5600000.0,M1915909017
25919,1196428',2018-09-04,FDRL/REAL TIME GROSS SETTL,3000000.0,0.0,,2018,9,4,PAYEMENT,3000000.0,C2052185144
25920,1196428',2018-09-04,RTGS/PUNBH18247314458/MAN,0.0,400000.0,,2018,9,4,CHECK_CASHING,400000.0,C646059443
25921,1196428',2018-09-04,TRF FROM  Indiaforensic SERVICES,0.0,10000000.0,,2018,9,4,CASH_IN,10000000.0,C1982591789
25922,1196428',2018-09-04,TRF FROM  Indiaforensic SERVICES,0.0,1000000.0,,2018,9,4,TRANSFER,1000000.0,C1977614404
25923,1196428',2018-09-04,RTGS/ICICH18247635210/Indfor,0.0,5400000.0,,2018,9,4,CHECK_CASHING,5400000.0,C1883840933
25924,1196428',2018-09-04,FDRL/REAL TIME GROSS SETTL,7385220.53,0.0,,2018,9,4,CHECK_WITHDRAWAL,7385220.53,C2007207148
25925,1196428',2018-09-04,FDRL/REAL TIME GROSS SETTL,10000000.0,0.0,,2018,9,4,CHECK_WITHDRAWAL,10000000.0,M1014644493
25926,1196428',2018-09-04,IMPS 824714377541 FROM AS,0.0,50150.0,,2018,9,4,CASH_IN,50150.0,C381605910
25927,1196428',2018-09-04,FDRL/INTERNAL FUND TRANSFE,200000.0,0.0,,2018,9,4,CHECK_WITHDRAWAL,200000.0,M1056752544
25928,1196428',2018-09-04,FDRL/INTERNAL FUND TRANSFE,200000.0,0.0,,2018,9,4,CASH_OUT,200000.0,M729567968
25929,1196428',2018-09-04,FDRL/INTERNAL FUND TRANSFE,200000.0,0.0,,2018,9,4,CHECK_WITHDRAWAL,200000.0,M1723507087
25930,1196428',2018-09-04,FDRL/INTERNAL FUND TRANSFE,200000.0,0.0,,2018,9,4,CASH_OUT,200000.0,C849038219
25931,1196428',2018-09-04,FDRL/INTERNAL FUND TRANSFE,500000.0,0.0,,2018,9,4,PAYEMENT,500000.0,C1038678108
25932,1196428',2018-09-04,FDRL/INTERNAL FUND TRANSFE,200000.0,0.0,,2018,9,4,PAYEMENT,200000.0,M1976340229
25933,1196428',2018-09-04,FDRL/INTERNAL FUND TRANSFE,200000.0,0.0,,2018,9,4,DEBIT,200000.0,M693274483
25934,1196428',2018-09-04,FDRL/INTERNAL FUND TRANSFE,200000.0,0.0,,2018,9,4,PAYEMENT,200000.0,M838050003
25935,1196428',2018-09-04,Indiaforensic SERVICES INDIA PVT,0.0,510826.0,,2018,9,4,CASH_IN,510826.0,C1009972184
25936,1196428',2018-09-04,NEWLAND PAYMENT TECHNOLOG,44580.25,0.0,,2018,9,4,DEBIT,44580.25,C63475121
25937,1196428',2018-09-04,IMAR00701805273,965.24,0.0,,2018,9,4,DEBIT,965.24,C1130075212
25938,1196428',2018-09-04,TRF FRM  Indiaforensic SERVICES,0.0,8900000.0,,2018,9,4,CASH_IN,8900000.0,C851316413
25939,1196428',2018-09-04,TRF FRM  Indiaforensic SERVICES,0.0,500000.0,,2018,9,4,TRANSFER,500000.0,M718843573
25940,1196428',2018-09-04,NEFT/N247180624564368/TEC,0.0,100000.0,,2018,9,4,CHECK_CASHING,100000.0,M1217713614
25941,1196428',2018-09-04,NEFT/000051617267/Indiaforensic,0.0,1000000.0,,2018,9,4,CHECK_CASHING,1000000.0,M706338650
25942,1196428',2018-09-04,FDRL/INTERNAL FUND TRANSFE,5000000.0,0.0,,2018,9,4,CASH_OUT,5000000.0,M995800830
25943,1196428',2018-09-04,FDRL/INTERNAL FUND TRANSFE,500000.0,0.0,,2018,9,4,DEBIT,500000.0,C1073259437
25944,1196428',2018-09-04,FDRL/INTERNAL FUND TRANSFE,3000000.0,0.0,,2018,9,4,CHECK_WITHDRAWAL,3000000.0,M1699315785
25945,1196428',2018-09-04,FDRL/INTERNAL FUND TRANSFE,500000.0,0.0,,2018,9,4,CHECK_WITHDRAWAL,500000.0,M1163711030
25946,1196428',2018-09-04,FDRL/INTERNAL FUND TRANSFE,500000.0,0.0,,2018,9,4,PAYEMENT,500000.0,C320106510
25947,1196428',2018-09-04,TRF FROM  Indiaforensic SERVICES,0.0,500000.0,,2018,9,4,CASH_IN,500000.0,M597251930
25948,1196428',2018-09-04,BEAT CSH PKP DEL UDYOG 72,0.0,164500.0,,2018,9,4,TRANSFER,164500.0,M1515100477
25949,1196428',2018-09-05,FDRL/INTERNAL FUND TRANSFE,1000000.0,0.0,,2018,9,5,CASH_OUT,1000000.0,M1412315921
25950,1196428',2018-09-05,FDRL/INTERNAL FUND TRANSFE,200000.0,0.0,,2018,9,5,PAYEMENT,200000.0,M1168923345
25951,1196428',2018-09-05,FDRL/INTERNAL FUND TRANSFE,200000.0,0.0,,2018,9,5,DEBIT,200000.0,M2042700604
25952,1196428',2018-09-05,CASHDEP/GHATKOPAR/,0.0,10561.0,,2018,9,5,CASH_IN,10561.0,C710481910
25953,1196428',2018-09-05,CASHDEP/NERUL/,0.0,34300.0,,2018,9,5,TRANSFER,34300.0,M1474634841
25954,1196428',2018-09-05,RTGS/SBINH18248026825/Indfor,0.0,8800000.0,,2018,9,5,CASH_IN,8800000.0,C669419693
25955,1196428',2018-09-05,NEFT/N248180625145262/BAT,0.0,100000.0,,2018,9,5,CHECK_CASHING,100000.0,C2095611317
25956,1196428',2018-09-05,FDRL/REAL TIME GROSS SETTL,9376108.64,0.0,,2018,9,5,DEBIT,9376108.64,C1316560467
25957,1196428',2018-09-05,FDRL/INTERNAL FUND TRANSFE,200000.0,0.0,,2018,9,5,DEBIT,200000.0,M1572144334
25958,1196428',2018-09-05,FDRL/INTERNAL FUND TRANSFE,300000.0,0.0,,2018,9,5,DEBIT,300000.0,M593517569
25959,1196428',2018-09-05,IMPS 824813351227 FROM AS,0.0,50199.0,,2018,9,5,CASH_IN,50199.0,M558730564
25960,1196428',2018-09-05,TRF FROM  Indiaforensic SERVICES,0.0,12100000.0,,2018,9,5,TRANSFER,12100000.0,C736160330
25961,1196428',2018-09-05,PBGI01001700213:Bank Guar,12390.0,0.0,,2018,9,5,DEBIT,12390.0,C417236208
25962,1196428',2018-09-05,FDRL/REAL TIME GROSS SETTL,10000000.0,0.0,,2018,9,5,CASH_OUT,10000000.0,C931482420
25963,1196428',2018-09-05,FDRL/NATIONAL ELECTRONIC F,1000000.0,0.0,,2018,9,5,PAYEMENT,1000000.0,M405976415
25964,1196428',2018-09-05,FDRL/INTERNAL FUND TRANSFE,300000.0,0.0,,2018,9,5,CHECK_WITHDRAWAL,300000.0,C208341157
25965,1196428',2018-09-05,FDRL/INTERNAL FUND TRANSFE,200000.0,0.0,,2018,9,5,CASH_OUT,200000.0,C382697424
25966,1196428',2018-09-05,FDRL/INTERNAL FUND TRANSFE,200000.0,0.0,,2018,9,5,PAYEMENT,200000.0,M875577692
25967,1196428',2018-09-05,CASHDEP/GHATKOPAR/,0.0,75000.0,,2018,9,5,TRANSFER,75000.0,C1822578654
25968,1196428',2018-09-05,Indiaforensic SERVICES INDIA PVT,0.0,16983.0,,2018,9,5,CASH_IN,16983.0,M2022435822
25969,1196428',2018-09-05,NEFT/SBIN318248985925/MS,0.0,100000.0,,2018,9,5,TRANSFER,100000.0,M1867372125
25970,1196428',2018-09-05,FDRL/INTERNAL FUND TRANSFE,200000.0,0.0,,2018,9,5,PAYEMENT,200000.0,M556592378
25971,1196428',2018-09-05,FDRL/INTERNAL FUND TRANSFE,200000.0,0.0,,2018,9,5,DEBIT,200000.0,C807072084
25972,1196428',2018-09-05,"Indiaforensic USA, INC./USD/2015",0.0,1432665.0,,2018,9,5,CASH_IN,1432665.0,C2077098348
25973,1196428',2018-09-05,IRTT00701825691,1362.88,0.0,,2018,9,5,PAYEMENT,1362.88,M1751878963
25974,1196428',2018-09-05,FDRL/INTERNAL FUND TRANSFE,300000.0,0.0,,2018,9,5,CHECK_WITHDRAWAL,300000.0,C1618278649
25975,1196428',2018-09-05,FDRL/INTERNAL FUND TRANSFE,200000.0,0.0,,2018,9,5,PAYEMENT,200000.0,C1987564320
25976,1196428',2018-09-05,TRF FROM  Indiaforensic SERVICES,0.0,8800000.0,,2018,9,5,CASH_IN,8800000.0,M848162783
25977,1196428',2018-09-05,NEFT/000051695802/Indiaforensic,0.0,500000.0,,2018,9,5,CASH_IN,500000.0,M347906624
25978,1196428',2018-09-05,NEFT/000051695707/Indiaforensic,0.0,1200000.0,,2018,9,5,CASH_IN,1200000.0,M271658762
25979,1196428',2018-09-05,NEFT/000051695619/Indiaforensic,0.0,1900000.0,,2018,9,5,TRANSFER,1900000.0,M1403007770
25980,1196428',2018-09-05,FDRL/INTERNAL FUND TRANSFE,5000000.0,0.0,,2018,9,5,CASH_OUT,5000000.0,M2043631011
25981,1196428',2018-09-05,FDRL/INTERNAL FUND TRANSFE,3000000.0,0.0,,2018,9,5,PAYEMENT,3000000.0,C107095723
25982,1196428',2018-09-05,FDRL/INTERNAL FUND TRANSFE,1000000.0,0.0,,2018,9,5,CASH_OUT,1000000.0,C985934102
25983,1196428',2018-09-05,BEAT CSH PKP DEL GURG 727,0.0,35500.0,,2018,9,5,TRANSFER,35500.0,C824197891
25984,1196428',2018-09-05,NEFT/AT0409FIXED63033/FIX,0.0,150000.0,,2018,9,5,TRANSFER,150000.0,C1696218625
25985,1196428',2018-09-05,TRF FROM  Indiaforensic SERVICES,0.0,500000.0,,2018,9,5,TRANSFER,500000.0,M1817447589
25986,1196428',2018-09-06,FDRL/INTERNAL FUND TRANSFE,200000.0,0.0,,2018,9,6,DEBIT,200000.0,C168639687
25987,1196428',2018-09-06,FDRL/INTERNAL FUND TRANSFE,300000.0,0.0,,2018,9,6,PAYEMENT,300000.0,C1630293008
25988,1196428',2018-09-06,FDRL/INTERNAL FUND TRANSFE,1000000.0,0.0,,2018,9,6,DEBIT,1000000.0,C1577420620
25989,1196428',2018-09-06,NEFT/N249180626126474/BAT,0.0,195000.0,,2018,9,6,TRANSFER,195000.0,C35263828
25990,1196428',2018-09-06,RTGS/HDFCH18249035126/Indfor,0.0,4900000.0,,2018,9,6,TRANSFER,4900000.0,M2014874822
25991,1196428',2018-09-06,RTGS/SBINH18249030752/Indfor,0.0,8000000.0,,2018,9,6,TRANSFER,8000000.0,M1553772873
25992,1196428',2018-09-06,TRF FROM  Indiaforensic SERVICES,0.0,11200000.0,,2018,9,6,CHECK_CASHING,11200000.0,C905650857
25993,1196428',2018-09-06,FDRL/REAL TIME GROSS SETTL,10503841.46,0.0,,2018,9,6,DEBIT,10503841.46,C1502287290
25994,1196428',2018-09-06,FDRL/REAL TIME GROSS SETTL,15000000.0,0.0,,2018,9,6,PAYEMENT,15000000.0,M1197564988
25995,1196428',2018-09-06,RTGS/HDFCH18249070511/JUN,0.0,200000.0,,2018,9,6,CHECK_CASHING,200000.0,M1843534160
25996,1196428',2018-09-06,FDRL/INTERNAL FUND TRANSFE,500000.0,0.0,,2018,9,6,DEBIT,500000.0,C871895680
25997,1196428',2018-09-06,CASHDEP/GHATKOPAR/,0.0,83000.0,,2018,9,6,CASH_IN,83000.0,C1398530689
25998,1196428',2018-09-06,CASHDEP/VIKASMARG/TP,0.0,65000.0,,2018,9,6,CASH_IN,65000.0,M834859488
25999,1196428',2018-09-06,RTGS/ICICH18249237027/Indfor,0.0,2100000.0,,2018,9,6,CASH_IN,2100000.0,M463880076
26000,1196428',2018-09-06,RTGS/ICICH18249236717/Indfor,0.0,1000000.0,,2018,9,6,CASH_IN,1000000.0,M1273091698
26001,1196428',2018-09-06,IMPS 824916356867 FROM PU,0.0,10000.0,,2018,9,6,CHECK_CASHING,10000.0,M134350609
26002,1196428',2018-09-06,FDRL/NATIONAL ELECTRONIC F,1000000.0,0.0,,2018,9,6,CASH_OUT,1000000.0,M1939822545
26003,1196428',2018-09-06,FDRL/NATIONAL ELECTRONIC F,3000000.0,0.0,,2018,9,6,PAYEMENT,3000000.0,M1498010747
26004,1196428',2018-09-06,FDRL/INTERNAL FUND TRANSFE,500000.0,0.0,,2018,9,6,DEBIT,500000.0,M615833646
26005,1196428',2018-09-06,TRF FROM  Indiaforensic ONLINE S,0.0,100000.0,,2018,9,6,TRANSFER,100000.0,M695601535
26006,1196428',2018-09-06,NEFT/N249180626782132/TEC,0.0,100000.0,,2018,9,6,CASH_IN,100000.0,M1741551200
26007,1196428',2018-09-06,TRF FROM Indiaforensic SERVICES,0.0,9100000.0,,2018,9,6,CASH_IN,9100000.0,M533060514
26008,1196428',2018-09-06,TRF TO  Indiaforensic SERVICES I,2000000.0,0.0,,2018,9,6,CHECK_WITHDRAWAL,2000000.0,M763925237
26009,1196428',2018-09-06,TRF TO  Indiaforensic SERVICES I,283000.0,0.0,,2018,9,6,DEBIT,283000.0,M309397793
26010,1196428',2018-09-06,BEAT CSH PKP DEL UDYOG 72,0.0,77000.0,,2018,9,6,CASH_IN,77000.0,M786088183
26011,1196428',2018-09-06,FDRL/INTERNAL FUND TRANSFE,500000.0,0.0,,2018,9,6,CHECK_WITHDRAWAL,500000.0,M1362397723
26012,1196428',2018-09-06,FDRL/INTERNAL FUND TRANSFE,1000000.0,0.0,,2018,9,6,CHECK_WITHDRAWAL,1000000.0,M166947904
26013,1196428',2018-09-06,FDRL/INTERNAL FUND TRANSFE,500000.0,0.0,,2018,9,6,CHECK_WITHDRAWAL,500000.0,M39384037
26014,1196428',2018-09-06,FDRL/INTERNAL FUND TRANSFE,5000000.0,0.0,,2018,9,6,PAYEMENT,5000000.0,M1475711030
26015,1196428',2018-09-06,FDRL/INTERNAL FUND TRANSFE,1000000.0,0.0,,2018,9,6,PAYEMENT,1000000.0,M727579419
26016,1196428',2018-09-07,NEFT/PUNBH18250341669/MAN,0.0,200000.0,,2018,9,7,CASH_IN,200000.0,M654290745
26017,1196428',2018-09-07,CHQ DEP/595216/OWDEL2/SBI,0.0,11800.0,,2018,9,7,TRANSFER,11800.0,C1559145228
26018,1196428',2018-09-07,CHQ DEP/897486/OWDEL2/SBI,0.0,11800.0,,2018,9,7,TRANSFER,11800.0,M688458571
26019,1196428',2018-09-07,CHQ DEP/383/OWDEL2/ANDB/,0.0,11800.0,,2018,9,7,TRANSFER,11800.0,M1895621189
26020,1196428',2018-09-07,CHQ DEP/132/OWDEL2/HDFC/M,0.0,11800.0,,2018,9,7,CASH_IN,11800.0,M1516781526
26021,1196428',2018-09-07,CHQ DEP/19117/OWDEL2/SBIN,0.0,11800.0,,2018,9,7,TRANSFER,11800.0,M409559965
26022,1196428',2018-09-07,CHQ DEP/130192/OWDEL2/SBI,0.0,11800.0,,2018,9,7,CHECK_CASHING,11800.0,M1771169983
26023,1196428',2018-09-07,CHQ DEP/238996/OWDEL1/SBI,0.0,8000.0,,2018,9,7,CHECK_CASHING,8000.0,C470217116
26024,1196428',2018-09-07,CHQ DEP/17851/OWDEL1/ALLA,0.0,11800.0,,2018,9,7,CASH_IN,11800.0,M585745963
26025,1196428',2018-09-07,CHQ DEP/246699/OWDEL1/PUN,0.0,11800.0,,2018,9,7,CASH_IN,11800.0,M2096974885
26026,1196428',2018-09-07,CHQ DEP/610911/OWDEL1/SBI,0.0,11800.0,,2018,9,7,CASH_IN,11800.0,M1287228290
26027,1196428',2018-09-07,RTGS/HDFCH18250223488/Indfor,0.0,4100000.0,,2018,9,7,CHECK_CASHING,4100000.0,M1178751818
26028,1196428',2018-09-07,CHQ DEP/864254/OWMUM3/BCB,0.0,77517.0,,2018,9,7,CASH_IN,77517.0,M145594829
26029,1196428',2018-09-07,TRF FROM  Indiaforensic SERVICES,0.0,9000000.0,,2018,9,7,TRANSFER,9000000.0,M1232351629
26030,1196428',2018-09-07,FDRL/REAL TIME GROSS SETTL,3000000.0,0.0,,2018,9,7,DEBIT,3000000.0,M1656904340
26031,1196428',2018-09-07,NEFT/AXISP00010868273/ACC,0.0,11000000.0,,2018,9,7,CHECK_CASHING,11000000.0,C24404443
26032,1196428',2018-09-07,IMPS 825014360089 FROM AS,0.0,100070.0,,2018,9,7,CHECK_CASHING,100070.0,C596299019
26033,1196428',2018-09-07,FDRL/REAL TIME GROSS SETTL,9398841.46,0.0,,2018,9,7,DEBIT,9398841.46,C1983747920
26034,1196428',2018-09-07,FDRL/REAL TIME GROSS SETTL,10000000.0,0.0,,2018,9,7,CHECK_WITHDRAWAL,10000000.0,C696705647
26035,1196428',2018-09-07,IRTT00701825912,422.61,0.0,,2018,9,7,CHECK_WITHDRAWAL,422.61,C1845765982
26036,1196428',2018-09-07,"Indiaforensic USA, INC./USD/995/",0.0,70893.75,,2018,9,7,CHECK_CASHING,70893.75,M877365519
26037,1196428',2018-09-07,IMPS 825015178982 FROM PU,0.0,17000.0,,2018,9,7,CHECK_CASHING,17000.0,C134604590
26038,1196428',2018-09-07,NEFT/SBIN618250128728/MS,0.0,100000.0,,2018,9,7,CHECK_CASHING,100000.0,M1053485132
26039,1196428',2018-09-07,IRTT00701825914,1323.54,0.0,,2018,9,7,PAYEMENT,1323.54,M1698378565
26040,1196428',2018-09-07,"Indiaforensic USA, INC./USD/1704",0.0,1214100.0,,2018,9,7,CHECK_CASHING,1214100.0,M1418167825
26041,1196428',2018-09-07,FDRL/INTERNAL FUND TRANSFE,1000000.0,0.0,,2018,9,7,PAYEMENT,1000000.0,M915318947
26042,1196428',2018-09-07,FDRL/INTERNAL FUND TRANSFE,500000.0,0.0,,2018,9,7,DEBIT,500000.0,M1471526064
26043,1196428',2018-09-07,CHQ DEPOSIT RETURN/246699,11800.0,0.0,,2018,9,7,PAYEMENT,11800.0,C474166728
26044,1196428',2018-09-07,FDRL/NATIONAL ELECTRONIC F,1000000.0,0.0,,2018,9,7,DEBIT,1000000.0,M1777764920
26045,1196428',2018-09-07,FDRL/NATIONAL ELECTRONIC F,1000000.0,0.0,,2018,9,7,CHECK_WITHDRAWAL,1000000.0,C1833549064
26046,1196428',2018-09-07,CHQ DEPOSIT RETURN/130192,11800.0,0.0,,2018,9,7,DEBIT,11800.0,M327804056
26047,1196428',2018-09-07,NEFT/N250180628062560/TEC,0.0,200000.0,,2018,9,7,TRANSFER,200000.0,M939893108
26048,1196428',2018-09-07,FDRL/INTERNAL FUND TRANSFE,300000.0,0.0,,2018,9,7,CHECK_WITHDRAWAL,300000.0,C1938462589
26049,1196428',2018-09-07,NEFT/000051847331/Indiaforensic,0.0,1000000.0,,2018,9,7,CASH_IN,1000000.0,M974784761
26050,1196428',2018-09-07,TRF FROM  Indiaforensic SERVICES,0.0,6100000.0,,2018,9,7,CHECK_CASHING,6100000.0,M209997138
26051,1196428',2018-09-07,FDRL/INTERNAL FUND TRANSFE,1000000.0,0.0,,2018,9,7,DEBIT,1000000.0,M359327148
26052,1196428',2018-09-07,FDRL/INTERNAL FUND TRANSFE,2000000.0,0.0,,2018,9,7,DEBIT,2000000.0,C1519216494
26053,1196428',2018-09-07,TRF FROM  Indiaforensic SERVICES,0.0,300000.0,,2018,9,7,CHECK_CASHING,300000.0,M142106520
26054,1196428',2018-09-07,TRF FROM  Indiaforensic SERVICES,0.0,1000000.0,,2018,9,7,TRANSFER,1000000.0,C1979080020
26055,1196428',2018-09-07,TRF FROM  Indiaforensic SERVICES,0.0,3900000.0,,2018,9,7,CASH_IN,3900000.0,C635281078
26056,1196428',2018-09-07,FDRL/INTERNAL FUND TRANSFE,500000.0,0.0,,2018,9,7,DEBIT,500000.0,C1866672043
26057,1196428',2018-09-07,FDRL/INTERNAL FUND TRANSFE,300000.0,0.0,,2018,9,7,CHECK_WITHDRAWAL,300000.0,M155979068
26058,1196428',2018-09-07,FDRL/INTERNAL FUND TRANSFE,500000.0,0.0,,2018,9,7,CASH_OUT,500000.0,M111496179
26059,1196428',2018-09-07,FDRL/INTERNAL FUND TRANSFE,500000.0,0.0,,2018,9,7,CHECK_WITHDRAWAL,500000.0,M1472428747
26060,1196428',2018-09-07,FDRL/INTERNAL FUND TRANSFE,500000.0,0.0,,2018,9,7,CASH_OUT,500000.0,C1167813715
26061,1196428',2018-09-07,FDRL/INTERNAL FUND TRANSFE,500000.0,0.0,,2018,9,7,DEBIT,500000.0,M235839070
26062,1196428',2018-09-07,FDRL/INTERNAL FUND TRANSFE,500000.0,0.0,,2018,9,7,CASH_OUT,500000.0,M1881768592
26063,1196428',2018-09-07,FDRL/INTERNAL FUND TRANSFE,3000000.0,0.0,,2018,9,7,CHECK_WITHDRAWAL,3000000.0,C185503802
26064,1196428',2018-09-07,FDRL/INTERNAL FUND TRANSFE,3000000.0,0.0,,2018,9,7,CHECK_WITHDRAWAL,3000000.0,C403147759
26065,1196428',2018-09-07,CHQ DEPOSIT RETURN/130192,100.0,0.0,,2018,9,7,PAYEMENT,100.0,M1725462644
26066,1196428',2018-09-07,CHQ DEPOSIT RETURN/130192,18.0,0.0,,2018,9,7,DEBIT,18.0,M685639359
26067,1196428',2018-09-08,IMPS 825112683776 FROM SA,0.0,100000.0,,2018,9,8,CHECK_CASHING,100000.0,M499928991
26068,1196428',2018-09-10,NEFT/FSFBH18250000156/FIN,0.0,63153.0,,2018,9,10,TRANSFER,63153.0,M960322367
26069,1196428',2018-09-10,RTGS/SBINH18253006333/Indfor,0.0,2000000.0,,2018,9,10,TRANSFER,2000000.0,M1786085833
26070,1196428',2018-09-10,FDRL/INTERNAL FUND TRANSFE,500000.0,0.0,,2018,9,10,DEBIT,500000.0,M718103121
26071,1196428',2018-09-10,RTGS/HDFCH18253348499/BAT,0.0,400000.0,,2018,9,10,CHECK_CASHING,400000.0,M757687320
26072,1196428',2018-09-10,RTGS/PUNBH18253388832/BAL,0.0,200000.0,,2018,9,10,TRANSFER,200000.0,M1144148971
26073,1196428',2018-09-10,NEFT/SBIN718253048127/MR,0.0,100000.0,,2018,9,10,TRANSFER,100000.0,M1868505862
26074,1196428',2018-09-10,FDRL/INTERNAL FUND TRANSFE,500000.0,0.0,,2018,9,10,CHECK_WITHDRAWAL,500000.0,M1608080402
26075,1196428',2018-09-10,FDRL/INTERNAL FUND TRANSFE,500000.0,0.0,,2018,9,10,CHECK_WITHDRAWAL,500000.0,M1154038476
26076,1196428',2018-09-10,PBGI01001800243:Bank Guar,236000.0,0.0,,2018,9,10,CHECK_WITHDRAWAL,236000.0,M1325923139
26077,1196428',2018-09-10,RTGS/PUNBH18253390714/MAN,0.0,200000.0,,2018,9,10,CASH_IN,200000.0,M1396188238
26078,1196428',2018-09-10,TRF FROM  Indiaforensic SERVICES,0.0,2000000.0,,2018,9,10,TRANSFER,2000000.0,M554850979
26079,1196428',2018-09-10,TRF FROM  Indiaforensic SERVICES,0.0,3000000.0,,2018,9,10,CASH_IN,3000000.0,M1055780232
26080,1196428',2018-09-10,TRF FROM  Indiaforensic SERVICES,0.0,3000000.0,,2018,9,10,CHECK_CASHING,3000000.0,M662568271
26081,1196428',2018-09-10,THE NEW INDIA ASSURANCE C,502149.0,0.0,,2018,9,10,CHECK_WITHDRAWAL,502149.0,C1649449847
26082,1196428',2018-09-10,TATA TELE SERVICES LTD AC,32400.0,0.0,,2018,9,10,PAYEMENT,32400.0,C1198167820
26083,1196428',2018-09-10,FDRL/NATIONAL ELECTRONIC F,12064.0,0.0,,2018,9,10,PAYEMENT,12064.0,C749672494
26084,1196428',2018-09-10,FDRL/REAL TIME GROSS SETTL,7133766.12,0.0,,2018,9,10,CHECK_WITHDRAWAL,7133766.12,C1423992712
26085,1196428',2018-09-10,RTGS/SBINH18253031149/Indfor,0.0,9800000.0,,2018,9,10,CASH_IN,9800000.0,C313124964
26086,1196428',2018-09-10,FDRL/REAL TIME GROSS SETTL,5888085.02,0.0,,2018,9,10,CASH_OUT,5888085.02,C500153041
26087,1196428',2018-09-10,FDRL/INTERNAL FUND TRANSFE,300000.0,0.0,,2018,9,10,DEBIT,300000.0,C728526866
26088,1196428',2018-09-10,FDRL/INTERNAL FUND TRANSFE,400000.0,0.0,,2018,9,10,CASH_OUT,400000.0,C40075281
26089,1196428',2018-09-10,TRF FROM  Indiaforensic SERVICES,0.0,2000000.0,,2018,9,10,TRANSFER,2000000.0,C456538529
26090,1196428',2018-09-10,TRF FROM  Indiaforensic SERVICES,0.0,4000000.0,,2018,9,10,TRANSFER,4000000.0,C2117043942
26091,1196428',2018-09-10,TRF FROM  Indiaforensic SERVICES,0.0,4000000.0,,2018,9,10,CASH_IN,4000000.0,C1838584624
26092,1196428',2018-09-10,FDRL/REAL TIME GROSS SETTL,11609266.98,0.0,,2018,9,10,DEBIT,11609266.98,M1733424208
26093,1196428',2018-09-10,FDRL/REAL TIME GROSS SETTL,1000000.0,0.0,,2018,9,10,PAYEMENT,1000000.0,M1060393794
26094,1196428',2018-09-10,FDRL/REAL TIME GROSS SETTL,1000000.0,0.0,,2018,9,10,DEBIT,1000000.0,M226593165
26095,1196428',2018-09-10,FDRL/REAL TIME GROSS SETTL,1000000.0,0.0,,2018,9,10,PAYEMENT,1000000.0,M426584880
26096,1196428',2018-09-10,IMPS 825314357132 FROM AS,0.0,120099.0,,2018,9,10,CASH_IN,120099.0,C448155494
26097,1196428',2018-09-10,IMPS 825315361151 FROM AS,0.0,130070.0,,2018,9,10,TRANSFER,130070.0,M1594302764
26098,1196428',2018-09-10,BEAT CSH PKP DEL GURG 727,0.0,149000.0,,2018,9,10,CASH_IN,149000.0,M271366306
26099,1196428',2018-09-10,RTGS/HDFCH18253448483/Indfor,0.0,4600000.0,,2018,9,10,CASH_IN,4600000.0,C348708793
26100,1196428',2018-09-10,RTGS/ICICH18253494923/Indfor,0.0,2100000.0,,2018,9,10,TRANSFER,2100000.0,M462659391
26101,1196428',2018-09-10,FDRL/INTERNAL FUND TRANSFE,300000.0,0.0,,2018,9,10,PAYEMENT,300000.0,M547825235
26102,1196428',2018-09-10,FDRL/INTERNAL FUND TRANSFE,400000.0,0.0,,2018,9,10,PAYEMENT,400000.0,M1301971459
26103,1196428',2018-09-10,FDRL/REAL TIME GROSS SETTL,1000000.0,0.0,,2018,9,10,DEBIT,1000000.0,M1155771218
26104,1196428',2018-09-10,FDRL/REAL TIME GROSS SETTL,5000000.0,0.0,,2018,9,10,DEBIT,5000000.0,M734120998
26105,1196428',2018-09-10,RTGS/ICICH18253493371/Indfor,0.0,4700000.0,,2018,9,10,TRANSFER,4700000.0,M1404561012
26106,1196428',2018-09-10,FT ZL180910CD1DDD02 PRAVE,0.0,100000.0,,2018,9,10,CHECK_CASHING,100000.0,M1376999853
26107,1196428',2018-09-10,FDRL/NATIONAL ELECTRONIC F,3000000.0,0.0,,2018,9,10,DEBIT,3000000.0,M255307196
26108,1196428',2018-09-10,FDRL/NATIONAL ELECTRONIC F,2000000.0,0.0,,2018,9,10,PAYEMENT,2000000.0,M11285367
26109,1196428',2018-09-10,NEFT/BARBY18253875477/MAK,0.0,50550.0,,2018,9,10,CASH_IN,50550.0,M714914851
26110,1196428',2018-09-10,TRF FROM  Indiaforensic SERVICES,0.0,3000000.0,,2018,9,10,TRANSFER,3000000.0,M1438724935
26111,1196428',2018-09-10,TRF FROM  Indiaforensic SERVICES,0.0,15000000.0,,2018,9,10,CHECK_CASHING,15000000.0,M662472677
26112,1196428',2018-09-10,FDRL/NATIONAL ELECTRONIC F,15000000.0,0.0,,2018,9,10,DEBIT,15000000.0,M1932384587
26113,1196428',2018-09-10,FDRL/NATIONAL ELECTRONIC F,2000000.0,0.0,,2018,9,10,CHECK_WITHDRAWAL,2000000.0,M719480872
26114,1196428',2018-09-10,FDRL/INTERNAL FUND TRANSFE,500000.0,0.0,,2018,9,10,CASH_OUT,500000.0,M1278136570
26115,1196428',2018-09-10,IMPS 825317157755 FROM SA,0.0,5000.0,,2018,9,10,CASH_IN,5000.0,M148964727
26116,1196428',2018-09-10,FDRL/INTERNAL FUND TRANSFE,300000.0,0.0,,2018,9,10,DEBIT,300000.0,M1177742051
26117,1196428',2018-09-10,FDRL/INTERNAL FUND TRANSFE,300000.0,0.0,,2018,9,10,DEBIT,300000.0,M724365571
26118,1196428',2018-09-10,FDRL/INTERNAL FUND TRANSFE,300000.0,0.0,,2018,9,10,CHECK_WITHDRAWAL,300000.0,M212535805
26119,1196428',2018-09-10,FDRL/INTERNAL FUND TRANSFE,200000.0,0.0,,2018,9,10,DEBIT,200000.0,M1596397541
26120,1196428',2018-09-10,TRF FROM  Indiaforensic SERVICES,0.0,10000000.0,,2018,9,10,CHECK_CASHING,10000000.0,M713285225
26121,1196428',2018-09-10,TRF FROM  Indiaforensic SERVICES,0.0,10000000.0,,2018,9,10,TRANSFER,10000000.0,C2032389005
26122,1196428',2018-09-10,TRF FROM  Indiaforensic SERVICES,0.0,500000.0,,2018,9,10,CHECK_CASHING,500000.0,M1156533869
26123,1196428',2018-09-10,FDRL/INTERNAL FUND TRANSFE,500000.0,0.0,,2018,9,10,PAYEMENT,500000.0,M105292474
26124,1196428',2018-09-10,FDRL/INTERNAL FUND TRANSFE,500000.0,0.0,,2018,9,10,CASH_OUT,500000.0,M1410438390
26125,1196428',2018-09-10,FDRL/INTERNAL FUND TRANSFE,500000.0,0.0,,2018,9,10,PAYEMENT,500000.0,M1257755465
26126,1196428',2018-09-10,FDRL/INTERNAL FUND TRANSFE,500000.0,0.0,,2018,9,10,DEBIT,500000.0,M1640401120
26127,1196428',2018-09-10,TRF FROM  Indiaforensic SERVICES,0.0,2000000.0,,2018,9,10,CHECK_CASHING,2000000.0,M1399060771
26128,1196428',2018-09-10,FDRL/INTERNAL FUND TRANSFE,5000000.0,0.0,,2018,9,10,DEBIT,5000000.0,C1262822392
26129,1196428',2018-09-10,FDRL/INTERNAL FUND TRANSFE,3000000.0,0.0,,2018,9,10,DEBIT,3000000.0,M148589770
26130,1196428',2018-09-10,BEAT CSH PKP DEL GURG 727,0.0,107000.0,,2018,9,10,TRANSFER,107000.0,M984489239
26131,1196428',2018-09-11,FDRL/INTERNAL FUND TRANSFE,500000.0,0.0,,2018,9,11,PAYEMENT,500000.0,C2115055717
26132,1196428',2018-09-11,FDRL/REAL TIME GROSS SETTL,10529863.34,0.0,,2018,9,11,CASH_OUT,10529863.34,C1166654566
26133,1196428',2018-09-11,NEFT/N254180629961463/USH,0.0,95000.0,,2018,9,11,TRANSFER,95000.0,M88042020
26134,1196428',2018-09-11,FDRL/REAL TIME GROSS SETTL,1000000.0,0.0,,2018,9,11,CASH_OUT,1000000.0,M717278894
26135,1196428',2018-09-11,NEFT/P18091141143260/S B,0.0,99500.0,,2018,9,11,TRANSFER,99500.0,M129220812
26136,1196428',2018-09-11,IMPS 825412466286 FROM SA,0.0,200000.0,,2018,9,11,CASH_IN,200000.0,M1015272304
26137,1196428',2018-09-11,FDRL/INTERNAL FUND TRANSFE,500000.0,0.0,,2018,9,11,DEBIT,500000.0,C1007717381
26138,1196428',2018-09-11,FDRL/INTERNAL FUND TRANSFE,500000.0,0.0,,2018,9,11,CHECK_WITHDRAWAL,500000.0,C1240091493
26139,1196428',2018-09-11,CASHDEP/GHATKOPAR/,0.0,100000.0,,2018,9,11,TRANSFER,100000.0,C1396297158
26140,1196428',2018-09-11,"Indiaforensic USA, INC./USD/2623",0.0,1890087.65,,2018,9,11,TRANSFER,1890087.65,M705803524
26141,1196428',2018-09-11,IRTT00701826182,1445.22,0.0,,2018,9,11,CASH_OUT,1445.22,C978740207
26142,1196428',2018-09-11,TRF FRM  Indiaforensic SERVICES,0.0,1000000.0,,2018,9,11,CHECK_CASHING,1000000.0,C115885991
26143,1196428',2018-09-11,NEFT/20702470121DC/ARTHAS,0.0,25000.0,,2018,9,11,CASH_IN,25000.0,C587433505
26144,1196428',2018-09-11,NEFT/AXISP00011322536/ACC,0.0,1000000.0,,2018,9,11,TRANSFER,1000000.0,C1637186972
26145,1196428',2018-09-11,CHQ DEP/676174/OWDEL1/SBI,0.0,11800.0,,2018,9,11,CASH_IN,11800.0,M190739308
26146,1196428',2018-09-11,CHQ DEP/311957/OWDEL1/PUN,0.0,11800.0,,2018,9,11,TRANSFER,11800.0,C778306577
26147,1196428',2018-09-11,CHQ DEP/777571/OWDEL1/SBI,0.0,11800.0,,2018,9,11,CHECK_CASHING,11800.0,M1863711975
26148,1196428',2018-09-11,CHQ DEP/1753/OWDEL1/ORBC/,0.0,11800.0,,2018,9,11,TRANSFER,11800.0,M1469855297
26149,1196428',2018-09-11,CHQ DEP/24818/OWDEL1/PUNB,0.0,11800.0,,2018,9,11,CASH_IN,11800.0,M794421806
26150,1196428',2018-09-11,CHQ DEP/21071/OWDEL1/PUNB,0.0,11800.0,,2018,9,11,TRANSFER,11800.0,M1334051844
26151,1196428',2018-09-11,CHQ DEP/885431/OWDEL1/SBI,0.0,11800.0,,2018,9,11,CHECK_CASHING,11800.0,M515450283
26152,1196428',2018-09-11,Indiaforensic SERVICES INDIA PVT,0.0,538835.0,,2018,9,11,CASH_IN,538835.0,M1747790771
26153,1196428',2018-09-11,FDRL/REAL TIME GROSS SETTL,2000000.0,0.0,,2018,9,11,DEBIT,2000000.0,M1284135884
26154,1196428',2018-09-11,FDRL/REAL TIME GROSS SETTL,2000000.0,0.0,,2018,9,11,PAYEMENT,2000000.0,C420561530
26155,1196428',2018-09-11,NEFT/BARBZ18254372139/MAK,0.0,50005.0,,2018,9,11,CASH_IN,50005.0,M694158341
26156,1196428',2018-09-11,RTGS/ICICH18254609520/Indfor,0.0,500000.0,,2018,9,11,CHECK_CASHING,500000.0,C2046578329
26157,1196428',2018-09-11,RTGS/ICICH18254607346/Indfor,0.0,1500000.0,,2018,9,11,TRANSFER,1500000.0,M942812964
26158,1196428',2018-09-11,FDRL/NATIONAL ELECTRONIC F,21109.0,0.0,,2018,9,11,CASH_OUT,21109.0,M1977844832
26159,1196428',2018-09-11,FDRL/NATIONAL ELECTRONIC F,21109.0,0.0,,2018,9,11,CHECK_WITHDRAWAL,21109.0,M1171276229
26160,1196428',2018-09-11,FDRL/NATIONAL ELECTRONIC F,27953.0,0.0,,2018,9,11,CHECK_WITHDRAWAL,27953.0,M1741253456
26161,1196428',2018-09-11,FDRL/NATIONAL ELECTRONIC F,23294.0,0.0,,2018,9,11,DEBIT,23294.0,M1549630173
26162,1196428',2018-09-11,TRF FROM  Indiaforensic SERVICES,0.0,5000000.0,,2018,9,11,TRANSFER,5000000.0,C1548218207
26163,1196428',2018-09-11,TRF FROM  Indiaforensic SERVICES,0.0,4000000.0,,2018,9,11,CASH_IN,4000000.0,C242559404
26164,1196428',2018-09-11,FDRL/NATIONAL ELECTRONIC F,1000000.0,0.0,,2018,9,11,CASH_OUT,1000000.0,C1153596299
26165,1196428',2018-09-11,FDRL/REAL TIME GROSS SETTL,10000000.0,0.0,,2018,9,11,DEBIT,10000000.0,M708011911
26166,1196428',2018-09-11,FDRL/INTERNAL FUND TRANSFE,400000.0,0.0,,2018,9,11,DEBIT,400000.0,M1579526490
26167,1196428',2018-09-11,Indiaforensic SERVICES INDIA PVT,0.0,141433.0,,2018,9,11,TRANSFER,141433.0,C1924874046
26168,1196428',2018-09-11,TRF FROM  Indiaforensic SERVICES,0.0,7700000.0,,2018,9,11,CASH_IN,7700000.0,C1079343872
26169,1196428',2018-09-11,TRF TO  Indiaforensic SERVICES I,15000.0,0.0,,2018,9,11,CASH_OUT,15000.0,M1025387324
26170,1196428',2018-09-11,FDRL/NATIONAL ELECTRONIC F,221263.0,0.0,,2018,9,11,DEBIT,221263.0,M2114990234
26171,1196428',2018-09-11,FDRL/NATIONAL ELECTRONIC F,290653.0,0.0,,2018,9,11,CASH_OUT,290653.0,M1843420945
26172,1196428',2018-09-11,FDRL/NATIONAL ELECTRONIC F,768734.0,0.0,,2018,9,11,CASH_OUT,768734.0,C863811613
26173,1196428',2018-09-11,FDRL/NATIONAL ELECTRONIC F,241812.0,0.0,,2018,9,11,CHECK_WITHDRAWAL,241812.0,M1539382844
26174,1196428',2018-09-11,NEFT/AXIC182545283958/Indfor,0.0,4500000.0,,2018,9,11,CASH_IN,4500000.0,M1846768700
26175,1196428',2018-09-11,FDRL/INTERNAL FUND TRANSFE,300000.0,0.0,,2018,9,11,CHECK_WITHDRAWAL,300000.0,C1640747200
26176,1196428',2018-09-11,FDRL/INTERNAL FUND TRANSFE,300000.0,0.0,,2018,9,11,CHECK_WITHDRAWAL,300000.0,M1099038981
26177,1196428',2018-09-11,FDRL/INTERNAL FUND TRANSFE,300000.0,0.0,,2018,9,11,CHECK_WITHDRAWAL,300000.0,C344610846
26178,1196428',2018-09-11,TRF TO  Indiaforensic SERVICES I,60000.0,0.0,,2018,9,11,PAYEMENT,60000.0,C1919277981
26179,1196428',2018-09-11,NEFT/N254180630692053/TEC,0.0,100000.0,,2018,9,11,CHECK_CASHING,100000.0,C2104652067
26180,1196428',2018-09-11,CHQ DEPOSIT RETURN/311957,11800.0,0.0,,2018,9,11,DEBIT,11800.0,C1092465037
26181,1196428',2018-09-11,CHQ DEPOSIT RETURN/1753/F,11800.0,0.0,,2018,9,11,DEBIT,11800.0,M995633719
26182,1196428',2018-09-11,FDRL/INTERNAL FUND TRANSFE,100000.0,0.0,,2018,9,11,CHECK_WITHDRAWAL,100000.0,M938465080
26183,1196428',2018-09-11,FDRL/INTERNAL FUND TRANSFE,500000.0,0.0,,2018,9,11,CHECK_WITHDRAWAL,500000.0,M1834981639
26184,1196428',2018-09-11,FDRL/INTERNAL FUND TRANSFE,500000.0,0.0,,2018,9,11,CHECK_WITHDRAWAL,500000.0,M1775303360
26185,1196428',2018-09-11,FDRL/INTERNAL FUND TRANSFE,5000000.0,0.0,,2018,9,11,PAYEMENT,5000000.0,M261084274
26186,1196428',2018-09-11,FDRL/INTERNAL FUND TRANSFE,500000.0,0.0,,2018,9,11,DEBIT,500000.0,M1007295516
26187,1196428',2018-09-11,FDRL/INTERNAL FUND TRANSFE,500000.0,0.0,,2018,9,11,PAYEMENT,500000.0,M470234716
26188,1196428',2018-09-11,BEAT CSH PKP DEL GURG 727,0.0,124500.0,,2018,9,11,TRANSFER,124500.0,M905290562
26189,1196428',2018-09-11,FDRL/INTERNAL FUND TRANSFE,400000.0,0.0,,2018,9,11,CHECK_WITHDRAWAL,400000.0,M798935213
26190,1196428',2018-09-11,FDRL/INTERNAL FUND TRANSFE,300000.0,0.0,,2018,9,11,DEBIT,300000.0,M1932154134
26191,1196428',2018-09-11,TRFF RM  Indiaforensic SERVICES,0.0,500000.0,,2018,9,11,CHECK_CASHING,500000.0,M1426777731
26192,1196428',2018-09-11,TRF FRM  Indiaforensic SERVICES,0.0,700000.0,,2018,9,11,TRANSFER,700000.0,M2001931511
26193,1196428',2018-09-11,TRF TO  Indiaforensic SERVICES I,36164.0,0.0,,2018,9,11,CASH_OUT,36164.0,M1028639221
26194,1196428',2018-09-11,FDRL/INTERNAL FUND TRANSFE,400000.0,0.0,,2018,9,11,DEBIT,400000.0,M129965176
26195,1196428',2018-09-11,FDRL/INTERNAL FUND TRANSFE,300000.0,0.0,,2018,9,11,CHECK_WITHDRAWAL,300000.0,M1666930496
26196,1196428',2018-09-11,CHQ DEPOSIT RETURN/311957,100.0,0.0,,2018,9,11,CHECK_WITHDRAWAL,100.0,M1348049534
26197,1196428',2018-09-11,CHQ DEPOSIT RETURN/311957,18.0,0.0,,2018,9,11,CHECK_WITHDRAWAL,18.0,M149861385
26198,1196428',2018-09-11,CHQ DEPOSIT RETURN/1753/C,100.0,0.0,,2018,9,11,CASH_OUT,100.0,M1803845616
26199,1196428',2018-09-11,CHQ DEPOSIT RETURN/1753/G,18.0,0.0,,2018,9,11,PAYEMENT,18.0,M396463835
26200,1196428',2018-09-12,FDRL/NATIONAL ELECTRONIC F,12366.0,0.0,,2018,9,12,DEBIT,12366.0,M1022045468
26201,1196428',2018-09-12,FDRL/NATIONAL ELECTRONIC F,29058.0,0.0,,2018,9,12,PAYEMENT,29058.0,M1556446144
26202,1196428',2018-09-12,FDRL/NATIONAL ELECTRONIC F,15035.0,0.0,,2018,9,12,CHECK_WITHDRAWAL,15035.0,M141959252
26203,1196428',2018-09-12,FDRL/NATIONAL ELECTRONIC F,17546.0,0.0,,2018,9,12,DEBIT,17546.0,M1997459283
26204,1196428',2018-09-12,FDRL/NATIONAL ELECTRONIC F,14909.0,0.0,,2018,9,12,DEBIT,14909.0,M539292855
26205,1196428',2018-09-12,FDRL/NATIONAL ELECTRONIC F,29650.0,0.0,,2018,9,12,DEBIT,29650.0,M878266233
26206,1196428',2018-09-12,FDRL/NATIONAL ELECTRONIC F,19389.0,0.0,,2018,9,12,CHECK_WITHDRAWAL,19389.0,M1660780699
26207,1196428',2018-09-12,FDRL/NATIONAL ELECTRONIC F,15244.0,0.0,,2018,9,12,DEBIT,15244.0,M1242431450
26208,1196428',2018-09-12,FDRL/NATIONAL ELECTRONIC F,23780.0,0.0,,2018,9,12,PAYEMENT,23780.0,M2075133206
26209,1196428',2018-09-12,FDRL/NATIONAL ELECTRONIC F,19543.0,0.0,,2018,9,12,DEBIT,19543.0,M1651383848
26210,1196428',2018-09-12,FDRL/NATIONAL ELECTRONIC F,17186.0,0.0,,2018,9,12,DEBIT,17186.0,M1364290623
26211,1196428',2018-09-12,FDRL/NATIONAL ELECTRONIC F,18998.0,0.0,,2018,9,12,CASH_OUT,18998.0,M1119145556
26212,1196428',2018-09-12,FDRL/NATIONAL ELECTRONIC F,8178.0,0.0,,2018,9,12,CASH_OUT,8178.0,M552762676
26213,1196428',2018-09-12,FDRL/NATIONAL ELECTRONIC F,26400.0,0.0,,2018,9,12,CASH_OUT,26400.0,M1549335447
26214,1196428',2018-09-12,FDRL/NATIONAL ELECTRONIC F,28335.0,0.0,,2018,9,12,CASH_OUT,28335.0,M1407332998
26215,1196428',2018-09-12,FDRL/NATIONAL ELECTRONIC F,25725.0,0.0,,2018,9,12,CASH_OUT,25725.0,M575173490
26216,1196428',2018-09-12,FDRL/NATIONAL ELECTRONIC F,14397.0,0.0,,2018,9,12,PAYEMENT,14397.0,M1463959599
26217,1196428',2018-09-12,FDRL/NATIONAL ELECTRONIC F,18612.0,0.0,,2018,9,12,CASH_OUT,18612.0,C191614132
26218,1196428',2018-09-12,FDRL/NATIONAL ELECTRONIC F,29479.0,0.0,,2018,9,12,CASH_OUT,29479.0,C1885712019
26219,1196428',2018-09-12,FDRL/NATIONAL ELECTRONIC F,24276.0,0.0,,2018,9,12,CASH_OUT,24276.0,M1406881784
26220,1196428',2018-09-12,FDRL/NATIONAL ELECTRONIC F,13555.0,0.0,,2018,9,12,DEBIT,13555.0,C1161865950
26221,1196428',2018-09-12,FDRL/NATIONAL ELECTRONIC F,10655.0,0.0,,2018,9,12,CHECK_WITHDRAWAL,10655.0,M1558051277
26222,1196428',2018-09-12,FDRL/NATIONAL ELECTRONIC F,18314.0,0.0,,2018,9,12,PAYEMENT,18314.0,M1173085824
26223,1196428',2018-09-12,FDRL/NATIONAL ELECTRONIC F,26350.0,0.0,,2018,9,12,DEBIT,26350.0,M569018137
26224,1196428',2018-09-12,FDRL/NATIONAL ELECTRONIC F,18314.0,0.0,,2018,9,12,CASH_OUT,18314.0,M1770271962
26225,1196428',2018-09-12,FDRL/NATIONAL ELECTRONIC F,18564.0,0.0,,2018,9,12,CASH_OUT,18564.0,M1586738337
26226,1196428',2018-09-12,FDRL/NATIONAL ELECTRONIC F,27563.0,0.0,,2018,9,12,CASH_OUT,27563.0,M1674738101
26227,1196428',2018-09-12,FDRL/NATIONAL ELECTRONIC F,18314.0,0.0,,2018,9,12,PAYEMENT,18314.0,C1590550415
26228,1196428',2018-09-12,FDRL/NATIONAL ELECTRONIC F,26855.0,0.0,,2018,9,12,DEBIT,26855.0,C705321061
26229,1196428',2018-09-12,FDRL/NATIONAL ELECTRONIC F,18699.0,0.0,,2018,9,12,PAYEMENT,18699.0,M873689156
26230,1196428',2018-09-12,FDRL/NATIONAL ELECTRONIC F,20592.0,0.0,,2018,9,12,CHECK_WITHDRAWAL,20592.0,M1538317866
26231,1196428',2018-09-12,FDRL/NATIONAL ELECTRONIC F,21907.0,0.0,,2018,9,12,CHECK_WITHDRAWAL,21907.0,C262828207
26232,1196428',2018-09-12,FDRL/NATIONAL ELECTRONIC F,10472.0,0.0,,2018,9,12,PAYEMENT,10472.0,C1222590577
26233,1196428',2018-09-12,FDRL/NATIONAL ELECTRONIC F,21271.0,0.0,,2018,9,12,PAYEMENT,21271.0,M2089852906
26234,1196428',2018-09-12,FDRL/NATIONAL ELECTRONIC F,28726.0,0.0,,2018,9,12,DEBIT,28726.0,M629502621
26235,1196428',2018-09-12,FDRL/NATIONAL ELECTRONIC F,26350.0,0.0,,2018,9,12,PAYEMENT,26350.0,M511596806
26236,1196428',2018-09-12,FDRL/NATIONAL ELECTRONIC F,12997.0,0.0,,2018,9,12,CASH_OUT,12997.0,M2079635991
26237,1196428',2018-09-12,FDRL/NATIONAL ELECTRONIC F,26050.0,0.0,,2018,9,12,PAYEMENT,26050.0,M1044456366
26238,1196428',2018-09-12,FDRL/NATIONAL ELECTRONIC F,12529.0,0.0,,2018,9,12,PAYEMENT,12529.0,C1689840534
26239,1196428',2018-09-12,FDRL/NATIONAL ELECTRONIC F,13174.0,0.0,,2018,9,12,CHECK_WITHDRAWAL,13174.0,M1092817314
26240,1196428',2018-09-12,FDRL/NATIONAL ELECTRONIC F,28579.0,0.0,,2018,9,12,PAYEMENT,28579.0,C1475909248
26241,1196428',2018-09-12,FDRL/NATIONAL ELECTRONIC F,18314.0,0.0,,2018,9,12,PAYEMENT,18314.0,M2040472550
26242,1196428',2018-09-12,FDRL/NATIONAL ELECTRONIC F,28579.0,0.0,,2018,9,12,CHECK_WITHDRAWAL,28579.0,C979719862
26243,1196428',2018-09-12,FDRL/NATIONAL ELECTRONIC F,17097.0,0.0,,2018,9,12,CASH_OUT,17097.0,C985934102
26244,1196428',2018-09-12,FDRL/NATIONAL ELECTRONIC F,25841.0,0.0,,2018,9,12,DEBIT,25841.0,C731253803
26245,1196428',2018-09-12,FDRL/NATIONAL ELECTRONIC F,17723.0,0.0,,2018,9,12,CHECK_WITHDRAWAL,17723.0,C1609562230
26246,1196428',2018-09-12,FDRL/NATIONAL ELECTRONIC F,14744.0,0.0,,2018,9,12,DEBIT,14744.0,M1076923640
26247,1196428',2018-09-12,FDRL/NATIONAL ELECTRONIC F,28156.0,0.0,,2018,9,12,CHECK_WITHDRAWAL,28156.0,M1144262832
26248,1196428',2018-09-12,FDRL/NATIONAL ELECTRONIC F,20303.0,0.0,,2018,9,12,CHECK_WITHDRAWAL,20303.0,M942922351
26249,1196428',2018-09-12,FDRL/NATIONAL ELECTRONIC F,18699.0,0.0,,2018,9,12,CHECK_WITHDRAWAL,18699.0,M1582038853
26250,1196428',2018-09-12,FDRL/NATIONAL ELECTRONIC F,28610.0,0.0,,2018,9,12,CHECK_WITHDRAWAL,28610.0,M36034212
26251,1196428',2018-09-12,FDRL/NATIONAL ELECTRONIC F,28602.0,0.0,,2018,9,12,DEBIT,28602.0,M1326356346
26252,1196428',2018-09-12,FDRL/NATIONAL ELECTRONIC F,28565.0,0.0,,2018,9,12,PAYEMENT,28565.0,C27489818
26253,1196428',2018-09-12,FDRL/NATIONAL ELECTRONIC F,15596.0,0.0,,2018,9,12,DEBIT,15596.0,C747979499
26254,1196428',2018-09-12,FDRL/NATIONAL ELECTRONIC F,13344.0,0.0,,2018,9,12,CASH_OUT,13344.0,C1660095722
26255,1196428',2018-09-12,FDRL/NATIONAL ELECTRONIC F,16157.0,0.0,,2018,9,12,CASH_OUT,16157.0,C372017580
26256,1196428',2018-09-12,FDRL/NATIONAL ELECTRONIC F,28602.0,0.0,,2018,9,12,CHECK_WITHDRAWAL,28602.0,M370179552
26257,1196428',2018-09-12,FDRL/NATIONAL ELECTRONIC F,18552.0,0.0,,2018,9,12,CASH_OUT,18552.0,C802935635
26258,1196428',2018-09-12,FDRL/NATIONAL ELECTRONIC F,18802.0,0.0,,2018,9,12,CHECK_WITHDRAWAL,18802.0,M1523086740
26259,1196428',2018-09-12,FDRL/NATIONAL ELECTRONIC F,11068.0,0.0,,2018,9,12,CASH_OUT,11068.0,M902885640
26260,1196428',2018-09-12,FDRL/NATIONAL ELECTRONIC F,28579.0,0.0,,2018,9,12,CASH_OUT,28579.0,C459172227
26261,1196428',2018-09-12,FDRL/NATIONAL ELECTRONIC F,13167.0,0.0,,2018,9,12,PAYEMENT,13167.0,C265108079
26262,1196428',2018-09-12,FDRL/NATIONAL ELECTRONIC F,18552.0,0.0,,2018,9,12,PAYEMENT,18552.0,C35126588
26263,1196428',2018-09-12,FDRL/NATIONAL ELECTRONIC F,13344.0,0.0,,2018,9,12,PAYEMENT,13344.0,C1589477624
26264,1196428',2018-09-12,FDRL/NATIONAL ELECTRONIC F,28594.0,0.0,,2018,9,12,CHECK_WITHDRAWAL,28594.0,C1283595719
26265,1196428',2018-09-12,FDRL/NATIONAL ELECTRONIC F,15596.0,0.0,,2018,9,12,CASH_OUT,15596.0,C101084405
26266,1196428',2018-09-12,FDRL/NATIONAL ELECTRONIC F,18528.0,0.0,,2018,9,12,PAYEMENT,18528.0,M7891579
26267,1196428',2018-09-12,FDRL/NATIONAL ELECTRONIC F,24736.0,0.0,,2018,9,12,CASH_OUT,24736.0,M150228660
26268,1196428',2018-09-12,FDRL/NATIONAL ELECTRONIC F,13167.0,0.0,,2018,9,12,DEBIT,13167.0,M190019040
26269,1196428',2018-09-12,FDRL/NATIONAL ELECTRONIC F,20302.0,0.0,,2018,9,12,CASH_OUT,20302.0,M1462909495
26270,1196428',2018-09-12,FDRL/NATIONAL ELECTRONIC F,20302.0,0.0,,2018,9,12,CASH_OUT,20302.0,C1192983708
26271,1196428',2018-09-12,FDRL/NATIONAL ELECTRONIC F,13167.0,0.0,,2018,9,12,DEBIT,13167.0,M1730398598
26272,1196428',2018-09-12,FDRL/NATIONAL ELECTRONIC F,28989.0,0.0,,2018,9,12,CHECK_WITHDRAWAL,28989.0,M1492635498
26273,1196428',2018-09-12,FDRL/NATIONAL ELECTRONIC F,19551.0,0.0,,2018,9,12,PAYEMENT,19551.0,M738483886
26274,1196428',2018-09-12,FDRL/NATIONAL ELECTRONIC F,28609.0,0.0,,2018,9,12,CASH_OUT,28609.0,M1583014678
26275,1196428',2018-09-12,FDRL/NATIONAL ELECTRONIC F,25051.0,0.0,,2018,9,12,PAYEMENT,25051.0,C395114097
26276,1196428',2018-09-12,FDRL/NATIONAL ELECTRONIC F,13167.0,0.0,,2018,9,12,DEBIT,13167.0,M743943553
26277,1196428',2018-09-12,FDRL/NATIONAL ELECTRONIC F,20480.0,0.0,,2018,9,12,PAYEMENT,20480.0,M2034445578
26278,1196428',2018-09-12,FDRL/NATIONAL ELECTRONIC F,13167.0,0.0,,2018,9,12,CASH_OUT,13167.0,C1383942363
26279,1196428',2018-09-12,FDRL/NATIONAL ELECTRONIC F,13749.0,0.0,,2018,9,12,CHECK_WITHDRAWAL,13749.0,M72285092
26280,1196428',2018-09-12,FDRL/NATIONAL ELECTRONIC F,28659.0,0.0,,2018,9,12,CHECK_WITHDRAWAL,28659.0,M586185216
26281,1196428',2018-09-12,FDRL/NATIONAL ELECTRONIC F,10320.0,0.0,,2018,9,12,CHECK_WITHDRAWAL,10320.0,M1378755468
26282,1196428',2018-09-12,FDRL/NATIONAL ELECTRONIC F,17619.0,0.0,,2018,9,12,CASH_OUT,17619.0,C765980478
26283,1196428',2018-09-12,FDRL/NATIONAL ELECTRONIC F,19381.0,0.0,,2018,9,12,CHECK_WITHDRAWAL,19381.0,C1200314947
26284,1196428',2018-09-12,FDRL/NATIONAL ELECTRONIC F,28609.0,0.0,,2018,9,12,CHECK_WITHDRAWAL,28609.0,C1973491942
26285,1196428',2018-09-12,FDRL/NATIONAL ELECTRONIC F,27486.0,0.0,,2018,9,12,DEBIT,27486.0,C1689374891
26286,1196428',2018-09-12,FDRL/NATIONAL ELECTRONIC F,20302.0,0.0,,2018,9,12,CASH_OUT,20302.0,C2053639017
26287,1196428',2018-09-12,FDRL/NATIONAL ELECTRONIC F,20302.0,0.0,,2018,9,12,CASH_OUT,20302.0,C1654056127
26288,1196428',2018-09-12,FDRL/NATIONAL ELECTRONIC F,19416.0,0.0,,2018,9,12,CHECK_WITHDRAWAL,19416.0,C803368825
26289,1196428',2018-09-12,FDRL/NATIONAL ELECTRONIC F,28610.0,0.0,,2018,9,12,CHECK_WITHDRAWAL,28610.0,C892686452
26290,1196428',2018-09-12,FDRL/NATIONAL ELECTRONIC F,20280.0,0.0,,2018,9,12,DEBIT,20280.0,C2031563133
26291,1196428',2018-09-12,FDRL/NATIONAL ELECTRONIC F,28859.0,0.0,,2018,9,12,CHECK_WITHDRAWAL,28859.0,C1619402333
26292,1196428',2018-09-12,FDRL/NATIONAL ELECTRONIC F,20302.0,0.0,,2018,9,12,DEBIT,20302.0,C1149273771
26293,1196428',2018-09-12,FDRL/NATIONAL ELECTRONIC F,20280.0,0.0,,2018,9,12,CHECK_WITHDRAWAL,20280.0,C2109470512
26294,1196428',2018-09-12,FDRL/NATIONAL ELECTRONIC F,12648.0,0.0,,2018,9,12,DEBIT,12648.0,C1059781259
26295,1196428',2018-09-12,FDRL/NATIONAL ELECTRONIC F,18602.0,0.0,,2018,9,12,CHECK_WITHDRAWAL,18602.0,C125722707
26296,1196428',2018-09-12,FDRL/NATIONAL ELECTRONIC F,13167.0,0.0,,2018,9,12,DEBIT,13167.0,C1778300121
26297,1196428',2018-09-12,FDRL/NATIONAL ELECTRONIC F,17356.0,0.0,,2018,9,12,PAYEMENT,17356.0,C313124964
26298,1196428',2018-09-12,FDRL/NATIONAL ELECTRONIC F,28609.0,0.0,,2018,9,12,CHECK_WITHDRAWAL,28609.0,C1220897602
26299,1196428',2018-09-12,FDRL/NATIONAL ELECTRONIC F,28609.0,0.0,,2018,9,12,CHECK_WITHDRAWAL,28609.0,C1515704208
26300,1196428',2018-09-12,FDRL/NATIONAL ELECTRONIC F,26140.0,0.0,,2018,9,12,DEBIT,26140.0,C1313534832
26301,1196428',2018-09-12,FDRL/NATIONAL ELECTRONIC F,27254.0,0.0,,2018,9,12,DEBIT,27254.0,C1141137903
26302,1196428',2018-09-12,FDRL/NATIONAL ELECTRONIC F,18602.0,0.0,,2018,9,12,DEBIT,18602.0,C1869228744
26303,1196428',2018-09-12,FDRL/NATIONAL ELECTRONIC F,28610.0,0.0,,2018,9,12,DEBIT,28610.0,C2078250226
26304,1196428',2018-09-12,FDRL/NATIONAL ELECTRONIC F,20303.0,0.0,,2018,9,12,DEBIT,20303.0,C1300519073
26305,1196428',2018-09-12,FDRL/NATIONAL ELECTRONIC F,13167.0,0.0,,2018,9,12,CASH_OUT,13167.0,M1808484670
26306,1196428',2018-09-12,FDRL/NATIONAL ELECTRONIC F,20303.0,0.0,,2018,9,12,PAYEMENT,20303.0,M829035073
26307,1196428',2018-09-12,FDRL/NATIONAL ELECTRONIC F,14627.0,0.0,,2018,9,12,PAYEMENT,14627.0,M1674174327
26308,1196428',2018-09-12,FDRL/NATIONAL ELECTRONIC F,11068.0,0.0,,2018,9,12,DEBIT,11068.0,M2135203084
26309,1196428',2018-09-12,FDRL/NATIONAL ELECTRONIC F,23996.0,0.0,,2018,9,12,PAYEMENT,23996.0,C1673971173
26310,1196428',2018-09-12,FDRL/NATIONAL ELECTRONIC F,28610.0,0.0,,2018,9,12,CASH_OUT,28610.0,C339099861
26311,1196428',2018-09-12,FDRL/NATIONAL ELECTRONIC F,28672.0,0.0,,2018,9,12,PAYEMENT,28672.0,M2045422556
26312,1196428',2018-09-12,FDRL/NATIONAL ELECTRONIC F,28610.0,0.0,,2018,9,12,PAYEMENT,28610.0,C1266035080
26313,1196428',2018-09-12,FDRL/NATIONAL ELECTRONIC F,28660.0,0.0,,2018,9,12,DEBIT,28660.0,C1060041730
26314,1196428',2018-09-12,FDRL/NATIONAL ELECTRONIC F,20281.0,0.0,,2018,9,12,CASH_OUT,20281.0,C1475395523
26315,1196428',2018-09-12,FDRL/NATIONAL ELECTRONIC F,13167.0,0.0,,2018,9,12,PAYEMENT,13167.0,C265845794
26316,1196428',2018-09-12,FDRL/NATIONAL ELECTRONIC F,21949.0,0.0,,2018,9,12,DEBIT,21949.0,C58091972
26317,1196428',2018-09-12,FDRL/NATIONAL ELECTRONIC F,22527.0,0.0,,2018,9,12,CASH_OUT,22527.0,C193864812
26318,1196428',2018-09-12,FDRL/NATIONAL ELECTRONIC F,20347.0,0.0,,2018,9,12,PAYEMENT,20347.0,C681835572
26319,1196428',2018-09-12,FDRL/NATIONAL ELECTRONIC F,20303.0,0.0,,2018,9,12,PAYEMENT,20303.0,C965197768
26320,1196428',2018-09-12,FDRL/NATIONAL ELECTRONIC F,20303.0,0.0,,2018,9,12,CHECK_WITHDRAWAL,20303.0,C893038039
26321,1196428',2018-09-12,FDRL/NATIONAL ELECTRONIC F,16157.0,0.0,,2018,9,12,DEBIT,16157.0,C1317731757
26322,1196428',2018-09-12,FDRL/NATIONAL ELECTRONIC F,13167.0,0.0,,2018,9,12,DEBIT,13167.0,C1373467808
26323,1196428',2018-09-12,FDRL/NATIONAL ELECTRONIC F,13167.0,0.0,,2018,9,12,PAYEMENT,13167.0,C1318822808
26324,1196428',2018-09-12,FDRL/NATIONAL ELECTRONIC F,20281.0,0.0,,2018,9,12,DEBIT,20281.0,C1424731356
26325,1196428',2018-09-12,FDRL/NATIONAL ELECTRONIC F,8307.0,0.0,,2018,9,12,CASH_OUT,8307.0,C1439007204
26326,1196428',2018-09-12,FDRL/NATIONAL ELECTRONIC F,22149.0,0.0,,2018,9,12,PAYEMENT,22149.0,C1116292004
26327,1196428',2018-09-12,FDRL/NATIONAL ELECTRONIC F,13167.0,0.0,,2018,9,12,DEBIT,13167.0,C638551812
26328,1196428',2018-09-12,FDRL/NATIONAL ELECTRONIC F,17508.0,0.0,,2018,9,12,PAYEMENT,17508.0,C193826743
26329,1196428',2018-09-12,FDRL/NATIONAL ELECTRONIC F,20303.0,0.0,,2018,9,12,CHECK_WITHDRAWAL,20303.0,C309167705
26330,1196428',2018-09-12,FDRL/NATIONAL ELECTRONIC F,25269.0,0.0,,2018,9,12,PAYEMENT,25269.0,C811597470
26331,1196428',2018-09-12,FDRL/NATIONAL ELECTRONIC F,18552.0,0.0,,2018,9,12,DEBIT,18552.0,C1014923261
26332,1196428',2018-09-12,FDRL/NATIONAL ELECTRONIC F,19238.0,0.0,,2018,9,12,DEBIT,19238.0,C925574515
26333,1196428',2018-09-12,FDRL/NATIONAL ELECTRONIC F,25294.0,0.0,,2018,9,12,CHECK_WITHDRAWAL,25294.0,C1988152146
26334,1196428',2018-09-12,FDRL/NATIONAL ELECTRONIC F,11423.0,0.0,,2018,9,12,DEBIT,11423.0,C71555810
26335,1196428',2018-09-12,FDRL/NATIONAL ELECTRONIC F,13344.0,0.0,,2018,9,12,DEBIT,13344.0,C1273939873
26336,1196428',2018-09-12,FDRL/NATIONAL ELECTRONIC F,28860.0,0.0,,2018,9,12,CASH_OUT,28860.0,C749672494
26337,1196428',2018-09-12,FDRL/NATIONAL ELECTRONIC F,14980.0,0.0,,2018,9,12,CHECK_WITHDRAWAL,14980.0,C1504109395
26338,1196428',2018-09-12,NEFT/000049779470/ACCOUNT,0.0,20303.0,,2018,9,12,TRANSFER,20303.0,C2107268831
26339,1196428',2018-09-12,RTGS/HDFCH18255728281/BAT,0.0,295000.0,,2018,9,12,CASH_IN,295000.0,C1141137903
26340,1196428',2018-09-12,RTGS/SBINH18255020210/Indfor,0.0,7200000.0,,2018,9,12,TRANSFER,7200000.0,M492166970
26341,1196428',2018-09-12,FDRL/INTERNAL FUND TRANSFE,1000000.0,0.0,,2018,9,12,CHECK_WITHDRAWAL,1000000.0,C762570948
26342,1196428',2018-09-12,CHQ DEP/21574/OWDEL2/ORBC,0.0,11800.0,,2018,9,12,CHECK_CASHING,11800.0,C1440282299
26343,1196428',2018-09-12,CHQ DEP/43811/OWDEL2/ORBC,0.0,11800.0,,2018,9,12,TRANSFER,11800.0,M1583639547
26344,1196428',2018-09-12,CHQ DEP/792/OWDEL1/HDFC/V,0.0,11800.0,,2018,9,12,CHECK_CASHING,11800.0,M1476691574
26345,1196428',2018-09-12,NEFT/BARBZ18255818102/MAK,0.0,50550.0,,2018,9,12,CHECK_CASHING,50550.0,C893339434
26346,1196428',2018-09-12,RTGS/HDFCH18255777408/Indfor,0.0,4200000.0,,2018,9,12,CASH_IN,4200000.0,M722806861
26347,1196428',2018-09-12,RTGS/UTIBH18255614968/Indfor,0.0,2000000.0,,2018,9,12,CHECK_CASHING,2000000.0,C1150610696
26348,1196428',2018-09-12,FDRL/REAL TIME GROSS SETTL,12690697.74,0.0,,2018,9,12,CASH_OUT,12690697.74,C1674899618
26349,1196428',2018-09-12,RTGS/ICICH18255726641/Indfor,0.0,2900000.0,,2018,9,12,TRANSFER,2900000.0,M481126602
26350,1196428',2018-09-12,TRF FRM  Indiaforensic SERVICES,0.0,8400000.0,,2018,9,12,TRANSFER,8400000.0,C1793325972
26351,1196428',2018-09-12,STAMP PAPER PURCHASING,100.0,0.0,,2018,9,12,DEBIT,100.0,M132360639
26352,1196428',2018-09-12,STAMP PAPER PURCHASING,100.0,0.0,,2018,9,12,CASH_OUT,100.0,M2052092920
26353,1196428',2018-09-12,CASHDEP/GHATKOPAR/,0.0,111000.0,,2018,9,12,CHECK_CASHING,111000.0,M236650472
26354,1196428',2018-09-12,FDRL/REAL TIME GROSS SETTL,10000000.0,0.0,,2018,9,12,CHECK_WITHDRAWAL,10000000.0,M2089634452
26355,1196428',2018-09-12,IMPS 825515313217 FROM AS,0.0,80080.0,,2018,9,12,TRANSFER,80080.0,M1097809105
26356,1196428',2018-09-12,Indiaforensic SERVICES INDIA PVT,0.0,140414.0,,2018,9,12,TRANSFER,140414.0,C302025300
26357,1196428',2018-09-12,NEFT/ICIB182550009765/MAN,0.0,28989.0,,2018,9,12,CASH_IN,28989.0,M134742492
26358,1196428',2018-09-12,TRF FROM  Indiaforensic SERVICES,0.0,7400000.0,,2018,9,12,CASH_IN,7400000.0,C1511785794
26359,1196428',2018-09-12,TRF FROM  Indiaforensic SERVICES,0.0,2700000.0,,2018,9,12,CASH_IN,2700000.0,M1604293868
26360,1196428',2018-09-12,NEFT/KKBK182559086166/Acc,0.0,5000000.0,,2018,9,12,CHECK_CASHING,5000000.0,M1853641629
26361,1196428',2018-09-12,FDRL/NATIONAL ELECTRONIC F,34769.0,0.0,,2018,9,12,CASH_OUT,34769.0,M710600916
26362,1196428',2018-09-12,FDRL/NATIONAL ELECTRONIC F,43623.0,0.0,,2018,9,12,DEBIT,43623.0,M985323561
26363,1196428',2018-09-12,FDRL/NATIONAL ELECTRONIC F,42093.0,0.0,,2018,9,12,PAYEMENT,42093.0,M1194715097
26364,1196428',2018-09-12,FDRL/NATIONAL ELECTRONIC F,31829.0,0.0,,2018,9,12,CASH_OUT,31829.0,M693684695
26365,1196428',2018-09-12,FDRL/NATIONAL ELECTRONIC F,41075.0,0.0,,2018,9,12,PAYEMENT,41075.0,M1582319135
26366,1196428',2018-09-12,FDRL/NATIONAL ELECTRONIC F,112020.0,0.0,,2018,9,12,CASH_OUT,112020.0,M227290600
26367,1196428',2018-09-12,FDRL/NATIONAL ELECTRONIC F,36918.0,0.0,,2018,9,12,DEBIT,36918.0,M2089806029
26368,1196428',2018-09-12,FDRL/NATIONAL ELECTRONIC F,37993.0,0.0,,2018,9,12,PAYEMENT,37993.0,M1477278751
26369,1196428',2018-09-12,FDRL/NATIONAL ELECTRONIC F,31216.0,0.0,,2018,9,12,PAYEMENT,31216.0,M1650385017
26370,1196428',2018-09-12,FDRL/NATIONAL ELECTRONIC F,66280.0,0.0,,2018,9,12,PAYEMENT,66280.0,M1921059756
26371,1196428',2018-09-12,FDRL/NATIONAL ELECTRONIC F,78389.0,0.0,,2018,9,12,CASH_OUT,78389.0,M590434145
26372,1196428',2018-09-12,FDRL/NATIONAL ELECTRONIC F,73217.0,0.0,,2018,9,12,DEBIT,73217.0,M1671621366
26373,1196428',2018-09-12,FDRL/NATIONAL ELECTRONIC F,66609.0,0.0,,2018,9,12,PAYEMENT,66609.0,M899686935
26374,1196428',2018-09-12,FDRL/NATIONAL ELECTRONIC F,62662.0,0.0,,2018,9,12,CASH_OUT,62662.0,M2054039573
26375,1196428',2018-09-12,FDRL/NATIONAL ELECTRONIC F,59149.0,0.0,,2018,9,12,CHECK_WITHDRAWAL,59149.0,M1271480561
26376,1196428',2018-09-12,FDRL/NATIONAL ELECTRONIC F,58440.0,0.0,,2018,9,12,DEBIT,58440.0,C1259769769
26377,1196428',2018-09-12,FDRL/NATIONAL ELECTRONIC F,59712.0,0.0,,2018,9,12,CHECK_WITHDRAWAL,59712.0,M649539827
26378,1196428',2018-09-12,FDRL/NATIONAL ELECTRONIC F,61989.0,0.0,,2018,9,12,PAYEMENT,61989.0,C893350828
26379,1196428',2018-09-12,FDRL/NATIONAL ELECTRONIC F,66423.0,0.0,,2018,9,12,CASH_OUT,66423.0,M20364107
26380,1196428',2018-09-12,FDRL/NATIONAL ELECTRONIC F,64006.0,0.0,,2018,9,12,CASH_OUT,64006.0,M2023197227
26381,1196428',2018-09-12,FDRL/NATIONAL ELECTRONIC F,74327.0,0.0,,2018,9,12,CASH_OUT,74327.0,C232812328
26382,1196428',2018-09-12,FDRL/NATIONAL ELECTRONIC F,67735.0,0.0,,2018,9,12,CHECK_WITHDRAWAL,67735.0,M902890505
26383,1196428',2018-09-12,FDRL/NATIONAL ELECTRONIC F,97210.0,0.0,,2018,9,12,PAYEMENT,97210.0,M1465861273
26384,1196428',2018-09-12,FDRL/NATIONAL ELECTRONIC F,59088.0,0.0,,2018,9,12,PAYEMENT,59088.0,M949506330
26385,1196428',2018-09-12,FDRL/NATIONAL ELECTRONIC F,63955.0,0.0,,2018,9,12,PAYEMENT,63955.0,M2084969506
26386,1196428',2018-09-12,FDRL/NATIONAL ELECTRONIC F,32410.0,0.0,,2018,9,12,PAYEMENT,32410.0,M608038618
26387,1196428',2018-09-12,FDRL/NATIONAL ELECTRONIC F,32677.0,0.0,,2018,9,12,PAYEMENT,32677.0,M1041764081
26388,1196428',2018-09-12,FDRL/NATIONAL ELECTRONIC F,32212.0,0.0,,2018,9,12,CHECK_WITHDRAWAL,32212.0,M277788688
26389,1196428',2018-09-12,FDRL/NATIONAL ELECTRONIC F,41405.0,0.0,,2018,9,12,PAYEMENT,41405.0,M31440957
26390,1196428',2018-09-12,FDRL/NATIONAL ELECTRONIC F,36339.0,0.0,,2018,9,12,DEBIT,36339.0,C1805162633
26391,1196428',2018-09-12,FDRL/NATIONAL ELECTRONIC F,31282.0,0.0,,2018,9,12,DEBIT,31282.0,M1201023997
26392,1196428',2018-09-12,FDRL/NATIONAL ELECTRONIC F,35005.0,0.0,,2018,9,12,CHECK_WITHDRAWAL,35005.0,M1412743565
26393,1196428',2018-09-12,FDRL/INTERNAL FUND TRANSFE,400000.0,0.0,,2018,9,12,CHECK_WITHDRAWAL,400000.0,M1887477561
26394,1196428',2018-09-12,FDRL/INTERNAL FUND TRANSFE,400000.0,0.0,,2018,9,12,PAYEMENT,400000.0,C435161028
26395,1196428',2018-09-12,FDRL/NATIONAL ELECTRONIC F,3000000.0,0.0,,2018,9,12,CASH_OUT,3000000.0,M2126024846
26396,1196428',2018-09-12,FDRL/NATIONAL ELECTRONIC F,3000000.0,0.0,,2018,9,12,CASH_OUT,3000000.0,M885738476
26397,1196428',2018-09-12,NEFT/000052080613/Indiaforensic,0.0,500000.0,,2018,9,12,TRANSFER,500000.0,C1273939873
26398,1196428',2018-09-12,FDRL/NATIONAL ELECTRONIC F,15286.0,0.0,,2018,9,12,PAYEMENT,15286.0,C464094472
26399,1196428',2018-09-12,FDRL/NATIONAL ELECTRONIC F,13028.0,0.0,,2018,9,12,CASH_OUT,13028.0,C1475998599
26400,1196428',2018-09-12,FDRL/NATIONAL ELECTRONIC F,10452.0,0.0,,2018,9,12,CASH_OUT,10452.0,C1789550256
26401,1196428',2018-09-12,FDRL/NATIONAL ELECTRONIC F,13593.0,0.0,,2018,9,12,DEBIT,13593.0,C1805445027
26402,1196428',2018-09-12,FDRL/NATIONAL ELECTRONIC F,10452.0,0.0,,2018,9,12,PAYEMENT,10452.0,C968448640
26403,1196428',2018-09-12,FDRL/NATIONAL ELECTRONIC F,23520.0,0.0,,2018,9,12,CASH_OUT,23520.0,C691636444
26404,1196428',2018-09-12,FDRL/NATIONAL ELECTRONIC F,18822.0,0.0,,2018,9,12,CASH_OUT,18822.0,C1778801068
26405,1196428',2018-09-12,FDRL/NATIONAL ELECTRONIC F,10624.0,0.0,,2018,9,12,PAYEMENT,10624.0,C2029896123
26406,1196428',2018-09-12,FDRL/NATIONAL ELECTRONIC F,19146.0,0.0,,2018,9,12,CASH_OUT,19146.0,C1677727024
26407,1196428',2018-09-12,FDRL/NATIONAL ELECTRONIC F,22844.0,0.0,,2018,9,12,CHECK_WITHDRAWAL,22844.0,C1525944481
26408,1196428',2018-09-12,FDRL/NATIONAL ELECTRONIC F,28288.0,0.0,,2018,9,12,CASH_OUT,28288.0,C481402298
26409,1196428',2018-09-12,FDRL/NATIONAL ELECTRONIC F,13084.0,0.0,,2018,9,12,DEBIT,13084.0,C177457290
26410,1196428',2018-09-12,FDRL/NATIONAL ELECTRONIC F,12535.0,0.0,,2018,9,12,CHECK_WITHDRAWAL,12535.0,M1138171728
26411,1196428',2018-09-12,FDRL/NATIONAL ELECTRONIC F,12101.0,0.0,,2018,9,12,DEBIT,12101.0,C1452722471
26412,1196428',2018-09-12,FDRL/NATIONAL ELECTRONIC F,21580.0,0.0,,2018,9,12,DEBIT,21580.0,C861958315
26413,1196428',2018-09-12,FDRL/NATIONAL ELECTRONIC F,18489.0,0.0,,2018,9,12,CASH_OUT,18489.0,M919438675
26414,1196428',2018-09-12,FDRL/NATIONAL ELECTRONIC F,22600.0,0.0,,2018,9,12,DEBIT,22600.0,M1501022601
26415,1196428',2018-09-12,FDRL/NATIONAL ELECTRONIC F,27685.0,0.0,,2018,9,12,PAYEMENT,27685.0,M397708705
26416,1196428',2018-09-12,FDRL/NATIONAL ELECTRONIC F,25791.0,0.0,,2018,9,12,CHECK_WITHDRAWAL,25791.0,M1092898377
26417,1196428',2018-09-12,FDRL/NATIONAL ELECTRONIC F,10414.0,0.0,,2018,9,12,DEBIT,10414.0,M1957947378
26418,1196428',2018-09-12,FDRL/NATIONAL ELECTRONIC F,10123.0,0.0,,2018,9,12,PAYEMENT,10123.0,C785703145
26419,1196428',2018-09-12,FDRL/NATIONAL ELECTRONIC F,25304.0,0.0,,2018,9,12,CHECK_WITHDRAWAL,25304.0,M2094125621
26420,1196428',2018-09-12,FDRL/NATIONAL ELECTRONIC F,800.0,0.0,,2018,9,12,CASH_OUT,800.0,M1918034019
26421,1196428',2018-09-12,FDRL/NATIONAL ELECTRONIC F,18454.0,0.0,,2018,9,12,CHECK_WITHDRAWAL,18454.0,M745483242
26422,1196428',2018-09-12,FDRL/NATIONAL ELECTRONIC F,16944.0,0.0,,2018,9,12,DEBIT,16944.0,M1878714361
26423,1196428',2018-09-12,FDRL/NATIONAL ELECTRONIC F,11368.0,0.0,,2018,9,12,DEBIT,11368.0,M203939387
26424,1196428',2018-09-12,FDRL/NATIONAL ELECTRONIC F,12596.0,0.0,,2018,9,12,DEBIT,12596.0,C382934088
26425,1196428',2018-09-12,FDRL/NATIONAL ELECTRONIC F,15871.0,0.0,,2018,9,12,PAYEMENT,15871.0,C158876320
26426,1196428',2018-09-12,FDRL/NATIONAL ELECTRONIC F,27120.0,0.0,,2018,9,12,CHECK_WITHDRAWAL,27120.0,C732929236
26427,1196428',2018-09-12,FDRL/NATIONAL ELECTRONIC F,12393.0,0.0,,2018,9,12,CHECK_WITHDRAWAL,12393.0,C1554622120
26428,1196428',2018-09-12,FDRL/NATIONAL ELECTRONIC F,3644.0,0.0,,2018,9,12,PAYEMENT,3644.0,C1359484306
26429,1196428',2018-09-12,FDRL/NATIONAL ELECTRONIC F,15641.0,0.0,,2018,9,12,PAYEMENT,15641.0,C1782704802
26430,1196428',2018-09-12,FDRL/NATIONAL ELECTRONIC F,26047.0,0.0,,2018,9,12,DEBIT,26047.0,C1609562230
26431,1196428',2018-09-12,FDRL/NATIONAL ELECTRONIC F,24240.0,0.0,,2018,9,12,CASH_OUT,24240.0,C1220897602
26432,1196428',2018-09-12,FDRL/NATIONAL ELECTRONIC F,22340.0,0.0,,2018,9,12,DEBIT,22340.0,C1213257323
26433,1196428',2018-09-12,FDRL/NATIONAL ELECTRONIC F,14363.0,0.0,,2018,9,12,CASH_OUT,14363.0,C674913323
26434,1196428',2018-09-12,FDRL/NATIONAL ELECTRONIC F,7777.0,0.0,,2018,9,12,DEBIT,7777.0,C803116137
26435,1196428',2018-09-12,FDRL/NATIONAL ELECTRONIC F,20103.0,0.0,,2018,9,12,CHECK_WITHDRAWAL,20103.0,C1450417897
26436,1196428',2018-09-12,FDRL/NATIONAL ELECTRONIC F,20303.0,0.0,,2018,9,12,CASH_OUT,20303.0,C826383690
26437,1196428',2018-09-12,FDRL/NATIONAL ELECTRONIC F,13764.0,0.0,,2018,9,12,CASH_OUT,13764.0,M1718920203
26438,1196428',2018-09-12,FDRL/NATIONAL ELECTRONIC F,5985.0,0.0,,2018,9,12,DEBIT,5985.0,M1002711260
26439,1196428',2018-09-12,FDRL/NATIONAL ELECTRONIC F,20573.0,0.0,,2018,9,12,PAYEMENT,20573.0,C545710008
26440,1196428',2018-09-12,FDRL/NATIONAL ELECTRONIC F,14962.0,0.0,,2018,9,12,DEBIT,14962.0,C1838584624
26441,1196428',2018-09-12,FDRL/NATIONAL ELECTRONIC F,28264.0,0.0,,2018,9,12,PAYEMENT,28264.0,C1030706332
26442,1196428',2018-09-12,FDRL/NATIONAL ELECTRONIC F,23701.0,0.0,,2018,9,12,CASH_OUT,23701.0,M2129060443
26443,1196428',2018-09-12,FDRL/NATIONAL ELECTRONIC F,11982.0,0.0,,2018,9,12,DEBIT,11982.0,C1195471589
26444,1196428',2018-09-12,FDRL/NATIONAL ELECTRONIC F,10727.0,0.0,,2018,9,12,DEBIT,10727.0,M1398128260
26445,1196428',2018-09-12,FDRL/NATIONAL ELECTRONIC F,19360.0,0.0,,2018,9,12,PAYEMENT,19360.0,C1856036778
26446,1196428',2018-09-12,FDRL/NATIONAL ELECTRONIC F,17535.0,0.0,,2018,9,12,PAYEMENT,17535.0,C2067546399
26447,1196428',2018-09-12,FDRL/NATIONAL ELECTRONIC F,15333.0,0.0,,2018,9,12,DEBIT,15333.0,C818570949
26448,1196428',2018-09-12,FDRL/NATIONAL ELECTRONIC F,17509.0,0.0,,2018,9,12,DEBIT,17509.0,M535878604
26449,1196428',2018-09-12,FDRL/NATIONAL ELECTRONIC F,16267.0,0.0,,2018,9,12,DEBIT,16267.0,C358945794
26450,1196428',2018-09-12,FDRL/NATIONAL ELECTRONIC F,17699.0,0.0,,2018,9,12,DEBIT,17699.0,C922511709
26451,1196428',2018-09-12,FDRL/NATIONAL ELECTRONIC F,13697.0,0.0,,2018,9,12,CASH_OUT,13697.0,C988138425
26452,1196428',2018-09-12,FDRL/NATIONAL ELECTRONIC F,13493.0,0.0,,2018,9,12,CASH_OUT,13493.0,C814900611
26453,1196428',2018-09-12,FDRL/NATIONAL ELECTRONIC F,27537.0,0.0,,2018,9,12,CHECK_WITHDRAWAL,27537.0,C1467740330
26454,1196428',2018-09-12,FDRL/NATIONAL ELECTRONIC F,23796.0,0.0,,2018,9,12,CASH_OUT,23796.0,M858308953
26455,1196428',2018-09-12,FDRL/NATIONAL ELECTRONIC F,16992.0,0.0,,2018,9,12,DEBIT,16992.0,M1773085261
26456,1196428',2018-09-12,FDRL/NATIONAL ELECTRONIC F,18545.0,0.0,,2018,9,12,DEBIT,18545.0,M472606308
26457,1196428',2018-09-12,FDRL/NATIONAL ELECTRONIC F,15171.0,0.0,,2018,9,12,DEBIT,15171.0,M51583809
26458,1196428',2018-09-12,FDRL/NATIONAL ELECTRONIC F,15543.0,0.0,,2018,9,12,CASH_OUT,15543.0,M1337700382
26459,1196428',2018-09-12,FDRL/NATIONAL ELECTRONIC F,14121.0,0.0,,2018,9,12,PAYEMENT,14121.0,C1918034924
26460,1196428',2018-09-12,FDRL/INTERNAL FUND TRANSFE,3000000.0,0.0,,2018,9,12,DEBIT,3000000.0,M527477577
26461,1196428',2018-09-12,FDRL/INTERNAL FUND TRANSFE,500000.0,0.0,,2018,9,12,PAYEMENT,500000.0,M577217292
26462,1196428',2018-09-12,FDRL/INTERNAL FUND TRANSFE,500000.0,0.0,,2018,9,12,PAYEMENT,500000.0,C184253187
26463,1196428',2018-09-12,FDRL/INTERNAL FUND TRANSFE,3000000.0,0.0,,2018,9,12,PAYEMENT,3000000.0,C1778300121
26464,1196428',2018-09-12,FDRL/INTERNAL FUND TRANSFE,400000.0,0.0,,2018,9,12,CHECK_WITHDRAWAL,400000.0,C667504652
26465,1196428',2018-09-12,FDRL/INTERNAL FUND TRANSFE,400000.0,0.0,,2018,9,12,CASH_OUT,400000.0,C638590716
26466,1196428',2018-09-12,NEFT/N255180631780025/Indfor,0.0,980000.0,,2018,9,12,CASH_IN,980000.0,C1532153384
26467,1196428',2018-09-12,BEAT CSH PKP DEL GURG 727,0.0,161000.0,,2018,9,12,TRANSFER,161000.0,C208427878
26468,1196428',2018-09-13,FDRL/INTERNAL FUND TRANSFE,400000.0,0.0,,2018,9,13,CHECK_WITHDRAWAL,400000.0,C1530086509
26469,1196428',2018-09-13,FDRL/INTERNAL FUND TRANSFE,400000.0,0.0,,2018,9,13,CHECK_WITHDRAWAL,400000.0,C703957828
26470,1196428',2018-09-13,FDRL/INTERNAL FUND TRANSFE,400000.0,0.0,,2018,9,13,PAYEMENT,400000.0,C891020651
26471,1196428',2018-09-13,CHQ DEP/831850/OWDEL1/PUN,0.0,11800.0,,2018,9,13,CHECK_CASHING,11800.0,M1680032445
26472,1196428',2018-09-13,CHQ DEP/5104/OWDEL1/ORBC/,0.0,11800.0,,2018,9,13,CHECK_CASHING,11800.0,C553264065
26473,1196428',2018-09-13,CHQ DEP/710623/OWDEL1/SBI,0.0,11800.0,,2018,9,13,TRANSFER,11800.0,M1097298586
26474,1196428',2018-09-13,CHQ DEP/116839/OWDEL1/COR,0.0,11800.0,,2018,9,13,CASH_IN,11800.0,M870026554
26475,1196428',2018-09-13,CHQ DEP/188/OWDEL1/PSIB/I,0.0,11800.0,,2018,9,13,TRANSFER,11800.0,C695653925
26476,1196428',2018-09-13,CHQ DEP/29560/OWDEL1/SBIN,0.0,11800.0,,2018,9,13,TRANSFER,11800.0,M1248361658
26477,1196428',2018-09-13,TRF FRM  Indiaforensic SERVICES,0.0,13400000.0,,2018,9,13,CASH_IN,13400000.0,C1689262323
26478,1196428',2018-09-13,TRF TO  Indiaforensic SERVICES I,169047.0,0.0,,2018,9,13,DEBIT,169047.0,C1757877803
26479,1196428',2018-09-13,FDRL/REAL TIME GROSS SETTL,11864498.83,0.0,,2018,9,13,CHECK_WITHDRAWAL,11864498.83,C1849933855
26480,1196428',2018-09-13,FDRL/NATIONAL ELECTRONIC F,11076.0,0.0,,2018,9,13,CHECK_WITHDRAWAL,11076.0,C1753128715
26481,1196428',2018-09-13,FDRL/NATIONAL ELECTRONIC F,18552.0,0.0,,2018,9,13,CHECK_WITHDRAWAL,18552.0,C1527761090
26482,1196428',2018-09-13,FDRL/NATIONAL ELECTRONIC F,7752.0,0.0,,2018,9,13,CASH_OUT,7752.0,C1754722089
26483,1196428',2018-09-13,FDRL/NATIONAL ELECTRONIC F,13787.0,0.0,,2018,9,13,PAYEMENT,13787.0,C1261039678
26484,1196428',2018-09-13,FDRL/NATIONAL ELECTRONIC F,56775.0,0.0,,2018,9,13,CASH_OUT,56775.0,C836514715
26485,1196428',2018-09-13,FDRL/NATIONAL ELECTRONIC F,11196.0,0.0,,2018,9,13,DEBIT,11196.0,C1640961071
26486,1196428',2018-09-13,FDRL/NATIONAL ELECTRONIC F,7751.0,0.0,,2018,9,13,CASH_OUT,7751.0,C1838584624
26487,1196428',2018-09-13,FDRL/INTERNAL FUND TRANSFE,400000.0,0.0,,2018,9,13,DEBIT,400000.0,C1209271652
26488,1196428',2018-09-13,RTGS/HDFCH18256963281/BAT,0.0,225000.0,,2018,9,13,TRANSFER,225000.0,C745740822
26489,1196428',2018-09-13,CHQ DEPOSIT RETURN/116839,11800.0,0.0,,2018,9,13,DEBIT,11800.0,C1401721023
26490,1196428',2018-09-13,CHQ DEPOSIT RETURN/188/FU,11800.0,0.0,,2018,9,13,CHECK_WITHDRAWAL,11800.0,C47827984
26491,1196428',2018-09-13,FDRL/INTERNAL FUND TRANSFE,400000.0,0.0,,2018,9,13,PAYEMENT,400000.0,C1849941462
26492,1196428',2018-09-13,FDRL/INTERNAL FUND TRANSFE,400000.0,0.0,,2018,9,13,DEBIT,400000.0,C70895366
26493,1196428',2018-09-13,NEFT/BARBP18256361095/MAK,0.0,100500.0,,2018,9,13,TRANSFER,100500.0,C977993101
26494,1196428',2018-09-13,FDRL/INTERNAL FUND TRANSFE,400000.0,0.0,,2018,9,13,CHECK_WITHDRAWAL,400000.0,C2116873183
26495,1196428',2018-09-13,NEFT/000052122197/Indiaforensic,0.0,790000.0,,2018,9,13,CHECK_CASHING,790000.0,C892686452
26496,1196428',2018-09-13,FDRL/INTERNAL FUND TRANSFE,100000.0,0.0,,2018,9,13,CHECK_WITHDRAWAL,100000.0,C1540270363
26497,1196428',2018-09-13,NEFT/000052122053/Indiaforensic,0.0,2100000.0,,2018,9,13,CHECK_CASHING,2100000.0,C534662976
26498,1196428',2018-09-13,TRF FROM  Indiaforensic SERVICES,0.0,4300000.0,,2018,9,13,CHECK_CASHING,4300000.0,C30013970
26499,1196428',2018-09-13,BEAT CSH PKP DEL GURG 727,0.0,201500.0,,2018,9,13,TRANSFER,201500.0,C1809373351
26500,1196428',2018-09-13,FDRL/INTERNAL FUND TRANSFE,7000000.0,0.0,,2018,9,13,CASH_OUT,7000000.0,C741431520
26501,1196428',2018-09-13,CHQ DEPOSIT RETURN/116839,100.0,0.0,,2018,9,13,PAYEMENT,100.0,C669771073
26502,1196428',2018-09-13,CHQ DEPOSIT RETURN/116839,18.0,0.0,,2018,9,13,CASH_OUT,18.0,C1915091057
26503,1196428',2018-09-13,CHQ DEPOSIT RETURN/188/CH,100.0,0.0,,2018,9,13,CHECK_WITHDRAWAL,100.0,C323287038
26504,1196428',2018-09-13,CHQ DEPOSIT RETURN/188/GS,18.0,0.0,,2018,9,13,PAYEMENT,18.0,C1027992087
26505,1196428',2018-09-14,NEFT/PUNBH18257454368/BAL,0.0,100000.0,,2018,9,14,CHECK_CASHING,100000.0,C1435804085
26506,1196428',2018-09-14,CASHDEP/BOISAR/,0.0,6000.0,,2018,9,14,TRANSFER,6000.0,C1153596299
26507,1196428',2018-09-14,NEFT/N257180632409391/TEC,0.0,100000.0,,2018,9,14,TRANSFER,100000.0,C1541743053
26508,1196428',2018-09-14,FDRL/INTERNAL FUND TRANSFE,400000.0,0.0,,2018,9,14,CASH_OUT,400000.0,C1213257323
26509,1196428',2018-09-14,RTGS/SBINH18257025349/Indfor,0.0,6000000.0,,2018,9,14,CHECK_CASHING,6000000.0,C295081230
26510,1196428',2018-09-14,NEFT/SAA145672206/LIBRA F,0.0,11800.0,,2018,9,14,CHECK_CASHING,11800.0,C531511436
26511,1196428',2018-09-14,FDRL/INTERNAL FUND TRANSFE,400000.0,0.0,,2018,9,14,DEBIT,400000.0,C175291188
26512,1196428',2018-09-14,IRTT00701826415,1303.14,0.0,,2018,9,14,CHECK_WITHDRAWAL,1303.14,C1259769769
26513,1196428',2018-09-14,"Indiaforensic USA, INC/USD/15460",0.0,1100752.0,,2018,9,14,CHECK_CASHING,1100752.0,C205300866
26514,1196428',2018-09-14,RTGS/HDFCH18257899201/Indfor,0.0,5700000.0,,2018,9,14,TRANSFER,5700000.0,C1297873690
26515,1196428',2018-09-14,FDRL/REAL TIME GROSS SETTL,11212121.55,0.0,,2018,9,14,PAYEMENT,11212121.55,C715819458
26516,1196428',2018-09-14,TRF FROM  Indiaforensic SERVICES,0.0,11700000.0,,2018,9,14,CASH_IN,11700000.0,C18928637
26517,1196428',2018-09-14,FDRL/REAL TIME GROSS SETTL,10000000.0,0.0,,2018,9,14,DEBIT,10000000.0,C1079343872
26518,1196428',2018-09-14,FDRL/REAL TIME GROSS SETTL,3000000.0,0.0,,2018,9,14,CHECK_WITHDRAWAL,3000000.0,C99275333
26519,1196428',2018-09-14,CASHDEP/GHATKOPAR/,0.0,86000.0,,2018,9,14,CASH_IN,86000.0,C1450828900
26520,1196428',2018-09-14,IMPS 825716841006 FROM SA,0.0,200000.0,,2018,9,14,CASH_IN,200000.0,C1339257929
26521,1196428',2018-09-14,TRF FRM  Indiaforensic SERVICES,0.0,10000000.0,,2018,9,14,CHECK_CASHING,10000000.0,C893041125
26522,1196428',2018-09-14,IMPS 825716850028 FROM SA,0.0,110000.0,,2018,9,14,CHECK_CASHING,110000.0,C380242442
26523,1196428',2018-09-14,FDRL/NATIONAL ELECTRONIC F,3000000.0,0.0,,2018,9,14,DEBIT,3000000.0,C1220897602
26524,1196428',2018-09-14,FDRL/NATIONAL ELECTRONIC F,3000000.0,0.0,,2018,9,14,PAYEMENT,3000000.0,C495071437
26525,1196428',2018-09-14,FDRL/NATIONAL ELECTRONIC F,1000000.0,0.0,,2018,9,14,CHECK_WITHDRAWAL,1000000.0,C1753128715
26526,1196428',2018-09-14,FDRL/NATIONAL ELECTRONIC F,3000000.0,0.0,,2018,9,14,DEBIT,3000000.0,C1387460501
26527,1196428',2018-09-14,Indiaforensic SERVICES INDIA PVT,0.0,275412.0,,2018,9,14,CASH_IN,275412.0,C425987411
26528,1196428',2018-09-14,NEFT/000052191015/Indiaforensic,0.0,1000000.0,,2018,9,14,CASH_IN,1000000.0,C914293025
26529,1196428',2018-09-14,IMPS 825717144445 FROM SA,0.0,100000.0,,2018,9,14,CASH_IN,100000.0,C1765998352
26530,1196428',2018-09-14,FDRL/NATIONAL ELECTRONIC F,40764.0,0.0,,2018,9,14,CASH_OUT,40764.0,C1651144763
26531,1196428',2018-09-14,FDRL/NATIONAL ELECTRONIC F,46750.0,0.0,,2018,9,14,CHECK_WITHDRAWAL,46750.0,C922871524
26532,1196428',2018-09-14,FDRL/NATIONAL ELECTRONIC F,44471.0,0.0,,2018,9,14,DEBIT,44471.0,C807247901
26533,1196428',2018-09-14,FDRL/NATIONAL ELECTRONIC F,33854.0,0.0,,2018,9,14,DEBIT,33854.0,M385500805
26534,1196428',2018-09-14,NEFT/000052188850/Indiaforensic,0.0,1700000.0,,2018,9,14,CHECK_CASHING,1700000.0,M1255551187
26535,1196428',2018-09-14,TRF FRM  Indiaforensic SERVICES,0.0,700000.0,,2018,9,14,CASH_IN,700000.0,M568741308
26536,1196428',2018-09-14,TRF TO  Indiaforensic SERVICES I,162000.0,0.0,,2018,9,14,DEBIT,162000.0,M1102568869
26537,1196428',2018-09-14,TRF FRM  Indiaforensic SERVICES,0.0,400000.0,,2018,9,14,CHECK_CASHING,400000.0,C22448303
26538,1196428',2018-09-14,NEFT/AXISP00011785103/ACC,0.0,4000000.0,,2018,9,14,TRANSFER,4000000.0,M194896381
26539,1196428',2018-09-14,TRF FRM  Indiaforensic SERVICES,0.0,8800000.0,,2018,9,14,TRANSFER,8800000.0,M61341270
26540,1196428',2018-09-14,TRF TO  Indiaforensic SERVICES I,3000000.0,0.0,,2018,9,14,DEBIT,3000000.0,M1123500948
26541,1196428',2018-09-14,FDRL/INTERNAL FUND TRANSFE,5000000.0,0.0,,2018,9,14,DEBIT,5000000.0,C1761291320
26542,1196428',2018-09-14,FDRL/INTERNAL FUND TRANSFE,3000000.0,0.0,,2018,9,14,CHECK_WITHDRAWAL,3000000.0,M1621235266
26543,1196428',2018-09-14,FDRL/INTERNAL FUND TRANSFE,1000000.0,0.0,,2018,9,14,CASH_OUT,1000000.0,M1441687926
26544,1196428',2018-09-14,FDRL/INTERNAL FUND TRANSFE,2000000.0,0.0,,2018,9,14,PAYEMENT,2000000.0,C1274219061
26545,1196428',2018-09-14,BEAT CSH PKP DEL UDYOG 72,0.0,158000.0,,2018,9,14,TRANSFER,158000.0,M215001396
26546,1196428',2018-09-15,FDRL/INTERNAL FUND TRANSFE,2000000.0,0.0,,2018,9,15,PAYEMENT,2000000.0,M1122089151
26547,1196428',2018-09-15,NEFT/P18091546113493/S B,0.0,199500.0,,2018,9,15,CASH_IN,199500.0,M1401767702
26548,1196428',2018-09-15,NEFT/SBIN318258294049/MR,0.0,100000.0,,2018,9,15,CASH_IN,100000.0,M681646780
26549,1196428',2018-09-15,RTGS/SBINH18258023367/Indfor,0.0,6600000.0,,2018,9,15,TRANSFER,6600000.0,M627518624
26550,1196428',2018-09-15,TRF FRM  Indiaforensic SERVICES,0.0,10000000.0,,2018,9,15,CHECK_CASHING,10000000.0,M827873651
26551,1196428',2018-09-15,TRF FRM  Indiaforensic SERVICES,0.0,2000000.0,,2018,9,15,CHECK_CASHING,2000000.0,C893038039
26552,1196428',2018-09-15,NEFT/AXISP00011835213/ACC,0.0,6000000.0,,2018,9,15,TRANSFER,6000000.0,M500644839
26553,1196428',2018-09-15,NEFT/AXISP00011835263/ACC,0.0,17000000.0,,2018,9,15,CHECK_CASHING,17000000.0,M1320279615
26554,1196428',2018-09-15,FDRL/REAL TIME GROSS SETTL,15000000.0,0.0,,2018,9,15,CHECK_WITHDRAWAL,15000000.0,C131837504
26555,1196428',2018-09-15,FDRL/REAL TIME GROSS SETTL,10000000.0,0.0,,2018,9,15,CHECK_WITHDRAWAL,10000000.0,M1918879588
26556,1196428',2018-09-15,FDRL/REAL TIME GROSS SETTL,6713415.91,0.0,,2018,9,15,CASH_OUT,6713415.91,M83411567
26557,1196428',2018-09-15,FDRL/INTERNAL FUND TRANSFE,2000000.0,0.0,,2018,9,15,PAYEMENT,2000000.0,M2055417819
26558,1196428',2018-09-15,FDRL/REAL TIME GROSS SETTL,2000000.0,0.0,,2018,9,15,CASH_OUT,2000000.0,M2000932570
26559,1196428',2018-09-15,FDRL/REAL TIME GROSS SETTL,5000000.0,0.0,,2018,9,15,CASH_OUT,5000000.0,M1065956371
26560,1196428',2018-09-15,TRF FROM  Indiaforensic SERVICES,0.0,2000000.0,,2018,9,15,TRANSFER,2000000.0,M932396484
26561,1196428',2018-09-15,TRF FROM  Indiaforensic SERVICES,0.0,5000000.0,,2018,9,15,CHECK_CASHING,5000000.0,C1911645398
26562,1196428',2018-09-15,FDRL/NATIONAL ELECTRONIC F,2000000.0,0.0,,2018,9,15,PAYEMENT,2000000.0,M34878398
26563,1196428',2018-09-15,FDRL/NATIONAL ELECTRONIC F,2000000.0,0.0,,2018,9,15,CASH_OUT,2000000.0,C947982595
26564,1196428',2018-09-15,NEFT/000052252539/Indiaforensic,0.0,500000.0,,2018,9,15,TRANSFER,500000.0,M653118063
26565,1196428',2018-09-15,NEFT/000052252446/Indiaforensic,0.0,1000000.0,,2018,9,15,CASH_IN,1000000.0,M319762729
26566,1196428',2018-09-15,TRF FROM  Indiaforensic SERVICES,0.0,1000000.0,,2018,9,15,CHECK_CASHING,1000000.0,C414409410
26567,1196428',2018-09-15,NEFT/000052252930/Indiaforensic,0.0,2000000.0,,2018,9,15,CHECK_CASHING,2000000.0,M906784387
26568,1196428',2018-09-15,FDRL/INTERNAL FUND TRANSFE,6000000.0,0.0,,2018,9,15,PAYEMENT,6000000.0,C1334669858
26569,1196428',2018-09-15,IMPS 825818760579 FROM OX,0.0,200000.0,,2018,9,15,TRANSFER,200000.0,C643956982
26570,1196428',2018-09-15,FDRL/INTERNAL FUND TRANSFE,2000000.0,0.0,,2018,9,15,PAYEMENT,2000000.0,C1339858954
26571,1196428',2018-09-15,FDRL/INTERNAL FUND TRANSFE,2000000.0,0.0,,2018,9,15,PAYEMENT,2000000.0,M694345146
26572,1196428',2018-09-15,BEAT CSH PKP DEL GURGA 72,0.0,75300.0,,2018,9,15,TRANSFER,75300.0,M1987612084
26573,1196428',2018-09-17,RTGS/UTIBH18260644604/Indfor,0.0,1000000.0,,2018,9,17,CHECK_CASHING,1000000.0,M749441464
26574,1196428',2018-09-17,RTGS/PUNBH18260493308/BAL,0.0,200000.0,,2018,9,17,CASH_IN,200000.0,C1810800169
26575,1196428',2018-09-17,FDRL/INTERNAL FUND TRANSFE,500000.0,0.0,,2018,9,17,CASH_OUT,500000.0,C500153041
26576,1196428',2018-09-17,FDRL/INTERNAL FUND TRANSFE,500000.0,0.0,,2018,9,17,PAYEMENT,500000.0,M1338272358
26577,1196428',2018-09-17,NEFT/N260180633955286/TEC,0.0,200000.0,,2018,9,17,CHECK_CASHING,200000.0,C2085805920
26578,1196428',2018-09-17,RTGS/HDFCH18260352480/BAT,0.0,400000.0,,2018,9,17,TRANSFER,400000.0,M1803875006
26579,1196428',2018-09-17,RTGS/HDFCH18260343186/BAJ,0.0,200000.0,,2018,9,17,CASH_IN,200000.0,C1525711410
26580,1196428',2018-09-17,CHQ DEP/242230/OWDEL2/ICI,0.0,11800.0,,2018,9,17,TRANSFER,11800.0,M1920337651
26581,1196428',2018-09-17,NEFT/AXISP00011935115/ACC,0.0,5000000.0,,2018,9,17,CASH_IN,5000000.0,M1077761684
26582,1196428',2018-09-17,TRF FRM  Indiaforensic SERVICES,0.0,2000000.0,,2018,9,17,CHECK_CASHING,2000000.0,M1579591396
26583,1196428',2018-09-17,TRF FRM  Indiaforensic SERVICES,0.0,15000000.0,,2018,9,17,CASH_IN,15000000.0,C1872618824
26584,1196428',2018-09-17,FDRL/REAL TIME GROSS SETTL,10000000.0,0.0,,2018,9,17,CHECK_WITHDRAWAL,10000000.0,M626147483
26585,1196428',2018-09-17,FDRL/REAL TIME GROSS SETTL,4020064.27,0.0,,2018,9,17,PAYEMENT,4020064.27,C1383942363
26586,1196428',2018-09-17,RTGS/SBINH18260031427/Indfor,0.0,8100000.0,,2018,9,17,CHECK_CASHING,8100000.0,M2138664880
26587,1196428',2018-09-17,FDRL/INTERNAL FUND TRANSFE,500000.0,0.0,,2018,9,17,DEBIT,500000.0,M1084411479
26588,1196428',2018-09-17,FDRL/REAL TIME GROSS SETTL,10000000.0,0.0,,2018,9,17,CHECK_WITHDRAWAL,10000000.0,C1382034610
26589,1196428',2018-09-17,FDRL/REAL TIME GROSS SETTL,431617.44,0.0,,2018,9,17,PAYEMENT,431617.44,C540811471
26590,1196428',2018-09-17,RTGS/HDFCH18260350296/Indfor,0.0,4200000.0,,2018,9,17,TRANSFER,4200000.0,M1168278961
26591,1196428',2018-09-17,FDRL/REAL TIME GROSS SETTL,3000000.0,0.0,,2018,9,17,DEBIT,3000000.0,C1848415041
26592,1196428',2018-09-17,FDRL/REAL TIME GROSS SETTL,3000000.0,0.0,,2018,9,17,CHECK_WITHDRAWAL,3000000.0,M1153991113
26593,1196428',2018-09-17,FDRL/REAL TIME GROSS SETTL,2000000.0,0.0,,2018,9,17,CASH_OUT,2000000.0,C2082673402
26594,1196428',2018-09-17,FDRL/REAL TIME GROSS SETTL,2000000.0,0.0,,2018,9,17,PAYEMENT,2000000.0,C969412636
26595,1196428',2018-09-17,RTGS/ICICH18260429723/Indfor,0.0,1000000.0,,2018,9,17,TRANSFER,1000000.0,M326386056
26596,1196428',2018-09-17,RTGS/ICICH18260432270/Indfor,0.0,500000.0,,2018,9,17,CHECK_CASHING,500000.0,C1710901767
26597,1196428',2018-09-17,FDRL/INTERNAL FUND TRANSFE,500000.0,0.0,,2018,9,17,CASH_OUT,500000.0,C1240091493
26598,1196428',2018-09-17,FDRL/INTERNAL FUND TRANSFE,500000.0,0.0,,2018,9,17,CASH_OUT,500000.0,M2008274494
26599,1196428',2018-09-17,RTGS/ICICH18260469774/Indfor,0.0,1900000.0,,2018,9,17,TRANSFER,1900000.0,C631424220
26600,1196428',2018-09-17,FDRL/REAL TIME GROSS SETTL,2000000.0,0.0,,2018,9,17,CASH_OUT,2000000.0,C590842329
26601,1196428',2018-09-17,CHQ DEPOSIT RETURN/242230,11800.0,0.0,,2018,9,17,DEBIT,11800.0,C875917495
26602,1196428',2018-09-17,"Indiaforensic USA, INC./USD/2286",0.0,1648723.04,,2018,9,17,CHECK_CASHING,1648723.04,C289045778
26603,1196428',2018-09-17,IRTT00701826685,1401.77,0.0,,2018,9,17,PAYEMENT,1401.77,M354505642
26604,1196428',2018-09-17,Indiaforensic SERVICES INDIA PVT,0.0,352227.0,,2018,9,17,CHECK_CASHING,352227.0,M628817604
26605,1196428',2018-09-17,TRF FRM  Indiaforensic SERVICES,0.0,4000000.0,,2018,9,17,CHECK_CASHING,4000000.0,C362966988
26606,1196428',2018-09-17,TRF FROM  Indiaforensic SERVICES,0.0,10000000.0,,2018,9,17,TRANSFER,10000000.0,C2145961947
26607,1196428',2018-09-17,TRF FROM  Indiaforensic SERVICES,0.0,10000000.0,,2018,9,17,TRANSFER,10000000.0,M1362161031
26608,1196428',2018-09-17,CASHDEP/GHATKOPAR/,0.0,132000.0,,2018,9,17,CHECK_CASHING,132000.0,C2040656033
26609,1196428',2018-09-17,FDRL/NATIONAL ELECTRONIC F,2000000.0,0.0,,2018,9,17,PAYEMENT,2000000.0,C1412774833
26610,1196428',2018-09-17,FDRL/NATIONAL ELECTRONIC F,3000000.0,0.0,,2018,9,17,PAYEMENT,3000000.0,C91463800
26611,1196428',2018-09-17,FDRL/NATIONAL ELECTRONIC F,2000000.0,0.0,,2018,9,17,CASH_OUT,2000000.0,C193864812
26612,1196428',2018-09-17,FDRL/NATIONAL ELECTRONIC F,3000000.0,0.0,,2018,9,17,CHECK_WITHDRAWAL,3000000.0,M1544952096
26613,1196428',2018-09-17,FDRL/NATIONAL ELECTRONIC F,1000000.0,0.0,,2018,9,17,DEBIT,1000000.0,C2126920602
26614,1196428',2018-09-17,FDRL/NATIONAL ELECTRONIC F,1000000.0,0.0,,2018,9,17,DEBIT,1000000.0,M1948735161
26615,1196428',2018-09-17,FDRL/NATIONAL ELECTRONIC F,1000000.0,0.0,,2018,9,17,CHECK_WITHDRAWAL,1000000.0,M316820365
26616,1196428',2018-09-17,FDRL/NATIONAL ELECTRONIC F,1000000.0,0.0,,2018,9,17,PAYEMENT,1000000.0,M221179626
26617,1196428',2018-09-17,FDRL/NATIONAL ELECTRONIC F,1000000.0,0.0,,2018,9,17,DEBIT,1000000.0,C1805162633
26618,1196428',2018-09-17,FDRL/NATIONAL ELECTRONIC F,1000000.0,0.0,,2018,9,17,DEBIT,1000000.0,C1357537552
26619,1196428',2018-09-17,FDRL/NATIONAL ELECTRONIC F,1000000.0,0.0,,2018,9,17,PAYEMENT,1000000.0,C846947180
26620,1196428',2018-09-17,FDRL/NATIONAL ELECTRONIC F,1000000.0,0.0,,2018,9,17,CHECK_WITHDRAWAL,1000000.0,C705480294
26621,1196428',2018-09-17,FDRL/NATIONAL ELECTRONIC F,1000000.0,0.0,,2018,9,17,CHECK_WITHDRAWAL,1000000.0,C276384108
26622,1196428',2018-09-17,FDRL/NATIONAL ELECTRONIC F,1000000.0,0.0,,2018,9,17,CASH_OUT,1000000.0,C893339434
26623,1196428',2018-09-17,NEFT/AT1709INRFI12033/FIX,0.0,100000.0,,2018,9,17,CASH_IN,100000.0,M236447651
26624,1196428',2018-09-17,FDRL/INTERNAL FUND TRANSFE,7000000.0,0.0,,2018,9,17,CHECK_WITHDRAWAL,7000000.0,C1179975227
26625,1196428',2018-09-17,TRF FRM  Indiaforensic SERVICES,0.0,800000.0,,2018,9,17,CHECK_CASHING,800000.0,M1871636362
26626,1196428',2018-09-17,TRF FRM  Indiaforensic SERVICES,0.0,900000.0,,2018,9,17,CHECK_CASHING,900000.0,M128711345
26627,1196428',2018-09-17,TRF FRM  Indiaforensic SERVICES,0.0,300000.0,,2018,9,17,CASH_IN,300000.0,M298391684
26628,1196428',2018-09-17,FDRL/INTERNAL FUND TRANSFE,500000.0,0.0,,2018,9,17,PAYEMENT,500000.0,C1927159174
26629,1196428',2018-09-17,FDRL/INTERNAL FUND TRANSFE,500000.0,0.0,,2018,9,17,PAYEMENT,500000.0,C728526866
26630,1196428',2018-09-17,FDRL/INTERNAL FUND TRANSFE,500000.0,0.0,,2018,9,17,CHECK_WITHDRAWAL,500000.0,C1049804269
26631,1196428',2018-09-17,BEAT CSH PKP DEL UDYOG 72,0.0,190900.0,,2018,9,17,CHECK_CASHING,190900.0,M119123049
26632,1196428',2018-09-17,CHQ DEPOSIT RETURN/242230,100.0,0.0,,2018,9,17,DEBIT,100.0,M663504614
26633,1196428',2018-09-17,CHQ DEPOSIT RETURN/242230,18.0,0.0,,2018,9,17,PAYEMENT,18.0,M744941142
26634,1196428',2018-09-18,FDRL/INTERNAL FUND TRANSFE,500000.0,0.0,,2018,9,18,CASH_OUT,500000.0,M923831205
26635,1196428',2018-09-18,NEFT/JAKA180918088895/MAN,0.0,11800.0,,2018,9,18,TRANSFER,11800.0,M2038208876
26636,1196428',2018-09-18,TRF FROM  Indiaforensic SERVICES,0.0,9100000.0,,2018,9,18,TRANSFER,9100000.0,M1244648095
26637,1196428',2018-09-18,FDRL/REAL TIME GROSS SETTL,2000000.0,0.0,,2018,9,18,DEBIT,2000000.0,M695324329
26638,1196428',2018-09-18,FDRL/REAL TIME GROSS SETTL,5000000.0,0.0,,2018,9,18,DEBIT,5000000.0,M1833084435
26639,1196428',2018-09-18,FDRL/REAL TIME GROSS SETTL,2000000.0,0.0,,2018,9,18,CASH_OUT,2000000.0,M585591077
26640,1196428',2018-09-18,RTGS/HDFCH18261523587/Indfor,0.0,3800000.0,,2018,9,18,CHECK_CASHING,3800000.0,M1794428624
26641,1196428',2018-09-18,FDRL/REAL TIME GROSS SETTL,2000000.0,0.0,,2018,9,18,DEBIT,2000000.0,M1375258538
26642,1196428',2018-09-18,FDRL/REAL TIME GROSS SETTL,2000000.0,0.0,,2018,9,18,CHECK_WITHDRAWAL,2000000.0,M2066480213
26643,1196428',2018-09-18,IMPS 826113161918 FROM PU,0.0,33000.0,,2018,9,18,TRANSFER,33000.0,M1560932376
26644,1196428',2018-09-18,RTGS/HDFCH18261572329/BAT,0.0,300000.0,,2018,9,18,CHECK_CASHING,300000.0,M1731081465
26645,1196428',2018-09-18,IMPS 826115260721 FROM SA,0.0,50000.0,,2018,9,18,TRANSFER,50000.0,M1654801430
26646,1196428',2018-09-18,IMPS 826115286946 FROM SA,0.0,50000.0,,2018,9,18,CASH_IN,50000.0,M707581168
26647,1196428',2018-09-18,FDRL/INTERNAL FUND TRANSFE,500000.0,0.0,,2018,9,18,CASH_OUT,500000.0,M1707159283
26648,1196428',2018-09-18,IMPS 826115312198 FROM SA,0.0,200000.0,,2018,9,18,TRANSFER,200000.0,M145185598
26649,1196428',2018-09-18,Indiaforensic SERVICES INDIA PVT,0.0,138569.0,,2018,9,18,CHECK_CASHING,138569.0,M1804914387
26650,1196428',2018-09-18,NEFT/AXISP00012157922/ACC,0.0,7000000.0,,2018,9,18,CHECK_CASHING,7000000.0,M421048180
26651,1196428',2018-09-18,CASHDEP/GHATKOPAR/,0.0,99000.0,,2018,9,18,CASH_IN,99000.0,M637246977
26652,1196428',2018-09-18,FDRL/INTERNAL FUND TRANSFE,500000.0,0.0,,2018,9,18,CASH_OUT,500000.0,C1937294500
26653,1196428',2018-09-18,TRF FRM  Indiaforensic SERVICES,0.0,10000000.0,,2018,9,18,CASH_IN,10000000.0,M952458535
26654,1196428',2018-09-18,FDRL/NATIONAL ELECTRONIC F,12951940.77,0.0,,2018,9,18,CHECK_WITHDRAWAL,12951940.77,M816954633
26655,1196428',2018-09-18,FDRL/INTERNAL FUND TRANSFE,1000000.0,0.0,,2018,9,18,CHECK_WITHDRAWAL,1000000.0,M1952420927
26656,1196428',2018-09-18,FDRL/INTERNAL FUND TRANSFE,1000000.0,0.0,,2018,9,18,DEBIT,1000000.0,M911096338
26657,1196428',2018-09-18,FDRL/INTERNAL FUND TRANSFE,1000000.0,0.0,,2018,9,18,CASH_OUT,1000000.0,M1455165497
26658,1196428',2018-09-18,FDRL/INTERNAL FUND TRANSFE,1000000.0,0.0,,2018,9,18,CASH_OUT,1000000.0,M1319925308
26659,1196428',2018-09-18,NEFT/000052393511/Indiaforensic,0.0,500000.0,,2018,9,18,CASH_IN,500000.0,C518953848
26660,1196428',2018-09-18,NEFT/000052393733/Indiaforensic,0.0,3500000.0,,2018,9,18,CASH_IN,3500000.0,C696705647
26661,1196428',2018-09-18,BEAT CSH PKP DEL GURG 727,0.0,95000.0,,2018,9,18,TRANSFER,95000.0,M2094129348
26662,1196428',2018-09-18,FDRL/INTERNAL FUND TRANSFE,1000000.0,0.0,,2018,9,18,CHECK_WITHDRAWAL,1000000.0,M366496896
26663,1196428',2018-09-18,FDRL/INTERNAL FUND TRANSFE,1000000.0,0.0,,2018,9,18,CASH_OUT,1000000.0,M1011698289
26664,1196428',2018-09-18,FDRL/INTERNAL FUND TRANSFE,1000000.0,0.0,,2018,9,18,PAYEMENT,1000000.0,M1975566420
26665,1196428',2018-09-18,FDRL/INTERNAL FUND TRANSFE,500000.0,0.0,,2018,9,18,DEBIT,500000.0,M641779010
26666,1196428',2018-09-18,FDRL/INTERNAL FUND TRANSFE,500000.0,0.0,,2018,9,18,DEBIT,500000.0,C464246030
26667,1196428',2018-09-18,TRF FRM  Indiaforensic SERVICES,0.0,500000.0,,2018,9,18,TRANSFER,500000.0,C1940189108
26668,1196428',2018-09-18,"Indiaforensic USA, INC./USD/3704",0.0,2670656.1,,2018,9,18,CHECK_CASHING,2670656.1,M1045045497
26669,1196428',2018-09-18,IRTT00701826926,1585.72,0.0,,2018,9,18,CHECK_WITHDRAWAL,1585.72,M1086945641
26670,1196428',2018-09-19,FDRL/INTERNAL FUND TRANSFE,500000.0,0.0,,2018,9,19,CASH_OUT,500000.0,M890558053
26671,1196428',2018-09-19,FDRL/INTERNAL FUND TRANSFE,1000000.0,0.0,,2018,9,19,CHECK_WITHDRAWAL,1000000.0,C1536728605
26672,1196428',2018-09-19,TRF FROM  Indiaforensic SERVICES,0.0,800000.0,,2018,9,19,TRANSFER,800000.0,M772068994
26673,1196428',2018-09-19,FDRL/INTERNAL FUND TRANSFE,500000.0,0.0,,2018,9,19,DEBIT,500000.0,C489712935
26674,1196428',2018-09-19,NEFT/N262180635583815/JUN,0.0,160000.0,,2018,9,19,CHECK_CASHING,160000.0,C1787868648
26675,1196428',2018-09-19,RTGS/SBINH18262029647/Indfor,0.0,4500000.0,,2018,9,19,CASH_IN,4500000.0,C1526401615
26676,1196428',2018-09-19,RTGS/HDFCH18262695595/Indfor,0.0,3600000.0,,2018,9,19,TRANSFER,3600000.0,C596299019
26677,1196428',2018-09-19,NEFT/N262180635645125/BAT,0.0,165000.0,,2018,9,19,TRANSFER,165000.0,C1785910017
26678,1196428',2018-09-19,TRF FROM  Indiaforensic SERVICES,0.0,5000000.0,,2018,9,19,TRANSFER,5000000.0,C1839337592
26679,1196428',2018-09-19,TRF FROM  Indiaforensic SERVICES,0.0,4000000.0,,2018,9,19,CHECK_CASHING,4000000.0,C75629578
26680,1196428',2018-09-19,FDRL/REAL TIME GROSS SETTL,13133965.34,0.0,,2018,9,19,CHECK_WITHDRAWAL,13133965.34,C831467165
26681,1196428',2018-09-19,FDRL/NATIONAL ELECTRONIC F,20103.0,0.0,,2018,9,19,PAYEMENT,20103.0,C851772371
26682,1196428',2018-09-19,FDRL/REAL TIME GROSS SETTL,3000000.0,0.0,,2018,9,19,CHECK_WITHDRAWAL,3000000.0,C813163690
26683,1196428',2018-09-19,FDRL/REAL TIME GROSS SETTL,3000000.0,0.0,,2018,9,19,PAYEMENT,3000000.0,C824197891
26684,1196428',2018-09-19,FDRL/NATIONAL ELECTRONIC F,15824.0,0.0,,2018,9,19,CHECK_WITHDRAWAL,15824.0,C1491213790
26685,1196428',2018-09-19,IMPS 826215127769 FROM AR,0.0,14095.0,,2018,9,19,CASH_IN,14095.0,C1892646174
26686,1196428',2018-09-19,NEFT/CBINH18262148726/M s,0.0,13500.0,,2018,9,19,TRANSFER,13500.0,M743358763
26687,1196428',2018-09-19,TRF FROM  Indiaforensic SERVICES,0.0,1000000.0,,2018,9,19,TRANSFER,1000000.0,C1946866478
26688,1196428',2018-09-19,TRF FROM  Indiaforensic SERVICES,0.0,5000000.0,,2018,9,19,CASH_IN,5000000.0,M321056491
26689,1196428',2018-09-19,NEFT/AXISP00012349615/ACC,0.0,3000000.0,,2018,9,19,TRANSFER,3000000.0,C1377194794
26690,1196428',2018-09-19,FDRL/NATIONAL ELECTRONIC F,20412.0,0.0,,2018,9,19,DEBIT,20412.0,M893710514
26691,1196428',2018-09-19,FDRL/NATIONAL ELECTRONIC F,1000000.0,0.0,,2018,9,19,CASH_OUT,1000000.0,M17524610
26692,1196428',2018-09-19,FDRL/NATIONAL ELECTRONIC F,1000000.0,0.0,,2018,9,19,DEBIT,1000000.0,C1014935920
26693,1196428',2018-09-19,FDRL/NATIONAL ELECTRONIC F,1000000.0,0.0,,2018,9,19,PAYEMENT,1000000.0,M236776836
26694,1196428',2018-09-19,FDRL/NATIONAL ELECTRONIC F,1000000.0,0.0,,2018,9,19,CASH_OUT,1000000.0,M523260070
26695,1196428',2018-09-19,FDRL/NATIONAL ELECTRONIC F,1000000.0,0.0,,2018,9,19,DEBIT,1000000.0,C251966229
26696,1196428',2018-09-19,FDRL/NATIONAL ELECTRONIC F,1000000.0,0.0,,2018,9,19,DEBIT,1000000.0,C2137848242
26697,1196428',2018-09-19,TRF FROM  Indiaforensic SERVICES,0.0,500000.0,,2018,9,19,CASH_IN,500000.0,M1985668144
26698,1196428',2018-09-19,TRF FROM  Indiaforensic SERVICES,0.0,500000.0,,2018,9,19,CASH_IN,500000.0,M1381375886
26699,1196428',2018-09-19,TRF FROM  Indiaforensic SERVICES,0.0,4000000.0,,2018,9,19,CASH_IN,4000000.0,M165737955
26700,1196428',2018-09-19,FDRL/INTERNAL FUND TRANSFE,1000000.0,0.0,,2018,9,19,DEBIT,1000000.0,C2106576360
26701,1196428',2018-09-19,FDRL/INTERNAL FUND TRANSFE,1000000.0,0.0,,2018,9,19,CASH_OUT,1000000.0,C207258326
26702,1196428',2018-09-19,FDRL/INTERNAL FUND TRANSFE,1000000.0,0.0,,2018,9,19,DEBIT,1000000.0,C1089993541
26703,1196428',2018-09-19,FDRL/INTERNAL FUND TRANSFE,1000000.0,0.0,,2018,9,19,PAYEMENT,1000000.0,C1269605689
26704,1196428',2018-09-19,FDRL/INTERNAL FUND TRANSFE,1000000.0,0.0,,2018,9,19,DEBIT,1000000.0,C1548218207
26705,1196428',2018-09-19,FDRL/INTERNAL FUND TRANSFE,1000000.0,0.0,,2018,9,19,PAYEMENT,1000000.0,C620638596
26706,1196428',2018-09-19,FDRL/INTERNAL FUND TRANSFE,500000.0,0.0,,2018,9,19,PAYEMENT,500000.0,C629598328
26707,1196428',2018-09-19,FDRL/INTERNAL FUND TRANSFE,1000000.0,0.0,,2018,9,19,PAYEMENT,1000000.0,M555275554
26708,1196428',2018-09-19,FDRL/INTERNAL FUND TRANSFE,500000.0,0.0,,2018,9,19,DEBIT,500000.0,C1549086472
26709,1196428',2018-09-19,BEAT CSH PKP DEL GURG 727,0.0,88000.0,,2018,9,19,TRANSFER,88000.0,C1010306008
26710,1196428',2018-09-20,RTGS/UTIBH18263673968/Indfor,0.0,1500000.0,,2018,9,20,CASH_IN,1500000.0,C47827984
26711,1196428',2018-09-20,FDRL/INTERNAL FUND TRANSFE,500000.0,0.0,,2018,9,20,DEBIT,500000.0,C1213485528
26712,1196428',2018-09-20,FDRL/INTERNAL FUND TRANSFE,500000.0,0.0,,2018,9,20,CHECK_WITHDRAWAL,500000.0,M80686687
26713,1196428',2018-09-20,RTGS/HDFCH18263810305/Indfor,0.0,800000.0,,2018,9,20,TRANSFER,800000.0,C556534527
26714,1196428',2018-09-20,FDRL/INTERNAL FUND TRANSFE,1000000.0,0.0,,2018,9,20,CHECK_WITHDRAWAL,1000000.0,C1219161283
26715,1196428',2018-09-20,RTGS/SBINH18263024297/Indfor,0.0,9300000.0,,2018,9,20,TRANSFER,9300000.0,C982891593
26716,1196428',2018-09-20,FDRL/INTERNAL FUND TRANSFE,1000000.0,0.0,,2018,9,20,PAYEMENT,1000000.0,C851772371
26717,1196428',2018-09-20,FDRL/REAL TIME GROSS SETTL,6627463.0,0.0,,2018,9,20,CASH_OUT,6627463.0,M84437966
26718,1196428',2018-09-20,TRF FROM  Indiaforensic SERVICES,0.0,8500000.0,,2018,9,20,TRANSFER,8500000.0,C1289493889
26719,1196428',2018-09-20,RTGS/ICICH18263808935/Indfor,0.0,3800000.0,,2018,9,20,CASH_IN,3800000.0,M684541638
26720,1196428',2018-09-20,NEFT/AXISP00012423325/ACC,0.0,2000000.0,,2018,9,20,CASH_IN,2000000.0,M893642648
26721,1196428',2018-09-20,RTGS/HDFCH18263889135/BAT,0.0,290000.0,,2018,9,20,CASH_IN,290000.0,M28534787
26722,1196428',2018-09-20,FDRL/REAL TIME GROSS SETTL,10000000.0,0.0,,2018,9,20,CHECK_WITHDRAWAL,10000000.0,M768463661
26723,1196428',2018-09-20,FDRL/INTERNAL FUND TRANSFE,1000000.0,0.0,,2018,9,20,DEBIT,1000000.0,M601115519
26724,1196428',2018-09-20,FDRL/REAL TIME GROSS SETTL,2000000.0,0.0,,2018,9,20,PAYEMENT,2000000.0,M591625339
26725,1196428',2018-09-20,FDRL/REAL TIME GROSS SETTL,3000000.0,0.0,,2018,9,20,PAYEMENT,3000000.0,M1969097065
26726,1196428',2018-09-20,NEFT/N263180636739991/TEC,0.0,200000.0,,2018,9,20,TRANSFER,200000.0,M162077179
26727,1196428',2018-09-20,TRF FROM  Indiaforensic SERVICES,0.0,2700000.0,,2018,9,20,CASH_IN,2700000.0,M2034571520
26728,1196428',2018-09-20,FDRL/INTERNAL FUND TRANSFE,1000000.0,0.0,,2018,9,20,PAYEMENT,1000000.0,M28494729
26729,1196428',2018-09-20,FDRL/INTERNAL FUND TRANSFE,1000000.0,0.0,,2018,9,20,DEBIT,1000000.0,M116938546
26730,1196428',2018-09-20,FDRL/INTERNAL FUND TRANSFE,1000000.0,0.0,,2018,9,20,CASH_OUT,1000000.0,M2052750222
26731,1196428',2018-09-20,BEAT CSH PKP DEL GURG 727,0.0,50300.0,,2018,9,20,CASH_IN,50300.0,M1338255526
26732,1196428',2018-09-21,FDRL/INTERNAL FUND TRANSFE,500000.0,0.0,,2018,9,21,DEBIT,500000.0,C849689177
26733,1196428',2018-09-21,"Indiaforensic USA, INC/USD/28494",0.0,2034471.6,,2018,9,21,CHECK_CASHING,2034471.6,C160284738
26734,1196428',2018-09-21,IRTT00701827077,1471.2,0.0,,2018,9,21,PAYEMENT,1471.2,M2075499676
26735,1196428',2018-09-21,"Indiaforensic USA, INC./USD/4002",0.0,2857785.0,,2018,9,21,CASH_IN,2857785.0,C487219656
26736,1196428',2018-09-21,IRTT00701827076,1619.4,0.0,,2018,9,21,CASH_OUT,1619.4,M1799012282
26737,1196428',2018-09-21,FDRL/REAL TIME GROSS SETTL,5000000.0,0.0,,2018,9,21,CHECK_WITHDRAWAL,5000000.0,C324470431
26738,1196428',2018-09-21,FUND TRF FROM  Indiaforensic SER,0.0,5000000.0,,2018,9,21,CHECK_CASHING,5000000.0,M137024479
26739,1196428',2018-09-21,FDRL/NXTXN_PAYMENT,0.0,28400.0,,2018,9,21,CASH_IN,28400.0,C1360650266
26740,1196428',2018-09-21,FDRL/IndforSECURE_PAYMENT,0.0,27849.0,,2018,9,21,CHECK_CASHING,27849.0,C580735116
26741,1196428',2018-09-21,NEFT/N264180637115450/JUN,0.0,100000.0,,2018,9,21,CHECK_CASHING,100000.0,C1781090157
26742,1196428',2018-09-21,FUND TRF FROM  Indiaforensic SER,0.0,7500000.0,,2018,9,21,CHECK_CASHING,7500000.0,C1846735756
26743,1196428',2018-09-21,NEFT/AXISP00012522771/ACC,0.0,1000000.0,,2018,9,21,TRANSFER,1000000.0,C928023753
26744,1196428',2018-09-21,FDRL/NATIONAL ELECTRONIC F,113695.0,0.0,,2018,9,21,CHECK_WITHDRAWAL,113695.0,C614438306
26745,1196428',2018-09-21,FDRL/NATIONAL ELECTRONIC F,296400.0,0.0,,2018,9,21,PAYEMENT,296400.0,C1469261298
26746,1196428',2018-09-21,FDRL/INTERNAL FUND TRANSFE,1000000.0,0.0,,2018,9,21,CASH_OUT,1000000.0,C691586697
26747,1196428',2018-09-21,NEFT/KKBK182641074330/Acc,0.0,3000000.0,,2018,9,21,CASH_IN,3000000.0,M751175063
26748,1196428',2018-09-21,RTGS/ICICH18264221264/Indfor,0.0,2000000.0,,2018,9,21,CHECK_CASHING,2000000.0,M1955013570
26749,1196428',2018-09-21,FDRL/REAL TIME GROSS SETTL,10000000.0,0.0,,2018,9,21,DEBIT,10000000.0,C824208363
26750,1196428',2018-09-21,Indiaforensic SERVICES INDIA PVT,0.0,260744.0,,2018,9,21,TRANSFER,260744.0,C229313132
26751,1196428',2018-09-21,NEFT/N264180637344418/BAT,0.0,250000.0,,2018,9,21,CASH_IN,250000.0,C383296094
26752,1196428',2018-09-21,NEFT/AXISP00012568925/ACC,0.0,1100000.0,,2018,9,21,CHECK_CASHING,1100000.0,C1359484306
26753,1196428',2018-09-21,NEFT/AXISP00012568927/ACC,0.0,5900000.0,,2018,9,21,CASH_IN,5900000.0,C1511785794
26754,1196428',2018-09-21,NEFT CHARGES AND GST/0000,29.5,0.0,,2018,9,21,PAYEMENT,29.5,C1482979717
26755,1196428',2018-09-21,NEFT/000050794471/INDIAN,8170503.0,0.0,,2018,9,21,PAYEMENT,8170503.0,C1019670582
26756,1196428',2018-09-21,FUND TRF FROM  Indiaforensic SER,0.0,400000.0,,2018,9,21,CHECK_CASHING,400000.0,C667346055
26757,1196428',2018-09-21,FUND TRF FROM  Indiaforensic SER,0.0,900000.0,,2018,9,21,CASH_IN,900000.0,C107095723
26758,1196428',2018-09-21,IMPS 826419316039 FROM OX,0.0,100000.0,,2018,9,21,TRANSFER,100000.0,C1671386208
26759,1196428',2018-09-21,FDRL/INTERNAL FUND TRANSFE,1000000.0,0.0,,2018,9,21,DEBIT,1000000.0,C932583850
26760,1196428',2018-09-21,FDRL/INTERNAL FUND TRANSFE,1000000.0,0.0,,2018,9,21,DEBIT,1000000.0,C2040657244
26761,1196428',2018-09-21,FDRL/INTERNAL FUND TRANSFE,1000000.0,0.0,,2018,9,21,CHECK_WITHDRAWAL,1000000.0,C1273939873
26762,1196428',2018-09-24,CASHDEP/BOISAR/,0.0,10000.0,,2018,9,24,TRANSFER,10000.0,C932583850
26763,1196428',2018-09-24,IMPS 826710841928 FROM SA,0.0,50000.0,,2018,9,24,CASH_IN,50000.0,M1864754483
26764,1196428',2018-09-24,IMPS 826711872234 FROM SA,0.0,50000.0,,2018,9,24,CHECK_CASHING,50000.0,M260189050
26765,1196428',2018-09-24,RTGS/SBINH18267010757/Indfor,0.0,2000000.0,,2018,9,24,CHECK_CASHING,2000000.0,C288197656
26766,1196428',2018-09-24,FDRL/INTERNAL FUND TRANSFE,500000.0,0.0,,2018,9,24,CHECK_WITHDRAWAL,500000.0,M1927269490
26767,1196428',2018-09-24,FDRL/INTERNAL FUND TRANSFE,1000000.0,0.0,,2018,9,24,CASH_OUT,1000000.0,M1765396124
26768,1196428',2018-09-24,FDRL/INTERNAL FUND TRANSFE,500000.0,0.0,,2018,9,24,CASH_OUT,500000.0,C874023329
26769,1196428',2018-09-24,TRF FROM  Indiaforensic SERVICES,0.0,2000000.0,,2018,9,24,CHECK_CASHING,2000000.0,C715007517
26770,1196428',2018-09-24,TRF FROM  Indiaforensic SERVICES,0.0,5000000.0,,2018,9,24,TRANSFER,5000000.0,C910119139
26771,1196428',2018-09-24,TRF FROM  Indiaforensic SERVICES,0.0,10000000.0,,2018,9,24,CHECK_CASHING,10000000.0,C157316544
26772,1196428',2018-09-24,FDRL/INTERNAL FUND TRANSFE,1000000.0,0.0,,2018,9,24,DEBIT,1000000.0,C676931970
26773,1196428',2018-09-24,FDRL/INTERNAL FUND TRANSFE,1000000.0,0.0,,2018,9,24,CHECK_WITHDRAWAL,1000000.0,C728526866
26774,1196428',2018-09-24,FDRL/INTERNAL FUND TRANSFE,1000000.0,0.0,,2018,9,24,PAYEMENT,1000000.0,C1321128627
26775,1196428',2018-09-24,RTGS/HDFCH18267167796/Indfor,0.0,2700000.0,,2018,9,24,TRANSFER,2700000.0,C489693281
26776,1196428',2018-09-24,FDRL/INTERNAL FUND TRANSFE,5000000.0,0.0,,2018,9,24,PAYEMENT,5000000.0,C305259590
26777,1196428',2018-09-24,FDRL/INTERNAL FUND TRANSFE,5000000.0,0.0,,2018,9,24,CASH_OUT,5000000.0,C2078448324
26778,1196428',2018-09-24,FDRL/INTERNAL FUND TRANSFE,5000000.0,0.0,,2018,9,24,PAYEMENT,5000000.0,C1374917762
26779,1196428',2018-09-24,TRF FROM  Indiaforensic SERVICES,0.0,11900000.0,,2018,9,24,CHECK_CASHING,11900000.0,C339099861
26780,1196428',2018-09-24,FDRL/REAL TIME GROSS SETTL,3000000.0,0.0,,2018,9,24,DEBIT,3000000.0,C1493448513
26781,1196428',2018-09-24,IRTT00701827257,974.69,0.0,,2018,9,24,PAYEMENT,974.69,C160284738
26782,1196428',2018-09-24,"Indiaforensic USA, INC./USD/9090",0.0,655207.2,,2018,9,24,CASH_IN,655207.2,C593596322
26783,1196428',2018-09-24,IMPS 826716392408 FROM AS,0.0,70099.0,,2018,9,24,CHECK_CASHING,70099.0,C945327594
26784,1196428',2018-09-24,FDRL/INTERNAL FUND TRANSFE,5000000.0,0.0,,2018,9,24,CASH_OUT,5000000.0,C1009972184
26785,1196428',2018-09-24,FDRL/INTERNAL FUND TRANSFE,5000000.0,0.0,,2018,9,24,CHECK_WITHDRAWAL,5000000.0,C1034382650
26786,1196428',2018-09-24,NEFT/N267180638165349/JUN,0.0,140000.0,,2018,9,24,CASH_IN,140000.0,C309167705
26787,1196428',2018-09-24,FDRL/NATIONAL ELECTRONIC F,122787.0,0.0,,2018,9,24,CASH_OUT,122787.0,C2091209617
26788,1196428',2018-09-24,FDRL/NATIONAL ELECTRONIC F,35268.0,0.0,,2018,9,24,CHECK_WITHDRAWAL,35268.0,C1997859171
26789,1196428',2018-09-24,IMPS 826717099083 FROM SA,0.0,50000.0,,2018,9,24,CHECK_CASHING,50000.0,C1716892902
26790,1196428',2018-09-24,TRF FROM  Indiaforensic SERVICES,0.0,15000000.0,,2018,9,24,CHECK_CASHING,15000000.0,C1065349988
26791,1196428',2018-09-24,FDRL/NATIONAL ELECTRONIC F,4599443.0,0.0,,2018,9,24,DEBIT,4599443.0,C1494271614
26792,1196428',2018-09-24,FDRL/NATIONAL ELECTRONIC F,10000000.0,0.0,,2018,9,24,PAYEMENT,10000000.0,C627357682
26793,1196428',2018-09-24,TRF FROM  Indiaforensic SERVICES,0.0,5000000.0,,2018,9,24,TRANSFER,5000000.0,M1484819842
26794,1196428',2018-09-24,TRF FROM  Indiaforensic SERVICES,0.0,2000000.0,,2018,9,24,CASH_IN,2000000.0,M1186732868
26795,1196428',2018-09-24,IMPS 826717921264 FROM OX,0.0,200000.0,,2018,9,24,CHECK_CASHING,200000.0,M1131010855
26796,1196428',2018-09-24,FUNDS FRM  Indiaforensic SERVICE,0.0,10000000.0,,2018,9,24,CHECK_CASHING,10000000.0,M1771935978
26797,1196428',2018-09-24,FUNDS FRM  Indiaforensic SERVICE,0.0,15000000.0,,2018,9,24,CHECK_CASHING,15000000.0,C276384108
26798,1196428',2018-09-24,NEFT CHARGES AND GST/0000,29.5,0.0,,2018,9,24,DEBIT,29.5,M393929482
26799,1196428',2018-09-24,NEFT/000051029935/Indiaforensic,9052228.0,0.0,,2018,9,24,DEBIT,9052228.0,M1746820035
26800,1196428',2018-09-24,NEFT CHARGES AND GST/0000,29.5,0.0,,2018,9,24,CASH_OUT,29.5,M905479937
26801,1196428',2018-09-24,NEFT/000051030191/Indiaforensic,9180006.0,0.0,,2018,9,24,CASH_OUT,9180006.0,M371221309
26802,1196428',2018-09-24,IMPS 826718281280 FROM SA,0.0,5000.0,,2018,9,24,CASH_IN,5000.0,M1085039239
26803,1196428',2018-09-24,TRF FROM  Indiaforensic SERVICES,0.0,1000000.0,,2018,9,24,CHECK_CASHING,1000000.0,M245942535
26804,1196428',2018-09-24,TRF FROM  Indiaforensic SERVICES,0.0,1000000.0,,2018,9,24,CHECK_CASHING,1000000.0,M1974407064
26805,1196428',2018-09-24,TRF FROM  Indiaforensic SERVICES,0.0,500000.0,,2018,9,24,CHECK_CASHING,500000.0,M100510528
26806,1196428',2018-09-24,TRF FROM  Indiaforensic SERVICES,0.0,10000000.0,,2018,9,24,TRANSFER,10000000.0,C1624455220
26807,1196428',2018-09-24,FDRL/INTERNAL FUND TRANSFE,1000000.0,0.0,,2018,9,24,DEBIT,1000000.0,C1849933855
26808,1196428',2018-09-24,FDRL/INTERNAL FUND TRANSFE,500000.0,0.0,,2018,9,24,PAYEMENT,500000.0,C1479553213
26809,1196428',2018-09-24,FDRL/INTERNAL FUND TRANSFE,1000000.0,0.0,,2018,9,24,PAYEMENT,1000000.0,C2014517831
26810,1196428',2018-09-24,FDRL/INTERNAL FUND TRANSFE,1000000.0,0.0,,2018,9,24,PAYEMENT,1000000.0,C815264031
26811,1196428',2018-09-24,FDRL/INTERNAL FUND TRANSFE,1000000.0,0.0,,2018,9,24,CASH_OUT,1000000.0,M799078448
26812,1196428',2018-09-24,FDRL/INTERNAL FUND TRANSFE,1000000.0,0.0,,2018,9,24,DEBIT,1000000.0,M1812377995
26813,1196428',2018-09-24,FDRL/INTERNAL FUND TRANSFE,1000000.0,0.0,,2018,9,24,CASH_OUT,1000000.0,C251155815
26814,1196428',2018-09-24,FDRL/INTERNAL FUND TRANSFE,500000.0,0.0,,2018,9,24,CHECK_WITHDRAWAL,500000.0,M1549942775
26815,1196428',2018-09-24,FDRL/INTERNAL FUND TRANSFE,500000.0,0.0,,2018,9,24,DEBIT,500000.0,M1302941797
26816,1196428',2018-09-24,FDRL/INTERNAL FUND TRANSFE,5000000.0,0.0,,2018,9,24,CHECK_WITHDRAWAL,5000000.0,M671818316
26817,1196428',2018-09-24,FDRL/INTERNAL FUND TRANSFE,5000000.0,0.0,,2018,9,24,CHECK_WITHDRAWAL,5000000.0,M538994471
26818,1196428',2018-09-24,FDRL/INTERNAL FUND TRANSFE,5000000.0,0.0,,2018,9,24,PAYEMENT,5000000.0,M1829492778
26819,1196428',2018-09-24,BEAT CSH PKP DEL GURG 727,0.0,113000.0,,2018,9,24,CHECK_CASHING,113000.0,M8158505
26820,1196428',2018-09-24,NEFT/000052647733/Indiaforensic,0.0,3600000.0,,2018,9,24,CHECK_CASHING,3600000.0,M870553967
26821,1196428',2018-09-25,FDRL/NATIONAL ELECTRONIC F,9052228.65,0.0,,2018,9,25,DEBIT,9052228.65,M1110995944
26822,1196428',2018-09-25,FDRL/INTERNAL FUND TRANSFE,500000.0,0.0,,2018,9,25,CASH_OUT,500000.0,M992857921
26823,1196428',2018-09-25,NEFT/PUNBH18268985837/BAL,0.0,150000.0,,2018,9,25,TRANSFER,150000.0,M1839996572
26824,1196428',2018-09-25,RTGS/UTIBH18268696797/Indfor,0.0,3000000.0,,2018,9,25,CHECK_CASHING,3000000.0,M2086820381
26825,1196428',2018-09-25,FDRL/NATIONAL ELECTRONIC F,3043151.63,0.0,,2018,9,25,PAYEMENT,3043151.63,M1237055647
26826,1196428',2018-09-25,Indiaforensic SERVICES INDIA PVT,0.0,261052.0,,2018,9,25,CHECK_CASHING,261052.0,M148182790
26827,1196428',2018-09-25,TRF FROM  Indiaforensic SERVICES,0.0,15000000.0,,2018,9,25,TRANSFER,15000000.0,M676816226
26828,1196428',2018-09-25,FDRL/REAL TIME GROSS SETTL,15000000.0,0.0,,2018,9,25,DEBIT,15000000.0,M652616511
26829,1196428',2018-09-25,CHQ DEP/863462/OWDEL2/PUN,0.0,11800.0,,2018,9,25,CASH_IN,11800.0,M2064656796
26830,1196428',2018-09-25,RTGS/HDFCH18268338273/Indfor,0.0,3200000.0,,2018,9,25,TRANSFER,3200000.0,M826331829
26831,1196428',2018-09-25,FDRL/REAL TIME GROSS SETTL,3000000.0,0.0,,2018,9,25,DEBIT,3000000.0,M1516522329
26832,1196428',2018-09-25,CASHDEP/GHATKOPAR/,0.0,100000.0,,2018,9,25,CASH_IN,100000.0,M215680619
26833,1196428',2018-09-25,FUND TRF  Indiaforensic SERVICES,0.0,4000000.0,,2018,9,25,CHECK_CASHING,4000000.0,M1111086363
26834,1196428',2018-09-25,FUND TRF  Indiaforensic SERVICES,0.0,4000000.0,,2018,9,25,CASH_IN,4000000.0,M1614545948
26835,1196428',2018-09-25,FUND TRF  Indiaforensic SERVICES,0.0,500000.0,,2018,9,25,CHECK_CASHING,500000.0,M769891363
26836,1196428',2018-09-25,FDRL/INTERNAL FUND TRANSFE,5000000.0,0.0,,2018,9,25,CASH_OUT,5000000.0,M485211052
26837,1196428',2018-09-25,RTGS/UTIBH18268637009/Indfor,0.0,1000000.0,,2018,9,25,CHECK_CASHING,1000000.0,M2094476772
26838,1196428',2018-09-25,FDRL/INTERNAL FUND TRANSFE,5000000.0,0.0,,2018,9,25,CASH_OUT,5000000.0,M469185795
26839,1196428',2018-09-25,"Indiaforensic USA, INC./USD/6060",0.0,4375681.0,,2018,9,25,CASH_IN,4375681.0,M915514572
26840,1196428',2018-09-25,IRTT00701827430,1892.62,0.0,,2018,9,25,CASH_OUT,1892.62,M1219082029
26841,1196428',2018-09-25,FDRL/REAL TIME GROSS SETTL,3000000.0,0.0,,2018,9,25,CHECK_WITHDRAWAL,3000000.0,M1621135314
26842,1196428',2018-09-25,FDRL/INTERNAL FUND TRANSFE,500000.0,0.0,,2018,9,25,CHECK_WITHDRAWAL,500000.0,M695160674
26843,1196428',2018-09-25,Indiaforensic SERVICES INDIA PVT,0.0,98899.0,,2018,9,25,CHECK_CASHING,98899.0,C1303702634
26844,1196428',2018-09-25,TRF FROM  Indiaforensic SERVICES,0.0,9700000.0,,2018,9,25,CHECK_CASHING,9700000.0,M156411463
26845,1196428',2018-09-25,IMPS 826816152751 FROM PU,0.0,33000.0,,2018,9,25,CHECK_CASHING,33000.0,M1576221393
26846,1196428',2018-09-25,NEFT/AT2409FIXED76033/FIX,0.0,180000.0,,2018,9,25,TRANSFER,180000.0,C183354406
26847,1196428',2018-09-25,NEFT/IOBAN18268558370/M/S,0.0,11800.0,,2018,9,25,CASH_IN,11800.0,M33083464
26848,1196428',2018-09-25,TRF FROM  Indiaforensic SERVICES,0.0,10000000.0,,2018,9,25,CHECK_CASHING,10000000.0,M485969443
26849,1196428',2018-09-25,NEFT CHARGES AND GST/0000,29.5,0.0,,2018,9,25,DEBIT,29.5,C987060415
26850,1196428',2018-09-25,NEFT/000051151857/GALENA,5000000.0,0.0,,2018,9,25,CHECK_WITHDRAWAL,5000000.0,M1980969351
26851,1196428',2018-09-25,NEFT/BARBC18268310283/IND,0.0,6490.0,,2018,9,25,CHECK_CASHING,6490.0,C465499079
26852,1196428',2018-09-25,NEFT/000052730115/Indiaforensic,0.0,3100000.0,,2018,9,25,CHECK_CASHING,3100000.0,M2018377927
26853,1196428',2018-09-25,FDRL/INTERNAL FUND TRANSFE,2000000.0,0.0,,2018,9,25,CASH_OUT,2000000.0,M1488662264
26854,1196428',2018-09-25,FDRL/INTERNAL FUND TRANSFE,5000000.0,0.0,,2018,9,25,CHECK_WITHDRAWAL,5000000.0,M102724857
26855,1196428',2018-09-25,FDRL/INTERNAL FUND TRANSFE,1000000.0,0.0,,2018,9,25,DEBIT,1000000.0,C929286459
26856,1196428',2018-09-25,FDRL/INTERNAL FUND TRANSFE,1000000.0,0.0,,2018,9,25,PAYEMENT,1000000.0,M314750956
26857,1196428',2018-09-25,BEAT CSH PKP DEL GURG 727,0.0,100000.0,,2018,9,25,TRANSFER,100000.0,M1248197219
26858,1196428',2018-09-26,FDRL/INTERNAL FUND TRANSFE,500000.0,0.0,,2018,9,26,CHECK_WITHDRAWAL,500000.0,M11350317
26859,1196428',2018-09-26,FDRL/INTERNAL FUND TRANSFE,1000000.0,0.0,,2018,9,26,PAYEMENT,1000000.0,C981198566
26860,1196428',2018-09-26,FDRL/REAL TIME GROSS SETTL,2000000.0,0.0,,2018,9,26,PAYEMENT,2000000.0,C1141137903
26861,1196428',2018-09-26,FDRL/REAL TIME GROSS SETTL,5000000.0,0.0,,2018,9,26,CHECK_WITHDRAWAL,5000000.0,C679235222
26862,1196428',2018-09-26,TRF FROM  Indiaforensic SERVICES,0.0,800000.0,,2018,9,26,CASH_IN,800000.0,C874023329
26863,1196428',2018-09-26,TRF TO  Indiaforensic SERVICES I,171000.0,0.0,,2018,9,26,DEBIT,171000.0,C1398530689
26864,1196428',2018-09-26,TRF FROM  Indiaforensic SERVICES,0.0,300000.0,,2018,9,26,CHECK_CASHING,300000.0,C111210112
26865,1196428',2018-09-26,CASHDEP/GHATKOPAR/,0.0,10561.0,,2018,9,26,CHECK_CASHING,10561.0,C306285887
26866,1196428',2018-09-26,FDRL/INTERNAL FUND TRANSFE,1000000.0,0.0,,2018,9,26,DEBIT,1000000.0,C893339434
26867,1196428',2018-09-26,NEFT/SBIN918269223950/M.R,0.0,100000.0,,2018,9,26,CHECK_CASHING,100000.0,C1404112538
26868,1196428',2018-09-26,RTGS/SBINH18269013134/MS,0.0,960000.0,,2018,9,26,TRANSFER,960000.0,C593210287
26869,1196428',2018-09-26,NEFT/P18092655046673/S B,0.0,99500.0,,2018,9,26,CHECK_CASHING,99500.0,C219913687
26870,1196428',2018-09-26,"Indiaforensic USA, INC./USD/1495",0.0,107864.25,,2018,9,26,CHECK_CASHING,107864.25,C724821526
26871,1196428',2018-09-26,IRTT00701827572,482.08,0.0,,2018,9,26,DEBIT,482.08,C897209100
26872,1196428',2018-09-26,CHQ DEP/749352/OWDEL1/SBI,0.0,11800.0,,2018,9,26,TRANSFER,11800.0,C1060041730
26873,1196428',2018-09-26,CHQ DEP/350406/OWDEL1/SBI,0.0,11800.0,,2018,9,26,CHECK_CASHING,11800.0,M884150907
26874,1196428',2018-09-26,CHQ DEP/591/OWDEL1/HDFC/N,0.0,11800.0,,2018,9,26,CASH_IN,11800.0,C916869225
26875,1196428',2018-09-26,CHQ DEP/105397/OWDEL1/SBI,0.0,11800.0,,2018,9,26,CASH_IN,11800.0,C193625667
26876,1196428',2018-09-26,NEFT/N269180639848892/JUN,0.0,100000.0,,2018,9,26,TRANSFER,100000.0,M74229705
26877,1196428',2018-09-26,RTGS/HDFCH18269535595/Indfor,0.0,3300000.0,,2018,9,26,TRANSFER,3300000.0,C684896216
26878,1196428',2018-09-26,INTEX TECHNOLOGIES INDIA,1000000.0,0.0,,2018,9,26,PAYEMENT,1000000.0,C405881980
26879,1196428',2018-09-26,RTGS/SBINH18269034144/Indfor,0.0,8400000.0,,2018,9,26,CASH_IN,8400000.0,C237988421
26880,1196428',2018-09-26,FDRL/NATIONAL ELECTRONIC F,13380158.93,0.0,,2018,9,26,CASH_OUT,13380158.93,C1805683209
26881,1196428',2018-09-26,RTGS/HDFCH18269572344/BAT,0.0,250000.0,,2018,9,26,CASH_IN,250000.0,C1870252780
26882,1196428',2018-09-26,FDRL/INTERNAL FUND TRANSFE,200000.0,0.0,,2018,9,26,CHECK_WITHDRAWAL,200000.0,C673068808
26883,1196428',2018-09-26,CASHDEP/GHATKOPAR/,0.0,103000.0,,2018,9,26,CHECK_CASHING,103000.0,C79685693
26884,1196428',2018-09-26,TRF FROM  Indiaforensic SERVICES,0.0,13100000.0,,2018,9,26,CASH_IN,13100000.0,C1721246982
26885,1196428',2018-09-26,FDRL/NATIONAL ELECTRONIC F,1000000.0,0.0,,2018,9,26,PAYEMENT,1000000.0,C489712935
26886,1196428',2018-09-26,FDRL/NATIONAL ELECTRONIC F,5000000.0,0.0,,2018,9,26,CASH_OUT,5000000.0,C557041912
26887,1196428',2018-09-26,FDRL/NATIONAL ELECTRONIC F,5000000.0,0.0,,2018,9,26,CHECK_WITHDRAWAL,5000000.0,C1651855867
26888,1196428',2018-09-26,FDRL/NATIONAL ELECTRONIC F,84750.0,0.0,,2018,9,26,CHECK_WITHDRAWAL,84750.0,C143580560
26889,1196428',2018-09-26,NEFT/000052794127/Indiaforensic,0.0,900000.0,,2018,9,26,TRANSFER,900000.0,C2113748097
26890,1196428',2018-09-26,FDRL/NATIONAL ELECTRONIC F,38212.0,0.0,,2018,9,26,CHECK_WITHDRAWAL,38212.0,C1641169735
26891,1196428',2018-09-26,FDRL/NATIONAL ELECTRONIC F,61274.0,0.0,,2018,9,26,DEBIT,61274.0,C651445737
26892,1196428',2018-09-26,FDRL/NATIONAL ELECTRONIC F,69693.0,0.0,,2018,9,26,DEBIT,69693.0,C1482979717
26893,1196428',2018-09-26,FDRL/NATIONAL ELECTRONIC F,58443.0,0.0,,2018,9,26,DEBIT,58443.0,C2029310301
26894,1196428',2018-09-26,FDRL/NATIONAL ELECTRONIC F,39639.0,0.0,,2018,9,26,CHECK_WITHDRAWAL,39639.0,C1753714541
26895,1196428',2018-09-26,FDRL/NATIONAL ELECTRONIC F,36452.0,0.0,,2018,9,26,CHECK_WITHDRAWAL,36452.0,C1849941462
26896,1196428',2018-09-26,FDRL/NATIONAL ELECTRONIC F,65704.0,0.0,,2018,9,26,PAYEMENT,65704.0,C1390121014
26897,1196428',2018-09-26,FDRL/NATIONAL ELECTRONIC F,82104.0,0.0,,2018,9,26,CASH_OUT,82104.0,C1450828900
26898,1196428',2018-09-26,FDRL/NATIONAL ELECTRONIC F,30216.0,0.0,,2018,9,26,DEBIT,30216.0,C895798008
26899,1196428',2018-09-26,FDRL/NATIONAL ELECTRONIC F,48950.0,0.0,,2018,9,26,CASH_OUT,48950.0,C917187702
26900,1196428',2018-09-26,FDRL/NATIONAL ELECTRONIC F,50262.0,0.0,,2018,9,26,CHECK_WITHDRAWAL,50262.0,M1843121654
26901,1196428',2018-09-26,FDRL/NATIONAL ELECTRONIC F,36624.0,0.0,,2018,9,26,CHECK_WITHDRAWAL,36624.0,M105503177
26902,1196428',2018-09-26,FDRL/NATIONAL ELECTRONIC F,52225.0,0.0,,2018,9,26,DEBIT,52225.0,M1088012577
26903,1196428',2018-09-26,FDRL/NATIONAL ELECTRONIC F,30250.0,0.0,,2018,9,26,PAYEMENT,30250.0,M1655080274
26904,1196428',2018-09-26,FDRL/NATIONAL ELECTRONIC F,69077.0,0.0,,2018,9,26,CHECK_WITHDRAWAL,69077.0,M1871932056
26905,1196428',2018-09-26,FDRL/NATIONAL ELECTRONIC F,43358.0,0.0,,2018,9,26,DEBIT,43358.0,C175382361
26906,1196428',2018-09-26,FDRL/NATIONAL ELECTRONIC F,42043.0,0.0,,2018,9,26,PAYEMENT,42043.0,C2112826959
26907,1196428',2018-09-26,FDRL/NATIONAL ELECTRONIC F,36325.0,0.0,,2018,9,26,DEBIT,36325.0,C284399568
26908,1196428',2018-09-26,FDRL/NATIONAL ELECTRONIC F,39550.0,0.0,,2018,9,26,DEBIT,39550.0,C54274682
26909,1196428',2018-09-26,FDRL/NATIONAL ELECTRONIC F,85169.0,0.0,,2018,9,26,DEBIT,85169.0,M593623080
26910,1196428',2018-09-26,FDRL/NATIONAL ELECTRONIC F,33353.0,0.0,,2018,9,26,DEBIT,33353.0,M1275185959
26911,1196428',2018-09-26,FDRL/NATIONAL ELECTRONIC F,68788.0,0.0,,2018,9,26,PAYEMENT,68788.0,C2032924554
26912,1196428',2018-09-26,FDRL/NATIONAL ELECTRONIC F,58082.0,0.0,,2018,9,26,PAYEMENT,58082.0,C366015139
26913,1196428',2018-09-26,FDRL/NATIONAL ELECTRONIC F,60747.0,0.0,,2018,9,26,CASH_OUT,60747.0,M2145533512
26914,1196428',2018-09-26,FDRL/NATIONAL ELECTRONIC F,81803.0,0.0,,2018,9,26,CHECK_WITHDRAWAL,81803.0,M857485467
26915,1196428',2018-09-26,FDRL/NATIONAL ELECTRONIC F,89351.0,0.0,,2018,9,26,PAYEMENT,89351.0,M619881142
26916,1196428',2018-09-26,FDRL/NATIONAL ELECTRONIC F,44356.0,0.0,,2018,9,26,PAYEMENT,44356.0,M2140138909
26917,1196428',2018-09-26,FDRL/NATIONAL ELECTRONIC F,35962.0,0.0,,2018,9,26,CASH_OUT,35962.0,C1069568462
26918,1196428',2018-09-26,FDRL/NATIONAL ELECTRONIC F,33536.0,0.0,,2018,9,26,CASH_OUT,33536.0,M1674658176
26919,1196428',2018-09-26,FDRL/INTERNAL FUND TRANSFE,40680.0,0.0,,2018,9,26,CHECK_WITHDRAWAL,40680.0,C1243393970
26920,1196428',2018-09-26,FDRL/NATIONAL ELECTRONIC F,31595.0,0.0,,2018,9,26,CASH_OUT,31595.0,C643021151
26921,1196428',2018-09-26,FDRL/NATIONAL ELECTRONIC F,34258.0,0.0,,2018,9,26,PAYEMENT,34258.0,C1792199533
26922,1196428',2018-09-26,NEFT/N269180640234156/TEC,0.0,300000.0,,2018,9,26,CASH_IN,300000.0,C401067111
26923,1196428',2018-09-26,FDRL/NATIONAL ELECTRONIC F,2000000.0,0.0,,2018,9,26,DEBIT,2000000.0,M2092275478
26924,1196428',2018-09-26,NEFT/000052794004/Indiaforensic,0.0,2000000.0,,2018,9,26,TRANSFER,2000000.0,C1876351111
26925,1196428',2018-09-26,TRF FROM  Indiaforensic SERVICES,0.0,10000000.0,,2018,9,26,CHECK_CASHING,10000000.0,M1939586068
26926,1196428',2018-09-26,TRF FROM  Indiaforensic SERVICES,0.0,500000.0,,2018,9,26,CASH_IN,500000.0,C1827845688
26927,1196428',2018-09-26,FDRL/NATIONAL ELECTRONIC F,3000000.0,0.0,,2018,9,26,PAYEMENT,3000000.0,C1653433120
26928,1196428',2018-09-26,FDRL/NATIONAL ELECTRONIC F,2000000.0,0.0,,2018,9,26,DEBIT,2000000.0,M248549685
26929,1196428',2018-09-26,FDRL/INTERNAL FUND TRANSFE,34118.0,0.0,,2018,9,26,DEBIT,34118.0,C699539366
26930,1196428',2018-09-26,FDRL/NATIONAL ELECTRONIC F,94774.0,0.0,,2018,9,26,PAYEMENT,94774.0,M1847777116
26931,1196428',2018-09-26,FDRL/INTERNAL FUND TRANSFE,1000000.0,0.0,,2018,9,26,CHECK_WITHDRAWAL,1000000.0,M1624421807
26932,1196428',2018-09-26,FDRL/INTERNAL FUND TRANSFE,5000000.0,0.0,,2018,9,26,CASH_OUT,5000000.0,C256125761
26933,1196428',2018-09-26,FDRL/INTERNAL FUND TRANSFE,500000.0,0.0,,2018,9,26,PAYEMENT,500000.0,M1581387813
26934,1196428',2018-09-26,FDRL/INTERNAL FUND TRANSFE,500000.0,0.0,,2018,9,26,PAYEMENT,500000.0,C414821585
26935,1196428',2018-09-26,TRF TO  Indiaforensic SERVICES I,129225.0,0.0,,2018,9,26,PAYEMENT,129225.0,C972765878
26936,1196428',2018-09-26,TRF FROM  Indiaforensic SERVICES,0.0,600000.0,,2018,9,26,CASH_IN,600000.0,C365212068
26937,1196428',2018-09-26,TRF FROM  Indiaforensic SERVICES,0.0,800000.0,,2018,9,26,CHECK_CASHING,800000.0,M1980128232
26938,1196428',2018-09-26,FDRL/INTERNAL FUND TRANSFE,1000000.0,0.0,,2018,9,26,CHECK_WITHDRAWAL,1000000.0,M632223310
26939,1196428',2018-09-26,BEAT CSH PKP DEL UDYOG 72,0.0,87000.0,,2018,9,26,CASH_IN,87000.0,M424345420
26940,1196428',2018-09-27,Indiaforensic SERVICES INDIA PVT,0.0,98827.0,,2018,9,27,TRANSFER,98827.0,M496751014
26941,1196428',2018-09-27,FDRL/INTERNAL FUND TRANSFE,1000000.0,0.0,,2018,9,27,CASH_OUT,1000000.0,M937859966
26942,1196428',2018-09-27,CHQ DEP/432/OWDEL2/HDFC/,0.0,11800.0,,2018,9,27,TRANSFER,11800.0,M295162875
26943,1196428',2018-09-27,IMPS 827013105641 FROM PU,0.0,30000.0,,2018,9,27,CASH_IN,30000.0,C265108079
26944,1196428',2018-09-27,NEFT/N270180640702900/USH,0.0,100000.0,,2018,9,27,TRANSFER,100000.0,M1831314308
26945,1196428',2018-09-27,RTGS/SBINH18270037394/Indfor,0.0,9300000.0,,2018,9,27,CASH_IN,9300000.0,C566698125
26946,1196428',2018-09-27,NEFT/BARBT18270774511/MAK,0.0,50550.0,,2018,9,27,TRANSFER,50550.0,M861018002
26947,1196428',2018-09-27,TRF FROM  Indiaforensic SERVICES,0.0,7100000.0,,2018,9,27,CHECK_CASHING,7100000.0,C683605346
26948,1196428',2018-09-27,FDRL/NATIONAL ELECTRONIC F,10000000.0,0.0,,2018,9,27,DEBIT,10000000.0,C97730845
26949,1196428',2018-09-27,FDRL/NATIONAL ELECTRONIC F,5496030.08,0.0,,2018,9,27,PAYEMENT,5496030.08,C1940189108
26950,1196428',2018-09-27,FDRL/NATIONAL ELECTRONIC F,2500.0,0.0,,2018,9,27,CASH_OUT,2500.0,C1923206317
26951,1196428',2018-09-27,FDRL/NATIONAL ELECTRONIC F,2500.0,0.0,,2018,9,27,CASH_OUT,2500.0,C1302931951
26952,1196428',2018-09-27,FDRL/NATIONAL ELECTRONIC F,2500.0,0.0,,2018,9,27,PAYEMENT,2500.0,C662267010
26953,1196428',2018-09-27,FDRL/NATIONAL ELECTRONIC F,2500.0,0.0,,2018,9,27,DEBIT,2500.0,C306206744
26954,1196428',2018-09-27,FDRL/NATIONAL ELECTRONIC F,2500.0,0.0,,2018,9,27,CHECK_WITHDRAWAL,2500.0,C209813603
26955,1196428',2018-09-27,FDRL/NATIONAL ELECTRONIC F,5000.0,0.0,,2018,9,27,CHECK_WITHDRAWAL,5000.0,C128870695
26956,1196428',2018-09-27,FDRL/NATIONAL ELECTRONIC F,2500.0,0.0,,2018,9,27,CASH_OUT,2500.0,C85102332
26957,1196428',2018-09-27,FDRL/NATIONAL ELECTRONIC F,5000.0,0.0,,2018,9,27,CHECK_WITHDRAWAL,5000.0,C1540270363
26958,1196428',2018-09-27,FDRL/NATIONAL ELECTRONIC F,2000.0,0.0,,2018,9,27,CHECK_WITHDRAWAL,2000.0,C2033711470
26959,1196428',2018-09-27,FDRL/NATIONAL ELECTRONIC F,2000.0,0.0,,2018,9,27,CHECK_WITHDRAWAL,2000.0,C392292416
26960,1196428',2018-09-27,FDRL/NATIONAL ELECTRONIC F,2500.0,0.0,,2018,9,27,PAYEMENT,2500.0,C620638596
26961,1196428',2018-09-27,FDRL/NATIONAL ELECTRONIC F,3000.0,0.0,,2018,9,27,DEBIT,3000.0,C1014255081
26962,1196428',2018-09-27,FDRL/NATIONAL ELECTRONIC F,2500.0,0.0,,2018,9,27,CHECK_WITHDRAWAL,2500.0,C648604330
26963,1196428',2018-09-27,FDRL/NATIONAL ELECTRONIC F,2500.0,0.0,,2018,9,27,DEBIT,2500.0,C1464984894
26964,1196428',2018-09-27,Indiaforensic SERVICES INDIA PVT,0.0,128178.0,,2018,9,27,CASH_IN,128178.0,C811597470
26965,1196428',2018-09-27,RTGS/ICICH18270740141/Indfor,0.0,1800000.0,,2018,9,27,CASH_IN,1800000.0,C766671686
26966,1196428',2018-09-27,FDRL/NATIONAL ELECTRONIC F,3000000.0,0.0,,2018,9,27,CHECK_WITHDRAWAL,3000000.0,C898762325
26967,1196428',2018-09-27,IMPS 827016742995 FROM OX,0.0,200000.0,,2018,9,27,CHECK_CASHING,200000.0,C1271057169
26968,1196428',2018-09-27,CASHPMT/GURGAON/SELF,49000.0,0.0,,2018,9,27,PAYEMENT,49000.0,C1635341595
26969,1196428',2018-09-27,NEFT/IOBAN18270560620/K,0.0,2500.0,,2018,9,27,TRANSFER,2500.0,C406477119
26970,1196428',2018-09-27,NEFT/N270180641130154/BAT,0.0,250000.0,,2018,9,27,CASH_IN,250000.0,C1963862935
26971,1196428',2018-09-27,TRF FROM  Indiaforensic SERVICES,0.0,5000000.0,,2018,9,27,CHECK_CASHING,5000000.0,C1703397679
26972,1196428',2018-09-27,FDRL/INTERNAL FUND TRANSFE,500000.0,0.0,,2018,9,27,PAYEMENT,500000.0,C1379289710
26973,1196428',2018-09-27,FDRL/INTERNAL FUND TRANSFE,500000.0,0.0,,2018,9,27,CHECK_WITHDRAWAL,500000.0,C1369695156
26974,1196428',2018-09-27,FDRL/INTERNAL FUND TRANSFE,500000.0,0.0,,2018,9,27,DEBIT,500000.0,C384735911
26975,1196428',2018-09-27,FDRL/INTERNAL FUND TRANSFE,3000000.0,0.0,,2018,9,27,PAYEMENT,3000000.0,M739259593
26976,1196428',2018-09-27,TRF FROM  Indiaforensic SERVICES,0.0,1300000.0,,2018,9,27,TRANSFER,1300000.0,C800523009
26977,1196428',2018-09-27,FDRL/INTERNAL FUND TRANSFE,1000000.0,0.0,,2018,9,27,CHECK_WITHDRAWAL,1000000.0,M1033636535
26978,1196428',2018-09-27,TRF TO  Indiaforensic SERVICES I,407100.0,0.0,,2018,9,27,PAYEMENT,407100.0,M1138060675
26979,1196428',2018-09-27,TRF FROM  Indiaforensic SERVICES,0.0,600000.0,,2018,9,27,CHECK_CASHING,600000.0,C1656107232
26980,1196428',2018-09-27,FDRL/INTERNAL FUND TRANSFE,1000000.0,0.0,,2018,9,27,DEBIT,1000000.0,M935832500
26981,1196428',2018-09-27,TRF FROM  Indiaforensic SERVICES,0.0,3000000.0,,2018,9,27,CHECK_CASHING,3000000.0,C711248671
26982,1196428',2018-09-27,BEAT CSH PKP DEL UDYOG 72,0.0,34000.0,,2018,9,27,CASH_IN,34000.0,C1379289710
26983,1196428',2018-09-28,FDRL/INTERNAL FUND TRANSFE,2000000.0,0.0,,2018,9,28,CASH_OUT,2000000.0,C842729010
26984,1196428',2018-09-28,FDRL/INTERNAL FUND TRANSFE,500000.0,0.0,,2018,9,28,PAYEMENT,500000.0,C1765998352
26985,1196428',2018-09-28,IMPS 827110291678 FROM SA,0.0,200000.0,,2018,9,28,CHECK_CASHING,200000.0,C142211154
26986,1196428',2018-09-28,FDRL/INTERNAL FUND TRANSFE,1000000.0,0.0,,2018,9,28,DEBIT,1000000.0,C185353840
26987,1196428',2018-09-28,TRF FROM  Indiaforensic SERVICES,0.0,500000.0,,2018,9,28,CHECK_CASHING,500000.0,C2078250226
26988,1196428',2018-09-28,DHL EXPRESS INDIA PVT LTD,8870.0,0.0,,2018,9,28,CHECK_WITHDRAWAL,8870.0,C787040724
26989,1196428',2018-09-28,RTGS/HDFCH18271910153/Indfor,0.0,2600000.0,,2018,9,28,CASH_IN,2600000.0,C1532153384
26990,1196428',2018-09-28,NEFT/PUNBH18271727336/BAL,0.0,50000.0,,2018,9,28,CASH_IN,50000.0,C2145319283
26991,1196428',2018-09-28,RTGS/SBINH18271065993/Indfor,0.0,8000000.0,,2018,9,28,CHECK_CASHING,8000000.0,C711248671
26992,1196428',2018-09-28,NEFT/N271180642049915/ARI,0.0,11800.0,,2018,9,28,TRANSFER,11800.0,C1945802665
26993,1196428',2018-09-28,Indiaforensic SERVICES INDIA PVT,0.0,120266.0,,2018,9,28,TRANSFER,120266.0,C1805683209
26994,1196428',2018-09-28,RTGS/ICICH18271886057/Indfor,0.0,1300000.0,,2018,9,28,TRANSFER,1300000.0,M621053594
26995,1196428',2018-09-28,"Indiaforensic USA, INC./USD/5276",0.0,3803996.0,,2018,9,28,CHECK_CASHING,3803996.0,M1211716631
26996,1196428',2018-09-28,IRTT00701828001,1789.72,0.0,,2018,9,28,PAYEMENT,1789.72,C1761353343
26997,1196428',2018-09-28,IMPS 827116061266 FROM OX,0.0,200000.0,,2018,9,28,CASH_IN,200000.0,C1327907419
26998,1196428',2018-09-28,IMPS 827116061311 FROM OX,0.0,200000.0,,2018,9,28,CASH_IN,200000.0,M721447636
26999,1196428',2018-09-28,IMPS 827116061358 FROM OX,0.0,200000.0,,2018,9,28,TRANSFER,200000.0,M566452877
27000,1196428',2018-09-28,IMPS 827116061418 FROM OX,0.0,200000.0,,2018,9,28,CASH_IN,200000.0,M2013745474
27001,1196428',2018-09-28,IMPS 827116061478 FROM OX,0.0,200000.0,,2018,9,28,TRANSFER,200000.0,M1013425965
27002,1196428',2018-09-28,IMPS 827116061529 FROM OX,0.0,200000.0,,2018,9,28,TRANSFER,200000.0,M1618306297
27003,1196428',2018-09-28,IMPS 827116061580 FROM OX,0.0,200000.0,,2018,9,28,TRANSFER,200000.0,M883328243
27004,1196428',2018-09-28,FDRL/NATIONAL ELECTRONIC F,4155728.89,0.0,,2018,9,28,DEBIT,4155728.89,C1014935920
27005,1196428',2018-09-28,FDRL/NATIONAL ELECTRONIC F,10000000.0,0.0,,2018,9,28,CASH_OUT,10000000.0,M1963915749
27006,1196428',2018-09-28,FDRL/NATIONAL ELECTRONIC F,1000000.0,0.0,,2018,9,28,CASH_OUT,1000000.0,M1182424061
27007,1196428',2018-09-28,FDRL/NATIONAL ELECTRONIC F,1000000.0,0.0,,2018,9,28,DEBIT,1000000.0,M1944067111
27008,1196428',2018-09-28,FDRL/NATIONAL ELECTRONIC F,1000000.0,0.0,,2018,9,28,CASH_OUT,1000000.0,C2030493231
27009,1196428',2018-09-28,NEFT/N271180642313604/TEC,0.0,100000.0,,2018,9,28,CHECK_CASHING,100000.0,M6219287
27010,1196428',2018-09-28,TRF FROM  Indiaforensic SERVICES,0.0,9500000.0,,2018,9,28,CHECK_CASHING,9500000.0,M764466514
27011,1196428',2018-09-28,TRF FROM  Indiaforensic SERVICES,0.0,300000.0,,2018,9,28,CHECK_CASHING,300000.0,M416793289
27012,1196428',2018-09-28,TRF FROM  Indiaforensic SERVICES,0.0,1000000.0,,2018,9,28,CASH_IN,1000000.0,M644292702
27013,1196428',2018-09-28,TRF FROM  Indiaforensic SERVICES,0.0,500000.0,,2018,9,28,CHECK_CASHING,500000.0,C795982694
27014,1196428',2018-09-28,FDRL/INTERNAL FUND TRANSFE,2000000.0,0.0,,2018,9,28,PAYEMENT,2000000.0,C1896985362
27015,1196428',2018-09-28,FDRL/INTERNAL FUND TRANSFE,100000.0,0.0,,2018,9,28,CASH_OUT,100000.0,C1348373832
27016,1196428',2018-09-28,FDRL/INTERNAL FUND TRANSFE,500000.0,0.0,,2018,9,28,CASH_OUT,500000.0,C2078250226
27017,1196428',2018-09-28,FDRL/INTERNAL FUND TRANSFE,500000.0,0.0,,2018,9,28,CHECK_WITHDRAWAL,500000.0,C11003494
27018,1196428',2018-09-28,FDRL/INTERNAL FUND TRANSFE,500000.0,0.0,,2018,9,28,PAYEMENT,500000.0,C1647754924
27019,1196428',2018-09-28,FDRL/INTERNAL FUND TRANSFE,5000000.0,0.0,,2018,9,28,PAYEMENT,5000000.0,M1850575372
27020,1196428',2018-09-28,FDRL/INTERNAL FUND TRANSFE,500000.0,0.0,,2018,9,28,DEBIT,500000.0,C44870833
27021,1196428',2018-09-28,TRF FROM  Indiaforensic SERVICES,0.0,500000.0,,2018,9,28,CASH_IN,500000.0,C1149273771
27022,1196428',2018-09-28,BEAT CSH PKP DEL UDYOG 72,0.0,111000.0,,2018,9,28,TRANSFER,111000.0,C1730752455
27023,1196428',2018-09-29,NEFT/N272180642710697/USH,0.0,40000.0,,2018,9,29,TRANSFER,40000.0,C1754722089
27024,1196428',2018-09-29,NEFT/SBIN318272577599/TAR,0.0,195000.0,,2018,9,29,TRANSFER,195000.0,C2022973332
27025,1196428',2018-09-29,FDRL/INTERNAL FUND TRANSFE,100000.0,0.0,,2018,9,29,DEBIT,100000.0,C847552559
27026,1196428',2018-09-29,FDRL/INTERNAL FUND TRANSFE,2000000.0,0.0,,2018,9,29,CHECK_WITHDRAWAL,2000000.0,M70859399
27027,1196428',2018-09-29,CHQ DEP/953968/OWDEL1/SBI,0.0,15000.0,,2018,9,29,CHECK_CASHING,15000.0,M256438526
27028,1196428',2018-09-29,AWARDS AND BRAND MERCHAND,3860.0,0.0,,2018,9,29,CASH_OUT,3860.0,C969409298
27029,1196428',2018-09-29,TRF FROM  Indiaforensic SERVICES,0.0,5000000.0,,2018,9,29,TRANSFER,5000000.0,M1993135133
27030,1196428',2018-09-29,TRF FROM  Indiaforensic SERVICES,0.0,1000000.0,,2018,9,29,CHECK_CASHING,1000000.0,C832279283
27031,1196428',2018-09-29,TRF FROM  Indiaforensic SERVICES,0.0,500000.0,,2018,9,29,CHECK_CASHING,500000.0,C415155691
27032,1196428',2018-09-29,FDRL/REAL TIME GROSS SETTL,3000000.0,0.0,,2018,9,29,PAYEMENT,3000000.0,M1693216057
27033,1196428',2018-09-29,FDRL/REAL TIME GROSS SETTL,5000000.0,0.0,,2018,9,29,CHECK_WITHDRAWAL,5000000.0,C1079491260
27034,1196428',2018-09-29,RTGS/HDFCH18272129335/Indfor,0.0,2900000.0,,2018,9,29,CHECK_CASHING,2900000.0,C681419196
27035,1196428',2018-09-29,FDRL/REAL TIME GROSS SETTL,3000000.0,0.0,,2018,9,29,DEBIT,3000000.0,C766950017
27036,1196428',2018-09-29,NEFT/000052993681/Indiaforensic,0.0,500000.0,,2018,9,29,TRANSFER,500000.0,M1969507672
27037,1196428',2018-09-29,TRF FRM  Indiaforensic SERVICES,0.0,500000.0,,2018,9,29,CASH_IN,500000.0,C796028148
27038,1196428',2018-09-29,TRF FRM  Indiaforensic SERVICES,0.0,5000000.0,,2018,9,29,CASH_IN,5000000.0,M721267463
27039,1196428',2018-09-29,TRF FRM  Indiaforensic SERVICES,0.0,1000000.0,,2018,9,29,CASH_IN,1000000.0,C1216820233
27040,1196428',2018-09-29,TRF FRM  Indiaforensic SERVICES,0.0,500000.0,,2018,9,29,CHECK_CASHING,500000.0,C2121831742
27041,1196428',2018-09-29,FDRL/INTERNAL FUND TRANSFE,2000000.0,0.0,,2018,9,29,CASH_OUT,2000000.0,C1427825258
27042,1196428',2018-09-29,FDRL/INTERNAL FUND TRANSFE,2000000.0,0.0,,2018,9,29,DEBIT,2000000.0,M298561927
27043,1196428',2018-09-29,FDRL/INTERNAL FUND TRANSFE,3000000.0,0.0,,2018,9,29,DEBIT,3000000.0,M2132781699
27044,1196428',2018-09-29,NEFT/000052995510/Indiaforensic,0.0,3090000.0,,2018,9,29,CASH_IN,3090000.0,C801777708
27045,1196428',2018-09-29,TRF FROM  Indiaforensic SERVICES,0.0,5000000.0,,2018,9,29,CHECK_CASHING,5000000.0,M393000117
27046,1196428',2018-09-29,BEAT CSH PKP DEL UDYOG 72,0.0,55000.0,,2018,9,29,CASH_IN,55000.0,M15686276
27047,1196428',2018-09-30,1196428:Int.Coll:01-09-20,807998.0,0.0,,2018,9,30,PAYEMENT,807998.0,M1975310099
27048,1196428',2018-10-01,RTGS/HDFCH18274208254/BAT,0.0,260000.0,,2018,10,1,CHECK_CASHING,260000.0,M807196799
27049,1196428',2018-10-01,RTGS/UTIBH18274656657/Indfor,0.0,1000000.0,,2018,10,1,CHECK_CASHING,1000000.0,M471978974
27050,1196428',2018-10-01,RTGS/SBINH18274010577/Indfor,0.0,5800000.0,,2018,10,1,CASH_IN,5800000.0,C1311325237
27051,1196428',2018-10-01,FDRL/NATIONAL ELECTRONIC F,14401241.36,0.0,,2018,10,1,PAYEMENT,14401241.36,M1469278723
27052,1196428',2018-10-01,FDRL/INTERNAL FUND TRANSFE,500000.0,0.0,,2018,10,1,CASH_OUT,500000.0,M425737632
27053,1196428',2018-10-01,NEFT/SBIN518274041276/MR,0.0,100000.0,,2018,10,1,CHECK_CASHING,100000.0,M274848935
27054,1196428',2018-10-01,IMPS 827413008717 FROM SA,0.0,100000.0,,2018,10,1,TRANSFER,100000.0,M974661879
27055,1196428',2018-10-01,TRF FROM  Indiaforensic SERVICES,0.0,4000000.0,,2018,10,1,TRANSFER,4000000.0,M191999807
27056,1196428',2018-10-01,TRF FROM  Indiaforensic SERVICES,0.0,5000000.0,,2018,10,1,TRANSFER,5000000.0,M1048035699
27057,1196428',2018-10-01,TRF FROM  Indiaforensic SERVICES,0.0,3000000.0,,2018,10,1,CASH_IN,3000000.0,C1921483039
27058,1196428',2018-10-01,IMPS 827414119277 FROM PU,0.0,20000.0,,2018,10,1,TRANSFER,20000.0,C1848270947
27059,1196428',2018-10-01,IRTT00701828232,1697.76,0.0,,2018,10,1,CHECK_WITHDRAWAL,1697.76,M787544355
27060,1196428',2018-10-01,"Indiaforensic USA, INC./USD/4548",0.0,3293114.0,,2018,10,1,CHECK_CASHING,3293114.0,C902020892
27061,1196428',2018-10-01,FDRL/INTERNAL FUND TRANSFE,2500000.0,0.0,,2018,10,1,CHECK_WITHDRAWAL,2500000.0,M311334770
27062,1196428',2018-10-01,FDRL/INTERNAL FUND TRANSFE,2000000.0,0.0,,2018,10,1,CASH_OUT,2000000.0,M93651430
27063,1196428',2018-10-01,FDRL/INTERNAL FUND TRANSFE,2500000.0,0.0,,2018,10,1,DEBIT,2500000.0,C1930186237
27064,1196428',2018-10-01,IMPS 827415374087 FROM AS,0.0,90190.0,,2018,10,1,TRANSFER,90190.0,M1379527651
27065,1196428',2018-10-01,CASHDEP/GHATKOPAR/,0.0,91500.0,,2018,10,1,CHECK_CASHING,91500.0,M356067659
27066,1196428',2018-10-01,FDRL/NATIONAL ELECTRONIC F,673633.0,0.0,,2018,10,1,DEBIT,673633.0,C1079491260
27067,1196428',2018-10-01,RTGS/ICICH18274441602/Indfor,0.0,500000.0,,2018,10,1,TRANSFER,500000.0,M275199537
27068,1196428',2018-10-01,TRF FRM  Indiaforensic SERVICES,0.0,15000000.0,,2018,10,1,TRANSFER,15000000.0,C2106643654
27069,1196428',2018-10-01,TRF FRM  Indiaforensic SERVICES,0.0,7400000.0,,2018,10,1,CASH_IN,7400000.0,M224044153
27070,1196428',2018-10-01,TRF FRM  Indiaforensic SERVICES,0.0,800000.0,,2018,10,1,CASH_IN,800000.0,M701513664
27071,1196428',2018-10-01,TRF TO  Indiaforensic SERVICES I,82600.0,0.0,,2018,10,1,CASH_OUT,82600.0,C967425740
27072,1196428',2018-10-01,FDRL/NATIONAL ELECTRONIC F,65054.0,0.0,,2018,10,1,CASH_OUT,65054.0,M279462920
27073,1196428',2018-10-01,FDRL/NATIONAL ELECTRONIC F,82815.0,0.0,,2018,10,1,CASH_OUT,82815.0,C1044117371
27074,1196428',2018-10-01,FDRL/NATIONAL ELECTRONIC F,66998.0,0.0,,2018,10,1,PAYEMENT,66998.0,C2067466390
27075,1196428',2018-10-01,FDRL/NATIONAL ELECTRONIC F,69353.0,0.0,,2018,10,1,DEBIT,69353.0,M980415668
27076,1196428',2018-10-01,FDRL/NATIONAL ELECTRONIC F,56493.0,0.0,,2018,10,1,CHECK_WITHDRAWAL,56493.0,C824197891
27077,1196428',2018-10-01,TRF FROM  Indiaforensic SERVICES,0.0,1600000.0,,2018,10,1,TRANSFER,1600000.0,C1891412311
27078,1196428',2018-10-01,FDRL/NATIONAL ELECTRONIC F,14496982.08,0.0,,2018,10,1,CHECK_WITHDRAWAL,14496982.08,C1023535667
27079,1196428',2018-10-01,FDRL/NATIONAL ELECTRONIC F,11863128.18,0.0,,2018,10,1,DEBIT,11863128.18,C220204350
27080,1196428',2018-10-01,FDRL/INTERNAL FUND TRANSFE,0.0,2000000.0,,2018,10,1,CASH_IN,2000000.0,M1542490767
27081,1196428',2018-10-01,FDRL/INTERNAL FUND TRANSFE,6000000.0,0.0,,2018,10,1,PAYEMENT,6000000.0,M1647072210
27082,1196428',2018-10-01,FDRL/INTERNAL FUND TRANSFE,2000000.0,0.0,,2018,10,1,CHECK_WITHDRAWAL,2000000.0,M1645624567
27083,1196428',2018-10-01,NEFT/AT0110FIXED23033/FIX,0.0,500000.0,,2018,10,1,CHECK_CASHING,500000.0,C506903242
27084,1196428',2018-10-01,BEAT CSH PKP DEL UDYOG 72,0.0,103400.0,,2018,10,1,CHECK_CASHING,103400.0,M2072059657
27085,1196428',2018-10-01,NEFT/20734858711DC/ARTHAS,0.0,25000.0,,2018,10,1,CASH_IN,25000.0,C304406966
27086,1196428',2018-10-01,NEFT/SBIN518274940738/Indfor,0.0,11400000.0,,2018,10,1,CHECK_CASHING,11400000.0,C75629578
27087,1196428',2018-10-01,NEFT/N274180645314676/TEC,0.0,200000.0,,2018,10,1,CHECK_CASHING,200000.0,M1037398211
27088,1196428',2018-10-03,RTGS/PUNBH18276724817/BAL,0.0,200000.0,,2018,10,3,CHECK_CASHING,200000.0,C2072030256
27089,1196428',2018-10-03,NEFT/N276180645608675/BAT,0.0,175000.0,,2018,10,3,CASH_IN,175000.0,C886888353
27090,1196428',2018-10-03,FDRL/INTERNAL FUND TRANSFE,2000000.0,0.0,,2018,10,3,CHECK_WITHDRAWAL,2000000.0,C701279123
27091,1196428',2018-10-03,FDRL/REAL TIME GROSS SETTL,10000000.0,0.0,,2018,10,3,CHECK_WITHDRAWAL,10000000.0,C864016033
27092,1196428',2018-10-03,FDRL/INTERNAL FUND TRANSFE,500000.0,0.0,,2018,10,3,DEBIT,500000.0,C515442419
27093,1196428',2018-10-03,TATA TELE SERVICES LTD,3175.0,0.0,,2018,10,3,DEBIT,3175.0,M2127093801
27094,1196428',2018-10-03,IRTT00701828400,2251.9,0.0,,2018,10,3,PAYEMENT,2251.9,C1649686970
27095,1196428',2018-10-03,"Indiaforensic USA, INC./USD/8758",0.0,6371663.25,,2018,10,3,CHECK_CASHING,6371663.25,C701855966
27096,1196428',2018-10-03,RTGS/ICICH18276562916/Indfor,0.0,2000000.0,,2018,10,3,CASH_IN,2000000.0,C1505217516
27097,1196428',2018-10-03,FDRL/REAL TIME GROSS SETTL,3000000.0,0.0,,2018,10,3,CHECK_WITHDRAWAL,3000000.0,M676875212
27098,1196428',2018-10-03,FDRL/REAL TIME GROSS SETTL,5000000.0,0.0,,2018,10,3,CASH_OUT,5000000.0,C681709819
27099,1196428',2018-10-03,TRF FROM  Indiaforensic SERVICES,0.0,12200000.0,,2018,10,3,TRANSFER,12200000.0,M1025042585
27100,1196428',2018-10-03,FDRL/NATIONAL ELECTRONIC F,12190010.37,0.0,,2018,10,3,DEBIT,12190010.37,C807247901
27101,1196428',2018-10-03,NEFT/SBIN618276948131/RID,0.0,11800.0,,2018,10,3,CHECK_CASHING,11800.0,M18308448
27102,1196428',2018-10-03,NEFT/PUNBH18276343268/RAT,0.0,60000.0,,2018,10,3,CHECK_CASHING,60000.0,M170030714
27103,1196428',2018-10-03,FDRL/NATIONAL ELECTRONIC F,1000000.0,0.0,,2018,10,3,PAYEMENT,1000000.0,M621155607
27104,1196428',2018-10-03,NEFT/N276180646152192/MAL,0.0,8000.0,,2018,10,3,CASH_IN,8000.0,C1660095722
27105,1196428',2018-10-03,CASHDEP/GHATKOPAR/,0.0,74000.0,,2018,10,3,TRANSFER,74000.0,M1571765149
27106,1196428',2018-10-03,TRF FROM  Indiaforensic SERVICES,0.0,12200000.0,,2018,10,3,TRANSFER,12200000.0,C1663686815
27107,1196428',2018-10-03,FDRL/NATIONAL ELECTRONIC F,11805782.83,0.0,,2018,10,3,CHECK_WITHDRAWAL,11805782.83,M279824269
27108,1196428',2018-10-03,FD Booking 709005421635,635000.0,0.0,,2018,10,3,DEBIT,635000.0,M1570490488
27109,1196428',2018-10-03,NEFT/000053179803/Indiaforensic,0.0,500000.0,,2018,10,3,CHECK_CASHING,500000.0,M1063002743
27110,1196428',2018-10-03,NEFT/SBIN718276396713/TAR,0.0,190000.0,,2018,10,3,CASH_IN,190000.0,M1530195938
27111,1196428',2018-10-03,NEFT/000053183673/Indiaforensic,0.0,3000000.0,,2018,10,3,CASH_IN,3000000.0,C1883840933
27112,1196428',2018-10-03,TRF FROM  Indiaforensic SERVICES,0.0,1800000.0,,2018,10,3,TRANSFER,1800000.0,M2097586567
27113,1196428',2018-10-03,TRF FROM  Indiaforensic SERVICES,0.0,4200000.0,,2018,10,3,TRANSFER,4200000.0,C1700852615
27114,1196428',2018-10-03,BEAT CSH PKP DEL GURG 727,0.0,105500.0,,2018,10,3,CHECK_CASHING,105500.0,C1457728035
27115,1196428',2018-10-03,FDRL/INTERNAL FUND TRANSFE,500000.0,0.0,,2018,10,3,PAYEMENT,500000.0,C47249488
27116,1196428',2018-10-03,FDRL/INTERNAL FUND TRANSFE,3000000.0,0.0,,2018,10,3,CHECK_WITHDRAWAL,3000000.0,C33524623
27117,1196428',2018-10-03,FDRL/INTERNAL FUND TRANSFE,500000.0,0.0,,2018,10,3,PAYEMENT,500000.0,C2133591152
27118,1196428',2018-10-03,FDRL/INTERNAL FUND TRANSFE,3000000.0,0.0,,2018,10,3,PAYEMENT,3000000.0,C193864812
27119,1196428',2018-10-03,IMLCU0070181423:Letter of,22415.0,0.0,,2018,10,3,CASH_OUT,22415.0,C1058921154
27120,1196428',2018-10-03,IMLCU0070181423:Letter of,5804.7,0.0,,2018,10,3,CASH_OUT,5804.7,C798678484
27121,1196428',2018-10-04,Indiaforensic SERVICES INDIA PVT,0.0,414089.0,,2018,10,4,CHECK_CASHING,414089.0,C769342184
27122,1196428',2018-10-04,TRF FROM  Indiaforensic SERVICES,0.0,8500000.0,,2018,10,4,TRANSFER,8500000.0,C981198566
27123,1196428',2018-10-04,RTGS/ICICH18277673046/Indfor,0.0,500000.0,,2018,10,4,CHECK_CASHING,500000.0,C1281898359
27124,1196428',2018-10-04,RTGS/ICICH18277672910/Indfor,0.0,1000000.0,,2018,10,4,CHECK_CASHING,1000000.0,C30013970
27125,1196428',2018-10-04,FDRL/INTERNAL FUND TRANSFE,5000000.0,0.0,,2018,10,4,PAYEMENT,5000000.0,C31789747
27126,1196428',2018-10-04,FDRL/NATIONAL ELECTRONIC F,4000000.0,0.0,,2018,10,4,CASH_OUT,4000000.0,C93518808
27127,1196428',2018-10-04,FDRL/NATIONAL ELECTRONIC F,4000000.0,0.0,,2018,10,4,DEBIT,4000000.0,C2093546827
27128,1196428',2018-10-04,CASHDEP/NERUL/,0.0,20000.0,,2018,10,4,CHECK_CASHING,20000.0,C976133979
27129,1196428',2018-10-04,TRF FROM  Indiaforensic SERVICES,0.0,3800000.0,,2018,10,4,TRANSFER,3800000.0,C849038219
27130,1196428',2018-10-04,NEFT/N277180647347603/JUN,0.0,180000.0,,2018,10,4,CHECK_CASHING,180000.0,C1789550256
27131,1196428',2018-10-04,FDRL/REAL TIME GROSS SETTL,3000000.0,0.0,,2018,10,4,CASH_OUT,3000000.0,C363475076
27132,1196428',2018-10-04,NEFT/BARBW18277919469/SIN,0.0,11800.0,,2018,10,4,CASH_IN,11800.0,C2110623348
27133,1196428',2018-10-04,Indiaforensic SERVICES INDIA PVT,0.0,117758.0,,2018,10,4,CASH_IN,117758.0,C1161820020
27134,1196428',2018-10-04,FDRL/NATIONAL ELECTRONIC F,31240.0,0.0,,2018,10,4,CASH_OUT,31240.0,C627675433
27135,1196428',2018-10-04,FDRL/NATIONAL ELECTRONIC F,10932.0,0.0,,2018,10,4,CASH_OUT,10932.0,C1145835418
27136,1196428',2018-10-04,TRF FROM  Indiaforensic SERVICES,0.0,13400000.0,,2018,10,4,CHECK_CASHING,13400000.0,C1778300121
27137,1196428',2018-10-04,FDRL/INTERNAL FUND TRANSFE,300000.0,0.0,,2018,10,4,PAYEMENT,300000.0,C1325626015
27138,1196428',2018-10-04,IMPS 827717895859 FROM SA,0.0,200000.0,,2018,10,4,CASH_IN,200000.0,C8733802
27139,1196428',2018-10-04,FDRL/NATIONAL ELECTRONIC F,10000000.0,0.0,,2018,10,4,PAYEMENT,10000000.0,C990053853
27140,1196428',2018-10-04,NEFT/000053262627/Indiaforensic,0.0,600000.0,,2018,10,4,CHECK_CASHING,600000.0,C218193338
27141,1196428',2018-10-04,NEFT/000053262895/Indiaforensic,0.0,500000.0,,2018,10,4,TRANSFER,500000.0,M832073005
27142,1196428',2018-10-04,FDRL/NATIONAL ELECTRONIC F,2139279.4,0.0,,2018,10,4,CASH_OUT,2139279.4,M189083850
27143,1196428',2018-10-04,FDRL/INTERNAL FUND TRANSFE,2000000.0,0.0,,2018,10,4,CHECK_WITHDRAWAL,2000000.0,C103357744
27144,1196428',2018-10-04,NEFT/FSFBH18277000516/Fin,0.0,150360.0,,2018,10,4,TRANSFER,150360.0,M1942890330
27145,1196428',2018-10-04,TRF FROM  Indiaforensic SERVICES,0.0,1000000.0,,2018,10,4,CASH_IN,1000000.0,C2011941350
27146,1196428',2018-10-04,TRF FROM  Indiaforensic SERVICES,0.0,900000.0,,2018,10,4,TRANSFER,900000.0,C1505755152
27147,1196428',2018-10-04,TRF FROM  Indiaforensic SERVICES,0.0,600000.0,,2018,10,4,CHECK_CASHING,600000.0,M1051118371
27148,1196428',2018-10-04,BEAT CSH PKP DEL GURG 727,0.0,90500.0,,2018,10,4,TRANSFER,90500.0,M1502077581
27149,1196428',2018-10-04,FDRL/INTERNAL FUND TRANSFE,500000.0,0.0,,2018,10,4,CHECK_WITHDRAWAL,500000.0,M1801625172
27150,1196428',2018-10-04,FDRL/INTERNAL FUND TRANSFE,500000.0,0.0,,2018,10,4,PAYEMENT,500000.0,C360898540
27151,1196428',2018-10-04,FDRL/INTERNAL FUND TRANSFE,500000.0,0.0,,2018,10,4,CHECK_WITHDRAWAL,500000.0,M1408738192
27152,1196428',2018-10-04,FDRL/INTERNAL FUND TRANSFE,500000.0,0.0,,2018,10,4,CASH_OUT,500000.0,C237594516
27153,1196428',2018-10-04,FDRL/INTERNAL FUND TRANSFE,500000.0,0.0,,2018,10,4,CASH_OUT,500000.0,M1645271006
27154,1196428',2018-10-04,FDRL/INTERNAL FUND TRANSFE,500000.0,0.0,,2018,10,4,CHECK_WITHDRAWAL,500000.0,M1616707854
27155,1196428',2018-10-04,FDRL/INTERNAL FUND TRANSFE,500000.0,0.0,,2018,10,4,CASH_OUT,500000.0,C1334973394
27156,1196428',2018-10-04,FDRL/INTERNAL FUND TRANSFE,500000.0,0.0,,2018,10,4,CHECK_WITHDRAWAL,500000.0,M1547406846
27157,1196428',2018-10-05,FDRL/INTERNAL FUND TRANSFE,100000.0,0.0,,2018,10,5,DEBIT,100000.0,M51814511
27158,1196428',2018-10-05,TRF FROM Indiaforensic SERVICES,0.0,2200000.0,,2018,10,5,TRANSFER,2200000.0,M1679527434
27159,1196428',2018-10-05,IMPS 827813624134 FROM SA,0.0,200000.0,,2018,10,5,CHECK_CASHING,200000.0,M858729243
27160,1196428',2018-10-05,CHQ DEP/432/OWDEL2/HDFC/B,0.0,11800.0,,2018,10,5,CHECK_CASHING,11800.0,M317858117
27161,1196428',2018-10-05,CHQ DEP/201/OWDEL1/HDFC/H,0.0,11800.0,,2018,10,5,CHECK_CASHING,11800.0,M974232437
27162,1196428',2018-10-05,CHQ DEP/84471/OWDEL1/UTIB,0.0,11800.0,,2018,10,5,TRANSFER,11800.0,M535001108
27163,1196428',2018-10-05,"NETHOPE, INC/USD/40000/73",0.0,2922000.0,,2018,10,5,CHECK_CASHING,2922000.0,M967799453
27164,1196428',2018-10-05,IRTT00701828824,1630.96,0.0,,2018,10,5,CASH_OUT,1630.96,M1704857178
27165,1196428',2018-10-05,"Indiaforensic USA, INC./USD/6612",0.0,4830504.3,,2018,10,5,TRANSFER,4830504.3,M888552844
27166,1196428',2018-10-05,IRTT00701828823,1974.49,0.0,,2018,10,5,CASH_OUT,1974.49,M257269635
27167,1196428',2018-10-05,FDRL/REAL TIME GROSS SETTL,10000000.0,0.0,,2018,10,5,PAYEMENT,10000000.0,C1305075214
27168,1196428',2018-10-05,FDRL/INTERNAL FUND TRANSFE,300000.0,0.0,,2018,10,5,CHECK_WITHDRAWAL,300000.0,C1627965794
27169,1196428',2018-10-05,NEFT/PUNBH18278842272/BAL,0.0,100000.0,,2018,10,5,CASH_IN,100000.0,M1559676676
27170,1196428',2018-10-05,IMPS 827815348101 FROM AS,0.0,120020.0,,2018,10,5,CHECK_CASHING,120020.0,C741431520
27171,1196428',2018-10-05,Indiaforensic SERVICES INDIA PVT,0.0,92333.0,,2018,10,5,CASH_IN,92333.0,C2143477943
27172,1196428',2018-10-05,NEFT/N278180648688019/BAT,0.0,200000.0,,2018,10,5,TRANSFER,200000.0,C638551812
27173,1196428',2018-10-05,NEFT/SBIN918278582717/IND,0.0,625817.9,,2018,10,5,TRANSFER,625817.9,C1027296777
27174,1196428',2018-10-05,TRF FROM  Indiaforensic SERVICES,0.0,3000000.0,,2018,10,5,TRANSFER,3000000.0,C1554540309
27175,1196428',2018-10-05,TRF FROM  Indiaforensic SERVICES,0.0,3000000.0,,2018,10,5,CHECK_CASHING,3000000.0,M2120427827
27176,1196428',2018-10-05,NEFT/SBIN918278574489/IND,0.0,1076056.4,,2018,10,5,CASH_IN,1076056.4,C820910648
27177,1196428',2018-10-05,IMPS 827817609639 FROM OX,0.0,200000.0,,2018,10,5,TRANSFER,200000.0,M415456371
27178,1196428',2018-10-05,IMPS 827817609694 FROM OX,0.0,200000.0,,2018,10,5,CHECK_CASHING,200000.0,M598340030
27179,1196428',2018-10-05,IMPS 827817609726 FROM OX,0.0,200000.0,,2018,10,5,CHECK_CASHING,200000.0,C345679794
27180,1196428',2018-10-05,IMPS 827817609777 FROM OX,0.0,200000.0,,2018,10,5,CASH_IN,200000.0,M1605050346
27181,1196428',2018-10-05,IMPS 827817609836 FROM OX,0.0,200000.0,,2018,10,5,CASH_IN,200000.0,C1144070975
27182,1196428',2018-10-05,IMPS 827817609874 FROM OX,0.0,200000.0,,2018,10,5,CHECK_CASHING,200000.0,M639999796
27183,1196428',2018-10-05,IMPS 827817609929 FROM OX,0.0,200000.0,,2018,10,5,CHECK_CASHING,200000.0,C343534938
27184,1196428',2018-10-05,IMPS 827817609980 FROM OX,0.0,200000.0,,2018,10,5,CASH_IN,200000.0,M479872561
27185,1196428',2018-10-05,IMPS 827817610032 FROM OX,0.0,200000.0,,2018,10,5,CASH_IN,200000.0,M61732893
27186,1196428',2018-10-05,IMPS 827817610085 FROM OX,0.0,200000.0,,2018,10,5,TRANSFER,200000.0,C160632822
27187,1196428',2018-10-05,TRF FROM  Indiaforensic SERVICES,0.0,6600000.0,,2018,10,5,TRANSFER,6600000.0,C1183266411
27188,1196428',2018-10-05,IMPS 827817610877 FROM OX,0.0,200000.0,,2018,10,5,TRANSFER,200000.0,M1328778262
27189,1196428',2018-10-05,IMPS 827817610928 FROM OX,0.0,200000.0,,2018,10,5,CASH_IN,200000.0,M704806959
27190,1196428',2018-10-05,IMPS 827817610990 FROM OX,0.0,200000.0,,2018,10,5,CASH_IN,200000.0,C229313132
27191,1196428',2018-10-05,IMPS 827817611063 FROM OX,0.0,200000.0,,2018,10,5,CASH_IN,200000.0,M325906300
27192,1196428',2018-10-05,IMPS 827817611132 FROM OX,0.0,200000.0,,2018,10,5,TRANSFER,200000.0,M1267748122
27193,1196428',2018-10-05,IMPS 827817611191 FROM OX,0.0,200000.0,,2018,10,5,CHECK_CASHING,200000.0,M159739450
27194,1196428',2018-10-05,IMPS 827817611252 FROM OX,0.0,200000.0,,2018,10,5,CHECK_CASHING,200000.0,M1702289141
27195,1196428',2018-10-05,IMPS 827817611299 FROM OX,0.0,200000.0,,2018,10,5,CHECK_CASHING,200000.0,C1200612373
27196,1196428',2018-10-05,IMPS 827817611337 FROM OX,0.0,200000.0,,2018,10,5,TRANSFER,200000.0,C1840046890
27197,1196428',2018-10-05,IMPS 827817611406 FROM OX,0.0,200000.0,,2018,10,5,CHECK_CASHING,200000.0,M1261751850
27198,1196428',2018-10-05,IMPS 827817612129 FROM OX,0.0,200000.0,,2018,10,5,TRANSFER,200000.0,M1535970431
27199,1196428',2018-10-05,IMPS 827817612191 FROM OX,0.0,200000.0,,2018,10,5,TRANSFER,200000.0,M524251983
27200,1196428',2018-10-05,IMPS 827817612243 FROM OX,0.0,200000.0,,2018,10,5,TRANSFER,200000.0,C1406749291
27201,1196428',2018-10-05,FDRL/NATIONAL ELECTRONIC F,5487290.27,0.0,,2018,10,5,CHECK_WITHDRAWAL,5487290.27,C1415645767
27202,1196428',2018-10-05,IMPS 827817612296 FROM OX,0.0,200000.0,,2018,10,5,CASH_IN,200000.0,M1816834020
27203,1196428',2018-10-05,IMPS 827817612353 FROM OX,0.0,200000.0,,2018,10,5,TRANSFER,200000.0,C1732292969
27204,1196428',2018-10-05,FDRL/NATIONAL ELECTRONIC F,10000000.0,0.0,,2018,10,5,DEBIT,10000000.0,M1739764490
27205,1196428',2018-10-05,NEFT/N278180649008377/TEC,0.0,300000.0,,2018,10,5,CHECK_CASHING,300000.0,M1664129150
27206,1196428',2018-10-05,NEFT/000053343979/Indiaforensic,0.0,1300000.0,,2018,10,5,TRANSFER,1300000.0,M1128852062
27207,1196428',2018-10-05,NEFT/000053344208/Indiaforensic,0.0,1200000.0,,2018,10,5,TRANSFER,1200000.0,M182471589
27208,1196428',2018-10-05,FDRL/INTERNAL FUND TRANSFE,1000000.0,0.0,,2018,10,5,PAYEMENT,1000000.0,M1056074872
27209,1196428',2018-10-05,FDRL/INTERNAL FUND TRANSFE,1000000.0,0.0,,2018,10,5,CASH_OUT,1000000.0,M2106622700
27210,1196428',2018-10-05,FDRL/INTERNAL FUND TRANSFE,1000000.0,0.0,,2018,10,5,CASH_OUT,1000000.0,M163766295
27211,1196428',2018-10-05,FDRL/INTERNAL FUND TRANSFE,1000000.0,0.0,,2018,10,5,CHECK_WITHDRAWAL,1000000.0,M802332120
27212,1196428',2018-10-05,FDRL/INTERNAL FUND TRANSFE,1000000.0,0.0,,2018,10,5,CASH_OUT,1000000.0,M1676185662
27213,1196428',2018-10-05,FDRL/INTERNAL FUND TRANSFE,1000000.0,0.0,,2018,10,5,DEBIT,1000000.0,M1776427379
27214,1196428',2018-10-05,FDRL/INTERNAL FUND TRANSFE,1000000.0,0.0,,2018,10,5,CASH_OUT,1000000.0,M334173295
27215,1196428',2018-10-05,TRF FROM  Indiaforensic SERVICES,0.0,700000.0,,2018,10,5,TRANSFER,700000.0,M330490124
27216,1196428',2018-10-05,TRF FROM  Indiaforensic SERVICES,0.0,500000.0,,2018,10,5,CHECK_CASHING,500000.0,M1154845973
27217,1196428',2018-10-05,TRF FROM  Indiaforensic SERVICES,0.0,400000.0,,2018,10,5,CHECK_CASHING,400000.0,M911987264
27218,1196428',2018-10-05,TRF TO  Indiaforensic SERVICES I,1300000.0,0.0,,2018,10,5,PAYEMENT,1300000.0,M1680147473
27219,1196428',2018-10-05,BEAT CSH PKP DEL GURGA 72,0.0,37000.0,,2018,10,5,TRANSFER,37000.0,M293659205
27220,1196428',2018-10-06,RTGS/SBINH18279007352/SAI,0.0,599941.0,,2018,10,6,CASH_IN,599941.0,M1432093328
27221,1196428',2018-10-06,RTGS/HDFCH18279009828/JUN,0.0,300000.0,,2018,10,6,TRANSFER,300000.0,M901262414
27222,1196428',2018-10-06,CHQ DEP/194/OWDEL2/ANDB/,0.0,11800.0,,2018,10,6,CASH_IN,11800.0,M899962047
27223,1196428',2018-10-06,TRF FROM  Indiaforensic SERVICES,0.0,5000000.0,,2018,10,6,CASH_IN,5000000.0,M32715716
27224,1196428',2018-10-06,TRF FROM  Indiaforensic SERVICES,0.0,500000.0,,2018,10,6,CHECK_CASHING,500000.0,M1510311379
27225,1196428',2018-10-06,RTGS/ICICH18279249963/Indfor,0.0,1000000.0,,2018,10,6,CASH_IN,1000000.0,M1517206841
27226,1196428',2018-10-06,FDRL/INTERNAL FUND TRANSFE,2000000.0,0.0,,2018,10,6,CASH_OUT,2000000.0,M2030024765
27227,1196428',2018-10-06,FDRL/INTERNAL FUND TRANSFE,500000.0,0.0,,2018,10,6,DEBIT,500000.0,M1267580132
27228,1196428',2018-10-06,RTGS/HDFCH18279087789/BAT,0.0,300000.0,,2018,10,6,CHECK_CASHING,300000.0,C655391383
27229,1196428',2018-10-06,RTGS/SBINH18279050125/Indfor,0.0,1500000.0,,2018,10,6,CHECK_CASHING,1500000.0,C2117215775
27230,1196428',2018-10-06,TRF FROM  Indiaforensic SERVICES,0.0,4000000.0,,2018,10,6,CASH_IN,4000000.0,C2106576360
27231,1196428',2018-10-06,TRF FROM  Indiaforensic SERVICES,0.0,3000000.0,,2018,10,6,CASH_IN,3000000.0,M267789972
27232,1196428',2018-10-06,TRF FROM  Indiaforensic SERVICES,0.0,500000.0,,2018,10,6,TRANSFER,500000.0,M292960678
27233,1196428',2018-10-06,TRF FROM  Indiaforensic SERVICES,0.0,500000.0,,2018,10,6,CHECK_CASHING,500000.0,C1638372110
27234,1196428',2018-10-06,FDRL/NATIONAL ELECTRONIC F,14623405.17,0.0,,2018,10,6,DEBIT,14623405.17,C1377774115
27235,1196428',2018-10-06,TRF FROM  Indiaforensic SERVICES,0.0,1000000.0,,2018,10,6,CASH_IN,1000000.0,M1877845145
27236,1196428',2018-10-06,IMPS 827917984137 FROM OX,0.0,100000.0,,2018,10,6,CHECK_CASHING,100000.0,M869149988
27237,1196428',2018-10-06,IMPS 827917984202 FROM OX,0.0,200000.0,,2018,10,6,CASH_IN,200000.0,M1324498984
27238,1196428',2018-10-06,FDRL/INTERNAL FUND TRANSFE,2000000.0,0.0,,2018,10,6,CASH_OUT,2000000.0,C748014372
27239,1196428',2018-10-06,BEAT CSH PKP DEL GURG 727,0.0,144000.0,,2018,10,6,CASH_IN,144000.0,M1556526073
27240,1196428',2018-10-08,RTGS/HDFCH18281120866/BAT,0.0,275000.0,,2018,10,8,CHECK_CASHING,275000.0,M1113797896
27241,1196428',2018-10-08,CASHDEP/NERUL/,0.0,20700.0,,2018,10,8,CHECK_CASHING,20700.0,M111103216
27242,1196428',2018-10-08,TRF FROM  Indiaforensic SERVICES,0.0,2000000.0,,2018,10,8,TRANSFER,2000000.0,M402054040
27243,1196428',2018-10-08,TRF TO  Indiaforensic SERVICES I,341292.0,0.0,,2018,10,8,DEBIT,341292.0,C1174935745
27244,1196428',2018-10-08,FDRL/INTERNAL FUND TRANSFE,2000000.0,0.0,,2018,10,8,DEBIT,2000000.0,M3128155
27245,1196428',2018-10-08,TRF FROM  Indiaforensic SERVICES,0.0,8900000.0,,2018,10,8,TRANSFER,8900000.0,M804435874
27246,1196428',2018-10-08,RTGS/SBINH18281044647/Indfor,0.0,8900000.0,,2018,10,8,TRANSFER,8900000.0,M22524150
27247,1196428',2018-10-08,FDRL/NATIONAL ELECTRONIC F,7734685.41,0.0,,2018,10,8,CHECK_WITHDRAWAL,7734685.41,C717951588
27248,1196428',2018-10-08,FDRL/NATIONAL ELECTRONIC F,10000000.0,0.0,,2018,10,8,CHECK_WITHDRAWAL,10000000.0,M994429804
27249,1196428',2018-10-08,RTGS/ICICH18281420012/Indfor,0.0,500000.0,,2018,10,8,CASH_IN,500000.0,M42960844
27250,1196428',2018-10-08,RTGS/ICICH18281418422/Indfor,0.0,1300000.0,,2018,10,8,CHECK_CASHING,1300000.0,M117897905
27251,1196428',2018-10-08,Indiaforensic SERVICES INDIA PVT,0.0,196435.0,,2018,10,8,CHECK_CASHING,196435.0,M919103236
27252,1196428',2018-10-08,FDRL/NATIONAL ELECTRONIC F,1000000.0,0.0,,2018,10,8,PAYEMENT,1000000.0,M2117556230
27253,1196428',2018-10-08,FDRL/NATIONAL ELECTRONIC F,1000000.0,0.0,,2018,10,8,CASH_OUT,1000000.0,M2047174428
27254,1196428',2018-10-08,TRF FROM  Indiaforensic SERVICES,0.0,4000000.0,,2018,10,8,CHECK_CASHING,4000000.0,M1468774738
27255,1196428',2018-10-08,TRF FROM  Indiaforensic SERVICES,0.0,4000000.0,,2018,10,8,CASH_IN,4000000.0,M266577647
27256,1196428',2018-10-08,TRF FROM  Indiaforensic SERVICES,0.0,4000000.0,,2018,10,8,CASH_IN,4000000.0,M1474343674
27257,1196428',2018-10-08,TRF FROM  Indiaforensic SERVICES,0.0,5000000.0,,2018,10,8,CASH_IN,5000000.0,M1664266643
27258,1196428',2018-10-08,TRF FROM  Indiaforensic SERVICES,0.0,5000000.0,,2018,10,8,CASH_IN,5000000.0,M842463018
27259,1196428',2018-10-08,TRF FROM  Indiaforensic SERVICES,0.0,3000000.0,,2018,10,8,CASH_IN,3000000.0,M284325832
27260,1196428',2018-10-08,TRF FROM  Indiaforensic SERVICES,0.0,1000000.0,,2018,10,8,TRANSFER,1000000.0,M1784760424
27261,1196428',2018-10-08,NEFT/BARBC18281317633/IND,0.0,6490.0,,2018,10,8,CASH_IN,6490.0,M1489026763
27262,1196428',2018-10-08,BEAT CSH PKP DEL GURG 727,0.0,123200.0,,2018,10,8,CHECK_CASHING,123200.0,C1800405372
27263,1196428',2018-10-08,FDRL/NATIONAL ELECTRONIC F,11494049.47,0.0,,2018,10,8,DEBIT,11494049.47,C2071512077
27264,1196428',2018-10-08,FDRL/NATIONAL ELECTRONIC F,1000000.0,0.0,,2018,10,8,DEBIT,1000000.0,C1588635270
27265,1196428',2018-10-08,FDRL/NATIONAL ELECTRONIC F,1000000.0,0.0,,2018,10,8,CHECK_WITHDRAWAL,1000000.0,C1495001462
27266,1196428',2018-10-08,FDRL/NATIONAL ELECTRONIC F,2000000.0,0.0,,2018,10,8,CASH_OUT,2000000.0,M84558619
27267,1196428',2018-10-08,FDRL/NATIONAL ELECTRONIC F,1000000.0,0.0,,2018,10,8,CASH_OUT,1000000.0,M113925453
27268,1196428',2018-10-08,FDRL/NATIONAL ELECTRONIC F,2000000.0,0.0,,2018,10,8,PAYEMENT,2000000.0,M645245228
27269,1196428',2018-10-08,FDRL/INTERNAL FUND TRANSFE,1000000.0,0.0,,2018,10,8,DEBIT,1000000.0,M636094317
27270,1196428',2018-10-08,FDRL/INTERNAL FUND TRANSFE,100000.0,0.0,,2018,10,8,DEBIT,100000.0,M1583961850
27271,1196428',2018-10-08,FDRL/INTERNAL FUND TRANSFE,1000000.0,0.0,,2018,10,8,CHECK_WITHDRAWAL,1000000.0,M708029389
27272,1196428',2018-10-08,FDRL/INTERNAL FUND TRANSFE,500000.0,0.0,,2018,10,8,CHECK_WITHDRAWAL,500000.0,M508231066
27273,1196428',2018-10-08,FDRL/INTERNAL FUND TRANSFE,100000.0,0.0,,2018,10,8,PAYEMENT,100000.0,C1838491463
27274,1196428',2018-10-08,FDRL/INTERNAL FUND TRANSFE,500000.0,0.0,,2018,10,8,CASH_OUT,500000.0,M1094448975
27275,1196428',2018-10-09,FDRL/INTERNAL FUND TRANSFE,2000000.0,0.0,,2018,10,9,CASH_OUT,2000000.0,M717841651
27276,1196428',2018-10-09,FDRL/NATIONAL ELECTRONIC F,1000000.0,0.0,,2018,10,9,CASH_OUT,1000000.0,M1954167102
27277,1196428',2018-10-09,FDRL/NATIONAL ELECTRONIC F,1000000.0,0.0,,2018,10,9,CHECK_WITHDRAWAL,1000000.0,M1043087369
27278,1196428',2018-10-09,TRF FROM  Indiaforensic SERVICES,0.0,1000000.0,,2018,10,9,TRANSFER,1000000.0,M1489610760
27279,1196428',2018-10-09,FDRL/NATIONAL ELECTRONIC F,17685.0,0.0,,2018,10,9,PAYEMENT,17685.0,C1556875182
27280,1196428',2018-10-09,FDRL/NATIONAL ELECTRONIC F,14737.0,0.0,,2018,10,9,CHECK_WITHDRAWAL,14737.0,M1109811596
27281,1196428',2018-10-09,FDRL/NATIONAL ELECTRONIC F,17685.0,0.0,,2018,10,9,DEBIT,17685.0,C101571284
27282,1196428',2018-10-09,FDRL/NATIONAL ELECTRONIC F,17684.0,0.0,,2018,10,9,CHECK_WITHDRAWAL,17684.0,M178952563
27283,1196428',2018-10-09,NEFT/PUNBH18282422225/BAL,0.0,99000.0,,2018,10,9,CHECK_CASHING,99000.0,M2081263541
27284,1196428',2018-10-09,FDRL/INTERNAL FUND TRANSFE,100000.0,0.0,,2018,10,9,CASH_OUT,100000.0,C2078250226
27285,1196428',2018-10-09,IMPS 828213312170 FROM AS,0.0,110099.0,,2018,10,9,CASH_IN,110099.0,C1570256460
27286,1196428',2018-10-09,FDRL/NATIONAL ELECTRONIC F,1000000.0,0.0,,2018,10,9,DEBIT,1000000.0,M441055416
27287,1196428',2018-10-09,FDRL/NATIONAL ELECTRONIC F,500000.0,0.0,,2018,10,9,CASH_OUT,500000.0,C2077098348
27288,1196428',2018-10-09,NEFT/N282180651695239/JUN,0.0,150000.0,,2018,10,9,CHECK_CASHING,150000.0,C1062254208
27289,1196428',2018-10-09,NEFT/N282180651830823/ASH,0.0,13500.0,,2018,10,9,TRANSFER,13500.0,C1787868648
27290,1196428',2018-10-09,RTGS/SBINH18282061252/Indfor,0.0,2000000.0,,2018,10,9,TRANSFER,2000000.0,C161140376
27291,1196428',2018-10-09,TRF FROM  Indiaforensic SERVICES,0.0,5000000.0,,2018,10,9,TRANSFER,5000000.0,M1471351873
27292,1196428',2018-10-09,TRF TO  Indiaforensic SERVICES I,250000.0,0.0,,2018,10,9,PAYEMENT,250000.0,M1328437771
27293,1196428',2018-10-09,TRF TO  Indiaforensic SERVICES I,32047.0,0.0,,2018,10,9,CHECK_WITHDRAWAL,32047.0,M341537411
27294,1196428',2018-10-09,TRF FROM  Indiaforensic SERVICES,0.0,800000.0,,2018,10,9,CASH_IN,800000.0,M1367049026
27295,1196428',2018-10-09,RTGS/ICICH18282553974/Indfor,0.0,900000.0,,2018,10,9,CASH_IN,900000.0,C2029310301
27296,1196428',2018-10-09,Indiaforensic SERVICES INDIA PVT,0.0,81143.0,,2018,10,9,CASH_IN,81143.0,C1606699851
27297,1196428',2018-10-09,RTGS/ICICH18282555469/Indfor,0.0,2500000.0,,2018,10,9,CASH_IN,2500000.0,C1103621993
27298,1196428',2018-10-09,NEFT/20750582571DC/ARTHAS,0.0,300000.0,,2018,10,9,TRANSFER,300000.0,M34447014
27299,1196428',2018-10-09,TRF FROM  Indiaforensic SERVICES,0.0,5000000.0,,2018,10,9,TRANSFER,5000000.0,C1428675504
27300,1196428',2018-10-09,TRF FROM  Indiaforensic SERVICES,0.0,4000000.0,,2018,10,9,CHECK_CASHING,4000000.0,M1783999682
27301,1196428',2018-10-09,TRF FROM  Indiaforensic SERVICES,0.0,2000000.0,,2018,10,9,CASH_IN,2000000.0,C1247600089
27302,1196428',2018-10-09,FDRL/NATIONAL ELECTRONIC F,14164035.56,0.0,,2018,10,9,CHECK_WITHDRAWAL,14164035.56,M835388411
27303,1196428',2018-10-09,FDRL/NATIONAL ELECTRONIC F,4000000.0,0.0,,2018,10,9,DEBIT,4000000.0,C404279307
27304,1196428',2018-10-09,TRF FROM  Indiaforensic SERVICES,0.0,2000000.0,,2018,10,9,CHECK_CASHING,2000000.0,C278407008
27305,1196428',2018-10-09,TRF FROM  Indiaforensic SERVICES,0.0,900000.0,,2018,10,9,CASH_IN,900000.0,M1721234210
27306,1196428',2018-10-09,FDRL/INTERNAL FUND TRANSFE,1000000.0,0.0,,2018,10,9,PAYEMENT,1000000.0,M1576908104
27307,1196428',2018-10-09,FDRL/INTERNAL FUND TRANSFE,5000000.0,0.0,,2018,10,9,CASH_OUT,5000000.0,M1547162536
27308,1196428',2018-10-09,FDRL/INTERNAL FUND TRANSFE,500000.0,0.0,,2018,10,9,CHECK_WITHDRAWAL,500000.0,M1057827479
27309,1196428',2018-10-09,BEAT CSH PKP DEL GURGA 72,0.0,107500.0,,2018,10,9,CHECK_CASHING,107500.0,M1498878973
27310,1196428',2018-10-10,NEFT/SBIN318283752400/QUT,0.0,11800.0,,2018,10,10,TRANSFER,11800.0,M1420281457
27311,1196428',2018-10-10,NEFT/SBIN318283772086/SRI,0.0,100000.0,,2018,10,10,CASH_IN,100000.0,M2000558609
27312,1196428',2018-10-10,"Indiaforensic USA, INC./USD/1932",0.0,14245988.9,,2018,10,10,CASH_IN,14245988.9,M1598229594
27313,1196428',2018-10-10,IRTT00701829144,3669.28,0.0,,2018,10,10,CASH_OUT,3669.28,M2001514483
27314,1196428',2018-10-10,FDRL/NATIONAL ELECTRONIC F,15052.0,0.0,,2018,10,10,CASH_OUT,15052.0,M1808413339
27315,1196428',2018-10-10,TRF TO  Indiaforensic SERVICES I,5000000.0,0.0,,2018,10,10,PAYEMENT,5000000.0,M662376084
27316,1196428',2018-10-10,TRF FROM  Indiaforensic SERVICES,0.0,5400000.0,,2018,10,10,TRANSFER,5400000.0,M1462583713
27317,1196428',2018-10-10,RTGS/HDFCH18283588995/BAT,0.0,225000.0,,2018,10,10,TRANSFER,225000.0,M1292178703
27318,1196428',2018-10-10,FDRL/REAL TIME GROSS SETTL,10000000.0,0.0,,2018,10,10,CHECK_WITHDRAWAL,10000000.0,M1378894443
27319,1196428',2018-10-10,NEFT/SBIN418283211421/SRI,0.0,100000.0,,2018,10,10,CASH_IN,100000.0,M671194471
27320,1196428',2018-10-10,TRF FROM 409000362497  OX,0.0,65843.0,,2018,10,10,CASH_IN,65843.0,M2120887477
27321,1196428',2018-10-10,NEFT/000053627948/Indiaforensic,0.0,2000000.0,,2018,10,10,CASH_IN,2000000.0,M1565473666
27322,1196428',2018-10-10,NEFT/000053625631/Indiaforensic,0.0,1200000.0,,2018,10,10,CASH_IN,1200000.0,M336600403
27323,1196428',2018-10-10,IMPS 828317302405 FROM OX,0.0,200000.0,,2018,10,10,CASH_IN,200000.0,M1108314788
27324,1196428',2018-10-10,IMPS 828317302463 FROM OX,0.0,200000.0,,2018,10,10,CHECK_CASHING,200000.0,M1776708407
27325,1196428',2018-10-10,IMPS 828317302505 FROM OX,0.0,200000.0,,2018,10,10,CHECK_CASHING,200000.0,M1886072816
27326,1196428',2018-10-10,IMPS 828317302564 FROM OX,0.0,200000.0,,2018,10,10,CASH_IN,200000.0,M392269298
27327,1196428',2018-10-10,FDRL/NATIONAL ELECTRONIC F,10000000.0,0.0,,2018,10,10,CASH_OUT,10000000.0,M240263357
27328,1196428',2018-10-10,TRF FROM  Indiaforensic SERVICES,0.0,3800000.0,,2018,10,10,CHECK_CASHING,3800000.0,M2137827177
27329,1196428',2018-10-10,TRF FROM  Indiaforensic SERVICES,0.0,600000.0,,2018,10,10,TRANSFER,600000.0,M996688653
27330,1196428',2018-10-10,TRF FROM  Indiaforensic SERVICES,0.0,10000000.0,,2018,10,10,CASH_IN,10000000.0,C1829831147
27331,1196428',2018-10-10,FDRL/INTERNAL FUND TRANSFE,2000000.0,0.0,,2018,10,10,PAYEMENT,2000000.0,M720435458
27332,1196428',2018-10-10,FDRL/INTERNAL FUND TRANSFE,1000000.0,0.0,,2018,10,10,CASH_OUT,1000000.0,M29096009
27333,1196428',2018-10-10,FDRL/INTERNAL FUND TRANSFE,5000000.0,0.0,,2018,10,10,CHECK_WITHDRAWAL,5000000.0,M150995440
27334,1196428',2018-10-10,BEAT CSH PKP DEL GURGA 72,0.0,162000.0,,2018,10,10,CHECK_CASHING,162000.0,M1241251535
27335,1196428',2018-10-11,FDRL/NATIONAL ELECTRONIC F,5984726.33,0.0,,2018,10,11,CASH_OUT,5984726.33,M1254542588
27336,1196428',2018-10-11,RTGS/HDFCH18284642446/BAT,0.0,300000.0,,2018,10,11,CASH_IN,300000.0,M710538853
27337,1196428',2018-10-11,FDRL/INTERNAL FUND TRANSFE,500000.0,0.0,,2018,10,11,DEBIT,500000.0,M399672840
27338,1196428',2018-10-11,RTGS/SBINH18284008941/SAI,0.0,500000.0,,2018,10,11,TRANSFER,500000.0,M1566931514
27339,1196428',2018-10-11,LAKSHIM KANT SHARMA,15977.0,0.0,,2018,10,11,CHECK_WITHDRAWAL,15977.0,C1540270363
27340,1196428',2018-10-11,"Indiaforensic USA, INC./USD/2774",0.0,2047212.0,,2018,10,11,TRANSFER,2047212.0,C900425684
27341,1196428',2018-10-11,IRTT00701829329,1473.5,0.0,,2018,10,11,DEBIT,1473.5,M1361294362
27342,1196428',2018-10-11,CHQ DEP/290744/OWDEL1/CLA,0.0,11800.0,,2018,10,11,CASH_IN,11800.0,C264843581
27343,1196428',2018-10-11,CHQ DEP/209037/OWDEL1/SBI,0.0,11800.0,,2018,10,11,CASH_IN,11800.0,M1897445965
27344,1196428',2018-10-11,CHQ DEP/123/OWDEL1/HDFC/N,0.0,8250.0,,2018,10,11,TRANSFER,8250.0,M345439288
27345,1196428',2018-10-11,NEFT/N284180653935099/ESS,0.0,100000.0,,2018,10,11,TRANSFER,100000.0,M2130477201
27346,1196428',2018-10-11,RTGS/PUNBH18284877940/BAL,0.0,200000.0,,2018,10,11,CASH_IN,200000.0,M1516263359
27347,1196428',2018-10-11,RTGS/ICICH18284785373/Indfor,0.0,8400000.0,,2018,10,11,CHECK_CASHING,8400000.0,M508839235
27348,1196428',2018-10-11,TRF FROM  Indiaforensic SERVICES,0.0,5000000.0,,2018,10,11,CASH_IN,5000000.0,M530611995
27349,1196428',2018-10-11,NEFT/000053684216/Indiaforensic,0.0,500000.0,,2018,10,11,CASH_IN,500000.0,C1761324386
27350,1196428',2018-10-11,RTGS/SBINH18284055676/Indfor,0.0,1000000.0,,2018,10,11,TRANSFER,1000000.0,C90486891
27351,1196428',2018-10-11,Indiaforensic SERVICES INDIA PVT,0.0,97773.0,,2018,10,11,CHECK_CASHING,97773.0,C573200870
27352,1196428',2018-10-11,IMPS 828416350766 FROM AS,0.0,125099.0,,2018,10,11,CASH_IN,125099.0,C1825992554
27353,1196428',2018-10-11,FDRL/NATIONAL ELECTRONIC F,12953.0,0.0,,2018,10,11,DEBIT,12953.0,M1278682262
27354,1196428',2018-10-11,FDRL/NATIONAL ELECTRONIC F,28288.0,0.0,,2018,10,11,PAYEMENT,28288.0,M2009652577
27355,1196428',2018-10-11,FDRL/NATIONAL ELECTRONIC F,13084.0,0.0,,2018,10,11,DEBIT,13084.0,M1504904868
27356,1196428',2018-10-11,FDRL/NATIONAL ELECTRONIC F,26227.0,0.0,,2018,10,11,CASH_OUT,26227.0,C88226327
27357,1196428',2018-10-11,FDRL/NATIONAL ELECTRONIC F,14101.0,0.0,,2018,10,11,CASH_OUT,14101.0,M203497386
27358,1196428',2018-10-11,FDRL/NATIONAL ELECTRONIC F,19146.0,0.0,,2018,10,11,CHECK_WITHDRAWAL,19146.0,M1264078907
27359,1196428',2018-10-11,FDRL/NATIONAL ELECTRONIC F,10821.0,0.0,,2018,10,11,DEBIT,10821.0,M1870838648
27360,1196428',2018-10-11,FDRL/NATIONAL ELECTRONIC F,10583.0,0.0,,2018,10,11,CHECK_WITHDRAWAL,10583.0,C1683963531
27361,1196428',2018-10-11,FDRL/NATIONAL ELECTRONIC F,21933.0,0.0,,2018,10,11,CHECK_WITHDRAWAL,21933.0,M620120832
27362,1196428',2018-10-11,FDRL/NATIONAL ELECTRONIC F,25791.0,0.0,,2018,10,11,DEBIT,25791.0,M37714710
27363,1196428',2018-10-11,FDRL/NATIONAL ELECTRONIC F,19449.0,0.0,,2018,10,11,PAYEMENT,19449.0,M1135370372
27364,1196428',2018-10-11,FDRL/NATIONAL ELECTRONIC F,10989.0,0.0,,2018,10,11,CHECK_WITHDRAWAL,10989.0,C1700355047
27365,1196428',2018-10-11,FDRL/NATIONAL ELECTRONIC F,22600.0,0.0,,2018,10,11,DEBIT,22600.0,C1884600481
27366,1196428',2018-10-11,FDRL/NATIONAL ELECTRONIC F,19069.0,0.0,,2018,10,11,CHECK_WITHDRAWAL,19069.0,C1105527690
27367,1196428',2018-10-11,FDRL/NATIONAL ELECTRONIC F,25719.0,0.0,,2018,10,11,DEBIT,25719.0,M714819629
27368,1196428',2018-10-11,FDRL/NATIONAL ELECTRONIC F,11756.0,0.0,,2018,10,11,CASH_OUT,11756.0,M722465639
27369,1196428',2018-10-11,FDRL/NATIONAL ELECTRONIC F,12596.0,0.0,,2018,10,11,DEBIT,12596.0,C801412408
27370,1196428',2018-10-11,FDRL/NATIONAL ELECTRONIC F,15871.0,0.0,,2018,10,11,CASH_OUT,15871.0,M1678349105
27371,1196428',2018-10-11,FDRL/NATIONAL ELECTRONIC F,27120.0,0.0,,2018,10,11,PAYEMENT,27120.0,C35534346
27372,1196428',2018-10-11,FDRL/NATIONAL ELECTRONIC F,22340.0,0.0,,2018,10,11,CHECK_WITHDRAWAL,22340.0,C943166837
27373,1196428',2018-10-11,FDRL/NATIONAL ELECTRONIC F,25488.0,0.0,,2018,10,11,CHECK_WITHDRAWAL,25488.0,M1063088470
27374,1196428',2018-10-11,FDRL/NATIONAL ELECTRONIC F,13697.0,0.0,,2018,10,11,DEBIT,13697.0,M634480856
27375,1196428',2018-10-11,FDRL/NATIONAL ELECTRONIC F,22360.0,0.0,,2018,10,11,CHECK_WITHDRAWAL,22360.0,M1229660324
27376,1196428',2018-10-11,FDRL/NATIONAL ELECTRONIC F,24311.0,0.0,,2018,10,11,CHECK_WITHDRAWAL,24311.0,M1995775202
27377,1196428',2018-10-11,FDRL/NATIONAL ELECTRONIC F,24090.0,0.0,,2018,10,11,DEBIT,24090.0,M982735022
27378,1196428',2018-10-11,FDRL/NATIONAL ELECTRONIC F,11909.0,0.0,,2018,10,11,PAYEMENT,11909.0,C1754722089
27379,1196428',2018-10-11,FDRL/NATIONAL ELECTRONIC F,25871.0,0.0,,2018,10,11,CASH_OUT,25871.0,M536571624
27380,1196428',2018-10-11,FDRL/NATIONAL ELECTRONIC F,26593.0,0.0,,2018,10,11,DEBIT,26593.0,C1498878963
27381,1196428',2018-10-11,FDRL/NATIONAL ELECTRONIC F,25650.0,0.0,,2018,10,11,CHECK_WITHDRAWAL,25650.0,C1962165946
27382,1196428',2018-10-11,FDRL/NATIONAL ELECTRONIC F,12244.0,0.0,,2018,10,11,CASH_OUT,12244.0,M1170462195
27383,1196428',2018-10-11,FDRL/NATIONAL ELECTRONIC F,11668.0,0.0,,2018,10,11,DEBIT,11668.0,C414205222
27384,1196428',2018-10-11,FDRL/NATIONAL ELECTRONIC F,18054.0,0.0,,2018,10,11,CASH_OUT,18054.0,M1229413386
27385,1196428',2018-10-11,FDRL/NATIONAL ELECTRONIC F,15333.0,0.0,,2018,10,11,CHECK_WITHDRAWAL,15333.0,M712447692
27386,1196428',2018-10-11,FDRL/NATIONAL ELECTRONIC F,25170.0,0.0,,2018,10,11,DEBIT,25170.0,C269902384
27387,1196428',2018-10-11,FDRL/NATIONAL ELECTRONIC F,15112.0,0.0,,2018,10,11,DEBIT,15112.0,C955097010
27388,1196428',2018-10-11,FDRL/NATIONAL ELECTRONIC F,20776.0,0.0,,2018,10,11,CHECK_WITHDRAWAL,20776.0,C1827996167
27389,1196428',2018-10-11,FDRL/NATIONAL ELECTRONIC F,26400.0,0.0,,2018,10,11,CASH_OUT,26400.0,M30162194
27390,1196428',2018-10-11,FDRL/NATIONAL ELECTRONIC F,12358.0,0.0,,2018,10,11,CHECK_WITHDRAWAL,12358.0,C1115240385
27391,1196428',2018-10-11,FDRL/NATIONAL ELECTRONIC F,25730.0,0.0,,2018,10,11,CHECK_WITHDRAWAL,25730.0,M1710595137
27392,1196428',2018-10-11,FDRL/NATIONAL ELECTRONIC F,12837.0,0.0,,2018,10,11,PAYEMENT,12837.0,M970087106
27393,1196428',2018-10-11,FDRL/NATIONAL ELECTRONIC F,15543.0,0.0,,2018,10,11,CHECK_WITHDRAWAL,15543.0,M561635968
27394,1196428',2018-10-11,FDRL/NATIONAL ELECTRONIC F,21975.0,0.0,,2018,10,11,CASH_OUT,21975.0,C440480434
27395,1196428',2018-10-11,FDRL/NATIONAL ELECTRONIC F,29945.0,0.0,,2018,10,11,CHECK_WITHDRAWAL,29945.0,C46748390
27396,1196428',2018-10-11,FDRL/NATIONAL ELECTRONIC F,14814.0,0.0,,2018,10,11,DEBIT,14814.0,M976616410
27397,1196428',2018-10-11,FDRL/NATIONAL ELECTRONIC F,17271.0,0.0,,2018,10,11,CASH_OUT,17271.0,M1796408655
27398,1196428',2018-10-11,FDRL/NATIONAL ELECTRONIC F,6714.0,0.0,,2018,10,11,CASH_OUT,6714.0,M424513770
27399,1196428',2018-10-11,FDRL/NATIONAL ELECTRONIC F,22600.0,0.0,,2018,10,11,DEBIT,22600.0,M1867357103
27400,1196428',2018-10-11,FDRL/NATIONAL ELECTRONIC F,9529.0,0.0,,2018,10,11,PAYEMENT,9529.0,M215680372
27401,1196428',2018-10-11,FDRL/NATIONAL ELECTRONIC F,22600.0,0.0,,2018,10,11,DEBIT,22600.0,M764256713
27402,1196428',2018-10-11,FDRL/NATIONAL ELECTRONIC F,14814.0,0.0,,2018,10,11,DEBIT,14814.0,M538413261
27403,1196428',2018-10-11,FDRL/NATIONAL ELECTRONIC F,25000.0,0.0,,2018,10,11,CASH_OUT,25000.0,M942160595
27404,1196428',2018-10-11,FDRL/NATIONAL ELECTRONIC F,16842.0,0.0,,2018,10,11,CHECK_WITHDRAWAL,16842.0,M1319156415
27405,1196428',2018-10-11,FDRL/NATIONAL ELECTRONIC F,14814.0,0.0,,2018,10,11,CASH_OUT,14814.0,M361847129
27406,1196428',2018-10-11,FDRL/NATIONAL ELECTRONIC F,27629.0,0.0,,2018,10,11,CASH_OUT,27629.0,C1790202239
27407,1196428',2018-10-11,FDRL/NATIONAL ELECTRONIC F,24860.0,0.0,,2018,10,11,DEBIT,24860.0,M955868325
27408,1196428',2018-10-11,FDRL/NATIONAL ELECTRONIC F,22300.0,0.0,,2018,10,11,PAYEMENT,22300.0,M1251133153
27409,1196428',2018-10-11,FDRL/NATIONAL ELECTRONIC F,24860.0,0.0,,2018,10,11,PAYEMENT,24860.0,M1854311181
27410,1196428',2018-10-11,FDRL/NATIONAL ELECTRONIC F,15052.0,0.0,,2018,10,11,CASH_OUT,15052.0,C928023753
27411,1196428',2018-10-11,FDRL/NATIONAL ELECTRONIC F,24860.0,0.0,,2018,10,11,PAYEMENT,24860.0,M771609335
27412,1196428',2018-10-11,FDRL/NATIONAL ELECTRONIC F,24860.0,0.0,,2018,10,11,CASH_OUT,24860.0,C1452722471
27413,1196428',2018-10-11,FDRL/NATIONAL ELECTRONIC F,13826.0,0.0,,2018,10,11,DEBIT,13826.0,M1625968481
27414,1196428',2018-10-11,FDRL/NATIONAL ELECTRONIC F,24860.0,0.0,,2018,10,11,PAYEMENT,24860.0,M458727925
27415,1196428',2018-10-11,FDRL/NATIONAL ELECTRONIC F,25025.0,0.0,,2018,10,11,CHECK_WITHDRAWAL,25025.0,C111210112
27416,1196428',2018-10-11,FDRL/NATIONAL ELECTRONIC F,24860.0,0.0,,2018,10,11,DEBIT,24860.0,C464246030
27417,1196428',2018-10-11,FDRL/NATIONAL ELECTRONIC F,15052.0,0.0,,2018,10,11,CHECK_WITHDRAWAL,15052.0,M2080752777
27418,1196428',2018-10-11,FDRL/NATIONAL ELECTRONIC F,24860.0,0.0,,2018,10,11,PAYEMENT,24860.0,M1357563045
27419,1196428',2018-10-11,FDRL/NATIONAL ELECTRONIC F,12596.0,0.0,,2018,10,11,CHECK_WITHDRAWAL,12596.0,M68500741
27420,1196428',2018-10-11,FDRL/NATIONAL ELECTRONIC F,24659.0,0.0,,2018,10,11,CASH_OUT,24659.0,C1664330755
27421,1196428',2018-10-11,FDRL/NATIONAL ELECTRONIC F,24659.0,0.0,,2018,10,11,DEBIT,24659.0,C1823014131
27422,1196428',2018-10-11,FDRL/NATIONAL ELECTRONIC F,24859.0,0.0,,2018,10,11,PAYEMENT,24859.0,M1293355387
27423,1196428',2018-10-11,FDRL/NATIONAL ELECTRONIC F,24859.0,0.0,,2018,10,11,CHECK_WITHDRAWAL,24859.0,M34599177
27424,1196428',2018-10-11,FDRL/NATIONAL ELECTRONIC F,26860.0,0.0,,2018,10,11,DEBIT,26860.0,M685059787
27425,1196428',2018-10-11,FDRL/NATIONAL ELECTRONIC F,24860.0,0.0,,2018,10,11,PAYEMENT,24860.0,M376456946
27426,1196428',2018-10-11,FDRL/NATIONAL ELECTRONIC F,12100.0,0.0,,2018,10,11,CHECK_WITHDRAWAL,12100.0,M793798217
27427,1196428',2018-10-11,FDRL/NATIONAL ELECTRONIC F,24032.0,0.0,,2018,10,11,CHECK_WITHDRAWAL,24032.0,C264685626
27428,1196428',2018-10-11,FDRL/NATIONAL ELECTRONIC F,29475.0,0.0,,2018,10,11,DEBIT,29475.0,M954243999
27429,1196428',2018-10-11,FDRL/NATIONAL ELECTRONIC F,24859.0,0.0,,2018,10,11,CASH_OUT,24859.0,C1816986148
27430,1196428',2018-10-11,FDRL/NATIONAL ELECTRONIC F,24860.0,0.0,,2018,10,11,DEBIT,24860.0,C1144527317
27431,1196428',2018-10-11,FDRL/NATIONAL ELECTRONIC F,22036.0,0.0,,2018,10,11,PAYEMENT,22036.0,C1790831319
27432,1196428',2018-10-11,FDRL/NATIONAL ELECTRONIC F,15052.0,0.0,,2018,10,11,PAYEMENT,15052.0,C571435580
27433,1196428',2018-10-11,FDRL/NATIONAL ELECTRONIC F,15052.0,0.0,,2018,10,11,DEBIT,15052.0,C1262016786
27434,1196428',2018-10-11,FDRL/NATIONAL ELECTRONIC F,24859.0,0.0,,2018,10,11,CASH_OUT,24859.0,C1287328228
27435,1196428',2018-10-11,FDRL/NATIONAL ELECTRONIC F,19027.0,0.0,,2018,10,11,DEBIT,19027.0,C329473339
27436,1196428',2018-10-11,FDRL/NATIONAL ELECTRONIC F,9648.0,0.0,,2018,10,11,PAYEMENT,9648.0,C1354725727
27437,1196428',2018-10-11,FDRL/NATIONAL ELECTRONIC F,26216.0,0.0,,2018,10,11,CHECK_WITHDRAWAL,26216.0,C1300519073
27438,1196428',2018-10-11,FDRL/NATIONAL ELECTRONIC F,23202.0,0.0,,2018,10,11,CASH_OUT,23202.0,C2052185144
27439,1196428',2018-10-11,FDRL/NATIONAL ELECTRONIC F,17508.0,0.0,,2018,10,11,DEBIT,17508.0,C1485516154
27440,1196428',2018-10-11,FDRL/NATIONAL ELECTRONIC F,20384.0,0.0,,2018,10,11,PAYEMENT,20384.0,C2143477943
27441,1196428',2018-10-11,FDRL/NATIONAL ELECTRONIC F,24660.0,0.0,,2018,10,11,DEBIT,24660.0,C476402209
27442,1196428',2018-10-11,FDRL/NATIONAL ELECTRONIC F,22460.0,0.0,,2018,10,11,PAYEMENT,22460.0,C1255024717
27443,1196428',2018-10-11,FDRL/NATIONAL ELECTRONIC F,17508.0,0.0,,2018,10,11,PAYEMENT,17508.0,C1870367457
27444,1196428',2018-10-11,FDRL/NATIONAL ELECTRONIC F,21544.0,0.0,,2018,10,11,CHECK_WITHDRAWAL,21544.0,C465257140
27445,1196428',2018-10-11,FDRL/NATIONAL ELECTRONIC F,24860.0,0.0,,2018,10,11,DEBIT,24860.0,C745740822
27446,1196428',2018-10-11,FDRL/NATIONAL ELECTRONIC F,9648.0,0.0,,2018,10,11,PAYEMENT,9648.0,C1390121014
27447,1196428',2018-10-11,FDRL/NATIONAL ELECTRONIC F,15052.0,0.0,,2018,10,11,CHECK_WITHDRAWAL,15052.0,C1481851679
27448,1196428',2018-10-11,FDRL/NATIONAL ELECTRONIC F,24860.0,0.0,,2018,10,11,DEBIT,24860.0,C741431520
27449,1196428',2018-10-11,FDRL/NATIONAL ELECTRONIC F,5450.0,0.0,,2018,10,11,DEBIT,5450.0,C758888772
27450,1196428',2018-10-11,FDRL/NATIONAL ELECTRONIC F,10547.0,0.0,,2018,10,11,DEBIT,10547.0,C1001409363
27451,1196428',2018-10-11,FDRL/NATIONAL ELECTRONIC F,25930.0,0.0,,2018,10,11,CASH_OUT,25930.0,M1340854901
27452,1196428',2018-10-11,FDRL/NATIONAL ELECTRONIC F,17351.0,0.0,,2018,10,11,PAYEMENT,17351.0,M265997755
27453,1196428',2018-10-11,FDRL/NATIONAL ELECTRONIC F,12704.0,0.0,,2018,10,11,PAYEMENT,12704.0,M1257695233
27454,1196428',2018-10-11,FDRL/NATIONAL ELECTRONIC F,18675.0,0.0,,2018,10,11,CHECK_WITHDRAWAL,18675.0,C150309335
27455,1196428',2018-10-11,FDRL/NATIONAL ELECTRONIC F,13697.0,0.0,,2018,10,11,CHECK_WITHDRAWAL,13697.0,M1572611628
27456,1196428',2018-10-11,FDRL/NATIONAL ELECTRONIC F,17271.0,0.0,,2018,10,11,DEBIT,17271.0,M280183141
27457,1196428',2018-10-11,FDRL/NATIONAL ELECTRONIC F,19252.0,0.0,,2018,10,11,CHECK_WITHDRAWAL,19252.0,M808540700
27458,1196428',2018-10-11,FDRL/NATIONAL ELECTRONIC F,14990.0,0.0,,2018,10,11,PAYEMENT,14990.0,M565481399
27459,1196428',2018-10-11,FDRL/NATIONAL ELECTRONIC F,17927.0,0.0,,2018,10,11,CASH_OUT,17927.0,C842729010
27460,1196428',2018-10-11,FDRL/NATIONAL ELECTRONIC F,16918.0,0.0,,2018,10,11,CASH_OUT,16918.0,M178371442
27461,1196428',2018-10-11,FDRL/NATIONAL ELECTRONIC F,15520.0,0.0,,2018,10,11,CASH_OUT,15520.0,M2076445832
27462,1196428',2018-10-11,FDRL/NATIONAL ELECTRONIC F,12849.0,0.0,,2018,10,11,DEBIT,12849.0,C599968109
27463,1196428',2018-10-11,FDRL/NATIONAL ELECTRONIC F,15824.0,0.0,,2018,10,11,PAYEMENT,15824.0,C599265282
27464,1196428',2018-10-11,FDRL/NATIONAL ELECTRONIC F,10452.0,0.0,,2018,10,11,DEBIT,10452.0,C669771073
27465,1196428',2018-10-11,FDRL/NATIONAL ELECTRONIC F,15820.0,0.0,,2018,10,11,CHECK_WITHDRAWAL,15820.0,C2137848242
27466,1196428',2018-10-11,FDRL/NATIONAL ELECTRONIC F,10452.0,0.0,,2018,10,11,DEBIT,10452.0,M997986347
27467,1196428',2018-10-11,FDRL/NATIONAL ELECTRONIC F,23192.0,0.0,,2018,10,11,CASH_OUT,23192.0,M1063792159
27468,1196428',2018-10-11,FDRL/NATIONAL ELECTRONIC F,13816.0,0.0,,2018,10,11,DEBIT,13816.0,C22448303
27469,1196428',2018-10-11,CHQ DEPOSIT RETURN/209037,11800.0,0.0,,2018,10,11,CHECK_WITHDRAWAL,11800.0,M315692635
27470,1196428',2018-10-11,FDRL/NATIONAL ELECTRONIC F,10000000.0,0.0,,2018,10,11,CASH_OUT,10000000.0,M803644277
27471,1196428',2018-10-11,TRF FROM  Indiaforensic SERVICES,0.0,600000.0,,2018,10,11,TRANSFER,600000.0,M415913007
27472,1196428',2018-10-11,IMPS 828417662198 FROM OX,0.0,200000.0,,2018,10,11,TRANSFER,200000.0,M1344197461
27473,1196428',2018-10-11,IMPS 828417662265 FROM OX,0.0,200000.0,,2018,10,11,CHECK_CASHING,200000.0,M132014623
27474,1196428',2018-10-11,IMPS 828417662301 FROM OX,0.0,200000.0,,2018,10,11,CHECK_CASHING,200000.0,M577051450
27475,1196428',2018-10-11,IMPS 828417662356 FROM OX,0.0,200000.0,,2018,10,11,TRANSFER,200000.0,C1491676195
27476,1196428',2018-10-11,IMPS 828417662435 FROM OX,0.0,200000.0,,2018,10,11,TRANSFER,200000.0,C943166837
27477,1196428',2018-10-11,TRF FROM  Indiaforensic SERVICES,0.0,600000.0,,2018,10,11,CASH_IN,600000.0,M1402953791
27478,1196428',2018-10-11,FDRL/NATIONAL ELECTRONIC F,7372551.44,0.0,,2018,10,11,DEBIT,7372551.44,M1974589236
27479,1196428',2018-10-11,FDRL/NATIONAL ELECTRONIC F,1000000.0,0.0,,2018,10,11,CASH_OUT,1000000.0,C1701412896
27480,1196428',2018-10-11,TRF FROM  Indiaforensic SERVICES,0.0,10000000.0,,2018,10,11,CASH_IN,10000000.0,M1355606971
27481,1196428',2018-10-11,FDRL/INTERNAL FUND TRANSFE,1000000.0,0.0,,2018,10,11,DEBIT,1000000.0,M1037747072
27482,1196428',2018-10-11,FDRL/INTERNAL FUND TRANSFE,5000000.0,0.0,,2018,10,11,CHECK_WITHDRAWAL,5000000.0,M82220349
27483,1196428',2018-10-11,FDRL/INTERNAL FUND TRANSFE,2000000.0,0.0,,2018,10,11,CASH_OUT,2000000.0,M953439482
27484,1196428',2018-10-11,FDRL/INTERNAL FUND TRANSFE,1000000.0,0.0,,2018,10,11,DEBIT,1000000.0,C1914282536
27485,1196428',2018-10-11,FDRL/INTERNAL FUND TRANSFE,1000000.0,0.0,,2018,10,11,CHECK_WITHDRAWAL,1000000.0,C691636444
27486,1196428',2018-10-11,TRF FROM  Indiaforensic SERVICES,0.0,7200000.0,,2018,10,11,CHECK_CASHING,7200000.0,C683605346
27487,1196428',2018-10-11,NEFT/N284180654385416/TEC,0.0,300000.0,,2018,10,11,CHECK_CASHING,300000.0,M1967366965
27488,1196428',2018-10-11,BEAT CSH PKP DEL GURGA 72,0.0,131000.0,,2018,10,11,CHECK_CASHING,131000.0,M508405148
27489,1196428',2018-10-11,DSB SHORT CSH 500X2 09102,1000.0,0.0,,2018,10,11,DEBIT,1000.0,M1295579320
27490,1196428',2018-10-11,CHQ DEPOSIT RETURN/209037,100.0,0.0,,2018,10,11,PAYEMENT,100.0,M995168511
27491,1196428',2018-10-11,CHQ DEPOSIT RETURN/209037,18.0,0.0,,2018,10,11,CASH_OUT,18.0,M1102425439
27492,1196428',2018-10-12,FDRL/INTERNAL FUND TRANSFE,500000.0,0.0,,2018,10,12,CHECK_WITHDRAWAL,500000.0,M590053012
27493,1196428',2018-10-12,FDRL/NATIONAL ELECTRONIC F,4000000.0,0.0,,2018,10,12,PAYEMENT,4000000.0,M386886002
27494,1196428',2018-10-12,FDRL/NATIONAL ELECTRONIC F,3000000.0,0.0,,2018,10,12,PAYEMENT,3000000.0,M227585143
27495,1196428',2018-10-12,TRF FROM  Indiaforensic SERVICES,0.0,4000000.0,,2018,10,12,CHECK_CASHING,4000000.0,M2105068287
27496,1196428',2018-10-12,TRF FROM  Indiaforensic SERVICES,0.0,10000000.0,,2018,10,12,CASH_IN,10000000.0,M1038116064
27497,1196428',2018-10-12,FDRL/REAL TIME GROSS SETTL,10000000.0,0.0,,2018,10,12,DEBIT,10000000.0,M345805867
27498,1196428',2018-10-12,RTGS/HDFCH18285856991/BAT,0.0,300000.0,,2018,10,12,TRANSFER,300000.0,M1128144161
27499,1196428',2018-10-12,FDRL/REAL TIME GROSS SETTL,2000000.0,0.0,,2018,10,12,CHECK_WITHDRAWAL,2000000.0,M1492172037
27500,1196428',2018-10-12,FDRL/REAL TIME GROSS SETTL,2000000.0,0.0,,2018,10,12,PAYEMENT,2000000.0,M731603444
27501,1196428',2018-10-12,NEFT/PUNBH18285173999/BAL,0.0,99000.0,,2018,10,12,CHECK_CASHING,99000.0,M879683510
27502,1196428',2018-10-12,DHL EXPRESS INDIA PVT LTD,714.0,0.0,,2018,10,12,DEBIT,714.0,M555126583
27503,1196428',2018-10-12,TRF FROM  Indiaforensic SERVICES,0.0,4900000.0,,2018,10,12,TRANSFER,4900000.0,M1344791022
27504,1196428',2018-10-12,NEFT/N285180654804775/JUN,0.0,140000.0,,2018,10,12,TRANSFER,140000.0,M40493588
27505,1196428',2018-10-12,NEFT/20756842881DC/ARTHAS,0.0,200000.0,,2018,10,12,CHECK_CASHING,200000.0,M1099885881
27506,1196428',2018-10-12,CASHDEP/GHATKOPAR/,0.0,194500.0,,2018,10,12,CHECK_CASHING,194500.0,M107256650
27507,1196428',2018-10-12,RTGS/SBINH18285064200/Indfor,0.0,10000000.0,,2018,10,12,CASH_IN,10000000.0,M1410611700
27508,1196428',2018-10-12,RTGS/ICICH18285252351/Indfor,0.0,500000.0,,2018,10,12,TRANSFER,500000.0,M954062800
27509,1196428',2018-10-12,RTGS/ICICH18285251931/Indfor,0.0,1400000.0,,2018,10,12,CHECK_CASHING,1400000.0,M13013852
27510,1196428',2018-10-12,IMPS 828515153253 FROM PU,0.0,50000.0,,2018,10,12,CASH_IN,50000.0,M1101858256
27511,1196428',2018-10-12,IMPS 828516269937 FROM SA,0.0,200000.0,,2018,10,12,CHECK_CASHING,200000.0,M1180862248
27512,1196428',2018-10-12,Indiaforensic SERVICES INDIA PVT,0.0,117798.0,,2018,10,12,TRANSFER,117798.0,M966462848
27513,1196428',2018-10-12,FDRL/NATIONAL ELECTRONIC F,1000000.0,0.0,,2018,10,12,DEBIT,1000000.0,M1284324188
27514,1196428',2018-10-12,FDRL/NATIONAL ELECTRONIC F,1000000.0,0.0,,2018,10,12,CASH_OUT,1000000.0,C374625527
27515,1196428',2018-10-12,FDRL/NATIONAL ELECTRONIC F,1000000.0,0.0,,2018,10,12,CHECK_WITHDRAWAL,1000000.0,C1262822392
27516,1196428',2018-10-12,FDRL/NATIONAL ELECTRONIC F,1000000.0,0.0,,2018,10,12,CHECK_WITHDRAWAL,1000000.0,C1671386208
27517,1196428',2018-10-12,TRF FROM  Indiaforensic ONLINE S,0.0,1000000.0,,2018,10,12,CASH_IN,1000000.0,C1869197498
27518,1196428',2018-10-12,TRF FROM  Indiaforensic SERVICES,0.0,600000.0,,2018,10,12,CHECK_CASHING,600000.0,C271488817
27519,1196428',2018-10-12,FDRL/NATIONAL ELECTRONIC F,11638934.7,0.0,,2018,10,12,CHECK_WITHDRAWAL,11638934.7,M1915909017
27520,1196428',2018-10-12,TRF FROM  Indiaforensic SERVICES,0.0,10000000.0,,2018,10,12,CASH_IN,10000000.0,C2052185144
27521,1196428',2018-10-12,NEFT CHARGES AND GST/0000,29.5,0.0,,2018,10,12,PAYEMENT,29.5,C646059443
27522,1196428',2018-10-12,NEFT/000053117904/INDIAN,8700000.0,0.0,,2018,10,12,CASH_OUT,8700000.0,C1982591789
27523,1196428',2018-10-12,FDRL/INTERNAL FUND TRANSFE,1000000.0,0.0,,2018,10,12,CASH_OUT,1000000.0,C1977614404
27524,1196428',2018-10-12,FDRL/INTERNAL FUND TRANSFE,1000000.0,0.0,,2018,10,12,CHECK_WITHDRAWAL,1000000.0,C1883840933
27525,1196428',2018-10-12,TRF FROM  Indiaforensic SERVICES,0.0,4200000.0,,2018,10,12,CHECK_CASHING,4200000.0,C2007207148
27526,1196428',2018-10-12,FDRL/INTERNAL FUND TRANSFE,1000000.0,0.0,,2018,10,12,CHECK_WITHDRAWAL,1000000.0,M1014644493
27527,1196428',2018-10-12,FDRL/INTERNAL FUND TRANSFE,500000.0,0.0,,2018,10,12,CHECK_WITHDRAWAL,500000.0,C381605910
27528,1196428',2018-10-12,FDRL/INTERNAL FUND TRANSFE,1000000.0,0.0,,2018,10,12,CASH_OUT,1000000.0,M1056752544
27529,1196428',2018-10-12,FDRL/INTERNAL FUND TRANSFE,1000000.0,0.0,,2018,10,12,CASH_OUT,1000000.0,M729567968
27530,1196428',2018-10-12,FDRL/INTERNAL FUND TRANSFE,2000000.0,0.0,,2018,10,12,CHECK_WITHDRAWAL,2000000.0,M1723507087
27531,1196428',2018-10-12,FDRL/INTERNAL FUND TRANSFE,2000000.0,0.0,,2018,10,12,CASH_OUT,2000000.0,C849038219
27532,1196428',2018-10-12,BEAT CSH PKP DEL GURGA 72,0.0,122000.0,,2018,10,12,TRANSFER,122000.0,C1038678108
27533,1196428',2018-10-15,NEFT/PUNBH18288404638/BAL,0.0,125000.0,,2018,10,15,CASH_IN,125000.0,M1976340229
27534,1196428',2018-10-15,FDRL/INTERNAL FUND TRANSFE,500000.0,0.0,,2018,10,15,CASH_OUT,500000.0,M693274483
27535,1196428',2018-10-15,RTGS/UTIBH18288632082/Indfor,0.0,1000000.0,,2018,10,15,CASH_IN,1000000.0,M838050003
27536,1196428',2018-10-15,FDRL/INTERNAL FUND TRANSFE,500000.0,0.0,,2018,10,15,CHECK_WITHDRAWAL,500000.0,C1009972184
27537,1196428',2018-10-15,NEFT/SBIN718288203783/MR,0.0,100000.0,,2018,10,15,TRANSFER,100000.0,C63475121
27538,1196428',2018-10-15,RTGS/HDFCH18288085071/BAT,0.0,350000.0,,2018,10,15,CHECK_CASHING,350000.0,C1130075212
27539,1196428',2018-10-15,"Indiaforensic USA, INC./USD/4194",0.0,3070081.2,,2018,10,15,CASH_IN,3070081.2,C851316413
27540,1196428',2018-10-15,IRTT00701829564,1657.61,0.0,,2018,10,15,PAYEMENT,1657.61,M718843573
27541,1196428',2018-10-15,TRF FROM  Indiaforensic SERVICES,0.0,5300000.0,,2018,10,15,CASH_IN,5300000.0,M1217713614
27542,1196428',2018-10-15,RTGS/ICICH18288366075/Indfor,0.0,3500000.0,,2018,10,15,CHECK_CASHING,3500000.0,M706338650
27543,1196428',2018-10-15,CHQ DEP/2089/OWDEL1/SCBL/,0.0,50000.0,,2018,10,15,CHECK_CASHING,50000.0,M995800830
27544,1196428',2018-10-15,TRF FROM  Indiaforensic SERVICES,0.0,3000000.0,,2018,10,15,TRANSFER,3000000.0,C1073259437
27545,1196428',2018-10-15,TRF FROM  Indiaforensic SERVICES,0.0,4000000.0,,2018,10,15,TRANSFER,4000000.0,M1699315785
27546,1196428',2018-10-15,Indiaforensic SERVICES INDIA PVT,0.0,261511.0,,2018,10,15,CASH_IN,261511.0,M1163711030
27547,1196428',2018-10-15,FDRL/NATIONAL ELECTRONIC F,1000000.0,0.0,,2018,10,15,CHECK_WITHDRAWAL,1000000.0,C320106510
27548,1196428',2018-10-15,FDRL/NATIONAL ELECTRONIC F,1000000.0,0.0,,2018,10,15,CASH_OUT,1000000.0,M597251930
27549,1196428',2018-10-15,FDRL/NATIONAL ELECTRONIC F,1000000.0,0.0,,2018,10,15,CASH_OUT,1000000.0,M1515100477
27550,1196428',2018-10-15,TRF FROM  Indiaforensic SERVICES,0.0,15000000.0,,2018,10,15,CHECK_CASHING,15000000.0,M1412315921
27551,1196428',2018-10-15,TRF FROM  Indiaforensic SERVICES,0.0,15000000.0,,2018,10,15,TRANSFER,15000000.0,M1168923345
27552,1196428',2018-10-15,TRF FROM  Indiaforensic SERVICES,0.0,10000000.0,,2018,10,15,CHECK_CASHING,10000000.0,M2042700604
27553,1196428',2018-10-15,IMPS 828818917598 FROM OX,0.0,200000.0,,2018,10,15,CASH_IN,200000.0,C710481910
27554,1196428',2018-10-15,IMPS 828818917658 FROM OX,0.0,200000.0,,2018,10,15,CHECK_CASHING,200000.0,M1474634841
27555,1196428',2018-10-15,IMPS 828818917698 FROM OX,0.0,200000.0,,2018,10,15,TRANSFER,200000.0,C669419693
27556,1196428',2018-10-15,IMPS 828818917781 FROM OX,0.0,200000.0,,2018,10,15,CHECK_CASHING,200000.0,C2095611317
27557,1196428',2018-10-15,FDRL/NATIONAL ELECTRONIC F,9734526.09,0.0,,2018,10,15,CASH_OUT,9734526.09,C1316560467
27558,1196428',2018-10-15,FDRL/INTERNAL FUND TRANSFE,400000.0,0.0,,2018,10,15,PAYEMENT,400000.0,M1572144334
27559,1196428',2018-10-15,FDRL/INTERNAL FUND TRANSFE,400000.0,0.0,,2018,10,15,DEBIT,400000.0,M593517569
27560,1196428',2018-10-15,FDRL/INTERNAL FUND TRANSFE,3000000.0,0.0,,2018,10,15,CASH_OUT,3000000.0,M558730564
27561,1196428',2018-10-15,FDRL/INTERNAL FUND TRANSFE,1000000.0,0.0,,2018,10,15,CASH_OUT,1000000.0,C736160330
27562,1196428',2018-10-15,FDRL/INTERNAL FUND TRANSFE,1000000.0,0.0,,2018,10,15,PAYEMENT,1000000.0,C417236208
27563,1196428',2018-10-15,FDRL/INTERNAL FUND TRANSFE,2000000.0,0.0,,2018,10,15,CHECK_WITHDRAWAL,2000000.0,C931482420
27564,1196428',2018-10-15,FDRL/INTERNAL FUND TRANSFE,2000000.0,0.0,,2018,10,15,PAYEMENT,2000000.0,M405976415
27565,1196428',2018-10-15,TRF FROM  Indiaforensic SERVICES,0.0,1000000.0,,2018,10,15,TRANSFER,1000000.0,C208341157
27566,1196428',2018-10-15,TRF FROM  Indiaforensic SERVICES,0.0,3600000.0,,2018,10,15,CHECK_CASHING,3600000.0,C382697424
27567,1196428',2018-10-15,TRF FROM  Indiaforensic SERVICES,0.0,3000000.0,,2018,10,15,CHECK_CASHING,3000000.0,M875577692
27568,1196428',2018-10-15,BEAT CSH PKP DEL GURGA 72,0.0,285000.0,,2018,10,15,CASH_IN,285000.0,C1822578654
27569,1196428',2018-10-15,IMPS 828820437855 FROM SA,0.0,100000.0,,2018,10,15,CASH_IN,100000.0,M2022435822
27570,1196428',2018-10-16,FDRL/NATIONAL ELECTRONIC F,8700000.0,0.0,,2018,10,16,CASH_OUT,8700000.0,M1867372125
27571,1196428',2018-10-16,FDRL/NATIONAL ELECTRONIC F,8700000.0,0.0,,2018,10,16,CHECK_WITHDRAWAL,8700000.0,M556592378
27572,1196428',2018-10-16,FDRL/NATIONAL ELECTRONIC F,12902575.22,0.0,,2018,10,16,PAYEMENT,12902575.22,C807072084
27573,1196428',2018-10-16,FDRL/NATIONAL ELECTRONIC F,12488928.53,0.0,,2018,10,16,PAYEMENT,12488928.53,C2077098348
27574,1196428',2018-10-16,FDRL/INTERNAL FUND TRANSFE,500000.0,0.0,,2018,10,16,CHECK_WITHDRAWAL,500000.0,M1751878963
27575,1196428',2018-10-16,FDRL/NATIONAL ELECTRONIC F,37510.0,0.0,,2018,10,16,CHECK_WITHDRAWAL,37510.0,C1618278649
27576,1196428',2018-10-16,FDRL/NATIONAL ELECTRONIC F,38584.0,0.0,,2018,10,16,PAYEMENT,38584.0,C1987564320
27577,1196428',2018-10-16,FDRL/NATIONAL ELECTRONIC F,30183.0,0.0,,2018,10,16,DEBIT,30183.0,M848162783
27578,1196428',2018-10-16,FDRL/NATIONAL ELECTRONIC F,9840.0,0.0,,2018,10,16,CASH_OUT,9840.0,M347906624
27579,1196428',2018-10-16,FDRL/NATIONAL ELECTRONIC F,37509.0,0.0,,2018,10,16,CHECK_WITHDRAWAL,37509.0,M271658762
27580,1196428',2018-10-16,FDRL/NATIONAL ELECTRONIC F,36175.0,0.0,,2018,10,16,CHECK_WITHDRAWAL,36175.0,M1403007770
27581,1196428',2018-10-16,FDRL/NATIONAL ELECTRONIC F,33127.0,0.0,,2018,10,16,DEBIT,33127.0,M2043631011
27582,1196428',2018-10-16,FDRL/NATIONAL ELECTRONIC F,41256.0,0.0,,2018,10,16,CASH_OUT,41256.0,C107095723
27583,1196428',2018-10-16,FDRL/NATIONAL ELECTRONIC F,57512.0,0.0,,2018,10,16,CHECK_WITHDRAWAL,57512.0,C985934102
27584,1196428',2018-10-16,FDRL/NATIONAL ELECTRONIC F,82868.0,0.0,,2018,10,16,CHECK_WITHDRAWAL,82868.0,C824197891
27585,1196428',2018-10-16,FDRL/NATIONAL ELECTRONIC F,37510.0,0.0,,2018,10,16,DEBIT,37510.0,C1696218625
27586,1196428',2018-10-16,FDRL/NATIONAL ELECTRONIC F,75553.0,0.0,,2018,10,16,DEBIT,75553.0,M1817447589
27587,1196428',2018-10-16,FDRL/NATIONAL ELECTRONIC F,82619.0,0.0,,2018,10,16,CASH_OUT,82619.0,C168639687
27588,1196428',2018-10-16,FDRL/NATIONAL ELECTRONIC F,86467.0,0.0,,2018,10,16,CASH_OUT,86467.0,C1630293008
27589,1196428',2018-10-16,FDRL/NATIONAL ELECTRONIC F,54564.0,0.0,,2018,10,16,DEBIT,54564.0,C1577420620
27590,1196428',2018-10-16,FDRL/NATIONAL ELECTRONIC F,62588.0,0.0,,2018,10,16,CASH_OUT,62588.0,C35263828
27591,1196428',2018-10-16,FDRL/NATIONAL ELECTRONIC F,57514.0,0.0,,2018,10,16,PAYEMENT,57514.0,M2014874822
27592,1196428',2018-10-16,FDRL/NATIONAL ELECTRONIC F,65698.0,0.0,,2018,10,16,CHECK_WITHDRAWAL,65698.0,M1553772873
27593,1196428',2018-10-16,FDRL/NATIONAL ELECTRONIC F,59093.0,0.0,,2018,10,16,DEBIT,59093.0,C905650857
27594,1196428',2018-10-16,FDRL/NATIONAL ELECTRONIC F,58075.0,0.0,,2018,10,16,CASH_OUT,58075.0,C1502287290
27595,1196428',2018-10-16,FDRL/NATIONAL ELECTRONIC F,53809.0,0.0,,2018,10,16,CHECK_WITHDRAWAL,53809.0,M1197564988
27596,1196428',2018-10-16,FDRL/NATIONAL ELECTRONIC F,121468.0,0.0,,2018,10,16,CASH_OUT,121468.0,M1843534160
27597,1196428',2018-10-16,FDRL/NATIONAL ELECTRONIC F,51447.0,0.0,,2018,10,16,CASH_OUT,51447.0,C871895680
27598,1196428',2018-10-16,FDRL/NATIONAL ELECTRONIC F,101261.0,0.0,,2018,10,16,CASH_OUT,101261.0,C1398530689
27599,1196428',2018-10-16,FDRL/NATIONAL ELECTRONIC F,82815.0,0.0,,2018,10,16,CHECK_WITHDRAWAL,82815.0,M834859488
27600,1196428',2018-10-16,FDRL/NATIONAL ELECTRONIC F,32150.0,0.0,,2018,10,16,CHECK_WITHDRAWAL,32150.0,M463880076
27601,1196428',2018-10-16,FDRL/NATIONAL ELECTRONIC F,31213.0,0.0,,2018,10,16,CHECK_WITHDRAWAL,31213.0,M1273091698
27602,1196428',2018-10-16,FDRL/NATIONAL ELECTRONIC F,41857.0,0.0,,2018,10,16,CHECK_WITHDRAWAL,41857.0,M134350609
27603,1196428',2018-10-16,FDRL/NATIONAL ELECTRONIC F,42288.0,0.0,,2018,10,16,CHECK_WITHDRAWAL,42288.0,M1939822545
27604,1196428',2018-10-16,FDRL/NATIONAL ELECTRONIC F,31214.0,0.0,,2018,10,16,PAYEMENT,31214.0,M1498010747
27605,1196428',2018-10-16,IRTT00701829710,3034.69,0.0,,2018,10,16,PAYEMENT,3034.69,M615833646
27606,1196428',2018-10-16,"Indiaforensic USA, INC./USD/1460",0.0,10720510.4,,2018,10,16,CASH_IN,10720510.4,M695601535
27607,1196428',2018-10-16,MANDEEP KAUR,59000.0,0.0,,2018,10,16,CHECK_WITHDRAWAL,59000.0,M1741551200
27608,1196428',2018-10-16,TATA TELE SERVICES LTD,32400.0,0.0,,2018,10,16,CHECK_WITHDRAWAL,32400.0,M533060514
27609,1196428',2018-10-16,VODAFONE,16200.0,0.0,,2018,10,16,PAYEMENT,16200.0,M763925237
27610,1196428',2018-10-16,FDRL/REAL TIME GROSS SETTL,2000000.0,0.0,,2018,10,16,CHECK_WITHDRAWAL,2000000.0,M309397793
27611,1196428',2018-10-16,FDRL/REAL TIME GROSS SETTL,5000000.0,0.0,,2018,10,16,PAYEMENT,5000000.0,M786088183
27612,1196428',2018-10-16,FDRL/REAL TIME GROSS SETTL,5000000.0,0.0,,2018,10,16,CASH_OUT,5000000.0,M1362397723
27613,1196428',2018-10-16,TRF FROM  Indiaforensic SERVICES,0.0,4600000.0,,2018,10,16,CHECK_CASHING,4600000.0,M166947904
27614,1196428',2018-10-16,RTGS/ICICH18289528098/Indfor,0.0,1000000.0,,2018,10,16,CASH_IN,1000000.0,M39384037
27615,1196428',2018-10-16,RTGS/ICICH18289527469/Indfor,0.0,2000000.0,,2018,10,16,CASH_IN,2000000.0,M1475711030
27616,1196428',2018-10-16,RTGS/ICICH18289529307/Indfor,0.0,500000.0,,2018,10,16,TRANSFER,500000.0,M727579419
27617,1196428',2018-10-16,RTGS/ICICH18289545734/Indfor,0.0,1100000.0,,2018,10,16,CHECK_CASHING,1100000.0,M654290745
27618,1196428',2018-10-16,RTGS/SBINH18289055080/Indfor,0.0,11000000.0,,2018,10,16,CHECK_CASHING,11000000.0,C1559145228
27619,1196428',2018-10-16,IMPS 828915170196 FROM PU,0.0,40000.0,,2018,10,16,TRANSFER,40000.0,M688458571
27620,1196428',2018-10-16,FDRL/REAL TIME GROSS SETTL,2000000.0,0.0,,2018,10,16,PAYEMENT,2000000.0,M1895621189
27621,1196428',2018-10-16,Indiaforensic SERVICES INDIA PVT,0.0,91604.0,,2018,10,16,TRANSFER,91604.0,M1516781526
27622,1196428',2018-10-16,FDRL/NATIONAL ELECTRONIC F,8700000.0,0.0,,2018,10,16,CASH_OUT,8700000.0,M409559965
27623,1196428',2018-10-16,FDRL/INTERNAL FUND TRANSFE,300000.0,0.0,,2018,10,16,CASH_OUT,300000.0,M1771169983
27624,1196428',2018-10-16,TRF FROM  Indiaforensic SERVICES,0.0,10000000.0,,2018,10,16,TRANSFER,10000000.0,C470217116
27625,1196428',2018-10-16,FDRL/NATIONAL ELECTRONIC F,11520933.33,0.0,,2018,10,16,CHECK_WITHDRAWAL,11520933.33,M585745963
27626,1196428',2018-10-16,FDRL/INTERNAL FUND TRANSFE,200000.0,0.0,,2018,10,16,CASH_OUT,200000.0,M2096974885
27627,1196428',2018-10-16,FDRL/INTERNAL FUND TRANSFE,100000.0,0.0,,2018,10,16,DEBIT,100000.0,M1287228290
27628,1196428',2018-10-16,FDRL/NATIONAL ELECTRONIC F,56493.0,0.0,,2018,10,16,CASH_OUT,56493.0,M1178751818
27629,1196428',2018-10-16,FDRL/NATIONAL ELECTRONIC F,66998.0,0.0,,2018,10,16,CASH_OUT,66998.0,M145594829
27630,1196428',2018-10-16,FDRL/NATIONAL ELECTRONIC F,69353.0,0.0,,2018,10,16,CASH_OUT,69353.0,M1232351629
27631,1196428',2018-10-16,FDRL/NATIONAL ELECTRONIC F,1000000.0,0.0,,2018,10,16,CASH_OUT,1000000.0,M1656904340
27632,1196428',2018-10-16,FDRL/NATIONAL ELECTRONIC F,30302.0,0.0,,2018,10,16,CASH_OUT,30302.0,C24404443
27633,1196428',2018-10-16,FDRL/NATIONAL ELECTRONIC F,44405.0,0.0,,2018,10,16,DEBIT,44405.0,C596299019
27634,1196428',2018-10-16,FDRL/NATIONAL ELECTRONIC F,37626.0,0.0,,2018,10,16,CASH_OUT,37626.0,C1983747920
27635,1196428',2018-10-16,FDRL/NATIONAL ELECTRONIC F,45693.0,0.0,,2018,10,16,CHECK_WITHDRAWAL,45693.0,C696705647
27636,1196428',2018-10-16,FDRL/NATIONAL ELECTRONIC F,48127.0,0.0,,2018,10,16,DEBIT,48127.0,C1845765982
27637,1196428',2018-10-16,FDRL/NATIONAL ELECTRONIC F,42043.0,0.0,,2018,10,16,CASH_OUT,42043.0,M877365519
27638,1196428',2018-10-16,FDRL/NATIONAL ELECTRONIC F,36609.0,0.0,,2018,10,16,CHECK_WITHDRAWAL,36609.0,C134604590
27639,1196428',2018-10-16,FDRL/NATIONAL ELECTRONIC F,34160.0,0.0,,2018,10,16,PAYEMENT,34160.0,M1053485132
27640,1196428',2018-10-16,FDRL/NATIONAL ELECTRONIC F,42103.0,0.0,,2018,10,16,CHECK_WITHDRAWAL,42103.0,M1698378565
27641,1196428',2018-10-16,FDRL/NATIONAL ELECTRONIC F,65054.0,0.0,,2018,10,16,PAYEMENT,65054.0,M1418167825
27642,1196428',2018-10-16,FDRL/NATIONAL ELECTRONIC F,45929.0,0.0,,2018,10,16,PAYEMENT,45929.0,M915318947
27643,1196428',2018-10-16,FDRL/NATIONAL ELECTRONIC F,31595.0,0.0,,2018,10,16,CHECK_WITHDRAWAL,31595.0,M1471526064
27644,1196428',2018-10-16,FDRL/NATIONAL ELECTRONIC F,33900.0,0.0,,2018,10,16,PAYEMENT,33900.0,C474166728
27645,1196428',2018-10-16,FDRL/NATIONAL ELECTRONIC F,34258.0,0.0,,2018,10,16,CHECK_WITHDRAWAL,34258.0,M1777764920
27646,1196428',2018-10-16,FDRL/NATIONAL ELECTRONIC F,42223.0,0.0,,2018,10,16,DEBIT,42223.0,C1833549064
27647,1196428',2018-10-16,FDRL/NATIONAL ELECTRONIC F,37142.0,0.0,,2018,10,16,PAYEMENT,37142.0,M327804056
27648,1196428',2018-10-16,FDRL/NATIONAL ELECTRONIC F,45175.0,0.0,,2018,10,16,DEBIT,45175.0,M939893108
27649,1196428',2018-10-16,FDRL/INTERNAL FUND TRANSFE,40680.0,0.0,,2018,10,16,DEBIT,40680.0,C1938462589
27650,1196428',2018-10-16,FDRL/NATIONAL ELECTRONIC F,46750.0,0.0,,2018,10,16,PAYEMENT,46750.0,M974784761
27651,1196428',2018-10-16,FDRL/NATIONAL ELECTRONIC F,35030.0,0.0,,2018,10,16,PAYEMENT,35030.0,M209997138
27652,1196428',2018-10-16,FDRL/NATIONAL ELECTRONIC F,30264.0,0.0,,2018,10,16,PAYEMENT,30264.0,M359327148
27653,1196428',2018-10-16,TRF FROM  Indiaforensic SERVICES,0.0,3400000.0,,2018,10,16,CASH_IN,3400000.0,C1519216494
27654,1196428',2018-10-16,NEFT/SBIN818289815438/JAY,0.0,11800.0,,2018,10,16,CASH_IN,11800.0,M142106520
27655,1196428',2018-10-16,FDRL/INTERNAL FUND TRANSFE,3000000.0,0.0,,2018,10,16,CASH_OUT,3000000.0,C1979080020
27656,1196428',2018-10-16,FDRL/INTERNAL FUND TRANSFE,3000000.0,0.0,,2018,10,16,CASH_OUT,3000000.0,C635281078
27657,1196428',2018-10-16,FDRL/INTERNAL FUND TRANSFE,500000.0,0.0,,2018,10,16,DEBIT,500000.0,C1866672043
27658,1196428',2018-10-16,FDRL/INTERNAL FUND TRANSFE,1000000.0,0.0,,2018,10,16,CHECK_WITHDRAWAL,1000000.0,M155979068
27659,1196428',2018-10-16,FDRL/INTERNAL FUND TRANSFE,1000000.0,0.0,,2018,10,16,CHECK_WITHDRAWAL,1000000.0,M111496179
27660,1196428',2018-10-16,FDRL/INTERNAL FUND TRANSFE,100000.0,0.0,,2018,10,16,CASH_OUT,100000.0,M1472428747
27661,1196428',2018-10-16,FDRL/INTERNAL FUND TRANSFE,100000.0,0.0,,2018,10,16,PAYEMENT,100000.0,C1167813715
27662,1196428',2018-10-16,TRF FROM  Indiaforensic SERVICES,0.0,600000.0,,2018,10,16,CHECK_CASHING,600000.0,M235839070
27663,1196428',2018-10-16,TRF FROM  Indiaforensic SERVICES,0.0,1100000.0,,2018,10,16,CHECK_CASHING,1100000.0,M1881768592
27664,1196428',2018-10-16,TRF FROM  Indiaforensic SERVICES,0.0,900000.0,,2018,10,16,CASH_IN,900000.0,C185503802
27665,1196428',2018-10-16,BEAT CSH PKP DEL GURGA 72,0.0,84000.0,,2018,10,16,CASH_IN,84000.0,C403147759
27666,1196428',2018-10-17,NEFT/000053506155/Account,0.0,1000000.0,,2018,10,17,TRANSFER,1000000.0,M1725462644
27667,1196428',2018-10-17,FDRL/INTERNAL FUND TRANSFE,200000.0,0.0,,2018,10,17,DEBIT,200000.0,M685639359
27668,1196428',2018-10-17,FDRL/INTERNAL FUND TRANSFE,300000.0,0.0,,2018,10,17,CHECK_WITHDRAWAL,300000.0,M499928991
27669,1196428',2018-10-17,FDRL/INTERNAL FUND TRANSFE,200000.0,0.0,,2018,10,17,PAYEMENT,200000.0,M960322367
27670,1196428',2018-10-17,FDRL/INTERNAL FUND TRANSFE,300000.0,0.0,,2018,10,17,CHECK_WITHDRAWAL,300000.0,M1786085833
27671,1196428',2018-10-17,RTGS/SBINH18290009285/SAI,0.0,340000.0,,2018,10,17,CHECK_CASHING,340000.0,M718103121
27672,1196428',2018-10-17,NEFT/AT1610FIXED63033/FIX,0.0,200000.0,,2018,10,17,CHECK_CASHING,200000.0,M757687320
27673,1196428',2018-10-17,RTGS/HDFCH18290528863/BAT,0.0,500000.0,,2018,10,17,TRANSFER,500000.0,M1144148971
27674,1196428',2018-10-17,TRF FROM  Indiaforensic SERVICES,0.0,4400000.0,,2018,10,17,CHECK_CASHING,4400000.0,M1868505862
27675,1196428',2018-10-17,Indiaforensic SERVICES INDIA PVT,0.0,107505.0,,2018,10,17,CASH_IN,107505.0,M1608080402
27676,1196428',2018-10-17,NEFT/20766075721DC/ARTHAS,0.0,25000.0,,2018,10,17,TRANSFER,25000.0,M1154038476
27677,1196428',2018-10-17,IMPS 829016019204 FROM SA,0.0,50000.0,,2018,10,17,CASH_IN,50000.0,M1325923139
27678,1196428',2018-10-17,FD Booking 709005482544,25000.0,0.0,,2018,10,17,CASH_OUT,25000.0,M1396188238
27679,1196428',2018-10-17,IMPS 829017546454 FROM OX,0.0,200000.0,,2018,10,17,CASH_IN,200000.0,M554850979
27680,1196428',2018-10-17,FDRL/NATIONAL ELECTRONIC F,8700000.0,0.0,,2018,10,17,CHECK_WITHDRAWAL,8700000.0,M1055780232
27681,1196428',2018-10-17,TRF FROM  Indiaforensic SERVICES,0.0,900000.0,,2018,10,17,TRANSFER,900000.0,M662568271
27682,1196428',2018-10-17,TRF FROM  Indiaforensic SERVICES,0.0,10000000.0,,2018,10,17,CHECK_CASHING,10000000.0,C1649449847
27683,1196428',2018-10-17,TRF FROM  Indiaforensic SERVICES,0.0,4500000.0,,2018,10,17,CHECK_CASHING,4500000.0,C1198167820
27684,1196428',2018-10-17,TRF FROM  Indiaforensic SERVICES,0.0,500000.0,,2018,10,17,CHECK_CASHING,500000.0,C749672494
27685,1196428',2018-10-17,NEFT/N290180658539915/TEC,0.0,300000.0,,2018,10,17,CASH_IN,300000.0,C1423992712
27686,1196428',2018-10-17,NEFT/000054042393/Indiaforensic,0.0,2300000.0,,2018,10,17,CASH_IN,2300000.0,C313124964
27687,1196428',2018-10-17,PBGI01001800283:Bank Guar,2773.0,0.0,,2018,10,17,CHECK_WITHDRAWAL,2773.0,C500153041
27688,1196428',2018-10-17,NEFT/000054042559/Indiaforensic,0.0,2300000.0,,2018,10,17,TRANSFER,2300000.0,C728526866
27689,1196428',2018-10-17,TRF TO  Indiaforensic SERVICES I,225958.0,0.0,,2018,10,17,DEBIT,225958.0,C40075281
27690,1196428',2018-10-17,FDRL/INTERNAL FUND TRANSFE,3000000.0,0.0,,2018,10,17,CASH_OUT,3000000.0,C456538529
27691,1196428',2018-10-17,FDRL/INTERNAL FUND TRANSFE,3000000.0,0.0,,2018,10,17,CASH_OUT,3000000.0,C2117043942
27692,1196428',2018-10-17,NEFT CHARGES AND GST/0000,29.5,0.0,,2018,10,17,DEBIT,29.5,C1838584624
27693,1196428',2018-10-17,NEFT/000053640884/INDIAN,11294970.0,0.0,,2018,10,17,PAYEMENT,11294970.0,M1733424208
27694,1196428',2018-10-17,FDRL/INTERNAL FUND TRANSFE,1000000.0,0.0,,2018,10,17,CASH_OUT,1000000.0,M1060393794
27695,1196428',2018-10-17,FDRL/INTERNAL FUND TRANSFE,500000.0,0.0,,2018,10,17,DEBIT,500000.0,M226593165
27696,1196428',2018-10-17,FDRL/INTERNAL FUND TRANSFE,1000000.0,0.0,,2018,10,17,PAYEMENT,1000000.0,M426584880
27697,1196428',2018-10-17,FDRL/INTERNAL FUND TRANSFE,500000.0,0.0,,2018,10,17,DEBIT,500000.0,C448155494
27698,1196428',2018-10-17,TRF FROM  Indiaforensic SERVICES,0.0,700000.0,,2018,10,17,TRANSFER,700000.0,M1594302764
27699,1196428',2018-10-17,BEAT CSH PKP DEL GURGA 72,0.0,128000.0,,2018,10,17,CHECK_CASHING,128000.0,M271366306
27700,1196428',2018-10-18,NEFT/N291180658717047/JUN,0.0,90000.0,,2018,10,18,CASH_IN,90000.0,C348708793
27701,1196428',2018-10-18,TRF FROM  Indiaforensic SERVICES,0.0,4600000.0,,2018,10,18,TRANSFER,4600000.0,M462659391
27702,1196428',2018-10-18,CHQ DEP/218/OWDEL1/UCBA/N,0.0,11800.0,,2018,10,18,CASH_IN,11800.0,M547825235
27703,1196428',2018-10-18,IMPS 829113364046 FROM AS,0.0,120099.0,,2018,10,18,TRANSFER,120099.0,M1301971459
27704,1196428',2018-10-18,RTGS/HDFCH18291649894/Indfor,0.0,1500000.0,,2018,10,18,CASH_IN,1500000.0,M1155771218
27705,1196428',2018-10-18,FDRL/REAL TIME GROSS SETTL,3000000.0,0.0,,2018,10,18,CHECK_WITHDRAWAL,3000000.0,M734120998
27706,1196428',2018-10-18,IMPS 829115193542 FROM PU,0.0,40000.0,,2018,10,18,CHECK_CASHING,40000.0,M1404561012
27707,1196428',2018-10-18,FDRL/NATIONAL ELECTRONIC F,1000000.0,0.0,,2018,10,18,DEBIT,1000000.0,M1376999853
27708,1196428',2018-10-18,FDRL/NATIONAL ELECTRONIC F,1000000.0,0.0,,2018,10,18,CASH_OUT,1000000.0,M255307196
27709,1196428',2018-10-18,FDRL/NATIONAL ELECTRONIC F,1000000.0,0.0,,2018,10,18,CASH_OUT,1000000.0,M11285367
27710,1196428',2018-10-18,TRF FROM  Indiaforensic SERVICES,0.0,3000000.0,,2018,10,18,CASH_IN,3000000.0,M714914851
27711,1196428',2018-10-18,STAMP PAPER PURCHASING,100.0,0.0,,2018,10,18,DEBIT,100.0,M1438724935
27712,1196428',2018-10-18,TRF TO  Indiaforensic SERVICES I,315000.0,0.0,,2018,10,18,CHECK_WITHDRAWAL,315000.0,M662472677
27713,1196428',2018-10-18,NEFT/N291180658977060/BAT,0.0,350000.0,,2018,10,18,CASH_IN,350000.0,M1932384587
27714,1196428',2018-10-18,TRF FROM  Indiaforensic SERVICES,0.0,900000.0,,2018,10,18,CASH_IN,900000.0,M719480872
27715,1196428',2018-10-18,TRF FROM  Indiaforensic SERVICES,0.0,400000.0,,2018,10,18,CASH_IN,400000.0,M1278136570
27716,1196428',2018-10-18,NEFT/000054077205/Indiaforensic,0.0,1000000.0,,2018,10,18,CASH_IN,1000000.0,M148964727
27717,1196428',2018-10-18,NEFT/000054075193/Indiaforensic,0.0,1300000.0,,2018,10,18,CASH_IN,1300000.0,M1177742051
27718,1196428',2018-10-18,FDRL/INTERNAL FUND TRANSFE,1000000.0,0.0,,2018,10,18,CASH_OUT,1000000.0,M724365571
27719,1196428',2018-10-18,FDRL/INTERNAL FUND TRANSFE,2000000.0,0.0,,2018,10,18,CHECK_WITHDRAWAL,2000000.0,M212535805
27720,1196428',2018-10-18,FDRL/INTERNAL FUND TRANSFE,2000000.0,0.0,,2018,10,18,CASH_OUT,2000000.0,M1596397541
27721,1196428',2018-10-18,FDRL/INTERNAL FUND TRANSFE,1000000.0,0.0,,2018,10,18,PAYEMENT,1000000.0,M713285225
27722,1196428',2018-10-18,BEAT CSH PKP DEL GURGA 72,0.0,61000.0,,2018,10,18,CASH_IN,61000.0,C2032389005
27723,1196428',2018-10-19,FDRL/REAL TIME GROSS SETTL,2000000.0,0.0,,2018,10,19,DEBIT,2000000.0,M1156533869
27724,1196428',2018-10-19,CASHDEP/BOISAR/,0.0,8000.0,,2018,10,19,CHECK_CASHING,8000.0,M105292474
27725,1196428',2018-10-19,TFR FRM 409000438620  Indfor,0.0,3000000.0,,2018,10,19,CHECK_CASHING,3000000.0,M1410438390
27726,1196428',2018-10-19,TFR FRM 409000438611  Indfor,0.0,5000000.0,,2018,10,19,CHECK_CASHING,5000000.0,M1257755465
27727,1196428',2018-10-19,TFR FRM 409000438611  Indfor,0.0,5000000.0,,2018,10,19,TRANSFER,5000000.0,M1640401120
27728,1196428',2018-10-19,TRF FRM 409000438611  Indfor,0.0,5000000.0,,2018,10,19,CASH_IN,5000000.0,M1399060771
27729,1196428',2018-10-19,TFR FRM 409000438611  Indfor,0.0,5000000.0,,2018,10,19,TRANSFER,5000000.0,C1262822392
27730,1196428',2018-10-19,TFR FRM 409000438611  Indfor,0.0,2000000.0,,2018,10,19,CASH_IN,2000000.0,M148589770
27731,1196428',2018-10-19,TFR FRM 409000438611  Indfor,0.0,2000000.0,,2018,10,19,CHECK_CASHING,2000000.0,M984489239
27732,1196428',2018-10-19,FDRL/INTERNAL FUND TRANSFE,500000.0,0.0,,2018,10,19,PAYEMENT,500000.0,C2115055717
27733,1196428',2018-10-19,FDRL/INTERNAL FUND TRANSFE,500000.0,0.0,,2018,10,19,PAYEMENT,500000.0,C1166654566
27734,1196428',2018-10-19,FDRL/INTERNAL FUND TRANSFE,3000000.0,0.0,,2018,10,19,CHECK_WITHDRAWAL,3000000.0,M88042020
27735,1196428',2018-10-20,IMPS 829311150141 FROM SA,0.0,200000.0,,2018,10,20,CASH_IN,200000.0,M717278894
27736,1196428',2018-10-20,NEFT/SBIN118293581214/MR,0.0,100000.0,,2018,10,20,CASH_IN,100000.0,M129220812
27737,1196428',2018-10-20,TRF FROM  Indiaforensic SERVICES,0.0,1000000.0,,2018,10,20,CHECK_CASHING,1000000.0,M1015272304
27738,1196428',2018-10-20,TRF FROM  Indiaforensic SERVICES,0.0,1000000.0,,2018,10,20,CHECK_CASHING,1000000.0,C1007717381
27739,1196428',2018-10-20,TRF FROM  Indiaforensic SERVICES,0.0,1000000.0,,2018,10,20,TRANSFER,1000000.0,C1240091493
27740,1196428',2018-10-20,NEFT/N293180659646172/JUN,0.0,70000.0,,2018,10,20,TRANSFER,70000.0,C1396297158
27741,1196428',2018-10-20,NEFT/SBIN118293706003/SRI,0.0,100000.0,,2018,10,20,TRANSFER,100000.0,M705803524
27742,1196428',2018-10-20,TRF FROM  Indiaforensic SERVICES,0.0,2000000.0,,2018,10,20,CASH_IN,2000000.0,C978740207
27743,1196428',2018-10-20,TRF FROM  Indiaforensic SERVICES,0.0,1000000.0,,2018,10,20,CHECK_CASHING,1000000.0,C115885991
27744,1196428',2018-10-20,FDRL/NATIONAL ELECTRONIC F,2500.0,0.0,,2018,10,20,CASH_OUT,2500.0,C587433505
27745,1196428',2018-10-20,FDRL/NATIONAL ELECTRONIC F,2500.0,0.0,,2018,10,20,PAYEMENT,2500.0,C1637186972
27746,1196428',2018-10-20,FDRL/NATIONAL ELECTRONIC F,1500.0,0.0,,2018,10,20,PAYEMENT,1500.0,M190739308
27747,1196428',2018-10-20,FDRL/NATIONAL ELECTRONIC F,1500.0,0.0,,2018,10,20,PAYEMENT,1500.0,C778306577
27748,1196428',2018-10-20,FDRL/NATIONAL ELECTRONIC F,2000.0,0.0,,2018,10,20,PAYEMENT,2000.0,M1863711975
27749,1196428',2018-10-20,FDRL/NATIONAL ELECTRONIC F,2500.0,0.0,,2018,10,20,PAYEMENT,2500.0,M1469855297
27750,1196428',2018-10-20,FDRL/NATIONAL ELECTRONIC F,2500.0,0.0,,2018,10,20,PAYEMENT,2500.0,M794421806
27751,1196428',2018-10-20,FDRL/NATIONAL ELECTRONIC F,5000.0,0.0,,2018,10,20,PAYEMENT,5000.0,M1334051844
27752,1196428',2018-10-20,FDRL/NATIONAL ELECTRONIC F,3000.0,0.0,,2018,10,20,CASH_OUT,3000.0,M515450283
27753,1196428',2018-10-20,FDRL/NATIONAL ELECTRONIC F,3000.0,0.0,,2018,10,20,DEBIT,3000.0,M1747790771
27754,1196428',2018-10-20,FDRL/NATIONAL ELECTRONIC F,5000.0,0.0,,2018,10,20,PAYEMENT,5000.0,M1284135884
27755,1196428',2018-10-20,FDRL/NATIONAL ELECTRONIC F,2000.0,0.0,,2018,10,20,CHECK_WITHDRAWAL,2000.0,C420561530
27756,1196428',2018-10-20,FDRL/NATIONAL ELECTRONIC F,2500.0,0.0,,2018,10,20,PAYEMENT,2500.0,M694158341
27757,1196428',2018-10-20,FDRL/NATIONAL ELECTRONIC F,2500.0,0.0,,2018,10,20,DEBIT,2500.0,C2046578329
27758,1196428',2018-10-20,FDRL/NATIONAL ELECTRONIC F,8700000.0,0.0,,2018,10,20,DEBIT,8700000.0,M942812964
27759,1196428',2018-10-20,FDRL/NATIONAL ELECTRONIC F,7653819.08,0.0,,2018,10,20,DEBIT,7653819.08,M1977844832
27760,1196428',2018-10-20,FDRL/NATIONAL ELECTRONIC F,7653819.08,0.0,,2018,10,20,CHECK_WITHDRAWAL,7653819.08,M1171276229
27761,1196428',2018-10-20,IMPS 829315183327 FROM PU,0.0,30000.0,,2018,10,20,TRANSFER,30000.0,M1741253456
27762,1196428',2018-10-20,RTGS/SBINH18293047756/MS,0.0,605000.0,,2018,10,20,CASH_IN,605000.0,M1549630173
27763,1196428',2018-10-20,NEFT/SBIN118293827721/SRI,0.0,175000.0,,2018,10,20,TRANSFER,175000.0,C1548218207
27764,1196428',2018-10-20,RTGS/ICICH18293207827/Indfor,0.0,2000000.0,,2018,10,20,TRANSFER,2000000.0,C242559404
27765,1196428',2018-10-20,RTGS/SBINH18293060001/Indfor,0.0,1100000.0,,2018,10,20,CHECK_CASHING,1100000.0,C1153596299
27766,1196428',2018-10-20,RTGS/SBINH18293058982/Indfor,0.0,12500000.0,,2018,10,20,TRANSFER,12500000.0,M708011911
27767,1196428',2018-10-20,IMPS 829316232956 FROM OX,0.0,200000.0,,2018,10,20,TRANSFER,200000.0,M1579526490
27768,1196428',2018-10-20,IMPS 829316233002 FROM OX,0.0,200000.0,,2018,10,20,TRANSFER,200000.0,C1924874046
27769,1196428',2018-10-20,IMPS 829316233028 FROM OX,0.0,200000.0,,2018,10,20,CHECK_CASHING,200000.0,C1079343872
27770,1196428',2018-10-20,FDRL/NATIONAL ELECTRONIC F,11260002.16,0.0,,2018,10,20,DEBIT,11260002.16,M1025387324
27771,1196428',2018-10-20,FDRL/NATIONAL ELECTRONIC F,11260002.16,0.0,,2018,10,20,PAYEMENT,11260002.16,M2114990234
27772,1196428',2018-10-20,TRF FROM  Indiaforensic SERVICES,0.0,1000000.0,,2018,10,20,CASH_IN,1000000.0,M1843420945
27773,1196428',2018-10-20,TRF FROM  Indiaforensic SERVICES,0.0,3000000.0,,2018,10,20,CASH_IN,3000000.0,C863811613
27774,1196428',2018-10-20,TRF FROM  Indiaforensic SERVICES,0.0,3000000.0,,2018,10,20,TRANSFER,3000000.0,M1539382844
27775,1196428',2018-10-20,FDRL/NATIONAL ELECTRONIC F,1000000.0,0.0,,2018,10,20,PAYEMENT,1000000.0,M1846768700
27776,1196428',2018-10-20,FDRL/NATIONAL ELECTRONIC F,1000000.0,0.0,,2018,10,20,DEBIT,1000000.0,C1640747200
27777,1196428',2018-10-20,FDRL/INTERNAL FUND TRANSFE,500000.0,0.0,,2018,10,20,CHECK_WITHDRAWAL,500000.0,M1099038981
27778,1196428',2018-10-20,FDRL/INTERNAL FUND TRANSFE,2000000.0,0.0,,2018,10,20,PAYEMENT,2000000.0,C344610846
27779,1196428',2018-10-20,FDRL/INTERNAL FUND TRANSFE,2000000.0,0.0,,2018,10,20,CASH_OUT,2000000.0,C1919277981
27780,1196428',2018-10-20,FDRL/INTERNAL FUND TRANSFE,500000.0,0.0,,2018,10,20,PAYEMENT,500000.0,C2104652067
27781,1196428',2018-10-20,BEAT CSH PKP DEL GURGA 72,0.0,181100.0,,2018,10,20,TRANSFER,181100.0,C1092465037
27782,1196428',2018-10-22,NEFT/IOBAN18293557019/K,0.0,2500.0,,2018,10,22,TRANSFER,2500.0,M995633719
27783,1196428',2018-10-22,RTGS/HDFCH18295008159/JUN,0.0,250000.0,,2018,10,22,CASH_IN,250000.0,M938465080
27784,1196428',2018-10-22,"Indiaforensic USA, INC./USD/5198",0.0,3795059.8,,2018,10,22,CASH_IN,3795059.8,M1834981639
27785,1196428',2018-10-22,IRTT00701830145,1788.11,0.0,,2018,10,22,CHECK_WITHDRAWAL,1788.11,M1775303360
27786,1196428',2018-10-22,FDRL/NATIONAL ELECTRONIC F,127695.0,0.0,,2018,10,22,CASH_OUT,127695.0,M261084274
27787,1196428',2018-10-22,FDRL/NATIONAL ELECTRONIC F,156500.0,0.0,,2018,10,22,CHECK_WITHDRAWAL,156500.0,M1007295516
27788,1196428',2018-10-22,FDRL/NXTXN_PAYMENT,0.0,8900.0,,2018,10,22,CHECK_CASHING,8900.0,M470234716
27789,1196428',2018-10-22,FDRL/IndforSECURE_PAYMENT,0.0,20920.0,,2018,10,22,CASH_IN,20920.0,M905290562
27790,1196428',2018-10-22,TRF FROM  Indiaforensic SERVICES,0.0,5000000.0,,2018,10,22,CASH_IN,5000000.0,M798935213
27791,1196428',2018-10-22,TRF FROM  Indiaforensic SERVICES,0.0,1000000.0,,2018,10,22,CHECK_CASHING,1000000.0,M1932154134
27792,1196428',2018-10-22,TRF FROM  Indiaforensic SERVICES,0.0,500000.0,,2018,10,22,CHECK_CASHING,500000.0,M1426777731
27793,1196428',2018-10-22,RTGS/ICICH18295312118/Indfor,0.0,500000.0,,2018,10,22,TRANSFER,500000.0,M2001931511
27794,1196428',2018-10-22,RTGS/ICICH18295321847/Indfor,0.0,500000.0,,2018,10,22,CHECK_CASHING,500000.0,M1028639221
27795,1196428',2018-10-22,IRTT00701830154,1958.91,0.0,,2018,10,22,PAYEMENT,1958.91,M129965176
27796,1196428',2018-10-22,"Indiaforensic USA, INC./USD/6497",0.0,4743970.77,,2018,10,22,TRANSFER,4743970.77,M1666930496
27797,1196428',2018-10-22,NEFT/PUNBH18295625191/BAL,0.0,175000.0,,2018,10,22,TRANSFER,175000.0,M1348049534
27798,1196428',2018-10-22,RTGS/SBINH18295060863/Indfor,0.0,8000000.0,,2018,10,22,CASH_IN,8000000.0,M149861385
27799,1196428',2018-10-22,FDRL/NATIONAL ELECTRONIC F,14916156.31,0.0,,2018,10,22,DEBIT,14916156.31,M1803845616
27800,1196428',2018-10-22,NEFT/000054224041/Indiaforensic,0.0,500000.0,,2018,10,22,CHECK_CASHING,500000.0,M396463835
27801,1196428',2018-10-22,RTGS/ICICH18295349218/Indfor,0.0,1000000.0,,2018,10,22,CHECK_CASHING,1000000.0,M1022045468
27802,1196428',2018-10-22,FDRL/NATIONAL ELECTRONIC F,3000000.0,0.0,,2018,10,22,CASH_OUT,3000000.0,M1556446144
27803,1196428',2018-10-22,IMPS 829516486629 FROM SA,0.0,50000.0,,2018,10,22,CASH_IN,50000.0,M141959252
27804,1196428',2018-10-22,NEFT/N295180660819459/TEC,0.0,200000.0,,2018,10,22,TRANSFER,200000.0,M1997459283
27805,1196428',2018-10-22,TRF FROM  Indiaforensic SERVICES,0.0,1500000.0,,2018,10,22,CHECK_CASHING,1500000.0,M539292855
27806,1196428',2018-10-22,TRF FROM  Indiaforensic SERVICES,0.0,1300000.0,,2018,10,22,CASH_IN,1300000.0,M878266233
27807,1196428',2018-10-22,NEFT/000054246664/Indiaforensic,0.0,1500000.0,,2018,10,22,TRANSFER,1500000.0,M1660780699
27808,1196428',2018-10-22,TRF FROM  Indiaforensic SERVICES,0.0,15000000.0,,2018,10,22,CASH_IN,15000000.0,M1242431450
27809,1196428',2018-10-22,TRF FROM  Indiaforensic SERVICES,0.0,15000000.0,,2018,10,22,TRANSFER,15000000.0,M2075133206
27810,1196428',2018-10-22,NEFT CHARGES AND GST/0000,29.5,0.0,,2018,10,22,PAYEMENT,29.5,M1651383848
27811,1196428',2018-10-22,NEFT/000054081217/INDIAN,14028000.0,0.0,,2018,10,22,PAYEMENT,14028000.0,M1364290623
27812,1196428',2018-10-22,NEFT CHARGES AND GST/0000,29.5,0.0,,2018,10,22,CHECK_WITHDRAWAL,29.5,M1119145556
27813,1196428',2018-10-22,NEFT/000054081059/INDIAN,10033055.0,0.0,,2018,10,22,DEBIT,10033055.0,M552762676
27814,1196428',2018-10-22,TRF FROM  Indiaforensic SERVICES,0.0,500000.0,,2018,10,22,TRANSFER,500000.0,M1549335447
27815,1196428',2018-10-22,NEFT CHARGES AND GST/0000,29.5,0.0,,2018,10,22,DEBIT,29.5,M1407332998
27816,1196428',2018-10-22,NEFT/000054081188/INDIAN,10033055.0,0.0,,2018,10,22,CHECK_WITHDRAWAL,10033055.0,M575173490
27817,1196428',2018-10-22,FDRL/INTERNAL FUND TRANSFE,1000000.0,0.0,,2018,10,22,PAYEMENT,1000000.0,M1463959599
27818,1196428',2018-10-22,FDRL/INTERNAL FUND TRANSFE,1000000.0,0.0,,2018,10,22,CHECK_WITHDRAWAL,1000000.0,C191614132
27819,1196428',2018-10-22,FDRL/INTERNAL FUND TRANSFE,5000000.0,0.0,,2018,10,22,CASH_OUT,5000000.0,C1885712019
27820,1196428',2018-10-22,FDRL/INTERNAL FUND TRANSFE,500000.0,0.0,,2018,10,22,CASH_OUT,500000.0,M1406881784
27821,1196428',2018-10-22,BEAT CSH PKP DEL GURGA 72,0.0,292200.0,,2018,10,22,CASH_IN,292200.0,C1161865950
27822,1196428',2018-10-23,Indiaforensic SERVICES INDIA PVT,0.0,405838.0,,2018,10,23,CHECK_CASHING,405838.0,M1558051277
27823,1196428',2018-10-23,NEFT/SBIN218296906206/HAR,0.0,201.0,,2018,10,23,CHECK_CASHING,201.0,M1173085824
27824,1196428',2018-10-23,"Indiaforensic USA, INC./USD/1235",0.0,9083203.5,,2018,10,23,TRANSFER,9083203.5,M569018137
27825,1196428',2018-10-23,IRTT00701830406,2739.98,0.0,,2018,10,23,DEBIT,2739.98,M1770271962
27826,1196428',2018-10-23,FDRL/REAL TIME GROSS SETTL,1000000.0,0.0,,2018,10,23,CASH_OUT,1000000.0,M1586738337
27827,1196428',2018-10-23,FDRL/REAL TIME GROSS SETTL,5000000.0,0.0,,2018,10,23,DEBIT,5000000.0,M1674738101
27828,1196428',2018-10-23,FDRL/REAL TIME GROSS SETTL,5000000.0,0.0,,2018,10,23,CASH_OUT,5000000.0,C1590550415
27829,1196428',2018-10-23,TRF FROM  Indiaforensic SERVICES,0.0,5200000.0,,2018,10,23,TRANSFER,5200000.0,C705321061
27830,1196428',2018-10-23,FDRL/REAL TIME GROSS SETTL,5000000.0,0.0,,2018,10,23,DEBIT,5000000.0,M873689156
27831,1196428',2018-10-23,RTGS/ICICH18296465630/Indfor,0.0,1000000.0,,2018,10,23,TRANSFER,1000000.0,M1538317866
27832,1196428',2018-10-23,RTGS/ICICH18296466569/Indfor,0.0,500000.0,,2018,10,23,TRANSFER,500000.0,C262828207
27833,1196428',2018-10-23,RTGS/SBINH18296054384/Indfor,0.0,3300000.0,,2018,10,23,CHECK_CASHING,3300000.0,C1222590577
27834,1196428',2018-10-23,RTGS/SBINH18296063578/SAI,0.0,465000.0,,2018,10,23,CASH_IN,465000.0,M2089852906
27835,1196428',2018-10-23,Indiaforensic SERVICES INDIA PVT,0.0,108364.0,,2018,10,23,CHECK_CASHING,108364.0,M629502621
27836,1196428',2018-10-23,IRTT00701830471,2170.54,0.0,,2018,10,23,CHECK_WITHDRAWAL,2170.54,M511596806
27837,1196428',2018-10-23,"Indiaforensic USA, INC./USD/8054",0.0,5919690.0,,2018,10,23,CHECK_CASHING,5919690.0,M2079635991
27838,1196428',2018-10-23,FDRL/INTERNAL FUND TRANSFE,400000.0,0.0,,2018,10,23,PAYEMENT,400000.0,M1044456366
27839,1196428',2018-10-23,NEFT/N296180661591550/BAT,0.0,500000.0,,2018,10,23,CHECK_CASHING,500000.0,C1689840534
27840,1196428',2018-10-23,FDRL/NATIONAL ELECTRONIC F,9193450.28,0.0,,2018,10,23,DEBIT,9193450.28,M1092817314
27841,1196428',2018-10-23,FDRL/NATIONAL ELECTRONIC F,59427.0,0.0,,2018,10,23,PAYEMENT,59427.0,C1475909248
27842,1196428',2018-10-23,FDRL/NATIONAL ELECTRONIC F,72186.0,0.0,,2018,10,23,CASH_OUT,72186.0,M2040472550
27843,1196428',2018-10-23,FDRL/NATIONAL ELECTRONIC F,69935.0,0.0,,2018,10,23,CHECK_WITHDRAWAL,69935.0,C979719862
27844,1196428',2018-10-23,FDRL/NATIONAL ELECTRONIC F,80432.0,0.0,,2018,10,23,PAYEMENT,80432.0,C985934102
27845,1196428',2018-10-23,FDRL/NATIONAL ELECTRONIC F,84750.0,0.0,,2018,10,23,PAYEMENT,84750.0,C731253803
27846,1196428',2018-10-23,FDRL/NATIONAL ELECTRONIC F,61605.0,0.0,,2018,10,23,CHECK_WITHDRAWAL,61605.0,C1609562230
27847,1196428',2018-10-23,FDRL/NATIONAL ELECTRONIC F,60748.0,0.0,,2018,10,23,CASH_OUT,60748.0,M1076923640
27848,1196428',2018-10-23,FDRL/NATIONAL ELECTRONIC F,78494.0,0.0,,2018,10,23,DEBIT,78494.0,M1144262832
27849,1196428',2018-10-23,FDRL/NATIONAL ELECTRONIC F,50263.0,0.0,,2018,10,23,PAYEMENT,50263.0,M942922351
27850,1196428',2018-10-23,FDRL/NATIONAL ELECTRONIC F,53083.0,0.0,,2018,10,23,DEBIT,53083.0,M1582038853
27851,1196428',2018-10-23,TRF FROM  Indiaforensic SERVICES,0.0,800000.0,,2018,10,23,CHECK_CASHING,800000.0,M36034212
27852,1196428',2018-10-23,TRF TO  Indiaforensic SERVICES I,10400.0,0.0,,2018,10,23,CASH_OUT,10400.0,M1326356346
27853,1196428',2018-10-23,FDRL/NATIONAL ELECTRONIC F,58444.0,0.0,,2018,10,23,PAYEMENT,58444.0,C27489818
27854,1196428',2018-10-23,FDRL/NATIONAL ELECTRONIC F,68525.0,0.0,,2018,10,23,PAYEMENT,68525.0,C747979499
27855,1196428',2018-10-23,FDRL/NATIONAL ELECTRONIC F,61275.0,0.0,,2018,10,23,PAYEMENT,61275.0,C1660095722
27856,1196428',2018-10-23,FDRL/NATIONAL ELECTRONIC F,78727.0,0.0,,2018,10,23,PAYEMENT,78727.0,C372017580
27857,1196428',2018-10-23,TRF FROM  Indiaforensic SERVICES,0.0,5000000.0,,2018,10,23,CHECK_CASHING,5000000.0,M370179552
27858,1196428',2018-10-23,TRF FROM  Indiaforensic SERVICES,0.0,5000000.0,,2018,10,23,CASH_IN,5000000.0,C802935635
27859,1196428',2018-10-23,NEFT CHARGES AND GST/0000,29.5,0.0,,2018,10,23,DEBIT,29.5,M1523086740
27860,1196428',2018-10-23,NEFT/000054189302/INDIAN,9193450.0,0.0,,2018,10,23,CASH_OUT,9193450.0,M902885640
27861,1196428',2018-10-23,TRF FROM  Indiaforensic SERVICES,0.0,3700000.0,,2018,10,23,CHECK_CASHING,3700000.0,C459172227
27862,1196428',2018-10-23,FDRL/INTERNAL FUND TRANSFE,500000.0,0.0,,2018,10,23,CHECK_WITHDRAWAL,500000.0,C265108079
27863,1196428',2018-10-23,FDRL/INTERNAL FUND TRANSFE,500000.0,0.0,,2018,10,23,DEBIT,500000.0,C35126588
27864,1196428',2018-10-23,FDRL/INTERNAL FUND TRANSFE,100000.0,0.0,,2018,10,23,DEBIT,100000.0,C1589477624
27865,1196428',2018-10-23,FDRL/INTERNAL FUND TRANSFE,100000.0,0.0,,2018,10,23,CHECK_WITHDRAWAL,100000.0,C1283595719
27866,1196428',2018-10-23,FDRL/INTERNAL FUND TRANSFE,2000000.0,0.0,,2018,10,23,CHECK_WITHDRAWAL,2000000.0,C101084405
27867,1196428',2018-10-23,FDRL/INTERNAL FUND TRANSFE,200000.0,0.0,,2018,10,23,PAYEMENT,200000.0,M7891579
27868,1196428',2018-10-23,FDRL/INTERNAL FUND TRANSFE,500000.0,0.0,,2018,10,23,PAYEMENT,500000.0,M150228660
27869,1196428',2018-10-23,FDRL/INTERNAL FUND TRANSFE,3000000.0,0.0,,2018,10,23,DEBIT,3000000.0,M190019040
27870,1196428',2018-10-23,BEAT CSH PKP DEL GURGA 72,0.0,162500.0,,2018,10,23,TRANSFER,162500.0,M1462909495
27871,1196428',2018-10-24,NEFT/PUNBH18297948209/MAN,0.0,5000.0,,2018,10,24,CHECK_CASHING,5000.0,C1192983708
27872,1196428',2018-10-24,IMPS 829710308487 FROM PU,0.0,30000.0,,2018,10,24,CASH_IN,30000.0,M1730398598
27873,1196428',2018-10-24,RTGS/HDFCH18297358547/BAT,0.0,500000.0,,2018,10,24,TRANSFER,500000.0,M1492635498
27874,1196428',2018-10-24,TRF FROM  Indiaforensic SERVICES,0.0,4600000.0,,2018,10,24,CASH_IN,4600000.0,M738483886
27875,1196428',2018-10-24,FDRL/REAL TIME GROSS SETTL,5000000.0,0.0,,2018,10,24,CASH_OUT,5000000.0,M1583014678
27876,1196428',2018-10-24,FDRL/INTERNAL FUND TRANSFE,100000.0,0.0,,2018,10,24,CHECK_WITHDRAWAL,100000.0,C395114097
27877,1196428',2018-10-24,FDRL/INTERNAL FUND TRANSFE,300000.0,0.0,,2018,10,24,CASH_OUT,300000.0,M743943553
27878,1196428',2018-10-24,RTGS/SBINH18297049714/Indfor,0.0,5000000.0,,2018,10,24,CASH_IN,5000000.0,M2034445578
27879,1196428',2018-10-24,FDRL/NATIONAL ELECTRONIC F,122563.0,0.0,,2018,10,24,PAYEMENT,122563.0,C1383942363
27880,1196428',2018-10-24,FDRL/NATIONAL ELECTRONIC F,105965.0,0.0,,2018,10,24,DEBIT,105965.0,M72285092
27881,1196428',2018-10-24,FDRL/NATIONAL ELECTRONIC F,109176.0,0.0,,2018,10,24,DEBIT,109176.0,M586185216
27882,1196428',2018-10-24,FDRL/NATIONAL ELECTRONIC F,135816.0,0.0,,2018,10,24,DEBIT,135816.0,M1378755468
27883,1196428',2018-10-24,FDRL/NATIONAL ELECTRONIC F,109050.0,0.0,,2018,10,24,CASH_OUT,109050.0,C765980478
27884,1196428',2018-10-24,FDRL/INTERNAL FUND TRANSFE,1500000.0,0.0,,2018,10,24,PAYEMENT,1500000.0,C1200314947
27885,1196428',2018-10-24,TRF FROM  Indiaforensic SERVICES,0.0,14400000.0,,2018,10,24,CASH_IN,14400000.0,C1973491942
27886,1196428',2018-10-24,TRF FROM  Indiaforensic SERVICES,0.0,400000.0,,2018,10,24,CASH_IN,400000.0,C1689374891
27887,1196428',2018-10-24,FDRL/INTERNAL FUND TRANSFE,500000.0,0.0,,2018,10,24,PAYEMENT,500000.0,C2053639017
27888,1196428',2018-10-24,FDRL/INTERNAL FUND TRANSFE,500000.0,0.0,,2018,10,24,CHECK_WITHDRAWAL,500000.0,C1654056127
27889,1196428',2018-10-24,FDRL/INTERNAL FUND TRANSFE,500000.0,0.0,,2018,10,24,PAYEMENT,500000.0,C803368825
27890,1196428',2018-10-24,FDRL/INTERNAL FUND TRANSFE,1000000.0,0.0,,2018,10,24,DEBIT,1000000.0,C892686452
27891,1196428',2018-10-24,NEFT CHARGES AND GST/0000,29.5,0.0,,2018,10,24,PAYEMENT,29.5,C2031563133
27892,1196428',2018-10-24,NEFT/000054293055/INDIAN,7610675.0,0.0,,2018,10,24,CHECK_WITHDRAWAL,7610675.0,C1619402333
27893,1196428',2018-10-24,NEFT CHARGES AND GST/0000,29.5,0.0,,2018,10,24,PAYEMENT,29.5,C1149273771
27894,1196428',2018-10-24,NEFT/000054293149/INDIAN,7610675.0,0.0,,2018,10,24,DEBIT,7610675.0,C2109470512
27895,1196428',2018-10-24,BEAT CSH PKP DEL GURGA 72,0.0,72500.0,,2018,10,24,CHECK_CASHING,72500.0,C1059781259
27896,1196428',2018-10-25,RTGS/PUNBH18298078753/MAN,0.0,200000.0,,2018,10,25,TRANSFER,200000.0,C125722707
27897,1196428',2018-10-25,RTGS/ICICH18298627390/Indfor,0.0,2700000.0,,2018,10,25,CASH_IN,2700000.0,C1778300121
27898,1196428',2018-10-25,RTGS/ICICH18298627452/Indfor,0.0,500000.0,,2018,10,25,TRANSFER,500000.0,C313124964
27899,1196428',2018-10-25,NEFT/PUNBH18298113380/BAL,0.0,150000.0,,2018,10,25,CHECK_CASHING,150000.0,C1220897602
27900,1196428',2018-10-25,RTGS/SBINH18298006803/SAI,0.0,2000000.0,,2018,10,25,CHECK_CASHING,2000000.0,C1515704208
27901,1196428',2018-10-25,Indiaforensic SERVICES INDIA PVT,0.0,97797.0,,2018,10,25,CASH_IN,97797.0,C1313534832
27902,1196428',2018-10-25,RTGS/PUNBH18298083766/MAN,0.0,300000.0,,2018,10,25,TRANSFER,300000.0,C1141137903
27903,1196428',2018-10-25,FDRL/REAL TIME GROSS SETTL,5000000.0,0.0,,2018,10,25,CASH_OUT,5000000.0,C1869228744
27904,1196428',2018-10-25,FDRL/INTERNAL FUND TRANSFE,100000.0,0.0,,2018,10,25,DEBIT,100000.0,C2078250226
27905,1196428',2018-10-25,FDRL/INTERNAL FUND TRANSFE,100000.0,0.0,,2018,10,25,PAYEMENT,100000.0,C1300519073
27906,1196428',2018-10-25,FDRL/INTERNAL FUND TRANSFE,100000.0,0.0,,2018,10,25,CHECK_WITHDRAWAL,100000.0,M1808484670
27907,1196428',2018-10-25,FDRL/INTERNAL FUND TRANSFE,100000.0,0.0,,2018,10,25,CASH_OUT,100000.0,M829035073
27908,1196428',2018-10-25,FDRL/INTERNAL FUND TRANSFE,100000.0,0.0,,2018,10,25,CASH_OUT,100000.0,M1674174327
27909,1196428',2018-10-25,RTGS/HDFCH18298518574/JUN,0.0,200000.0,,2018,10,25,CASH_IN,200000.0,M2135203084
27910,1196428',2018-10-25,IMPS 829813769453 FROM SA,0.0,20000.0,,2018,10,25,TRANSFER,20000.0,C1673971173
27911,1196428',2018-10-25,IMPS 829813198593 FROM PU,0.0,45000.0,,2018,10,25,CASH_IN,45000.0,C339099861
27912,1196428',2018-10-25,TRF FROM  Indiaforensic SERVICES,0.0,3900000.0,,2018,10,25,TRANSFER,3900000.0,M2045422556
27913,1196428',2018-10-25,"Indiaforensic USA, INC./USD/2990",0.0,217971.0,,2018,10,25,CHECK_CASHING,217971.0,C1266035080
27914,1196428',2018-10-25,IRTT00701830743,581.17,0.0,,2018,10,25,PAYEMENT,581.17,C1060041730
27915,1196428',2018-10-25,RTGS/SBINH18298065302/Indfor,0.0,8000000.0,,2018,10,25,TRANSFER,8000000.0,C1475395523
27916,1196428',2018-10-25,Indiaforensic SERVICES INDIA PVT,0.0,115782.0,,2018,10,25,CASH_IN,115782.0,C265845794
27917,1196428',2018-10-25,FDRL/NATIONAL ELECTRONIC F,11818566.33,0.0,,2018,10,25,PAYEMENT,11818566.33,C58091972
27918,1196428',2018-10-25,NEFT/FSFBH18298000139/FIN,0.0,110370.0,,2018,10,25,TRANSFER,110370.0,C193864812
27919,1196428',2018-10-25,NEFT/N298180663227971/TEC,0.0,200000.0,,2018,10,25,TRANSFER,200000.0,C681835572
27920,1196428',2018-10-25,TRF FROM  Indiaforensic SERVICES,0.0,4000000.0,,2018,10,25,CHECK_CASHING,4000000.0,C965197768
27921,1196428',2018-10-25,TRF FROM  Indiaforensic SERVICES,0.0,4000000.0,,2018,10,25,CASH_IN,4000000.0,C893038039
27922,1196428',2018-10-25,TRF FROM  Indiaforensic SERVICES,0.0,3000000.0,,2018,10,25,TRANSFER,3000000.0,C1317731757
27923,1196428',2018-10-25,TRF FROM  Indiaforensic SERVICES,0.0,2000000.0,,2018,10,25,TRANSFER,2000000.0,C1373467808
27924,1196428',2018-10-25,IMPS 829819598118 FROM OX,0.0,200000.0,,2018,10,25,CHECK_CASHING,200000.0,C1318822808
27925,1196428',2018-10-25,IMPS 829819598155 FROM OX,0.0,200000.0,,2018,10,25,CASH_IN,200000.0,C1424731356
27926,1196428',2018-10-25,TRF FROM  Indiaforensic SERVICES,0.0,600000.0,,2018,10,25,TRANSFER,600000.0,C1439007204
27927,1196428',2018-10-25,TRF FROM  Indiaforensic SERVICES,0.0,400000.0,,2018,10,25,TRANSFER,400000.0,C1116292004
27928,1196428',2018-10-25,TRF FROM  Indiaforensic SERVICES,0.0,400000.0,,2018,10,25,CHECK_CASHING,400000.0,C638551812
27929,1196428',2018-10-25,FDRL/INTERNAL FUND TRANSFE,500000.0,0.0,,2018,10,25,DEBIT,500000.0,C193826743
27930,1196428',2018-10-25,FDRL/INTERNAL FUND TRANSFE,500000.0,0.0,,2018,10,25,CASH_OUT,500000.0,C309167705
27931,1196428',2018-10-25,FDRL/INTERNAL FUND TRANSFE,3000000.0,0.0,,2018,10,25,CASH_OUT,3000000.0,C811597470
27932,1196428',2018-10-25,FDRL/INTERNAL FUND TRANSFE,500000.0,0.0,,2018,10,25,PAYEMENT,500000.0,C1014923261
27933,1196428',2018-10-25,BEAT CSH PKP DEL GURGA 72,0.0,34000.0,,2018,10,25,TRANSFER,34000.0,C925574515
27934,1196428',2018-10-26,RTGS/YESBH18299053027/IND,11818566.0,0.0,,2018,10,26,DEBIT,11818566.0,C1988152146
27935,1196428',2018-10-26,NEFT/P18102689184979/S B,0.0,199500.0,,2018,10,26,TRANSFER,199500.0,C71555810
27936,1196428',2018-10-26,TRF FRM  Indiaforensic SERVICES,0.0,4000000.0,,2018,10,26,TRANSFER,4000000.0,C1273939873
27937,1196428',2018-10-26,RTGS/SBINH18299032934/SAI,0.0,1850000.0,,2018,10,26,TRANSFER,1850000.0,C749672494
27938,1196428',2018-10-26,CHQ DEP/215195/OWDEL1/SBI,0.0,11800.0,,2018,10,26,CASH_IN,11800.0,C1504109395
27939,1196428',2018-10-26,CHQ DEP/34044/OWDEL1/BKID,0.0,11800.0,,2018,10,26,CASH_IN,11800.0,C2107268831
27940,1196428',2018-10-26,CHQ DEP/39115/OWDEL1/BKID,0.0,11800.0,,2018,10,26,CASH_IN,11800.0,C1141137903
27941,1196428',2018-10-26,CHQ DEP/49957/OWDEL1/BKID,0.0,11800.0,,2018,10,26,CASH_IN,11800.0,M492166970
27942,1196428',2018-10-26,CHQ DEP/589859/OWDEL1/SBI,0.0,11800.0,,2018,10,26,CASH_IN,11800.0,C762570948
27943,1196428',2018-10-26,CHQ DEP/546820/OWDEL1/SBI,0.0,11800.0,,2018,10,26,CASH_IN,11800.0,C1440282299
27944,1196428',2018-10-26,CHQ DEP/29/OWDEL1/HDFC/MA,0.0,8000.0,,2018,10,26,TRANSFER,8000.0,M1583639547
27945,1196428',2018-10-26,FDRL/INTERNAL FUND TRANSFE,100000.0,0.0,,2018,10,26,DEBIT,100000.0,M1476691574
27946,1196428',2018-10-26,FDRL/INTERNAL FUND TRANSFE,100000.0,0.0,,2018,10,26,CASH_OUT,100000.0,C893339434
27947,1196428',2018-10-26,FDRL/REAL TIME GROSS SETTL,3000000.0,0.0,,2018,10,26,PAYEMENT,3000000.0,M722806861
27948,1196428',2018-10-26,FDRL/REAL TIME GROSS SETTL,2000000.0,0.0,,2018,10,26,CHECK_WITHDRAWAL,2000000.0,C1150610696
27949,1196428',2018-10-26,IRTT00701830921,2761.3,0.0,,2018,10,26,DEBIT,2761.3,C1674899618
27950,1196428',2018-10-26,"Indiaforensic USA, INC./USD/1258",0.0,9201681.8,,2018,10,26,CHECK_CASHING,9201681.8,M481126602
27951,1196428',2018-10-26,RTGS/ICICH18299830596/Indfor,0.0,1000000.0,,2018,10,26,CASH_IN,1000000.0,C1793325972
27952,1196428',2018-10-26,RTGS/ICICH18299826359/Indfor,0.0,500000.0,,2018,10,26,TRANSFER,500000.0,M132360639
27953,1196428',2018-10-26,RTGS/SBINH18299065306/Indfor,0.0,2000000.0,,2018,10,26,CASH_IN,2000000.0,M2052092920
27954,1196428',2018-10-26,IMPS 829915114633 FROM PU,0.0,40000.0,,2018,10,26,CASH_IN,40000.0,M236650472
27955,1196428',2018-10-26,Indiaforensic SERVICES INDIA PVT,0.0,102403.0,,2018,10,26,CASH_IN,102403.0,M2089634452
27956,1196428',2018-10-26,RTGS/ICICH18299872227/Indfor,0.0,1000000.0,,2018,10,26,CHECK_CASHING,1000000.0,M1097809105
27957,1196428',2018-10-26,RTGS/ICICH18299824833/Indfor,0.0,1000000.0,,2018,10,26,CASH_IN,1000000.0,C302025300
27958,1196428',2018-10-26,FDRL/NATIONAL ELECTRONIC F,13119211.3,0.0,,2018,10,26,CASH_OUT,13119211.3,M134742492
27959,1196428',2018-10-26,NEFT/000054535702/Indiaforensic,0.0,500000.0,,2018,10,26,CASH_IN,500000.0,C1511785794
27960,1196428',2018-10-26,TRF FROM  Indiaforensic SERVICES,0.0,15000000.0,,2018,10,26,TRANSFER,15000000.0,M1604293868
27961,1196428',2018-10-26,FDRL/NATIONAL ELECTRONIC F,13119211.3,0.0,,2018,10,26,CHECK_WITHDRAWAL,13119211.3,M1853641629
27962,1196428',2018-10-26,NEFT/PUNBH18299501831/BAL,0.0,100000.0,,2018,10,26,CASH_IN,100000.0,M710600916
27963,1196428',2018-10-26,NEFT/N299180663943377/TEC,0.0,100000.0,,2018,10,26,CASH_IN,100000.0,M985323561
27964,1196428',2018-10-26,NEFT/N299180663965490/BAT,0.0,500000.0,,2018,10,26,TRANSFER,500000.0,M1194715097
27965,1196428',2018-10-26,FDRL/NATIONAL ELECTRONIC F,248994.0,0.0,,2018,10,26,PAYEMENT,248994.0,M693684695
27966,1196428',2018-10-26,FDRL/NATIONAL ELECTRONIC F,299226.0,0.0,,2018,10,26,DEBIT,299226.0,M1582319135
27967,1196428',2018-10-26,FDRL/NATIONAL ELECTRONIC F,279608.0,0.0,,2018,10,26,DEBIT,279608.0,M227290600
27968,1196428',2018-10-26,FDRL/NATIONAL ELECTRONIC F,768734.0,0.0,,2018,10,26,DEBIT,768734.0,M2089806029
27969,1196428',2018-10-26,FDRL/NATIONAL ELECTRONIC F,213445.0,0.0,,2018,10,26,CASH_OUT,213445.0,M1477278751
27970,1196428',2018-10-26,IMPS 829917874366 FROM K,0.0,25000.0,,2018,10,26,CASH_IN,25000.0,M1650385017
27971,1196428',2018-10-26,NEFT/CSBKN18299013733/Indfor,0.0,500000.0,,2018,10,26,CASH_IN,500000.0,M1921059756
27972,1196428',2018-10-26,TRF FROM  Indiaforensic SERVICES,0.0,15000000.0,,2018,10,26,TRANSFER,15000000.0,M590434145
27973,1196428',2018-10-26,TRF FROM  Indiaforensic SERVICES,0.0,800000.0,,2018,10,26,CHECK_CASHING,800000.0,M1671621366
27974,1196428',2018-10-26,TRF FROM  Indiaforensic SERVICES,0.0,700000.0,,2018,10,26,CHECK_CASHING,700000.0,M899686935
27975,1196428',2018-10-26,FDRL/INTERNAL FUND TRANSFE,3000000.0,0.0,,2018,10,26,CASH_OUT,3000000.0,M2054039573
27976,1196428',2018-10-26,FDRL/INTERNAL FUND TRANSFE,500000.0,0.0,,2018,10,26,DEBIT,500000.0,M1271480561
27977,1196428',2018-10-26,FDRL/INTERNAL FUND TRANSFE,1000000.0,0.0,,2018,10,26,CASH_OUT,1000000.0,C1259769769
27978,1196428',2018-10-26,FDRL/INTERNAL FUND TRANSFE,1000000.0,0.0,,2018,10,26,PAYEMENT,1000000.0,M649539827
27979,1196428',2018-10-26,TRF TO  Indiaforensic SERVICES I,500000.0,0.0,,2018,10,26,CHECK_WITHDRAWAL,500000.0,C893350828
27980,1196428',2018-10-26,IMPS 829919662937 FROM SA,0.0,200000.0,,2018,10,26,CASH_IN,200000.0,M20364107
27981,1196428',2018-10-26,TRF TO  Indiaforensic SERVICES I,15000000.0,0.0,,2018,10,26,CASH_OUT,15000000.0,M2023197227
27982,1196428',2018-10-26,BEAT CSH PKP DEL GURGA 72,0.0,187100.0,,2018,10,26,TRANSFER,187100.0,C232812328
27983,1196428',2018-10-29,RTGS/PUNBH18302125486/MAN,0.0,300000.0,,2018,10,29,CHECK_CASHING,300000.0,M902890505
27984,1196428',2018-10-29,FDRL/INTERNAL FUND TRANSFE,200000.0,0.0,,2018,10,29,PAYEMENT,200000.0,M1465861273
27985,1196428',2018-10-29,FDRL/INTERNAL FUND TRANSFE,200000.0,0.0,,2018,10,29,CHECK_WITHDRAWAL,200000.0,M949506330
27986,1196428',2018-10-29,FDRL/INTERNAL FUND TRANSFE,200000.0,0.0,,2018,10,29,CASH_OUT,200000.0,M2084969506
27987,1196428',2018-10-29,RTGS/SBINH18302009857/Indfor,0.0,1000000.0,,2018,10,29,CASH_IN,1000000.0,M608038618
27988,1196428',2018-10-29,INTEX TECHNOLOGIES INDIA,1000000.0,0.0,,2018,10,29,CASH_OUT,1000000.0,M1041764081
27989,1196428',2018-10-29,RTGS/SBINH18302062960/MS,0.0,1300000.0,,2018,10,29,CASH_IN,1300000.0,M277788688
27990,1196428',2018-10-29,TRF FROM  Indiaforensic SERVICES,0.0,9200000.0,,2018,10,29,CASH_IN,9200000.0,M31440957
27991,1196428',2018-10-29,RTGS/HDFCH18302092957/Indfor,0.0,2500000.0,,2018,10,29,CASH_IN,2500000.0,C1805162633
27992,1196428',2018-10-29,RTGS/ICICH18302352962/Indfor,0.0,900000.0,,2018,10,29,CASH_IN,900000.0,M1201023997
27993,1196428',2018-10-29,FDRL/NATIONAL ELECTRONIC F,586843.0,0.0,,2018,10,29,CASH_OUT,586843.0,M1412743565
27994,1196428',2018-10-29,FDRL/NATIONAL ELECTRONIC F,11861159.49,0.0,,2018,10,29,DEBIT,11861159.49,M1887477561
27995,1196428',2018-10-29,IMPS 830217346889 FROM PU,0.0,40000.0,,2018,10,29,CASH_IN,40000.0,C435161028
27996,1196428',2018-10-29,TRF FROM  Indiaforensic SERVICES,0.0,1000000.0,,2018,10,29,TRANSFER,1000000.0,M2126024846
27997,1196428',2018-10-29,TRF FROM  Indiaforensic SERVICES,0.0,800000.0,,2018,10,29,CASH_IN,800000.0,M885738476
27998,1196428',2018-10-29,TRF FROM  Indiaforensic SERVICES,0.0,500000.0,,2018,10,29,CASH_IN,500000.0,C1273939873
27999,1196428',2018-10-29,TRF FROM  Indiaforensic SERVICES,0.0,1000000.0,,2018,10,29,CHECK_CASHING,1000000.0,C464094472
28000,1196428',2018-10-29,TRF FROM  Indiaforensic SERVICES,0.0,1000000.0,,2018,10,29,CASH_IN,1000000.0,C1475998599
28001,1196428',2018-10-29,TRF FROM  Indiaforensic SERVICES,0.0,15000000.0,,2018,10,29,CASH_IN,15000000.0,C1789550256
28002,1196428',2018-10-29,TRF FROM  Indiaforensic SERVICES,0.0,15000000.0,,2018,10,29,CASH_IN,15000000.0,C1805445027
28003,1196428',2018-10-29,TRF FROM  Indiaforensic SERVICES,0.0,2000000.0,,2018,10,29,CASH_IN,2000000.0,C968448640
28004,1196428',2018-10-29,TRF FROM  Indiaforensic SERVICES,0.0,4000000.0,,2018,10,29,TRANSFER,4000000.0,C691636444
28005,1196428',2018-10-29,NEFT CHARGES AND GST/0000,29.5,0.0,,2018,10,29,CHECK_WITHDRAWAL,29.5,C1778801068
28006,1196428',2018-10-29,NEFT/000054773664/INDIAN,12053490.0,0.0,,2018,10,29,CASH_OUT,12053490.0,C2029896123
28007,1196428',2018-10-29,NEFT CHARGES AND GST/0000,29.5,0.0,,2018,10,29,CASH_OUT,29.5,C1677727024
28008,1196428',2018-10-29,NEFT/000054774153/INDIAN,12053490.0,0.0,,2018,10,29,CASH_OUT,12053490.0,C1525944481
28009,1196428',2018-10-29,FDRL/INTERNAL FUND TRANSFE,2000000.0,0.0,,2018,10,29,CASH_OUT,2000000.0,C481402298
28010,1196428',2018-10-29,FDRL/INTERNAL FUND TRANSFE,3000000.0,0.0,,2018,10,29,DEBIT,3000000.0,C177457290
28011,1196428',2018-10-29,FDRL/INTERNAL FUND TRANSFE,500000.0,0.0,,2018,10,29,CHECK_WITHDRAWAL,500000.0,M1138171728
28012,1196428',2018-10-29,BEAT CSH PKP DEL GURGA 72,0.0,214000.0,,2018,10,29,TRANSFER,214000.0,C1452722471
28013,1196428',2018-10-30,RTGS/HDFCH18303142340/BAT,0.0,300000.0,,2018,10,30,CASH_IN,300000.0,C861958315
28014,1196428',2018-10-30,NEFT/SBIN618303784536/AYU,0.0,8000.0,,2018,10,30,TRANSFER,8000.0,M919438675
28015,1196428',2018-10-30,NEFT/SBIN618303782188/J B,0.0,8000.0,,2018,10,30,TRANSFER,8000.0,M1501022601
28016,1196428',2018-10-30,NEFT/SBIN618303783598/JAY,0.0,8000.0,,2018,10,30,CASH_IN,8000.0,M397708705
28017,1196428',2018-10-30,RTGS/YESBH18303437292/IND,11861159.0,0.0,,2018,10,30,CASH_OUT,11861159.0,M1092898377
28018,1196428',2018-10-30,TRF FROM  Indiaforensic SERVICES,0.0,2000000.0,,2018,10,30,CASH_IN,2000000.0,M1957947378
28019,1196428',2018-10-30,TRF FROM  Indiaforensic SERVICES,0.0,500000.0,,2018,10,30,TRANSFER,500000.0,C785703145
28020,1196428',2018-10-30,RTGS/HDFCH18303199872/JUN,0.0,250000.0,,2018,10,30,CHECK_CASHING,250000.0,M2094125621
28021,1196428',2018-10-30,NEFT/PUNBH18303864094/MAN,0.0,140000.0,,2018,10,30,CASH_IN,140000.0,M1918034019
28022,1196428',2018-10-30,VODAFONE MOBILE SERVICES,16200.0,0.0,,2018,10,30,CASH_OUT,16200.0,M745483242
28023,1196428',2018-10-30,TATA TELE SERVICES LD,1613.0,0.0,,2018,10,30,PAYEMENT,1613.0,M1878714361
28024,1196428',2018-10-30,FDRL/INTERNAL FUND TRANSFE,1000000.0,0.0,,2018,10,30,PAYEMENT,1000000.0,M203939387
28025,1196428',2018-10-30,RTGS/ICICH18303440515/Indfor,0.0,3000000.0,,2018,10,30,CHECK_CASHING,3000000.0,C382934088
28026,1196428',2018-10-30,RTGS/ICICH18303441965/Indfor,0.0,1000000.0,,2018,10,30,CASH_IN,1000000.0,C158876320
28027,1196428',2018-10-30,RTGS/ICICH18303441303/Indfor,0.0,500000.0,,2018,10,30,TRANSFER,500000.0,C732929236
28028,1196428',2018-10-30,TRF FROM  Indiaforensic SERVICES,0.0,2900000.0,,2018,10,30,CHECK_CASHING,2900000.0,C1554622120
28029,1196428',2018-10-30,IRTT00701831179,3668.49,0.0,,2018,10,30,DEBIT,3668.49,C1359484306
28030,1196428',2018-10-30,"Indiaforensic USA, INC./USD/1941",0.0,14241636.0,,2018,10,30,CHECK_CASHING,14241636.0,C1782704802
28031,1196428',2018-10-30,RTGS/SBINH18303048433/SRI,0.0,200000.0,,2018,10,30,CASH_IN,200000.0,C1609562230
28032,1196428',2018-10-30,FDRL/NATIONAL ELECTRONIC F,13493254.21,0.0,,2018,10,30,PAYEMENT,13493254.21,C1220897602
28033,1196428',2018-10-30,FDRL/NATIONAL ELECTRONIC F,10397028.28,0.0,,2018,10,30,CASH_OUT,10397028.28,C1213257323
28034,1196428',2018-10-30,Indiaforensic SERVICES INDIA PVT,0.0,237956.0,,2018,10,30,CASH_IN,237956.0,C674913323
28035,1196428',2018-10-30,TRF FROM  Indiaforensic SERVICES,0.0,10000000.0,,2018,10,30,CHECK_CASHING,10000000.0,C803116137
28036,1196428',2018-10-30,TRF FROM  Indiaforensic SERVICES,0.0,500000.0,,2018,10,30,CHECK_CASHING,500000.0,C1450417897
28037,1196428',2018-10-30,NEFT CHARGES AND GST/0000,29.5,0.0,,2018,10,30,CASH_OUT,29.5,C826383690
28038,1196428',2018-10-30,NEFT/000054923156/INDIAN,10397028.0,0.0,,2018,10,30,CHECK_WITHDRAWAL,10397028.0,M1718920203
28039,1196428',2018-10-30,IMPS 830319975561 FROM OX,0.0,200000.0,,2018,10,30,CASH_IN,200000.0,M1002711260
28040,1196428',2018-10-30,IMPS 830319975633 FROM OX,0.0,200000.0,,2018,10,30,CHECK_CASHING,200000.0,C545710008
28041,1196428',2018-10-30,IMPS 830319975677 FROM OX,0.0,200000.0,,2018,10,30,TRANSFER,200000.0,C1838584624
28042,1196428',2018-10-30,FDRL/INTERNAL FUND TRANSFE,200000.0,0.0,,2018,10,30,CASH_OUT,200000.0,C1030706332
28043,1196428',2018-10-30,FDRL/INTERNAL FUND TRANSFE,300000.0,0.0,,2018,10,30,CASH_OUT,300000.0,M2129060443
28044,1196428',2018-10-30,FDRL/INTERNAL FUND TRANSFE,1000000.0,0.0,,2018,10,30,DEBIT,1000000.0,C1195471589
28045,1196428',2018-10-30,TRF FROM  Indiaforensic SERVICES,0.0,2800000.0,,2018,10,30,CHECK_CASHING,2800000.0,M1398128260
28046,1196428',2018-10-30,TRF FROM  Indiaforensic SERVICES,0.0,500000.0,,2018,10,30,CHECK_CASHING,500000.0,C1856036778
28047,1196428',2018-10-30,FDRL/INTERNAL FUND TRANSFE,3000000.0,0.0,,2018,10,30,CASH_OUT,3000000.0,C2067546399
28048,1196428',2018-10-30,BEAT CSH PKP DEL GURGA 72,0.0,75100.0,,2018,10,30,CHECK_CASHING,75100.0,C818570949
28049,1196428',2018-10-31,RTGS/HDFCH18304370954/BAT,0.0,275000.0,,2018,10,31,CASH_IN,275000.0,M535878604
28050,1196428',2018-10-31,NEFT/SBIN818304059813/MR,0.0,100000.0,,2018,10,31,CHECK_CASHING,100000.0,C358945794
28051,1196428',2018-10-31,CHQ DEP/1/OWDEL1/BANDH/,0.0,11800.0,,2018,10,31,CASH_IN,11800.0,C922511709
28052,1196428',2018-10-31,CHQ DEP/666693/OWDEL1/SBI,0.0,11800.0,,2018,10,31,CHECK_CASHING,11800.0,C988138425
28053,1196428',2018-10-31,CHQ DEP/6902/OWDEL1/ALLA/,0.0,11800.0,,2018,10,31,CHECK_CASHING,11800.0,C814900611
28054,1196428',2018-10-31,CHQ DEP/794642/OWDEL1/UCB,0.0,11800.0,,2018,10,31,CASH_IN,11800.0,C1467740330
28055,1196428',2018-10-31,CHQ DEP/686360/OWDEL1/SBI,0.0,11800.0,,2018,10,31,TRANSFER,11800.0,M858308953
28056,1196428',2018-10-31,CHQ DEP/18359/OWDEL1/JAKA,0.0,11800.0,,2018,10,31,CHECK_CASHING,11800.0,M1773085261
28057,1196428',2018-10-31,CHQ DEP/219535/OWDEL1/SBI,0.0,11800.0,,2018,10,31,TRANSFER,11800.0,M472606308
28058,1196428',2018-10-31,CHQ DEP/80/OWDEL1/HDFC/KO,0.0,11800.0,,2018,10,31,TRANSFER,11800.0,M51583809
28059,1196428',2018-10-31,CHQ DEP/355879/OWDEL1/SBI,0.0,8000.0,,2018,10,31,CASH_IN,8000.0,M1337700382
28060,1196428',2018-10-31,TRF FROM  Indiaforensic SERVICES,0.0,3200000.0,,2018,10,31,CHECK_CASHING,3200000.0,C1918034924
28061,1196428',2018-10-31,NEFT/N304180667196674/TEC,0.0,200000.0,,2018,10,31,CASH_IN,200000.0,M527477577
28062,1196428',2018-10-31,FDRL/REAL TIME GROSS SETTL,2000000.0,0.0,,2018,10,31,CASH_OUT,2000000.0,M577217292
28063,1196428',2018-10-31,FDRL/REAL TIME GROSS SETTL,2000000.0,0.0,,2018,10,31,CHECK_WITHDRAWAL,2000000.0,C184253187
28064,1196428',2018-10-31,RTGS/ICICH18304627400/Indfor,0.0,1800000.0,,2018,10,31,CHECK_CASHING,1800000.0,C1778300121
28065,1196428',2018-10-31,RTGS/ICICH18304628088/Indfor,0.0,1100000.0,,2018,10,31,CHECK_CASHING,1100000.0,C667504652
28066,1196428',2018-10-31,TRF FROM  Indiaforensic SERVICES,0.0,900000.0,,2018,10,31,CASH_IN,900000.0,C638590716
28067,1196428',2018-10-31,Indiaforensic SERVICES INDIA PVT,0.0,85019.0,,2018,10,31,TRANSFER,85019.0,C1532153384
28068,1196428',2018-10-31,CHQ DEPOSIT RETURN/1/FUND,11800.0,0.0,,2018,10,31,CASH_OUT,11800.0,C208427878
28069,1196428',2018-10-31,CHQ DEPOSIT RETURN/666693,11800.0,0.0,,2018,10,31,PAYEMENT,11800.0,C1530086509
28070,1196428',2018-10-31,CHQ DEPOSIT RETURN/355879,8000.0,0.0,,2018,10,31,DEBIT,8000.0,C703957828
28071,1196428',2018-10-31,NEFT/N304180667607107/SID,0.0,50000.0,,2018,10,31,CASH_IN,50000.0,C891020651
28072,1196428',2018-10-31,TRF FROM  Indiaforensic SERVICES,0.0,13300000.0,,2018,10,31,CHECK_CASHING,13300000.0,M1680032445
28073,1196428',2018-10-31,TRF TO  Indiaforensic SERVICES I,230000.0,0.0,,2018,10,31,PAYEMENT,230000.0,C553264065
28074,1196428',2018-10-31,FDRL/NATIONAL ELECTRONIC F,11736132.76,0.0,,2018,10,31,CASH_OUT,11736132.76,M1097298586
28075,1196428',2018-10-31,FDRL/INTERNAL FUND TRANSFE,1000000.0,0.0,,2018,10,31,PAYEMENT,1000000.0,M870026554
28076,1196428',2018-10-31,FDRL/INTERNAL FUND TRANSFE,200000.0,0.0,,2018,10,31,DEBIT,200000.0,C695653925
28077,1196428',2018-10-31,FDRL/INTERNAL FUND TRANSFE,1000000.0,0.0,,2018,10,31,CASH_OUT,1000000.0,M1248361658
28078,1196428',2018-10-31,FDRL/INTERNAL FUND TRANSFE,300000.0,0.0,,2018,10,31,PAYEMENT,300000.0,C1689262323
28079,1196428',2018-10-31,FDRL/INTERNAL FUND TRANSFE,1000000.0,0.0,,2018,10,31,CASH_OUT,1000000.0,C1757877803
28080,1196428',2018-10-31,TRF FROM  Indiaforensic SERVICES,0.0,900000.0,,2018,10,31,CHECK_CASHING,900000.0,C1849933855
28081,1196428',2018-10-31,TRF FROM  Indiaforensic SERVICES,0.0,800000.0,,2018,10,31,CASH_IN,800000.0,C1753128715
28082,1196428',2018-10-31,CHQ DEPOSIT RETURN/1/CHAR,100.0,0.0,,2018,10,31,DEBIT,100.0,C1527761090
28083,1196428',2018-10-31,CHQ DEPOSIT RETURN/1/GST,18.0,0.0,,2018,10,31,CASH_OUT,18.0,C1754722089
28084,1196428',2018-10-31,CHQ DEPOSIT RETURN/666693,100.0,0.0,,2018,10,31,CHECK_WITHDRAWAL,100.0,C1261039678
28085,1196428',2018-10-31,CHQ DEPOSIT RETURN/666693,18.0,0.0,,2018,10,31,DEBIT,18.0,C836514715
28086,1196428',2018-10-31,CHQ DEPOSIT RETURN/355879,100.0,0.0,,2018,10,31,PAYEMENT,100.0,C1640961071
28087,1196428',2018-10-31,CHQ DEPOSIT RETURN/355879,18.0,0.0,,2018,10,31,DEBIT,18.0,C1838584624
28088,1196428',2018-10-31,1196428:Int.Coll:01-10-20,813298.0,0.0,,2018,10,31,PAYEMENT,813298.0,C1209271652
28089,1196428',2018-11-01,NEFT/PUNBH18305345226/BAL,0.0,100000.0,,2018,11,1,CHECK_CASHING,100000.0,C745740822
28090,1196428',2018-11-01,NEFT/KKBKH18305677848/RES,0.0,20000.0,,2018,11,1,CHECK_CASHING,20000.0,C1401721023
28091,1196428',2018-11-01,IMPS 830512414669 FROM SA,0.0,100000.0,,2018,11,1,TRANSFER,100000.0,C47827984
28092,1196428',2018-11-01,IMPS 830513440662 FROM SA,0.0,50000.0,,2018,11,1,CHECK_CASHING,50000.0,C1849941462
28093,1196428',2018-11-01,RTGS/UTIBH18305616465/Indfor,0.0,6000000.0,,2018,11,1,CASH_IN,6000000.0,C70895366
28094,1196428',2018-11-01,TRF FROM  Indiaforensic SERVICES,0.0,2900000.0,,2018,11,1,CHECK_CASHING,2900000.0,C977993101
28095,1196428',2018-11-01,FDRL/NATIONAL ELECTRONIC F,11736132.76,0.0,,2018,11,1,CASH_OUT,11736132.76,C2116873183
28096,1196428',2018-11-01,IMPS 830514112006 FROM PU,0.0,35000.0,,2018,11,1,CHECK_CASHING,35000.0,C892686452
28097,1196428',2018-11-01,IMPS 830515742273 FROM K,0.0,200000.0,,2018,11,1,CHECK_CASHING,200000.0,C1540270363
28098,1196428',2018-11-01,IMPS 830515743088 FROM K,0.0,200000.0,,2018,11,1,TRANSFER,200000.0,C534662976
28099,1196428',2018-11-01,RTGS/UTIBH18305629485/Indfor,0.0,10000000.0,,2018,11,1,CHECK_CASHING,10000000.0,C30013970
28100,1196428',2018-11-01,Indiaforensic SERVICES INDIA PVT,0.0,67174.0,,2018,11,1,CHECK_CASHING,67174.0,C1809373351
28101,1196428',2018-11-01,TRF FROM  Indiaforensic SERVICES,0.0,8700000.0,,2018,11,1,CHECK_CASHING,8700000.0,C741431520
28102,1196428',2018-11-01,FDRL/NATIONAL ELECTRONIC F,13221746.16,0.0,,2018,11,1,PAYEMENT,13221746.16,C669771073
28103,1196428',2018-11-01,FDRL/INTERNAL FUND TRANSFE,3000000.0,0.0,,2018,11,1,CHECK_WITHDRAWAL,3000000.0,C1915091057
28104,1196428',2018-11-01,FDRL/INTERNAL FUND TRANSFE,500000.0,0.0,,2018,11,1,PAYEMENT,500000.0,C323287038
28105,1196428',2018-11-01,FDRL/INTERNAL FUND TRANSFE,2000000.0,0.0,,2018,11,1,PAYEMENT,2000000.0,C1027992087
28106,1196428',2018-11-01,NEFT/N305180669526844/SID,0.0,50000.0,,2018,11,1,CASH_IN,50000.0,C1435804085
28107,1196428',2018-11-01,TRF FROM  Indiaforensic SERVICES,0.0,5600000.0,,2018,11,1,CASH_IN,5600000.0,C1153596299
28108,1196428',2018-11-01,TRF FROM  Indiaforensic SERVICES,0.0,500000.0,,2018,11,1,CASH_IN,500000.0,C1541743053
28109,1196428',2018-11-01,TRF TO  Indiaforensic SERVICES I,229969.0,0.0,,2018,11,1,CHECK_WITHDRAWAL,229969.0,C1213257323
28110,1196428',2018-11-01,NEFT/AT3110MOBIL13033/FIX,0.0,300000.0,,2018,11,1,CHECK_CASHING,300000.0,C295081230
28111,1196428',2018-11-01,BEAT CSH PKP DEL GURGA 77,0.0,80000.0,,2018,11,1,CHECK_CASHING,80000.0,C531511436
28112,1196428',2018-11-02,RTGS/SBINH18306015995/Indfor,0.0,6000000.0,,2018,11,2,TRANSFER,6000000.0,C175291188
28113,1196428',2018-11-02,FDRL/NATIONAL ELECTRONIC F,13221746.16,0.0,,2018,11,2,CASH_OUT,13221746.16,C1259769769
28114,1196428',2018-11-02,IMPS 830612136512 FROM K,0.0,200000.0,,2018,11,2,CHECK_CASHING,200000.0,C205300866
28115,1196428',2018-11-02,CHQ DEP/73244/OWDEL1/SBIN,0.0,11800.0,,2018,11,2,CHECK_CASHING,11800.0,C1297873690
28116,1196428',2018-11-02,CHQ DEP/977353/OWDEL1/PUN,0.0,11800.0,,2018,11,2,TRANSFER,11800.0,C715819458
28117,1196428',2018-11-02,CHQ DEP/8955/OWDEL1/BKID/,0.0,11800.0,,2018,11,2,CASH_IN,11800.0,C18928637
28118,1196428',2018-11-02,CHQ DEP/50/OWDEL1/HDFC/CI,0.0,11800.0,,2018,11,2,CASH_IN,11800.0,C1079343872
28119,1196428',2018-11-02,TRF FROM  Indiaforensic SERVICES,0.0,3500000.0,,2018,11,2,CHECK_CASHING,3500000.0,C99275333
28120,1196428',2018-11-02,RTGS/ICICH18306222307/Indfor,0.0,900000.0,,2018,11,2,TRANSFER,900000.0,C1450828900
28121,1196428',2018-11-02,RTGS/ICICH18306222940/Indfor,0.0,500000.0,,2018,11,2,CHECK_CASHING,500000.0,C1339257929
28122,1196428',2018-11-02,RTGS/ICICH18306221558/Indfor,0.0,2100000.0,,2018,11,2,TRANSFER,2100000.0,C893041125
28123,1196428',2018-11-02,FDRL/REAL TIME GROSS SETTL,5000000.0,0.0,,2018,11,2,PAYEMENT,5000000.0,C380242442
28124,1196428',2018-11-02,FDRL/REAL TIME GROSS SETTL,2000000.0,0.0,,2018,11,2,PAYEMENT,2000000.0,C1220897602
28125,1196428',2018-11-02,CHQ DEPOSIT RETURN/73244/,11800.0,0.0,,2018,11,2,DEBIT,11800.0,C495071437
28126,1196428',2018-11-02,CHQ DEPOSIT RETURN/8955/F,11800.0,0.0,,2018,11,2,CASH_OUT,11800.0,C1753128715
28127,1196428',2018-11-02,"Indiaforensic USA, INC./USD/1371",0.0,9944014.92,,2018,11,2,CASH_IN,9944014.92,C1387460501
28128,1196428',2018-11-02,IRTT00701831722,2894.92,0.0,,2018,11,2,DEBIT,2894.92,C425987411
28129,1196428',2018-11-02,IRTT00701831719,1467.11,0.0,,2018,11,2,PAYEMENT,1467.11,C914293025
28130,1196428',2018-11-02,"Indiaforensic USA, INC./USD/2774",0.0,2011704.8,,2018,11,2,TRANSFER,2011704.8,C1765998352
28131,1196428',2018-11-02,Indiaforensic SERVICES INDIA PVT,0.0,90149.0,,2018,11,2,TRANSFER,90149.0,C1651144763
28132,1196428',2018-11-02,FDRL/NATIONAL ELECTRONIC F,11044746.3,0.0,,2018,11,2,DEBIT,11044746.3,C922871524
28133,1196428',2018-11-02,NEFT/20794016181DC/ARTHAS,0.0,25000.0,,2018,11,2,TRANSFER,25000.0,M1059480890
28134,1196428',2018-11-02,NEFT/N306180670824412/TEC,0.0,200000.0,,2018,11,2,CASH_IN,200000.0,C474166728
28135,1196428',2018-11-02,NEFT/N306180670803778/BAT,0.0,500000.0,,2018,11,2,TRANSFER,500000.0,M414136086
28136,1196428',2018-11-02,TRF FROM  Indiaforensic SERVICES,0.0,10000000.0,,2018,11,2,CASH_IN,10000000.0,M1209728527
28137,1196428',2018-11-02,NEFT CHARGES AND GST/0000,29.5,0.0,,2018,11,2,PAYEMENT,29.5,C967609356
28138,1196428',2018-11-02,NEFT/000055369317/INDIAN,11044746.0,0.0,,2018,11,2,PAYEMENT,11044746.0,C1519254830
28139,1196428',2018-11-02,TRF FROM  Indiaforensic SERVICES,0.0,4900000.0,,2018,11,2,TRANSFER,4900000.0,M1117501271
28140,1196428',2018-11-02,TRF FROM  Indiaforensic SERVICES,0.0,500000.0,,2018,11,2,TRANSFER,500000.0,M401617172
28141,1196428',2018-11-02,TRF FROM  Indiaforensic SERVICES,0.0,800000.0,,2018,11,2,TRANSFER,800000.0,M587743135
28142,1196428',2018-11-02,FDRL/INTERNAL FUND TRANSFE,100000.0,0.0,,2018,11,2,DEBIT,100000.0,C1505755152
28143,1196428',2018-11-02,FDRL/INTERNAL FUND TRANSFE,100000.0,0.0,,2018,11,2,CASH_OUT,100000.0,M987609753
28144,1196428',2018-11-02,FDRL/INTERNAL FUND TRANSFE,50000.0,0.0,,2018,11,2,CHECK_WITHDRAWAL,50000.0,C1886938557
28145,1196428',2018-11-02,FDRL/INTERNAL FUND TRANSFE,100000.0,0.0,,2018,11,2,CASH_OUT,100000.0,M958955062
28146,1196428',2018-11-02,FDRL/INTERNAL FUND TRANSFE,100000.0,0.0,,2018,11,2,CASH_OUT,100000.0,M1783496418
28147,1196428',2018-11-02,FDRL/INTERNAL FUND TRANSFE,100000.0,0.0,,2018,11,2,PAYEMENT,100000.0,M618736064
28148,1196428',2018-11-02,FDRL/INTERNAL FUND TRANSFE,50000.0,0.0,,2018,11,2,DEBIT,50000.0,C1946866478
28149,1196428',2018-11-02,FDRL/INTERNAL FUND TRANSFE,3000000.0,0.0,,2018,11,2,DEBIT,3000000.0,M818123400
28150,1196428',2018-11-02,FDRL/INTERNAL FUND TRANSFE,1000000.0,0.0,,2018,11,2,DEBIT,1000000.0,C2009468024
28151,1196428',2018-11-02,FDRL/INTERNAL FUND TRANSFE,1000000.0,0.0,,2018,11,2,CHECK_WITHDRAWAL,1000000.0,C1022680775
28152,1196428',2018-11-02,FDRL/INTERNAL FUND TRANSFE,100000.0,0.0,,2018,11,2,DEBIT,100000.0,M1310755992
28153,1196428',2018-11-02,FDRL/INTERNAL FUND TRANSFE,100000.0,0.0,,2018,11,2,CHECK_WITHDRAWAL,100000.0,M1553088064
28154,1196428',2018-11-02,FDRL/INTERNAL FUND TRANSFE,500000.0,0.0,,2018,11,2,DEBIT,500000.0,M743512841
28155,1196428',2018-11-02,BEAT CSH PKP DEL GURGA 77,0.0,33000.0,,2018,11,2,CASH_IN,33000.0,C2011184385
28156,1196428',2018-11-02,CHQ DEPOSIT RETURN/73244/,100.0,0.0,,2018,11,2,CHECK_WITHDRAWAL,100.0,M405417067
28157,1196428',2018-11-02,CHQ DEPOSIT RETURN/73244/,18.0,0.0,,2018,11,2,CASH_OUT,18.0,C211528162
28158,1196428',2018-11-02,CHQ DEPOSIT RETURN/8955/C,100.0,0.0,,2018,11,2,CHECK_WITHDRAWAL,100.0,C31789747
28159,1196428',2018-11-02,CHQ DEPOSIT RETURN/8955/G,18.0,0.0,,2018,11,2,CASH_OUT,18.0,C1975607158
28160,1196428',2018-11-03,RTGS/PUNBH18307246799/MAN,0.0,300000.0,,2018,11,3,CHECK_CASHING,300000.0,M1368926191
28161,1196428',2018-11-03,RTGS/SBINH18307030466/SRI,0.0,200000.0,,2018,11,3,TRANSFER,200000.0,M173412374
28162,1196428',2018-11-03,IMLCU0070181423:Letter of,4525.83,0.0,,2018,11,3,PAYEMENT,4525.83,M1645929191
28163,1196428',2018-11-03,IMLCU0070181423:Letter of,1994.65,0.0,,2018,11,3,PAYEMENT,1994.65,C235386075
28164,1196428',2018-11-03,NEFT/N307180671596409/JUN,0.0,100000.0,,2018,11,3,CHECK_CASHING,100000.0,C2014517831
28165,1196428',2018-11-03,TRF FROM  Indiaforensic SERVICES,0.0,3000000.0,,2018,11,3,CHECK_CASHING,3000000.0,M2113755606
28166,1196428',2018-11-03,RTGS/PUNBH18307260268/BAL,0.0,200000.0,,2018,11,3,CHECK_CASHING,200000.0,C1782098044
28167,1196428',2018-11-03,RTGS/ICICH18307379168/Indfor,0.0,500000.0,,2018,11,3,TRANSFER,500000.0,M1074489745
28168,1196428',2018-11-03,RTGS/ICICH18307378015/Indfor,0.0,1000000.0,,2018,11,3,TRANSFER,1000000.0,C1070146065
28169,1196428',2018-11-03,RTGS/ICICH18307379820/Indfor,0.0,1000000.0,,2018,11,3,CASH_IN,1000000.0,M493618516
28170,1196428',2018-11-03,NEFT/N307180671804265/USH,0.0,10000.0,,2018,11,3,TRANSFER,10000.0,M753439011
28171,1196428',2018-11-03,NEFT/SBIN318307586581/SRI,0.0,190000.0,,2018,11,3,CASH_IN,190000.0,C378841819
28172,1196428',2018-11-03,TRF FROM  Indiaforensic SERVICES,0.0,10000000.0,,2018,11,3,TRANSFER,10000000.0,M1381876909
28173,1196428',2018-11-03,TRF FROM  Indiaforensic SERVICES,0.0,1000000.0,,2018,11,3,TRANSFER,1000000.0,C969412636
28174,1196428',2018-11-03,TRF FROM  Indiaforensic SERVICES,0.0,1000000.0,,2018,11,3,CHECK_CASHING,1000000.0,C2030493231
28175,1196428',2018-11-03,IMPS 830717987325 FROM SA,0.0,200000.0,,2018,11,3,CHECK_CASHING,200000.0,C1680630881
28176,1196428',2018-11-03,FDRL/NATIONAL ELECTRONIC F,11116023.86,0.0,,2018,11,3,PAYEMENT,11116023.86,C1339858954
28177,1196428',2018-11-03,FDRL/INTERNAL FUND TRANSFE,500000.0,0.0,,2018,11,3,CASH_OUT,500000.0,C506903242
28178,1196428',2018-11-03,FDRL/INTERNAL FUND TRANSFE,3000000.0,0.0,,2018,11,3,CASH_OUT,3000000.0,M2072059657
28179,1196428',2018-11-03,FDRL/INTERNAL FUND TRANSFE,3000000.0,0.0,,2018,11,3,PAYEMENT,3000000.0,C304406966
28180,1196428',2018-11-03,BEAT CSH PKP DEL GURGA 77,0.0,56000.0,,2018,11,3,TRANSFER,56000.0,C75629578
28181,1196428',2018-11-05,NEFT/PUNBH18309119860/BAL,0.0,175000.0,,2018,11,5,CASH_IN,175000.0,M1037398211
28182,1196428',2018-11-05,RTGS/HDFCH18309169329/BAT,0.0,500000.0,,2018,11,5,TRANSFER,500000.0,C2072030256
28183,1196428',2018-11-05,CASHDEP/NERUL/,0.0,30000.0,,2018,11,5,TRANSFER,30000.0,C886888353
28184,1196428',2018-11-05,NEFT/N309180673121776/SID,0.0,102900.0,,2018,11,5,CHECK_CASHING,102900.0,C701279123
28185,1196428',2018-11-05,TRF FROM  Indiaforensic SERVICES,0.0,6500000.0,,2018,11,5,CHECK_CASHING,6500000.0,C864016033
28186,1196428',2018-11-05,TRF FROM  Indiaforensic SERVICES,0.0,15000000.0,,2018,11,5,CHECK_CASHING,15000000.0,C515442419
28187,1196428',2018-11-05,TRF FROM  Indiaforensic SERVICES,0.0,15000000.0,,2018,11,5,TRANSFER,15000000.0,M2127093801
28188,1196428',2018-11-05,TRF FROM  Indiaforensic SERVICES,0.0,10000000.0,,2018,11,5,CHECK_CASHING,10000000.0,C1649686970
28189,1196428',2018-11-05,NEFT CHARGES AND GST/0000,29.5,0.0,,2018,11,5,CHECK_WITHDRAWAL,29.5,C701855966
28190,1196428',2018-11-05,NEFT/000055746054/Indiaforensic,15000000.0,0.0,,2018,11,5,DEBIT,15000000.0,C1505217516
28191,1196428',2018-11-05,FDRL/INTERNAL FUND TRANSFE,500000.0,0.0,,2018,11,5,CASH_OUT,500000.0,M676875212
28192,1196428',2018-11-05,FDRL/INTERNAL FUND TRANSFE,3000000.0,0.0,,2018,11,5,CHECK_WITHDRAWAL,3000000.0,C681709819
28193,1196428',2018-11-05,FDRL/INTERNAL FUND TRANSFE,3000000.0,0.0,,2018,11,5,CASH_OUT,3000000.0,M1025042585
28194,1196428',2018-11-05,FDRL/INTERNAL FUND TRANSFE,1000000.0,0.0,,2018,11,5,CHECK_WITHDRAWAL,1000000.0,C807247901
28195,1196428',2018-11-05,NEFT/000055178733/Indiaforensic,0.0,1400000.0,,2018,11,5,TRANSFER,1400000.0,M18308448
28196,1196428',2018-11-05,NEFT/000055180407/Indiaforensic,0.0,2600000.0,,2018,11,5,CASH_IN,2600000.0,M170030714
28197,1196428',2018-11-05,TRF TO  Indiaforensic SERVICES I,1300000.0,0.0,,2018,11,5,CHECK_WITHDRAWAL,1300000.0,M621155607
28198,1196428',2018-11-05,TRF FROM  Indiaforensic SERVICES,0.0,2400000.0,,2018,11,5,CHECK_CASHING,2400000.0,C1660095722
28199,1196428',2018-11-05,BEAT CSH PKP DEL GURGA 77,0.0,240000.0,,2018,11,5,CHECK_CASHING,240000.0,M1571765149
28200,1196428',2018-11-06,NEFT/N310180674151629/TEC,0.0,100000.0,,2018,11,6,CHECK_CASHING,100000.0,C1663686815
28201,1196428',2018-11-06,UPI/831009487595/COMPUTER,0.0,8200.0,,2018,11,6,CASH_IN,8200.0,M279824269
28202,1196428',2018-11-06,IMPS 831009306964 FROM SU,0.0,8200.0,,2018,11,6,TRANSFER,8200.0,M1570490488
28203,1196428',2018-11-06,RTGS/PUNBH18310289210/MAN,0.0,300000.0,,2018,11,6,TRANSFER,300000.0,M1063002743
28204,1196428',2018-11-06,UPI/831010725852/UPI/VINO,0.0,8200.0,,2018,11,6,TRANSFER,8200.0,M1530195938
28205,1196428',2018-11-06,IMPS 831010633929 FROM SA,0.0,8200.0,,2018,11,6,CHECK_CASHING,8200.0,C1883840933
28206,1196428',2018-11-06,NEFT CHARGES AND GST/0000,29.5,0.0,,2018,11,6,CASH_OUT,29.5,M2097586567
28207,1196428',2018-11-06,NEFT/000055839539/INDIAN,11116024.0,0.0,,2018,11,6,CHECK_WITHDRAWAL,11116024.0,C1700852615
28208,1196428',2018-11-06,RTGS/YESBH18310429656/Indfor,4000000.0,0.0,,2018,11,6,CASH_OUT,4000000.0,C1457728035
28209,1196428',2018-11-06,RTGS/YESBH18310429730/IND,3585365.0,0.0,,2018,11,6,CASH_OUT,3585365.0,C47249488
28210,1196428',2018-11-06,RTGS/UTIBH18310695424/Indfor,0.0,1000000.0,,2018,11,6,TRANSFER,1000000.0,C33524623
28211,1196428',2018-11-06,NEFT/SBIN518310816407/SRI,0.0,160000.0,,2018,11,6,CASH_IN,160000.0,C2133591152
28212,1196428',2018-11-06,TRF FROM  Indiaforensic SERVICES,0.0,4000000.0,,2018,11,6,CASH_IN,4000000.0,C193864812
28213,1196428',2018-11-06,NEFT CHARGES AND GST/0000,29.5,0.0,,2018,11,6,PAYEMENT,29.5,C1058921154
28214,1196428',2018-11-06,NEFT/000055850802/INDIAN,14800000.0,0.0,,2018,11,6,CHECK_WITHDRAWAL,14800000.0,C798678484
28215,1196428',2018-11-06,TRF TO  Indiaforensic SERVICES I,2000000.0,0.0,,2018,11,6,PAYEMENT,2000000.0,C769342184
28216,1196428',2018-11-06,TRF FROM  Indiaforensic SERVICES,0.0,2000000.0,,2018,11,6,CASH_IN,2000000.0,C981198566
28217,1196428',2018-11-06,FDRL/REAL TIME GROSS SETTL,2000000.0,0.0,,2018,11,6,PAYEMENT,2000000.0,C1281898359
28218,1196428',2018-11-06,FDRL/REAL TIME GROSS SETTL,2000000.0,0.0,,2018,11,6,CASH_OUT,2000000.0,C30013970
28219,1196428',2018-11-06,RTGS/ICICH18310663025/Indfor,0.0,500000.0,,2018,11,6,CHECK_CASHING,500000.0,C31789747
28220,1196428',2018-11-06,RTGS/ICICH18310679279/Indfor,0.0,1000000.0,,2018,11,6,CASH_IN,1000000.0,C93518808
28221,1196428',2018-11-06,CASHPMT/GURGAON/SELF,49000.0,0.0,,2018,11,6,CHECK_WITHDRAWAL,49000.0,C2093546827
28222,1196428',2018-11-06,FDRL/NATIONAL ELECTRONIC F,99107.0,0.0,,2018,11,6,DEBIT,99107.0,C976133979
28223,1196428',2018-11-06,FDRL/NATIONAL ELECTRONIC F,160223.0,0.0,,2018,11,6,CASH_OUT,160223.0,C849038219
28224,1196428',2018-11-06,FDRL/INTERNAL FUND TRANSFE,500000.0,0.0,,2018,11,6,DEBIT,500000.0,C1789550256
28225,1196428',2018-11-06,FDRL/IndforSECURE_PAYMENT,0.0,15428.0,,2018,11,6,CHECK_CASHING,15428.0,C363475076
28226,1196428',2018-11-06,FDRL/NXTXN_PAYMENT,0.0,9927.0,,2018,11,6,CASH_IN,9927.0,C2110623348
28227,1196428',2018-11-06,831017040844-ACCOUNT VALI,0.0,1.0,,2018,11,6,CASH_IN,1.0,C1161820020
28228,1196428',2018-11-06,TRF FROM  Indiaforensic SERVICES,0.0,14300000.0,,2018,11,6,TRANSFER,14300000.0,C627675433
28229,1196428',2018-11-06,FDRL/NATIONAL ELECTRONIC F,14211535.27,0.0,,2018,11,6,CASH_OUT,14211535.27,C1145835418
28230,1196428',2018-11-06,FDRL/NATIONAL ELECTRONIC F,21933.0,0.0,,2018,11,6,DEBIT,21933.0,C1778300121
28231,1196428',2018-11-06,NEFT/AXIC183104222630/Indfor,0.0,10000000.0,,2018,11,6,CASH_IN,10000000.0,C1325626015
28232,1196428',2018-11-06,FDRL/INTERNAL FUND TRANSFE,3000000.0,0.0,,2018,11,6,PAYEMENT,3000000.0,C8733802
28233,1196428',2018-11-06,FDRL/INTERNAL FUND TRANSFE,1000000.0,0.0,,2018,11,6,PAYEMENT,1000000.0,C990053853
28234,1196428',2018-11-06,FDRL/INTERNAL FUND TRANSFE,1000000.0,0.0,,2018,11,6,PAYEMENT,1000000.0,C218193338
28235,1196428',2018-11-06,FDRL/INTERNAL FUND TRANSFE,500000.0,0.0,,2018,11,6,DEBIT,500000.0,M832073005
28236,1196428',2018-11-06,TRF FROM  Indiaforensic SERVICES,0.0,2000000.0,,2018,11,6,TRANSFER,2000000.0,M189083850
28237,1196428',2018-11-06,TRF FROM  Indiaforensic SERVICES,0.0,5000000.0,,2018,11,6,CASH_IN,5000000.0,C103357744
28238,1196428',2018-11-07,FDRL/NATIONAL ELECTRONIC F,25527.0,0.0,,2018,11,7,CASH_OUT,25527.0,M1942890330
28239,1196428',2018-11-07,FDRL/NATIONAL ELECTRONIC F,37817.0,0.0,,2018,11,7,CASH_OUT,37817.0,C2011941350
28240,1196428',2018-11-07,FDRL/NATIONAL ELECTRONIC F,40968.0,0.0,,2018,11,7,DEBIT,40968.0,C1505755152
28241,1196428',2018-11-07,FDRL/NATIONAL ELECTRONIC F,22360.0,0.0,,2018,11,7,DEBIT,22360.0,M1051118371
28242,1196428',2018-11-07,FDRL/NATIONAL ELECTRONIC F,34546.0,0.0,,2018,11,7,DEBIT,34546.0,M1502077581
28243,1196428',2018-11-07,FDRL/NATIONAL ELECTRONIC F,17271.0,0.0,,2018,11,7,CHECK_WITHDRAWAL,17271.0,M1801625172
28244,1196428',2018-11-07,FDRL/NATIONAL ELECTRONIC F,42043.0,0.0,,2018,11,7,CASH_OUT,42043.0,C360898540
28245,1196428',2018-11-07,FDRL/NATIONAL ELECTRONIC F,34671.0,0.0,,2018,11,7,DEBIT,34671.0,M1408738192
28246,1196428',2018-11-07,FDRL/NATIONAL ELECTRONIC F,17800.0,0.0,,2018,11,7,CHECK_WITHDRAWAL,17800.0,C237594516
28247,1196428',2018-11-07,FDRL/NATIONAL ELECTRONIC F,11950.0,0.0,,2018,11,7,CHECK_WITHDRAWAL,11950.0,M1645271006
28248,1196428',2018-11-07,FDRL/NATIONAL ELECTRONIC F,16809.0,0.0,,2018,11,7,DEBIT,16809.0,M1616707854
28249,1196428',2018-11-07,FDRL/NATIONAL ELECTRONIC F,13697.0,0.0,,2018,11,7,CHECK_WITHDRAWAL,13697.0,C1334973394
28250,1196428',2018-11-07,FDRL/NATIONAL ELECTRONIC F,26277.0,0.0,,2018,11,7,CASH_OUT,26277.0,M1547406846
28251,1196428',2018-11-07,FDRL/NATIONAL ELECTRONIC F,19252.0,0.0,,2018,11,7,PAYEMENT,19252.0,M51814511
28252,1196428',2018-11-07,FDRL/NATIONAL ELECTRONIC F,3109.0,0.0,,2018,11,7,DEBIT,3109.0,M1679527434
28253,1196428',2018-11-07,FDRL/NATIONAL ELECTRONIC F,5800.0,0.0,,2018,11,7,DEBIT,5800.0,M858729243
28254,1196428',2018-11-07,FDRL/NATIONAL ELECTRONIC F,3589.0,0.0,,2018,11,7,DEBIT,3589.0,M317858117
28255,1196428',2018-11-07,FDRL/NATIONAL ELECTRONIC F,11909.0,0.0,,2018,11,7,DEBIT,11909.0,M974232437
28256,1196428',2018-11-07,FDRL/NATIONAL ELECTRONIC F,11737.0,0.0,,2018,11,7,CASH_OUT,11737.0,M535001108
28257,1196428',2018-11-07,FDRL/NATIONAL ELECTRONIC F,15314.0,0.0,,2018,11,7,CASH_OUT,15314.0,M967799453
28258,1196428',2018-11-07,FDRL/NATIONAL ELECTRONIC F,14424.0,0.0,,2018,11,7,PAYEMENT,14424.0,M1704857178
28259,1196428',2018-11-07,FDRL/NATIONAL ELECTRONIC F,27532.0,0.0,,2018,11,7,CHECK_WITHDRAWAL,27532.0,M888552844
28260,1196428',2018-11-07,FDRL/NATIONAL ELECTRONIC F,2303.0,0.0,,2018,11,7,CASH_OUT,2303.0,M257269635
28261,1196428',2018-11-07,FDRL/NATIONAL ELECTRONIC F,13816.0,0.0,,2018,11,7,CHECK_WITHDRAWAL,13816.0,C1305075214
28262,1196428',2018-11-07,FDRL/NATIONAL ELECTRONIC F,26227.0,0.0,,2018,11,7,CASH_OUT,26227.0,C1627965794
28263,1196428',2018-11-07,FDRL/NATIONAL ELECTRONIC F,12244.0,0.0,,2018,11,7,CASH_OUT,12244.0,M1559676676
28264,1196428',2018-11-07,FDRL/NATIONAL ELECTRONIC F,23520.0,0.0,,2018,11,7,CASH_OUT,23520.0,C741431520
28265,1196428',2018-11-07,FDRL/NATIONAL ELECTRONIC F,28288.0,0.0,,2018,11,7,PAYEMENT,28288.0,C2143477943
28266,1196428',2018-11-07,FDRL/NATIONAL ELECTRONIC F,17270.0,0.0,,2018,11,7,CHECK_WITHDRAWAL,17270.0,C638551812
28267,1196428',2018-11-07,FDRL/NATIONAL ELECTRONIC F,25650.0,0.0,,2018,11,7,PAYEMENT,25650.0,C1027296777
28268,1196428',2018-11-07,FDRL/NATIONAL ELECTRONIC F,12953.0,0.0,,2018,11,7,PAYEMENT,12953.0,C1554540309
28269,1196428',2018-11-07,FDRL/NATIONAL ELECTRONIC F,12351.0,0.0,,2018,11,7,CHECK_WITHDRAWAL,12351.0,M2120427827
28270,1196428',2018-11-07,FDRL/NATIONAL ELECTRONIC F,19449.0,0.0,,2018,11,7,CASH_OUT,19449.0,C820910648
28271,1196428',2018-11-07,FDRL/NATIONAL ELECTRONIC F,22600.0,0.0,,2018,11,7,CHECK_WITHDRAWAL,22600.0,M415456371
28272,1196428',2018-11-07,FDRL/NATIONAL ELECTRONIC F,26400.0,0.0,,2018,11,7,PAYEMENT,26400.0,M598340030
28273,1196428',2018-11-07,FDRL/NATIONAL ELECTRONIC F,11355.0,0.0,,2018,11,7,DEBIT,11355.0,C345679794
28274,1196428',2018-11-07,FDRL/NATIONAL ELECTRONIC F,15543.0,0.0,,2018,11,7,CHECK_WITHDRAWAL,15543.0,M1605050346
28275,1196428',2018-11-07,FDRL/NATIONAL ELECTRONIC F,15112.0,0.0,,2018,11,7,PAYEMENT,15112.0,C1144070975
28276,1196428',2018-11-07,FDRL/NATIONAL ELECTRONIC F,25791.0,0.0,,2018,11,7,DEBIT,25791.0,M639999796
28277,1196428',2018-11-07,FDRL/NATIONAL ELECTRONIC F,28900.0,0.0,,2018,11,7,DEBIT,28900.0,C343534938
28278,1196428',2018-11-07,FDRL/NATIONAL ELECTRONIC F,21975.0,0.0,,2018,11,7,PAYEMENT,21975.0,M479872561
28279,1196428',2018-11-07,FDRL/NATIONAL ELECTRONIC F,10583.0,0.0,,2018,11,7,CHECK_WITHDRAWAL,10583.0,M61732893
28280,1196428',2018-11-07,FDRL/NATIONAL ELECTRONIC F,13084.0,0.0,,2018,11,7,CASH_OUT,13084.0,C160632822
28281,1196428',2018-11-07,FDRL/NATIONAL ELECTRONIC F,23105.0,0.0,,2018,11,7,CASH_OUT,23105.0,C1183266411
28282,1196428',2018-11-07,FDRL/NATIONAL ELECTRONIC F,7510.0,0.0,,2018,11,7,DEBIT,7510.0,M1328778262
28283,1196428',2018-11-07,FDRL/NATIONAL ELECTRONIC F,25719.0,0.0,,2018,11,7,PAYEMENT,25719.0,M704806959
28284,1196428',2018-11-07,FDRL/NATIONAL ELECTRONIC F,12903.0,0.0,,2018,11,7,DEBIT,12903.0,C229313132
28285,1196428',2018-11-07,FDRL/NATIONAL ELECTRONIC F,22600.0,0.0,,2018,11,7,DEBIT,22600.0,M325906300
28286,1196428',2018-11-07,FDRL/NATIONAL ELECTRONIC F,17271.0,0.0,,2018,11,7,PAYEMENT,17271.0,M1267748122
28287,1196428',2018-11-07,FDRL/NATIONAL ELECTRONIC F,22600.0,0.0,,2018,11,7,CASH_OUT,22600.0,M159739450
28288,1196428',2018-11-07,FDRL/NATIONAL ELECTRONIC F,22600.0,0.0,,2018,11,7,DEBIT,22600.0,M1702289141
28289,1196428',2018-11-07,FDRL/NATIONAL ELECTRONIC F,14814.0,0.0,,2018,11,7,CASH_OUT,14814.0,C1200612373
28290,1196428',2018-11-07,FDRL/NATIONAL ELECTRONIC F,21235.0,0.0,,2018,11,7,DEBIT,21235.0,C1840046890
28291,1196428',2018-11-07,FDRL/NATIONAL ELECTRONIC F,19069.0,0.0,,2018,11,7,DEBIT,19069.0,M1261751850
28292,1196428',2018-11-07,FDRL/NATIONAL ELECTRONIC F,16842.0,0.0,,2018,11,7,DEBIT,16842.0,M1535970431
28293,1196428',2018-11-07,FDRL/NATIONAL ELECTRONIC F,19720.0,0.0,,2018,11,7,CASH_OUT,19720.0,M524251983
28294,1196428',2018-11-07,FDRL/NATIONAL ELECTRONIC F,24860.0,0.0,,2018,11,7,DEBIT,24860.0,C1406749291
28295,1196428',2018-11-07,FDRL/NATIONAL ELECTRONIC F,21691.0,0.0,,2018,11,7,CHECK_WITHDRAWAL,21691.0,C1415645767
28296,1196428',2018-11-07,FDRL/NATIONAL ELECTRONIC F,9529.0,0.0,,2018,11,7,CASH_OUT,9529.0,M1816834020
28297,1196428',2018-11-07,FDRL/NATIONAL ELECTRONIC F,14814.0,0.0,,2018,11,7,PAYEMENT,14814.0,C1732292969
28298,1196428',2018-11-07,FDRL/NATIONAL ELECTRONIC F,24860.0,0.0,,2018,11,7,DEBIT,24860.0,M1739764490
28299,1196428',2018-11-07,FDRL/NATIONAL ELECTRONIC F,25000.0,0.0,,2018,11,7,CASH_OUT,25000.0,M1664129150
28300,1196428',2018-11-07,FDRL/NATIONAL ELECTRONIC F,14814.0,0.0,,2018,11,7,CHECK_WITHDRAWAL,14814.0,M1128852062
28301,1196428',2018-11-07,FDRL/NATIONAL ELECTRONIC F,24860.0,0.0,,2018,11,7,DEBIT,24860.0,M182471589
28302,1196428',2018-11-07,FDRL/NATIONAL ELECTRONIC F,15052.0,0.0,,2018,11,7,CASH_OUT,15052.0,M1056074872
28303,1196428',2018-11-07,FDRL/NATIONAL ELECTRONIC F,24860.0,0.0,,2018,11,7,CHECK_WITHDRAWAL,24860.0,M2106622700
28304,1196428',2018-11-07,FDRL/NATIONAL ELECTRONIC F,24860.0,0.0,,2018,11,7,CHECK_WITHDRAWAL,24860.0,M163766295
28305,1196428',2018-11-07,FDRL/NATIONAL ELECTRONIC F,24860.0,0.0,,2018,11,7,DEBIT,24860.0,M802332120
28306,1196428',2018-11-07,FDRL/NATIONAL ELECTRONIC F,11368.0,0.0,,2018,11,7,DEBIT,11368.0,M1676185662
28307,1196428',2018-11-07,FDRL/NATIONAL ELECTRONIC F,15052.0,0.0,,2018,11,7,CASH_OUT,15052.0,M1776427379
28308,1196428',2018-11-07,FDRL/NATIONAL ELECTRONIC F,24058.0,0.0,,2018,11,7,PAYEMENT,24058.0,M334173295
28309,1196428',2018-11-07,FDRL/NATIONAL ELECTRONIC F,24860.0,0.0,,2018,11,7,CASH_OUT,24860.0,M330490124
28310,1196428',2018-11-07,FDRL/NATIONAL ELECTRONIC F,12596.0,0.0,,2018,11,7,PAYEMENT,12596.0,M1154845973
28311,1196428',2018-11-07,FDRL/NATIONAL ELECTRONIC F,15871.0,0.0,,2018,11,7,PAYEMENT,15871.0,M911987264
28312,1196428',2018-11-07,FDRL/NATIONAL ELECTRONIC F,15052.0,0.0,,2018,11,7,CHECK_WITHDRAWAL,15052.0,M1680147473
28313,1196428',2018-11-07,FDRL/NATIONAL ELECTRONIC F,27120.0,0.0,,2018,11,7,CHECK_WITHDRAWAL,27120.0,M293659205
28314,1196428',2018-11-07,FDRL/NATIONAL ELECTRONIC F,13366.0,0.0,,2018,11,7,PAYEMENT,13366.0,M1432093328
28315,1196428',2018-11-07,FDRL/NATIONAL ELECTRONIC F,12596.0,0.0,,2018,11,7,PAYEMENT,12596.0,M901262414
28316,1196428',2018-11-07,FDRL/NATIONAL ELECTRONIC F,24859.0,0.0,,2018,11,7,PAYEMENT,24859.0,M899962047
28317,1196428',2018-11-07,FDRL/NATIONAL ELECTRONIC F,24659.0,0.0,,2018,11,7,CASH_OUT,24659.0,M32715716
28318,1196428',2018-11-07,FDRL/NATIONAL ELECTRONIC F,6094.0,0.0,,2018,11,7,PAYEMENT,6094.0,M1510311379
28319,1196428',2018-11-07,FDRL/NATIONAL ELECTRONIC F,22342.0,0.0,,2018,11,7,CASH_OUT,22342.0,M1517206841
28320,1196428',2018-11-07,FDRL/NATIONAL ELECTRONIC F,26366.0,0.0,,2018,11,7,CHECK_WITHDRAWAL,26366.0,M2030024765
28321,1196428',2018-11-07,FDRL/NATIONAL ELECTRONIC F,24859.0,0.0,,2018,11,7,CASH_OUT,24859.0,M1267580132
28322,1196428',2018-11-07,FDRL/NATIONAL ELECTRONIC F,15052.0,0.0,,2018,11,7,DEBIT,15052.0,C655391383
28323,1196428',2018-11-07,FDRL/NATIONAL ELECTRONIC F,24659.0,0.0,,2018,11,7,CHECK_WITHDRAWAL,24659.0,C2117215775
28324,1196428',2018-11-07,FDRL/NATIONAL ELECTRONIC F,15052.0,0.0,,2018,11,7,CASH_OUT,15052.0,C2106576360
28325,1196428',2018-11-07,FDRL/NATIONAL ELECTRONIC F,22340.0,0.0,,2018,11,7,DEBIT,22340.0,M267789972
28326,1196428',2018-11-07,FDRL/NATIONAL ELECTRONIC F,23526.0,0.0,,2018,11,7,CHECK_WITHDRAWAL,23526.0,M292960678
28327,1196428',2018-11-07,FDRL/NATIONAL ELECTRONIC F,24860.0,0.0,,2018,11,7,CHECK_WITHDRAWAL,24860.0,C1638372110
28328,1196428',2018-11-07,FDRL/NATIONAL ELECTRONIC F,24859.0,0.0,,2018,11,7,CASH_OUT,24859.0,C1377774115
28329,1196428',2018-11-07,FDRL/NATIONAL ELECTRONIC F,24859.0,0.0,,2018,11,7,DEBIT,24859.0,M1877845145
28330,1196428',2018-11-07,FDRL/NATIONAL ELECTRONIC F,22849.0,0.0,,2018,11,7,CHECK_WITHDRAWAL,22849.0,M869149988
28331,1196428',2018-11-07,FDRL/NATIONAL ELECTRONIC F,15632.0,0.0,,2018,11,7,DEBIT,15632.0,M1324498984
28332,1196428',2018-11-07,FDRL/NATIONAL ELECTRONIC F,23504.0,0.0,,2018,11,7,PAYEMENT,23504.0,C748014372
28333,1196428',2018-11-07,FDRL/NATIONAL ELECTRONIC F,24859.0,0.0,,2018,11,7,DEBIT,24859.0,M1556526073
28334,1196428',2018-11-07,FDRL/NATIONAL ELECTRONIC F,9648.0,0.0,,2018,11,7,PAYEMENT,9648.0,M1113797896
28335,1196428',2018-11-07,FDRL/NATIONAL ELECTRONIC F,17684.0,0.0,,2018,11,7,DEBIT,17684.0,M111103216
28336,1196428',2018-11-07,FDRL/NATIONAL ELECTRONIC F,24860.0,0.0,,2018,11,7,CHECK_WITHDRAWAL,24860.0,M402054040
28337,1196428',2018-11-07,FDRL/NATIONAL ELECTRONIC F,14737.0,0.0,,2018,11,7,CASH_OUT,14737.0,C1174935745
28338,1196428',2018-11-07,FDRL/NATIONAL ELECTRONIC F,11613.0,0.0,,2018,11,7,DEBIT,11613.0,M3128155
28339,1196428',2018-11-07,FDRL/NATIONAL ELECTRONIC F,24059.0,0.0,,2018,11,7,PAYEMENT,24059.0,M804435874
28340,1196428',2018-11-07,FDRL/NATIONAL ELECTRONIC F,24860.0,0.0,,2018,11,7,PAYEMENT,24860.0,M22524150
28341,1196428',2018-11-07,FDRL/NATIONAL ELECTRONIC F,24860.0,0.0,,2018,11,7,CASH_OUT,24860.0,C717951588
28342,1196428',2018-11-07,FDRL/NATIONAL ELECTRONIC F,19027.0,0.0,,2018,11,7,DEBIT,19027.0,M994429804
28343,1196428',2018-11-07,FDRL/NATIONAL ELECTRONIC F,24660.0,0.0,,2018,11,7,CASH_OUT,24660.0,M42960844
28344,1196428',2018-11-07,FDRL/NATIONAL ELECTRONIC F,21640.0,0.0,,2018,11,7,DEBIT,21640.0,M117897905
28345,1196428',2018-11-07,FDRL/NATIONAL ELECTRONIC F,24860.0,0.0,,2018,11,7,DEBIT,24860.0,M919103236
28346,1196428',2018-11-07,FDRL/NATIONAL ELECTRONIC F,26216.0,0.0,,2018,11,7,CASH_OUT,26216.0,M2117556230
28347,1196428',2018-11-07,FDRL/NATIONAL ELECTRONIC F,17508.0,0.0,,2018,11,7,CHECK_WITHDRAWAL,17508.0,M2047174428
28348,1196428',2018-11-07,FDRL/NATIONAL ELECTRONIC F,24860.0,0.0,,2018,11,7,DEBIT,24860.0,M1468774738
28349,1196428',2018-11-07,FDRL/NATIONAL ELECTRONIC F,15052.0,0.0,,2018,11,7,PAYEMENT,15052.0,M266577647
28350,1196428',2018-11-07,FDRL/NATIONAL ELECTRONIC F,17685.0,0.0,,2018,11,7,CASH_OUT,17685.0,M1474343674
28351,1196428',2018-11-07,FDRL/NATIONAL ELECTRONIC F,17685.0,0.0,,2018,11,7,PAYEMENT,17685.0,M1664266643
28352,1196428',2018-11-07,FDRL/NATIONAL ELECTRONIC F,17508.0,0.0,,2018,11,7,DEBIT,17508.0,M842463018
28353,1196428',2018-11-07,FDRL/NATIONAL ELECTRONIC F,12911.0,0.0,,2018,11,7,CASH_OUT,12911.0,M284325832
28354,1196428',2018-11-07,FDRL/NATIONAL ELECTRONIC F,9648.0,0.0,,2018,11,7,CHECK_WITHDRAWAL,9648.0,M1784760424
28355,1196428',2018-11-07,FDRL/NATIONAL ELECTRONIC F,15052.0,0.0,,2018,11,7,CHECK_WITHDRAWAL,15052.0,M1489026763
28356,1196428',2018-11-07,FDRL/NATIONAL ELECTRONIC F,23354.0,0.0,,2018,11,7,DEBIT,23354.0,C1800405372
28357,1196428',2018-11-07,FDRL/NATIONAL ELECTRONIC F,15052.0,0.0,,2018,11,7,PAYEMENT,15052.0,C2071512077
28358,1196428',2018-11-07,FDRL/NATIONAL ELECTRONIC F,24860.0,0.0,,2018,11,7,CASH_OUT,24860.0,C1588635270
28359,1196428',2018-11-07,FDRL/NATIONAL ELECTRONIC F,7378.0,0.0,,2018,11,7,CHECK_WITHDRAWAL,7378.0,C1495001462
28360,1196428',2018-11-07,FDRL/NATIONAL ELECTRONIC F,10080.0,0.0,,2018,11,7,CHECK_WITHDRAWAL,10080.0,M84558619
28361,1196428',2018-11-07,FDRL/NATIONAL ELECTRONIC F,16038.0,0.0,,2018,11,7,CHECK_WITHDRAWAL,16038.0,M113925453
28362,1196428',2018-11-07,FDRL/NATIONAL ELECTRONIC F,10991.0,0.0,,2018,11,7,PAYEMENT,10991.0,M645245228
28363,1196428',2018-11-07,FDRL/NATIONAL ELECTRONIC F,2843.0,0.0,,2018,11,7,DEBIT,2843.0,M636094317
28364,1196428',2018-11-07,FDRL/NATIONAL ELECTRONIC F,28264.0,0.0,,2018,11,7,PAYEMENT,28264.0,M1583961850
28365,1196428',2018-11-07,FDRL/NATIONAL ELECTRONIC F,19046.0,0.0,,2018,11,7,PAYEMENT,19046.0,M708029389
28366,1196428',2018-11-07,FDRL/NATIONAL ELECTRONIC F,11470.0,0.0,,2018,11,7,DEBIT,11470.0,M508231066
28367,1196428',2018-11-07,FDRL/NATIONAL ELECTRONIC F,13819.0,0.0,,2018,11,7,CHECK_WITHDRAWAL,13819.0,C1838491463
28368,1196428',2018-11-07,FDRL/NATIONAL ELECTRONIC F,21887.0,0.0,,2018,11,7,PAYEMENT,21887.0,M1094448975
28369,1196428',2018-11-07,FDRL/NATIONAL ELECTRONIC F,24090.0,0.0,,2018,11,7,PAYEMENT,24090.0,M717841651
28370,1196428',2018-11-07,FDRL/NATIONAL ELECTRONIC F,15333.0,0.0,,2018,11,7,CASH_OUT,15333.0,M1954167102
28371,1196428',2018-11-07,FDRL/NATIONAL ELECTRONIC F,21544.0,0.0,,2018,11,7,CASH_OUT,21544.0,M1043087369
28372,1196428',2018-11-07,FDRL/NATIONAL ELECTRONIC F,23335.0,0.0,,2018,11,7,DEBIT,23335.0,M1489610760
28373,1196428',2018-11-07,RTGS/SBINH18311011436/Indfor,0.0,5000000.0,,2018,11,7,TRANSFER,5000000.0,C1556875182
28374,1196428',2018-11-07,FDRL/NATIONAL ELECTRONIC F,14211535.27,0.0,,2018,11,7,DEBIT,14211535.27,M1109811596
28375,1196428',2018-11-08,TRF FROM  Indiaforensic SERVICES,0.0,5000000.0,,2018,11,8,TRANSFER,5000000.0,C101571284
28376,1196428',2018-11-08,TRF FROM  Indiaforensic SERVICES,0.0,3000000.0,,2018,11,8,TRANSFER,3000000.0,M178952563
28377,1196428',2018-11-08,TRF FROM  Indiaforensic SERVICES,0.0,1000000.0,,2018,11,8,CHECK_CASHING,1000000.0,M2081263541
28378,1196428',2018-11-08,NEFT/P18110806318937/S B,0.0,199500.0,,2018,11,8,TRANSFER,199500.0,C2078250226
28379,1196428',2018-11-08,FDRL/REAL TIME GROSS SETTL,2000000.0,0.0,,2018,11,8,CHECK_WITHDRAWAL,2000000.0,C1570256460
28380,1196428',2018-11-08,FDRL/REAL TIME GROSS SETTL,5000000.0,0.0,,2018,11,8,PAYEMENT,5000000.0,M441055416
28381,1196428',2018-11-08,FDRL/REAL TIME GROSS SETTL,2000000.0,0.0,,2018,11,8,PAYEMENT,2000000.0,C2077098348
28382,1196428',2018-11-08,FDRL/INTERNAL FUND TRANSFE,500000.0,0.0,,2018,11,8,DEBIT,500000.0,C1062254208
28383,1196428',2018-11-08,TRF FROM  Indiaforensic SERVICES,0.0,2800000.0,,2018,11,8,CASH_IN,2800000.0,C1787868648
28384,1196428',2018-11-08,FDRL/REAL TIME GROSS SETTL,3000000.0,0.0,,2018,11,8,PAYEMENT,3000000.0,C161140376
28385,1196428',2018-11-08,NEFT/N312180676099962/BAT,0.0,500000.0,,2018,11,8,TRANSFER,500000.0,M1471351873
28386,1196428',2018-11-08,TRF FROM  Indiaforensic SERVICES,0.0,3000000.0,,2018,11,8,CHECK_CASHING,3000000.0,M1328437771
28387,1196428',2018-11-09,NEFT/PUNBH18313826997/BAL,0.0,110000.0,,2018,11,9,CASH_IN,110000.0,M341537411
28388,1196428',2018-11-09,RTGS/HDFCH18313641866/JUN,0.0,200000.0,,2018,11,9,TRANSFER,200000.0,M1367049026
28389,1196428',2018-11-09,CHQ DEP/45538/OWDEL1/SBIN,0.0,11800.0,,2018,11,9,TRANSFER,11800.0,C2029310301
28390,1196428',2018-11-09,CHQ DEP/191238/OWDEL1/SBI,0.0,11800.0,,2018,11,9,TRANSFER,11800.0,C1606699851
28391,1196428',2018-11-09,CHQ DEP/60/OWDEL1/PSIB/IB,0.0,11800.0,,2018,11,9,TRANSFER,11800.0,C1103621993
28392,1196428',2018-11-09,CHQ DEP/736421/OWDEL1/PUN,0.0,11800.0,,2018,11,9,CHECK_CASHING,11800.0,M34447014
28393,1196428',2018-11-09,CHQ DEP/368399/OWDEL1/PSI,0.0,11800.0,,2018,11,9,CASH_IN,11800.0,C1428675504
28394,1196428',2018-11-09,CHQ DEP/320431/OWDEL1/SBI,0.0,11800.0,,2018,11,9,TRANSFER,11800.0,M1783999682
28395,1196428',2018-11-09,CHQ DEP/297462/OWDEL1/SBI,0.0,11800.0,,2018,11,9,CHECK_CASHING,11800.0,C1247600089
28396,1196428',2018-11-09,CASHDEP/GHATKOPAR/,0.0,10561.0,,2018,11,9,TRANSFER,10561.0,M835388411
28397,1196428',2018-11-09,FDRL/REAL TIME GROSS SETTL,2000000.0,0.0,,2018,11,9,CHECK_WITHDRAWAL,2000000.0,C404279307
28398,1196428',2018-11-09,FDRL/REAL TIME GROSS SETTL,2000000.0,0.0,,2018,11,9,CASH_OUT,2000000.0,C278407008
28399,1196428',2018-11-09,TRF FROM  Indiaforensic SERVICES,0.0,3000000.0,,2018,11,9,CHECK_CASHING,3000000.0,M1721234210
28400,1196428',2018-11-09,TRF FROM  Indiaforensic SERVICES,0.0,3000000.0,,2018,11,9,CASH_IN,3000000.0,M1576908104
28401,1196428',2018-11-09,RTGS/PUNBH18313324679/MAN,0.0,300000.0,,2018,11,9,CHECK_CASHING,300000.0,M1547162536
28402,1196428',2018-11-09,FDRL/REAL TIME GROSS SETTL,5000000.0,0.0,,2018,11,9,PAYEMENT,5000000.0,M1057827479
28403,1196428',2018-11-09,FDRL/REAL TIME GROSS SETTL,1000000.0,0.0,,2018,11,9,CHECK_WITHDRAWAL,1000000.0,M1498878973
28404,1196428',2018-11-09,"Indiaforensic USA, INC./USD/1393",0.0,10125882.69,,2018,11,9,CASH_IN,10125882.69,M1420281457
28405,1196428',2018-11-09,IRTT00701832132,2927.66,0.0,,2018,11,9,DEBIT,2927.66,M2000558609
28406,1196428',2018-11-09,"Indiaforensic USA, INC./USD/1731",0.0,12542274.96,,2018,11,9,CASH_IN,12542274.96,M1598229594
28407,1196428',2018-11-09,IRTT00701832161,3362.61,0.0,,2018,11,9,CHECK_WITHDRAWAL,3362.61,M2001514483
28408,1196428',2018-11-09,IMLCU0070181423:Letter of,2598.83,0.0,,2018,11,9,DEBIT,2598.83,M1808413339
28409,1196428',2018-11-09,IMLCU0070181423:Letter of,1647.79,0.0,,2018,11,9,CASH_OUT,1647.79,M662376084
28410,1196428',2018-11-09,FDRL/NATIONAL ELECTRONIC F,9813009.37,0.0,,2018,11,9,CASH_OUT,9813009.37,M1462583713
28411,1196428',2018-11-09,FDRL/NATIONAL ELECTRONIC F,9813009.37,0.0,,2018,11,9,CHECK_WITHDRAWAL,9813009.37,M1292178703
28412,1196428',2018-11-09,IRTT00701832164,710.24,0.0,,2018,11,9,DEBIT,710.24,M1378894443
28413,1196428',2018-11-09,"Indiaforensic USA, INC./USD/4990",0.0,361375.8,,2018,11,9,CASH_IN,361375.8,M671194471
28414,1196428',2018-11-09,CHQ DEPOSIT RETURN/45538/,11800.0,0.0,,2018,11,9,PAYEMENT,11800.0,M2120887477
28415,1196428',2018-11-09,CHQ DEPOSIT RETURN/320431,11800.0,0.0,,2018,11,9,DEBIT,11800.0,M1565473666
28416,1196428',2018-11-09,TRF FROM  Indiaforensic SERVICES,0.0,3000000.0,,2018,11,9,CHECK_CASHING,3000000.0,M336600403
28417,1196428',2018-11-09,TRF FROM  Indiaforensic SERVICES,0.0,10000000.0,,2018,11,9,CASH_IN,10000000.0,M1108314788
28418,1196428',2018-11-09,FDRL/NATIONAL ELECTRONIC F,13700000.0,0.0,,2018,11,9,PAYEMENT,13700000.0,M1776708407
28419,1196428',2018-11-09,RTGS/SBINH18313049743/Indfor,0.0,11000000.0,,2018,11,9,TRANSFER,11000000.0,M1886072816
28420,1196428',2018-11-09,FDRL/NATIONAL ELECTRONIC F,10180768.56,0.0,,2018,11,9,CHECK_WITHDRAWAL,10180768.56,M392269298
28421,1196428',2018-11-09,PBGI01001800327:Bank Guar,3540.0,0.0,,2018,11,9,CASH_OUT,3540.0,M240263357
28422,1196428',2018-11-09,FDRL/INTERNAL FUND TRANSFE,1000000.0,0.0,,2018,11,9,PAYEMENT,1000000.0,M2137827177
28423,1196428',2018-11-09,PBGI01001800328:Bank Guar,3540.0,0.0,,2018,11,9,CHECK_WITHDRAWAL,3540.0,M996688653
28424,1196428',2018-11-09,NEFT/N313180676839379/BAT,0.0,420000.0,,2018,11,9,CASH_IN,420000.0,C1829831147
28425,1196428',2018-11-09,NEFT/N313180676873948/TEC,0.0,200000.0,,2018,11,9,CASH_IN,200000.0,M720435458
28426,1196428',2018-11-09,TRF FROM Indiaforensic SERVICES,0.0,15000000.0,,2018,11,9,CHECK_CASHING,15000000.0,M29096009
28427,1196428',2018-11-09,TRF FROM Indiaforensic SERVICES,0.0,5000000.0,,2018,11,9,CHECK_CASHING,5000000.0,M150995440
28428,1196428',2018-11-09,TRF FROM Indiaforensic SERVICES,0.0,1000000.0,,2018,11,9,CASH_IN,1000000.0,M1241251535
28429,1196428',2018-11-09,FDRL/INTERNAL FUND TRANSFE,500000.0,0.0,,2018,11,9,CHECK_WITHDRAWAL,500000.0,M1254542588
28430,1196428',2018-11-09,FDRL/NATIONAL ELECTRONIC F,10280532.97,0.0,,2018,11,9,CHECK_WITHDRAWAL,10280532.97,M710538853
28431,1196428',2018-11-09,FDRL/NATIONAL ELECTRONIC F,8100000.0,0.0,,2018,11,9,CASH_OUT,8100000.0,M399672840
28432,1196428',2018-11-09,TRF FROM  Indiaforensic SERVICES,0.0,2000000.0,,2018,11,9,CASH_IN,2000000.0,M1566931514
28433,1196428',2018-11-09,TRF FROM  Indiaforensic SERVICES,0.0,500000.0,,2018,11,9,CASH_IN,500000.0,C1540270363
28434,1196428',2018-11-09,NEFT/AT0911MOBILE3033/FIX,0.0,1500000.0,,2018,11,9,TRANSFER,1500000.0,C900425684
28435,1196428',2018-11-09,BEAT CSH PKP DEL GURGA 77,0.0,125000.0,,2018,11,9,CASH_IN,125000.0,M1361294362
28436,1196428',2018-11-09,STAMP PAPER PURCHASING,200.0,0.0,,2018,11,9,CASH_OUT,200.0,C264843581
28437,1196428',2018-11-09,CHQ DEPOSIT RETURN/45538/,100.0,0.0,,2018,11,9,CHECK_WITHDRAWAL,100.0,M1897445965
28438,1196428',2018-11-09,CHQ DEPOSIT RETURN/45538/,18.0,0.0,,2018,11,9,PAYEMENT,18.0,M345439288
28439,1196428',2018-11-09,CHQ DEPOSIT RETURN/320431,100.0,0.0,,2018,11,9,CASH_OUT,100.0,M2130477201
28440,1196428',2018-11-09,CHQ DEPOSIT RETURN/320431,18.0,0.0,,2018,11,9,DEBIT,18.0,M1516263359
28441,1196428',2018-11-12,NEFT/P18111208023867/S B,0.0,199500.0,,2018,11,12,CHECK_CASHING,199500.0,M508839235
28442,1196428',2018-11-12,RTGS/PUNBH18316331389/MAN,0.0,300000.0,,2018,11,12,CASH_IN,300000.0,M530611995
28443,1196428',2018-11-12,FDRL/INTERNAL FUND TRANSFE,200000.0,0.0,,2018,11,12,PAYEMENT,200000.0,C1761324386
28444,1196428',2018-11-12,FDRL/INTERNAL FUND TRANSFE,200000.0,0.0,,2018,11,12,CHECK_WITHDRAWAL,200000.0,C90486891
28445,1196428',2018-11-12,RTGS/HDFCH18316745477/BAT,0.0,300000.0,,2018,11,12,CHECK_CASHING,300000.0,C573200870
28446,1196428',2018-11-12,RTGS/PUNBH18316333504/BAL,0.0,200000.0,,2018,11,12,CHECK_CASHING,200000.0,C1825992554
28447,1196428',2018-11-12,CASHDEP/BOISAR/,0.0,5000.0,,2018,11,12,CASH_IN,5000.0,M1278682262
28448,1196428',2018-11-12,IRTT00701832409,1501.32,0.0,,2018,11,12,CHECK_WITHDRAWAL,1501.32,M2009652577
28449,1196428',2018-11-12,"Indiaforensic USA, INC./USD/3031",0.0,2201791.04,,2018,11,12,CASH_IN,2201791.04,M1504904868
28450,1196428',2018-11-12,NEFT/000055363865/Indiaforensic,0.0,1300000.0,,2018,11,12,TRANSFER,1300000.0,C88226327
28451,1196428',2018-11-12,NEFT/000055363086/Indiaforensic,0.0,5800000.0,,2018,11,12,TRANSFER,5800000.0,M203497386
28452,1196428',2018-11-12,TRF FROM  Indiaforensic SERVICES,0.0,4000000.0,,2018,11,12,CHECK_CASHING,4000000.0,M1264078907
28453,1196428',2018-11-12,TRF FROM  Indiaforensic SERVICES,0.0,2000000.0,,2018,11,12,TRANSFER,2000000.0,M1870838648
28454,1196428',2018-11-12,FDRL/NATIONAL ELECTRONIC F,197477.0,0.0,,2018,11,12,DEBIT,197477.0,C1683963531
28455,1196428',2018-11-12,FDRL/NATIONAL ELECTRONIC F,13172.0,0.0,,2018,11,12,CASH_OUT,13172.0,M620120832
28456,1196428',2018-11-12,Indiaforensic SERVICES INDIA PVT,0.0,605659.0,,2018,11,12,TRANSFER,605659.0,M37714710
28457,1196428',2018-11-12,FDRL/NATIONAL ELECTRONIC F,5000000.0,0.0,,2018,11,12,DEBIT,5000000.0,M1135370372
28458,1196428',2018-11-12,FDRL/NATIONAL ELECTRONIC F,5000000.0,0.0,,2018,11,12,CHECK_WITHDRAWAL,5000000.0,C1700355047
28459,1196428',2018-11-12,FDRL/NATIONAL ELECTRONIC F,5000000.0,0.0,,2018,11,12,DEBIT,5000000.0,C1884600481
28460,1196428',2018-11-12,FDRL/NATIONAL ELECTRONIC F,5000000.0,0.0,,2018,11,12,PAYEMENT,5000000.0,C1105527690
28461,1196428',2018-11-12,TRF FROM  Indiaforensic SERVICES,0.0,2500000.0,,2018,11,12,CASH_IN,2500000.0,M714819629
28462,1196428',2018-11-12,TRF FROM  Indiaforensic SERVICES,0.0,15000000.0,,2018,11,12,CHECK_CASHING,15000000.0,M722465639
28463,1196428',2018-11-12,TRF FROM  Indiaforensic SERVICES,0.0,15000000.0,,2018,11,12,TRANSFER,15000000.0,C801412408
28464,1196428',2018-11-12,TRF FROM  Indiaforensic SERVICES,0.0,10000000.0,,2018,11,12,CHECK_CASHING,10000000.0,M1678349105
28465,1196428',2018-11-12,IMPS 831618510873 FROM MR,0.0,8200.0,,2018,11,12,CASH_IN,8200.0,C35534346
28466,1196428',2018-11-12,FDRL/INTERNAL FUND TRANSFE,200000.0,0.0,,2018,11,12,PAYEMENT,200000.0,C943166837
28467,1196428',2018-11-12,FDRL/INTERNAL FUND TRANSFE,1000000.0,0.0,,2018,11,12,CASH_OUT,1000000.0,M1063088470
28468,1196428',2018-11-12,NEFT CHARGES AND GST/0000,29.5,0.0,,2018,11,12,CASH_OUT,29.5,M634480856
28469,1196428',2018-11-12,NEFT/000056409039/INDIAN,8100000.0,0.0,,2018,11,12,CHECK_WITHDRAWAL,8100000.0,M1229660324
28470,1196428',2018-11-12,NEFT CHARGES AND GST/0000,29.5,0.0,,2018,11,12,PAYEMENT,29.5,M1995775202
28471,1196428',2018-11-12,NEFT/000056410442/INDIAN,13665417.0,0.0,,2018,11,12,CHECK_WITHDRAWAL,13665417.0,M982735022
28472,1196428',2018-11-12,NEFT CHARGES AND GST/0000,29.5,0.0,,2018,11,12,CHECK_WITHDRAWAL,29.5,C1754722089
28473,1196428',2018-11-12,NEFT/000056410931/INDIAN,8100000.0,0.0,,2018,11,12,PAYEMENT,8100000.0,M536571624
28474,1196428',2018-11-12,IMPS 831618538917 FROM SA,0.0,200000.0,,2018,11,12,TRANSFER,200000.0,C1498878963
28475,1196428',2018-11-12,NEFT CHARGES AND GST/0000,29.5,0.0,,2018,11,12,PAYEMENT,29.5,C1962165946
28476,1196428',2018-11-12,NEFT/000056411119/INDIAN,14023377.0,0.0,,2018,11,12,CHECK_WITHDRAWAL,14023377.0,M1170462195
28477,1196428',2018-11-12,FDRL/INTERNAL FUND TRANSFE,3000000.0,0.0,,2018,11,12,DEBIT,3000000.0,C414205222
28478,1196428',2018-11-12,TRF FROM  Indiaforensic SERVICES,0.0,5000000.0,,2018,11,12,CASH_IN,5000000.0,M1229413386
28479,1196428',2018-11-12,TRF FROM  Indiaforensic SERVICES,0.0,2000000.0,,2018,11,12,CHECK_CASHING,2000000.0,M712447692
28480,1196428',2018-11-12,TRF FROM  Indiaforensic SERVICES,0.0,4000000.0,,2018,11,12,TRANSFER,4000000.0,C269902384
28481,1196428',2018-11-12,FDRL/INTERNAL FUND TRANSFE,3000000.0,0.0,,2018,11,12,PAYEMENT,3000000.0,C955097010
28482,1196428',2018-11-12,TRF TO  Indiaforensic SERVICES I,800000.0,0.0,,2018,11,12,DEBIT,800000.0,C1827996167
28483,1196428',2018-11-12,BEAT CSH PKP DEL GURGA 77,0.0,278700.0,,2018,11,12,TRANSFER,278700.0,M30162194
28484,1196428',2018-11-13,RTGS/HDFCH18317984273/BAT,0.0,500000.0,,2018,11,13,TRANSFER,500000.0,C1115240385
28485,1196428',2018-11-13,RTGS/PUNBH18317358907/MAN,0.0,200000.0,,2018,11,13,TRANSFER,200000.0,M1710595137
28486,1196428',2018-11-13,FDRL/REAL TIME GROSS SETTL,5000000.0,0.0,,2018,11,13,CHECK_WITHDRAWAL,5000000.0,M970087106
28487,1196428',2018-11-13,FDRL/REAL TIME GROSS SETTL,3000000.0,0.0,,2018,11,13,CHECK_WITHDRAWAL,3000000.0,M561635968
28488,1196428',2018-11-13,TRF FROM  Indiaforensic SERVICES,0.0,3000000.0,,2018,11,13,CASH_IN,3000000.0,C440480434
28489,1196428',2018-11-13,IMPS 831715460571 FROM SA,0.0,50000.0,,2018,11,13,TRANSFER,50000.0,C46748390
28490,1196428',2018-11-13,Indiaforensic SERVICES INDIA PVT,0.0,68059.0,,2018,11,13,CASH_IN,68059.0,M976616410
28491,1196428',2018-11-13,TRF FROM  Indiaforensic SERVICES,0.0,10600000.0,,2018,11,13,TRANSFER,10600000.0,M1796408655
28492,1196428',2018-11-13,TRF FROM  Indiaforensic SERVICES,0.0,1500000.0,,2018,11,13,CHECK_CASHING,1500000.0,M424513770
28493,1196428',2018-11-13,TRF FROM  Indiaforensic SERVICES,0.0,5300000.0,,2018,11,13,CASH_IN,5300000.0,M1867357103
28494,1196428',2018-11-13,FDRL/NATIONAL ELECTRONIC F,13395131.75,0.0,,2018,11,13,DEBIT,13395131.75,M215680372
28495,1196428',2018-11-13,IMPS 831717943192 FROM OX,0.0,200000.0,,2018,11,13,TRANSFER,200000.0,M764256713
28496,1196428',2018-11-13,IMPS 831717943239 FROM OX,0.0,200000.0,,2018,11,13,TRANSFER,200000.0,M538413261
28497,1196428',2018-11-13,IMPS 831717943283 FROM OX,0.0,200000.0,,2018,11,13,TRANSFER,200000.0,M942160595
28498,1196428',2018-11-13,IMPS 831717943309 FROM OX,0.0,200000.0,,2018,11,13,CHECK_CASHING,200000.0,M1319156415
28499,1196428',2018-11-13,IMPS 831717943351 FROM OX,0.0,200000.0,,2018,11,13,TRANSFER,200000.0,M361847129
28500,1196428',2018-11-13,IMPS 831718943673 FROM OX,0.0,200000.0,,2018,11,13,CHECK_CASHING,200000.0,C1790202239
28501,1196428',2018-11-13,IMPS 831718943711 FROM OX,0.0,200000.0,,2018,11,13,TRANSFER,200000.0,M955868325
28502,1196428',2018-11-13,IMPS 831718943768 FROM OX,0.0,200000.0,,2018,11,13,CHECK_CASHING,200000.0,M1251133153
28503,1196428',2018-11-13,IMPS 831718943802 FROM OX,0.0,200000.0,,2018,11,13,CASH_IN,200000.0,M1854311181
28504,1196428',2018-11-13,IMPS 831718943842 FROM OX,0.0,200000.0,,2018,11,13,TRANSFER,200000.0,C928023753
28505,1196428',2018-11-13,IMPS 831718943902 FROM OX,0.0,200000.0,,2018,11,13,CASH_IN,200000.0,M771609335
28506,1196428',2018-11-13,IMPS 831718943951 FROM OX,0.0,200000.0,,2018,11,13,CASH_IN,200000.0,C1452722471
28507,1196428',2018-11-13,IMPS 831718944006 FROM OX,0.0,200000.0,,2018,11,13,CHECK_CASHING,200000.0,M1625968481
28508,1196428',2018-11-13,IMPS 831718944038 FROM OX,0.0,200000.0,,2018,11,13,CASH_IN,200000.0,M458727925
28509,1196428',2018-11-13,IMPS 831718944069 FROM OX,0.0,200000.0,,2018,11,13,TRANSFER,200000.0,C111210112
28510,1196428',2018-11-13,IMPS 831718944694 FROM OX,0.0,200000.0,,2018,11,13,TRANSFER,200000.0,C464246030
28511,1196428',2018-11-13,IMPS 831718944728 FROM OX,0.0,200000.0,,2018,11,13,CHECK_CASHING,200000.0,M2080752777
28512,1196428',2018-11-13,IMPS 831718944768 FROM OX,0.0,200000.0,,2018,11,13,TRANSFER,200000.0,M1357563045
28513,1196428',2018-11-13,IMPS 831718944803 FROM OX,0.0,200000.0,,2018,11,13,CASH_IN,200000.0,M68500741
28514,1196428',2018-11-13,IMPS 831718944838 FROM OX,0.0,200000.0,,2018,11,13,CHECK_CASHING,200000.0,C1664330755
28515,1196428',2018-11-13,NEFT CHARGES AND GST/0000,29.5,0.0,,2018,11,13,PAYEMENT,29.5,C1823014131
28516,1196428',2018-11-13,NEFT/000056518481/INDIAN,8100000.0,0.0,,2018,11,13,DEBIT,8100000.0,M1293355387
28517,1196428',2018-11-13,FDRL/INTERNAL FUND TRANSFE,200000.0,0.0,,2018,11,13,CASH_OUT,200000.0,M34599177
28518,1196428',2018-11-13,FDRL/INTERNAL FUND TRANSFE,300000.0,0.0,,2018,11,13,CASH_OUT,300000.0,M685059787
28519,1196428',2018-11-13,TRF FROM  Indiaforensic SERVICES,0.0,1000000.0,,2018,11,13,CASH_IN,1000000.0,M376456946
28520,1196428',2018-11-13,BEAT CSH PKP DEL GURGA 77,0.0,89000.0,,2018,11,13,CHECK_CASHING,89000.0,M793798217
28521,1196428',2018-11-14,FDRL/INTERNAL FUND TRANSFE,300000.0,0.0,,2018,11,14,CASH_OUT,300000.0,C264685626
28522,1196428',2018-11-14,FDRL/INTERNAL FUND TRANSFE,200000.0,0.0,,2018,11,14,DEBIT,200000.0,M954243999
28523,1196428',2018-11-14,NEFT/N318180679375112/TEC,0.0,300000.0,,2018,11,14,TRANSFER,300000.0,C1816986148
28524,1196428',2018-11-14,RTGS/ICICH18318474912/Indfor,0.0,1900000.0,,2018,11,14,CASH_IN,1900000.0,C1144527317
28525,1196428',2018-11-14,NEFT/P18111411314067/S B,0.0,199500.0,,2018,11,14,CHECK_CASHING,199500.0,C1790831319
28526,1196428',2018-11-14,TRF FROM  Indiaforensic SERVICES,0.0,2600000.0,,2018,11,14,CASH_IN,2600000.0,C571435580
28527,1196428',2018-11-14,FDRL/REAL TIME GROSS SETTL,5000000.0,0.0,,2018,11,14,DEBIT,5000000.0,C1262016786
28528,1196428',2018-11-14,RTGS/HDFCH18318253189/JUN,0.0,260000.0,,2018,11,14,CHECK_CASHING,260000.0,C1287328228
28529,1196428',2018-11-14,TRF FROM  Indiaforensic SERVICES,0.0,8700000.0,,2018,11,14,CHECK_CASHING,8700000.0,C329473339
28530,1196428',2018-11-14,FDRL/NATIONAL ELECTRONIC F,7771747.38,0.0,,2018,11,14,CHECK_WITHDRAWAL,7771747.38,C1354725727
28531,1196428',2018-11-14,RTGS/ICICH18318551563/Indfor,0.0,1000000.0,,2018,11,14,CHECK_CASHING,1000000.0,C1300519073
28532,1196428',2018-11-14,RTGS/ICICH18318552117/Indfor,0.0,500000.0,,2018,11,14,CHECK_CASHING,500000.0,C2052185144
28533,1196428',2018-11-14,"Indiaforensic USA, INC./USD/1594",0.0,11464119.92,,2018,11,14,CASH_IN,11464119.92,C1485516154
28534,1196428',2018-11-14,IRTT00701832724,3168.54,0.0,,2018,11,14,CHECK_WITHDRAWAL,3168.54,C2143477943
28535,1196428',2018-11-14,Indiaforensic SERVICES INDIA PVT,0.0,37591.0,,2018,11,14,CHECK_CASHING,37591.0,C476402209
28536,1196428',2018-11-14,IRTT00701832721,1990.78,0.0,,2018,11,14,DEBIT,1990.78,C1255024717
28537,1196428',2018-11-14,"Indiaforensic USA, INC./USD/6842",0.0,4921005.17,,2018,11,14,TRANSFER,4921005.17,C1870367457
28538,1196428',2018-11-14,FDRL/INTERNAL FUND TRANSFE,50000.0,0.0,,2018,11,14,CHECK_WITHDRAWAL,50000.0,C465257140
28539,1196428',2018-11-14,FDRL/INTERNAL FUND TRANSFE,50000.0,0.0,,2018,11,14,CHECK_WITHDRAWAL,50000.0,C745740822
28540,1196428',2018-11-14,FDRL/INTERNAL FUND TRANSFE,50000.0,0.0,,2018,11,14,CHECK_WITHDRAWAL,50000.0,C1390121014
28541,1196428',2018-11-14,FDRL/INTERNAL FUND TRANSFE,50000.0,0.0,,2018,11,14,CASH_OUT,50000.0,C1481851679
28542,1196428',2018-11-14,FDRL/INTERNAL FUND TRANSFE,50000.0,0.0,,2018,11,14,PAYEMENT,50000.0,C741431520
28543,1196428',2018-11-14,FDRL/INTERNAL FUND TRANSFE,50000.0,0.0,,2018,11,14,CHECK_WITHDRAWAL,50000.0,C758888772
28544,1196428',2018-11-14,TRF FROM  Indiaforensic SERVICES,0.0,4100000.0,,2018,11,14,CASH_IN,4100000.0,C1001409363
28545,1196428',2018-11-14,FDRL/NATIONAL ELECTRONIC F,12756370.01,0.0,,2018,11,14,PAYEMENT,12756370.01,M1340854901
28546,1196428',2018-11-14,FDRL/INTERNAL FUND TRANSFE,1000000.0,0.0,,2018,11,14,PAYEMENT,1000000.0,M265997755
28547,1196428',2018-11-14,FDRL/INTERNAL FUND TRANSFE,3000000.0,0.0,,2018,11,14,PAYEMENT,3000000.0,M1257695233
28548,1196428',2018-11-14,FDRL/INTERNAL FUND TRANSFE,3000000.0,0.0,,2018,11,14,PAYEMENT,3000000.0,C150309335
28549,1196428',2018-11-14,TRF FROM  Indiaforensic SERVICES,0.0,500000.0,,2018,11,14,CASH_IN,500000.0,M1572611628
28550,1196428',2018-11-14,TRF FROM  Indiaforensic SERVICES,0.0,400000.0,,2018,11,14,CHECK_CASHING,400000.0,M280183141
28551,1196428',2018-11-14,BEAT CSH PKP DEL GURGA 77,0.0,135000.0,,2018,11,14,CASH_IN,135000.0,M808540700
28552,1196428',2018-11-14,IMPS 831822183517 FROM GA,0.0,199999.0,,2018,11,14,CHECK_CASHING,199999.0,M565481399
28553,1196428',2018-11-14,IMPS 831822182448 FROM GA,0.0,200000.0,,2018,11,14,CHECK_CASHING,200000.0,C842729010
28554,1196428',2018-11-14,IMPS 831822183526 FROM GA,0.0,199998.0,,2018,11,14,TRANSFER,199998.0,M178371442
28555,1196428',2018-11-14,IMPS 831822183644 FROM GA,0.0,200000.0,,2018,11,14,TRANSFER,200000.0,M2076445832
28556,1196428',2018-11-14,IMPS 831822183649 FROM GA,0.0,199999.0,,2018,11,14,CHECK_CASHING,199999.0,C599968109
28557,1196428',2018-11-14,IMPS 831822183652 FROM GA,0.0,200000.0,,2018,11,14,CASH_IN,200000.0,C599265282
28558,1196428',2018-11-14,IMPS 831822184663 FROM GA,0.0,199998.0,,2018,11,14,CHECK_CASHING,199998.0,C669771073
28559,1196428',2018-11-14,IMPS 831822184716 FROM GA,0.0,200000.0,,2018,11,14,CASH_IN,200000.0,C2137848242
28560,1196428',2018-11-14,IMPS 831822183766 FROM GA,0.0,199999.0,,2018,11,14,TRANSFER,199999.0,M997986347
28561,1196428',2018-11-14,IMPS 831822183778 FROM GA,0.0,200000.0,,2018,11,14,TRANSFER,200000.0,M1063792159
28562,1196428',2018-11-14,IMPS 831822184782 FROM GA,0.0,199997.0,,2018,11,14,TRANSFER,199997.0,C22448303
28563,1196428',2018-11-14,IMPS 831822183890 FROM GA,0.0,200000.0,,2018,11,14,CASH_IN,200000.0,M315692635
28564,1196428',2018-11-14,IMPS 831822183894 FROM GA,0.0,200000.0,,2018,11,14,CHECK_CASHING,200000.0,M803644277
28565,1196428',2018-11-14,IMPS 831822184833 FROM GA,0.0,199999.0,,2018,11,14,CASH_IN,199999.0,M415913007
28566,1196428',2018-11-14,IMPS 831822183928 FROM GA,0.0,199997.0,,2018,11,14,TRANSFER,199997.0,M1344197461
28567,1196428',2018-11-14,IMPS 831822183990 FROM GA,0.0,200000.0,,2018,11,14,CASH_IN,200000.0,M132014623
28568,1196428',2018-11-14,IMPS 831822184972 FROM GA,0.0,199999.0,,2018,11,14,CHECK_CASHING,199999.0,M577051450
28569,1196428',2018-11-14,IMPS 831822184035 FROM GA,0.0,199997.0,,2018,11,14,CASH_IN,199997.0,C1491676195
28570,1196428',2018-11-14,IMPS 831822184955 FROM GA,0.0,200000.0,,2018,11,14,CHECK_CASHING,200000.0,C943166837
28571,1196428',2018-11-14,IMPS 831822185047 FROM GA,0.0,200000.0,,2018,11,14,CASH_IN,200000.0,M1402953791
28572,1196428',2018-11-14,IMPS 831822185055 FROM GA,0.0,199999.0,,2018,11,14,CHECK_CASHING,199999.0,M1974589236
28573,1196428',2018-11-14,IMPS 831822185096 FROM GA,0.0,199997.0,,2018,11,14,CHECK_CASHING,199997.0,C1701412896
28574,1196428',2018-11-14,IMPS 831822184148 FROM GA,0.0,200000.0,,2018,11,14,CASH_IN,200000.0,M1355606971
28575,1196428',2018-11-14,IMPS 831822184200 FROM GA,0.0,200000.0,,2018,11,14,TRANSFER,200000.0,M1037747072
28576,1196428',2018-11-14,IMPS 831822185197 FROM GA,0.0,199999.0,,2018,11,14,CHECK_CASHING,199999.0,M82220349
28577,1196428',2018-11-14,IMPS 831822185202 FROM GA,0.0,199997.0,,2018,11,14,CHECK_CASHING,199997.0,M953439482
28578,1196428',2018-11-14,IMPS 831822185221 FROM GA,0.0,200000.0,,2018,11,14,CHECK_CASHING,200000.0,C1914282536
28579,1196428',2018-11-14,IMPS 831822184329 FROM GA,0.0,200000.0,,2018,11,14,CASH_IN,200000.0,C691636444
28580,1196428',2018-11-14,IMPS 831822185293 FROM GA,0.0,199999.0,,2018,11,14,CASH_IN,199999.0,C683605346
28581,1196428',2018-11-14,IMPS 831822184399 FROM GA,0.0,199997.0,,2018,11,14,CASH_IN,199997.0,M1967366965
28582,1196428',2018-11-14,IMPS 831822185342 FROM GA,0.0,200000.0,,2018,11,14,TRANSFER,200000.0,M508405148
28583,1196428',2018-11-14,IMPS 831822185549 FROM GA,0.0,199997.0,,2018,11,14,CHECK_CASHING,199997.0,M1295579320
28584,1196428',2018-11-14,IMPS 831822185539 FROM GA,0.0,200000.0,,2018,11,14,CASH_IN,200000.0,M995168511
28585,1196428',2018-11-14,IMPS 831822185399 FROM GA,0.0,199999.0,,2018,11,14,CASH_IN,199999.0,M1102425439
28586,1196428',2018-11-14,IMPS 831822185641 FROM GA,0.0,200000.0,,2018,11,14,TRANSFER,200000.0,M590053012
28587,1196428',2018-11-14,IMPS 831822185504 FROM GA,0.0,199997.0,,2018,11,14,CHECK_CASHING,199997.0,M386886002
28588,1196428',2018-11-14,IMPS 831822185673 FROM GA,0.0,200000.0,,2018,11,14,CHECK_CASHING,200000.0,M227585143
28589,1196428',2018-11-14,IMPS 831822185691 FROM GA,0.0,199999.0,,2018,11,14,CHECK_CASHING,199999.0,M2105068287
28590,1196428',2018-11-14,IMPS 831822185761 FROM GA,0.0,200000.0,,2018,11,14,TRANSFER,200000.0,M1038116064
28591,1196428',2018-11-14,IMPS 831822186628 FROM GA,0.0,199997.0,,2018,11,14,CHECK_CASHING,199997.0,M345805867
28592,1196428',2018-11-14,IMPS 831822185801 FROM GA,0.0,199999.0,,2018,11,14,TRANSFER,199999.0,M1128144161
28593,1196428',2018-11-14,IMPS 831822186629 FROM GA,0.0,200000.0,,2018,11,14,TRANSFER,200000.0,M1492172037
28594,1196428',2018-11-14,IMPS 831822185871 FROM GA,0.0,200000.0,,2018,11,14,TRANSFER,200000.0,M731603444
28595,1196428',2018-11-14,IMPS 831822185950 FROM GA,0.0,199997.0,,2018,11,14,CHECK_CASHING,199997.0,M879683510
28596,1196428',2018-11-14,IMPS 831822186725 FROM GA,0.0,199998.0,,2018,11,14,CHECK_CASHING,199998.0,M555126583
28597,1196428',2018-11-14,IMPS 831822186741 FROM GA,0.0,200000.0,,2018,11,14,CHECK_CASHING,200000.0,M1344791022
28598,1196428',2018-11-14,IMPS 831822186092 FROM GA,0.0,199998.0,,2018,11,14,CASH_IN,199998.0,M40493588
28599,1196428',2018-11-14,IMPS 831822186114 FROM GA,0.0,200000.0,,2018,11,14,TRANSFER,200000.0,M1099885881
28600,1196428',2018-11-14,IMPS 831822186916 FROM GA,0.0,199998.0,,2018,11,14,CASH_IN,199998.0,M107256650
28601,1196428',2018-11-14,IMPS 831822186937 FROM GA,0.0,200000.0,,2018,11,14,TRANSFER,200000.0,M1410611700
28602,1196428',2018-11-14,IMPS 831822187011 FROM GA,0.0,199998.0,,2018,11,14,CHECK_CASHING,199998.0,M954062800
28603,1196428',2018-11-14,IMPS 831822186429 FROM GA,0.0,200000.0,,2018,11,14,TRANSFER,200000.0,M13013852
28604,1196428',2018-11-14,IMPS 831822187531 FROM GA,0.0,199998.0,,2018,11,14,CASH_IN,199998.0,M1101858256
28605,1196428',2018-11-14,IMPS 831822187145 FROM GA,0.0,200000.0,,2018,11,14,TRANSFER,200000.0,M1180862248
28606,1196428',2018-11-14,IMPS 831822187670 FROM GA,0.0,199998.0,,2018,11,14,CHECK_CASHING,199998.0,M966462848
28607,1196428',2018-11-14,IMPS 831822187238 FROM GA,0.0,200000.0,,2018,11,14,TRANSFER,200000.0,M1284324188
28608,1196428',2018-11-14,IMPS 831822187282 FROM GA,0.0,199998.0,,2018,11,14,CHECK_CASHING,199998.0,C374625527
28609,1196428',2018-11-14,IMPS 831822187337 FROM GA,0.0,200000.0,,2018,11,14,CASH_IN,200000.0,C1262822392
28610,1196428',2018-11-14,IMPS 831822187910 FROM GA,0.0,199998.0,,2018,11,14,CASH_IN,199998.0,C1671386208
28611,1196428',2018-11-14,IMPS 831822187965 FROM GA,0.0,200000.0,,2018,11,14,CHECK_CASHING,200000.0,C1869197498
28612,1196428',2018-11-14,IMPS 831822187466 FROM GA,0.0,199998.0,,2018,11,14,CASH_IN,199998.0,C271488817
28613,1196428',2018-11-14,IMPS 831822188061 FROM GA,0.0,200000.0,,2018,11,14,TRANSFER,200000.0,M1915909017
28614,1196428',2018-11-14,IMPS 831822188081 FROM GA,0.0,199998.0,,2018,11,14,CHECK_CASHING,199998.0,C2052185144
28615,1196428',2018-11-14,IMPS 831822188190 FROM GA,0.0,199998.0,,2018,11,14,CASH_IN,199998.0,C646059443
28616,1196428',2018-11-14,IMPS 831822188586 FROM GA,0.0,199999.0,,2018,11,14,CHECK_CASHING,199999.0,C1982591789
28617,1196428',2018-11-14,IMPS 831822188735 FROM GA,0.0,199999.0,,2018,11,14,TRANSFER,199999.0,C1977614404
28618,1196428',2018-11-14,IMPS 831822188452 FROM GA,0.0,199998.0,,2018,11,14,CASH_IN,199998.0,C1883840933
28619,1196428',2018-11-14,IMPS 831822188778 FROM GA,0.0,199999.0,,2018,11,14,TRANSFER,199999.0,C2007207148
28620,1196428',2018-11-14,IMPS 831822189693 FROM GA,0.0,199998.0,,2018,11,14,CASH_IN,199998.0,M1014644493
28621,1196428',2018-11-14,IMPS 831822189783 FROM GA,0.0,199999.0,,2018,11,14,CHECK_CASHING,199999.0,C381605910
28622,1196428',2018-11-14,IMPS 831822188887 FROM GA,0.0,199998.0,,2018,11,14,CHECK_CASHING,199998.0,M1056752544
28623,1196428',2018-11-14,IMPS 831822188947 FROM GA,0.0,199999.0,,2018,11,14,CHECK_CASHING,199999.0,M729567968
28624,1196428',2018-11-14,IMPS 831822188976 FROM GA,0.0,199998.0,,2018,11,14,CHECK_CASHING,199998.0,M1723507087
28625,1196428',2018-11-14,IMPS 831822190029 FROM GA,0.0,199999.0,,2018,11,14,CASH_IN,199999.0,C849038219
28626,1196428',2018-11-14,IMPS 831822190101 FROM GA,0.0,199998.0,,2018,11,14,CHECK_CASHING,199998.0,C1038678108
28627,1196428',2018-11-14,IMPS 831822189108 FROM GA,0.0,199999.0,,2018,11,14,CASH_IN,199999.0,M1976340229
28628,1196428',2018-11-14,IMPS 831822189125 FROM GA,0.0,199998.0,,2018,11,14,TRANSFER,199998.0,M693274483
28629,1196428',2018-11-14,IMPS 831822189168 FROM GA,0.0,199999.0,,2018,11,14,CASH_IN,199999.0,M838050003
28630,1196428',2018-11-14,IMPS 831822189182 FROM GA,0.0,199998.0,,2018,11,14,CASH_IN,199998.0,C1009972184
28631,1196428',2018-11-14,IMPS 831822189236 FROM GA,0.0,199999.0,,2018,11,14,CASH_IN,199999.0,C63475121
28632,1196428',2018-11-14,IMPS 831822190618 FROM GA,0.0,199999.0,,2018,11,14,CASH_IN,199999.0,C1130075212
28633,1196428',2018-11-14,IMPS 831822189361 FROM GA,0.0,199998.0,,2018,11,14,TRANSFER,199998.0,C851316413
28634,1196428',2018-11-14,IMPS 831822190747 FROM GA,0.0,199998.0,,2018,11,14,CHECK_CASHING,199998.0,M718843573
28635,1196428',2018-11-14,IMPS 831822189478 FROM GA,0.0,199999.0,,2018,11,14,TRANSFER,199999.0,M1217713614
28636,1196428',2018-11-14,IMPS 831822191599 FROM GA,0.0,199998.0,,2018,11,14,CASH_IN,199998.0,M706338650
28637,1196428',2018-11-14,IMPS 831822191607 FROM GA,0.0,199999.0,,2018,11,14,CASH_IN,199999.0,M995800830
28638,1196428',2018-11-14,IMPS 831822191062 FROM GA,0.0,199998.0,,2018,11,14,CASH_IN,199998.0,C1073259437
28639,1196428',2018-11-14,IMPS 831822191746 FROM GA,0.0,199999.0,,2018,11,14,CHECK_CASHING,199999.0,M1699315785
28640,1196428',2018-11-14,IMPS 831822191854 FROM GA,0.0,199998.0,,2018,11,14,CHECK_CASHING,199998.0,M1163711030
28641,1196428',2018-11-14,IMPS 831822191186 FROM GA,0.0,199999.0,,2018,11,14,CHECK_CASHING,199999.0,C320106510
28642,1196428',2018-11-14,IMPS 831822191299 FROM GA,0.0,199998.0,,2018,11,14,TRANSFER,199998.0,M597251930
28643,1196428',2018-11-14,IMPS 831822191946 FROM GA,0.0,199999.0,,2018,11,14,CASH_IN,199999.0,M1515100477
28644,1196428',2018-11-14,IMPS 831822192014 FROM GA,0.0,199998.0,,2018,11,14,TRANSFER,199998.0,M1412315921
28645,1196428',2018-11-14,IMPS 831822192531 FROM GA,0.0,199999.0,,2018,11,14,TRANSFER,199999.0,M1168923345
28646,1196428',2018-11-14,IMPS 831822192097 FROM GA,0.0,199998.0,,2018,11,14,CHECK_CASHING,199998.0,M2042700604
28647,1196428',2018-11-14,IMPS 831822192715 FROM GA,0.0,199999.0,,2018,11,14,CHECK_CASHING,199999.0,C710481910
28648,1196428',2018-11-14,IMPS 831822192726 FROM GA,0.0,199998.0,,2018,11,14,CASH_IN,199998.0,M1474634841
28649,1196428',2018-11-14,IMPS 831822192825 FROM GA,0.0,199999.0,,2018,11,14,CASH_IN,199999.0,C669419693
28650,1196428',2018-11-14,IMPS 831822192241 FROM GA,0.0,199998.0,,2018,11,14,CASH_IN,199998.0,C2095611317
28651,1196428',2018-11-14,IMPS 831822192980 FROM GA,0.0,199999.0,,2018,11,14,CASH_IN,199999.0,C1316560467
28652,1196428',2018-11-15,FDRL/NATIONAL ELECTRONIC F,8100000.0,0.0,,2018,11,15,CHECK_WITHDRAWAL,8100000.0,M1572144334
28653,1196428',2018-11-15,FDRL/NATIONAL ELECTRONIC F,9300000.0,0.0,,2018,11,15,PAYEMENT,9300000.0,M593517569
28654,1196428',2018-11-15,FDRL/INTERNAL FUND TRANSFE,300000.0,0.0,,2018,11,15,PAYEMENT,300000.0,M558730564
28655,1196428',2018-11-15,RTGS/SBINH18319012773/SAI,0.0,475029.5,,2018,11,15,CASH_IN,475029.5,C736160330
28656,1196428',2018-11-15,TRF FROM  Indiaforensic SERVICES,0.0,500000.0,,2018,11,15,TRANSFER,500000.0,C417236208
28657,1196428',2018-11-15,TRF FROM  Indiaforensic SERVICES,0.0,500000.0,,2018,11,15,CHECK_CASHING,500000.0,C931482420
28658,1196428',2018-11-15,TRF TO  Indiaforensic SERVICES I,2000000.0,0.0,,2018,11,15,DEBIT,2000000.0,M405976415
28659,1196428',2018-11-15,RTGS/HDFCH18319395730/Indfor,0.0,2900000.0,,2018,11,15,CHECK_CASHING,2900000.0,C208341157
28660,1196428',2018-11-15,TRF FROM  Indiaforensic SERVICES,0.0,2400000.0,,2018,11,15,TRANSFER,2400000.0,C382697424
28661,1196428',2018-11-15,RTGS/PUNBH18319413819/MAN,0.0,250000.0,,2018,11,15,CASH_IN,250000.0,M875577692
28662,1196428',2018-11-15,"Indiaforensic USA, INC./USD/9268",0.0,6663692.0,,2018,11,15,CASH_IN,6663692.0,C1822578654
28663,1196428',2018-11-15,IRTT00701832917,2304.46,0.0,,2018,11,15,PAYEMENT,2304.46,M2022435822
28664,1196428',2018-11-15,FDRL/NATIONAL ELECTRONIC F,14915682.48,0.0,,2018,11,15,PAYEMENT,14915682.48,M1867372125
28665,1196428',2018-11-15,Indiaforensic SERVICES INDIA PVT,0.0,82982.0,,2018,11,15,CHECK_CASHING,82982.0,M556592378
28666,1196428',2018-11-15,TRF FROM  Indiaforensic SERVICES,0.0,8300000.0,,2018,11,15,TRANSFER,8300000.0,C807072084
28667,1196428',2018-11-15,NEFT/000055639038/Indiaforensic,0.0,500000.0,,2018,11,15,CASH_IN,500000.0,C2077098348
28668,1196428',2018-11-15,NEFT/000055638583/Indiaforensic,0.0,500000.0,,2018,11,15,CHECK_CASHING,500000.0,M1751878963
28669,1196428',2018-11-15,FDRL/INTERNAL FUND TRANSFE,200000.0,0.0,,2018,11,15,DEBIT,200000.0,C1618278649
28670,1196428',2018-11-15,FDRL/NATIONAL ELECTRONIC F,39804.0,0.0,,2018,11,15,DEBIT,39804.0,C1987564320
28671,1196428',2018-11-15,FDRL/NATIONAL ELECTRONIC F,37667.0,0.0,,2018,11,15,DEBIT,37667.0,M848162783
28672,1196428',2018-11-15,FDRL/NATIONAL ELECTRONIC F,39507.0,0.0,,2018,11,15,CHECK_WITHDRAWAL,39507.0,M347906624
28673,1196428',2018-11-15,FDRL/NATIONAL ELECTRONIC F,30250.0,0.0,,2018,11,15,DEBIT,30250.0,M271658762
28674,1196428',2018-11-15,FDRL/NATIONAL ELECTRONIC F,32994.0,0.0,,2018,11,15,DEBIT,32994.0,M1403007770
28675,1196428',2018-11-15,FDRL/NATIONAL ELECTRONIC F,38667.0,0.0,,2018,11,15,DEBIT,38667.0,M2043631011
28676,1196428',2018-11-15,FDRL/NATIONAL ELECTRONIC F,47365.0,0.0,,2018,11,15,CASH_OUT,47365.0,C107095723
28677,1196428',2018-11-15,FDRL/NATIONAL ELECTRONIC F,30818.0,0.0,,2018,11,15,CHECK_WITHDRAWAL,30818.0,C985934102
28678,1196428',2018-11-15,FDRL/NATIONAL ELECTRONIC F,32706.0,0.0,,2018,11,15,CASH_OUT,32706.0,C824197891
28679,1196428',2018-11-15,FDRL/NATIONAL ELECTRONIC F,45200.0,0.0,,2018,11,15,PAYEMENT,45200.0,C1696218625
28680,1196428',2018-11-15,FDRL/NATIONAL ELECTRONIC F,31213.0,0.0,,2018,11,15,PAYEMENT,31213.0,M1817447589
28681,1196428',2018-11-15,FDRL/NATIONAL ELECTRONIC F,33900.0,0.0,,2018,11,15,PAYEMENT,33900.0,C168639687
28682,1196428',2018-11-15,FDRL/NATIONAL ELECTRONIC F,32544.0,0.0,,2018,11,15,CASH_OUT,32544.0,C1630293008
28683,1196428',2018-11-15,FDRL/NATIONAL ELECTRONIC F,31595.0,0.0,,2018,11,15,CASH_OUT,31595.0,C1577420620
28684,1196428',2018-11-15,FDRL/NATIONAL ELECTRONIC F,46750.0,0.0,,2018,11,15,PAYEMENT,46750.0,C35263828
28685,1196428',2018-11-15,FDRL/NATIONAL ELECTRONIC F,33535.0,0.0,,2018,11,15,CASH_OUT,33535.0,M2014874822
28686,1196428',2018-11-15,FDRL/NATIONAL ELECTRONIC F,31214.0,0.0,,2018,11,15,PAYEMENT,31214.0,M1553772873
28687,1196428',2018-11-15,FDRL/NATIONAL ELECTRONIC F,37123.0,0.0,,2018,11,15,DEBIT,37123.0,C905650857
28688,1196428',2018-11-15,FDRL/NATIONAL ELECTRONIC F,45200.0,0.0,,2018,11,15,PAYEMENT,45200.0,C1502287290
28689,1196428',2018-11-15,FDRL/NATIONAL ELECTRONIC F,34258.0,0.0,,2018,11,15,CASH_OUT,34258.0,M1197564988
28690,1196428',2018-11-15,FDRL/NATIONAL ELECTRONIC F,36552.0,0.0,,2018,11,15,PAYEMENT,36552.0,M1843534160
28691,1196428',2018-11-15,FDRL/NATIONAL ELECTRONIC F,33126.0,0.0,,2018,11,15,PAYEMENT,33126.0,C871895680
28692,1196428',2018-11-15,FDRL/NATIONAL ELECTRONIC F,45200.0,0.0,,2018,11,15,DEBIT,45200.0,C1398530689
28693,1196428',2018-11-15,TRF FROM  Indiaforensic SERVICES,0.0,5100000.0,,2018,11,15,CHECK_CASHING,5100000.0,M834859488
28694,1196428',2018-11-15,TRF FROM  Indiaforensic SERVICES,0.0,800000.0,,2018,11,15,TRANSFER,800000.0,M463880076
28695,1196428',2018-11-15,TRF FROM  Indiaforensic SERVICES,0.0,500000.0,,2018,11,15,CASH_IN,500000.0,M1273091698
28696,1196428',2018-11-15,FDRL/INTERNAL FUND TRANSFE,300000.0,0.0,,2018,11,15,DEBIT,300000.0,M134350609
28697,1196428',2018-11-15,FDRL/INTERNAL FUND TRANSFE,1000000.0,0.0,,2018,11,15,CHECK_WITHDRAWAL,1000000.0,M1939822545
28698,1196428',2018-11-15,FDRL/INTERNAL FUND TRANSFE,1000000.0,0.0,,2018,11,15,PAYEMENT,1000000.0,M1498010747
28699,1196428',2018-11-15,NEFT CHARGES AND GST/0000,29.5,0.0,,2018,11,15,PAYEMENT,29.5,M615833646
28700,1196428',2018-11-15,NEFT/000056722856/INDIAN,14885387.0,0.0,,2018,11,15,CHECK_WITHDRAWAL,14885387.0,M695601535
28701,1196428',2018-11-15,TRF FROM  Indiaforensic SERVICES,0.0,800000.0,,2018,11,15,CHECK_CASHING,800000.0,M1741551200
28702,1196428',2018-11-15,BEAT CSH PKP DEL GURGA 77,0.0,197000.0,,2018,11,15,TRANSFER,197000.0,M533060514
28703,1196428',2018-11-16,RTGS/HDFCH18320509431/BAT,0.0,500000.0,,2018,11,16,CHECK_CASHING,500000.0,M763925237
28704,1196428',2018-11-16,NEFT/SBIN118320935590/SHI,0.0,11800.0,,2018,11,16,CASH_IN,11800.0,M309397793
28705,1196428',2018-11-16,FDRL/REAL TIME GROSS SETTL,3000000.0,0.0,,2018,11,16,PAYEMENT,3000000.0,M786088183
28706,1196428',2018-11-16,CHQ DEP/956555/OWDEL1/SBI,0.0,11800.0,,2018,11,16,CHECK_CASHING,11800.0,M1362397723
28707,1196428',2018-11-16,CHQ DEP/132691/OWDEL1/UTI,0.0,8000.0,,2018,11,16,TRANSFER,8000.0,M166947904
28708,1196428',2018-11-16,CHQ DEP/497681/OWDEL1/CNR,0.0,8000.0,,2018,11,16,CASH_IN,8000.0,M39384037
28709,1196428',2018-11-16,CHQ DEP/361256/OWDEL1/PUN,0.0,8000.0,,2018,11,16,CASH_IN,8000.0,M1475711030
28710,1196428',2018-11-16,TRF FROM  Indiaforensic SERVICES,0.0,2700000.0,,2018,11,16,TRANSFER,2700000.0,M727579419
28711,1196428',2018-11-16,FDRL/REAL TIME GROSS SETTL,3000000.0,0.0,,2018,11,16,CASH_OUT,3000000.0,M654290745
28712,1196428',2018-11-16,RTGS/ICICH18320769809/Indfor,0.0,500000.0,,2018,11,16,TRANSFER,500000.0,C1559145228
28713,1196428',2018-11-16,RTGS/ICICH18320770307/Indfor,0.0,500000.0,,2018,11,16,CASH_IN,500000.0,M688458571
28714,1196428',2018-11-16,FDRL/INTERNAL FUND TRANSFE,500000.0,0.0,,2018,11,16,CASH_OUT,500000.0,M1895621189
28715,1196428',2018-11-16,IRTT00701833034,2685.02,0.0,,2018,11,16,DEBIT,2685.02,M1516781526
28716,1196428',2018-11-16,"Indiaforensic USA, INC./USD/1227",0.0,8777912.0,,2018,11,16,CHECK_CASHING,8777912.0,M409559965
28717,1196428',2018-11-16,IMPS 832016922003 FROM SA,0.0,50000.0,,2018,11,16,CASH_IN,50000.0,M1771169983
28718,1196428',2018-11-16,Indiaforensic SERVICES INDIA PVT,0.0,88322.0,,2018,11,16,CASH_IN,88322.0,C470217116
28719,1196428',2018-11-16,FDRL/NATIONAL ELECTRONIC F,9300000.0,0.0,,2018,11,16,CASH_OUT,9300000.0,M585745963
28720,1196428',2018-11-16,CHQ DEPOSIT RETURN/956555,11800.0,0.0,,2018,11,16,CASH_OUT,11800.0,M2096974885
28721,1196428',2018-11-16,CHQ DEPOSIT RETURN/361256,8000.0,0.0,,2018,11,16,CHECK_WITHDRAWAL,8000.0,M1287228290
28722,1196428',2018-11-16,TRF FROM  Indiaforensic SERVICES,0.0,13300000.0,,2018,11,16,CHECK_CASHING,13300000.0,M1178751818
28723,1196428',2018-11-16,IMPS 832017825419 FROM OX,0.0,200000.0,,2018,11,16,CHECK_CASHING,200000.0,M145594829
28724,1196428',2018-11-16,IMPS 832017825463 FROM OX,0.0,200000.0,,2018,11,16,CASH_IN,200000.0,M1232351629
28725,1196428',2018-11-16,IMPS 832017825509 FROM OX,0.0,200000.0,,2018,11,16,TRANSFER,200000.0,M1656904340
28726,1196428',2018-11-16,IMPS 832017825550 FROM OX,0.0,200000.0,,2018,11,16,CASH_IN,200000.0,C24404443
28727,1196428',2018-11-16,IMPS 832017825591 FROM OX,0.0,200000.0,,2018,11,16,CHECK_CASHING,200000.0,C596299019
28728,1196428',2018-11-16,IMPS 832017825626 FROM OX,0.0,200000.0,,2018,11,16,TRANSFER,200000.0,C1983747920
28729,1196428',2018-11-16,IMPS 832017828200 FROM OX,0.0,200000.0,,2018,11,16,CHECK_CASHING,200000.0,C696705647
28730,1196428',2018-11-16,FDRL/NATIONAL ELECTRONIC F,14715053.25,0.0,,2018,11,16,CHECK_WITHDRAWAL,14715053.25,C1845765982
28731,1196428',2018-11-16,NEFT/N320180681653189/TEC,0.0,200000.0,,2018,11,16,CASH_IN,200000.0,M877365519
28732,1196428',2018-11-16,TRF FROM  Indiaforensic SERVICES,0.0,2300000.0,,2018,11,16,CHECK_CASHING,2300000.0,C134604590
28733,1196428',2018-11-16,TRF TO  Indiaforensic SERVICES I,1000000.0,0.0,,2018,11,16,CHECK_WITHDRAWAL,1000000.0,M1053485132
28734,1196428',2018-11-16,TRF FROM  Indiaforensic SERVICES,0.0,500000.0,,2018,11,16,TRANSFER,500000.0,M1698378565
28735,1196428',2018-11-16,TRF FROM  Indiaforensic SERVICES,0.0,700000.0,,2018,11,16,CHECK_CASHING,700000.0,M1418167825
28736,1196428',2018-11-16,BEAT CSH PKP DEL GURGA 77,0.0,54000.0,,2018,11,16,CASH_IN,54000.0,M915318947
28737,1196428',2018-11-16,CHQ DEPOSIT RETURN/956555,100.0,0.0,,2018,11,16,DEBIT,100.0,M1471526064
28738,1196428',2018-11-16,CHQ DEPOSIT RETURN/956555,18.0,0.0,,2018,11,16,PAYEMENT,18.0,C474166728
28739,1196428',2018-11-16,CHQ DEPOSIT RETURN/361256,100.0,0.0,,2018,11,16,PAYEMENT,100.0,M1777764920
28740,1196428',2018-11-16,CHQ DEPOSIT RETURN/361256,18.0,0.0,,2018,11,16,CASH_OUT,18.0,C1833549064
28741,1196428',2018-11-17,NEFT/PUNBH18321920995/BAL,0.0,150000.0,,2018,11,17,CHECK_CASHING,150000.0,M327804056
28742,1196428',2018-11-17,FDRL/INTERNAL FUND TRANSFE,300000.0,0.0,,2018,11,17,CHECK_WITHDRAWAL,300000.0,M939893108
28743,1196428',2018-11-17,FDRL/REAL TIME GROSS SETTL,2000000.0,0.0,,2018,11,17,CHECK_WITHDRAWAL,2000000.0,C1938462589
28744,1196428',2018-11-17,TATA TELE SERVICES LTD,32400.0,0.0,,2018,11,17,CASH_OUT,32400.0,M974784761
28745,1196428',2018-11-17,TATA TELE SERVICES LTD,1704.0,0.0,,2018,11,17,CHECK_WITHDRAWAL,1704.0,M209997138
28746,1196428',2018-11-17,TRF FROM  Indiaforensic SERVICES,0.0,2000000.0,,2018,11,17,TRANSFER,2000000.0,M359327148
28747,1196428',2018-11-17,RTGS/SBINH18321035358/SRI,0.0,460000.0,,2018,11,17,CHECK_CASHING,460000.0,C1519216494
28748,1196428',2018-11-17,RTGS/ICICH18321877872/Indfor,0.0,1500000.0,,2018,11,17,CASH_IN,1500000.0,M142106520
28749,1196428',2018-11-17,RTGS/ICICH18321878346/Indfor,0.0,500000.0,,2018,11,17,CASH_IN,500000.0,C1979080020
28750,1196428',2018-11-17,NEFT/BARBS18321808132/RAJ,0.0,97650.0,,2018,11,17,CASH_IN,97650.0,C635281078
28751,1196428',2018-11-17,RTGS/HDFCH18321782828/SHA,0.0,243954.0,,2018,11,17,CASH_IN,243954.0,C1866672043
28752,1196428',2018-11-17,RTGS/SBINH18321049284/Indfor,0.0,7000000.0,,2018,11,17,CASH_IN,7000000.0,M155979068
28753,1196428',2018-11-17,FDRL/NATIONAL ELECTRONIC F,9300000.0,0.0,,2018,11,17,DEBIT,9300000.0,M111496179
28754,1196428',2018-11-17,FDRL/INTERNAL FUND TRANSFE,1000000.0,0.0,,2018,11,17,CHECK_WITHDRAWAL,1000000.0,M1472428747
28755,1196428',2018-11-17,NEFT/AXIC183216881202/Indfor,0.0,5000000.0,,2018,11,17,CHECK_CASHING,5000000.0,C1167813715
28756,1196428',2018-11-17,IMPS 832116287613 FROM SA,0.0,100000.0,,2018,11,17,TRANSFER,100000.0,M235839070
28757,1196428',2018-11-17,NEFT/N321180682300301/BAT,0.0,200000.0,,2018,11,17,CHECK_CASHING,200000.0,M1881768592
28758,1196428',2018-11-17,TRF FROM  Indiaforensic SERVICES,0.0,500000.0,,2018,11,17,CHECK_CASHING,500000.0,C185503802
28759,1196428',2018-11-17,TRF FROM  Indiaforensic SERVICES,0.0,500000.0,,2018,11,17,CASH_IN,500000.0,C403147759
28760,1196428',2018-11-17,TRF FROM  Indiaforensic SERVICES,0.0,2000000.0,,2018,11,17,CASH_IN,2000000.0,M1725462644
28761,1196428',2018-11-17,FDRL/INTERNAL FUND TRANSFE,1000000.0,0.0,,2018,11,17,PAYEMENT,1000000.0,M685639359
28762,1196428',2018-11-17,FDRL/INTERNAL FUND TRANSFE,1000000.0,0.0,,2018,11,17,CASH_OUT,1000000.0,M499928991
28763,1196428',2018-11-17,FDRL/INTERNAL FUND TRANSFE,400000.0,0.0,,2018,11,17,PAYEMENT,400000.0,M960322367
28764,1196428',2018-11-17,FDRL/INTERNAL FUND TRANSFE,400000.0,0.0,,2018,11,17,CHECK_WITHDRAWAL,400000.0,M1786085833
28765,1196428',2018-11-17,BEAT CSH PKP DEL GURGA 77,0.0,155100.0,,2018,11,17,CASH_IN,155100.0,M718103121
28766,1196428',2018-11-19,RTGS/PUNBH18323458527/MAN,0.0,280000.0,,2018,11,19,CHECK_CASHING,280000.0,M757687320
28767,1196428',2018-11-19,TRF FROM  Indiaforensic SERVICES,0.0,3000000.0,,2018,11,19,TRANSFER,3000000.0,M1144148971
28768,1196428',2018-11-19,TRF FROM  Indiaforensic SERVICES,0.0,3000000.0,,2018,11,19,CASH_IN,3000000.0,M1868505862
28769,1196428',2018-11-19,RTGS/HDFCH18323860312/BAT,0.0,500000.0,,2018,11,19,TRANSFER,500000.0,M1608080402
28770,1196428',2018-11-19,FDRL/NATIONAL ELECTRONIC F,14546182.24,0.0,,2018,11,19,CHECK_WITHDRAWAL,14546182.24,M1154038476
28771,1196428',2018-11-19,RTGS/SBINH18323019124/SRI,0.0,445000.0,,2018,11,19,CASH_IN,445000.0,M1325923139
28772,1196428',2018-11-19,TRF FROM  Indiaforensic SERVICES,0.0,2000000.0,,2018,11,19,CHECK_CASHING,2000000.0,M1396188238
28773,1196428',2018-11-19,TRF FROM  Indiaforensic SERVICES,0.0,1000000.0,,2018,11,19,CHECK_CASHING,1000000.0,M554850979
28774,1196428',2018-11-19,RTGS/ICICH18323277621/Indfor,0.0,1000000.0,,2018,11,19,TRANSFER,1000000.0,M1055780232
28775,1196428',2018-11-19,RTGS/ICICH18323278187/Indfor,0.0,500000.0,,2018,11,19,CASH_IN,500000.0,M662568271
28776,1196428',2018-11-19,FDRL/REAL TIME GROSS SETTL,2000000.0,0.0,,2018,11,19,DEBIT,2000000.0,C1649449847
28777,1196428',2018-11-19,FDRL/REAL TIME GROSS SETTL,2000000.0,0.0,,2018,11,19,CASH_OUT,2000000.0,C1198167820
28778,1196428',2018-11-19,RTGS/SBINH18323049825/SAI,0.0,400000.0,,2018,11,19,TRANSFER,400000.0,C749672494
28779,1196428',2018-11-19,CASHDEP/NERUL/,0.0,30000.0,,2018,11,19,TRANSFER,30000.0,C1423992712
28780,1196428',2018-11-19,TRF FROM  Indiaforensic SERVICES,0.0,10000000.0,,2018,11,19,TRANSFER,10000000.0,C313124964
28781,1196428',2018-11-19,IMPS 832317575468 FROM OX,0.0,200000.0,,2018,11,19,CASH_IN,200000.0,C500153041
28782,1196428',2018-11-19,IMPS 832317575535 FROM OX,0.0,200000.0,,2018,11,19,CASH_IN,200000.0,C728526866
28783,1196428',2018-11-19,IMPS 832317575586 FROM OX,0.0,200000.0,,2018,11,19,CASH_IN,200000.0,C40075281
28784,1196428',2018-11-19,IMPS 832317575635 FROM OX,0.0,200000.0,,2018,11,19,CASH_IN,200000.0,C456538529
28785,1196428',2018-11-19,IMPS 832317575681 FROM OX,0.0,200000.0,,2018,11,19,CHECK_CASHING,200000.0,C2117043942
28786,1196428',2018-11-19,IMPS 832317575716 FROM OX,0.0,200000.0,,2018,11,19,CASH_IN,200000.0,C1838584624
28787,1196428',2018-11-19,FDRL/NATIONAL ELECTRONIC F,12700000.0,0.0,,2018,11,19,PAYEMENT,12700000.0,M1733424208
28788,1196428',2018-11-19,TRF FROM  Indiaforensic SERVICES,0.0,2000000.0,,2018,11,19,CASH_IN,2000000.0,M1060393794
28789,1196428',2018-11-19,TRF FROM  Indiaforensic SERVICES,0.0,15000000.0,,2018,11,19,CHECK_CASHING,15000000.0,M226593165
28790,1196428',2018-11-19,TRF FROM  Indiaforensic SERVICES,0.0,4000000.0,,2018,11,19,CASH_IN,4000000.0,M426584880
28791,1196428',2018-11-19,TRF FROM  Indiaforensic SERVICES,0.0,2000000.0,,2018,11,19,CHECK_CASHING,2000000.0,C448155494
28792,1196428',2018-11-19,FDRL/INTERNAL FUND TRANSFE,1000000.0,0.0,,2018,11,19,DEBIT,1000000.0,M1594302764
28793,1196428',2018-11-19,FDRL/INTERNAL FUND TRANSFE,1000000.0,0.0,,2018,11,19,DEBIT,1000000.0,M271366306
28794,1196428',2018-11-19,BEAT CSH PKP DEL GURGA 77,0.0,124500.0,,2018,11,19,TRANSFER,124500.0,C348708793
28795,1196428',2018-11-20,FDRL/INTERNAL FUND TRANSFE,300000.0,0.0,,2018,11,20,CHECK_WITHDRAWAL,300000.0,M462659391
28796,1196428',2018-11-20,RTGS/PUNBH18324479336/BAL,0.0,200000.0,,2018,11,20,TRANSFER,200000.0,M547825235
28797,1196428',2018-11-20,FDRL/REAL TIME GROSS SETTL,15000000.0,0.0,,2018,11,20,CASH_OUT,15000000.0,M1301971459
28798,1196428',2018-11-20,FDRL/REAL TIME GROSS SETTL,5000000.0,0.0,,2018,11,20,CASH_OUT,5000000.0,M1155771218
28799,1196428',2018-11-20,FDRL/INTERNAL FUND TRANSFE,300000.0,0.0,,2018,11,20,CHECK_WITHDRAWAL,300000.0,M734120998
28800,1196428',2018-11-20,TRF FROM Indiaforensic SERVICES,0.0,2200000.0,,2018,11,20,TRANSFER,2200000.0,M1404561012
28801,1196428',2018-11-20,TRF FROM  Indiaforensic SERVICES,0.0,1700000.0,,2018,11,20,CHECK_CASHING,1700000.0,M1376999853
28802,1196428',2018-11-20,TRF TO  Indiaforensic SERVICES I,366788.0,0.0,,2018,11,20,CASH_OUT,366788.0,M255307196
28803,1196428',2018-11-20,"Indiaforensic USA, INC./USD/2242",0.0,15936349.24,,2018,11,20,CHECK_CASHING,15936349.24,M11285367
28804,1196428',2018-11-20,IRTT00701833348,3973.54,0.0,,2018,11,20,CHECK_WITHDRAWAL,3973.54,M714914851
28805,1196428',2018-11-20,FDRL/NATIONAL ELECTRONIC F,12700000.0,0.0,,2018,11,20,PAYEMENT,12700000.0,M1438724935
28806,1196428',2018-11-20,NEFT/N324180683614520/JUN,0.0,140000.0,,2018,11,20,CHECK_CASHING,140000.0,M662472677
28807,1196428',2018-11-20,CASHDEP/NERUL/,0.0,62000.0,,2018,11,20,CASH_IN,62000.0,M1932384587
28808,1196428',2018-11-20,RTGS/ICICH18324436892/Indfor,0.0,2800000.0,,2018,11,20,CASH_IN,2800000.0,M719480872
28809,1196428',2018-11-20,NEFT/000055905865/Indiaforensic,0.0,1000000.0,,2018,11,20,CHECK_CASHING,1000000.0,M1278136570
28810,1196428',2018-11-20,FDRL/NATIONAL ELECTRONIC F,7989723.51,0.0,,2018,11,20,CHECK_WITHDRAWAL,7989723.51,M148964727
28811,1196428',2018-11-20,FDRL/INTERNAL FUND TRANSFE,50000.0,0.0,,2018,11,20,PAYEMENT,50000.0,M1177742051
28812,1196428',2018-11-20,FDRL/INTERNAL FUND TRANSFE,50000.0,0.0,,2018,11,20,PAYEMENT,50000.0,M724365571
28813,1196428',2018-11-20,FDRL/INTERNAL FUND TRANSFE,50000.0,0.0,,2018,11,20,CASH_OUT,50000.0,M212535805
28814,1196428',2018-11-20,FDRL/INTERNAL FUND TRANSFE,50000.0,0.0,,2018,11,20,DEBIT,50000.0,M1596397541
28815,1196428',2018-11-20,RTGS/SBINH18324060427/Indfor,0.0,11500000.0,,2018,11,20,CHECK_CASHING,11500000.0,M713285225
28816,1196428',2018-11-20,FDRL/NATIONAL ELECTRONIC F,12700000.0,0.0,,2018,11,20,CHECK_WITHDRAWAL,12700000.0,C2032389005
28817,1196428',2018-11-20,IMPS 832417868512 FROM OX,0.0,200000.0,,2018,11,20,TRANSFER,200000.0,M1156533869
28818,1196428',2018-11-20,IMPS 832417868570 FROM OX,0.0,200000.0,,2018,11,20,CHECK_CASHING,200000.0,M105292474
28819,1196428',2018-11-20,IMPS 832417868625 FROM OX,0.0,200000.0,,2018,11,20,CASH_IN,200000.0,M1410438390
28820,1196428',2018-11-20,IMPS 832417868671 FROM OX,0.0,200000.0,,2018,11,20,TRANSFER,200000.0,M1257755465
28821,1196428',2018-11-20,IMPS 832417868724 FROM OX,0.0,200000.0,,2018,11,20,TRANSFER,200000.0,M1640401120
28822,1196428',2018-11-20,IMPS 832417868760 FROM OX,0.0,200000.0,,2018,11,20,CHECK_CASHING,200000.0,M1399060771
28823,1196428',2018-11-20,IMPS 832417868824 FROM OX,0.0,200000.0,,2018,11,20,TRANSFER,200000.0,C1262822392
28824,1196428',2018-11-20,IMPS 832417868871 FROM OX,0.0,200000.0,,2018,11,20,CHECK_CASHING,200000.0,M148589770
28825,1196428',2018-11-20,IMPS 832417868904 FROM OX,0.0,200000.0,,2018,11,20,CASH_IN,200000.0,M984489239
28826,1196428',2018-11-20,IMPS 832417868959 FROM OX,0.0,200000.0,,2018,11,20,CASH_IN,200000.0,C2115055717
28827,1196428',2018-11-20,FDRL/NATIONAL ELECTRONIC F,4112557.17,0.0,,2018,11,20,PAYEMENT,4112557.17,C1166654566
28828,1196428',2018-11-20,TRF FRM 409000362497,0.0,323541.0,,2018,11,20,CASH_IN,323541.0,M88042020
28829,1196428',2018-11-20,TRF FROM  Indiaforensic SERVICES,0.0,5000000.0,,2018,11,20,CASH_IN,5000000.0,M717278894
28830,1196428',2018-11-20,FDRL/INTERNAL FUND TRANSFE,500000.0,0.0,,2018,11,20,PAYEMENT,500000.0,M129220812
28831,1196428',2018-11-20,FDRL/INTERNAL FUND TRANSFE,500000.0,0.0,,2018,11,20,PAYEMENT,500000.0,M1015272304
28832,1196428',2018-11-20,FDRL/INTERNAL FUND TRANSFE,500000.0,0.0,,2018,11,20,CASH_OUT,500000.0,C1007717381
28833,1196428',2018-11-20,FDRL/INTERNAL FUND TRANSFE,500000.0,0.0,,2018,11,20,DEBIT,500000.0,C1240091493
28834,1196428',2018-11-20,FDRL/INTERNAL FUND TRANSFE,1000000.0,0.0,,2018,11,20,CASH_OUT,1000000.0,C1396297158
28835,1196428',2018-11-20,FDRL/INTERNAL FUND TRANSFE,400000.0,0.0,,2018,11,20,CASH_OUT,400000.0,M705803524
28836,1196428',2018-11-20,TRF FROM  Indiaforensic SERVICES,0.0,2000000.0,,2018,11,20,CHECK_CASHING,2000000.0,C978740207
28837,1196428',2018-11-20,TRF FROM  Indiaforensic SERVICES,0.0,2000000.0,,2018,11,20,TRANSFER,2000000.0,C115885991
28838,1196428',2018-11-20,FUJIAN NEWLAND PAYMENT TE,1529290.08,0.0,,2018,11,20,CASH_OUT,1529290.08,C587433505
28839,1196428',2018-11-20,IMAR00701806868,3930.97,0.0,,2018,11,20,DEBIT,3930.97,C1637186972
28840,1196428',2018-11-20,BEAT CSH PKP DEL GURGA 77,0.0,107500.0,,2018,11,20,CHECK_CASHING,107500.0,M190739308
28841,1196428',2018-11-21,FDRL/NATIONAL ELECTRONIC F,4441827.47,0.0,,2018,11,21,CHECK_WITHDRAWAL,4441827.47,C778306577
28842,1196428',2018-11-21,FUND TRF FROM  Indiaforensic SER,0.0,1000000.0,,2018,11,21,CHECK_CASHING,1000000.0,M1863711975
28843,1196428',2018-11-21,FUND TRF FROM  Indiaforensic SER,0.0,500000.0,,2018,11,21,CHECK_CASHING,500000.0,M1469855297
28844,1196428',2018-11-21,FUND TRF FROM  Indiaforensic SER,0.0,2000000.0,,2018,11,21,CHECK_CASHING,2000000.0,M794421806
28845,1196428',2018-11-21,CHQ DEP/49927/OWDEL1/ICIC,0.0,11800.0,,2018,11,21,TRANSFER,11800.0,M1334051844
28846,1196428',2018-11-21,CHQ DEP/1446/OWDEL1/BARB/,0.0,11800.0,,2018,11,21,CASH_IN,11800.0,M515450283
28847,1196428',2018-11-21,CHQ DEP/1499/OWDEL1/HDFC/,0.0,11800.0,,2018,11,21,CASH_IN,11800.0,M1747790771
28848,1196428',2018-11-21,RTGS/HDFCH18325251113/BAT,0.0,500000.0,,2018,11,21,CASH_IN,500000.0,M1284135884
28849,1196428',2018-11-21,RTGS/ICICH18325544394/Indfor,0.0,1000000.0,,2018,11,21,TRANSFER,1000000.0,C420561530
28850,1196428',2018-11-21,NEFT/000055960058/Indiaforensic,0.0,900000.0,,2018,11,21,CASH_IN,900000.0,M694158341
28851,1196428',2018-11-21,IMPS 832516875369 FROM SA,0.0,200000.0,,2018,11,21,CHECK_CASHING,200000.0,C2046578329
28852,1196428',2018-11-21,NEFT/SBIN418325637792/IND,0.0,1659974.99,,2018,11,21,CASH_IN,1659974.99,M942812964
28853,1196428',2018-11-21,FUND TRF FROM  Indiaforensic SER,0.0,2000000.0,,2018,11,21,TRANSFER,2000000.0,M1977844832
28854,1196428',2018-11-21,FUND TRF FROM  Indiaforensic SER,0.0,1000000.0,,2018,11,21,TRANSFER,1000000.0,M1171276229
28855,1196428',2018-11-21,FDRL/INTERNAL FUND TRANSFE,500000.0,0.0,,2018,11,21,CASH_OUT,500000.0,M1741253456
28856,1196428',2018-11-21,FDRL/INTERNAL FUND TRANSFE,500000.0,0.0,,2018,11,21,CHECK_WITHDRAWAL,500000.0,M1549630173
28857,1196428',2018-11-21,FDRL/INTERNAL FUND TRANSFE,500000.0,0.0,,2018,11,21,DEBIT,500000.0,C1548218207
28858,1196428',2018-11-21,FDRL/INTERNAL FUND TRANSFE,500000.0,0.0,,2018,11,21,DEBIT,500000.0,C242559404
28859,1196428',2018-11-21,CHQ DEPOSIT RETURN/1499/D,11800.0,0.0,,2018,11,21,PAYEMENT,11800.0,C1153596299
28860,1196428',2018-11-21,FUND TRF FROM  Indiaforensic SER,0.0,500000.0,,2018,11,21,TRANSFER,500000.0,M708011911
28861,1196428',2018-11-22,FDRL/INTERNAL FUND TRANSFE,400000.0,0.0,,2018,11,22,PAYEMENT,400000.0,M1579526490
28862,1196428',2018-11-22,CHQ DEP/1855/OWDEL1/BARB/,0.0,8000.0,,2018,11,22,CHECK_CASHING,8000.0,C1924874046
28863,1196428',2018-11-22,CHQ DEP/74/OWDEL1/UCBA/SF,0.0,11800.0,,2018,11,22,TRANSFER,11800.0,C1079343872
28864,1196428',2018-11-22,CHQ DEP/388/OWDEL1/KKBK/G,0.0,11800.0,,2018,11,22,TRANSFER,11800.0,M1025387324
28865,1196428',2018-11-22,CHQ DEP/141643/OWDEL1/SBI,0.0,11800.0,,2018,11,22,CASH_IN,11800.0,M2114990234
28866,1196428',2018-11-22,CHQ DEP/202123/OWDEL1/SBI,0.0,11800.0,,2018,11,22,CASH_IN,11800.0,M1843420945
28867,1196428',2018-11-22,CHQ DEP/792364/OWDEL1/CNR,0.0,11800.0,,2018,11,22,CHECK_CASHING,11800.0,C863811613
28868,1196428',2018-11-22,CHQ DEP/463486/OWDEL1/AND,0.0,11800.0,,2018,11,22,CASH_IN,11800.0,M1539382844
28869,1196428',2018-11-22,CHQ DEP/3585/OWDEL1/ICIC/,0.0,11800.0,,2018,11,22,CASH_IN,11800.0,M1846768700
28870,1196428',2018-11-22,CHQ DEP/16/OWDEL1/HDFC/,0.0,11800.0,,2018,11,22,TRANSFER,11800.0,C1640747200
28871,1196428',2018-11-22,CHQ DEP/719902/OWDEL1/SBI,0.0,11800.0,,2018,11,22,TRANSFER,11800.0,M1099038981
28872,1196428',2018-11-22,CHQ DEP/240456/OWDEL1/SBI,0.0,11800.0,,2018,11,22,CASH_IN,11800.0,C344610846
28873,1196428',2018-11-22,CHQ DEP/515588/OWDEL1/SBI,0.0,11800.0,,2018,11,22,CHECK_CASHING,11800.0,C1919277981
28874,1196428',2018-11-22,CHQ DEP/531813/OWDEL1/SBI,0.0,11800.0,,2018,11,22,TRANSFER,11800.0,C2104652067
28875,1196428',2018-11-22,CHQ DEP/468399/OWDEL1/SBI,0.0,11800.0,,2018,11,22,CHECK_CASHING,11800.0,C1092465037
28876,1196428',2018-11-22,CHQ DEP/715735/OWDEL1/SBI,0.0,11800.0,,2018,11,22,TRANSFER,11800.0,M995633719
28877,1196428',2018-11-22,CHQ DEP/460731/OWDEL1/SBI,0.0,11800.0,,2018,11,22,TRANSFER,11800.0,M938465080
28878,1196428',2018-11-22,CHQ DEP/457953/OWDEL1/SBI,0.0,11800.0,,2018,11,22,CHECK_CASHING,11800.0,M1834981639
28879,1196428',2018-11-22,CHQ DEP/158374/OWDEL1/SBI,0.0,11800.0,,2018,11,22,CASH_IN,11800.0,M1775303360
28880,1196428',2018-11-22,CHQ DEP/285792/OWDEL1/PUN,0.0,8000.0,,2018,11,22,TRANSFER,8000.0,M261084274
28881,1196428',2018-11-22,RTGS/HDFCH18326346563/JUN,0.0,280000.0,,2018,11,22,TRANSFER,280000.0,M1007295516
28882,1196428',2018-11-22,NEFT/20829670531DC/ARTHAS,0.0,1146.0,,2018,11,22,CHECK_CASHING,1146.0,M470234716
28883,1196428',2018-11-22,RTGS/PUNBH18326518570/MAN,0.0,300000.0,,2018,11,22,TRANSFER,300000.0,M905290562
28884,1196428',2018-11-22,"Indiaforensic USA, INC./USD/1038",0.0,7365588.3,,2018,11,22,CASH_IN,7365588.3,M798935213
28885,1196428',2018-11-22,IRTT00701833474,2430.81,0.0,,2018,11,22,CASH_OUT,2430.81,M1932154134
28886,1196428',2018-11-22,TRF FROM  Indiaforensic SERVICES,0.0,2300000.0,,2018,11,22,CASH_IN,2300000.0,M1426777731
28887,1196428',2018-11-22,FDRL/NATIONAL ELECTRONIC F,50000.98,0.0,,2018,11,22,PAYEMENT,50000.98,M2001931511
28888,1196428',2018-11-22,RTGS/ICICH18326626018/Indfor,0.0,1000000.0,,2018,11,22,CHECK_CASHING,1000000.0,M1028639221
28889,1196428',2018-11-22,NEFT/SBIN518326053120/M S,0.0,8000.0,,2018,11,22,CHECK_CASHING,8000.0,M129965176
28890,1196428',2018-11-22,CHQ DEPOSIT RETURN/463486,11800.0,0.0,,2018,11,22,CASH_OUT,11800.0,M1666930496
28891,1196428',2018-11-22,CHQ DEPOSIT RETURN/158374,11800.0,0.0,,2018,11,22,DEBIT,11800.0,M1348049534
28892,1196428',2018-11-22,RTGS/HDFCH18326465257/BAT,0.0,300000.0,,2018,11,22,CASH_IN,300000.0,M149861385
28893,1196428',2018-11-22,RTGS/SBINH18326075204/Indfor,0.0,2000000.0,,2018,11,22,CASH_IN,2000000.0,M1803845616
28894,1196428',2018-11-22,CASHDEP/NERUL/,0.0,64200.0,,2018,11,22,CHECK_CASHING,64200.0,M396463835
28895,1196428',2018-11-22,FDRL/NATIONAL ELECTRONIC F,12700000.0,0.0,,2018,11,22,PAYEMENT,12700000.0,M1022045468
28896,1196428',2018-11-22,FDRL/NATIONAL ELECTRONIC F,2500.0,0.0,,2018,11,22,DEBIT,2500.0,M1556446144
28897,1196428',2018-11-22,FDRL/NATIONAL ELECTRONIC F,2500.0,0.0,,2018,11,22,DEBIT,2500.0,M141959252
28898,1196428',2018-11-22,FDRL/NATIONAL ELECTRONIC F,2500.0,0.0,,2018,11,22,DEBIT,2500.0,M1997459283
28899,1196428',2018-11-22,FDRL/NATIONAL ELECTRONIC F,2000.0,0.0,,2018,11,22,PAYEMENT,2000.0,M539292855
28900,1196428',2018-11-22,FDRL/NATIONAL ELECTRONIC F,2500.0,0.0,,2018,11,22,PAYEMENT,2500.0,M878266233
28901,1196428',2018-11-22,FDRL/NATIONAL ELECTRONIC F,2000.0,0.0,,2018,11,22,CASH_OUT,2000.0,M1660780699
28902,1196428',2018-11-22,FDRL/NATIONAL ELECTRONIC F,2000.0,0.0,,2018,11,22,PAYEMENT,2000.0,M1242431450
28903,1196428',2018-11-22,FDRL/NATIONAL ELECTRONIC F,2500.0,0.0,,2018,11,22,DEBIT,2500.0,M2075133206
28904,1196428',2018-11-22,FDRL/NATIONAL ELECTRONIC F,3000.0,0.0,,2018,11,22,CHECK_WITHDRAWAL,3000.0,M1651383848
28905,1196428',2018-11-22,FDRL/NATIONAL ELECTRONIC F,5000.0,0.0,,2018,11,22,CHECK_WITHDRAWAL,5000.0,M1364290623
28906,1196428',2018-11-22,FDRL/INTERNAL FUND TRANSFE,200000.0,0.0,,2018,11,22,CASH_OUT,200000.0,M1119145556
28907,1196428',2018-11-22,FDRL/NATIONAL ELECTRONIC F,5000.0,0.0,,2018,11,22,PAYEMENT,5000.0,M552762676
28908,1196428',2018-11-22,FDRL/NATIONAL ELECTRONIC F,3000.0,0.0,,2018,11,22,PAYEMENT,3000.0,M1549335447
28909,1196428',2018-11-22,FDRL/NATIONAL ELECTRONIC F,2000.0,0.0,,2018,11,22,CHECK_WITHDRAWAL,2000.0,M1407332998
28910,1196428',2018-11-22,FDRL/NATIONAL ELECTRONIC F,2500.0,0.0,,2018,11,22,DEBIT,2500.0,M575173490
28911,1196428',2018-11-22,Indiaforensic SERVICES INDIA PVT,0.0,166752.0,,2018,11,22,CHECK_CASHING,166752.0,M1463959599
28912,1196428',2018-11-22,FDRL/INTERNAL FUND TRANSFE,300000.0,0.0,,2018,11,22,CHECK_WITHDRAWAL,300000.0,C191614132
28913,1196428',2018-11-22,FDRL/NATIONAL ELECTRONIC F,57166.0,0.0,,2018,11,22,DEBIT,57166.0,C1885712019
28914,1196428',2018-11-22,FDRL/NATIONAL ELECTRONIC F,77500.0,0.0,,2018,11,22,PAYEMENT,77500.0,M1406881784
28915,1196428',2018-11-22,TRF FROM  Indiaforensic SERVICES,0.0,15000000.0,,2018,11,22,CASH_IN,15000000.0,C1161865950
28916,1196428',2018-11-22,FDRL/NATIONAL ELECTRONIC F,12700000.0,0.0,,2018,11,22,CASH_OUT,12700000.0,M1558051277
28917,1196428',2018-11-22,NEFT/000056049526/Indiaforensic,0.0,500000.0,,2018,11,22,TRANSFER,500000.0,M1173085824
28918,1196428',2018-11-22,NEFT/IOBAN18326491105/K,0.0,2500.0,,2018,11,22,TRANSFER,2500.0,M569018137
28919,1196428',2018-11-22,IMPS 832617409163 FROM OX,0.0,200000.0,,2018,11,22,CHECK_CASHING,200000.0,M1770271962
28920,1196428',2018-11-22,IMPS 832617409197 FROM OX,0.0,200000.0,,2018,11,22,CHECK_CASHING,200000.0,M1586738337
28921,1196428',2018-11-22,IMPS 832617409230 FROM OX,0.0,200000.0,,2018,11,22,TRANSFER,200000.0,M1674738101
28922,1196428',2018-11-22,IMPS 832617409277 FROM OX,0.0,200000.0,,2018,11,22,CHECK_CASHING,200000.0,C1590550415
28923,1196428',2018-11-22,IMPS 832617409334 FROM OX,0.0,200000.0,,2018,11,22,TRANSFER,200000.0,C705321061
28924,1196428',2018-11-22,IMPS 832617409397 FROM OX,0.0,200000.0,,2018,11,22,CASH_IN,200000.0,M873689156
28925,1196428',2018-11-22,IMPS 832617409454 FROM OX,0.0,200000.0,,2018,11,22,CHECK_CASHING,200000.0,M1538317866
28926,1196428',2018-11-22,IMPS 832617409497 FROM OX,0.0,200000.0,,2018,11,22,CASH_IN,200000.0,C262828207
28927,1196428',2018-11-22,IMPS 832617409549 FROM OX,0.0,200000.0,,2018,11,22,CHECK_CASHING,200000.0,C1222590577
28928,1196428',2018-11-22,IMPS 832617409602 FROM OX,0.0,200000.0,,2018,11,22,CHECK_CASHING,200000.0,M2089852906
28929,1196428',2018-11-22,IMPS 832617409897 FROM OX,0.0,200000.0,,2018,11,22,TRANSFER,200000.0,M629502621
28930,1196428',2018-11-22,IMPS 832617409944 FROM OX,0.0,200000.0,,2018,11,22,CHECK_CASHING,200000.0,M511596806
28931,1196428',2018-11-22,FDRL/NATIONAL ELECTRONIC F,14462349.65,0.0,,2018,11,22,PAYEMENT,14462349.65,M2079635991
28932,1196428',2018-11-22,NEFT/000056051641/Indiaforensic,0.0,1000000.0,,2018,11,22,TRANSFER,1000000.0,M1044456366
28933,1196428',2018-11-22,NEFT/N326180685411961/RAN,0.0,11800.0,,2018,11,22,CASH_IN,11800.0,C1689840534
28934,1196428',2018-11-22,NEFT/N326180685440687/TEC,0.0,300000.0,,2018,11,22,CHECK_CASHING,300000.0,M1092817314
28935,1196428',2018-11-22,FDRL/INTERNAL FUND TRANSFE,1000000.0,0.0,,2018,11,22,CHECK_WITHDRAWAL,1000000.0,C1475909248
28936,1196428',2018-11-22,TRF FROM  Indiaforensic SERVICES,0.0,600000.0,,2018,11,22,CASH_IN,600000.0,M2040472550
28937,1196428',2018-11-22,TRF TO  Indiaforensic SERVICES I,0.0,700000.0,,2018,11,22,TRANSFER,700000.0,C979719862
28938,1196428',2018-11-22,TRF FROM  Indiaforensic SERVICES,0.0,1000000.0,,2018,11,22,CASH_IN,1000000.0,C985934102
28939,1196428',2018-11-22,TRF TO  Indiaforensic SERVICES I,2000000.0,0.0,,2018,11,22,CHECK_WITHDRAWAL,2000000.0,C731253803
28940,1196428',2018-11-22,TRF FROM  Indiaforensic SERVICES,0.0,15000000.0,,2018,11,22,CASH_IN,15000000.0,C1609562230
28941,1196428',2018-11-22,FDRL/INTERNAL FUND TRANSFE,1000000.0,0.0,,2018,11,22,PAYEMENT,1000000.0,M1076923640
28942,1196428',2018-11-22,FDRL/INTERNAL FUND TRANSFE,1000000.0,0.0,,2018,11,22,CHECK_WITHDRAWAL,1000000.0,M1144262832
28943,1196428',2018-11-22,FDRL/INTERNAL FUND TRANSFE,300000.0,0.0,,2018,11,22,DEBIT,300000.0,M942922351
28944,1196428',2018-11-22,FDRL/INTERNAL FUND TRANSFE,300000.0,0.0,,2018,11,22,CHECK_WITHDRAWAL,300000.0,M1582038853
28945,1196428',2018-11-22,NEFT/N326180685414976/Indfor,0.0,1200000.0,,2018,11,22,CASH_IN,1200000.0,M36034212
28946,1196428',2018-11-22,TRF FROM  Indiaforensic SERVICES,0.0,500000.0,,2018,11,22,CHECK_CASHING,500000.0,M1326356346
28947,1196428',2018-11-22,BEAT CSH PKP DEL GURGA 77,0.0,174000.0,,2018,11,22,TRANSFER,174000.0,C27489818
28948,1196428',2018-11-22,CHQ DEPOSIT RETURN/158374,100.0,0.0,,2018,11,22,DEBIT,100.0,C747979499
28949,1196428',2018-11-22,CHQ DEPOSIT RETURN/158374,18.0,0.0,,2018,11,22,CHECK_WITHDRAWAL,18.0,C1660095722
28950,1196428',2018-11-23,RTGS/SBINH18327010346/Indfor,0.0,6500000.0,,2018,11,23,TRANSFER,6500000.0,C372017580
28951,1196428',2018-11-23,NEFT/SBIN518327703370/SHA,0.0,11800.0,,2018,11,23,CHECK_CASHING,11800.0,M370179552
28952,1196428',2018-11-23,FDRL/NATIONAL ELECTRONIC F,14871581.79,0.0,,2018,11,23,CHECK_WITHDRAWAL,14871581.79,C802935635
28953,1196428',2018-11-23,FDRL/INTERNAL FUND TRANSFE,400000.0,0.0,,2018,11,23,CHECK_WITHDRAWAL,400000.0,M1523086740
28954,1196428',2018-11-23,FDRL/INTERNAL FUND TRANSFE,3000000.0,0.0,,2018,11,23,CASH_OUT,3000000.0,M902885640
28955,1196428',2018-11-23,NEFT/FSFBH18327000093/FIN,0.0,148226.0,,2018,11,23,CASH_IN,148226.0,C459172227
28956,1196428',2018-11-26,CASHDEP/NERUL/,0.0,85000.0,,2018,11,26,CHECK_CASHING,85000.0,C265108079
28957,1196428',2018-11-26,RTGS/HDFCH18330598237/BAT,0.0,500000.0,,2018,11,26,CASH_IN,500000.0,C35126588
28958,1196428',2018-11-26,IMPS 833013165468 FROM PU,0.0,10000.0,,2018,11,26,CHECK_CASHING,10000.0,C1589477624
28959,1196428',2018-11-26,TRF FROM  Indiaforensic SERVICES,0.0,6800000.0,,2018,11,26,TRANSFER,6800000.0,C1283595719
28960,1196428',2018-11-26,TRF FROM  Indiaforensic SERVICES,0.0,2900000.0,,2018,11,26,TRANSFER,2900000.0,C101084405
28961,1196428',2018-11-26,RTGS/ICICH18330874259/Indfor,0.0,2000000.0,,2018,11,26,TRANSFER,2000000.0,M7891579
28962,1196428',2018-11-26,RTGS/ICICH18330876925/Indfor,0.0,2000000.0,,2018,11,26,CASH_IN,2000000.0,M150228660
28963,1196428',2018-11-26,"Indiaforensic USA, INC./USD/1216",0.0,8550026.6,,2018,11,26,TRANSFER,8550026.6,M190019040
28964,1196428',2018-11-26,IRTT00701833814,2644.0,0.0,,2018,11,26,CASH_OUT,2644.0,M1462909495
28965,1196428',2018-11-26,FDRL/NATIONAL ELECTRONIC F,4000000.0,0.0,,2018,11,26,DEBIT,4000000.0,C1192983708
28966,1196428',2018-11-26,FDRL/NATIONAL ELECTRONIC F,4000000.0,0.0,,2018,11,26,PAYEMENT,4000000.0,M1730398598
28967,1196428',2018-11-26,FDRL/NATIONAL ELECTRONIC F,3000000.0,0.0,,2018,11,26,CHECK_WITHDRAWAL,3000000.0,M1492635498
28968,1196428',2018-11-26,FDRL/NATIONAL ELECTRONIC F,4000000.0,0.0,,2018,11,26,CHECK_WITHDRAWAL,4000000.0,M738483886
28969,1196428',2018-11-26,Indiaforensic SERVICES INDIA PVT,0.0,847618.0,,2018,11,26,CASH_IN,847618.0,M1583014678
28970,1196428',2018-11-26,TRF FROM  Indiaforensic SERVICES,0.0,10000000.0,,2018,11,26,TRANSFER,10000000.0,C395114097
28971,1196428',2018-11-26,TRF FROM  Indiaforensic SERVICES,0.0,5000000.0,,2018,11,26,CASH_IN,5000000.0,M743943553
28972,1196428',2018-11-26,RTGS/SBINH18330082447/Indfor,0.0,14200000.0,,2018,11,26,CHECK_CASHING,14200000.0,M2034445578
28973,1196428',2018-11-26,FDRL/NATIONAL ELECTRONIC F,14900000.0,0.0,,2018,11,26,PAYEMENT,14900000.0,C1383942363
28974,1196428',2018-11-26,FDRL/NATIONAL ELECTRONIC F,11034967.22,0.0,,2018,11,26,CASH_OUT,11034967.22,M72285092
28975,1196428',2018-11-26,FDRL/NATIONAL ELECTRONIC F,14900000.0,0.0,,2018,11,26,CASH_OUT,14900000.0,M586185216
28976,1196428',2018-11-26,FDRL/INTERNAL FUND TRANSFE,400000.0,0.0,,2018,11,26,DEBIT,400000.0,M1378755468
28977,1196428',2018-11-26,TRF FROM  Indiaforensic SERVICES,0.0,3400000.0,,2018,11,26,TRANSFER,3400000.0,C765980478
28978,1196428',2018-11-26,TRF FROM  Indiaforensic SERVICES,0.0,1900000.0,,2018,11,26,CASH_IN,1900000.0,C1200314947
28979,1196428',2018-11-26,TRF TO  Indiaforensic SERVICES I,2500000.0,0.0,,2018,11,26,CASH_OUT,2500000.0,C1973491942
28980,1196428',2018-11-26,TRF FROM  Indiaforensic SERVICES,0.0,15000000.0,,2018,11,26,CHECK_CASHING,15000000.0,C1689374891
28981,1196428',2018-11-26,TRF FROM  Indiaforensic SERVICES,0.0,15000000.0,,2018,11,26,TRANSFER,15000000.0,C2053639017
28982,1196428',2018-11-26,TRF FROM  Indiaforensic SERVICES,0.0,1700000.0,,2018,11,26,CASH_IN,1700000.0,C1654056127
28983,1196428',2018-11-26,TRF FROM  Indiaforensic SERVICES,0.0,1200000.0,,2018,11,26,TRANSFER,1200000.0,C803368825
28984,1196428',2018-11-26,BEAT CSH PKP DEL GURGA 77,0.0,403000.0,,2018,11,26,TRANSFER,403000.0,C892686452
28985,1196428',2018-11-27,FDRL/REAL TIME GROSS SETTL,5000000.0,0.0,,2018,11,27,CHECK_WITHDRAWAL,5000000.0,C2031563133
28986,1196428',2018-11-27,FDRL/REAL TIME GROSS SETTL,5000000.0,0.0,,2018,11,27,DEBIT,5000000.0,C1619402333
28987,1196428',2018-11-27,FDRL/REAL TIME GROSS SETTL,5000000.0,0.0,,2018,11,27,CHECK_WITHDRAWAL,5000000.0,C1149273771
28988,1196428',2018-11-27,FDRL/REAL TIME GROSS SETTL,5000000.0,0.0,,2018,11,27,CHECK_WITHDRAWAL,5000000.0,C2109470512
28989,1196428',2018-11-27,FDRL/INTERNAL FUND TRANSFE,500000.0,0.0,,2018,11,27,CHECK_WITHDRAWAL,500000.0,C1059781259
28990,1196428',2018-11-27,FDRL/NATIONAL ELECTRONIC F,53895.0,0.0,,2018,11,27,CHECK_WITHDRAWAL,53895.0,C125722707
28991,1196428',2018-11-27,FDRL/NATIONAL ELECTRONIC F,61274.0,0.0,,2018,11,27,CASH_OUT,61274.0,C1778300121
28992,1196428',2018-11-27,FDRL/NATIONAL ELECTRONIC F,58443.0,0.0,,2018,11,27,CASH_OUT,58443.0,C313124964
28993,1196428',2018-11-27,FDRL/NATIONAL ELECTRONIC F,67431.0,0.0,,2018,11,27,DEBIT,67431.0,C1220897602
28994,1196428',2018-11-27,FDRL/NATIONAL ELECTRONIC F,69532.0,0.0,,2018,11,27,DEBIT,69532.0,C1515704208
28995,1196428',2018-11-27,FDRL/NATIONAL ELECTRONIC F,61538.0,0.0,,2018,11,27,CHECK_WITHDRAWAL,61538.0,C1313534832
28996,1196428',2018-11-27,FDRL/NATIONAL ELECTRONIC F,72523.0,0.0,,2018,11,27,PAYEMENT,72523.0,C1141137903
28997,1196428',2018-11-27,FDRL/NATIONAL ELECTRONIC F,83120.0,0.0,,2018,11,27,DEBIT,83120.0,C1869228744
28998,1196428',2018-11-27,FDRL/NATIONAL ELECTRONIC F,73033.0,0.0,,2018,11,27,CASH_OUT,73033.0,C2078250226
28999,1196428',2018-11-27,FDRL/NATIONAL ELECTRONIC F,57514.0,0.0,,2018,11,27,CHECK_WITHDRAWAL,57514.0,C1300519073
29000,1196428',2018-11-27,FDRL/NATIONAL ELECTRONIC F,53858.0,0.0,,2018,11,27,CASH_OUT,53858.0,M1808484670
29001,1196428',2018-11-27,FDRL/NATIONAL ELECTRONIC F,70696.0,0.0,,2018,11,27,CASH_OUT,70696.0,M829035073
29002,1196428',2018-11-27,FDRL/NATIONAL ELECTRONIC F,54564.0,0.0,,2018,11,27,PAYEMENT,54564.0,M1674174327
29003,1196428',2018-11-27,FDRL/NATIONAL ELECTRONIC F,93440.0,0.0,,2018,11,27,DEBIT,93440.0,M2135203084
29004,1196428',2018-11-27,FDRL/NATIONAL ELECTRONIC F,53700.0,0.0,,2018,11,27,CHECK_WITHDRAWAL,53700.0,C1673971173
29005,1196428',2018-11-27,FDRL/NATIONAL ELECTRONIC F,63597.0,0.0,,2018,11,27,PAYEMENT,63597.0,C339099861
29006,1196428',2018-11-27,FDRL/NATIONAL ELECTRONIC F,56129.0,0.0,,2018,11,27,PAYEMENT,56129.0,M2045422556
29007,1196428',2018-11-27,FDRL/NATIONAL ELECTRONIC F,69934.0,0.0,,2018,11,27,DEBIT,69934.0,C1266035080
29008,1196428',2018-11-27,FDRL/NATIONAL ELECTRONIC F,58878.0,0.0,,2018,11,27,CHECK_WITHDRAWAL,58878.0,C1060041730
29009,1196428',2018-11-27,FDRL/NATIONAL ELECTRONIC F,51447.0,0.0,,2018,11,27,CASH_OUT,51447.0,C1475395523
29010,1196428',2018-11-27,FDRL/NATIONAL ELECTRONIC F,73833.0,0.0,,2018,11,27,PAYEMENT,73833.0,C265845794
29011,1196428',2018-11-27,FDRL/NATIONAL ELECTRONIC F,104720.0,0.0,,2018,11,27,DEBIT,104720.0,C58091972
29012,1196428',2018-11-27,FDRL/NATIONAL ELECTRONIC F,109175.0,0.0,,2018,11,27,CHECK_WITHDRAWAL,109175.0,C193864812
29013,1196428',2018-11-27,FDRL/NATIONAL ELECTRONIC F,60059.0,0.0,,2018,11,27,DEBIT,60059.0,C681835572
29014,1196428',2018-11-27,FDRL/NATIONAL ELECTRONIC F,60747.0,0.0,,2018,11,27,CASH_OUT,60747.0,C965197768
29015,1196428',2018-11-27,FDRL/NATIONAL ELECTRONIC F,118814.0,0.0,,2018,11,27,DEBIT,118814.0,C893038039
29016,1196428',2018-11-27,FDRL/NATIONAL ELECTRONIC F,285445.0,0.0,,2018,11,27,DEBIT,285445.0,C1317731757
29017,1196428',2018-11-27,FDRL/NATIONAL ELECTRONIC F,175518.0,0.0,,2018,11,27,DEBIT,175518.0,C1373467808
29018,1196428',2018-11-27,FDRL/NATIONAL ELECTRONIC F,135816.0,0.0,,2018,11,27,PAYEMENT,135816.0,C1318822808
29019,1196428',2018-11-27,FDRL/NATIONAL ELECTRONIC F,223844.0,0.0,,2018,11,27,PAYEMENT,223844.0,C1424731356
29020,1196428',2018-11-27,FDRL/NATIONAL ELECTRONIC F,116316.0,0.0,,2018,11,27,DEBIT,116316.0,C1439007204
29021,1196428',2018-11-27,FDRL/NATIONAL ELECTRONIC F,221992.0,0.0,,2018,11,27,DEBIT,221992.0,C1116292004
29022,1196428',2018-11-27,FDRL/NATIONAL ELECTRONIC F,196219.0,0.0,,2018,11,27,CHECK_WITHDRAWAL,196219.0,C638551812
29023,1196428',2018-11-27,NEFT/IDIBH18331255246/SHI,0.0,8000.0,,2018,11,27,CASH_IN,8000.0,C193826743
29024,1196428',2018-11-27,CASHDEP/BOISAR/,0.0,7000.0,,2018,11,27,CASH_IN,7000.0,C309167705
29025,1196428',2018-11-27,VODAFONE MOBILE SERVICES,16200.0,0.0,,2018,11,27,PAYEMENT,16200.0,C811597470
29026,1196428',2018-11-27,IMPS 833113119944 FROM PU,0.0,25000.0,,2018,11,27,CASH_IN,25000.0,C1014923261
29027,1196428',2018-11-27,TRF FROM  Indiaforensic SERVICES,0.0,2300000.0,,2018,11,27,CHECK_CASHING,2300000.0,C925574515
29028,1196428',2018-11-27,TRF TO  Indiaforensic SERVICES I,1727846.0,0.0,,2018,11,27,CASH_OUT,1727846.0,C1988152146
29029,1196428',2018-11-27,TRF TO  Indiaforensic SERVICES I,81568.0,0.0,,2018,11,27,DEBIT,81568.0,C71555810
29030,1196428',2018-11-27,"Indiaforensic USA, INC./USD/1804",0.0,12736240.0,,2018,11,27,CHECK_CASHING,12736240.0,C1273939873
29031,1196428',2018-11-27,IRTT00701834033,3397.52,0.0,,2018,11,27,DEBIT,3397.52,C749672494
29032,1196428',2018-11-27,RTGS/ICICH18331355616/Indfor,0.0,1000000.0,,2018,11,27,TRANSFER,1000000.0,C1504109395
29033,1196428',2018-11-27,RTGS/ICICH18331354646/Indfor,0.0,1500000.0,,2018,11,27,CHECK_CASHING,1500000.0,C2107268831
29034,1196428',2018-11-27,CASHDEP/NERUL/,0.0,70000.0,,2018,11,27,TRANSFER,70000.0,C1141137903
29035,1196428',2018-11-27,FDRL/NATIONAL ELECTRONIC F,9349019.45,0.0,,2018,11,27,CHECK_WITHDRAWAL,9349019.45,M492166970
29036,1196428',2018-11-27,FDRL/NATIONAL ELECTRONIC F,14900000.0,0.0,,2018,11,27,PAYEMENT,14900000.0,C762570948
29037,1196428',2018-11-27,Indiaforensic SERVICES INDIA PVT,0.0,830853.0,,2018,11,27,CASH_IN,830853.0,C1440282299
29038,1196428',2018-11-27,TRF FROM  Indiaforensic SERVICES,0.0,9700000.0,,2018,11,27,TRANSFER,9700000.0,M1583639547
29039,1196428',2018-11-27,CASHPMT/GURGAON/SELF,49000.0,0.0,,2018,11,27,DEBIT,49000.0,M1476691574
29040,1196428',2018-11-27,NEFT/SBIN718331222960/Indfor,0.0,2600000.0,,2018,11,27,CHECK_CASHING,2600000.0,C893339434
29041,1196428',2018-11-27,NEFT/SBIN718331222611/Indfor,0.0,14900000.0,,2018,11,27,TRANSFER,14900000.0,M722806861
29042,1196428',2018-11-27,FDRL/NATIONAL ELECTRONIC F,5642585.58,0.0,,2018,11,27,PAYEMENT,5642585.58,C1150610696
29043,1196428',2018-11-27,FDRL/NATIONAL ELECTRONIC F,14900000.0,0.0,,2018,11,27,CHECK_WITHDRAWAL,14900000.0,C1674899618
29044,1196428',2018-11-27,IMPS 833117682760 FROM OX,0.0,200000.0,,2018,11,27,CHECK_CASHING,200000.0,M481126602
29045,1196428',2018-11-27,IMPS 833117682817 FROM OX,0.0,200000.0,,2018,11,27,TRANSFER,200000.0,C1793325972
29046,1196428',2018-11-27,IMPS 833117682895 FROM OX,0.0,200000.0,,2018,11,27,TRANSFER,200000.0,M132360639
29047,1196428',2018-11-27,IMPS 833117682939 FROM OX,0.0,200000.0,,2018,11,27,CHECK_CASHING,200000.0,M2052092920
29048,1196428',2018-11-27,IMPS 833117682982 FROM OX,0.0,200000.0,,2018,11,27,CASH_IN,200000.0,M236650472
29049,1196428',2018-11-27,IMPS 833117683027 FROM OX,0.0,200000.0,,2018,11,27,CASH_IN,200000.0,M2089634452
29050,1196428',2018-11-27,IMPS 833117683068 FROM OX,0.0,200000.0,,2018,11,27,CHECK_CASHING,200000.0,M1097809105
29051,1196428',2018-11-27,IMPS 833117683116 FROM OX,0.0,200000.0,,2018,11,27,CASH_IN,200000.0,C302025300
29052,1196428',2018-11-27,IMPS 833117683151 FROM OX,0.0,200000.0,,2018,11,27,TRANSFER,200000.0,M134742492
29053,1196428',2018-11-27,IMPS 833117683208 FROM OX,0.0,200000.0,,2018,11,27,CHECK_CASHING,200000.0,C1511785794
29054,1196428',2018-11-27,FDRL/NATIONAL ELECTRONIC F,851570.0,0.0,,2018,11,27,CHECK_WITHDRAWAL,851570.0,M1604293868
29055,1196428',2018-11-27,IMPS 833117684298 FROM OX,0.0,200000.0,,2018,11,27,CASH_IN,200000.0,M1853641629
29056,1196428',2018-11-27,IMPS 833117684345 FROM OX,0.0,200000.0,,2018,11,27,TRANSFER,200000.0,M710600916
29057,1196428',2018-11-27,TRF TO  Indiaforensic SERVICES I,10000.0,0.0,,2018,11,27,DEBIT,10000.0,M985323561
29058,1196428',2018-11-27,IMPS 833118699874 FROM OX,0.0,200000.0,,2018,11,27,CASH_IN,200000.0,M1194715097
29059,1196428',2018-11-27,IMPS 833118699916 FROM OX,0.0,200000.0,,2018,11,27,CHECK_CASHING,200000.0,M693684695
29060,1196428',2018-11-27,IMPS 833118699954 FROM OX,0.0,200000.0,,2018,11,27,CASH_IN,200000.0,M1582319135
29061,1196428',2018-11-27,IMPS 833118700019 FROM OX,0.0,200000.0,,2018,11,27,CASH_IN,200000.0,M227290600
29062,1196428',2018-11-27,IMPS 833118700068 FROM OX,0.0,200000.0,,2018,11,27,CASH_IN,200000.0,M2089806029
29063,1196428',2018-11-27,FDRL/INTERNAL FUND TRANSFE,300000.0,0.0,,2018,11,27,CHECK_WITHDRAWAL,300000.0,M1477278751
29064,1196428',2018-11-27,FDRL/INTERNAL FUND TRANSFE,400000.0,0.0,,2018,11,27,PAYEMENT,400000.0,M1650385017
29065,1196428',2018-11-27,TRF FROM  Indiaforensic SERVICES,0.0,1100000.0,,2018,11,27,TRANSFER,1100000.0,M1921059756
29066,1196428',2018-11-27,TRF FROM  Indiaforensic SERVICES,0.0,800000.0,,2018,11,27,CASH_IN,800000.0,M590434145
29067,1196428',2018-11-27,TRF TO  Indiaforensic SERVICES I,2000000.0,0.0,,2018,11,27,CHECK_WITHDRAWAL,2000000.0,M1671621366
29068,1196428',2018-11-27,IMPS 833119793188 FROM AR,0.0,4289.0,,2018,11,27,TRANSFER,4289.0,M899686935
29069,1196428',2018-11-27,BEAT CSH PKP DEL GURGA 77,0.0,120000.0,,2018,11,27,CHECK_CASHING,120000.0,M2054039573
29070,1196428',2018-11-28,CASHDEP/NERUL/,0.0,66200.0,,2018,11,28,CHECK_CASHING,66200.0,M1271480561
29071,1196428',2018-11-28,RTGS/UTIBH18332687154/Indfor,0.0,700000.0,,2018,11,28,TRANSFER,700000.0,C1259769769
29072,1196428',2018-11-28,TRF FROM  Indiaforensic SERVICES,0.0,3000000.0,,2018,11,28,CASH_IN,3000000.0,M649539827
29073,1196428',2018-11-28,TRF FROM  Indiaforensic SERVICES,0.0,500000.0,,2018,11,28,TRANSFER,500000.0,C893350828
29074,1196428',2018-11-28,INTEX TECHNOLOGIES INDIA,925000.0,0.0,,2018,11,28,CASH_OUT,925000.0,M20364107
29075,1196428',2018-11-28,RTGS/SBINH18332026979/SAI,0.0,400029.5,,2018,11,28,CHECK_CASHING,400029.5,M2023197227
29076,1196428',2018-11-28,TATA TELE SERVICES LTD,32400.0,0.0,,2018,11,28,PAYEMENT,32400.0,C232812328
29077,1196428',2018-11-28,CHQ DEP/1513/OWDEL1/HDFC/,0.0,11800.0,,2018,11,28,CHECK_CASHING,11800.0,M902890505
29078,1196428',2018-11-28,TRF FROM  Indiaforensic SERVICES,0.0,2000000.0,,2018,11,28,CHECK_CASHING,2000000.0,M1465861273
29079,1196428',2018-11-28,NEFT/20840325581DC/ARTHAS,0.0,333.0,,2018,11,28,TRANSFER,333.0,M949506330
29080,1196428',2018-11-28,Indiaforensic SERVICES INDIA PVT,0.0,800949.0,,2018,11,28,TRANSFER,800949.0,M2084969506
29081,1196428',2018-11-28,FDRL/NATIONAL ELECTRONIC F,13004987.52,0.0,,2018,11,28,DEBIT,13004987.52,M608038618
29082,1196428',2018-11-28,IMPS 833217884584 FROM MR,0.0,8200.0,,2018,11,28,CHECK_CASHING,8200.0,M1041764081
29083,1196428',2018-11-28,TRF FROM  Indiaforensic SERVICES,0.0,12600000.0,,2018,11,28,TRANSFER,12600000.0,M277788688
29084,1196428',2018-11-28,FDRL/INTERNAL FUND TRANSFE,400000.0,0.0,,2018,11,28,CHECK_WITHDRAWAL,400000.0,M31440957
29085,1196428',2018-11-28,TRF TO  Indiaforensic SERVICES I,1700000.0,0.0,,2018,11,28,PAYEMENT,1700000.0,C1805162633
29086,1196428',2018-11-28,TRF FROM  Indiaforensic SERVICES,0.0,600000.0,,2018,11,28,CHECK_CASHING,600000.0,M1201023997
29087,1196428',2018-11-28,TRF FROM  Indiaforensic SERVICES,0.0,500000.0,,2018,11,28,TRANSFER,500000.0,M1412743565
29088,1196428',2018-11-28,TRF TO  Indiaforensic SERVICES I,2000000.0,0.0,,2018,11,28,PAYEMENT,2000000.0,M1887477561
29089,1196428',2018-11-28,IMPS 833218553642 FROM SA,0.0,30000.0,,2018,11,28,TRANSFER,30000.0,C435161028
29090,1196428',2018-11-28,BEAT CSH PKP DEL GURGA 77,0.0,48500.0,,2018,11,28,TRANSFER,48500.0,M2126024846
29091,1196428',2018-11-29,FDRL/NATIONAL ELECTRONIC F,14900000.0,0.0,,2018,11,29,DEBIT,14900000.0,M885738476
29092,1196428',2018-11-29,RTGS/PUNBH18333613816/MAN,0.0,200000.0,,2018,11,29,CASH_IN,200000.0,C1273939873
29093,1196428',2018-11-29,RTGS/HDFCH18333234525/BAT,0.0,500000.0,,2018,11,29,CHECK_CASHING,500000.0,C464094472
29094,1196428',2018-11-29,RTGS/UTIBH18333645769/Indfor,0.0,7500000.0,,2018,11,29,CHECK_CASHING,7500000.0,C1475998599
29095,1196428',2018-11-29,FDRL/NATIONAL ELECTRONIC F,5351192.17,0.0,,2018,11,29,CHECK_WITHDRAWAL,5351192.17,C1789550256
29096,1196428',2018-11-29,TRF FROM  Indiaforensic SERVICES,0.0,1500000.0,,2018,11,29,CASH_IN,1500000.0,C1805445027
29097,1196428',2018-11-29,TRF TO  Indiaforensic SERVICES I,15000.0,0.0,,2018,11,29,CHECK_WITHDRAWAL,15000.0,C968448640
29098,1196428',2018-11-29,CHQ DEP/368591/OWDEL1/SBI,0.0,8000.0,,2018,11,29,CASH_IN,8000.0,C691636444
29099,1196428',2018-11-29,CHQ DEP/635563/OWDEL1/SBI,0.0,11800.0,,2018,11,29,CHECK_CASHING,11800.0,C1778801068
29100,1196428',2018-11-29,CHQ DEP/192/OWDEL1/ICIC/,0.0,11800.0,,2018,11,29,CASH_IN,11800.0,C2029896123
29101,1196428',2018-11-29,CHQ DEP/507261/OWDEL1/JAK,0.0,11800.0,,2018,11,29,CHECK_CASHING,11800.0,C1677727024
29102,1196428',2018-11-29,CHQ DEP/25096/OWDEL1/BKID,0.0,11800.0,,2018,11,29,CASH_IN,11800.0,C1525944481
29103,1196428',2018-11-29,CHQ DEP/26606/OWDEL1/BKID,0.0,11800.0,,2018,11,29,CHECK_CASHING,11800.0,C481402298
29104,1196428',2018-11-29,CHQ DEP/601/OWDEL1/BARB/S,0.0,1500.0,,2018,11,29,CASH_IN,1500.0,C177457290
29105,1196428',2018-11-29,CHQ DEP/1013/OWDEL1/KVBL/,0.0,1500.0,,2018,11,29,TRANSFER,1500.0,M1138171728
29106,1196428',2018-11-29,CHQ DEP/438537/OWDEL1/SBI,0.0,1500.0,,2018,11,29,TRANSFER,1500.0,C1452722471
29107,1196428',2018-11-29,CHQ DEP/153277/OWDEL1/IOB,0.0,1500.0,,2018,11,29,CHECK_CASHING,1500.0,C861958315
29108,1196428',2018-11-29,CHQ DEP/686667/OWDEL1/SBI,0.0,1500.0,,2018,11,29,CASH_IN,1500.0,M919438675
29109,1196428',2018-11-29,CHQ DEP/1296/OWDEL1/ANDB/,0.0,11800.0,,2018,11,29,TRANSFER,11800.0,M1501022601
29110,1196428',2018-11-29,RTGS/UTIBH18333662214/Indfor,0.0,6000000.0,,2018,11,29,CHECK_CASHING,6000000.0,M397708705
29111,1196428',2018-11-29,RTGS/HDFCH18333297115/Indfor,0.0,2900000.0,,2018,11,29,CASH_IN,2900000.0,M1092898377
29112,1196428',2018-11-29,NEFT/N333180689144891/JUN,0.0,170000.0,,2018,11,29,CHECK_CASHING,170000.0,M1957947378
29113,1196428',2018-11-29,FDRL/NATIONAL ELECTRONIC F,14900000.0,0.0,,2018,11,29,CASH_OUT,14900000.0,C785703145
29114,1196428',2018-11-29,RTGS/ICICH18333611796/Indfor,0.0,900000.0,,2018,11,29,CASH_IN,900000.0,M2094125621
29115,1196428',2018-11-29,NEFT/000056394359/Indiaforensic,0.0,1300000.0,,2018,11,29,TRANSFER,1300000.0,M1918034019
29116,1196428',2018-11-29,TRF FROM  Indiaforensic SERVICES,0.0,13700000.0,,2018,11,29,TRANSFER,13700000.0,M745483242
29117,1196428',2018-11-29,TRF TO  Indiaforensic SERVICES I,95431.0,0.0,,2018,11,29,CHECK_WITHDRAWAL,95431.0,M1878714361
29118,1196428',2018-11-29,FDRL/NATIONAL ELECTRONIC F,14642345.67,0.0,,2018,11,29,PAYEMENT,14642345.67,M203939387
29119,1196428',2018-11-29,NEFT/N333180689617072/TEC,0.0,100000.0,,2018,11,29,CHECK_CASHING,100000.0,C382934088
29120,1196428',2018-11-29,NEFT/20843436071DC/ARTHAS,0.0,478.0,,2018,11,29,TRANSFER,478.0,C158876320
29121,1196428',2018-11-29,TRF FROM  Indiaforensic SERVICES,0.0,1000000.0,,2018,11,29,TRANSFER,1000000.0,C732929236
29122,1196428',2018-11-29,TRF FROM  Indiaforensic SERVICES,0.0,700000.0,,2018,11,29,CASH_IN,700000.0,C1554622120
29123,1196428',2018-11-29,TRF FROM  Indiaforensic SERVICES,0.0,600000.0,,2018,11,29,CASH_IN,600000.0,C1359484306
29124,1196428',2018-11-29,TRF TO  Indiaforensic SERVICES I,500000.0,0.0,,2018,11,29,CASH_OUT,500000.0,C1782704802
29125,1196428',2018-11-29,BEAT CSH PKP DEL GURGA 77,0.0,140000.0,,2018,11,29,TRANSFER,140000.0,C1609562230
29126,1196428',2018-11-29,TRF TO  Indiaforensic SERVICES I,2000000.0,0.0,,2018,11,29,PAYEMENT,2000000.0,C1220897602
29127,1196428',2018-11-30,CASHDEP/NERUL/,0.0,49200.0,,2018,11,30,CASH_IN,49200.0,C1213257323
29128,1196428',2018-11-30,NEFT/N334180690224250/JUN,0.0,150000.0,,2018,11,30,CASH_IN,150000.0,C674913323
29129,1196428',2018-11-30,INFOEDGE INDIA LTD,187200.0,0.0,,2018,11,30,DEBIT,187200.0,C803116137
29130,1196428',2018-11-30,NATIONAL INSURANCE COMPAN,3448.0,0.0,,2018,11,30,CASH_OUT,3448.0,C1450417897
29131,1196428',2018-11-30,RTGS/HDFCH18334569117/BAT,0.0,300000.0,,2018,11,30,TRANSFER,300000.0,C826383690
29132,1196428',2018-11-30,"Indiaforensic USA, INC./USD/1597",0.0,11088176.8,,2018,11,30,CHECK_CASHING,11088176.8,M1718920203
29133,1196428',2018-11-30,IRTT00701834581,3100.87,0.0,,2018,11,30,PAYEMENT,3100.87,M1002711260
29134,1196428',2018-11-30,FDRL/REAL TIME GROSS SETTL,5000000.0,0.0,,2018,11,30,CASH_OUT,5000000.0,C545710008
29135,1196428',2018-11-30,FDRL/REAL TIME GROSS SETTL,5000000.0,0.0,,2018,11,30,DEBIT,5000000.0,C1838584624
29136,1196428',2018-11-30,FDRL/REAL TIME GROSS SETTL,2000000.0,0.0,,2018,11,30,DEBIT,2000000.0,C1030706332
29137,1196428',2018-11-30,DORD00701800378:Bank Guar,1180.0,0.0,,2018,11,30,PAYEMENT,1180.0,M2129060443
29138,1196428',2018-11-30,TRF FROM  Indiaforensic SERVICES,0.0,1600000.0,,2018,11,30,TRANSFER,1600000.0,C1195471589
29139,1196428',2018-11-30,TRF FROM  Indiaforensic SERVICES,0.0,10000000.0,,2018,11,30,CASH_IN,10000000.0,M1398128260
29140,1196428',2018-11-30,NEFT/20845922271DC/ARTHAS,0.0,1093.0,,2018,11,30,CHECK_CASHING,1093.0,C1856036778
29141,1196428',2018-11-30,NEFT/N334180691037421/TEC,0.0,200000.0,,2018,11,30,CASH_IN,200000.0,C2067546399
29142,1196428',2018-11-30,FDRL/INTERNAL FUND TRANSFE,400000.0,0.0,,2018,11,30,CHECK_WITHDRAWAL,400000.0,C818570949
29143,1196428',2018-11-30,TRF FROM  Indiaforensic SERVICES,0.0,700000.0,,2018,11,30,TRANSFER,700000.0,M535878604
29144,1196428',2018-11-30,TRF FROM  Indiaforensic SERVICES,0.0,800000.0,,2018,11,30,CASH_IN,800000.0,C358945794
29145,1196428',2018-11-30,TRF TO  Indiaforensic SERVICES I,220000.0,0.0,,2018,11,30,PAYEMENT,220000.0,C922511709
29146,1196428',2018-11-30,BEAT CSH PKP DEL GURGA 77,0.0,21500.0,,2018,11,30,CASH_IN,21500.0,C988138425
29147,1196428',2018-11-30,1196428:Int.Coll:01-11-20,764542.0,0.0,,2018,11,30,CHECK_WITHDRAWAL,764542.0,C814900611
29148,1196428',2018-12-01,IMPS 833510493692 FROM SA,0.0,200000.0,,2018,12,1,CASH_IN,200000.0,C1467740330
29149,1196428',2018-12-01,CHQ DEP/515097/OWDEL1/SYN,0.0,11800.0,,2018,12,1,CHECK_CASHING,11800.0,M858308953
29150,1196428',2018-12-01,CHQ DEP/827311/OWDEL1/SBI,0.0,11800.0,,2018,12,1,TRANSFER,11800.0,M1773085261
29151,1196428',2018-12-01,CHQ DEP/218914/OWDEL1/JAK,0.0,11800.0,,2018,12,1,CHECK_CASHING,11800.0,M472606308
29152,1196428',2018-12-01,CHQ DEP/863087/OWDEL1/JAK,0.0,11800.0,,2018,12,1,CHECK_CASHING,11800.0,M51583809
29153,1196428',2018-12-01,CHQ DEP/59355/OWDEL1/SBIN,0.0,11800.0,,2018,12,1,CASH_IN,11800.0,M1337700382
29154,1196428',2018-12-01,CHQ DEP/520707/OWDEL1/JAK,0.0,11800.0,,2018,12,1,CHECK_CASHING,11800.0,C1918034924
29155,1196428',2018-12-01,CHQ DEP/292964/OWDEL1/JAK,0.0,11800.0,,2018,12,1,TRANSFER,11800.0,M527477577
29156,1196428',2018-12-01,CHQ DEP/358142/OWDEL1/JAK,0.0,11800.0,,2018,12,1,CASH_IN,11800.0,M577217292
29157,1196428',2018-12-01,CHQ DEP/8387/OWDEL1/UBIN/,0.0,11800.0,,2018,12,1,CHECK_CASHING,11800.0,C184253187
29158,1196428',2018-12-01,CHQ DEP/27166/OWDEL1/BKDN,0.0,11800.0,,2018,12,1,CASH_IN,11800.0,C1778300121
29159,1196428',2018-12-01,CHQ DEP/392185/OWDEL1/SBI,0.0,11800.0,,2018,12,1,TRANSFER,11800.0,C667504652
29160,1196428',2018-12-01,CHQ DEP/867/OWDEL1/ICIC/H,0.0,11800.0,,2018,12,1,CHECK_CASHING,11800.0,C638590716
29161,1196428',2018-12-01,RTGS/SBINH18335021629/Indfor,0.0,8000000.0,,2018,12,1,CASH_IN,8000000.0,C1532153384
29162,1196428',2018-12-01,DLF GOLF RESORTS LTD,330400.0,0.0,,2018,12,1,DEBIT,330400.0,C208427878
29163,1196428',2018-12-01,BHARTI AIRTEL LTD,2150.0,0.0,,2018,12,1,DEBIT,2150.0,C1530086509
29164,1196428',2018-12-01,BHARTI AIRTEL LTD,2150.0,0.0,,2018,12,1,PAYEMENT,2150.0,C703957828
29165,1196428',2018-12-01,BHARTI AIRTEL LTD,2150.0,0.0,,2018,12,1,CHECK_WITHDRAWAL,2150.0,C891020651
29166,1196428',2018-12-01,BHARTI AIRTEL LTD,2087.0,0.0,,2018,12,1,CASH_OUT,2087.0,M1680032445
29167,1196428',2018-12-01,RTGS/ICICH18335850953/Indfor,0.0,2000000.0,,2018,12,1,TRANSFER,2000000.0,C553264065
29168,1196428',2018-12-01,RTGS/ICICH18335851479/Indfor,0.0,1000000.0,,2018,12,1,CHECK_CASHING,1000000.0,M1097298586
29169,1196428',2018-12-01,TRF FROM  Indiaforensic SERVICES,0.0,1000000.0,,2018,12,1,TRANSFER,1000000.0,M870026554
29170,1196428',2018-12-01,FDRL/INTERNAL FUND TRANSFE,500000.0,0.0,,2018,12,1,PAYEMENT,500000.0,C695653925
29171,1196428',2018-12-01,FDRL/NATIONAL ELECTRONIC F,8202145.1,0.0,,2018,12,1,PAYEMENT,8202145.1,M1248361658
29172,1196428',2018-12-01,FDRL/NATIONAL ELECTRONIC F,14900000.0,0.0,,2018,12,1,CHECK_WITHDRAWAL,14900000.0,C1689262323
29173,1196428',2018-12-01,CASHDEP/NERUL/,0.0,67900.0,,2018,12,1,TRANSFER,67900.0,C1757877803
29174,1196428',2018-12-01,CHQ DEPOSIT RETURN/218914,11800.0,0.0,,2018,12,1,CHECK_WITHDRAWAL,11800.0,C1849933855
29175,1196428',2018-12-01,CHQ DEPOSIT RETURN/59355/,11800.0,0.0,,2018,12,1,CASH_OUT,11800.0,C1753128715
29176,1196428',2018-12-01,CHQ DEPOSIT RETURN/292964,11800.0,0.0,,2018,12,1,CHECK_WITHDRAWAL,11800.0,C1527761090
29177,1196428',2018-12-01,TRF FROM  Indiaforensic SERVICES,0.0,3000000.0,,2018,12,1,TRANSFER,3000000.0,C1754722089
29178,1196428',2018-12-01,TRF FROM  Indiaforensic SERVICES,0.0,3000000.0,,2018,12,1,TRANSFER,3000000.0,C1261039678
29179,1196428',2018-12-01,IMPS 833517084243 FROM OX,0.0,200000.0,,2018,12,1,CASH_IN,200000.0,C836514715
29180,1196428',2018-12-01,IMPS 833517084331 FROM OX,0.0,200000.0,,2018,12,1,CHECK_CASHING,200000.0,C1640961071
29181,1196428',2018-12-01,IMPS 833517084392 FROM OX,0.0,200000.0,,2018,12,1,CHECK_CASHING,200000.0,C1838584624
29182,1196428',2018-12-01,IMPS 833517084448 FROM OX,0.0,200000.0,,2018,12,1,CASH_IN,200000.0,C1209271652
29183,1196428',2018-12-01,IMPS 833517084498 FROM OX,0.0,200000.0,,2018,12,1,CHECK_CASHING,200000.0,C745740822
29184,1196428',2018-12-01,IMPS 833517084560 FROM OX,0.0,200000.0,,2018,12,1,TRANSFER,200000.0,C1401721023
29185,1196428',2018-12-01,IMPS 833517084624 FROM OX,0.0,200000.0,,2018,12,1,CASH_IN,200000.0,C47827984
29186,1196428',2018-12-01,IMPS 833517084706 FROM OX,0.0,200000.0,,2018,12,1,CASH_IN,200000.0,C1849941462
29187,1196428',2018-12-01,IMPS 833517085017 FROM OX,0.0,200000.0,,2018,12,1,CHECK_CASHING,200000.0,C70895366
29188,1196428',2018-12-01,IMPS 833517085071 FROM OX,0.0,200000.0,,2018,12,1,CHECK_CASHING,200000.0,C977993101
29189,1196428',2018-12-01,IMPS 833517085144 FROM OX,0.0,200000.0,,2018,12,1,CASH_IN,200000.0,C2116873183
29190,1196428',2018-12-01,IMPS 833517085211 FROM OX,0.0,200000.0,,2018,12,1,CHECK_CASHING,200000.0,C892686452
29191,1196428',2018-12-01,TRF FROM  Indiaforensic SERVICES,0.0,2000000.0,,2018,12,1,CASH_IN,2000000.0,C1540270363
29192,1196428',2018-12-01,FDRL/NATIONAL ELECTRONIC F,8206127.04,0.0,,2018,12,1,CASH_OUT,8206127.04,C534662976
29193,1196428',2018-12-01,FDRL/INTERNAL FUND TRANSFE,3000000.0,0.0,,2018,12,1,PAYEMENT,3000000.0,C30013970
29194,1196428',2018-12-01,FDRL/INTERNAL FUND TRANSFE,400000.0,0.0,,2018,12,1,CASH_OUT,400000.0,C1809373351
29195,1196428',2018-12-01,NEFT/SBIN218335320779/Indfor,0.0,6000000.0,,2018,12,1,TRANSFER,6000000.0,C741431520
29196,1196428',2018-12-01,CHQ DEPOSIT RETURN/218914,100.0,0.0,,2018,12,1,PAYEMENT,100.0,C669771073
29197,1196428',2018-12-01,CHQ DEPOSIT RETURN/218914,18.0,0.0,,2018,12,1,PAYEMENT,18.0,C1915091057
29198,1196428',2018-12-01,CHQ DEPOSIT RETURN/59355/,100.0,0.0,,2018,12,1,CHECK_WITHDRAWAL,100.0,C323287038
29199,1196428',2018-12-01,CHQ DEPOSIT RETURN/59355/,18.0,0.0,,2018,12,1,CHECK_WITHDRAWAL,18.0,C1027992087
29200,1196428',2018-12-01,CHQ DEPOSIT RETURN/292964,100.0,0.0,,2018,12,1,DEBIT,100.0,C1435804085
29201,1196428',2018-12-01,CHQ DEPOSIT RETURN/292964,18.0,0.0,,2018,12,1,CASH_OUT,18.0,C1153596299
29202,1196428',2018-12-03,RTGS/PUNBH18337680224/SAI,0.0,200000.0,,2018,12,3,CASH_IN,200000.0,C1541743053
29203,1196428',2018-12-03,RTGS/HDFCH18337862127/BAT,0.0,500000.0,,2018,12,3,CASH_IN,500000.0,C1213257323
29204,1196428',2018-12-03,INFOEDGE INDIA LTD,37440.0,0.0,,2018,12,3,CHECK_WITHDRAWAL,37440.0,C295081230
29205,1196428',2018-12-03,TRF FROM  Indiaforensic SERVICES,0.0,4100000.0,,2018,12,3,TRANSFER,4100000.0,C531511436
29206,1196428',2018-12-03,TRF FROM  Indiaforensic SERVICES,0.0,1300000.0,,2018,12,3,CHECK_CASHING,1300000.0,C175291188
29207,1196428',2018-12-03,RTGS/HDFCH18337870080/Indfor,0.0,3800000.0,,2018,12,3,CHECK_CASHING,3800000.0,C1259769769
29208,1196428',2018-12-03,FDRL/INTERNAL FUND TRANSFE,0.0,3000000.0,,2018,12,3,TRANSFER,3000000.0,C205300866
29209,1196428',2018-12-03,FDRL/INTERNAL FUND TRANSFE,0.0,1000000.0,,2018,12,3,CHECK_CASHING,1000000.0,C1297873690
29210,1196428',2018-12-03,FDRL/NATIONAL ELECTRONIC F,14900000.0,0.0,,2018,12,3,CHECK_WITHDRAWAL,14900000.0,C715819458
29211,1196428',2018-12-03,CHQ DEP/32506/OWMUM5/DATT,0.0,11800.0,,2018,12,3,TRANSFER,11800.0,C18928637
29212,1196428',2018-12-03,CHQ DEP/32507/OWMUM5/DATT,0.0,11800.0,,2018,12,3,CASH_IN,11800.0,C1079343872
29213,1196428',2018-12-03,CHQ DEP/1045/OWMUM5/ICIC/,0.0,11800.0,,2018,12,3,CASH_IN,11800.0,C99275333
29214,1196428',2018-12-03,Indiaforensic SERVICES INDIA PVT,0.0,2427850.0,,2018,12,3,CASH_IN,2427850.0,C1450828900
29215,1196428',2018-12-03,RTGS/SBINH18337059211/Indfor,0.0,14900000.0,,2018,12,3,CHECK_CASHING,14900000.0,C1339257929
29216,1196428',2018-12-03,CHQ DEPOSIT RETURN/1045/F,11800.0,0.0,,2018,12,3,PAYEMENT,11800.0,C893041125
29217,1196428',2018-12-03,FDRL/NATIONAL ELECTRONIC F,5000000.0,0.0,,2018,12,3,DEBIT,5000000.0,C380242442
29218,1196428',2018-12-03,FDRL/NATIONAL ELECTRONIC F,12623800.93,0.0,,2018,12,3,PAYEMENT,12623800.93,C1220897602
29219,1196428',2018-12-03,TRF FROM  Indiaforensic SERVICES,0.0,1700000.0,,2018,12,3,CHECK_CASHING,1700000.0,C495071437
29220,1196428',2018-12-03,TRF FROM  Indiaforensic SERVICES,0.0,1200000.0,,2018,12,3,CASH_IN,1200000.0,C1753128715
29221,1196428',2018-12-03,NEFT/N337180692999095/JUN,0.0,100000.0,,2018,12,3,CHECK_CASHING,100000.0,C1387460501
29222,1196428',2018-12-03,TRF FROM  Indiaforensic SERVICES,0.0,14900000.0,,2018,12,3,TRANSFER,14900000.0,C425987411
29223,1196428',2018-12-03,PBGI01001800346:Bank Guar,2885.35,0.0,,2018,12,3,PAYEMENT,2885.35,C914293025
29224,1196428',2018-12-03,FDRL/NATIONAL ELECTRONIC F,1789452.24,0.0,,2018,12,3,CHECK_WITHDRAWAL,1789452.24,C1765998352
29225,1196428',2018-12-03,FDRL/NATIONAL ELECTRONIC F,14900000.0,0.0,,2018,12,3,CHECK_WITHDRAWAL,14900000.0,C1651144763
29226,1196428',2018-12-03,FDRL/INTERNAL FUND TRANSFE,500000.0,0.0,,2018,12,3,CASH_OUT,500000.0,C922871524
29227,1196428',2018-12-03,FDRL/INTERNAL FUND TRANSFE,500000.0,0.0,,2018,12,3,PAYEMENT,500000.0,C667346055
29228,1196428',2018-12-03,FDRL/INTERNAL FUND TRANSFE,2000000.0,0.0,,2018,12,3,CHECK_WITHDRAWAL,2000000.0,C1548833119
29229,1196428',2018-12-03,FDRL/INTERNAL FUND TRANSFE,500000.0,0.0,,2018,12,3,CASH_OUT,500000.0,C1398530689
29230,1196428',2018-12-03,FDRL/INTERNAL FUND TRANSFE,500000.0,0.0,,2018,12,3,DEBIT,500000.0,C1728766751
29231,1196428',2018-12-03,STAMP PAPER PURCHASING,100.0,0.0,,2018,12,3,PAYEMENT,100.0,C2068216232
29232,1196428',2018-12-03,IMPS 833719653050 FROM AR,0.0,1595.0,,2018,12,3,CASH_IN,1595.0,M422953853
29233,1196428',2018-12-03,TRF FROM  Indiaforensic SERVICES,0.0,15000000.0,,2018,12,3,TRANSFER,15000000.0,C14057327
29234,1196428',2018-12-03,TRF FROM  Indiaforensic SERVICES,0.0,1400000.0,,2018,12,3,CASH_IN,1400000.0,M580367329
29235,1196428',2018-12-03,TRF FROM  Indiaforensic SERVICES,0.0,400000.0,,2018,12,3,CHECK_CASHING,400000.0,M1631832255
29236,1196428',2018-12-03,NEFT/000056637046/Indiaforensic,0.0,1000000.0,,2018,12,3,CASH_IN,1000000.0,M1638258542
29237,1196428',2018-12-03,NEFT/N337180693552612/TEC,0.0,100000.0,,2018,12,3,TRANSFER,100000.0,M2124807825
29238,1196428',2018-12-03,BEAT CSH PKP DEL GURGA 77,0.0,87000.0,,2018,12,3,TRANSFER,87000.0,M1559547105
29239,1196428',2018-12-03,NEFT/000056637723/Indiaforensic,0.0,1600000.0,,2018,12,3,TRANSFER,1600000.0,M1787726380
29240,1196428',2018-12-03,CHQ DEPOSIT RETURN/1045/C,100.0,0.0,,2018,12,3,DEBIT,100.0,M675336790
29241,1196428',2018-12-03,CHQ DEPOSIT RETURN/1045/G,18.0,0.0,,2018,12,3,PAYEMENT,18.0,M2023018386
29242,1196428',2018-12-04,FDRL/REAL TIME GROSS SETTL,3000000.0,0.0,,2018,12,4,PAYEMENT,3000000.0,M1218843494
29243,1196428',2018-12-04,FDRL/REAL TIME GROSS SETTL,1000000.0,0.0,,2018,12,4,PAYEMENT,1000000.0,C708801789
29244,1196428',2018-12-04,FDRL/REAL TIME GROSS SETTL,3000000.0,0.0,,2018,12,4,DEBIT,3000000.0,M1823313951
29245,1196428',2018-12-04,FDRL/REAL TIME GROSS SETTL,2000000.0,0.0,,2018,12,4,CASH_OUT,2000000.0,M1660635397
29246,1196428',2018-12-04,FDRL/REAL TIME GROSS SETTL,1000000.0,0.0,,2018,12,4,DEBIT,1000000.0,C1188392295
29247,1196428',2018-12-04,FDRL/REAL TIME GROSS SETTL,5000000.0,0.0,,2018,12,4,DEBIT,5000000.0,C1977614404
29248,1196428',2018-12-04,CASHDEP/NERUL/,0.0,59000.0,,2018,12,4,TRANSFER,59000.0,M394976500
29249,1196428',2018-12-04,NEFT/P18120432222353/S B,0.0,199500.0,,2018,12,4,TRANSFER,199500.0,M2107202111
29250,1196428',2018-12-04,TRF FROM  Indiaforensic SERVICES,0.0,1300000.0,,2018,12,4,CHECK_CASHING,1300000.0,M466132515
29251,1196428',2018-12-04,TRF FROM  Indiaforensic SERVICES,0.0,700000.0,,2018,12,4,TRANSFER,700000.0,M390732591
29252,1196428',2018-12-04,RTGS/HDFCH18338020725/Indfor,0.0,4000000.0,,2018,12,4,CHECK_CASHING,4000000.0,M915493910
29253,1196428',2018-12-04,FDRL/NATIONAL ELECTRONIC F,8909090.16,0.0,,2018,12,4,PAYEMENT,8909090.16,M2127755465
29254,1196428',2018-12-04,RTGS/HDFCH18338077672/BAT,0.0,300000.0,,2018,12,4,CASH_IN,300000.0,M340425338
29255,1196428',2018-12-04,IMPS 833814161869 FROM PU,0.0,10000.0,,2018,12,4,CHECK_CASHING,10000.0,C2142748198
29256,1196428',2018-12-04,RTGS/ICICH18338420540/Indfor,0.0,900000.0,,2018,12,4,CHECK_CASHING,900000.0,M1631822877
29257,1196428',2018-12-04,FDRL/INTERNAL FUND TRANSFE,500000.0,0.0,,2018,12,4,CHECK_WITHDRAWAL,500000.0,C1036454560
29258,1196428',2018-12-04,TRF FROM  Indiaforensic SERVICES,0.0,6400000.0,,2018,12,4,TRANSFER,6400000.0,M584713316
29259,1196428',2018-12-04,RTGS/SBINH18338053948/Indfor,0.0,14100000.0,,2018,12,4,CHECK_CASHING,14100000.0,C1345463476
29260,1196428',2018-12-04,NEFT/20853724981DC/ARTHAS,0.0,3306.0,,2018,12,4,TRANSFER,3306.0,M526335602
29261,1196428',2018-12-04,FDRL/NATIONAL ELECTRONIC F,14900000.0,0.0,,2018,12,4,DEBIT,14900000.0,M446536770
29262,1196428',2018-12-04,Indiaforensic SERVICES INDIA PVT,0.0,81816.0,,2018,12,4,CHECK_CASHING,81816.0,C1937962514
29263,1196428',2018-12-04,NEFT/SBIN418338042276/M S,0.0,3800.0,,2018,12,4,CASH_IN,3800.0,C1697593996
29264,1196428',2018-12-04,FDRL/INTERNAL FUND TRANSFE,50000.0,0.0,,2018,12,4,CHECK_WITHDRAWAL,50000.0,M1054520980
29265,1196428',2018-12-04,FDRL/INTERNAL FUND TRANSFE,50000.0,0.0,,2018,12,4,PAYEMENT,50000.0,C345603257
29266,1196428',2018-12-04,NEFT/000056704543/Indiaforensic,0.0,1200000.0,,2018,12,4,TRANSFER,1200000.0,C1137371968
29267,1196428',2018-12-04,BOWMAN GILFILLAN INC/ZAR/,26520.0,0.0,,2018,12,4,CHECK_WITHDRAWAL,26520.0,M825422529
29268,1196428',2018-12-04,ORTT00701832255,342.74,0.0,,2018,12,4,CHECK_WITHDRAWAL,342.74,C1766973538
29269,1196428',2018-12-04,TRF FROM  Indiaforensic SERVICES,0.0,3200000.0,,2018,12,4,TRANSFER,3200000.0,M269244361
29270,1196428',2018-12-04,TRF FROM  Indiaforensic SERVICES,0.0,600000.0,,2018,12,4,CHECK_CASHING,600000.0,M1598992710
29271,1196428',2018-12-04,FDRL/NATIONAL ELECTRONIC F,14900000.0,0.0,,2018,12,4,PAYEMENT,14900000.0,M1912244374
29272,1196428',2018-12-04,OCCCHQ154637/DEP/UTTARBIH,0.0,11800.0,,2018,12,4,TRANSFER,11800.0,M495126515
29273,1196428',2018-12-04,0991OCC18000565,29.5,0.0,,2018,12,4,DEBIT,29.5,M1784255935
29274,1196428',2018-12-04,BEAT CSH PKP DEL GURGA 77,0.0,36000.0,,2018,12,4,TRANSFER,36000.0,M855013924
29275,1196428',2018-12-05,RTGS/HDFCH18339164475/BAT,0.0,350000.0,,2018,12,5,TRANSFER,350000.0,M1265512372
29276,1196428',2018-12-05,NEFT/N339180695209287/JUN,0.0,130000.0,,2018,12,5,CASH_IN,130000.0,M129449619
29277,1196428',2018-12-05,TRF FROM  Indiaforensic SERVICES,0.0,1800000.0,,2018,12,5,TRANSFER,1800000.0,M896852567
29278,1196428',2018-12-05,RTGS/ICICH18339566051/Indfor,0.0,800000.0,,2018,12,5,CHECK_CASHING,800000.0,M118334838
29279,1196428',2018-12-05,"Indiaforensic USA, INC./USD/1579",0.0,11087528.4,,2018,12,5,TRANSFER,11087528.4,M1908171571
29280,1196428',2018-12-05,IRTT00701835157,3100.76,0.0,,2018,12,5,DEBIT,3100.76,M536879980
29281,1196428',2018-12-05,FDRL/NATIONAL ELECTRONIC F,5000000.0,0.0,,2018,12,5,CASH_OUT,5000000.0,M331661366
29282,1196428',2018-12-05,FDRL/NATIONAL ELECTRONIC F,5000000.0,0.0,,2018,12,5,PAYEMENT,5000000.0,M416461363
29283,1196428',2018-12-05,NEFT/N339180695724685/TEC,0.0,200000.0,,2018,12,5,CASH_IN,200000.0,M809144216
29284,1196428',2018-12-05,TRF FROM  Indiaforensic SERVICES,0.0,12800000.0,,2018,12,5,CASH_IN,12800000.0,M1124830490
29285,1196428',2018-12-05,IMPS 833917650505 FROM OX,0.0,200000.0,,2018,12,5,CASH_IN,200000.0,M1944360353
29286,1196428',2018-12-05,IMPS 833917650560 FROM OX,0.0,200000.0,,2018,12,5,TRANSFER,200000.0,M223525281
29287,1196428',2018-12-05,IMPS 833917650612 FROM OX,0.0,200000.0,,2018,12,5,CHECK_CASHING,200000.0,M2044540303
29288,1196428',2018-12-05,IMPS 833917650678 FROM OX,0.0,200000.0,,2018,12,5,TRANSFER,200000.0,M129993197
29289,1196428',2018-12-05,IMPS 833917650747 FROM OX,0.0,200000.0,,2018,12,5,TRANSFER,200000.0,M646967106
29290,1196428',2018-12-05,FDRL/NATIONAL ELECTRONIC F,14900000.0,0.0,,2018,12,5,PAYEMENT,14900000.0,M130419048
29291,1196428',2018-12-05,FDRL/NATIONAL ELECTRONIC F,14083.2,0.0,,2018,12,5,CHECK_WITHDRAWAL,14083.2,C1360243494
29292,1196428',2018-12-05,IMPS 833917651530 FROM OX,0.0,200000.0,,2018,12,5,CHECK_CASHING,200000.0,M168361210
29293,1196428',2018-12-05,FDRL/INTERNAL FUND TRANSFE,500000.0,0.0,,2018,12,5,DEBIT,500000.0,C1515704208
29294,1196428',2018-12-05,FDRL/INTERNAL FUND TRANSFE,200000.0,0.0,,2018,12,5,DEBIT,200000.0,C1761291320
29295,1196428',2018-12-05,FDRL/INTERNAL FUND TRANSFE,300000.0,0.0,,2018,12,5,DEBIT,300000.0,C1834186423
29296,1196428',2018-12-05,TRF FROM  Indiaforensic SERVICES,0.0,800000.0,,2018,12,5,TRANSFER,800000.0,C929452805
29297,1196428',2018-12-05,TRF FROM  Indiaforensic SERVICES,0.0,500000.0,,2018,12,5,TRANSFER,500000.0,C316919580
29298,1196428',2018-12-05,IMPS 833920148623 FROM SA,0.0,100000.0,,2018,12,5,CHECK_CASHING,100000.0,C371271246
29299,1196428',2018-12-05,IMPS 833920163714 FROM SA,0.0,50000.0,,2018,12,5,CASH_IN,50000.0,C2071722626
29300,1196428',2018-12-06,RTGS/SBINH18340000810/Indfor,0.0,4000000.0,,2018,12,6,CASH_IN,4000000.0,C1535481925
29301,1196428',2018-12-06,FDRL/NATIONAL ELECTRONIC F,3753584.86,0.0,,2018,12,6,CASH_OUT,3753584.86,C1069568462
29302,1196428',2018-12-06,RTGS/SBINH18340000807/Indfor,0.0,14900000.0,,2018,12,6,CHECK_CASHING,14900000.0,C1664927413
29303,1196428',2018-12-06,FDRL/NATIONAL ELECTRONIC F,14900000.0,0.0,,2018,12,6,CASH_OUT,14900000.0,C2143477943
29304,1196428',2018-12-06,FDRL/INTERNAL FUND TRANSFE,500000.0,0.0,,2018,12,6,PAYEMENT,500000.0,C1803078638
29305,1196428',2018-12-06,FDRL/INTERNAL FUND TRANSFE,500000.0,0.0,,2018,12,6,PAYEMENT,500000.0,C814900611
29306,1196428',2018-12-06,CASHDEP/NERUL/,0.0,70500.0,,2018,12,6,CASH_IN,70500.0,C1007483565
29307,1196428',2018-12-06,CHQ DEP/511920/OWDEL1/SBI,0.0,11800.0,,2018,12,6,CHECK_CASHING,11800.0,C1931283804
29308,1196428',2018-12-06,CHQ DEP/13685/OWDEL1/BKID,0.0,11800.0,,2018,12,6,CHECK_CASHING,11800.0,C2106418971
29309,1196428',2018-12-06,NEFT/SBIN518340698061/HIL,0.0,11800.0,,2018,12,6,CHECK_CASHING,11800.0,C1019670582
29310,1196428',2018-12-06,TRF FROM  Indiaforensic SERVICES,0.0,1500000.0,,2018,12,6,TRANSFER,1500000.0,C1429623854
29311,1196428',2018-12-06,RTGS/HDFCH18340469695/BAT,0.0,275000.0,,2018,12,6,CHECK_CASHING,275000.0,C1516565803
29312,1196428',2018-12-06,RTGS/ICICH18340709401/Indfor,0.0,1800000.0,,2018,12,6,TRANSFER,1800000.0,C1782113663
29313,1196428',2018-12-06,NEFT/20859701451DC/ARTHAS,0.0,7507.0,,2018,12,6,CASH_IN,7507.0,C115885991
29314,1196428',2018-12-06,TRF FROM  Indiaforensic SERVICES,0.0,5000000.0,,2018,12,6,TRANSFER,5000000.0,C1113848808
29315,1196428',2018-12-06,IMPS 834017024252 FROM OX,0.0,200000.0,,2018,12,6,CASH_IN,200000.0,C1817886095
29316,1196428',2018-12-06,IMPS 834017024313 FROM OX,0.0,200000.0,,2018,12,6,TRANSFER,200000.0,C798678484
29317,1196428',2018-12-06,IMPS 834017024365 FROM OX,0.0,200000.0,,2018,12,6,CASH_IN,200000.0,C492997256
29318,1196428',2018-12-06,FDRL/NATIONAL ELECTRONIC F,12693108.0,0.0,,2018,12,6,CASH_OUT,12693108.0,C1645903235
29319,1196428',2018-12-06,TRF FROM  Indiaforensic SERVICES,0.0,9500000.0,,2018,12,6,TRANSFER,9500000.0,C1856036778
29320,1196428',2018-12-06,TRF TO  Indiaforensic SERVICES I,50000.0,0.0,,2018,12,6,PAYEMENT,50000.0,C2032924554
29321,1196428',2018-12-06,NEFT/000056864161/Indiaforensic,0.0,500000.0,,2018,12,6,CHECK_CASHING,500000.0,C1014923261
29322,1196428',2018-12-06,STAMP PAPER PURCHASING,100.0,0.0,,2018,12,6,DEBIT,100.0,C1321139761
29323,1196428',2018-12-06,NEFT/N340180696872756/Indfor,0.0,600000.0,,2018,12,6,CHECK_CASHING,600000.0,C559485820
29324,1196428',2018-12-06,BEAT CSH PKP DEL GURGA 77,0.0,56500.0,,2018,12,6,CASH_IN,56500.0,C1186256103
29325,1196428',2018-12-07,NEFT/N341180697366709/TEC,0.0,200000.0,,2018,12,7,CHECK_CASHING,200000.0,C447691425
29326,1196428',2018-12-07,FDRL/REAL TIME GROSS SETTL,10000000.0,0.0,,2018,12,7,PAYEMENT,10000000.0,C442364016
29327,1196428',2018-12-07,RTGS/HDFCH18341531263/BAT,0.0,350000.0,,2018,12,7,CHECK_CASHING,350000.0,C1871196571
29328,1196428',2018-12-07,CHQ DEP/594/OWHYD1/ANDB/T,0.0,11800.0,,2018,12,7,CHECK_CASHING,11800.0,C1486249495
29329,1196428',2018-12-07,CHQ DEP/159387/OWHYD1/SBI,0.0,11800.0,,2018,12,7,CHECK_CASHING,11800.0,C2067546399
29330,1196428',2018-12-07,CHQ DEP/751/OWHYD1/HDFC/W,0.0,11800.0,,2018,12,7,CASH_IN,11800.0,C778306577
29331,1196428',2018-12-07,CHQ DEP/605232/OWHYD1/SBI,0.0,11800.0,,2018,12,7,TRANSFER,11800.0,C1495761010
29332,1196428',2018-12-07,CHQ DEP/191639/OWHYD1/SBI,0.0,11800.0,,2018,12,7,TRANSFER,11800.0,C717951588
29333,1196428',2018-12-07,CHQ DEP/985095/OWHYD1/SBI,0.0,11800.0,,2018,12,7,CHECK_CASHING,11800.0,C1653433120
29334,1196428',2018-12-07,CHQ DEP/809261/OWHYD1/SBI,0.0,11800.0,,2018,12,7,CASH_IN,11800.0,M1499920448
29335,1196428',2018-12-07,CHQ DEP/63439/OWHYD1/SBIN,0.0,11800.0,,2018,12,7,CHECK_CASHING,11800.0,M1162881954
29336,1196428',2018-12-07,CHQ DEP/135/OWHYD1/BARB/T,0.0,11800.0,,2018,12,7,CHECK_CASHING,11800.0,C1457383927
29337,1196428',2018-12-07,CHQ DEP/480286/OWHYD1/SBI,0.0,11800.0,,2018,12,7,TRANSFER,11800.0,C428183334
29338,1196428',2018-12-07,CHQ DEP/67978/OWDEL1/PUNB,0.0,11800.0,,2018,12,7,CHECK_CASHING,11800.0,M1724537291
29339,1196428',2018-12-07,CHQ DEP/1015/OWDEL1/BARB/,0.0,11800.0,,2018,12,7,TRANSFER,11800.0,M1511293665
29340,1196428',2018-12-07,CHQ DEP/141227/OWDEL1/IDI,0.0,11800.0,,2018,12,7,CHECK_CASHING,11800.0,C426416592
29341,1196428',2018-12-07,CHQ DEP/85702/OWDEL1/BKID,0.0,11800.0,,2018,12,7,CHECK_CASHING,11800.0,C1195378184
29342,1196428',2018-12-07,CHQ DEP/799446/OWDEL1/UTB,0.0,11800.0,,2018,12,7,CHECK_CASHING,11800.0,M445063878
29343,1196428',2018-12-07,CHQ DEP/241/OWDEL1/BARB/D,0.0,11800.0,,2018,12,7,TRANSFER,11800.0,M785280006
29344,1196428',2018-12-07,CHQ DEP/602218/OWDEL1/SBI,0.0,11800.0,,2018,12,7,CHECK_CASHING,11800.0,M1015975401
29345,1196428',2018-12-07,CHQ DEP/232672/OWDEL1/PUN,0.0,11800.0,,2018,12,7,CHECK_CASHING,11800.0,C320737482
29346,1196428',2018-12-07,CHQ DEP/822507/OWDEL1/SBI,0.0,11800.0,,2018,12,7,CASH_IN,11800.0,M421231858
29347,1196428',2018-12-07,CHQ DEP/846/OWDEL1/BARB/C,0.0,11800.0,,2018,12,7,CHECK_CASHING,11800.0,M1177862856
29348,1196428',2018-12-07,CHQ DEP/649/OWDEL1/BARB/B,0.0,11800.0,,2018,12,7,TRANSFER,11800.0,C701279123
29349,1196428',2018-12-07,CHQ DEP/838/OWDEL1/BARB/S,0.0,11800.0,,2018,12,7,TRANSFER,11800.0,M305836125
29350,1196428',2018-12-07,CHQ DEP/1508/OWDEL1/BARB/,0.0,11800.0,,2018,12,7,TRANSFER,11800.0,C594250212
29351,1196428',2018-12-07,CHQ DEP/29478/OWDEL1/ALLA,0.0,11800.0,,2018,12,7,CASH_IN,11800.0,M1088945514
29352,1196428',2018-12-07,CHQ DEP/7200/OWDEL1/FDRL/,0.0,8000.0,,2018,12,7,CASH_IN,8000.0,M901807426
29353,1196428',2018-12-07,CHQ DEP/286851/OWDEL1/SBI,0.0,11800.0,,2018,12,7,TRANSFER,11800.0,M2109162412
29354,1196428',2018-12-07,CHQ DEP/299811/OWDEL1/SBI,0.0,11800.0,,2018,12,7,TRANSFER,11800.0,M215986835
29355,1196428',2018-12-07,CHQ DEP/307901/OWDEL1/SBI,0.0,11800.0,,2018,12,7,CASH_IN,11800.0,M1849856235
29356,1196428',2018-12-07,FDRL/INTERNAL FUND TRANSFE,500000.0,0.0,,2018,12,7,PAYEMENT,500000.0,C24119573
29357,1196428',2018-12-07,RTGS/SBINH18341045825/SRI,0.0,200000.0,,2018,12,7,TRANSFER,200000.0,C1406293991
29358,1196428',2018-12-07,RTGS/SBINH18341060064/Indfor,0.0,8500000.0,,2018,12,7,CHECK_CASHING,8500000.0,C1123629720
29359,1196428',2018-12-07,CHQ DEPOSIT RETURN/846/AC,11800.0,0.0,,2018,12,7,CASH_OUT,11800.0,M1108506396
29360,1196428',2018-12-07,RTGS/ICICH18341842013/Indfor,0.0,1000000.0,,2018,12,7,TRANSFER,1000000.0,M1976167370
29361,1196428',2018-12-07,CHQ DEPOSIT RETURN/159387,11800.0,0.0,,2018,12,7,PAYEMENT,11800.0,C1554282047
29362,1196428',2018-12-07,CHQ DEPOSIT RETURN/605232,11800.0,0.0,,2018,12,7,DEBIT,11800.0,C1327282178
29363,1196428',2018-12-07,CHQ DEPOSIT RETURN/809261,11800.0,0.0,,2018,12,7,PAYEMENT,11800.0,C381605910
29364,1196428',2018-12-07,CHQ DEPOSIT RETURN/135/IN,11800.0,0.0,,2018,12,7,CHECK_WITHDRAWAL,11800.0,C1477641326
29365,1196428',2018-12-07,CHQ DEPOSIT RETURN/480286,11800.0,0.0,,2018,12,7,DEBIT,11800.0,M1133230402
29366,1196428',2018-12-07,TRF FROM  Indiaforensic SERVICES,0.0,1900000.0,,2018,12,7,CASH_IN,1900000.0,M283583132
29367,1196428',2018-12-07,NEFT/SBIN618341814447/IND,0.0,1016404.94,,2018,12,7,CASH_IN,1016404.94,C1475998599
29368,1196428',2018-12-07,FDRL/NATIONAL ELECTRONIC F,718390.0,0.0,,2018,12,7,CASH_OUT,718390.0,C1022023283
29369,1196428',2018-12-07,FDRL/NATIONAL ELECTRONIC F,7295750.21,0.0,,2018,12,7,CHECK_WITHDRAWAL,7295750.21,M1050704650
29370,1196428',2018-12-07,FDRL/NATIONAL ELECTRONIC F,2456.0,0.0,,2018,12,7,DEBIT,2456.0,M1606921780
29371,1196428',2018-12-07,FDRL/NATIONAL ELECTRONIC F,9999.0,0.0,,2018,12,7,CASH_OUT,9999.0,M662194817
29372,1196428',2018-12-07,FDRL/NATIONAL ELECTRONIC F,900.0,0.0,,2018,12,7,PAYEMENT,900.0,C643996026
29373,1196428',2018-12-07,NEFT/000056930269/Indiaforensic,0.0,500000.0,,2018,12,7,CHECK_CASHING,500000.0,M287465934
29374,1196428',2018-12-07,FDRL/INTERNAL FUND TRANSFE,500000.0,0.0,,2018,12,7,PAYEMENT,500000.0,M94356250
29375,1196428',2018-12-07,FDRL/INTERNAL FUND TRANSFE,500000.0,0.0,,2018,12,7,CASH_OUT,500000.0,M823573672
29376,1196428',2018-12-07,TRF FROM  Indiaforensic SERVICES,0.0,1500000.0,,2018,12,7,TRANSFER,1500000.0,M1724185160
29377,1196428',2018-12-07,TRF FROM  Indiaforensic SERVICES,0.0,13800000.0,,2018,12,7,TRANSFER,13800000.0,M365194469
29378,1196428',2018-12-07,FDRL/NATIONAL ELECTRONIC F,14900000.0,0.0,,2018,12,7,PAYEMENT,14900000.0,C1691272400
29379,1196428',2018-12-07,UPI/834117676889/COST FOR,0.0,940.0,,2018,12,7,TRANSFER,940.0,M11478640
29380,1196428',2018-12-07,NEFT/N341180698265635/TEC,0.0,200000.0,,2018,12,7,TRANSFER,200000.0,M384891313
29381,1196428',2018-12-07,FDRL/INTERNAL FUND TRANSFE,500000.0,0.0,,2018,12,7,CASH_OUT,500000.0,C1487669283
29382,1196428',2018-12-07,FDRL/INTERNAL FUND TRANSFE,500000.0,0.0,,2018,12,7,CHECK_WITHDRAWAL,500000.0,C428183334
29383,1196428',2018-12-07,FDRL/INTERNAL FUND TRANSFE,2000000.0,0.0,,2018,12,7,PAYEMENT,2000000.0,C1526234185
29384,1196428',2018-12-07,FDRL/INTERNAL FUND TRANSFE,2000000.0,0.0,,2018,12,7,CHECK_WITHDRAWAL,2000000.0,M1646580273
29385,1196428',2018-12-07,IMPS 834118659006 FROM SA,0.0,200000.0,,2018,12,7,CHECK_CASHING,200000.0,C1144070975
29386,1196428',2018-12-07,IMPS 834119679976 FROM SA,0.0,50000.0,,2018,12,7,TRANSFER,50000.0,M1642324564
29387,1196428',2018-12-07,IMPS 834119695724 FROM SA,0.0,25000.0,,2018,12,7,CHECK_CASHING,25000.0,C383371416
29388,1196428',2018-12-07,CHQ DEPOSIT RETURN/159387,100.0,0.0,,2018,12,7,CHECK_WITHDRAWAL,100.0,M1069325566
29389,1196428',2018-12-07,CHQ DEPOSIT RETURN/159387,18.0,0.0,,2018,12,7,CHECK_WITHDRAWAL,18.0,M1956389667
29390,1196428',2018-12-07,CHQ DEPOSIT RETURN/605232,100.0,0.0,,2018,12,7,CASH_OUT,100.0,M791104471
29391,1196428',2018-12-07,CHQ DEPOSIT RETURN/605232,18.0,0.0,,2018,12,7,DEBIT,18.0,M1646021909
29392,1196428',2018-12-07,CHQ DEPOSIT RETURN/809261,100.0,0.0,,2018,12,7,CASH_OUT,100.0,M948831733
29393,1196428',2018-12-07,CHQ DEPOSIT RETURN/809261,18.0,0.0,,2018,12,7,CASH_OUT,18.0,M671738090
29394,1196428',2018-12-07,CHQ DEPOSIT RETURN/480286,100.0,0.0,,2018,12,7,PAYEMENT,100.0,M1500033164
29395,1196428',2018-12-07,CHQ DEPOSIT RETURN/480286,18.0,0.0,,2018,12,7,DEBIT,18.0,C1530086509
29396,1196428',2018-12-10,NEFT/SBIN718344319871/M S,0.0,5000.0,,2018,12,10,CASH_IN,5000.0,C751413576
29397,1196428',2018-12-10,RTGS/HDFCH18344715138/BAT,0.0,500000.0,,2018,12,10,CHECK_CASHING,500000.0,C1210002123
29398,1196428',2018-12-10,CHQ DEP/12379/OWWEST1/AND,0.0,11800.0,,2018,12,10,TRANSFER,11800.0,M1410145533
29399,1196428',2018-12-10,NEFT/AXSK183440001908/SUP,0.0,8260.0,,2018,12,10,CASH_IN,8260.0,C124017533
29400,1196428',2018-12-10,CHQ DEP/136481/OWDEL1/CNR,0.0,11500.0,,2018,12,10,TRANSFER,11500.0,M1212304298
29401,1196428',2018-12-10,CHQ DEP/35460/OWDEL1/PUNB,0.0,11800.0,,2018,12,10,TRANSFER,11800.0,C1129670968
29402,1196428',2018-12-10,CHQ DEP/456818/OWDEL1/SYN,0.0,11800.0,,2018,12,10,CASH_IN,11800.0,M1772586603
29403,1196428',2018-12-10,CHQ DEP/368418/OWDEL1/SBI,0.0,11800.0,,2018,12,10,CASH_IN,11800.0,M1699085373
29404,1196428',2018-12-10,CHQ DEP/8/OWDEL1/HDFC/,0.0,11800.0,,2018,12,10,CASH_IN,11800.0,M1907539879
29405,1196428',2018-12-10,CHQ DEP/976499/OWDEL1/SBI,0.0,11800.0,,2018,12,10,CASH_IN,11800.0,M484895096
29406,1196428',2018-12-10,CHQ DEP/59353/OWDEL1/ORBC,0.0,11800.0,,2018,12,10,CHECK_CASHING,11800.0,M1124718653
29407,1196428',2018-12-10,CHQ DEP/260/OWDEL1/BARB/U,0.0,11800.0,,2018,12,10,CASH_IN,11800.0,M2081364415
29408,1196428',2018-12-10,CHQ DEP/1891/OWDEL1/ALLA/,0.0,11800.0,,2018,12,10,CASH_IN,11800.0,C798678484
29409,1196428',2018-12-10,CHQ DEP/753871/OWDEL1/SBI,0.0,11800.0,,2018,12,10,CASH_IN,11800.0,C2109470512
29410,1196428',2018-12-10,CHQ DEP/103/OWDEL1/HDFC/N,0.0,11800.0,,2018,12,10,CASH_IN,11800.0,C2032924554
29411,1196428',2018-12-10,CHQ DEP/685/OWDEL1/ICIC/J,0.0,11800.0,,2018,12,10,CASH_IN,11800.0,C1802632685
29412,1196428',2018-12-10,CHQ DEP/1562/OWDEL1/HDFC/,0.0,11800.0,,2018,12,10,TRANSFER,11800.0,C1636786811
29413,1196428',2018-12-10,CHQ DEP/328/OWDEL1/HDFC/S,0.0,11800.0,,2018,12,10,CHECK_CASHING,11800.0,C1785910017
29414,1196428',2018-12-10,CHQ DEP/656556/OWDEL1/SBI,0.0,11800.0,,2018,12,10,CASH_IN,11800.0,C1768641212
29415,1196428',2018-12-10,TRF FROM  Indiaforensic SERVICES,0.0,4000000.0,,2018,12,10,CHECK_CASHING,4000000.0,C1255024717
29416,1196428',2018-12-10,FDRL/INTERNAL FUND TRANSFE,50000.0,0.0,,2018,12,10,PAYEMENT,50000.0,C1105527690
29417,1196428',2018-12-10,FDRL/INTERNAL FUND TRANSFE,50000.0,0.0,,2018,12,10,DEBIT,50000.0,C716442925
29418,1196428',2018-12-10,FDRL/INTERNAL FUND TRANSFE,50000.0,0.0,,2018,12,10,CASH_OUT,50000.0,C17820769
29419,1196428',2018-12-10,FDRL/INTERNAL FUND TRANSFE,50000.0,0.0,,2018,12,10,PAYEMENT,50000.0,C2087040347
29420,1196428',2018-12-10,FDRL/INTERNAL FUND TRANSFE,50000.0,0.0,,2018,12,10,PAYEMENT,50000.0,C289045778
29421,1196428',2018-12-10,FDRL/INTERNAL FUND TRANSFE,50000.0,0.0,,2018,12,10,DEBIT,50000.0,C1511785794
29422,1196428',2018-12-10,IMPS 834413629614 FROM SA,0.0,30000.0,,2018,12,10,CASH_IN,30000.0,C346008447
29423,1196428',2018-12-10,NEFT/JAKA181210866917/EVE,0.0,11800.0,,2018,12,10,CHECK_CASHING,11800.0,C1320515149
29424,1196428',2018-12-10,RTGS/HDFCH18344766398/Indfor,0.0,6100000.0,,2018,12,10,TRANSFER,6100000.0,C2072865894
29425,1196428',2018-12-10,CHQ DEPOSIT RETURN/976499,11800.0,0.0,,2018,12,10,DEBIT,11800.0,C679235222
29426,1196428',2018-12-10,CASHDEP/NERUL/,0.0,59000.0,,2018,12,10,TRANSFER,59000.0,C861720625
29427,1196428',2018-12-10,FDRL/INTERNAL FUND TRANSFE,500000.0,0.0,,2018,12,10,CASH_OUT,500000.0,C1047634424
29428,1196428',2018-12-10,FDRL/NATIONAL ELECTRONIC F,10226606.19,0.0,,2018,12,10,CHECK_WITHDRAWAL,10226606.19,M1785122074
29429,1196428',2018-12-10,TRF FROM  Indiaforensic SERVICES,0.0,10000000.0,,2018,12,10,CASH_IN,10000000.0,M541190792
29430,1196428',2018-12-10,TRF FROM  Indiaforensic SERVICES,0.0,3000000.0,,2018,12,10,TRANSFER,3000000.0,C480500119
29431,1196428',2018-12-10,TRF FROM  Indiaforensic SERVICES,0.0,1200000.0,,2018,12,10,CHECK_CASHING,1200000.0,C1196307684
29432,1196428',2018-12-10,TRF TO  Indiaforensic SERVICES I,373047.0,0.0,,2018,12,10,PAYEMENT,373047.0,M1112250637
29433,1196428',2018-12-10,IMPS 834417345280 FROM OX,0.0,200000.0,,2018,12,10,CHECK_CASHING,200000.0,C1329589315
29434,1196428',2018-12-10,FDRL/NATIONAL ELECTRONIC F,14900000.0,0.0,,2018,12,10,CHECK_WITHDRAWAL,14900000.0,M1794907886
29435,1196428',2018-12-10,TRF FROM  Indiaforensic SERVICES,0.0,15000000.0,,2018,12,10,CASH_IN,15000000.0,M929949615
29436,1196428',2018-12-10,FDRL/NATIONAL ELECTRONIC F,14900000.0,0.0,,2018,12,10,DEBIT,14900000.0,M460810919
29437,1196428',2018-12-10,PBGI01001800355:Bank Guar,23600.0,0.0,,2018,12,10,CASH_OUT,23600.0,M1022056497
29438,1196428',2018-12-10,TRF FROM  Indiaforensic SERVICES,0.0,10000000.0,,2018,12,10,CASH_IN,10000000.0,M1029105455
29439,1196428',2018-12-10,FDRL/INTERNAL FUND TRANSFE,500000.0,0.0,,2018,12,10,DEBIT,500000.0,C68113386
29440,1196428',2018-12-10,FDRL/INTERNAL FUND TRANSFE,2000000.0,0.0,,2018,12,10,PAYEMENT,2000000.0,C1526234185
29441,1196428',2018-12-10,NEFT/SBIN818344275488/Indfor,0.0,2500000.0,,2018,12,10,CASH_IN,2500000.0,C1871689990
29442,1196428',2018-12-10,BEAT CSH PKP DEL GURGA 77,0.0,113500.0,,2018,12,10,CHECK_CASHING,113500.0,C2145961947
29443,1196428',2018-12-10,CHQ DEPOSIT RETURN/976499,100.0,0.0,,2018,12,10,PAYEMENT,100.0,C1727331144
29444,1196428',2018-12-10,CHQ DEPOSIT RETURN/976499,18.0,0.0,,2018,12,10,PAYEMENT,18.0,M309346040
29445,1196428',2018-12-11,FDRL/NATIONAL ELECTRONIC F,15897.0,0.0,,2018,12,11,DEBIT,15897.0,M181836961
29446,1196428',2018-12-11,CASHDEP/NERUL/,0.0,61400.0,,2018,12,11,CHECK_CASHING,61400.0,M1133134634
29447,1196428',2018-12-11,FDRL/INTERNAL FUND TRANSFE,500000.0,0.0,,2018,12,11,CASH_OUT,500000.0,M2055376904
29448,1196428',2018-12-11,FDRL/NATIONAL ELECTRONIC F,17684.0,0.0,,2018,12,11,CASH_OUT,17684.0,C1162775738
29449,1196428',2018-12-11,FDRL/NATIONAL ELECTRONIC F,17685.0,0.0,,2018,12,11,CASH_OUT,17685.0,M2003953605
29450,1196428',2018-12-11,FDRL/NATIONAL ELECTRONIC F,40968.0,0.0,,2018,12,11,CHECK_WITHDRAWAL,40968.0,M551122271
29451,1196428',2018-12-11,FDRL/NATIONAL ELECTRONIC F,17095.0,0.0,,2018,12,11,DEBIT,17095.0,C1162775738
29452,1196428',2018-12-11,FDRL/NATIONAL ELECTRONIC F,13263.0,0.0,,2018,12,11,CHECK_WITHDRAWAL,13263.0,M340123938
29453,1196428',2018-12-11,Indiaforensic SERVICES INDIA PVT,0.0,1815018.0,,2018,12,11,TRANSFER,1815018.0,M1736328722
29454,1196428',2018-12-11,TRF FROM  Indiaforensic SERVICES,0.0,5000000.0,,2018,12,11,TRANSFER,5000000.0,M12946632
29455,1196428',2018-12-11,TRF FROM  Indiaforensic SERVICES,0.0,1000000.0,,2018,12,11,CASH_IN,1000000.0,M37743965
29456,1196428',2018-12-11,FDRL/REAL TIME GROSS SETTL,15000000.0,0.0,,2018,12,11,PAYEMENT,15000000.0,C596299019
29457,1196428',2018-12-11,FDRL/REAL TIME GROSS SETTL,1000000.0,0.0,,2018,12,11,DEBIT,1000000.0,C22448303
29458,1196428',2018-12-11,FDRL/REAL TIME GROSS SETTL,1000000.0,0.0,,2018,12,11,PAYEMENT,1000000.0,C362966988
29459,1196428',2018-12-11,RTGS/ICICH18345371708/Indfor,0.0,2000000.0,,2018,12,11,CASH_IN,2000000.0,C1237095816
29460,1196428',2018-12-11,NEFT/SBIN818345664998/M S,0.0,20000.0,,2018,12,11,TRANSFER,20000.0,C1993311391
29461,1196428',2018-12-11,NEFT/000057062481/Indiaforensic,0.0,2000000.0,,2018,12,11,TRANSFER,2000000.0,C285527187
29462,1196428',2018-12-11,NEFT/000057061217/Indiaforensic,0.0,1500000.0,,2018,12,11,CHECK_CASHING,1500000.0,M636870733
29463,1196428',2018-12-11,NEFT/000057063223/Indiaforensic,0.0,500000.0,,2018,12,11,CASH_IN,500000.0,M1555825276
29464,1196428',2018-12-11,TRF FROM  Indiaforensic SERVICES,0.0,4500000.0,,2018,12,11,TRANSFER,4500000.0,M1755654501
29465,1196428',2018-12-11,RTGS/ICICH18345410541/Indfor,0.0,500000.0,,2018,12,11,TRANSFER,500000.0,M688092799
29466,1196428',2018-12-11,CHQ DEP/20239/OWMUM5/BKDN,0.0,11800.0,,2018,12,11,CASH_IN,11800.0,M1208189031
29467,1196428',2018-12-11,CHQ DEP/121/OWMUM5/BARB/A,0.0,11800.0,,2018,12,11,CHECK_CASHING,11800.0,M1859114989
29468,1196428',2018-12-11,CHQ DEP/2965/OWMUM5/ICIC/,0.0,11800.0,,2018,12,11,CASH_IN,11800.0,M1353507228
29469,1196428',2018-12-11,CHQ DEP/294007/OWMUM5/UTI,0.0,11800.0,,2018,12,11,TRANSFER,11800.0,C1950696591
29470,1196428',2018-12-11,CHQ DEP/331/OWMUM5/BARB/H,0.0,11800.0,,2018,12,11,CHECK_CASHING,11800.0,C1569007457
29471,1196428',2018-12-11,CHQ DEP/2287/OWMUM5/BARB/,0.0,11800.0,,2018,12,11,CHECK_CASHING,11800.0,M46206298
29472,1196428',2018-12-11,CHQ DEP/132/OWMUM5/HDFC/D,0.0,11800.0,,2018,12,11,CHECK_CASHING,11800.0,C1788961047
29473,1196428',2018-12-11,CHQ DEP/537/OWMUM5/HDFC/D,0.0,11800.0,,2018,12,11,CHECK_CASHING,11800.0,M346794051
29474,1196428',2018-12-11,CHQ DEP/5732/OWMUM5/UBIN/,0.0,11800.0,,2018,12,11,TRANSFER,11800.0,C883252426
29475,1196428',2018-12-11,CASHDEP/GURGAON/,0.0,80000.0,,2018,12,11,CHECK_CASHING,80000.0,C1219273867
29476,1196428',2018-12-11,RTGS/UTIBH18345624177/Indfor,0.0,5000000.0,,2018,12,11,CHECK_CASHING,5000000.0,C1923206317
29477,1196428',2018-12-11,TRF FROM  Indiaforensic SERVICES,0.0,4900000.0,,2018,12,11,TRANSFER,4900000.0,C341552838
29478,1196428',2018-12-11,RTGS/SBINH18345053992/Indfor,0.0,10800000.0,,2018,12,11,TRANSFER,10800000.0,M403128001
29479,1196428',2018-12-11,FDRL/INTERNAL FUND TRANSFE,500000.0,0.0,,2018,12,11,PAYEMENT,500000.0,M1392701465
29480,1196428',2018-12-11,FDRL/NATIONAL ELECTRONIC F,9185173.24,0.0,,2018,12,11,CHECK_WITHDRAWAL,9185173.24,C1320217924
29481,1196428',2018-12-11,FDRL/NATIONAL ELECTRONIC F,6442085.68,0.0,,2018,12,11,CHECK_WITHDRAWAL,6442085.68,C52620058
29482,1196428',2018-12-11,FDRL/NATIONAL ELECTRONIC F,14900000.0,0.0,,2018,12,11,CHECK_WITHDRAWAL,14900000.0,C2040656033
29483,1196428',2018-12-11,NEFT/SBIN918345312393/M S,0.0,20000.0,,2018,12,11,CHECK_CASHING,20000.0,C1273939873
29484,1196428',2018-12-11,TRF FRM 409000362497  Indfor,0.0,45620.0,,2018,12,11,CASH_IN,45620.0,C18928637
29485,1196428',2018-12-11,IMPS 834517725941 FROM OX,0.0,200000.0,,2018,12,11,CHECK_CASHING,200000.0,C2016335685
29486,1196428',2018-12-11,IMPS 834517725999 FROM OX,0.0,200000.0,,2018,12,11,TRANSFER,200000.0,C1498878963
29487,1196428',2018-12-11,IMPS 834517726044 FROM OX,0.0,200000.0,,2018,12,11,CHECK_CASHING,200000.0,M265664109
29488,1196428',2018-12-11,IMPS 834517726102 FROM OX,0.0,200000.0,,2018,12,11,CASH_IN,200000.0,M436978593
29489,1196428',2018-12-11,IMPS 834517726156 FROM OX,0.0,200000.0,,2018,12,11,TRANSFER,200000.0,C774480275
29490,1196428',2018-12-11,IMPS 834517726205 FROM OX,0.0,200000.0,,2018,12,11,CASH_IN,200000.0,C1958390694
29491,1196428',2018-12-11,IMPS 834517726244 FROM OX,0.0,200000.0,,2018,12,11,CHECK_CASHING,200000.0,C2083562754
29492,1196428',2018-12-11,IMPS 834517726323 FROM OX,0.0,200000.0,,2018,12,11,CHECK_CASHING,200000.0,C408304912
29493,1196428',2018-12-11,IMPS 834517726363 FROM OX,0.0,200000.0,,2018,12,11,CHECK_CASHING,200000.0,C2077672286
29494,1196428',2018-12-11,IMPS 834517726408 FROM OX,0.0,200000.0,,2018,12,11,TRANSFER,200000.0,C266912553
29495,1196428',2018-12-11,IMPS 834517726973 FROM OX,0.0,200000.0,,2018,12,11,CASH_IN,200000.0,C874023329
29496,1196428',2018-12-11,IMPS 834517727039 FROM OX,0.0,200000.0,,2018,12,11,CHECK_CASHING,200000.0,C381390837
29497,1196428',2018-12-11,IMPS 834517727079 FROM OX,0.0,200000.0,,2018,12,11,CASH_IN,200000.0,C1536044711
29498,1196428',2018-12-11,IMPS 834517727121 FROM OX,0.0,200000.0,,2018,12,11,CASH_IN,200000.0,C1749476584
29499,1196428',2018-12-11,IMPS 834517727194 FROM OX,0.0,200000.0,,2018,12,11,TRANSFER,200000.0,C476800120
29500,1196428',2018-12-11,IMPS 834517727245 FROM OX,0.0,200000.0,,2018,12,11,TRANSFER,200000.0,C1379289710
29501,1196428',2018-12-11,IMPS 834517727284 FROM OX,0.0,200000.0,,2018,12,11,CHECK_CASHING,200000.0,C1756877039
29502,1196428',2018-12-11,IMPS 834517727328 FROM OX,0.0,200000.0,,2018,12,11,CHECK_CASHING,200000.0,C2050019814
29503,1196428',2018-12-11,IMPS 834517727367 FROM OX,0.0,200000.0,,2018,12,11,TRANSFER,200000.0,C1515704208
29504,1196428',2018-12-11,IMPS 834517727429 FROM OX,0.0,200000.0,,2018,12,11,TRANSFER,200000.0,C434091818
29505,1196428',2018-12-11,IMPS 834517728282 FROM OX,0.0,200000.0,,2018,12,11,CASH_IN,200000.0,C1847509784
29506,1196428',2018-12-11,IMPS 834517728341 FROM OX,0.0,200000.0,,2018,12,11,CHECK_CASHING,200000.0,C256125761
29507,1196428',2018-12-11,IMPS 834517728402 FROM OX,0.0,200000.0,,2018,12,11,CHECK_CASHING,200000.0,C655391383
29508,1196428',2018-12-11,IMPS 834517728449 FROM OX,0.0,200000.0,,2018,12,11,CHECK_CASHING,200000.0,C1389405694
29509,1196428',2018-12-11,IMPS 834517728522 FROM OX,0.0,200000.0,,2018,12,11,CHECK_CASHING,200000.0,C202149782
29510,1196428',2018-12-11,IMPS 834517728595 FROM OX,0.0,200000.0,,2018,12,11,TRANSFER,200000.0,C1136186114
29511,1196428',2018-12-11,IMPS 834517728643 FROM OX,0.0,200000.0,,2018,12,11,CHECK_CASHING,200000.0,C1023535667
29512,1196428',2018-12-11,IMPS 834517728718 FROM OX,0.0,200000.0,,2018,12,11,CASH_IN,200000.0,C184253187
29513,1196428',2018-12-11,IMPS 834517728783 FROM OX,0.0,200000.0,,2018,12,11,TRANSFER,200000.0,C720759478
29514,1196428',2018-12-11,IMPS 834517728867 FROM OX,0.0,200000.0,,2018,12,11,CHECK_CASHING,200000.0,C314245922
29515,1196428',2018-12-11,NEFT/PUNBB18345004248/BIK,0.0,11800.0,,2018,12,11,CHECK_CASHING,11800.0,C295081230
29516,1196428',2018-12-11,TRF FROM  Indiaforensic SERVICES,0.0,4000000.0,,2018,12,11,CHECK_CASHING,4000000.0,C214774813
29517,1196428',2018-12-11,TRF FROM  Indiaforensic SERVICES,0.0,3000000.0,,2018,12,11,TRANSFER,3000000.0,C2078448324
29518,1196428',2018-12-11,NEFT CHARGES AND GST/0000,29.5,0.0,,2018,12,11,DEBIT,29.5,C1220897602
29519,1196428',2018-12-11,NEFT/000059528576/INDIAN,13968013.0,0.0,,2018,12,11,CASH_OUT,13968013.0,C776404949
29520,1196428',2018-12-11,BEAT CSH PKP DEL GURGA 77,0.0,73100.0,,2018,12,11,CASH_IN,73100.0,C510382951
29521,1196428',2018-12-12,RTGS/PUNBH18346822665/BAL,0.0,200000.0,,2018,12,12,CHECK_CASHING,200000.0,C381390837
29522,1196428',2018-12-12,FDRL/INTERNAL FUND TRANSFE,500000.0,0.0,,2018,12,12,CASH_OUT,500000.0,C75457651
29523,1196428',2018-12-12,NEFT/SBIN118346430622/M S,0.0,10000.0,,2018,12,12,TRANSFER,10000.0,C352202338
29524,1196428',2018-12-12,RTGS/HDFCH18346124473/JUN,0.0,200000.0,,2018,12,12,TRANSFER,200000.0,C1058664855
29525,1196428',2018-12-12,NEFT/JAKA181212884531/SHA,0.0,11800.0,,2018,12,12,CASH_IN,11800.0,C891020651
29526,1196428',2018-12-12,TRF FROM  Indiaforensic SERVICES,0.0,3300000.0,,2018,12,12,CHECK_CASHING,3300000.0,C1673971173
29527,1196428',2018-12-12,TRF FROM  Indiaforensic SERVICES,0.0,900000.0,,2018,12,12,CASH_IN,900000.0,C1198167820
29528,1196428',2018-12-12,TRF FROM  Indiaforensic SERVICES,0.0,1100000.0,,2018,12,12,CASH_IN,1100000.0,C746359178
29529,1196428',2018-12-12,FDRL/INTERNAL FUND TRANSFE,500000.0,0.0,,2018,12,12,CHECK_WITHDRAWAL,500000.0,C2116802101
29530,1196428',2018-12-12,FDRL/INTERNAL FUND TRANSFE,500000.0,0.0,,2018,12,12,CHECK_WITHDRAWAL,500000.0,C607702142
29531,1196428',2018-12-12,RTGS/ICICH18346535245/Indfor,0.0,5200000.0,,2018,12,12,CASH_IN,5200000.0,C590842329
29532,1196428',2018-12-12,CASHDEP/GHATKOPAR/,0.0,10561.0,,2018,12,12,CHECK_CASHING,10561.0,C1515979807
29533,1196428',2018-12-12,RTGS/HDFCH18346191588/BAT,0.0,500000.0,,2018,12,12,TRANSFER,500000.0,C175382361
29534,1196428',2018-12-12,NEFT/000057157897/Indiaforensic,0.0,1200000.0,,2018,12,12,TRANSFER,1200000.0,C515442419
29535,1196428',2018-12-12,"Indiaforensic USA, INC./USD/1369",0.0,9817594.2,,2018,12,12,TRANSFER,9817594.2,C921424481
29536,1196428',2018-12-12,IRTT00701835938,2872.17,0.0,,2018,12,12,PAYEMENT,2872.17,C1734649556
29537,1196428',2018-12-12,Indiaforensic SERVICES INDIA PVT,0.0,83706.0,,2018,12,12,CASH_IN,83706.0,C1760872167
29538,1196428',2018-12-12,FDRL/NATIONAL ELECTRONIC F,14900000.0,0.0,,2018,12,12,CASH_OUT,14900000.0,C842729010
29539,1196428',2018-12-12,FDRL/NATIONAL ELECTRONIC F,6407054.01,0.0,,2018,12,12,DEBIT,6407054.01,C1727331144
29540,1196428',2018-12-12,NEFT/FDRL979893798/ARTHASH,0.0,25000.0,,2018,12,12,CASH_IN,25000.0,C1515979807
29541,1196428',2018-12-12,TRF FRM 409000362497  Indfor,0.0,83706.0,,2018,12,12,CASH_IN,83706.0,C1655039175
29542,1196428',2018-12-12,WRONGLY CREDITED TWICE 12,83706.0,0.0,,2018,12,12,CASH_OUT,83706.0,C593210287
29543,1196428',2018-12-12,TRF FROM  Indiaforensic SERVICES,0.0,5000000.0,,2018,12,12,CASH_IN,5000000.0,C214774813
29544,1196428',2018-12-12,TRF FROM  Indiaforensic SERVICES,0.0,5000000.0,,2018,12,12,CHECK_CASHING,5000000.0,C143580560
29545,1196428',2018-12-12,TRF FROM  Indiaforensic SERVICES,0.0,4000000.0,,2018,12,12,TRANSFER,4000000.0,C1684776894
29546,1196428',2018-12-12,FDRL/INTERNAL FUND TRANSFE,100000.0,0.0,,2018,12,12,CHECK_WITHDRAWAL,100000.0,C406477119
29547,1196428',2018-12-12,FDRL/INTERNAL FUND TRANSFE,2000000.0,0.0,,2018,12,12,PAYEMENT,2000000.0,C1653433120
29548,1196428',2018-12-12,TRF TO  Indiaforensic SERVICES I,115000.0,0.0,,2018,12,12,PAYEMENT,115000.0,C218193338
29549,1196428',2018-12-12,FDRL/INTERNAL FUND TRANSFE,1000000.0,0.0,,2018,12,12,CHECK_WITHDRAWAL,1000000.0,C728885526
29550,1196428',2018-12-12,FDRL/INTERNAL FUND TRANSFE,500000.0,0.0,,2018,12,12,CASH_OUT,500000.0,C914293025
29551,1196428',2018-12-13,FDRL/NATIONAL ELECTRONIC F,16021.0,0.0,,2018,12,13,CASH_OUT,16021.0,C1210180003
29552,1196428',2018-12-13,FDRL/NATIONAL ELECTRONIC F,77500.0,0.0,,2018,12,13,CHECK_WITHDRAWAL,77500.0,C1692142175
29553,1196428',2018-12-13,FDRL/NATIONAL ELECTRONIC F,45200.0,0.0,,2018,12,13,CASH_OUT,45200.0,C954697228
29554,1196428',2018-12-13,FDRL/NATIONAL ELECTRONIC F,54240.0,0.0,,2018,12,13,DEBIT,54240.0,C17820769
29555,1196428',2018-12-13,FDRL/NATIONAL ELECTRONIC F,58760.0,0.0,,2018,12,13,CASH_OUT,58760.0,C1360767589
29556,1196428',2018-12-13,FDRL/NATIONAL ELECTRONIC F,50925.0,0.0,,2018,12,13,DEBIT,50925.0,C1189861498
29557,1196428',2018-12-13,FDRL/NATIONAL ELECTRONIC F,32544.0,0.0,,2018,12,13,DEBIT,32544.0,C519458373
29558,1196428',2018-12-13,FDRL/NATIONAL ELECTRONIC F,26825.0,0.0,,2018,12,13,CASH_OUT,26825.0,C284399568
29559,1196428',2018-12-13,FDRL/NATIONAL ELECTRONIC F,17271.0,0.0,,2018,12,13,DEBIT,17271.0,C1249000159
29560,1196428',2018-12-13,FDRL/NATIONAL ELECTRONIC F,16187.0,0.0,,2018,12,13,PAYEMENT,16187.0,M1996932205
29561,1196428',2018-12-13,FDRL/NATIONAL ELECTRONIC F,22360.0,0.0,,2018,12,13,CASH_OUT,22360.0,C302870502
29562,1196428',2018-12-13,FDRL/NATIONAL ELECTRONIC F,18092.0,0.0,,2018,12,13,CHECK_WITHDRAWAL,18092.0,M1618178090
29563,1196428',2018-12-13,FDRL/NATIONAL ELECTRONIC F,13697.0,0.0,,2018,12,13,DEBIT,13697.0,M1371833986
29564,1196428',2018-12-13,FDRL/NATIONAL ELECTRONIC F,15824.0,0.0,,2018,12,13,CASH_OUT,15824.0,M1837244843
29565,1196428',2018-12-13,FDRL/NATIONAL ELECTRONIC F,26277.0,0.0,,2018,12,13,PAYEMENT,26277.0,C570588770
29566,1196428',2018-12-13,FDRL/NATIONAL ELECTRONIC F,19252.0,0.0,,2018,12,13,CASH_OUT,19252.0,M1340625046
29567,1196428',2018-12-13,FDRL/NATIONAL ELECTRONIC F,11909.0,0.0,,2018,12,13,CASH_OUT,11909.0,M1655149992
29568,1196428',2018-12-13,FDRL/NATIONAL ELECTRONIC F,15171.0,0.0,,2018,12,13,DEBIT,15171.0,C2046578329
29569,1196428',2018-12-13,FDRL/NATIONAL ELECTRONIC F,16809.0,0.0,,2018,12,13,DEBIT,16809.0,C1624533975
29570,1196428',2018-12-13,FDRL/NATIONAL ELECTRONIC F,27532.0,0.0,,2018,12,13,CHECK_WITHDRAWAL,27532.0,C1891412311
29571,1196428',2018-12-13,FDRL/NATIONAL ELECTRONIC F,11737.0,0.0,,2018,12,13,PAYEMENT,11737.0,C1508456612
29572,1196428',2018-12-13,FDRL/NATIONAL ELECTRONIC F,13816.0,0.0,,2018,12,13,CASH_OUT,13816.0,M1372621296
29573,1196428',2018-12-13,FDRL/NATIONAL ELECTRONIC F,14424.0,0.0,,2018,12,13,DEBIT,14424.0,C703957828
29574,1196428',2018-12-13,FDRL/NATIONAL ELECTRONIC F,23520.0,0.0,,2018,12,13,CHECK_WITHDRAWAL,23520.0,M151368577
29575,1196428',2018-12-13,FDRL/NATIONAL ELECTRONIC F,12244.0,0.0,,2018,12,13,CASH_OUT,12244.0,C439917369
29576,1196428',2018-12-13,FDRL/NATIONAL ELECTRONIC F,28288.0,0.0,,2018,12,13,CHECK_WITHDRAWAL,28288.0,M1934175175
29577,1196428',2018-12-13,FDRL/NATIONAL ELECTRONIC F,26227.0,0.0,,2018,12,13,PAYEMENT,26227.0,M1916568790
29578,1196428',2018-12-13,FDRL/NATIONAL ELECTRONIC F,19146.0,0.0,,2018,12,13,PAYEMENT,19146.0,C495071437
29579,1196428',2018-12-13,FDRL/NATIONAL ELECTRONIC F,25650.0,0.0,,2018,12,13,DEBIT,25650.0,C1111747867
29580,1196428',2018-12-13,FDRL/NATIONAL ELECTRONIC F,13084.0,0.0,,2018,12,13,DEBIT,13084.0,C1196307684
29581,1196428',2018-12-13,FDRL/NATIONAL ELECTRONIC F,12953.0,0.0,,2018,12,13,PAYEMENT,12953.0,C1684776894
29582,1196428',2018-12-13,FDRL/NATIONAL ELECTRONIC F,19449.0,0.0,,2018,12,13,DEBIT,19449.0,M739821537
29583,1196428',2018-12-13,FDRL/NATIONAL ELECTRONIC F,12351.0,0.0,,2018,12,13,CHECK_WITHDRAWAL,12351.0,C815264031
29584,1196428',2018-12-13,FDRL/NATIONAL ELECTRONIC F,19560.0,0.0,,2018,12,13,CHECK_WITHDRAWAL,19560.0,C1479450980
29585,1196428',2018-12-13,FDRL/NATIONAL ELECTRONIC F,17895.0,0.0,,2018,12,13,DEBIT,17895.0,C1316198760
29586,1196428',2018-12-13,FDRL/NATIONAL ELECTRONIC F,15543.0,0.0,,2018,12,13,DEBIT,15543.0,M302555099
29587,1196428',2018-12-13,FDRL/NATIONAL ELECTRONIC F,26400.0,0.0,,2018,12,13,DEBIT,26400.0,C922062853
29588,1196428',2018-12-13,FDRL/NATIONAL ELECTRONIC F,29022.0,0.0,,2018,12,13,CHECK_WITHDRAWAL,29022.0,C1469084143
29589,1196428',2018-12-13,FDRL/NATIONAL ELECTRONIC F,21933.0,0.0,,2018,12,13,PAYEMENT,21933.0,C1971344738
29590,1196428',2018-12-13,FDRL/NATIONAL ELECTRONIC F,28900.0,0.0,,2018,12,13,CHECK_WITHDRAWAL,28900.0,C1373172466
29591,1196428',2018-12-13,FDRL/NATIONAL ELECTRONIC F,21975.0,0.0,,2018,12,13,PAYEMENT,21975.0,C767904468
29592,1196428',2018-12-13,FDRL/NATIONAL ELECTRONIC F,22600.0,0.0,,2018,12,13,CHECK_WITHDRAWAL,22600.0,C1369695156
29593,1196428',2018-12-13,FDRL/NATIONAL ELECTRONIC F,7510.0,0.0,,2018,12,13,PAYEMENT,7510.0,C370055648
29594,1196428',2018-12-13,FDRL/NATIONAL ELECTRONIC F,25719.0,0.0,,2018,12,13,DEBIT,25719.0,C611572016
29595,1196428',2018-12-13,FDRL/NATIONAL ELECTRONIC F,23105.0,0.0,,2018,12,13,CHECK_WITHDRAWAL,23105.0,C216084411
29596,1196428',2018-12-13,FDRL/NATIONAL ELECTRONIC F,14814.0,0.0,,2018,12,13,CASH_OUT,14814.0,C1491213790
29597,1196428',2018-12-13,FDRL/NATIONAL ELECTRONIC F,22600.0,0.0,,2018,12,13,CASH_OUT,22600.0,C1753295732
29598,1196428',2018-12-13,FDRL/NATIONAL ELECTRONIC F,22600.0,0.0,,2018,12,13,CHECK_WITHDRAWAL,22600.0,C265184085
29599,1196428',2018-12-13,FDRL/NATIONAL ELECTRONIC F,15112.0,0.0,,2018,12,13,CHECK_WITHDRAWAL,15112.0,C587433505
29600,1196428',2018-12-13,FDRL/NATIONAL ELECTRONIC F,24235.0,0.0,,2018,12,13,CHECK_WITHDRAWAL,24235.0,C58333888
29601,1196428',2018-12-13,FDRL/NATIONAL ELECTRONIC F,17271.0,0.0,,2018,12,13,CASH_OUT,17271.0,C1276424637
29602,1196428',2018-12-13,FDRL/NATIONAL ELECTRONIC F,16842.0,0.0,,2018,12,13,PAYEMENT,16842.0,C1354774829
29603,1196428',2018-12-13,FDRL/NATIONAL ELECTRONIC F,9529.0,0.0,,2018,12,13,CASH_OUT,9529.0,C382934088
29604,1196428',2018-12-13,FDRL/NATIONAL ELECTRONIC F,24860.0,0.0,,2018,12,13,PAYEMENT,24860.0,C1298177219
29605,1196428',2018-12-13,FDRL/NATIONAL ELECTRONIC F,19720.0,0.0,,2018,12,13,CASH_OUT,19720.0,C1688071442
29606,1196428',2018-12-13,FDRL/NATIONAL ELECTRONIC F,25000.0,0.0,,2018,12,13,CHECK_WITHDRAWAL,25000.0,C1409342334
29607,1196428',2018-12-13,FDRL/NATIONAL ELECTRONIC F,8395.0,0.0,,2018,12,13,PAYEMENT,8395.0,C721267591
29608,1196428',2018-12-13,FDRL/NATIONAL ELECTRONIC F,24860.0,0.0,,2018,12,13,PAYEMENT,24860.0,C127252077
29609,1196428',2018-12-13,FDRL/NATIONAL ELECTRONIC F,24860.0,0.0,,2018,12,13,CASH_OUT,24860.0,M393386110
29610,1196428',2018-12-13,FDRL/NATIONAL ELECTRONIC F,24860.0,0.0,,2018,12,13,PAYEMENT,24860.0,C1379031360
29611,1196428',2018-12-13,FDRL/NATIONAL ELECTRONIC F,19069.0,0.0,,2018,12,13,PAYEMENT,19069.0,M580085236
29612,1196428',2018-12-13,FDRL/NATIONAL ELECTRONIC F,15052.0,0.0,,2018,12,13,CHECK_WITHDRAWAL,15052.0,M817545888
29613,1196428',2018-12-13,FDRL/NATIONAL ELECTRONIC F,24860.0,0.0,,2018,12,13,CASH_OUT,24860.0,M1086042677
29614,1196428',2018-12-13,FDRL/NATIONAL ELECTRONIC F,11368.0,0.0,,2018,12,13,DEBIT,11368.0,M180000326
29615,1196428',2018-12-13,FDRL/NATIONAL ELECTRONIC F,15052.0,0.0,,2018,12,13,DEBIT,15052.0,C46748390
29616,1196428',2018-12-13,FDRL/NATIONAL ELECTRONIC F,24860.0,0.0,,2018,12,13,PAYEMENT,24860.0,C1266035080
29617,1196428',2018-12-13,FDRL/NATIONAL ELECTRONIC F,24860.0,0.0,,2018,12,13,CHECK_WITHDRAWAL,24860.0,M897492078
29618,1196428',2018-12-13,FDRL/NATIONAL ELECTRONIC F,13259.0,0.0,,2018,12,13,CASH_OUT,13259.0,M300514815
29619,1196428',2018-12-13,FDRL/NATIONAL ELECTRONIC F,15052.0,0.0,,2018,12,13,CASH_OUT,15052.0,M2051586326
29620,1196428',2018-12-13,FDRL/NATIONAL ELECTRONIC F,27120.0,0.0,,2018,12,13,CHECK_WITHDRAWAL,27120.0,C1354774829
29621,1196428',2018-12-13,FDRL/NATIONAL ELECTRONIC F,12596.0,0.0,,2018,12,13,DEBIT,12596.0,C716083600
29622,1196428',2018-12-13,FDRL/NATIONAL ELECTRONIC F,15052.0,0.0,,2018,12,13,CHECK_WITHDRAWAL,15052.0,C715007517
29623,1196428',2018-12-13,FDRL/NATIONAL ELECTRONIC F,24659.0,0.0,,2018,12,13,CASH_OUT,24659.0,C374625527
29624,1196428',2018-12-13,FDRL/NATIONAL ELECTRONIC F,24859.0,0.0,,2018,12,13,CHECK_WITHDRAWAL,24859.0,C1083962448
29625,1196428',2018-12-13,FDRL/NATIONAL ELECTRONIC F,26366.0,0.0,,2018,12,13,PAYEMENT,26366.0,C121488263
29626,1196428',2018-12-13,FDRL/NATIONAL ELECTRONIC F,15052.0,0.0,,2018,12,13,DEBIT,15052.0,C602874477
29627,1196428',2018-12-13,FDRL/NATIONAL ELECTRONIC F,24659.0,0.0,,2018,12,13,CASH_OUT,24659.0,C988705496
29628,1196428',2018-12-13,FDRL/NATIONAL ELECTRONIC F,24859.0,0.0,,2018,12,13,DEBIT,24859.0,C1481851679
29629,1196428',2018-12-13,FDRL/NATIONAL ELECTRONIC F,16437.0,0.0,,2018,12,13,CHECK_WITHDRAWAL,16437.0,C306206744
29630,1196428',2018-12-13,FDRL/NATIONAL ELECTRONIC F,15871.0,0.0,,2018,12,13,DEBIT,15871.0,C202149782
29631,1196428',2018-12-13,FDRL/NATIONAL ELECTRONIC F,24371.0,0.0,,2018,12,13,CASH_OUT,24371.0,C1621383518
29632,1196428',2018-12-13,FDRL/NATIONAL ELECTRONIC F,24860.0,0.0,,2018,12,13,PAYEMENT,24860.0,C683605346
29633,1196428',2018-12-13,FDRL/NATIONAL ELECTRONIC F,26047.0,0.0,,2018,12,13,DEBIT,26047.0,C1982828534
29634,1196428',2018-12-13,FDRL/NATIONAL ELECTRONIC F,24859.0,0.0,,2018,12,13,CHECK_WITHDRAWAL,24859.0,C1262822392
29635,1196428',2018-12-13,FDRL/NATIONAL ELECTRONIC F,24859.0,0.0,,2018,12,13,DEBIT,24859.0,C1539556581
29636,1196428',2018-12-13,FDRL/NATIONAL ELECTRONIC F,24859.0,0.0,,2018,12,13,CASH_OUT,24859.0,C12793273
29637,1196428',2018-12-13,FDRL/NATIONAL ELECTRONIC F,9648.0,0.0,,2018,12,13,CASH_OUT,9648.0,C1816757085
29638,1196428',2018-12-13,FDRL/NATIONAL ELECTRONIC F,24860.0,0.0,,2018,12,13,CHECK_WITHDRAWAL,24860.0,C1753295732
29639,1196428',2018-12-13,FDRL/NATIONAL ELECTRONIC F,23504.0,0.0,,2018,12,13,CHECK_WITHDRAWAL,23504.0,C408304912
29640,1196428',2018-12-13,FDRL/NATIONAL ELECTRONIC F,24860.0,0.0,,2018,12,13,CASH_OUT,24860.0,C1276319779
29641,1196428',2018-12-13,FDRL/NATIONAL ELECTRONIC F,22340.0,0.0,,2018,12,13,CHECK_WITHDRAWAL,22340.0,C254784037
29642,1196428',2018-12-13,FDRL/NATIONAL ELECTRONIC F,14087.0,0.0,,2018,12,13,CHECK_WITHDRAWAL,14087.0,C1859795678
29643,1196428',2018-12-13,FDRL/NATIONAL ELECTRONIC F,19027.0,0.0,,2018,12,13,CHECK_WITHDRAWAL,19027.0,C1504109395
29644,1196428',2018-12-13,FDRL/NATIONAL ELECTRONIC F,26216.0,0.0,,2018,12,13,CHECK_WITHDRAWAL,26216.0,C814900611
29645,1196428',2018-12-13,FDRL/NATIONAL ELECTRONIC F,24860.0,0.0,,2018,12,13,CASH_OUT,24860.0,C732929236
29646,1196428',2018-12-13,FDRL/NATIONAL ELECTRONIC F,22360.0,0.0,,2018,12,13,PAYEMENT,22360.0,C1167813715
29647,1196428',2018-12-13,FDRL/NATIONAL ELECTRONIC F,15052.0,0.0,,2018,12,13,DEBIT,15052.0,C853932876
29648,1196428',2018-12-13,FDRL/NATIONAL ELECTRONIC F,17508.0,0.0,,2018,12,13,DEBIT,17508.0,C1410669831
29649,1196428',2018-12-13,FDRL/NATIONAL ELECTRONIC F,15052.0,0.0,,2018,12,13,CASH_OUT,15052.0,C54274682
29650,1196428',2018-12-13,FDRL/NATIONAL ELECTRONIC F,15052.0,0.0,,2018,12,13,PAYEMENT,15052.0,C720370261
29651,1196428',2018-12-13,FDRL/NATIONAL ELECTRONIC F,17508.0,0.0,,2018,12,13,PAYEMENT,17508.0,C882849154
29652,1196428',2018-12-13,FDRL/NATIONAL ELECTRONIC F,24660.0,0.0,,2018,12,13,CHECK_WITHDRAWAL,24660.0,C1044472558
29653,1196428',2018-12-13,FDRL/NATIONAL ELECTRONIC F,9648.0,0.0,,2018,12,13,PAYEMENT,9648.0,C1060830840
29654,1196428',2018-12-13,FDRL/NATIONAL ELECTRONIC F,24860.0,0.0,,2018,12,13,PAYEMENT,24860.0,C1210002123
29655,1196428',2018-12-13,FDRL/NATIONAL ELECTRONIC F,23354.0,0.0,,2018,12,13,CASH_OUT,23354.0,C1222590577
29656,1196428',2018-12-13,FDRL/NATIONAL ELECTRONIC F,24860.0,0.0,,2018,12,13,PAYEMENT,24860.0,C1452722471
29657,1196428',2018-12-13,FDRL/NATIONAL ELECTRONIC F,8684.0,0.0,,2018,12,13,PAYEMENT,8684.0,C1185525558
29658,1196428',2018-12-13,FDRL/NATIONAL ELECTRONIC F,13586.0,0.0,,2018,12,13,CASH_OUT,13586.0,C826383690
29659,1196428',2018-12-13,FDRL/NATIONAL ELECTRONIC F,12596.0,0.0,,2018,12,13,DEBIT,12596.0,C211528162
29660,1196428',2018-12-13,FDRL/NATIONAL ELECTRONIC F,24860.0,0.0,,2018,12,13,CHECK_WITHDRAWAL,24860.0,C1017767725
29661,1196428',2018-12-13,FDRL/NATIONAL ELECTRONIC F,17628.0,0.0,,2018,12,13,PAYEMENT,17628.0,C1873099533
29662,1196428',2018-12-13,FDRL/NATIONAL ELECTRONIC F,27794.0,0.0,,2018,12,13,PAYEMENT,27794.0,C65197494
29663,1196428',2018-12-13,FDRL/NATIONAL ELECTRONIC F,14814.0,0.0,,2018,12,13,DEBIT,14814.0,C1474411656
29664,1196428',2018-12-13,FDRL/NATIONAL ELECTRONIC F,20612.0,0.0,,2018,12,13,DEBIT,20612.0,C2029406675
29665,1196428',2018-12-13,FDRL/NATIONAL ELECTRONIC F,14814.0,0.0,,2018,12,13,CHECK_WITHDRAWAL,14814.0,C2078250226
29666,1196428',2018-12-13,FDRL/NATIONAL ELECTRONIC F,7560.0,0.0,,2018,12,13,CHECK_WITHDRAWAL,7560.0,C875761527
29667,1196428',2018-12-13,FDRL/NATIONAL ELECTRONIC F,11157.0,0.0,,2018,12,13,CASH_OUT,11157.0,C935808590
29668,1196428',2018-12-13,FDRL/NATIONAL ELECTRONIC F,24090.0,0.0,,2018,12,13,DEBIT,24090.0,C1535481925
29669,1196428',2018-12-13,FDRL/NATIONAL ELECTRONIC F,21544.0,0.0,,2018,12,13,PAYEMENT,21544.0,C952610115
29670,1196428',2018-12-13,FDRL/NATIONAL ELECTRONIC F,22616.0,0.0,,2018,12,13,CASH_OUT,22616.0,C661442540
29671,1196428',2018-12-13,FDRL/NATIONAL ELECTRONIC F,15333.0,0.0,,2018,12,13,CHECK_WITHDRAWAL,15333.0,C2029406675
29672,1196428',2018-12-13,FDRL/INTERNAL FUND TRANSFE,500000.0,0.0,,2018,12,13,DEBIT,500000.0,C395114097
29673,1196428',2018-12-13,CHQ DEP/3/OWDEL1/PSIB/MAI,0.0,11800.0,,2018,12,13,TRANSFER,11800.0,C1302931951
29674,1196428',2018-12-13,CHQ DEP/29/OWDEL1/PSIB/GT,0.0,11800.0,,2018,12,13,CASH_IN,11800.0,C1703397679
29675,1196428',2018-12-13,CHQ DEP/345/OWDEL1/HDFC/P,0.0,8000.0,,2018,12,13,CASH_IN,8000.0,C1401721023
29676,1196428',2018-12-13,CHQ DEP/773072/OWDEL1/PUN,0.0,8000.0,,2018,12,13,CHECK_CASHING,8000.0,C1408337297
29677,1196428',2018-12-13,CHQ DEP/26349/OWDEL1/ALLA,0.0,11800.0,,2018,12,13,CASH_IN,11800.0,C35126588
29678,1196428',2018-12-13,TRF FROM  Indiaforensic SERVICES,0.0,2300000.0,,2018,12,13,TRANSFER,2300000.0,C1905079199
29679,1196428',2018-12-13,TRF FROM  Indiaforensic SERVICES,0.0,1600000.0,,2018,12,13,CHECK_CASHING,1600000.0,C1067155425
29680,1196428',2018-12-13,NEFT/SBIN218347680523/M S,0.0,15000.0,,2018,12,13,CHECK_CASHING,15000.0,C1467806809
29681,1196428',2018-12-13,FDRL/REAL TIME GROSS SETTL,300000.0,0.0,,2018,12,13,PAYEMENT,300000.0,C1703196166
29682,1196428',2018-12-13,FDRL/REAL TIME GROSS SETTL,600000.0,0.0,,2018,12,13,PAYEMENT,600000.0,C1136186114
29683,1196428',2018-12-13,FDRL/REAL TIME GROSS SETTL,700000.0,0.0,,2018,12,13,PAYEMENT,700000.0,C346546542
29684,1196428',2018-12-13,FDRL/NATIONAL ELECTRONIC F,118814.0,0.0,,2018,12,13,DEBIT,118814.0,C1689840534
29685,1196428',2018-12-13,CHQ DEPOSIT RETURN/3/DRAW,11800.0,0.0,,2018,12,13,PAYEMENT,11800.0,C1249000159
29686,1196428',2018-12-13,NEFT/000057245181/Indiaforensic,0.0,500000.0,,2018,12,13,CHECK_CASHING,500000.0,C594250212
29687,1196428',2018-12-13,NEFT/000057243554/Indiaforensic,0.0,1000000.0,,2018,12,13,CHECK_CASHING,1000000.0,C1396827930
29688,1196428',2018-12-13,TRF FRM 409000362497  Indfor,0.0,438286.0,,2018,12,13,CASH_IN,438286.0,C413177525
29689,1196428',2018-12-13,NEFT/N347180702588193/TEC,0.0,100000.0,,2018,12,13,CHECK_CASHING,100000.0,C1966562224
29690,1196428',2018-12-13,TRF FROM  Indiaforensic SERVICES,0.0,4800000.0,,2018,12,13,TRANSFER,4800000.0,C596299019
29691,1196428',2018-12-13,FDRL/NATIONAL ELECTRONIC F,14900000.0,0.0,,2018,12,13,CHECK_WITHDRAWAL,14900000.0,C580431625
29692,1196428',2018-12-13,NEFT/SBIN218347879586/Indfor,0.0,2000000.0,,2018,12,13,TRANSFER,2000000.0,C863811613
29693,1196428',2018-12-13,TRF FRM  Indiaforensic SERVICES,0.0,8300000.0,,2018,12,13,TRANSFER,8300000.0,C1696758742
29694,1196428',2018-12-13,TRF FRM  Indiaforensic SERVICES,0.0,800000.0,,2018,12,13,CHECK_CASHING,800000.0,C1137520422
29695,1196428',2018-12-13,FDRL/INTERNAL FUND TRANSFE,500000.0,0.0,,2018,12,13,PAYEMENT,500000.0,C1790202239
29696,1196428',2018-12-13,POS ACQ FP SETT DT 121218,0.0,20.0,,2018,12,13,TRANSFER,20.0,C580735116
29697,1196428',2018-12-14,RTGS/PUNBH18348860073/MAN,0.0,400000.0,,2018,12,14,TRANSFER,400000.0,C837588739
29698,1196428',2018-12-14,CASHDEP/NERUL/,0.0,78000.0,,2018,12,14,CHECK_CASHING,78000.0,C1384149246
29699,1196428',2018-12-14,FDRL/INTERNAL FUND TRANSFE,500000.0,0.0,,2018,12,14,DEBIT,500000.0,C1207946845
29700,1196428',2018-12-14,FDRL/REAL TIME GROSS SETTL,1000000.0,0.0,,2018,12,14,PAYEMENT,1000000.0,C451934410
29701,1196428',2018-12-14,FDRL/REAL TIME GROSS SETTL,1000000.0,0.0,,2018,12,14,PAYEMENT,1000000.0,C495071437
29702,1196428',2018-12-14,FDRL/REAL TIME GROSS SETTL,10000000.0,0.0,,2018,12,14,CASH_OUT,10000000.0,C1095446005
29703,1196428',2018-12-14,RTGS/HDFCH18348431000/Indfor,0.0,3100000.0,,2018,12,14,TRANSFER,3100000.0,C197353092
29704,1196428',2018-12-14,IMPS 834811670476 FROM SA,0.0,100000.0,,2018,12,14,CHECK_CASHING,100000.0,C83827469
29705,1196428',2018-12-14,IMPS 834811705530 FROM SA,0.0,50000.0,,2018,12,14,CASH_IN,50000.0,C1804631788
29706,1196428',2018-12-14,FDRL/INTERNAL FUND TRANSFE,1000000.0,0.0,,2018,12,14,PAYEMENT,1000000.0,C1636786811
29707,1196428',2018-12-14,CHQ DEP/456953/OWDEL1/PSI,0.0,11800.0,,2018,12,14,CASH_IN,11800.0,C837153776
29708,1196428',2018-12-14,CHQ DEP/8081/OWDEL1/MAHB/,0.0,11800.0,,2018,12,14,CHECK_CASHING,11800.0,C361931733
29709,1196428',2018-12-14,CHQ DEP/103/OWDEL1/PSIB/F,0.0,11800.0,,2018,12,14,CHECK_CASHING,11800.0,C1654583020
29710,1196428',2018-12-14,TRF FRM  Indiaforensic SERVICES,0.0,1700000.0,,2018,12,14,CHECK_CASHING,1700000.0,C815121481
29711,1196428',2018-12-14,"Indiaforensic USA, INC./USD/1172",0.0,8371660.54,,2018,12,14,CHECK_CASHING,8371660.54,C33524623
29712,1196428',2018-12-14,IRTT00701836215,2611.9,0.0,,2018,12,14,DEBIT,2611.9,C471450373
29713,1196428',2018-12-14,RTGS/ICICH18348785392/Indfor,0.0,1100000.0,,2018,12,14,CHECK_CASHING,1100000.0,C1643217922
29714,1196428',2018-12-14,CHQ DEPOSIT RETURN/103/OT,11800.0,0.0,,2018,12,14,CHECK_WITHDRAWAL,11800.0,C1195471589
29715,1196428',2018-12-14,NEFT/000057303245/Indiaforensic,0.0,1700000.0,,2018,12,14,CHECK_CASHING,1700000.0,C143580560
29716,1196428',2018-12-14,RTGS/UTIBH18348655801/Indfor,0.0,6000000.0,,2018,12,14,TRANSFER,6000000.0,C74288440
29717,1196428',2018-12-14,RTGS/SBINH18348056289/Indfor,0.0,7600000.0,,2018,12,14,TRANSFER,7600000.0,C1642006480
29718,1196428',2018-12-14,NEFT/N348180703313755/BAT,0.0,325000.0,,2018,12,14,TRANSFER,325000.0,C1897193207
29719,1196428',2018-12-14,FDRL/NATIONAL ELECTRONIC F,10608172.53,0.0,,2018,12,14,CASH_OUT,10608172.53,C1750665229
29720,1196428',2018-12-14,FDRL/NATIONAL ELECTRONIC F,105215.0,0.0,,2018,12,14,CASH_OUT,105215.0,C1731824557
29721,1196428',2018-12-14,FDRL/NATIONAL ELECTRONIC F,119825.0,0.0,,2018,12,14,PAYEMENT,119825.0,C214974969
29722,1196428',2018-12-14,FDRL/NATIONAL ELECTRONIC F,13836842.13,0.0,,2018,12,14,CHECK_WITHDRAWAL,13836842.13,C803116137
29723,1196428',2018-12-14,TRF FRM 409000362497  Indfor,0.0,96794.0,,2018,12,14,TRANSFER,96794.0,C602874477
29724,1196428',2018-12-14,NEFT/N348180703405898/TEC,0.0,200000.0,,2018,12,14,CHECK_CASHING,200000.0,M637904446
29725,1196428',2018-12-14,FDRL/INTERNAL FUND TRANSFE,200000.0,0.0,,2018,12,14,CASH_OUT,200000.0,M1117679709
29726,1196428',2018-12-14,TRF FRM  Indiaforensic SERVICES,0.0,5000000.0,,2018,12,14,TRANSFER,5000000.0,C22448303
29727,1196428',2018-12-14,FDRL/NXTXN_PAYMENT,0.0,6500.0,,2018,12,14,CHECK_CASHING,6500.0,C1869400026
29728,1196428',2018-12-14,FDRL/IndforSECURE_PAYMENT,0.0,18300.0,,2018,12,14,CHECK_CASHING,18300.0,M462945848
29729,1196428',2018-12-14,TRF FROM  Indiaforensic SERVICES,0.0,9800000.0,,2018,12,14,TRANSFER,9800000.0,M1797758242
29730,1196428',2018-12-14,TRF FROM  Indiaforensic SERVICES,0.0,400000.0,,2018,12,14,CHECK_CASHING,400000.0,M920334854
29731,1196428',2018-12-14,TRF TO  Indiaforensic SERVICES I,200000.0,0.0,,2018,12,14,CASH_OUT,200000.0,C1002407179
29732,1196428',2018-12-14,NEFT CHARGES AND GST/0000,29.5,0.0,,2018,12,14,CHECK_WITHDRAWAL,29.5,M751855156
29733,1196428',2018-12-14,NEFT/000059902079/INDIAN,14900000.0,0.0,,2018,12,14,PAYEMENT,14900000.0,M963057491
29734,1196428',2018-12-14,FDRL/INTERNAL FUND TRANSFE,2000000.0,0.0,,2018,12,14,CASH_OUT,2000000.0,C49191134
29735,1196428',2018-12-14,FDRL/INTERNAL FUND TRANSFE,1000000.0,0.0,,2018,12,14,CASH_OUT,1000000.0,M323095858
29736,1196428',2018-12-14,FDRL/INTERNAL FUND TRANSFE,500000.0,0.0,,2018,12,14,CASH_OUT,500000.0,M936577936
29737,1196428',2018-12-14,BEAT CSH PKP DEL GURGA 77,0.0,342000.0,,2018,12,14,CASH_IN,342000.0,M1338453330
29738,1196428',2018-12-15,CASHDEP/BOISAR/,0.0,5000.0,,2018,12,15,TRANSFER,5000.0,M16104112
29739,1196428',2018-12-15,PBGI01001700032:Bank Guar,53690.0,0.0,,2018,12,15,DEBIT,53690.0,M1189266100
29740,1196428',2018-12-15,CHQ DEP/103/OWDEL1/PSIB/F,0.0,11800.0,,2018,12,15,CHECK_CASHING,11800.0,C1653859230
29741,1196428',2018-12-15,TRF FRM  Indiaforensic SERVICES,0.0,1000000.0,,2018,12,15,TRANSFER,1000000.0,M386385497
29742,1196428',2018-12-15,RTGS/ICICH18349215367/Indfor,0.0,1000000.0,,2018,12,15,TRANSFER,1000000.0,M2026124327
29743,1196428',2018-12-15,RTGS/SBINH18349049147/Indfor,0.0,10000000.0,,2018,12,15,TRANSFER,10000000.0,M728025638
29744,1196428',2018-12-15,RTGS/ICICH18349232328/Indfor,0.0,1000000.0,,2018,12,15,CASH_IN,1000000.0,C40075281
29745,1196428',2018-12-15,TRF FROM  Indiaforensic SERVICES,0.0,2000000.0,,2018,12,15,CHECK_CASHING,2000000.0,C1796712971
29746,1196428',2018-12-15,TRF FROM  Indiaforensic SERVICES,0.0,3000000.0,,2018,12,15,TRANSFER,3000000.0,M2142936755
29747,1196428',2018-12-15,TRF FROM  Indiaforensic SERVICES,0.0,3000000.0,,2018,12,15,CASH_IN,3000000.0,C1246370163
29748,1196428',2018-12-15,STAMP PAPER PURCHASING  s,100.0,0.0,,2018,12,15,DEBIT,100.0,M629170781
29749,1196428',2018-12-15,TRF FROM  Indiaforensic SERVICES,0.0,1000000.0,,2018,12,15,TRANSFER,1000000.0,C132379888
29750,1196428',2018-12-15,BEAT CSH PKP DEL GURGA 77,0.0,83000.0,,2018,12,15,TRANSFER,83000.0,C1638543071
29751,1196428',2018-12-15,VISA POS ACQUIRER SETLMNT,0.0,20.98,,2018,12,15,CASH_IN,20.98,M1360195110
29752,1196428',2018-12-17,FDRL/INTERNAL FUND TRANSFE,500000.0,0.0,,2018,12,17,CASH_OUT,500000.0,C1909597726
29753,1196428',2018-12-17,FDRL/INTERNAL FUND TRANSFE,500000.0,0.0,,2018,12,17,CASH_OUT,500000.0,M1125298596
29754,1196428',2018-12-17,FDRL/INTERNAL FUND TRANSFE,2000000.0,0.0,,2018,12,17,CASH_OUT,2000000.0,M1742411574
29755,1196428',2018-12-17,FDRL/INTERNAL FUND TRANSFE,400000.0,0.0,,2018,12,17,DEBIT,400000.0,C257884050
29756,1196428',2018-12-17,FDRL/INTERNAL FUND TRANSFE,400000.0,0.0,,2018,12,17,DEBIT,400000.0,M798412371
29757,1196428',2018-12-17,FDRL/NATIONAL ELECTRONIC F,14900000.0,0.0,,2018,12,17,CASH_OUT,14900000.0,C1465813088
29758,1196428',2018-12-17,FDRL/REAL TIME GROSS SETTL,1000000.0,0.0,,2018,12,17,CHECK_WITHDRAWAL,1000000.0,M237609087
29759,1196428',2018-12-17,FDRL/REAL TIME GROSS SETTL,1000000.0,0.0,,2018,12,17,CASH_OUT,1000000.0,C1393428647
29760,1196428',2018-12-17,RTGS/SBINH18351011432/Indfor,0.0,3100000.0,,2018,12,17,CASH_IN,3100000.0,M1199416856
29761,1196428',2018-12-17,TRF FRM  Indiaforensic SERVICES,0.0,1000000.0,,2018,12,17,CHECK_CASHING,1000000.0,C1070146065
29762,1196428',2018-12-17,TRF FRM  Indiaforensic SERVICES,0.0,500000.0,,2018,12,17,TRANSFER,500000.0,M1502153853
29763,1196428',2018-12-17,FDRL/NATIONAL ELECTRONIC F,7288788.1,0.0,,2018,12,17,DEBIT,7288788.1,M1363057875
29764,1196428',2018-12-17,CHQ DEP/378/OWDEL1/UCBA/B,0.0,11800.0,,2018,12,17,CHECK_CASHING,11800.0,M541055517
29765,1196428',2018-12-17,CHQ DEP/544501/OWDEL1/SBI,0.0,11800.0,,2018,12,17,TRANSFER,11800.0,M131048725
29766,1196428',2018-12-17,CHQ DEP/331043/OWDEL1/SBI,0.0,11800.0,,2018,12,17,CASH_IN,11800.0,M1312332108
29767,1196428',2018-12-17,CHQ DEP/500505/OWDEL1/SBI,0.0,11800.0,,2018,12,17,CASH_IN,11800.0,M97183264
29768,1196428',2018-12-17,CHQ DEP/192882/OWDEL1/IDI,0.0,11800.0,,2018,12,17,CASH_IN,11800.0,M1431472749
29769,1196428',2018-12-17,TRF FROM  Indiaforensic SERVICES,0.0,2000000.0,,2018,12,17,CHECK_CASHING,2000000.0,C804836251
29770,1196428',2018-12-17,CASHDEP/NERUL/,0.0,119400.0,,2018,12,17,TRANSFER,119400.0,M1267061962
29771,1196428',2018-12-17,RTGS/ICICH18351347231/Indfor,0.0,1600000.0,,2018,12,17,CHECK_CASHING,1600000.0,M2117949825
29772,1196428',2018-12-17,RTGS/ICICH18351349000/Indfor,0.0,1400000.0,,2018,12,17,CHECK_CASHING,1400000.0,M1976313615
29773,1196428',2018-12-17,CHQ DEPOSIT RETURN/192882,11800.0,0.0,,2018,12,17,PAYEMENT,11800.0,C1448947115
29774,1196428',2018-12-17,FDRL/INTERNAL FUND TRANSFE,500000.0,0.0,,2018,12,17,CASH_OUT,500000.0,M107131803
29775,1196428',2018-12-17,TRF FRM  Indiaforensic SERVICES,0.0,2000000.0,,2018,12,17,TRANSFER,2000000.0,M479144545
29776,1196428',2018-12-17,TRF FRM  Indiaforensic SERVICES,0.0,1000000.0,,2018,12,17,CASH_IN,1000000.0,M946036398
29777,1196428',2018-12-17,TRF FRM  Indiaforensic SERVICES,0.0,5000000.0,,2018,12,17,CASH_IN,5000000.0,C290945720
29778,1196428',2018-12-17,TRF FRM  Indiaforensic SERVICES,0.0,5000000.0,,2018,12,17,CASH_IN,5000000.0,M37257448
29779,1196428',2018-12-17,TRF FRM  Indiaforensic SERVICES,0.0,14500000.0,,2018,12,17,CASH_IN,14500000.0,M55627944
29780,1196428',2018-12-17,TRF FRM  Indiaforensic SERVICES,0.0,2000000.0,,2018,12,17,CASH_IN,2000000.0,M1286497008
29781,1196428',2018-12-17,FDRL/NATIONAL ELECTRONIC F,11652413.19,0.0,,2018,12,17,CHECK_WITHDRAWAL,11652413.19,M150086278
29782,1196428',2018-12-17,FDRL/NATIONAL ELECTRONIC F,14900000.0,0.0,,2018,12,17,DEBIT,14900000.0,C173247103
29783,1196428',2018-12-17,FDRL/INTERNAL FUND TRANSFE,2000000.0,0.0,,2018,12,17,PAYEMENT,2000000.0,M536732872
29784,1196428',2018-12-17,FDRL/INTERNAL FUND TRANSFE,1000000.0,0.0,,2018,12,17,CASH_OUT,1000000.0,C1878704627
29785,1196428',2018-12-17,TRF TO  Indiaforensic SERVICES I,2447600.0,0.0,,2018,12,17,CHECK_WITHDRAWAL,2447600.0,M200265601
29786,1196428',2018-12-17,BEAT CSH PKP DEL GURGA 77,0.0,136500.0,,2018,12,17,CASH_IN,136500.0,C1453128758
29787,1196428',2018-12-17,CHQ DEPOSIT RETURN/192882,100.0,0.0,,2018,12,17,CASH_OUT,100.0,C1065251495
29788,1196428',2018-12-17,CHQ DEPOSIT RETURN/192882,18.0,0.0,,2018,12,17,PAYEMENT,18.0,M98818070
29789,1196428',2018-12-18,FDRL/NATIONAL ELECTRONIC F,1000000.0,0.0,,2018,12,18,CHECK_WITHDRAWAL,1000000.0,C232834050
29790,1196428',2018-12-18,FDRL/NATIONAL ELECTRONIC F,1000000.0,0.0,,2018,12,18,PAYEMENT,1000000.0,C1216911343
29791,1196428',2018-12-18,TRF FRM 409000362497  Indfor,0.0,215205.0,,2018,12,18,TRANSFER,215205.0,C1984917168
29792,1196428',2018-12-18,TRF FROM  Indiaforensic SERVICES,0.0,1000000.0,,2018,12,18,TRANSFER,1000000.0,M1787972939
29793,1196428',2018-12-18,TRF FROM  Indiaforensic SERVICES,0.0,500000.0,,2018,12,18,CASH_IN,500000.0,M1856509153
29794,1196428',2018-12-18,TRF FROM  Indiaforensic SERVICES,0.0,500000.0,,2018,12,18,CASH_IN,500000.0,C1916873789
29795,1196428',2018-12-18,IMPS 835214127301 FROM PU,0.0,26000.0,,2018,12,18,CHECK_CASHING,26000.0,C1826598423
29796,1196428',2018-12-18,RTGS/ICICH18352449999/Indfor,0.0,1500000.0,,2018,12,18,CASH_IN,1500000.0,C2113748097
29797,1196428',2018-12-18,RTGS/ICICH18352452955/Indfor,0.0,900000.0,,2018,12,18,CASH_IN,900000.0,M1491805136
29798,1196428',2018-12-18,CASHDEP/NERUL/,0.0,91000.0,,2018,12,18,TRANSFER,91000.0,C346008447
29799,1196428',2018-12-18,FDRL/REAL TIME GROSS SETTL,5000000.0,0.0,,2018,12,18,DEBIT,5000000.0,M795270772
29800,1196428',2018-12-18,TRF FROM  Indiaforensic SERVICES,0.0,3000000.0,,2018,12,18,CASH_IN,3000000.0,C1351115755
29801,1196428',2018-12-18,TRF FROM  Indiaforensic SERVICES,0.0,3000000.0,,2018,12,18,CASH_IN,3000000.0,M316014100
29802,1196428',2018-12-18,FDRL/NATIONAL ELECTRONIC F,5000000.0,0.0,,2018,12,18,CHECK_WITHDRAWAL,5000000.0,M824065553
29803,1196428',2018-12-18,NEFT/N352180705784208/TEC,0.0,200000.0,,2018,12,18,CASH_IN,200000.0,M465070853
29804,1196428',2018-12-18,TRF FROM  Indiaforensic SERVICES,0.0,3000000.0,,2018,12,18,CHECK_CASHING,3000000.0,M414613413
29805,1196428',2018-12-18,FDRL/INTERNAL FUND TRANSFE,500000.0,0.0,,2018,12,18,PAYEMENT,500000.0,M1722552432
29806,1196428',2018-12-18,FDRL/INTERNAL FUND TRANSFE,500000.0,0.0,,2018,12,18,CHECK_WITHDRAWAL,500000.0,M1420641051
29807,1196428',2018-12-18,FDRL/INTERNAL FUND TRANSFE,2000000.0,0.0,,2018,12,18,CHECK_WITHDRAWAL,2000000.0,M1227671790
29808,1196428',2018-12-18,BEAT CSH PKP DEL GURGA 77,0.0,103500.0,,2018,12,18,TRANSFER,103500.0,M1652554005
29809,1196428',2018-12-19,IMPS 835309942227 FROM OX,0.0,200000.0,,2018,12,19,TRANSFER,200000.0,M690838049
29810,1196428',2018-12-19,TRF FRM 409000362497  Indfor,0.0,641815.0,,2018,12,19,TRANSFER,641815.0,M1323905847
29811,1196428',2018-12-19,TRF TO  Indiaforensic SERVICES I,1704000.0,0.0,,2018,12,19,CASH_OUT,1704000.0,M1194912106
29812,1196428',2018-12-19,TRF FROM  Indiaforensic SERVICES,0.0,1600000.0,,2018,12,19,CHECK_CASHING,1600000.0,M230270836
29813,1196428',2018-12-19,TRF FROM  Indiaforensic SERVICES,0.0,600000.0,,2018,12,19,TRANSFER,600000.0,M869260913
29814,1196428',2018-12-19,NEFT/000057580442/Indiaforensic,0.0,500000.0,,2018,12,19,CHECK_CASHING,500000.0,M190260061
29815,1196428',2018-12-19,NEFT/000057580625/Indiaforensic,0.0,1200000.0,,2018,12,19,CASH_IN,1200000.0,C1436823730
29816,1196428',2018-12-19,TRF FRM  Indiaforensic SERVICES,0.0,4000000.0,,2018,12,19,CHECK_CASHING,4000000.0,C1219248641
29817,1196428',2018-12-19,TRF FRM  Indiaforensic SERVICES,0.0,4000000.0,,2018,12,19,CHECK_CASHING,4000000.0,M1101625662
29818,1196428',2018-12-19,TRF FRM  Indiaforensic SERVICES,0.0,1000000.0,,2018,12,19,CASH_IN,1000000.0,M118977999
29819,1196428',2018-12-19,IMPS 835317133145 FROM OX,0.0,200000.0,,2018,12,19,CASH_IN,200000.0,C1742506664
29820,1196428',2018-12-19,IMPS 835317133178 FROM OX,0.0,200000.0,,2018,12,19,TRANSFER,200000.0,M1143592562
29821,1196428',2018-12-19,IMPS 835317133222 FROM OX,0.0,200000.0,,2018,12,19,CHECK_CASHING,200000.0,C935808590
29822,1196428',2018-12-19,IMPS 835317133289 FROM OX,0.0,200000.0,,2018,12,19,CASH_IN,200000.0,C103357744
29823,1196428',2018-12-19,IMPS 835317133330 FROM OX,0.0,200000.0,,2018,12,19,CHECK_CASHING,200000.0,M797250570
29824,1196428',2018-12-19,IMPS 835317133383 FROM OX,0.0,200000.0,,2018,12,19,TRANSFER,200000.0,C1923206317
29825,1196428',2018-12-19,FDRL/INTERNAL FUND TRANSFE,500000.0,0.0,,2018,12,19,CHECK_WITHDRAWAL,500000.0,M725814534
29826,1196428',2018-12-19,FDRL/INTERNAL FUND TRANSFE,1000000.0,0.0,,2018,12,19,PAYEMENT,1000000.0,M98249191
29827,1196428',2018-12-19,FDRL/INTERNAL FUND TRANSFE,1000000.0,0.0,,2018,12,19,CASH_OUT,1000000.0,M1546774255
29828,1196428',2018-12-19,IMPS 835318135604 FROM OX,0.0,200000.0,,2018,12,19,TRANSFER,200000.0,C949483950
29829,1196428',2018-12-19,IMPS 835318135651 FROM OX,0.0,200000.0,,2018,12,19,TRANSFER,200000.0,M118884235
29830,1196428',2018-12-19,IMPS 835318135701 FROM OX,0.0,200000.0,,2018,12,19,CASH_IN,200000.0,C1227603646
29831,1196428',2018-12-19,FDRL/INTERNAL FUND TRANSFE,400000.0,0.0,,2018,12,19,CASH_OUT,400000.0,M1279758401
29832,1196428',2018-12-19,NEFT CHARGES AND GST/0000,29.5,0.0,,2018,12,19,CASH_OUT,29.5,C1937294500
29833,1196428',2018-12-19,NEFT/000060406280/INDIAN,12243122.0,0.0,,2018,12,19,CHECK_WITHDRAWAL,12243122.0,M2051420622
29834,1196428',2018-12-19,BEAT CSH PKP DEL GURGA 78,0.0,59000.0,,2018,12,19,CASH_IN,59000.0,C987060415
29835,1196428',2018-12-20,CHQ DEP/45758/OWDEL1/IBKL,0.0,11800.0,,2018,12,20,TRANSFER,11800.0,C555334025
29836,1196428',2018-12-20,CHQ DEP/801554/OWDEL1/SBI,0.0,11800.0,,2018,12,20,TRANSFER,11800.0,C1374063565
29837,1196428',2018-12-20,CHQ DEP/2960/OWDEL1/ICIC/,0.0,11800.0,,2018,12,20,CASH_IN,11800.0,C1805708874
29838,1196428',2018-12-20,CHQ DEP/835787/OWDEL1/SBI,0.0,11800.0,,2018,12,20,CHECK_CASHING,11800.0,M201075755
29839,1196428',2018-12-20,CHQ DEP/182/OWDEL1/ICIC/N,0.0,11800.0,,2018,12,20,CASH_IN,11800.0,C1379289710
29840,1196428',2018-12-20,CHQ DEP/349886/OWDEL1/SBI,0.0,11800.0,,2018,12,20,TRANSFER,11800.0,C1082580319
29841,1196428',2018-12-20,CHQ DEP/47539/OWDEL1/IBKL,0.0,11800.0,,2018,12,20,TRANSFER,11800.0,M949966841
29842,1196428',2018-12-20,CHQ DEP/609013/OWDEL1/SBI,0.0,11800.0,,2018,12,20,CASH_IN,11800.0,C1882615733
29843,1196428',2018-12-20,CHQ DEP/233447/OWDEL1/SBI,0.0,11800.0,,2018,12,20,CHECK_CASHING,11800.0,C1653859230
29844,1196428',2018-12-20,CHQ DEP/339498/OWDEL1/SBI,0.0,11800.0,,2018,12,20,CASH_IN,11800.0,C1945802665
29845,1196428',2018-12-20,CHQ DEP/852237/OWDEL1/SBI,0.0,11800.0,,2018,12,20,CHECK_CASHING,11800.0,M1200741024
29846,1196428',2018-12-20,CHQ DEP/801148/OWDEL1/YES,0.0,11800.0,,2018,12,20,CASH_IN,11800.0,C1849941462
29847,1196428',2018-12-20,CHQ DEP/31749/OWDEL1/SBIN,0.0,11800.0,,2018,12,20,TRANSFER,11800.0,C1740509828
29848,1196428',2018-12-20,CHQ DEP/197630/OWDEL1/SBI,0.0,11800.0,,2018,12,20,CASH_IN,11800.0,M1520779780
29849,1196428',2018-12-20,CHQ DEP/124688/OWDEL1/RAJ,0.0,11800.0,,2018,12,20,CHECK_CASHING,11800.0,M468138124
29850,1196428',2018-12-20,CHQ DEP/373/OWDEL1/RAJAS/,0.0,11800.0,,2018,12,20,CHECK_CASHING,11800.0,M1043282886
29851,1196428',2018-12-20,CHQ DEP/339860/OWDEL1/SBI,0.0,11800.0,,2018,12,20,CASH_IN,11800.0,C1401721023
29852,1196428',2018-12-20,CHQ DEP/772867/OWDEL1/SBI,0.0,11800.0,,2018,12,20,CASH_IN,11800.0,M2071008706
29853,1196428',2018-12-20,CHQ DEP/162894/OWDEL1/SBI,0.0,11800.0,,2018,12,20,CASH_IN,11800.0,M962324553
29854,1196428',2018-12-20,CHQ DEP/2314/OWDEL1/ICIC/,0.0,11800.0,,2018,12,20,TRANSFER,11800.0,M1717427201
29855,1196428',2018-12-20,CHQ DEP/464941/OWDEL1/SBI,0.0,15000.0,,2018,12,20,CHECK_CASHING,15000.0,C2007792854
29856,1196428',2018-12-20,CHQ DEP/310550/OWDEL1/PUN,0.0,11800.0,,2018,12,20,TRANSFER,11800.0,C520826875
29857,1196428',2018-12-20,CHQ DEP/85935/OWDEL1/UBIN,0.0,11800.0,,2018,12,20,CASH_IN,11800.0,M371139929
29858,1196428',2018-12-20,CHQ DEP/286324/OWDEL1/COR,0.0,11800.0,,2018,12,20,CHECK_CASHING,11800.0,C298492445
29859,1196428',2018-12-20,CHQ DEP/3225/OWDEL1/HDFC/,0.0,15000.0,,2018,12,20,TRANSFER,15000.0,C2141140246
29860,1196428',2018-12-20,CHQ DEP/982341/OWDEL1/SBI,0.0,15000.0,,2018,12,20,TRANSFER,15000.0,C686224839
29861,1196428',2018-12-20,CHQ DEP/373772/OWDEL1/SBI,0.0,15000.0,,2018,12,20,TRANSFER,15000.0,M588701562
29862,1196428',2018-12-20,INFOEDGE INDIA LTD,100800.0,0.0,,2018,12,20,PAYEMENT,100800.0,M152274497
29863,1196428',2018-12-20,TRF FRM  Indiaforensic SERVICES,0.0,1000000.0,,2018,12,20,CHECK_CASHING,1000000.0,C1934634055
29864,1196428',2018-12-20,TRF FRM  Indiaforensic SERVICES,0.0,500000.0,,2018,12,20,CHECK_CASHING,500000.0,M1401219726
29865,1196428',2018-12-20,TRF FRM  Indiaforensic SERVICES,0.0,500000.0,,2018,12,20,CHECK_CASHING,500000.0,M495664236
29866,1196428',2018-12-20,TRF FRM 409000362497  Indfor,0.0,256146.0,,2018,12,20,CHECK_CASHING,256146.0,C1526542158
29867,1196428',2018-12-20,RTGS/ICICH18354696899/Indfor,0.0,700000.0,,2018,12,20,TRANSFER,700000.0,C8298099
29868,1196428',2018-12-20,RTGS/ICICH18354696320/Indfor,0.0,1800000.0,,2018,12,20,CASH_IN,1800000.0,C204540579
29869,1196428',2018-12-20,CHQ DEPOSIT RETURN/801554,11800.0,0.0,,2018,12,20,PAYEMENT,11800.0,M1722737070
29870,1196428',2018-12-20,CHQ DEPOSIT RETURN/349886,11800.0,0.0,,2018,12,20,CASH_OUT,11800.0,M1243116493
29871,1196428',2018-12-20,CHQ DEPOSIT RETURN/339860,11800.0,0.0,,2018,12,20,CHECK_WITHDRAWAL,11800.0,M44017967
29872,1196428',2018-12-20,FDRL/NATIONAL ELECTRONIC F,3000000.0,0.0,,2018,12,20,CHECK_WITHDRAWAL,3000000.0,M884270863
29873,1196428',2018-12-20,FDRL/NATIONAL ELECTRONIC F,314060.0,0.0,,2018,12,20,CHECK_WITHDRAWAL,314060.0,M881113302
29874,1196428',2018-12-20,FDRL/NATIONAL ELECTRONIC F,48514.0,0.0,,2018,12,20,CASH_OUT,48514.0,M1093495523
29875,1196428',2018-12-20,FDRL/NATIONAL ELECTRONIC F,749829.5,0.0,,2018,12,20,PAYEMENT,749829.5,M1984423401
29876,1196428',2018-12-20,TRF FRM  Indiaforensic SERVICES,0.0,4000000.0,,2018,12,20,CASH_IN,4000000.0,M503154107
29877,1196428',2018-12-20,TRF FRM  Indiaforensic SERVICES,0.0,7800000.0,,2018,12,20,CASH_IN,7800000.0,M370432376
29878,1196428',2018-12-20,TRFT O  Indiaforensic SERVICES I,239515.0,0.0,,2018,12,20,PAYEMENT,239515.0,M1008590807
29879,1196428',2018-12-20,NEFT CHARGES AND GST/0000,29.5,0.0,,2018,12,20,DEBIT,29.5,M2072955860
29880,1196428',2018-12-20,NEFT/000060528865/INDIAN,9065756.0,0.0,,2018,12,20,CHECK_WITHDRAWAL,9065756.0,C1988852187
29881,1196428',2018-12-20,FDRL/INTERNAL FUND TRANSFE,500000.0,0.0,,2018,12,20,PAYEMENT,500000.0,C1531514206
29882,1196428',2018-12-20,FDRL/INTERNAL FUND TRANSFE,500000.0,0.0,,2018,12,20,DEBIT,500000.0,M1745709486
29883,1196428',2018-12-20,FDRL/INTERNAL FUND TRANSFE,2000000.0,0.0,,2018,12,20,DEBIT,2000000.0,C701855966
29884,1196428',2018-12-20,TRF FRM  Indiaforensic SERVICES,0.0,500000.0,,2018,12,20,TRANSFER,500000.0,M1431652715
29885,1196428',2018-12-20,TRFF RM  Indiaforensic SERVICES,0.0,500000.0,,2018,12,20,TRANSFER,500000.0,C747869108
29886,1196428',2018-12-20,IMPS 835420153014 FROM MA,0.0,11800.0,,2018,12,20,CHECK_CASHING,11800.0,C715819458
29887,1196428',2018-12-20,CHQ DEPOSIT RETURN/801554,100.0,0.0,,2018,12,20,CASH_OUT,100.0,M1947363905
29888,1196428',2018-12-20,CHQ DEPOSIT RETURN/801554,18.0,0.0,,2018,12,20,DEBIT,18.0,M1580127502
29889,1196428',2018-12-20,CHQ DEPOSIT RETURN/349886,100.0,0.0,,2018,12,20,CASH_OUT,100.0,M701036732
29890,1196428',2018-12-20,CHQ DEPOSIT RETURN/349886,18.0,0.0,,2018,12,20,CASH_OUT,18.0,M521224741
29891,1196428',2018-12-20,CHQ DEPOSIT RETURN/339860,100.0,0.0,,2018,12,20,CASH_OUT,100.0,M1094182664
29892,1196428',2018-12-20,CHQ DEPOSIT RETURN/339860,18.0,0.0,,2018,12,20,DEBIT,18.0,M418037528
29893,1196428',2018-12-21,FDRL/NATIONAL ELECTRONIC F,2000.0,0.0,,2018,12,21,DEBIT,2000.0,M1853697850
29894,1196428',2018-12-21,FDRL/NATIONAL ELECTRONIC F,2000.0,0.0,,2018,12,21,CHECK_WITHDRAWAL,2000.0,M1342771396
29895,1196428',2018-12-21,FDRL/NATIONAL ELECTRONIC F,2500.0,0.0,,2018,12,21,PAYEMENT,2500.0,M593387690
29896,1196428',2018-12-21,FDRL/NATIONAL ELECTRONIC F,2500.0,0.0,,2018,12,21,CHECK_WITHDRAWAL,2500.0,M364993184
29897,1196428',2018-12-21,FDRL/NATIONAL ELECTRONIC F,2500.0,0.0,,2018,12,21,PAYEMENT,2500.0,M228636156
29898,1196428',2018-12-21,FDRL/NATIONAL ELECTRONIC F,5000.0,0.0,,2018,12,21,DEBIT,5000.0,M685771173
29899,1196428',2018-12-21,FDRL/NATIONAL ELECTRONIC F,2500.0,0.0,,2018,12,21,CASH_OUT,2500.0,C1749476584
29900,1196428',2018-12-21,FDRL/NATIONAL ELECTRONIC F,2500.0,0.0,,2018,12,21,DEBIT,2500.0,M1315580013
29901,1196428',2018-12-21,FDRL/NATIONAL ELECTRONIC F,3000.0,0.0,,2018,12,21,CHECK_WITHDRAWAL,3000.0,C627421335
29902,1196428',2018-12-21,FDRL/NATIONAL ELECTRONIC F,2000.0,0.0,,2018,12,21,CHECK_WITHDRAWAL,2000.0,M1420042301
29903,1196428',2018-12-21,FDRL/NATIONAL ELECTRONIC F,3000.0,0.0,,2018,12,21,DEBIT,3000.0,M1343209823
29904,1196428',2018-12-21,FDRL/NATIONAL ELECTRONIC F,800724.75,0.0,,2018,12,21,PAYEMENT,800724.75,M1449687264
29905,1196428',2018-12-21,FDRL/NATIONAL ELECTRONIC F,2000.0,0.0,,2018,12,21,CASH_OUT,2000.0,M554971739
29906,1196428',2018-12-21,FDRL/NATIONAL ELECTRONIC F,5000.0,0.0,,2018,12,21,DEBIT,5000.0,M1467927386
29907,1196428',2018-12-21,FDRL/NATIONAL ELECTRONIC F,2500.0,0.0,,2018,12,21,DEBIT,2500.0,M542025480
29908,1196428',2018-12-21,NEFT/IOBAN18355664386/K,0.0,2500.0,,2018,12,21,CASH_IN,2500.0,M1674129623
29909,1196428',2018-12-21,NEFT/20181221NOCA0876/VIS,0.0,10.0,,2018,12,21,TRANSFER,10.0,C578599557
29910,1196428',2018-12-21,TRF FRM  Indiaforensic SERVICES,0.0,900000.0,,2018,12,21,CHECK_CASHING,900000.0,M1919504426
29911,1196428',2018-12-21,IMPS 835513685313 FROM OX,0.0,200000.0,,2018,12,21,CASH_IN,200000.0,M192143542
29912,1196428',2018-12-21,FDRL/REAL TIME GROSS SETTL,2000000.0,0.0,,2018,12,21,PAYEMENT,2000000.0,C414205222
29913,1196428',2018-12-21,RTGS/ICICH18355836794/Indfor,0.0,500000.0,,2018,12,21,CHECK_CASHING,500000.0,C2112826959
29914,1196428',2018-12-21,RTGS/ICICH18355834921/Indfor,0.0,1400000.0,,2018,12,21,TRANSFER,1400000.0,M27761893
29915,1196428',2018-12-21,TRF FRM 409000362497  Indfor,0.0,1392771.0,,2018,12,21,TRANSFER,1392771.0,C1837012795
29916,1196428',2018-12-21,FDRL/NATIONAL ELECTRONIC F,3000000.0,0.0,,2018,12,21,CHECK_WITHDRAWAL,3000000.0,M102770624
29917,1196428',2018-12-21,NEFT/N355180708169415/TEC,0.0,100000.0,,2018,12,21,TRANSFER,100000.0,C1897193207
29918,1196428',2018-12-21,FDRL/NATIONAL ELECTRONIC F,92882.0,0.0,,2018,12,21,PAYEMENT,92882.0,M213001848
29919,1196428',2018-12-21,TRF FRM 409000362497  Indfor,0.0,907015.0,,2018,12,21,CHECK_CASHING,907015.0,C1877453512
29920,1196428',2018-12-21,TRF FRM  Indiaforensic SERVICES,0.0,5000000.0,,2018,12,21,TRANSFER,5000000.0,M730700637
29921,1196428',2018-12-21,NEFT CHARGES AND GST/0000,29.5,0.0,,2018,12,21,CHECK_WITHDRAWAL,29.5,M1704583743
29922,1196428',2018-12-21,NEFT/000060647748/GALENA,5000000.0,0.0,,2018,12,21,CASH_OUT,5000000.0,M825840646
29923,1196428',2018-12-21,NEFT/FSFBH18355000177/FIN,0.0,141600.0,,2018,12,21,CHECK_CASHING,141600.0,M587134164
29924,1196428',2018-12-21,TRF FRM  Indiaforensic SERVICES,0.0,1000000.0,,2018,12,21,CHECK_CASHING,1000000.0,C123366619
29925,1196428',2018-12-21,FDRL/INTERNAL FUND TRANSFE,2000000.0,0.0,,2018,12,21,DEBIT,2000000.0,M259460643
29926,1196428',2018-12-21,IMPS 835519808418 FROM OX,0.0,200000.0,,2018,12,21,CHECK_CASHING,200000.0,C1066166621
29927,1196428',2018-12-21,IMPS 835519808468 FROM OX,0.0,200000.0,,2018,12,21,CHECK_CASHING,200000.0,C903028779
29928,1196428',2018-12-21,IMPS 835519808502 FROM OX,0.0,200000.0,,2018,12,21,TRANSFER,200000.0,C11003494
29929,1196428',2018-12-21,IMPS 835519808545 FROM OX,0.0,200000.0,,2018,12,21,CHECK_CASHING,200000.0,C191614132
29930,1196428',2018-12-21,IMPS 835519808583 FROM OX,0.0,200000.0,,2018,12,21,CASH_IN,200000.0,C54274682
29931,1196428',2018-12-21,IMPS 835519808619 FROM OX,0.0,200000.0,,2018,12,21,TRANSFER,200000.0,M565871587
29932,1196428',2018-12-21,FDRL/INTERNAL FUND TRANSFE,500000.0,0.0,,2018,12,21,DEBIT,500000.0,M2068982708
29933,1196428',2018-12-21,FDRL/INTERNAL FUND TRANSFE,500000.0,0.0,,2018,12,21,PAYEMENT,500000.0,C1062630352
29934,1196428',2018-12-21,FDRL/INTERNAL FUND TRANSFE,500000.0,0.0,,2018,12,21,CASH_OUT,500000.0,C2116153614
29935,1196428',2018-12-24,RTGS/ICICH18358205734/Indfor,0.0,2000000.0,,2018,12,24,CHECK_CASHING,2000000.0,M375356410
29936,1196428',2018-12-24,RTGS/ICICH18358206105/Indfor,0.0,500000.0,,2018,12,24,CHECK_CASHING,500000.0,C1452722471
29937,1196428',2018-12-24,FDRL/REAL TIME GROSS SETTL,2000000.0,0.0,,2018,12,24,PAYEMENT,2000000.0,C1630293008
29938,1196428',2018-12-24,TRF FROM  Indiaforensic SERVICES,0.0,1000000.0,,2018,12,24,CASH_IN,1000000.0,C645187727
29939,1196428',2018-12-24,INFOEDGE INDIA LTD,20160.0,0.0,,2018,12,24,CASH_OUT,20160.0,C294252921
29940,1196428',2018-12-24,CHQ DEP/243646/OWDEL1/SBI,0.0,11800.0,,2018,12,24,CHECK_CASHING,11800.0,C1641587857
29941,1196428',2018-12-24,CHQ DEP/720080/OWDEL1/PUN,0.0,11800.0,,2018,12,24,TRANSFER,11800.0,C1027043112
29942,1196428',2018-12-24,CHQ DEP/30239/OWDEL1/ORBC,0.0,11800.0,,2018,12,24,CASH_IN,11800.0,M421776114
29943,1196428',2018-12-24,CHQ DEP/366359/OWDEL1/PUN,0.0,11800.0,,2018,12,24,TRANSFER,11800.0,C847552559
29944,1196428',2018-12-24,CHQ DEP/914573/OWDEL1/PUN,0.0,11800.0,,2018,12,24,CASH_IN,11800.0,C1782580546
29945,1196428',2018-12-24,CHQ DEP/996236/OWDEL1/SBI,0.0,11800.0,,2018,12,24,CHECK_CASHING,11800.0,C1382034610
29946,1196428',2018-12-24,CHQ DEP/640995/OWDEL1/PUN,0.0,11800.0,,2018,12,24,CHECK_CASHING,11800.0,C1161865950
29947,1196428',2018-12-24,TRF FROM  Indiaforensic SERVICES,0.0,500000.0,,2018,12,24,CASH_IN,500000.0,C408304912
29948,1196428',2018-12-24,FDRL/REAL TIME GROSS SETTL,2000000.0,0.0,,2018,12,24,PAYEMENT,2000000.0,C623476050
29949,1196428',2018-12-24,CHQ DEPOSIT RETURN/914573,11800.0,0.0,,2018,12,24,PAYEMENT,11800.0,C1357984916
29950,1196428',2018-12-24,TRF FROM  Indiaforensic SERVICES,0.0,2000000.0,,2018,12,24,CHECK_CASHING,2000000.0,C895798008
29951,1196428',2018-12-24,FDRL/INTERNAL FUND TRANSFE,0.0,3000000.0,,2018,12,24,TRANSFER,3000000.0,C1529115495
29952,1196428',2018-12-24,FDRL/NATIONAL ELECTRONIC F,3000000.0,0.0,,2018,12,24,CASH_OUT,3000000.0,C881662115
29953,1196428',2018-12-24,FDRL/NATIONAL ELECTRONIC F,2000000.0,0.0,,2018,12,24,DEBIT,2000000.0,C2129901484
29954,1196428',2018-12-24,IMPS 835816475233 FROM OX,0.0,100000.0,,2018,12,24,CHECK_CASHING,100000.0,C1104197405
29955,1196428',2018-12-24,FDRL/INTERNAL FUND TRANSFE,100000.0,0.0,,2018,12,24,DEBIT,100000.0,C1738994372
29956,1196428',2018-12-24,TRF FROM  Indiaforensic SERVICES,0.0,1000000.0,,2018,12,24,CASH_IN,1000000.0,C147647618
29957,1196428',2018-12-24,TRF FROM  Indiaforensic SERVICES,0.0,15000000.0,,2018,12,24,CASH_IN,15000000.0,C1157297801
29958,1196428',2018-12-24,TRF FROM  Indiaforensic SERVICES,0.0,2000000.0,,2018,12,24,CHECK_CASHING,2000000.0,C437747500
29959,1196428',2018-12-24,TRF FROM  Indiaforensic SERVICES,0.0,5000000.0,,2018,12,24,TRANSFER,5000000.0,C448155494
29960,1196428',2018-12-24,FDRL/NATIONAL ELECTRONIC F,3000000.0,0.0,,2018,12,24,CASH_OUT,3000000.0,C762570948
29961,1196428',2018-12-24,FDRL/NATIONAL ELECTRONIC F,3000000.0,0.0,,2018,12,24,CHECK_WITHDRAWAL,3000000.0,C1207946845
29962,1196428',2018-12-24,FDRL/NATIONAL ELECTRONIC F,3000000.0,0.0,,2018,12,24,DEBIT,3000000.0,C161140376
29963,1196428',2018-12-24,FDRL/NATIONAL ELECTRONIC F,3000000.0,0.0,,2018,12,24,CASH_OUT,3000000.0,C1167066016
29964,1196428',2018-12-24,FDRL/NATIONAL ELECTRONIC F,3000000.0,0.0,,2018,12,24,CHECK_WITHDRAWAL,3000000.0,C1183572822
29965,1196428',2018-12-24,FDRL/NATIONAL ELECTRONIC F,193657.33,0.0,,2018,12,24,CHECK_WITHDRAWAL,193657.33,C522632546
29966,1196428',2018-12-24,FDRL/NATIONAL ELECTRONIC F,1248434.0,0.0,,2018,12,24,CHECK_WITHDRAWAL,1248434.0,C2133732070
29967,1196428',2018-12-24,FDRL/NATIONAL ELECTRONIC F,1800343.0,0.0,,2018,12,24,CHECK_WITHDRAWAL,1800343.0,C1141100442
29968,1196428',2018-12-24,FDRL/INTERNAL FUND TRANSFE,400000.0,0.0,,2018,12,24,CASH_OUT,400000.0,M1032678573
29969,1196428',2018-12-24,FDRL/INTERNAL FUND TRANSFE,500000.0,0.0,,2018,12,24,CHECK_WITHDRAWAL,500000.0,C26334874
29970,1196428',2018-12-24,FDRL/INTERNAL FUND TRANSFE,1000000.0,0.0,,2018,12,24,DEBIT,1000000.0,C2095093840
29971,1196428',2018-12-24,TRF FROM  Indiaforensic SERVICES,0.0,2000000.0,,2018,12,24,TRANSFER,2000000.0,M1572855883
29972,1196428',2018-12-24,TRF FROM  Indiaforensic SERVICES,0.0,500000.0,,2018,12,24,CHECK_CASHING,500000.0,M52808470
29973,1196428',2018-12-24,TRF FROM  Indiaforensic SERVICES,0.0,500000.0,,2018,12,24,TRANSFER,500000.0,C815264031
29974,1196428',2018-12-24,TRF FROM  Indiaforensic SERVICES,0.0,500000.0,,2018,12,24,TRANSFER,500000.0,C1973538135
29975,1196428',2018-12-24,FDRL/INTERNAL FUND TRANSFE,3000000.0,0.0,,2018,12,24,PAYEMENT,3000000.0,C1295301356
29976,1196428',2018-12-24,FDRL/INTERNAL FUND TRANSFE,3000000.0,0.0,,2018,12,24,CHECK_WITHDRAWAL,3000000.0,C716442925
29977,1196428',2018-12-24,FDRL/INTERNAL FUND TRANSFE,400000.0,0.0,,2018,12,24,CHECK_WITHDRAWAL,400000.0,C1482979717
29978,1196428',2018-12-24,BEAT CSH PKP DEL GURGA 77,0.0,90200.0,,2018,12,24,TRANSFER,90200.0,C871895680
29979,1196428',2018-12-24,CHQ DEPOSIT RETURN/914573,100.0,0.0,,2018,12,24,PAYEMENT,100.0,C2013854563
29980,1196428',2018-12-24,CHQ DEPOSIT RETURN/914573,18.0,0.0,,2018,12,24,DEBIT,18.0,M405602357
29981,1196428',2018-12-26,RTGS/UTIBH18360693706/Indfor,0.0,800000.0,,2018,12,26,CHECK_CASHING,800000.0,C345679794
29982,1196428',2018-12-26,CASHDEP/NERUL/,0.0,77000.0,,2018,12,26,CASH_IN,77000.0,C896393489
29983,1196428',2018-12-26,FDRL/INTERNAL FUND TRANSFE,300000.0,0.0,,2018,12,26,CHECK_WITHDRAWAL,300000.0,M640263118
29984,1196428',2018-12-26,TRF FROM  Indiaforensic SERVICES,0.0,2000000.0,,2018,12,26,CHECK_CASHING,2000000.0,C1554540309
29985,1196428',2018-12-26,FDRL/INTERNAL FUND TRANSFE,300000.0,0.0,,2018,12,26,PAYEMENT,300000.0,C711496491
29986,1196428',2018-12-26,TRF FROM  Indiaforensic SERVICES,0.0,2000000.0,,2018,12,26,CHECK_CASHING,2000000.0,C1501701470
29987,1196428',2018-12-26,RTGS/ICICH18360400256/Indfor,0.0,500000.0,,2018,12,26,CASH_IN,500000.0,C1778289781
29988,1196428',2018-12-26,RTGS/ICICH18360399469/Indfor,0.0,1000000.0,,2018,12,26,TRANSFER,1000000.0,C531511436
29989,1196428',2018-12-26,RTGS/ICICH18360398838/Indfor,0.0,1000000.0,,2018,12,26,TRANSFER,1000000.0,C51626955
29990,1196428',2018-12-26,RTGS/ICICH18360397031/Indfor,0.0,1500000.0,,2018,12,26,CASH_IN,1500000.0,C732929236
29991,1196428',2018-12-26,TATA TELE SERVICES LTD,2310.0,0.0,,2018,12,26,DEBIT,2310.0,C977993101
29992,1196428',2018-12-26,FDRL/REAL TIME GROSS SETTL,3000000.0,0.0,,2018,12,26,DEBIT,3000000.0,C1036138670
29993,1196428',2018-12-26,FDRL/REAL TIME GROSS SETTL,5000000.0,0.0,,2018,12,26,CHECK_WITHDRAWAL,5000000.0,C500153041
29994,1196428',2018-12-26,RTGS/ICICH18360423816/Indfor,0.0,500000.0,,2018,12,26,CHECK_CASHING,500000.0,C1453795463
29995,1196428',2018-12-26,NEFT/N360180710502144/TEC,0.0,100000.0,,2018,12,26,TRANSFER,100000.0,C288106800
29996,1196428',2018-12-26,FDRL/INTERNAL FUND TRANSFE,0.0,2000000.0,,2018,12,26,CASH_IN,2000000.0,C33524623
29997,1196428',2018-12-26,TRF FRM 409000362497  Indfor,0.0,1749295.0,,2018,12,26,TRANSFER,1749295.0,C1263845074
29998,1196428',2018-12-26,FDRL/NATIONAL ELECTRONIC F,3000000.0,0.0,,2018,12,26,DEBIT,3000000.0,C1178471274
29999,1196428',2018-12-26,FDRL/NATIONAL ELECTRONIC F,58444.0,0.0,,2018,12,26,CHECK_WITHDRAWAL,58444.0,C849038219
30000,1196428',2018-12-26,NEFT/000057920265/Indiaforensic,0.0,1700000.0,,2018,12,26,CASH_IN,1700000.0,C1132146097
30001,1196428',2018-12-26,TRF FROM  Indiaforensic SERVICES,0.0,5000000.0,,2018,12,26,CASH_IN,5000000.0,C1210315704
30002,1196428',2018-12-26,TRF FROM  Indiaforensic SERVICES,0.0,4000000.0,,2018,12,26,CASH_IN,4000000.0,C1609979141
30003,1196428',2018-12-26,TRF FROM  Indiaforensic SERVICES,0.0,500000.0,,2018,12,26,TRANSFER,500000.0,C118648358
30004,1196428',2018-12-26,FDRL/INTERNAL FUND TRANSFE,500000.0,0.0,,2018,12,26,PAYEMENT,500000.0,C1531333864
30005,1196428',2018-12-26,FDRL/INTERNAL FUND TRANSFE,1000000.0,0.0,,2018,12,26,CHECK_WITHDRAWAL,1000000.0,M1515294537
30006,1196428',2018-12-26,FDRL/INTERNAL FUND TRANSFE,1000000.0,0.0,,2018,12,26,CHECK_WITHDRAWAL,1000000.0,M751764052
30007,1196428',2018-12-26,FDRL/INTERNAL FUND TRANSFE,500000.0,0.0,,2018,12,26,DEBIT,500000.0,M664177215
30008,1196428',2018-12-26,FDRL/INTERNAL FUND TRANSFE,500000.0,0.0,,2018,12,26,CASH_OUT,500000.0,M285630521
30009,1196428',2018-12-26,FDRL/INTERNAL FUND TRANSFE,500000.0,0.0,,2018,12,26,DEBIT,500000.0,M676853552
30010,1196428',2018-12-26,BEAT CSH PKP DEL GURGA 77,0.0,67000.0,,2018,12,26,CHECK_CASHING,67000.0,M930843801
30011,1196428',2018-12-27,FDRL/NATIONAL ELECTRONIC F,34402.0,0.0,,2018,12,27,PAYEMENT,34402.0,M17307487
30012,1196428',2018-12-27,FDRL/NATIONAL ELECTRONIC F,30818.0,0.0,,2018,12,27,CHECK_WITHDRAWAL,30818.0,M239811214
30013,1196428',2018-12-27,FDRL/NATIONAL ELECTRONIC F,37667.0,0.0,,2018,12,27,PAYEMENT,37667.0,M1429594005
30014,1196428',2018-12-27,FDRL/NATIONAL ELECTRONIC F,39507.0,0.0,,2018,12,27,PAYEMENT,39507.0,M481494049
30015,1196428',2018-12-27,FDRL/NATIONAL ELECTRONIC F,37231.0,0.0,,2018,12,27,CHECK_WITHDRAWAL,37231.0,M1197610250
30016,1196428',2018-12-27,FDRL/NATIONAL ELECTRONIC F,38667.0,0.0,,2018,12,27,CHECK_WITHDRAWAL,38667.0,M1449045632
30017,1196428',2018-12-27,FDRL/NATIONAL ELECTRONIC F,32706.0,0.0,,2018,12,27,DEBIT,32706.0,M952744224
30018,1196428',2018-12-27,FDRL/NATIONAL ELECTRONIC F,39804.0,0.0,,2018,12,27,PAYEMENT,39804.0,M139246209
30019,1196428',2018-12-27,FDRL/NATIONAL ELECTRONIC F,49669.0,0.0,,2018,12,27,CASH_OUT,49669.0,M863994310
30020,1196428',2018-12-27,FDRL/NATIONAL ELECTRONIC F,41345.0,0.0,,2018,12,27,PAYEMENT,41345.0,M1553183602
30021,1196428',2018-12-27,FDRL/NATIONAL ELECTRONIC F,30170.0,0.0,,2018,12,27,CASH_OUT,30170.0,M78921512
30022,1196428',2018-12-27,FDRL/NATIONAL ELECTRONIC F,31213.0,0.0,,2018,12,27,CHECK_WITHDRAWAL,31213.0,M1088782032
30023,1196428',2018-12-27,FDRL/NATIONAL ELECTRONIC F,46750.0,0.0,,2018,12,27,CASH_OUT,46750.0,M2041213627
30024,1196428',2018-12-27,FDRL/NATIONAL ELECTRONIC F,31595.0,0.0,,2018,12,27,CHECK_WITHDRAWAL,31595.0,C1044472558
30025,1196428',2018-12-27,FDRL/NATIONAL ELECTRONIC F,45200.0,0.0,,2018,12,27,PAYEMENT,45200.0,C1336496959
30026,1196428',2018-12-27,FDRL/NATIONAL ELECTRONIC F,34258.0,0.0,,2018,12,27,DEBIT,34258.0,M368183804
30027,1196428',2018-12-27,FDRL/NATIONAL ELECTRONIC F,36552.0,0.0,,2018,12,27,CHECK_WITHDRAWAL,36552.0,M970284950
30028,1196428',2018-12-27,FDRL/NATIONAL ELECTRONIC F,45200.0,0.0,,2018,12,27,CASH_OUT,45200.0,M1070671846
30029,1196428',2018-12-27,FDRL/NATIONAL ELECTRONIC F,32544.0,0.0,,2018,12,27,CASH_OUT,32544.0,M345946097
30030,1196428',2018-12-27,FDRL/NATIONAL ELECTRONIC F,37123.0,0.0,,2018,12,27,CHECK_WITHDRAWAL,37123.0,C1937962514
30031,1196428',2018-12-27,FDRL/NATIONAL ELECTRONIC F,33127.0,0.0,,2018,12,27,CASH_OUT,33127.0,C2008913953
30032,1196428',2018-12-27,FDRL/REAL TIME GROSS SETTL,5000000.0,0.0,,2018,12,27,CASH_OUT,5000000.0,M380677295
30033,1196428',2018-12-27,FDRL/REAL TIME GROSS SETTL,3000000.0,0.0,,2018,12,27,CASH_OUT,3000000.0,M1739820129
30034,1196428',2018-12-27,FDRL/INTERNAL FUND TRANSFE,100000.0,0.0,,2018,12,27,CHECK_WITHDRAWAL,100000.0,M110314381
30035,1196428',2018-12-27,TRF FRM 409000362497  Indfor,0.0,3540861.0,,2018,12,27,TRANSFER,3540861.0,M798839822
30036,1196428',2018-12-27,FDRL/REAL TIME GROSS SETTL,3000000.0,0.0,,2018,12,27,DEBIT,3000000.0,C1761353343
30037,1196428',2018-12-27,CASHDEP/BOISAR/,0.0,3000.0,,2018,12,27,CHECK_CASHING,3000.0,M1751582394
30038,1196428',2018-12-27,TRF FROM  Indiaforensic SERVICES,0.0,2000000.0,,2018,12,27,CASH_IN,2000000.0,M275213440
30039,1196428',2018-12-27,RTGS/ICICH18361547464/Indfor,0.0,1000000.0,,2018,12,27,CHECK_CASHING,1000000.0,C678651991
30040,1196428',2018-12-27,RTGS/ICICH18361548100/Indfor,0.0,1000000.0,,2018,12,27,CHECK_CASHING,1000000.0,M694432383
30041,1196428',2018-12-27,FDRL/NATIONAL ELECTRONIC F,2000000.0,0.0,,2018,12,27,CHECK_WITHDRAWAL,2000000.0,C2116153614
30042,1196428',2018-12-27,FDRL/NATIONAL ELECTRONIC F,2000000.0,0.0,,2018,12,27,CASH_OUT,2000000.0,C1373130111
30043,1196428',2018-12-27,FDRL/INTERNAL FUND TRANSFE,200000.0,0.0,,2018,12,27,CASH_OUT,200000.0,M1325053111
30044,1196428',2018-12-27,TRF FRM  Indiaforensic SERVICES,0.0,10000000.0,,2018,12,27,CASH_IN,10000000.0,M1842399189
30045,1196428',2018-12-27,NEFT/000057994636/Indiaforensic,0.0,500000.0,,2018,12,27,CHECK_CASHING,500000.0,M477430769
30046,1196428',2018-12-27,FDRL/NATIONAL ELECTRONIC F,36516.5,0.0,,2018,12,27,CASH_OUT,36516.5,C1803688302
30047,1196428',2018-12-27,FDRL/NATIONAL ELECTRONIC F,25920.0,0.0,,2018,12,27,CASH_OUT,25920.0,C325918040
30048,1196428',2018-12-27,FDRL/NATIONAL ELECTRONIC F,36000.0,0.0,,2018,12,27,DEBIT,36000.0,M2081778817
30049,1196428',2018-12-27,FDRL/NATIONAL ELECTRONIC F,34851.0,0.0,,2018,12,27,CASH_OUT,34851.0,M997522561
30050,1196428',2018-12-27,FDRL/NATIONAL ELECTRONIC F,30637.5,0.0,,2018,12,27,DEBIT,30637.5,C1570256460
30051,1196428',2018-12-27,FDRL/NATIONAL ELECTRONIC F,35771.5,0.0,,2018,12,27,CHECK_WITHDRAWAL,35771.5,M414412950
30052,1196428',2018-12-27,FDRL/NATIONAL ELECTRONIC F,20000.0,0.0,,2018,12,27,CHECK_WITHDRAWAL,20000.0,C1545523026
30053,1196428',2018-12-27,FDRL/NATIONAL ELECTRONIC F,40907.0,0.0,,2018,12,27,PAYEMENT,40907.0,C1923206317
30054,1196428',2018-12-27,FDRL/NATIONAL ELECTRONIC F,34766.0,0.0,,2018,12,27,PAYEMENT,34766.0,M1615491843
30055,1196428',2018-12-27,FDRL/NATIONAL ELECTRONIC F,33715.5,0.0,,2018,12,27,CASH_OUT,33715.5,C473485349
30056,1196428',2018-12-27,FDRL/NATIONAL ELECTRONIC F,46720.0,0.0,,2018,12,27,CASH_OUT,46720.0,C510382951
30057,1196428',2018-12-27,FDRL/NATIONAL ELECTRONIC F,31368.0,0.0,,2018,12,27,CHECK_WITHDRAWAL,31368.0,M1429436113
30058,1196428',2018-12-27,FDRL/NATIONAL ELECTRONIC F,27282.0,0.0,,2018,12,27,DEBIT,27282.0,M1596121702
30059,1196428',2018-12-27,FDRL/NATIONAL ELECTRONIC F,29439.0,0.0,,2018,12,27,PAYEMENT,29439.0,M1641026918
30060,1196428',2018-12-27,FDRL/NATIONAL ELECTRONIC F,28064.5,0.0,,2018,12,27,CASH_OUT,28064.5,C897697267
30061,1196428',2018-12-27,FDRL/NATIONAL ELECTRONIC F,28757.0,0.0,,2018,12,27,PAYEMENT,28757.0,C230816700
30062,1196428',2018-12-27,FDRL/NATIONAL ELECTRONIC F,26578.0,0.0,,2018,12,27,PAYEMENT,26578.0,C1106230569
30063,1196428',2018-12-27,FDRL/NATIONAL ELECTRONIC F,30030.0,0.0,,2018,12,27,PAYEMENT,30030.0,M930188353
30064,1196428',2018-12-27,FDRL/NATIONAL ELECTRONIC F,29555.0,0.0,,2018,12,27,CHECK_WITHDRAWAL,29555.0,M1355995515
30065,1196428',2018-12-27,FDRL/NATIONAL ELECTRONIC F,26850.0,0.0,,2018,12,27,PAYEMENT,26850.0,M82862370
30066,1196428',2018-12-27,FDRL/NATIONAL ELECTRONIC F,36916.5,0.0,,2018,12,27,DEBIT,36916.5,M93928334
30067,1196428',2018-12-27,FDRL/NATIONAL ELECTRONIC F,25724.0,0.0,,2018,12,27,PAYEMENT,25724.0,C207258326
30068,1196428',2018-12-27,FDRL/NATIONAL ELECTRONIC F,31798.5,0.0,,2018,12,27,CASH_OUT,31798.5,C155169291
30069,1196428',2018-12-27,FDRL/NATIONAL ELECTRONIC F,30374.0,0.0,,2018,12,27,CHECK_WITHDRAWAL,30374.0,C1516565803
30070,1196428',2018-12-27,FDRL/NATIONAL ELECTRONIC F,34967.5,0.0,,2018,12,27,CHECK_WITHDRAWAL,34967.5,M918302405
30071,1196428',2018-12-27,FDRL/NATIONAL ELECTRONIC F,2630681.98,0.0,,2018,12,27,DEBIT,2630681.98,M101715009
30072,1196428',2018-12-27,FDRL/NATIONAL ELECTRONIC F,1778110.78,0.0,,2018,12,27,PAYEMENT,1778110.78,M1693638731
30073,1196428',2018-12-27,FDRL/NATIONAL ELECTRONIC F,1705287.58,0.0,,2018,12,27,DEBIT,1705287.58,C1711313768
30074,1196428',2018-12-27,TRF FRM  Indiaforensic SERVICES,0.0,2400000.0,,2018,12,27,CASH_IN,2400000.0,C465257140
30075,1196428',2018-12-27,FDRL/INTERNAL FUND TRANSFE,1000000.0,0.0,,2018,12,27,CHECK_WITHDRAWAL,1000000.0,C1877764981
30076,1196428',2018-12-27,FDRL/INTERNAL FUND TRANSFE,500000.0,0.0,,2018,12,27,CHECK_WITHDRAWAL,500000.0,C731253803
30077,1196428',2018-12-27,FDRL/INTERNAL FUND TRANSFE,1000000.0,0.0,,2018,12,27,DEBIT,1000000.0,M730606907
30078,1196428',2018-12-27,FDRL/INTERNAL FUND TRANSFE,500000.0,0.0,,2018,12,27,CASH_OUT,500000.0,C1914772936
30079,1196428',2018-12-27,FDRL/INTERNAL FUND TRANSFE,100000.0,0.0,,2018,12,27,PAYEMENT,100000.0,C1508456612
30080,1196428',2018-12-27,FDRL/INTERNAL FUND TRANSFE,500000.0,0.0,,2018,12,27,DEBIT,500000.0,C228669487
30081,1196428',2018-12-27,FDRL/INTERNAL FUND TRANSFE,100000.0,0.0,,2018,12,27,DEBIT,100000.0,M506660128
30082,1196428',2018-12-27,TRF FROM 409000362497  OX,0.0,1819734.0,,2018,12,27,CASH_IN,1819734.0,M841536159
30083,1196428',2018-12-27,BEAT CSH PKP DEL GURGA 77,0.0,91000.0,,2018,12,27,TRANSFER,91000.0,C758750856
30084,1196428',2018-12-28,CASHDEP/NERUL/,0.0,50000.0,,2018,12,28,CHECK_CASHING,50000.0,M765212715
30085,1196428',2018-12-28,FDRL/INTERNAL FUND TRANSFE,0.0,500000.0,,2018,12,28,CHECK_CASHING,500000.0,M319488518
30086,1196428',2018-12-28,FDRL/REAL TIME GROSS SETTL,5000000.0,0.0,,2018,12,28,CASH_OUT,5000000.0,M1934387496
30087,1196428',2018-12-28,FDRL/INTERNAL FUND TRANSFE,200000.0,0.0,,2018,12,28,CASH_OUT,200000.0,C638822140
30088,1196428',2018-12-28,FDRL/INTERNAL FUND TRANSFE,0.0,1000000.0,,2018,12,28,TRANSFER,1000000.0,C1346065207
30089,1196428',2018-12-28,FDRL/NATIONAL ELECTRONIC F,500000.0,0.0,,2018,12,28,CHECK_WITHDRAWAL,500000.0,M32302420
30090,1196428',2018-12-28,FDRL/NATIONAL ELECTRONIC F,500000.0,0.0,,2018,12,28,CHECK_WITHDRAWAL,500000.0,M1261461477
30091,1196428',2018-12-28,NEFT/000058062001/Indiaforensic,0.0,500000.0,,2018,12,28,CHECK_CASHING,500000.0,C1012785532
30092,1196428',2018-12-28,FDRL/INTERNAL FUND TRANSFE,0.0,1000000.0,,2018,12,28,CASH_IN,1000000.0,M1671878348
30093,1196428',2018-12-28,FDRL/INTERNAL FUND TRANSFE,0.0,500000.0,,2018,12,28,TRANSFER,500000.0,C1499383906
30094,1196428',2018-12-28,FDRL/INTERNAL FUND TRANSFE,0.0,1000000.0,,2018,12,28,TRANSFER,1000000.0,C1525409936
30095,1196428',2018-12-28,FDRL/NATIONAL ELECTRONIC F,2887102.0,0.0,,2018,12,28,CASH_OUT,2887102.0,C865922491
30096,1196428',2018-12-28,NEFT/SBIN218362508230/IND,0.0,2375304.23,,2018,12,28,CASH_IN,2375304.23,M875769792
30097,1196428',2018-12-28,FDRL/INTERNAL FUND TRANSFE,500000.0,0.0,,2018,12,28,CASH_OUT,500000.0,C418902856
30098,1196428',2018-12-28,FDRL/INTERNAL FUND TRANSFE,1000000.0,0.0,,2018,12,28,CASH_OUT,1000000.0,C194988831
30099,1196428',2018-12-28,FDRL/INTERNAL FUND TRANSFE,1000000.0,0.0,,2018,12,28,CHECK_WITHDRAWAL,1000000.0,C803793969
30100,1196428',2018-12-28,FDRL/INTERNAL FUND TRANSFE,0.0,500000.0,,2018,12,28,CASH_IN,500000.0,M2014009380
30101,1196428',2018-12-28,FDRL/INTERNAL FUND TRANSFE,0.0,1000000.0,,2018,12,28,CHECK_CASHING,1000000.0,M1014133140
30102,1196428',2018-12-28,FDRL/INTERNAL FUND TRANSFE,300000.0,0.0,,2018,12,28,PAYEMENT,300000.0,C2100440237
30103,1196428',2018-12-28,NEFT/N362180712407800/TEC,0.0,200000.0,,2018,12,28,CASH_IN,200000.0,M469867212
30104,1196428',2018-12-28,FDRL/INTERNAL FUND TRANSFE,400000.0,0.0,,2018,12,28,DEBIT,400000.0,M303769632
30105,1196428',2018-12-28,BEAT CSH PKP DEL GURGA 77,0.0,143000.0,,2018,12,28,CASH_IN,143000.0,C624539461
30106,1196428',2018-12-29,CASHDEP/NERUL/,0.0,30100.0,,2018,12,29,CASH_IN,30100.0,M1921144339
30107,1196428',2018-12-29,FDRL/INTERNAL FUND TRANSFE,0.0,1000000.0,,2018,12,29,CHECK_CASHING,1000000.0,C1664927413
30108,1196428',2018-12-29,FDRL/INTERNAL FUND TRANSFE,0.0,500000.0,,2018,12,29,CHECK_CASHING,500000.0,C1790657739
30109,1196428',2018-12-29,FDRL/NATIONAL ELECTRONIC F,500000.0,0.0,,2018,12,29,CASH_OUT,500000.0,M1880273089
30110,1196428',2018-12-29,FDRL/NATIONAL ELECTRONIC F,500000.0,0.0,,2018,12,29,DEBIT,500000.0,M734383607
30111,1196428',2018-12-29,FDRL/NATIONAL ELECTRONIC F,500000.0,0.0,,2018,12,29,DEBIT,500000.0,C805898248
30112,1196428',2018-12-29,CHQ DEP/102835/OWDEL1/YES,0.0,13500.0,,2018,12,29,CHECK_CASHING,13500.0,M273082117
30113,1196428',2018-12-29,CHQ DEP/196/OWDEL1/HDFC/B,0.0,11800.0,,2018,12,29,CHECK_CASHING,11800.0,C2043975568
30114,1196428',2018-12-29,CHQ DEP/63590/OWDEL1/ALLA,0.0,13500.0,,2018,12,29,CHECK_CASHING,13500.0,M2033058547
30115,1196428',2018-12-29,FDRL/INTERNAL FUND TRANSFE,0.0,1000000.0,,2018,12,29,CASH_IN,1000000.0,M43403295
30116,1196428',2018-12-29,FDRL/INTERNAL FUND TRANSFE,0.0,1000000.0,,2018,12,29,TRANSFER,1000000.0,C1269605689
30117,1196428',2018-12-29,FDRL/INTERNAL FUND TRANSFE,0.0,1000000.0,,2018,12,29,TRANSFER,1000000.0,C1727565779
30118,1196428',2018-12-29,FDRL/INTERNAL FUND TRANSFE,0.0,1000000.0,,2018,12,29,TRANSFER,1000000.0,C849038219
30119,1196428',2018-12-29,FDRL/INTERNAL FUND TRANSFE,0.0,1000000.0,,2018,12,29,TRANSFER,1000000.0,C443298466
30120,1196428',2018-12-29,FDRL/INTERNAL FUND TRANSFE,0.0,1000000.0,,2018,12,29,CHECK_CASHING,1000000.0,C694632384
30121,1196428',2018-12-29,FDRL/INTERNAL FUND TRANSFE,0.0,1000000.0,,2018,12,29,TRANSFER,1000000.0,C1948558238
30122,1196428',2018-12-29,FDRL/REAL TIME GROSS SETTL,3000000.0,0.0,,2018,12,29,DEBIT,3000000.0,C58333888
30123,1196428',2018-12-29,FDRL/NATIONAL ELECTRONIC F,500000.0,0.0,,2018,12,29,PAYEMENT,500000.0,C1167066016
30124,1196428',2018-12-29,FDRL/NATIONAL ELECTRONIC F,500000.0,0.0,,2018,12,29,CASH_OUT,500000.0,C188246551
30125,1196428',2018-12-29,FDRL/INTERNAL FUND TRANSFE,500000.0,0.0,,2018,12,29,PAYEMENT,500000.0,C1303868418
30126,1196428',2018-12-29,FDRL/INTERNAL FUND TRANSFE,1000000.0,0.0,,2018,12,29,CHECK_WITHDRAWAL,1000000.0,C873287880
30127,1196428',2018-12-29,FDRL/INTERNAL FUND TRANSFE,1000000.0,0.0,,2018,12,29,CASH_OUT,1000000.0,C1897050650
30128,1196428',2018-12-29,FDRL/INTERNAL FUND TRANSFE,400000.0,0.0,,2018,12,29,CHECK_WITHDRAWAL,400000.0,C360898540
30129,1196428',2018-12-29,CHQ DEPOSIT RETURN/196/FU,11800.0,0.0,,2018,12,29,CASH_OUT,11800.0,M283338301
30130,1196428',2018-12-29,BEAT CSH PKP DEL GURGA 77,0.0,197000.0,,2018,12,29,TRANSFER,197000.0,C966526472
30131,1196428',2018-12-29,CHQ DEPOSIT RETURN/196/CH,100.0,0.0,,2018,12,29,CASH_OUT,100.0,M1043525810
30132,1196428',2018-12-29,CHQ DEPOSIT RETURN/196/GS,18.0,0.0,,2018,12,29,CASH_OUT,18.0,C1870436181
30133,1196428',2018-12-31,FDRL/INTERNAL FUND TRANSFE,100000.0,0.0,,2018,12,31,CHECK_WITHDRAWAL,100000.0,M702479289
30134,1196428',2018-12-31,FDRL/INTERNAL FUND TRANSFE,0.0,1000000.0,,2018,12,31,CASH_IN,1000000.0,M1755160348
30135,1196428',2018-12-31,FDRL/INTERNAL FUND TRANSFE,0.0,500000.0,,2018,12,31,CASH_IN,500000.0,C268265185
30136,1196428',2018-12-31,FDRL/NATIONAL ELECTRONIC F,500000.0,0.0,,2018,12,31,CASH_OUT,500000.0,M1533532103
30137,1196428',2018-12-31,FDRL/NATIONAL ELECTRONIC F,1000000.0,0.0,,2018,12,31,DEBIT,1000000.0,C1167066016
30138,1196428',2018-12-31,CHQ DEP/34110/OWDEL1/SBIN,0.0,11800.0,,2018,12,31,TRANSFER,11800.0,C383296094
30139,1196428',2018-12-31,FDRL/INTERNAL FUND TRANSFE,0.0,1000000.0,,2018,12,31,TRANSFER,1000000.0,C2013854563
30140,1196428',2018-12-31,FDRL/INTERNAL FUND TRANSFE,32000.0,0.0,,2018,12,31,CHECK_WITHDRAWAL,32000.0,C646059443
30141,1196428',2018-12-31,FDRL/INTERNAL FUND TRANSFE,528711.0,0.0,,2018,12,31,PAYEMENT,528711.0,M537705292
30142,1196428',2018-12-31,FDRL/INTERNAL FUND TRANSFE,0.0,5000000.0,,2018,12,31,TRANSFER,5000000.0,M619531308
30143,1196428',2018-12-31,FDRL/INTERNAL FUND TRANSFE,0.0,1000000.0,,2018,12,31,CASH_IN,1000000.0,C796796033
30144,1196428',2018-12-31,FDRL/INTERNAL FUND TRANSFE,0.0,5000000.0,,2018,12,31,CHECK_CASHING,5000000.0,M617085163
30145,1196428',2018-12-31,FDRL/INTERNAL FUND TRANSFE,0.0,500000.0,,2018,12,31,CASH_IN,500000.0,C1697258007
30146,1196428',2018-12-31,FDRL/INTERNAL FUND TRANSFE,0.0,1000000.0,,2018,12,31,CASH_IN,1000000.0,M925761260
30147,1196428',2018-12-31,FDRL/INTERNAL FUND TRANSFE,0.0,1000000.0,,2018,12,31,CASH_IN,1000000.0,M1821441907
30148,1196428',2018-12-31,FDRL/INTERNAL FUND TRANSFE,0.0,1000000.0,,2018,12,31,CASH_IN,1000000.0,C1334973394
30149,1196428',2018-12-31,FDRL/REAL TIME GROSS SETTL,5000000.0,0.0,,2018,12,31,CASH_OUT,5000000.0,C531511436
30150,1196428',2018-12-31,FDRL/REAL TIME GROSS SETTL,5000000.0,0.0,,2018,12,31,CASH_OUT,5000000.0,C1788961047
30151,1196428',2018-12-31,FDRL/REAL TIME GROSS SETTL,5000000.0,0.0,,2018,12,31,DEBIT,5000000.0,C184253187
30152,1196428',2018-12-31,TRF FROM 409000362497  OX,0.0,3956623.0,,2018,12,31,TRANSFER,3956623.0,C1090263069
30153,1196428',2018-12-31,FDRL/INTERNAL FUND TRANSFE,500000.0,0.0,,2018,12,31,CASH_OUT,500000.0,C804475266
30154,1196428',2018-12-31,FDRL/INTERNAL FUND TRANSFE,500000.0,0.0,,2018,12,31,CHECK_WITHDRAWAL,500000.0,C1494895909
30155,1196428',2018-12-31,FDRL/INTERNAL FUND TRANSFE,500000.0,0.0,,2018,12,31,CHECK_WITHDRAWAL,500000.0,C1360767589
30156,1196428',2018-12-31,FDRL/INTERNAL FUND TRANSFE,400000.0,0.0,,2018,12,31,CHECK_WITHDRAWAL,400000.0,C1251991550
30157,1196428',2018-12-31,FDRL/INTERNAL FUND TRANSFE,1000000.0,0.0,,2018,12,31,CHECK_WITHDRAWAL,1000000.0,C1871689990
30158,1196428',2018-12-31,FDRL/INTERNAL FUND TRANSFE,200000.0,0.0,,2018,12,31,CASH_OUT,200000.0,C1898859288
30159,1196428',2018-12-31,FDRL/NATIONAL ELECTRONIC F,1000000.0,0.0,,2018,12,31,CHECK_WITHDRAWAL,1000000.0,C940159462
30160,1196428',2018-12-31,IMPS 836517484448 FROM MU,0.0,5000.0,,2018,12,31,CHECK_CASHING,5000.0,C1017767725
30161,1196428',2018-12-31,FDRL/INTERNAL FUND TRANSFE,0.0,500000.0,,2018,12,31,TRANSFER,500000.0,C219771880
30162,1196428',2018-12-31,FDRL/NATIONAL ELECTRONIC F,500000.0,0.0,,2018,12,31,DEBIT,500000.0,C465499079
30163,1196428',2018-12-31,BEAT CSH PKP DEL GURGA 77,0.0,37000.0,,2018,12,31,TRANSFER,37000.0,C683605346
30164,1196428',2018-12-31,1196428:Int.Coll:01-12-20,830384.0,0.0,,2018,12,31,CASH_OUT,830384.0,C716442925
30165,409000362497',2018-01-01,IMPS 3012171C,5859736.48,0.0,,2018,1,1,CHECK_WITHDRAWAL,5859736.48,C1452722471
30166,409000362497',2018-01-01,IMPS 311217 1C,1937398.01,0.0,,2018,1,1,DEBIT,1937398.01,C505528357
30167,409000362497',2018-01-01,IMPS 010118 2C,4689365.4,0.0,,2018,1,1,DEBIT,4689365.4,C2115178036
30168,409000362497',2018-01-01,IMPS 010118 3C,10816152.48,0.0,,2018,1,1,DEBIT,10816152.48,C1416278059
30169,409000362497',2018-01-01,FDRL/INTERNAL FUND TRANSFE,0.0,9000000.0,,2018,1,1,CHECK_CASHING,9000000.0,C667346055
30170,409000362497',2018-01-01,FDRL/INTERNAL FUND TRANSFE,0.0,9000000.0,,2018,1,1,CASH_IN,9000000.0,C1401721023
30171,409000362497',2018-01-01,FDRL/INTERNAL FUND TRANSFE,0.0,3000000.0,,2018,1,1,CASH_IN,3000000.0,C59215997
30172,409000362497',2018-01-01,NEFT/AXIC180017700341/Indfor,0.0,5000000.0,,2018,1,1,CASH_IN,5000000.0,C1761291320
30173,409000362497',2018-01-01,NEFT/SBIN918001464821/Indfor,0.0,4000000.0,,2018,1,1,TRANSFER,4000000.0,C1991252420
30174,409000362497',2018-01-01,IMPS 010118 4C,5801462.06,0.0,,2018,1,1,CHECK_WITHDRAWAL,5801462.06,C1856036778
30175,409000362497',2018-01-01,Sweep Trf To: 40900036427,699152.0,0.0,,2018,1,1,DEBIT,699152.0,C599968109
30176,409000362497',2018-01-02,IMPS 0101181C,5528676.54,0.0,,2018,1,2,CHECK_WITHDRAWAL,5528676.54,C2037251990
30177,409000362497',2018-01-02,IMPS 020118 1C,2898905.81,0.0,,2018,1,2,CASH_OUT,2898905.81,C899455803
30178,409000362497',2018-01-02,NEFT/BKIDN18002822220/MAN,0.0,1000.0,,2018,1,2,TRANSFER,1000.0,M1131246915
30179,409000362497',2018-01-02,BIGTREE ENTERTAINMENT PRI,10357.0,0.0,,2018,1,2,PAYEMENT,10357.0,C1691655733
30180,409000362497',2018-01-02,INDIAIDEAS.COM LTD,94069.0,0.0,,2018,1,2,PAYEMENT,94069.0,M39955969
30181,409000362497',2018-01-02,IRCTC CORPORATE OFFICE AC,448110.0,0.0,,2018,1,2,CASH_OUT,448110.0,M1743859821
30182,409000362497',2018-01-02,PAYU PAYMENTS PRIVATE LIM,54937.0,0.0,,2018,1,2,PAYEMENT,54937.0,C1227603646
30183,409000362497',2018-01-02,AVENUES INDIA PRIVATE LIM,30873.0,0.0,,2018,1,2,DEBIT,30873.0,C1445567246
30184,409000362497',2018-01-02,FUTURE RETAIL LIMITED (OW,6086.0,0.0,,2018,1,2,PAYEMENT,6086.0,C2133591152
30185,409000362497',2018-01-02,PASFAR TECHNOLOGIES PRIVA,7639.0,0.0,,2018,1,2,PAYEMENT,7639.0,M1887201048
30186,409000362497',2018-01-02,MEHAR ENTERTAINMENT PRIVA,16922.0,0.0,,2018,1,2,CHECK_WITHDRAWAL,16922.0,M327218870
30187,409000362497',2018-01-02,E-BILLING SOLUTIONS PRIVA,1726.0,0.0,,2018,1,2,CASH_OUT,1726.0,M824537060
30188,409000362497',2018-01-02,SYNERGISTIC FINANCIAL NET,18.0,0.0,,2018,1,2,PAYEMENT,18.0,M1184707801
30189,409000362497',2018-01-02,Indiaforensic SERVICES INDIA PVT,2290185.0,0.0,,2018,1,2,CHECK_WITHDRAWAL,2290185.0,M1784227095
30190,409000362497',2018-01-02,IMPS 020118 3C,11841545.08,0.0,,2018,1,2,PAYEMENT,11841545.08,M1965694701
30191,409000362497',2018-01-02,IMPS 800218065527 FROM OX,0.0,200000.0,,2018,1,2,TRANSFER,200000.0,M1873661876
30192,409000362497',2018-01-02,IMPS 800218065580 FROM OX,0.0,200000.0,,2018,1,2,CASH_IN,200000.0,M1725165978
30193,409000362497',2018-01-02,IMPS 800218065613 FROM OX,0.0,200000.0,,2018,1,2,CASH_IN,200000.0,M1377685601
30194,409000362497',2018-01-02,IMPS 800218065655 FROM OX,0.0,200000.0,,2018,1,2,TRANSFER,200000.0,M840591224
30195,409000362497',2018-01-02,IMPS 800218065684 FROM OX,0.0,200000.0,,2018,1,2,CHECK_CASHING,200000.0,M1055570021
30196,409000362497',2018-01-02,IMPS 800218065731 FROM OX,0.0,200000.0,,2018,1,2,CHECK_CASHING,200000.0,M1949868620
30197,409000362497',2018-01-02,IMPS 800218065767 FROM OX,0.0,200000.0,,2018,1,2,CHECK_CASHING,200000.0,M1518598469
30198,409000362497',2018-01-02,IMPS 800218065808 FROM OX,0.0,200000.0,,2018,1,2,CASH_IN,200000.0,M1065714722
30199,409000362497',2018-01-02,IMPS 800218065914 FROM OX,0.0,200000.0,,2018,1,2,CASH_IN,200000.0,M1103587537
30200,409000362497',2018-01-02,IMPS 800218065951 FROM OX,0.0,200000.0,,2018,1,2,CASH_IN,200000.0,M804824892
30201,409000362497',2018-01-02,IMPS 800218066481 FROM OX,0.0,200000.0,,2018,1,2,CASH_IN,200000.0,M236294307
30202,409000362497',2018-01-02,IMPS 800218066532 FROM OX,0.0,200000.0,,2018,1,2,CASH_IN,200000.0,M615602626
30203,409000362497',2018-01-02,IMPS 800218066579 FROM OX,0.0,200000.0,,2018,1,2,CASH_IN,200000.0,M85348371
30204,409000362497',2018-01-02,IMPS 800218066630 FROM OX,0.0,200000.0,,2018,1,2,CHECK_CASHING,200000.0,M863394546
30205,409000362497',2018-01-02,IMPS 800218066669 FROM OX,0.0,200000.0,,2018,1,2,CASH_IN,200000.0,M26274417
30206,409000362497',2018-01-02,IMPS 800218066712 FROM OX,0.0,200000.0,,2018,1,2,CASH_IN,200000.0,C2033711470
30207,409000362497',2018-01-02,IMPS 800218066770 FROM OX,0.0,200000.0,,2018,1,2,CASH_IN,200000.0,C818570949
30208,409000362497',2018-01-02,IMPS 800218066818 FROM OX,0.0,200000.0,,2018,1,2,CHECK_CASHING,200000.0,C1909597726
30209,409000362497',2018-01-02,IMPS 800218066866 FROM OX,0.0,200000.0,,2018,1,2,CHECK_CASHING,200000.0,C1755976954
30210,409000362497',2018-01-02,IMPS 800218066915 FROM OX,0.0,200000.0,,2018,1,2,CASH_IN,200000.0,C1394526584
30211,409000362497',2018-01-02,NEFT/SBIN218002296692/Indfor,0.0,3000000.0,,2018,1,2,CHECK_CASHING,3000000.0,C1019670582
30212,409000362497',2018-01-02,IMPS 800219078609 FROM OX,0.0,200000.0,,2018,1,2,CASH_IN,200000.0,C1137371968
30213,409000362497',2018-01-02,IMPS 800219078699 FROM OX,0.0,200000.0,,2018,1,2,CHECK_CASHING,200000.0,C643996026
30214,409000362497',2018-01-02,IMPS 800219078759 FROM OX,0.0,200000.0,,2018,1,2,CHECK_CASHING,200000.0,C1948471365
30215,409000362497',2018-01-02,FDRL/INTERNAL FUND TRANSFE,0.0,15000000.0,,2018,1,2,CHECK_CASHING,15000000.0,C298222185
30216,409000362497',2018-01-02,FDRL/INTERNAL FUND TRANSFE,0.0,2000000.0,,2018,1,2,CASH_IN,2000000.0,C1234363215
30217,409000362497',2018-01-02,IMPS 020118 4C,3036635.99,0.0,,2018,1,2,PAYEMENT,3036635.99,C1554622120
30218,409000362497',2018-01-02,Sweep Trf To: 40900036427,635655.0,0.0,,2018,1,2,CASH_OUT,635655.0,C85102332
30219,409000362497',2018-01-03,IMPS 0201181C,4483439.51,0.0,,2018,1,3,PAYEMENT,4483439.51,C370055648
30220,409000362497',2018-01-03,IMPS 030118 2C,3919961.35,0.0,,2018,1,3,CASH_OUT,3919961.35,C732929236
30221,409000362497',2018-01-03,RTGS/YESBH18003031222/IRC,0.0,1573275.0,,2018,1,3,TRANSFER,1573275.0,C969409298
30222,409000362497',2018-01-03,BIGTREE ENTERTAINMENT PRI,3015.0,0.0,,2018,1,3,CHECK_WITHDRAWAL,3015.0,C1753714541
30223,409000362497',2018-01-03,INDIAIDEAS.COM LTD,78822.0,0.0,,2018,1,3,PAYEMENT,78822.0,C2067546399
30224,409000362497',2018-01-03,IRCTC CORPORATE OFFICE AC,127050.0,0.0,,2018,1,3,PAYEMENT,127050.0,C1254893565
30225,409000362497',2018-01-03,PAYU PAYMENTS PRIVATE LIM,21060.0,0.0,,2018,1,3,DEBIT,21060.0,C1245442940
30226,409000362497',2018-01-03,BIDDERBOY CORPORATION,146.0,0.0,,2018,1,3,CHECK_WITHDRAWAL,146.0,C708992245
30227,409000362497',2018-01-03,AVENUES INDIA PRIVATE LIM,4888.0,0.0,,2018,1,3,DEBIT,4888.0,M554529299
30228,409000362497',2018-01-03,SYNERGISTIC FINANCIAL NET,4893.0,0.0,,2018,1,3,PAYEMENT,4893.0,M27547215
30229,409000362497',2018-01-03,ZAAK EPAYMENT SERVICES PR,392.0,0.0,,2018,1,3,CASH_OUT,392.0,C2134357721
30230,409000362497',2018-01-03,METRO INFRASYS PRIVATE LI,1346.0,0.0,,2018,1,3,PAYEMENT,1346.0,C1794607688
30231,409000362497',2018-01-03,PASFAR TECHNOLOGIES PRIVA,2644.0,0.0,,2018,1,3,CHECK_WITHDRAWAL,2644.0,M144967076
30232,409000362497',2018-01-03,DISH INFRA SERVICES PRIVA,2609.0,0.0,,2018,1,3,CHECK_WITHDRAWAL,2609.0,M2038648224
30233,409000362497',2018-01-03,JUST DIAL LIMITED,4513.0,0.0,,2018,1,3,CHECK_WITHDRAWAL,4513.0,M1934926296
30234,409000362497',2018-01-03,MEHAR ENTERTAINMENT PRIVA,3226.0,0.0,,2018,1,3,PAYEMENT,3226.0,C1135870515
30235,409000362497',2018-01-03,E-BILLING SOLUTIONS PRIVA,1172.0,0.0,,2018,1,3,DEBIT,1172.0,C1834992330
30236,409000362497',2018-01-03,Indiaforensic SERVICES INDIA PVT,860758.0,0.0,,2018,1,3,CHECK_WITHDRAWAL,860758.0,C1958814164
30237,409000362497',2018-01-03,FDRL/INTERNAL FUND TRANSFE,0.0,10000000.0,,2018,1,3,TRANSFER,10000000.0,M1801169903
30238,409000362497',2018-01-03,FDRL/INTERNAL FUND TRANSFE,0.0,15000000.0,,2018,1,3,TRANSFER,15000000.0,C84804929
30239,409000362497',2018-01-03,NEFT/SBIN318003733622/Indfor,0.0,4400000.0,,2018,1,3,CHECK_CASHING,4400000.0,C669419693
30240,409000362497',2018-01-03,IMPS 030118 3C,11717363.4,0.0,,2018,1,3,DEBIT,11717363.4,M1532745522
30241,409000362497',2018-01-03,IMPS 030118 4C,2365840.18,0.0,,2018,1,3,DEBIT,2365840.18,C890123495
30242,409000362497',2018-01-03,Sweep Trf To: 40900036427,783924.0,0.0,,2018,1,3,DEBIT,783924.0,C310976964
30243,409000362497',2018-01-04,IMPS 0301181C,6824118.53,0.0,,2018,1,4,PAYEMENT,6824118.53,C500153041
30244,409000362497',2018-01-04,IMPS 040118 2C,2254070.71,0.0,,2018,1,4,PAYEMENT,2254070.71,M63750910
30245,409000362497',2018-01-04,BIGTREE ENTERTAINMENT PRI,560.0,0.0,,2018,1,4,PAYEMENT,560.0,M783247403
30246,409000362497',2018-01-04,INDIAIDEAS.COM LTD,49220.0,0.0,,2018,1,4,DEBIT,49220.0,M284461959
30247,409000362497',2018-01-04,IRCTC CORPORATE OFFICE AC,122770.0,0.0,,2018,1,4,DEBIT,122770.0,M1682227555
30248,409000362497',2018-01-04,PAYU PAYMENTS PRIVATE LIM,33724.0,0.0,,2018,1,4,CASH_OUT,33724.0,M1985187592
30249,409000362497',2018-01-04,AVENUES INDIA PRIVATE LIM,7174.0,0.0,,2018,1,4,PAYEMENT,7174.0,M2099418363
30250,409000362497',2018-01-04,FUTURE RETAIL LIMITED (OW,616.0,0.0,,2018,1,4,PAYEMENT,616.0,M695300031
30251,409000362497',2018-01-04,PASFAR TECHNOLOGIES PRIVA,979.0,0.0,,2018,1,4,CHECK_WITHDRAWAL,979.0,M131631585
30252,409000362497',2018-01-04,DISH INFRA SERVICES PRIVA,1279.0,0.0,,2018,1,4,PAYEMENT,1279.0,M1654215129
30253,409000362497',2018-01-04,JUST DIAL LIMITED,1552.0,0.0,,2018,1,4,CHECK_WITHDRAWAL,1552.0,M1842957286
30254,409000362497',2018-01-04,MEHAR ENTERTAINMENT PRIVA,5516.0,0.0,,2018,1,4,CASH_OUT,5516.0,C1531333864
30255,409000362497',2018-01-04,E-BILLING SOLUTIONS PRIVA,4416.0,0.0,,2018,1,4,PAYEMENT,4416.0,C1266601271
30256,409000362497',2018-01-04,LOCALCUBE COMMERCE PRIVAT,102577.0,0.0,,2018,1,4,CASH_OUT,102577.0,C1479450980
30257,409000362497',2018-01-04,Indiaforensic SERVICES INDIA PVT,589519.0,0.0,,2018,1,4,CASH_OUT,589519.0,C225769102
30258,409000362497',2018-01-04,IMPS 040118 3C,5995392.71,0.0,,2018,1,4,DEBIT,5995392.71,M202935582
30259,409000362497',2018-01-04,NEFT/SBIN418004829612/Indfor,0.0,5500000.0,,2018,1,4,CASH_IN,5500000.0,M612501773
30260,409000362497',2018-01-04,FDRL/INTERNAL FUND TRANSFE,0.0,10000000.0,,2018,1,4,CASH_IN,10000000.0,M1519394478
30261,409000362497',2018-01-04,FDRL/INTERNAL FUND TRANSFE,0.0,10000000.0,,2018,1,4,CHECK_CASHING,10000000.0,C607874855
30262,409000362497',2018-01-04,FDRL/INTERNAL FUND TRANSFE,0.0,1000000.0,,2018,1,4,CASH_IN,1000000.0,C1941371857
30263,409000362497',2018-01-04,IMPS 040118 4C,10103082.09,0.0,,2018,1,4,CASH_OUT,10103082.09,C1186449563
30264,409000362497',2018-01-04,Sweep Trf To: 40900036427,433962.0,0.0,,2018,1,4,PAYEMENT,433962.0,C2007149130
30265,409000362497',2018-01-05,TDS operative a/c dr for,4374.0,0.0,,2018,1,5,PAYEMENT,4374.0,C198998678
30266,409000362497',2018-01-05,BIGTREE ENTERTAINMENT PRI,305.0,0.0,,2018,1,5,PAYEMENT,305.0,M2122390950
30267,409000362497',2018-01-05,INDIAIDEAS.COM LTD,71248.0,0.0,,2018,1,5,DEBIT,71248.0,M1705386364
30268,409000362497',2018-01-05,IRCTC CORPORATE OFFICE AC,123885.0,0.0,,2018,1,5,DEBIT,123885.0,C1520366382
30269,409000362497',2018-01-05,PAYU PAYMENTS PRIVATE LIM,28194.0,0.0,,2018,1,5,PAYEMENT,28194.0,C789195255
30270,409000362497',2018-01-05,AVENUES INDIA PRIVATE LIM,16528.0,0.0,,2018,1,5,CHECK_WITHDRAWAL,16528.0,M1541173351
30271,409000362497',2018-01-05,SYNERGISTIC FINANCIAL NET,2172.0,0.0,,2018,1,5,CASH_OUT,2172.0,C2046611860
30272,409000362497',2018-01-05,FUTURE RETAIL LIMITED (OW,755.0,0.0,,2018,1,5,CASH_OUT,755.0,C488044861
30273,409000362497',2018-01-05,PASFAR TECHNOLOGIES PRIVA,10.0,0.0,,2018,1,5,CHECK_WITHDRAWAL,10.0,C820234826
30274,409000362497',2018-01-05,MEHAR ENTERTAINMENT PRIVA,7344.0,0.0,,2018,1,5,DEBIT,7344.0,C1511785794
30275,409000362497',2018-01-05,E-BILLING SOLUTIONS PRIVA,1513.0,0.0,,2018,1,5,PAYEMENT,1513.0,M998703767
30276,409000362497',2018-01-05,VOUCHER ACTIVATION SERVIC,2853.0,0.0,,2018,1,5,DEBIT,2853.0,C863811613
30277,409000362497',2018-01-05,QWIKCILVER SOLUTIONS PRIV,14206.0,0.0,,2018,1,5,CHECK_WITHDRAWAL,14206.0,C1130075212
30278,409000362497',2018-01-05,Indiaforensic SERVICES INDIA PVT,476046.0,0.0,,2018,1,5,CASH_OUT,476046.0,M1804404453
30279,409000362497',2018-01-05,IMPS 0401181C,9771569.67,0.0,,2018,1,5,CHECK_WITHDRAWAL,9771569.67,C479778696
30280,409000362497',2018-01-05,IMPS 050118 2C,3069982.48,0.0,,2018,1,5,DEBIT,3069982.48,M1909310540
30281,409000362497',2018-01-05,IMPS 050118 3C,10158237.63,0.0,,2018,1,5,CASH_OUT,10158237.63,M101818740
30282,409000362497',2018-01-05,NEFT/SBIN518005812700/Indfor,0.0,5100000.0,,2018,1,5,CHECK_CASHING,5100000.0,C1742506664
30283,409000362497',2018-01-05,FDRL/INTERNAL FUND TRANSFE,0.0,10000000.0,,2018,1,5,TRANSFER,10000000.0,M82169174
30284,409000362497',2018-01-05,FDRL/INTERNAL FUND TRANSFE,0.0,10000000.0,,2018,1,5,CASH_IN,10000000.0,C525141182
30285,409000362497',2018-01-05,FDRL/INTERNAL FUND TRANSFE,0.0,1000000.0,,2018,1,5,TRANSFER,1000000.0,M302869938
30286,409000362497',2018-01-05,FDRL/INTERNAL FUND TRANSFE,0.0,1000000.0,,2018,1,5,TRANSFER,1000000.0,C459971513
30287,409000362497',2018-01-05,IMPS 050118 4C,6001621.53,0.0,,2018,1,5,CASH_OUT,6001621.53,C488624810
30288,409000362497',2018-01-05,Sweep Trf To: 40900036427,558631.0,0.0,,2018,1,5,CHECK_WITHDRAWAL,558631.0,C476182975
30289,409000362497',2018-01-06,IMPS 0401181C,6614712.3,0.0,,2018,1,6,PAYEMENT,6614712.3,C1204684191
30290,409000362497',2018-01-06,IMPS 060118 2C,2549821.26,0.0,,2018,1,6,CASH_OUT,2549821.26,C1380361139
30291,409000362497',2018-01-06,IMPS 060118 3C,12742615.92,0.0,,2018,1,6,PAYEMENT,12742615.92,C997608398
30292,409000362497',2018-01-06,NEFT/SBIN618006819461/Indfor,0.0,6100000.0,,2018,1,6,TRANSFER,6100000.0,C1479450980
30293,409000362497',2018-01-06,IMPS 060118 4C,3872632.89,0.0,,2018,1,6,DEBIT,3872632.89,C721267591
30294,409000362497',2018-01-06,FDRL/INTERNAL FUND TRANSFE,0.0,15000000.0,,2018,1,6,CASH_IN,15000000.0,C1561784955
30295,409000362497',2018-01-06,Sweep Trf To: 40900036427,618099.0,0.0,,2018,1,6,PAYEMENT,618099.0,C1871293699
30296,409000362497',2018-01-08,IMPS 0601181C,1208271.42,0.0,,2018,1,8,CHECK_WITHDRAWAL,1208271.42,C2107935820
30297,409000362497',2018-01-08,IMPS 070118 1C,1397973.82,0.0,,2018,1,8,CHECK_WITHDRAWAL,1397973.82,C674913323
30298,409000362497',2018-01-08,IMPS 080118 2C,9621521.84,0.0,,2018,1,8,PAYEMENT,9621521.84,C1031639563
30299,409000362497',2018-01-08,BIGTREE ENTERTAINMENT PRI,2293.0,0.0,,2018,1,8,DEBIT,2293.0,C1302931951
30300,409000362497',2018-01-08,INDIAIDEAS.COM LTD,58341.0,0.0,,2018,1,8,DEBIT,58341.0,C530216580
30301,409000362497',2018-01-08,IRCTC CORPORATE OFFICE AC,375995.0,0.0,,2018,1,8,PAYEMENT,375995.0,C228669487
30302,409000362497',2018-01-08,PAYU PAYMENTS PRIVATE LIM,70588.0,0.0,,2018,1,8,CHECK_WITHDRAWAL,70588.0,C1684776894
30303,409000362497',2018-01-08,AVENUES INDIA PRIVATE LIM,19165.0,0.0,,2018,1,8,DEBIT,19165.0,C554025243
30304,409000362497',2018-01-08,SYNERGISTIC FINANCIAL NET,1175.0,0.0,,2018,1,8,PAYEMENT,1175.0,C689651304
30305,409000362497',2018-01-08,FUTURE RETAIL LIMITED (OW,7217.0,0.0,,2018,1,8,PAYEMENT,7217.0,C1536728605
30306,409000362497',2018-01-08,METRO INFRASYS PRIVATE LI,673.0,0.0,,2018,1,8,DEBIT,673.0,C1682576062
30307,409000362497',2018-01-08,PASFAR TECHNOLOGIES PRIVA,1018.0,0.0,,2018,1,8,PAYEMENT,1018.0,C2077672286
30308,409000362497',2018-01-08,JUST DIAL LIMITED,1099.0,0.0,,2018,1,8,CASH_OUT,1099.0,C1099915107
30309,409000362497',2018-01-08,MEHAR ENTERTAINMENT PRIVA,18434.0,0.0,,2018,1,8,CHECK_WITHDRAWAL,18434.0,C283747838
30310,409000362497',2018-01-08,E-BILLING SOLUTIONS PRIVA,342.0,0.0,,2018,1,8,DEBIT,342.0,C1334973394
30311,409000362497',2018-01-08,Indiaforensic SERVICES INDIA PVT,1483458.0,0.0,,2018,1,8,CASH_OUT,1483458.0,C1788314109
30312,409000362497',2018-01-08,IMPS 080118 3C,13284055.57,0.0,,2018,1,8,CASH_OUT,13284055.57,C1200314947
30313,409000362497',2018-01-08,NEFT/BKIDN18008514045/SUS,0.0,2999.0,,2018,1,8,CASH_IN,2999.0,C2107268831
30314,409000362497',2018-01-08,FDRL/INTERNAL FUND TRANSFE,0.0,15000000.0,,2018,1,8,TRANSFER,15000000.0,C1725571079
30315,409000362497',2018-01-08,FDRL/INTERNAL FUND TRANSFE,0.0,15000000.0,,2018,1,8,TRANSFER,15000000.0,C508000580
30316,409000362497',2018-01-08,NEFT/SBIN718008872681/Indfor,0.0,8200000.0,,2018,1,8,CHECK_CASHING,8200000.0,C1107146140
30317,409000362497',2018-01-08,IMPS 080118 4C,1023522.46,0.0,,2018,1,8,CHECK_WITHDRAWAL,1023522.46,C1260889084
30318,409000362497',2018-01-08,Sweep Trf To: 40900036427,983550.0,0.0,,2018,1,8,PAYEMENT,983550.0,M1220223609
30319,409000362497',2018-01-09,IMPS 0801181C,8732475.57,0.0,,2018,1,9,PAYEMENT,8732475.57,M1188992772
30320,409000362497',2018-01-09,IMPS 090118 2C,6330395.93,0.0,,2018,1,9,DEBIT,6330395.93,M715374946
30321,409000362497',2018-01-09,IMPS 090118 3C,14582819.95,0.0,,2018,1,9,DEBIT,14582819.95,C564160838
30322,409000362497',2018-01-09,NEFT/SBIN818009820297/Indfor,0.0,4600000.0,,2018,1,9,CHECK_CASHING,4600000.0,C1172704377
30323,409000362497',2018-01-09,FDRL/INTERNAL FUND TRANSFE,0.0,5000000.0,,2018,1,9,CHECK_CASHING,5000000.0,C722844186
30324,409000362497',2018-01-09,FDRL/INTERNAL FUND TRANSFE,0.0,5000000.0,,2018,1,9,CASH_IN,5000000.0,C663202788
30325,409000362497',2018-01-09,FDRL/INTERNAL FUND TRANSFE,0.0,5000000.0,,2018,1,9,TRANSFER,5000000.0,M363659622
30326,409000362497',2018-01-09,FDRL/INTERNAL FUND TRANSFE,0.0,5000000.0,,2018,1,9,TRANSFER,5000000.0,C250289324
30327,409000362497',2018-01-09,FDRL/INTERNAL FUND TRANSFE,0.0,5000000.0,,2018,1,9,CHECK_CASHING,5000000.0,M1358503546
30328,409000362497',2018-01-09,FDRL/INTERNAL FUND TRANSFE,0.0,3000000.0,,2018,1,9,TRANSFER,3000000.0,C1750350389
30329,409000362497',2018-01-09,IMPS 0901184C,5403598.64,0.0,,2018,1,9,CASH_OUT,5403598.64,M595355562
30330,409000362497',2018-01-09,Sweep Trf To: 40900036427,1247880.0,0.0,,2018,1,9,PAYEMENT,1247880.0,M49027117
30331,409000362497',2018-01-10,IMPS 0901181C,6139516.7,0.0,,2018,1,10,PAYEMENT,6139516.7,C490150701
30332,409000362497',2018-01-10,IMPS 100118 2C,5346159.91,0.0,,2018,1,10,CASH_OUT,5346159.91,C1100871710
30333,409000362497',2018-01-10,BIGTREE ENTERTAINMENT PRI,701.0,0.0,,2018,1,10,CHECK_WITHDRAWAL,701.0,M1365743658
30334,409000362497',2018-01-10,INDIAIDEAS.COM LTD,231807.0,0.0,,2018,1,10,CHECK_WITHDRAWAL,231807.0,M446966876
30335,409000362497',2018-01-10,IRCTC CORPORATE OFFICE AC,188005.0,0.0,,2018,1,10,CASH_OUT,188005.0,C1740000325
30336,409000362497',2018-01-10,PAYU PAYMENTS PRIVATE LIM,44641.0,0.0,,2018,1,10,CHECK_WITHDRAWAL,44641.0,C381605910
30337,409000362497',2018-01-10,AVENUES INDIA PRIVATE LIM,25472.0,0.0,,2018,1,10,DEBIT,25472.0,C1849933855
30338,409000362497',2018-01-10,FUTURE RETAIL LIMITED (OW,1186.0,0.0,,2018,1,10,DEBIT,1186.0,M537263161
30339,409000362497',2018-01-10,PASFAR TECHNOLOGIES PRIVA,3673.0,0.0,,2018,1,10,CHECK_WITHDRAWAL,3673.0,C713039134
30340,409000362497',2018-01-10,MEHAR ENTERTAINMENT PRIVA,6452.0,0.0,,2018,1,10,CHECK_WITHDRAWAL,6452.0,M537322643
30341,409000362497',2018-01-10,E-BILLING SOLUTIONS PRIVA,1416.0,0.0,,2018,1,10,CHECK_WITHDRAWAL,1416.0,C1226372269
30342,409000362497',2018-01-10,Indiaforensic SERVICES INDIA PVT,1380965.0,0.0,,2018,1,10,PAYEMENT,1380965.0,M1057516458
30343,409000362497',2018-01-10,IMPS 100118 3C,12757641.9,0.0,,2018,1,10,CASH_OUT,12757641.9,M1846714109
30344,409000362497',2018-01-10,NEFT/SBIN118010004687/Indfor,0.0,2900000.0,,2018,1,10,CASH_IN,2900000.0,C1692142175
30345,409000362497',2018-01-10,IMPS 100118 4C,741317.31,0.0,,2018,1,10,CHECK_WITHDRAWAL,741317.31,C1167066016
30346,409000362497',2018-01-10,FDRL/INTERNAL FUND TRANSFE,0.0,5000000.0,,2018,1,10,CASH_IN,5000000.0,C1337741679
30347,409000362497',2018-01-10,FDRL/INTERNAL FUND TRANSFE,0.0,5000000.0,,2018,1,10,CASH_IN,5000000.0,C1166654566
30348,409000362497',2018-01-10,FDRL/INTERNAL FUND TRANSFE,0.0,5000000.0,,2018,1,10,CHECK_CASHING,5000000.0,C954723689
30349,409000362497',2018-01-10,FDRL/INTERNAL FUND TRANSFE,0.0,5000000.0,,2018,1,10,CASH_IN,5000000.0,C1485516154
30350,409000362497',2018-01-10,FDRL/INTERNAL FUND TRANSFE,0.0,3000000.0,,2018,1,10,CASH_IN,3000000.0,C782432613
30351,409000362497',2018-01-10,Sweep Trf To: 40900036427,1038044.0,0.0,,2018,1,10,CASH_OUT,1038044.0,C1727565779
30352,409000362497',2018-01-11,IMPS 1001181C,5379021.0,0.0,,2018,1,11,CASH_OUT,5379021.0,C762570948
30353,409000362497',2018-01-11,IMPS 110118 2C,6874601.23,0.0,,2018,1,11,DEBIT,6874601.23,C1572600325
30354,409000362497',2018-01-11,BIGTREE ENTERTAINMENT PRI,130.0,0.0,,2018,1,11,CHECK_WITHDRAWAL,130.0,C599968109
30355,409000362497',2018-01-11,INDIAIDEAS.COM LTD,147674.0,0.0,,2018,1,11,DEBIT,147674.0,C1432387181
30356,409000362497',2018-01-11,IRCTC CORPORATE OFFICE AC,83225.0,0.0,,2018,1,11,CASH_OUT,83225.0,C1575652338
30357,409000362497',2018-01-11,PAYU PAYMENTS PRIVATE LIM,20717.0,0.0,,2018,1,11,PAYEMENT,20717.0,C927008541
30358,409000362497',2018-01-11,AVENUES INDIA PRIVATE LIM,23751.0,0.0,,2018,1,11,PAYEMENT,23751.0,C2125012025
30359,409000362497',2018-01-11,SYNERGISTIC FINANCIAL NET,98.0,0.0,,2018,1,11,CHECK_WITHDRAWAL,98.0,C778559237
30360,409000362497',2018-01-11,FUTURE RETAIL LIMITED (OW,271.0,0.0,,2018,1,11,CHECK_WITHDRAWAL,271.0,C1689374891
30361,409000362497',2018-01-11,PASFAR TECHNOLOGIES PRIVA,294.0,0.0,,2018,1,11,CASH_OUT,294.0,C759994182
30362,409000362497',2018-01-11,JUST DIAL LIMITED,4430.0,0.0,,2018,1,11,DEBIT,4430.0,C1570560183
30363,409000362497',2018-01-11,MEHAR ENTERTAINMENT PRIVA,3802.0,0.0,,2018,1,11,DEBIT,3802.0,C1316198760
30364,409000362497',2018-01-11,E-BILLING SOLUTIONS PRIVA,1242.0,0.0,,2018,1,11,CHECK_WITHDRAWAL,1242.0,C2116153614
30365,409000362497',2018-01-11,Indiaforensic SERVICES INDIA PVT,557301.0,0.0,,2018,1,11,CASH_OUT,557301.0,C1306439078
30366,409000362497',2018-01-11,NEFT/SBIN218011013041/Indfor,0.0,2500000.0,,2018,1,11,TRANSFER,2500000.0,C1203094087
30367,409000362497',2018-01-11,FDRL/INTERNAL FUND TRANSFE,0.0,5000000.0,,2018,1,11,CASH_IN,5000000.0,C1210180003
30368,409000362497',2018-01-11,FDRL/INTERNAL FUND TRANSFE,0.0,5000000.0,,2018,1,11,TRANSFER,5000000.0,C1354725727
30369,409000362497',2018-01-11,FDRL/INTERNAL FUND TRANSFE,0.0,5000000.0,,2018,1,11,CHECK_CASHING,5000000.0,C1877453512
30370,409000362497',2018-01-11,FDRL/INTERNAL FUND TRANSFE,0.0,5000000.0,,2018,1,11,TRANSFER,5000000.0,C1095446005
30371,409000362497',2018-01-11,FDRL/INTERNAL FUND TRANSFE,0.0,5000000.0,,2018,1,11,CASH_IN,5000000.0,C593596322
30372,409000362497',2018-01-11,NEFT/AXIC180111421396/Indfor,0.0,5000000.0,,2018,1,11,CHECK_CASHING,5000000.0,C1479553213
30373,409000362497',2018-01-11,FDRL/INTERNAL FUND TRANSFE,0.0,1000000.0,,2018,1,11,TRANSFER,1000000.0,C1915163610
30374,409000362497',2018-01-11,FDRL/INTERNAL FUND TRANSFE,0.0,500000.0,,2018,1,11,CHECK_CASHING,500000.0,C2036762590
30375,409000362497',2018-01-11,IMPS 100118 4C,15234387.95,0.0,,2018,1,11,CHECK_WITHDRAWAL,15234387.95,C2050019814
30376,409000362497',2018-01-11,IMPS 110118 4C,3354438.79,0.0,,2018,1,11,CASH_OUT,3354438.79,C1065997164
30377,409000362497',2018-01-11,Sweep Trf To: 40900036427,1098866.0,0.0,,2018,1,11,DEBIT,1098866.0,C1504109395
30378,409000362497',2018-01-12,IMPS 1101181C,5931311.01,0.0,,2018,1,12,PAYEMENT,5931311.01,C668345982
30379,409000362497',2018-01-12,IMPS 120118 2C,5811958.54,0.0,,2018,1,12,CASH_OUT,5811958.54,C655391383
30380,409000362497',2018-01-12,NEFT/BKIDN18012948597/REN,0.0,1000.0,,2018,1,12,CASH_IN,1000.0,C219913687
30381,409000362497',2018-01-12,IMPS 120118 3C,14559884.47,0.0,,2018,1,12,CASH_OUT,14559884.47,C1323741703
30382,409000362497',2018-01-12,BIGTREE ENTERTAINMENT PRI,2375.0,0.0,,2018,1,12,PAYEMENT,2375.0,C2120528456
30383,409000362497',2018-01-12,IRCTC CORPORATE OFFICE AC,98400.0,0.0,,2018,1,12,DEBIT,98400.0,C1134976854
30384,409000362497',2018-01-12,PAYU PAYMENTS PRIVATE LIM,40352.0,0.0,,2018,1,12,CASH_OUT,40352.0,C2032924554
30385,409000362497',2018-01-12,AVENUES INDIA PRIVATE LIM,7647.0,0.0,,2018,1,12,PAYEMENT,7647.0,C277510102
30386,409000362497',2018-01-12,FUTURE RETAIL LIMITED (OW,1309.0,0.0,,2018,1,12,DEBIT,1309.0,C542895457
30387,409000362497',2018-01-12,PASFAR TECHNOLOGIES PRIVA,2057.0,0.0,,2018,1,12,DEBIT,2057.0,C1348373832
30388,409000362497',2018-01-12,BIGTREE ENTERTAINMENT PRI,2090.0,0.0,,2018,1,12,PAYEMENT,2090.0,C648021642
30389,409000362497',2018-01-12,INDIAIDEAS.COM LTD,38909.0,0.0,,2018,1,12,PAYEMENT,38909.0,C1014255081
30390,409000362497',2018-01-12,IRCTC CORPORATE OFFICE AC,110450.0,0.0,,2018,1,12,DEBIT,110450.0,C71555810
30391,409000362497',2018-01-12,PAYU PAYMENTS PRIVATE LIM,14569.0,0.0,,2018,1,12,PAYEMENT,14569.0,M1864025743
30392,409000362497',2018-01-12,AVENUES INDIA PRIVATE LIM,11856.0,0.0,,2018,1,12,DEBIT,11856.0,C787040724
30393,409000362497',2018-01-12,FUTURE RETAIL LIMITED (OW,4198.0,0.0,,2018,1,12,CASH_OUT,4198.0,M1577196804
30394,409000362497',2018-01-12,PASFAR TECHNOLOGIES PRIVA,1469.0,0.0,,2018,1,12,DEBIT,1469.0,M1481038207
30395,409000362497',2018-01-12,JUST DIAL LIMITED,756.0,0.0,,2018,1,12,PAYEMENT,756.0,M1814213966
30396,409000362497',2018-01-12,MEHAR ENTERTAINMENT PRIVA,4609.0,0.0,,2018,1,12,DEBIT,4609.0,C208427878
30397,409000362497',2018-01-12,DIGIVIVE SERVICES PRIVATE,115.0,0.0,,2018,1,12,CASH_OUT,115.0,M1485728890
30398,409000362497',2018-01-12,E-BILLING SOLUTIONS PRIVA,342.0,0.0,,2018,1,12,PAYEMENT,342.0,C755355682
30399,409000362497',2018-01-12,VOUCHER ACTIVATION SERVIC,2612.0,0.0,,2018,1,12,PAYEMENT,2612.0,M1386877717
30400,409000362497',2018-01-12,Indiaforensic SERVICES INDIA PVT,697694.0,0.0,,2018,1,12,DEBIT,697694.0,C590333606
30401,409000362497',2018-01-12,FDRL/INTERNAL FUND TRANSFE,0.0,15000000.0,,2018,1,12,TRANSFER,15000000.0,M766877129
30402,409000362497',2018-01-12,FDRL/INTERNAL FUND TRANSFE,0.0,15000000.0,,2018,1,12,CASH_IN,15000000.0,C716083600
30403,409000362497',2018-01-12,FDRL/INTERNAL FUND TRANSFE,0.0,4000000.0,,2018,1,12,TRANSFER,4000000.0,M1942370533
30404,409000362497',2018-01-12,FDRL/INTERNAL FUND TRANSFE,0.0,500000.0,,2018,1,12,CASH_IN,500000.0,C1725097945
30405,409000362497',2018-01-12,FDRL/INTERNAL FUND TRANSFE,0.0,5000000.0,,2018,1,12,CHECK_CASHING,5000000.0,M1929778763
30406,409000362497',2018-01-12,IMPS 120118 4C,6852525.21,0.0,,2018,1,12,PAYEMENT,6852525.21,M638248903
30407,409000362497',2018-01-12,Sweep Trf To: 40900036427,1469354.0,0.0,,2018,1,12,PAYEMENT,1469354.0,C1567520676
30408,409000362497',2018-01-15,RTGS/SBINH18015010997/Indfor,0.0,10000000.0,,2018,1,15,CHECK_CASHING,10000000.0,C818570949
30409,409000362497',2018-01-15,IMPS 1201181C,5844753.57,0.0,,2018,1,15,CHECK_WITHDRAWAL,5844753.57,M2045434281
30410,409000362497',2018-01-15,IMPS 130118 1C,14847107.76,0.0,,2018,1,15,CHECK_WITHDRAWAL,14847107.76,M90422303
30411,409000362497',2018-01-15,IMPS 140118 1C,1031603.2,0.0,,2018,1,15,CASH_OUT,1031603.2,C671848738
30412,409000362497',2018-01-15,IMPS 150118 2C,10354868.04,0.0,,2018,1,15,CASH_OUT,10354868.04,M1183390298
30413,409000362497',2018-01-15,BIGTREE ENTERTAINMENT PRI,3169.0,0.0,,2018,1,15,PAYEMENT,3169.0,M707411899
30414,409000362497',2018-01-15,IRCTC CORPORATE OFFICE AC,191770.0,0.0,,2018,1,15,DEBIT,191770.0,M979425573
30415,409000362497',2018-01-15,PAYU PAYMENTS PRIVATE LIM,20352.0,0.0,,2018,1,15,PAYEMENT,20352.0,M154671602
30416,409000362497',2018-01-15,AVENUES INDIA PRIVATE LIM,9203.0,0.0,,2018,1,15,CASH_OUT,9203.0,C1890258988
30417,409000362497',2018-01-15,FUTURE RETAIL LIMITED (OW,17273.0,0.0,,2018,1,15,PAYEMENT,17273.0,C1141137903
30418,409000362497',2018-01-15,PASFAR TECHNOLOGIES PRIVA,490.0,0.0,,2018,1,15,CHECK_WITHDRAWAL,490.0,C1870252780
30419,409000362497',2018-01-15,MEHAR ENTERTAINMENT PRIVA,10600.0,0.0,,2018,1,15,PAYEMENT,10600.0,C522553046
30420,409000362497',2018-01-15,DIGIVIVE SERVICES PRIVATE,48.0,0.0,,2018,1,15,CHECK_WITHDRAWAL,48.0,C1509170127
30421,409000362497',2018-01-15,E-BILLING SOLUTIONS PRIVA,6642.0,0.0,,2018,1,15,PAYEMENT,6642.0,C1556875182
30422,409000362497',2018-01-15,QWIKCILVER SOLUTIONS PRIV,13470.0,0.0,,2018,1,15,CASH_OUT,13470.0,C832279283
30423,409000362497',2018-01-15,Indiaforensic SERVICES INDIA PVT,923948.0,0.0,,2018,1,15,CHECK_WITHDRAWAL,923948.0,C650657798
30424,409000362497',2018-01-15,IMPS 150118 3C,16619244.76,0.0,,2018,1,15,CHECK_WITHDRAWAL,16619244.76,C1039865382
30425,409000362497',2018-01-15,NEFT/SBIN418015144752/Indfor,0.0,5000000.0,,2018,1,15,CHECK_CASHING,5000000.0,C304909156
30426,409000362497',2018-01-15,IMPS 150118 4C,858811.05,0.0,,2018,1,15,PAYEMENT,858811.05,C935808590
30427,409000362497',2018-01-15,FDRL/INTERNAL FUND TRANSFE,0.0,10000000.0,,2018,1,15,TRANSFER,10000000.0,C1878704627
30428,409000362497',2018-01-15,FDRL/INTERNAL FUND TRANSFE,0.0,15000000.0,,2018,1,15,CASH_IN,15000000.0,C1282745381
30429,409000362497',2018-01-15,FDRL/INTERNAL FUND TRANSFE,0.0,15000000.0,,2018,1,15,CHECK_CASHING,15000000.0,C1440325059
30430,409000362497',2018-01-15,Sweep Trf To: 40900036427,1523413.0,0.0,,2018,1,15,CASH_OUT,1523413.0,C459172227
30431,409000362497',2018-01-16,IMPS 1501181C,9406134.92,0.0,,2018,1,16,CHECK_WITHDRAWAL,9406134.92,C811597470
30432,409000362497',2018-01-16,IMPS 160118 2C,5351778.13,0.0,,2018,1,16,PAYEMENT,5351778.13,C571435580
30433,409000362497',2018-01-16,INDIAIDEAS.COM LTD,159493.0,0.0,,2018,1,16,PAYEMENT,159493.0,C895556946
30434,409000362497',2018-01-16,IRCTC CORPORATE OFFICE AC,70755.0,0.0,,2018,1,16,PAYEMENT,70755.0,M841132842
30435,409000362497',2018-01-16,PAYU PAYMENTS PRIVATE LIM,15180.0,0.0,,2018,1,16,PAYEMENT,15180.0,M2055509253
30436,409000362497',2018-01-16,AVENUES INDIA PRIVATE LIM,4630.0,0.0,,2018,1,16,PAYEMENT,4630.0,C1284149862
30437,409000362497',2018-01-16,FUTURE RETAIL LIMITED (OW,13733.0,0.0,,2018,1,16,CASH_OUT,13733.0,C553229336
30438,409000362497',2018-01-16,PASFAR TECHNOLOGIES PRIVA,979.0,0.0,,2018,1,16,CASH_OUT,979.0,M565445644
30439,409000362497',2018-01-16,ALT DIGITAL MEDIA ENTERTA,2577.0,0.0,,2018,1,16,DEBIT,2577.0,C1894207825
30440,409000362497',2018-01-16,Indiaforensic SERVICES INDIA PVT,602103.0,0.0,,2018,1,16,DEBIT,602103.0,C1197606915
30441,409000362497',2018-01-16,NEFT/SBIN418016950197/Indfor,0.0,5900000.0,,2018,1,16,CASH_IN,5900000.0,M678442296
30442,409000362497',2018-01-16,FDRL/INTERNAL FUND TRANSFE,0.0,15000000.0,,2018,1,16,CHECK_CASHING,15000000.0,M216000710
30443,409000362497',2018-01-16,FDRL/INTERNAL FUND TRANSFE,0.0,500000.0,,2018,1,16,TRANSFER,500000.0,M583926443
30444,409000362497',2018-01-16,IMPS 160120184C,2504387.59,0.0,,2018,1,16,DEBIT,2504387.59,M2050112633
30445,409000362497',2018-01-16,IMPS 160118 3C,13235185.61,0.0,,2018,1,16,PAYEMENT,13235185.61,C173141569
30446,409000362497',2018-01-16,Sweep Trf To: 40900036427,1431677.0,0.0,,2018,1,16,CASH_OUT,1431677.0,C1706891711
30447,409000362497',2018-01-17,IMPS 1601181C,1991919.0,0.0,,2018,1,17,PAYEMENT,1991919.0,M1942837738
30448,409000362497',2018-01-17,IMPS 170118 2C,6680504.38,0.0,,2018,1,17,PAYEMENT,6680504.38,M1834340566
30449,409000362497',2018-01-17,FDRL/INTERNAL FUND TRANSFE,0.0,10000000.0,,2018,1,17,CHECK_CASHING,10000000.0,C937195105
30450,409000362497',2018-01-17,FDRL/INTERNAL FUND TRANSFE,0.0,10000000.0,,2018,1,17,CASH_IN,10000000.0,C1205844899
30451,409000362497',2018-01-17,FDRL/INTERNAL FUND TRANSFE,0.0,5000000.0,,2018,1,17,TRANSFER,5000000.0,M459774109
30452,409000362497',2018-01-17,IMPS 170118 3C,10688421.12,0.0,,2018,1,17,DEBIT,10688421.12,M1521279993
30453,409000362497',2018-01-17,IMPS 170118 4C,1358003.62,0.0,,2018,1,17,CHECK_WITHDRAWAL,1358003.62,M473911947
30454,409000362497',2018-01-17,Sweep Trf To: 40900036427,798012.0,0.0,,2018,1,17,CHECK_WITHDRAWAL,798012.0,M247395591
30455,409000362497',2018-01-18,IMPS 1701181C,3612951.75,0.0,,2018,1,18,DEBIT,3612951.75,M253709668
30456,409000362497',2018-01-18,IMPS 180118 2C,5846476.76,0.0,,2018,1,18,PAYEMENT,5846476.76,M1185783525
30457,409000362497',2018-01-18,BIGTREE ENTERTAINMENT PRI,62.0,0.0,,2018,1,18,DEBIT,62.0,C1628035200
30458,409000362497',2018-01-18,INDIAIDEAS.COM LTD,113462.0,0.0,,2018,1,18,CHECK_WITHDRAWAL,113462.0,M1618442866
30459,409000362497',2018-01-18,IRCTC CORPORATE OFFICE AC,90030.0,0.0,,2018,1,18,CASH_OUT,90030.0,M206663802
30460,409000362497',2018-01-18,PAYU PAYMENTS PRIVATE LIM,6313.0,0.0,,2018,1,18,CASH_OUT,6313.0,M1827956042
30461,409000362497',2018-01-18,AVENUES INDIA PRIVATE LIM,6467.0,0.0,,2018,1,18,PAYEMENT,6467.0,C713338583
30462,409000362497',2018-01-18,FUTURE RETAIL LIMITED (OW,2593.0,0.0,,2018,1,18,DEBIT,2593.0,M1938684207
30463,409000362497',2018-01-18,METRO INFRASYS PRIVATE LI,673.0,0.0,,2018,1,18,DEBIT,673.0,C1378215782
30464,409000362497',2018-01-18,PASFAR TECHNOLOGIES PRIVA,6855.0,0.0,,2018,1,18,CHECK_WITHDRAWAL,6855.0,C945327594
30465,409000362497',2018-01-18,DISH INFRA SERVICES PRIVA,770.0,0.0,,2018,1,18,CHECK_WITHDRAWAL,770.0,M204567666
30466,409000362497',2018-01-18,MEHAR ENTERTAINMENT PRIVA,5991.0,0.0,,2018,1,18,PAYEMENT,5991.0,C1337741679
30467,409000362497',2018-01-18,E-BILLING SOLUTIONS PRIVA,733.0,0.0,,2018,1,18,CASH_OUT,733.0,C1174600239
30468,409000362497',2018-01-18,BIGTREE ENTERTAINMENT PRI,619.0,0.0,,2018,1,18,DEBIT,619.0,C1479450980
30469,409000362497',2018-01-18,INDIAIDEAS.COM LTD,50436.0,0.0,,2018,1,18,CASH_OUT,50436.0,C2100440237
30470,409000362497',2018-01-18,IRCTC CORPORATE OFFICE AC,94990.0,0.0,,2018,1,18,CHECK_WITHDRAWAL,94990.0,M1793928316
30471,409000362497',2018-01-18,PAYU PAYMENTS PRIVATE LIM,17252.0,0.0,,2018,1,18,CASH_OUT,17252.0,M1187554740
30472,409000362497',2018-01-18,AVENUES INDIA PRIVATE LIM,8999.0,0.0,,2018,1,18,CHECK_WITHDRAWAL,8999.0,M805554405
30473,409000362497',2018-01-18,FUTURE RETAIL LIMITED (OW,1676.0,0.0,,2018,1,18,DEBIT,1676.0,M1996862123
30474,409000362497',2018-01-18,DISH INFRA SERVICES PRIVA,494.0,0.0,,2018,1,18,CHECK_WITHDRAWAL,494.0,C386554824
30475,409000362497',2018-01-18,MEHAR ENTERTAINMENT PRIVA,10485.0,0.0,,2018,1,18,CASH_OUT,10485.0,C2085805920
30476,409000362497',2018-01-18,MUZAFFARPUR VIDYUT VITARA,321.0,0.0,,2018,1,18,CASH_OUT,321.0,C125722707
30477,409000362497',2018-01-18,ALT DIGITAL MEDIA ENTERTA,196.0,0.0,,2018,1,18,CHECK_WITHDRAWAL,196.0,C2119123648
30478,409000362497',2018-01-18,NAAPTOL ONLINE SHOPING PV,783.0,0.0,,2018,1,18,CHECK_WITHDRAWAL,783.0,C667346055
30479,409000362497',2018-01-18,Indiaforensic SERVICES INDIA PVT,728895.0,0.0,,2018,1,18,PAYEMENT,728895.0,C753282599
30480,409000362497',2018-01-18,Indiaforensic SERVICES INDIA PVT,655677.0,0.0,,2018,1,18,CASH_OUT,655677.0,C910260446
30481,409000362497',2018-01-18,IMPS 180120183C,11727506.05,0.0,,2018,1,18,CASH_OUT,11727506.05,C2065199032
30482,409000362497',2018-01-18,NEFT/SBIN618018816961/Indfor,0.0,4400000.0,,2018,1,18,TRANSFER,4400000.0,C542895457
30483,409000362497',2018-01-18,NEFT/FDRL504548828/Indiaforensic,0.0,1000000.0,,2018,1,18,CASH_IN,1000000.0,C1407083386
30484,409000362497',2018-01-18,FDRL/INTERNAL FUND TRANSFE,0.0,5000000.0,,2018,1,18,TRANSFER,5000000.0,C1727331144
30485,409000362497',2018-01-18,FDRL/INTERNAL FUND TRANSFE,0.0,5000000.0,,2018,1,18,TRANSFER,5000000.0,C909295153
30486,409000362497',2018-01-18,FDRL/INTERNAL FUND TRANSFE,0.0,5000000.0,,2018,1,18,CHECK_CASHING,5000000.0,C1925300085
30487,409000362497',2018-01-18,FDRL/INTERNAL FUND TRANSFE,0.0,5000000.0,,2018,1,18,CASH_IN,5000000.0,C1491213790
30488,409000362497',2018-01-18,FDRL/INTERNAL FUND TRANSFE,0.0,5000000.0,,2018,1,18,TRANSFER,5000000.0,C1396827930
30489,409000362497',2018-01-18,IMPS 180118 4C,1494993.35,0.0,,2018,1,18,DEBIT,1494993.35,C1172042998
30490,409000362497',2018-01-18,Sweep Trf To: 40900036427,1083291.0,0.0,,2018,1,18,CHECK_WITHDRAWAL,1083291.0,C657255537
30491,409000362497',2018-01-19,IMPS 1801181C,5072756.85,0.0,,2018,1,19,CHECK_WITHDRAWAL,5072756.85,C1130075212
30492,409000362497',2018-01-19,IMPS 190118 2C,4637937.71,0.0,,2018,1,19,DEBIT,4637937.71,C1132146097
30493,409000362497',2018-01-19,IMPS 190120183C,10384528.3,0.0,,2018,1,19,CASH_OUT,10384528.3,C75474253
30494,409000362497',2018-01-19,INDIAIDEAS.COM LTD,55019.0,0.0,,2018,1,19,DEBIT,55019.0,C191614132
30495,409000362497',2018-01-19,IRCTC CORPORATE OFFICE AC,132290.0,0.0,,2018,1,19,PAYEMENT,132290.0,C1039162432
30496,409000362497',2018-01-19,PAYU PAYMENTS PRIVATE LIM,7138.0,0.0,,2018,1,19,DEBIT,7138.0,C1979080020
30497,409000362497',2018-01-19,AVENUES INDIA PRIVATE LIM,6690.0,0.0,,2018,1,19,PAYEMENT,6690.0,C155439298
30498,409000362497',2018-01-19,PAYGATE INDIA PRIVATE LIM,691.0,0.0,,2018,1,19,PAYEMENT,691.0,C262828207
30499,409000362497',2018-01-19,FUTURE RETAIL LIMITED (OW,459.0,0.0,,2018,1,19,PAYEMENT,459.0,C888005223
30500,409000362497',2018-01-19,MEHAR ENTERTAINMENT PRIVA,7143.0,0.0,,2018,1,19,CHECK_WITHDRAWAL,7143.0,C392292416
30501,409000362497',2018-01-19,QWIKCILVER SOLUTIONS PRIV,6296.0,0.0,,2018,1,19,PAYEMENT,6296.0,C1727565779
30502,409000362497',2018-01-19,Indiaforensic SERVICES INDIA PVT,652388.0,0.0,,2018,1,19,PAYEMENT,652388.0,C1298147262
30503,409000362497',2018-01-19,IMPS 190120184C,6036783.26,0.0,,2018,1,19,CHECK_WITHDRAWAL,6036783.26,C1181708889
30504,409000362497',2018-01-19,FDRL/INTERNAL FUND TRANSFE,0.0,5000000.0,,2018,1,19,TRANSFER,5000000.0,C1536728605
30505,409000362497',2018-01-19,FDRL/INTERNAL FUND TRANSFE,0.0,5000000.0,,2018,1,19,CASH_IN,5000000.0,C1727093989
30506,409000362497',2018-01-19,FDRL/INTERNAL FUND TRANSFE,0.0,5000000.0,,2018,1,19,CASH_IN,5000000.0,C77652925
30507,409000362497',2018-01-19,FDRL/INTERNAL FUND TRANSFE,0.0,5000000.0,,2018,1,19,CASH_IN,5000000.0,C1120952561
30508,409000362497',2018-01-19,FDRL/INTERNAL FUND TRANSFE,0.0,5000000.0,,2018,1,19,TRANSFER,5000000.0,C1283626649
30509,409000362497',2018-01-19,FDRL/INTERNAL FUND TRANSFE,0.0,3000000.0,,2018,1,19,CHECK_CASHING,3000000.0,C343534938
30510,409000362497',2018-01-19,Sweep Trf To: 40900036427,871344.0,0.0,,2018,1,19,PAYEMENT,871344.0,C1485516154
30511,409000362497',2018-01-20,IMPS 1901181C,6092473.18,0.0,,2018,1,20,PAYEMENT,6092473.18,C620532131
30512,409000362497',2018-01-20,IMPS 200118 2C,3265072.56,0.0,,2018,1,20,PAYEMENT,3265072.56,C1809373351
30513,409000362497',2018-01-20,RTGS/ICICH18020720112/Indfor,0.0,2000000.0,,2018,1,20,TRANSFER,2000000.0,C193864812
30514,409000362497',2018-01-20,IMPS 200120183C,10052320.71,0.0,,2018,1,20,CHECK_WITHDRAWAL,10052320.71,C1746150957
30515,409000362497',2018-01-20,IMPS 802018875385 FROM OX,0.0,200000.0,,2018,1,20,CHECK_CASHING,200000.0,C691620198
30516,409000362497',2018-01-20,IMPS 802018875420 FROM OX,0.0,200000.0,,2018,1,20,CHECK_CASHING,200000.0,C811597470
30517,409000362497',2018-01-20,IMPS 802018875443 FROM OX,0.0,200000.0,,2018,1,20,CHECK_CASHING,200000.0,C1163480574
30518,409000362497',2018-01-20,IMPS 802018875471 FROM OX,0.0,200000.0,,2018,1,20,CASH_IN,200000.0,C596299019
30519,409000362497',2018-01-20,IMPS 802018875498 FROM OX,0.0,200000.0,,2018,1,20,CASH_IN,200000.0,C1511785794
30520,409000362497',2018-01-20,IMPS 802018875533 FROM OX,0.0,200000.0,,2018,1,20,CASH_IN,200000.0,C1623014027
30521,409000362497',2018-01-20,FDRL/INTERNAL FUND TRANSFE,0.0,10000000.0,,2018,1,20,CHECK_CASHING,10000000.0,C406477119
30522,409000362497',2018-01-20,FDRL/INTERNAL FUND TRANSFE,0.0,3000000.0,,2018,1,20,CHECK_CASHING,3000000.0,C691586697
30523,409000362497',2018-01-20,FDRL/INTERNAL FUND TRANSFE,0.0,500000.0,,2018,1,20,TRANSFER,500000.0,C194746285
30524,409000362497',2018-01-20,IMPS 200120184C,5831387.65,0.0,,2018,1,20,CASH_OUT,5831387.65,C2083562754
30525,409000362497',2018-01-20,Sweep Trf To: 40900036427,525905.0,0.0,,2018,1,20,CHECK_WITHDRAWAL,525905.0,C26334874
30526,409000362497',2018-01-22,IMPS 2001181C,2915932.32,0.0,,2018,1,22,CHECK_WITHDRAWAL,2915932.32,C705321061
30527,409000362497',2018-01-22,IMPS 210118 1C,958411.51,0.0,,2018,1,22,PAYEMENT,958411.51,C1107146140
30528,409000362497',2018-01-22,IMPS 220118 2C,7886245.8,0.0,,2018,1,22,DEBIT,7886245.8,C266912553
30529,409000362497',2018-01-22,IMPS 220120183C,12017105.8,0.0,,2018,1,22,DEBIT,12017105.8,C26334874
30530,409000362497',2018-01-22,BIGTREE ENTERTAINMENT PRI,5260.0,0.0,,2018,1,22,CHECK_WITHDRAWAL,5260.0,C1549086472
30531,409000362497',2018-01-22,INDIAIDEAS.COM LTD,149668.0,0.0,,2018,1,22,CASH_OUT,149668.0,C1217639236
30532,409000362497',2018-01-22,PAYU PAYMENTS PRIVATE LIM,43147.0,0.0,,2018,1,22,CHECK_WITHDRAWAL,43147.0,C1027992087
30533,409000362497',2018-01-22,BIDDERBOY CORPORATION,146.0,0.0,,2018,1,22,DEBIT,146.0,C1475909248
30534,409000362497',2018-01-22,AVENUES INDIA PRIVATE LIM,56438.0,0.0,,2018,1,22,CHECK_WITHDRAWAL,56438.0,C363330984
30535,409000362497',2018-01-22,FUTURE RETAIL LIMITED (OW,9737.0,0.0,,2018,1,22,CHECK_WITHDRAWAL,9737.0,C1957274125
30536,409000362497',2018-01-22,METRO INFRASYS PRIVATE LI,673.0,0.0,,2018,1,22,CHECK_WITHDRAWAL,673.0,C471115623
30537,409000362497',2018-01-22,PASFAR TECHNOLOGIES PRIVA,3271.0,0.0,,2018,1,22,CHECK_WITHDRAWAL,3271.0,C1348373832
30538,409000362497',2018-01-22,JUST DIAL LIMITED,1380.0,0.0,,2018,1,22,CASH_OUT,1380.0,C1914772936
30539,409000362497',2018-01-22,MEHAR ENTERTAINMENT PRIVA,17785.0,0.0,,2018,1,22,DEBIT,17785.0,C2040329005
30540,409000362497',2018-01-22,E-BILLING SOLUTIONS PRIVA,1577.0,0.0,,2018,1,22,CASH_OUT,1577.0,C362585233
30541,409000362497',2018-01-22,ALT DIGITAL MEDIA ENTERTA,98.0,0.0,,2018,1,22,CHECK_WITHDRAWAL,98.0,C1085479446
30542,409000362497',2018-01-22,Indiaforensic SERVICES INDIA PVT,1495750.0,0.0,,2018,1,22,PAYEMENT,1495750.0,C824197891
30543,409000362497',2018-01-22,IMPS 220120184C,4412181.21,0.0,,2018,1,22,CHECK_WITHDRAWAL,4412181.21,C674913323
30544,409000362497',2018-01-22,NEFT/SBIN918022338228/Indfor,0.0,5000000.0,,2018,1,22,TRANSFER,5000000.0,C721267591
30545,409000362497',2018-01-22,FDRL/INTERNAL FUND TRANSFE,0.0,15000000.0,,2018,1,22,TRANSFER,15000000.0,C1298314970
30546,409000362497',2018-01-22,FDRL/INTERNAL FUND TRANSFE,0.0,10000000.0,,2018,1,22,CHECK_CASHING,10000000.0,C1303868418
30547,409000362497',2018-01-22,FDRL/INTERNAL FUND TRANSFE,0.0,2000000.0,,2018,1,22,TRANSFER,2000000.0,C2091209617
30548,409000362497',2018-01-22,FDRL/INTERNAL FUND TRANSFE,0.0,2000000.0,,2018,1,22,CHECK_CASHING,2000000.0,C1503386238
30549,409000362497',2018-01-22,Sweep Trf To: 40900036427,883735.0,0.0,,2018,1,22,CASH_OUT,883735.0,C1066166621
30550,409000362497',2018-01-23,IMPS 2201181C,3928127.35,0.0,,2018,1,23,PAYEMENT,3928127.35,C1664330755
30551,409000362497',2018-01-23,IMPS 230118 2C,4278582.51,0.0,,2018,1,23,PAYEMENT,4278582.51,C1920084587
30552,409000362497',2018-01-23,BIGTREE ENTERTAINMENT PRI,352.0,0.0,,2018,1,23,CHECK_WITHDRAWAL,352.0,C386349248
30553,409000362497',2018-01-23,INDIAIDEAS.COM LTD,71739.0,0.0,,2018,1,23,CHECK_WITHDRAWAL,71739.0,C1144070975
30554,409000362497',2018-01-23,PAYU PAYMENTS PRIVATE LIM,14964.0,0.0,,2018,1,23,CHECK_WITHDRAWAL,14964.0,C1629911510
30555,409000362497',2018-01-23,AVENUES INDIA PRIVATE LIM,9874.0,0.0,,2018,1,23,CHECK_WITHDRAWAL,9874.0,C2145961947
30556,409000362497',2018-01-23,FUTURE RETAIL LIMITED (OW,2022.0,0.0,,2018,1,23,PAYEMENT,2022.0,C2046611860
30557,409000362497',2018-01-23,MEHAR ENTERTAINMENT PRIVA,1152.0,0.0,,2018,1,23,CASH_OUT,1152.0,C831467165
30558,409000362497',2018-01-23,MUZAFFARPUR VIDYUT VITARA,413.0,0.0,,2018,1,23,CASH_OUT,413.0,C1501701470
30559,409000362497',2018-01-23,ALT DIGITAL MEDIA ENTERTA,98.0,0.0,,2018,1,23,PAYEMENT,98.0,C2020152163
30560,409000362497',2018-01-23,VOUCHER ACTIVATION SERVIC,3407.0,0.0,,2018,1,23,DEBIT,3407.0,C1520366382
30561,409000362497',2018-01-23,Indiaforensic SERVICES INDIA PVT,617982.32,0.0,,2018,1,23,CASH_OUT,617982.32,C170899621
30562,409000362497',2018-01-23,IMPS 230118 3C,9936863.99,0.0,,2018,1,23,DEBIT,9936863.99,C1040240917
30563,409000362497',2018-01-23,NEFT/SBIN118023020867/Indfor,0.0,2600000.0,,2018,1,23,TRANSFER,2600000.0,C977993101
30564,409000362497',2018-01-23,FDRL/INTERNAL FUND TRANSFE,0.0,15000000.0,,2018,1,23,CHECK_CASHING,15000000.0,C1320515149
30565,409000362497',2018-01-23,FDRL/INTERNAL FUND TRANSFE,0.0,3000000.0,,2018,1,23,TRANSFER,3000000.0,C1927159174
30566,409000362497',2018-01-23,FDRL/INTERNAL FUND TRANSFE,0.0,500000.0,,2018,1,23,CHECK_CASHING,500000.0,C1169903663
30567,409000362497',2018-01-23,IMPS 230118 4C,3674629.94,0.0,,2018,1,23,CHECK_WITHDRAWAL,3674629.94,C1558550579
30568,409000362497',2018-01-23,Sweep Trf To: 40900036427,863848.0,0.0,,2018,1,23,PAYEMENT,863848.0,C691586697
30569,409000362497',2018-01-24,IMPS 2301181C,1374377.1,0.0,,2018,1,24,DEBIT,1374377.1,C1016689071
30570,409000362497',2018-01-24,IMPS 240118 3C,4323256.3,0.0,,2018,1,24,DEBIT,4323256.3,C1930851375
30571,409000362497',2018-01-24,BIGTREE ENTERTAINMENT PRI,3114.0,0.0,,2018,1,24,CASH_OUT,3114.0,C1227603646
30572,409000362497',2018-01-24,INDIAIDEAS.COM LTD,68610.0,0.0,,2018,1,24,CHECK_WITHDRAWAL,68610.0,C1811531351
30573,409000362497',2018-01-24,PAYU PAYMENTS PRIVATE LIM,15148.0,0.0,,2018,1,24,CASH_OUT,15148.0,M119755698
30574,409000362497',2018-01-24,AVENUES INDIA PRIVATE LIM,5878.0,0.0,,2018,1,24,DEBIT,5878.0,M257705168
30575,409000362497',2018-01-24,ZAAK EPAYMENT SERVICES PR,196.0,0.0,,2018,1,24,DEBIT,196.0,M1184596295
30576,409000362497',2018-01-24,FUTURE RETAIL LIMITED (OW,10290.0,0.0,,2018,1,24,CASH_OUT,10290.0,C1964947881
30577,409000362497',2018-01-24,PASFAR TECHNOLOGIES PRIVA,2057.0,0.0,,2018,1,24,CASH_OUT,2057.0,M2106692710
30578,409000362497',2018-01-24,HUNGAMA DIGITAL MEDIA ENT,878.0,0.0,,2018,1,24,CHECK_WITHDRAWAL,878.0,M698042909
30579,409000362497',2018-01-24,MEHAR ENTERTAINMENT PRIVA,8295.0,0.0,,2018,1,24,CHECK_WITHDRAWAL,8295.0,M1189267164
30580,409000362497',2018-01-24,E-BILLING SOLUTIONS PRIVA,1672.0,0.0,,2018,1,24,PAYEMENT,1672.0,M124475900
30581,409000362497',2018-01-24,Indiaforensic SERVICES INDIA PVT,708357.37,0.0,,2018,1,24,DEBIT,708357.37,M1791278159
30582,409000362497',2018-01-24,NEFT/FDRL504548543/Indiaforensic,0.0,5000000.0,,2018,1,24,TRANSFER,5000000.0,M1526034332
30583,409000362497',2018-01-24,NEFT/SBIN118024815844/Indfor,0.0,3000000.0,,2018,1,24,TRANSFER,3000000.0,M766190669
30584,409000362497',2018-01-24,FDRL/INTERNAL FUND TRANSFE,0.0,6000000.0,,2018,1,24,CASH_IN,6000000.0,M950698331
30585,409000362497',2018-01-24,FDRL/INTERNAL FUND TRANSFE,0.0,7000000.0,,2018,1,24,CASH_IN,7000000.0,M943023730
30586,409000362497',2018-01-24,IMPS 240120183C,8907013.89,0.0,,2018,1,24,PAYEMENT,8907013.89,M151337779
30587,409000362497',2018-01-24,IMPS 240120184C,4665080.09,0.0,,2018,1,24,DEBIT,4665080.09,M327560965
30588,409000362497',2018-01-24,Sweep Trf To: 40900036427,649531.0,0.0,,2018,1,24,DEBIT,649531.0,M409790193
30589,409000362497',2018-01-25,IMPS 2401181C,1398653.26,0.0,,2018,1,25,CHECK_WITHDRAWAL,1398653.26,M608248953
30590,409000362497',2018-01-25,IMPS 250118 2C,2619837.67,0.0,,2018,1,25,CHECK_WITHDRAWAL,2619837.67,M1740268424
30591,409000362497',2018-01-25,BIGTREE ENTERTAINMENT PRI,1643.0,0.0,,2018,1,25,PAYEMENT,1643.0,M577576379
30592,409000362497',2018-01-25,INDIAIDEAS.COM LTD,39461.0,0.0,,2018,1,25,DEBIT,39461.0,M2091108026
30593,409000362497',2018-01-25,PAYU PAYMENTS PRIVATE LIM,15815.0,0.0,,2018,1,25,DEBIT,15815.0,C795982694
30594,409000362497',2018-01-25,AVENUES INDIA PRIVATE LIM,9898.0,0.0,,2018,1,25,CASH_OUT,9898.0,C1608433267
30595,409000362497',2018-01-25,FUTURE RETAIL LIMITED (OW,3075.0,0.0,,2018,1,25,PAYEMENT,3075.0,M227671332
30596,409000362497',2018-01-25,PASFAR TECHNOLOGIES PRIVA,1469.0,0.0,,2018,1,25,CHECK_WITHDRAWAL,1469.0,M353356500
30597,409000362497',2018-01-25,MEHAR ENTERTAINMENT PRIVA,4493.0,0.0,,2018,1,25,CHECK_WITHDRAWAL,4493.0,C312537393
30598,409000362497',2018-01-25,E-BILLING SOLUTIONS PRIVA,2160.0,0.0,,2018,1,25,DEBIT,2160.0,M1220530738
30599,409000362497',2018-01-25,VOUCHER ACTIVATION SERVIC,4193.0,0.0,,2018,1,25,PAYEMENT,4193.0,M426264029
30600,409000362497',2018-01-25,QWIKCILVER SOLUTIONS PRIV,5431.0,0.0,,2018,1,25,PAYEMENT,5431.0,C1816986148
30601,409000362497',2018-01-25,Indiaforensic SERVICES INDIA PVT,758294.97,0.0,,2018,1,25,DEBIT,758294.97,C424954008
30602,409000362497',2018-01-25,IMPS 2501183C,5599678.06,0.0,,2018,1,25,CHECK_WITHDRAWAL,5599678.06,C35126588
30603,409000362497',2018-01-25,NEFT/SBIN218025732138/Indfor,0.0,8000000.0,,2018,1,25,TRANSFER,8000000.0,M1344518943
30604,409000362497',2018-01-25,IMPS 2501184C,3301199.12,0.0,,2018,1,25,CASH_OUT,3301199.12,C66893623
30605,409000362497',2018-01-25,FDRL/INTERNAL FUND TRANSFE,0.0,15000000.0,,2018,1,25,CHECK_CASHING,15000000.0,M341350645
30606,409000362497',2018-01-25,FDRL/INTERNAL FUND TRANSFE,0.0,500000.0,,2018,1,25,CASH_IN,500000.0,M1510863277
30607,409000362497',2018-01-25,FDRL/INTERNAL FUND TRANSFE,0.0,3000000.0,,2018,1,25,CHECK_CASHING,3000000.0,M1333352116
30608,409000362497',2018-01-25,Sweep Trf To: 40900036427,685661.0,0.0,,2018,1,25,DEBIT,685661.0,M1377507210
30609,409000362497',2018-01-29,IMPS 2501181C,3543332.1,0.0,,2018,1,29,CASH_OUT,3543332.1,M2140706836
30610,409000362497',2018-01-29,IMPS 260118 1C,8707385.54,0.0,,2018,1,29,CHECK_WITHDRAWAL,8707385.54,M1646173245
30611,409000362497',2018-01-29,IMPS 270118 1C,1079526.13,0.0,,2018,1,29,CHECK_WITHDRAWAL,1079526.13,C197353092
30612,409000362497',2018-01-29,IMPS 280118 1C,376768.97,0.0,,2018,1,29,CASH_OUT,376768.97,M1576861272
30613,409000362497',2018-01-29,IMPS 290118 2C,7466989.74,0.0,,2018,1,29,CHECK_WITHDRAWAL,7466989.74,C1286084959
30614,409000362497',2018-01-29,IMPS 290120183C,11507903.02,0.0,,2018,1,29,CHECK_WITHDRAWAL,11507903.02,M1807927606
30615,409000362497',2018-01-29,RTGS/YESBH18029374900/IRC,0.0,1292915.0,,2018,1,29,CHECK_CASHING,1292915.0,C830615916
30616,409000362497',2018-01-29,BIGTREE ENTERTAINMENT PRI,18058.0,0.0,,2018,1,29,PAYEMENT,18058.0,C1201057368
30617,409000362497',2018-01-29,INDIAIDEAS.COM LTD,67600.0,0.0,,2018,1,29,DEBIT,67600.0,C1639464943
30618,409000362497',2018-01-29,IRCTC CORPORATE OFFICE AC,88775.0,0.0,,2018,1,29,PAYEMENT,88775.0,C1395746279
30619,409000362497',2018-01-29,PAYU PAYMENTS PRIVATE LIM,83589.0,0.0,,2018,1,29,PAYEMENT,83589.0,C754244871
30620,409000362497',2018-01-29,AVENUES INDIA PRIVATE LIM,31799.0,0.0,,2018,1,29,CASH_OUT,31799.0,C1760872167
30621,409000362497',2018-01-29,SYNERGISTIC FINANCIAL NET,546.0,0.0,,2018,1,29,CASH_OUT,546.0,C595383525
30622,409000362497',2018-01-29,VINILOK SOLUTIONS PVT LTD,517.0,0.0,,2018,1,29,CHECK_WITHDRAWAL,517.0,C728885526
30623,409000362497',2018-01-29,FUTURE RETAIL LIMITED (OW,16339.0,0.0,,2018,1,29,PAYEMENT,16339.0,C1817886095
30624,409000362497',2018-01-29,METRO INFRASYS PRIVATE LI,673.0,0.0,,2018,1,29,PAYEMENT,673.0,C437747500
30625,409000362497',2018-01-29,PASFAR TECHNOLOGIES PRIVA,10773.0,0.0,,2018,1,29,DEBIT,10773.0,C1833467691
30626,409000362497',2018-01-29,VOYLLA FASHIONS PRIVATE L,1103.0,0.0,,2018,1,29,PAYEMENT,1103.0,C295081230
30627,409000362497',2018-01-29,MEHAR ENTERTAINMENT PRIVA,9102.0,0.0,,2018,1,29,CASH_OUT,9102.0,C362966988
30628,409000362497',2018-01-29,E-BILLING SOLUTIONS PRIVA,4733.0,0.0,,2018,1,29,PAYEMENT,4733.0,C1685697739
30629,409000362497',2018-01-29,ALT DIGITAL MEDIA ENTERTA,98.0,0.0,,2018,1,29,CASH_OUT,98.0,C2012808675
30630,409000362497',2018-01-29,Indiaforensic SERVICES INDIA PVT,1289715.4,0.0,,2018,1,29,DEBIT,1289715.4,C1871689990
30631,409000362497',2018-01-29,NEFT/SBIN318029810801/Indfor,0.0,4200000.0,,2018,1,29,TRANSFER,4200000.0,C1978980520
30632,409000362497',2018-01-29,NEFT/FDRL504548872/Indiaforensic,0.0,5000000.0,,2018,1,29,TRANSFER,5000000.0,M535626499
30633,409000362497',2018-01-29,FDRL/INTERNAL FUND TRANSFE,0.0,15000000.0,,2018,1,29,CHECK_CASHING,15000000.0,M798563077
30634,409000362497',2018-01-29,FDRL/INTERNAL FUND TRANSFE,0.0,5000000.0,,2018,1,29,CHECK_CASHING,5000000.0,M849227432
30635,409000362497',2018-01-29,IMPS 290120184C,2550537.5,0.0,,2018,1,29,CHECK_WITHDRAWAL,2550537.5,C1575652338
30636,409000362497',2018-01-29,NEFT/FDRL504548760/Indiaforensic,0.0,2000000.0,,2018,1,29,CHECK_CASHING,2000000.0,C977990184
30637,409000362497',2018-01-29,Sweep Trf To: 40900036427,1295364.0,0.0,,2018,1,29,CASH_OUT,1295364.0,C988138425
30638,409000362497',2018-01-30,IMPS 2901181C,5110805.68,0.0,,2018,1,30,CHECK_WITHDRAWAL,5110805.68,C2064897338
30639,409000362497',2018-01-30,IMPS 300118 2C,4263770.41,0.0,,2018,1,30,DEBIT,4263770.41,M1762249739
30640,409000362497',2018-01-30,IMPS 300120183C,10644922.4,0.0,,2018,1,30,PAYEMENT,10644922.4,C2012808675
30641,409000362497',2018-01-30,BIGTREE ENTERTAINMENT PRI,840.0,0.0,,2018,1,30,DEBIT,840.0,M1746216792
30642,409000362497',2018-01-30,INDIAIDEAS.COM LTD,60199.0,0.0,,2018,1,30,CASH_OUT,60199.0,M1755163228
30643,409000362497',2018-01-30,IRCTC CORPORATE OFFICE AC,23325.0,0.0,,2018,1,30,PAYEMENT,23325.0,M1884681990
30644,409000362497',2018-01-30,PAYU PAYMENTS PRIVATE LIM,4830.0,0.0,,2018,1,30,CHECK_WITHDRAWAL,4830.0,C774480275
30645,409000362497',2018-01-30,AVENUES INDIA PRIVATE LIM,11505.0,0.0,,2018,1,30,CHECK_WITHDRAWAL,11505.0,M217372750
30646,409000362497',2018-01-30,FUTURE RETAIL LIMITED (OW,84.0,0.0,,2018,1,30,CASH_OUT,84.0,M957645452
30647,409000362497',2018-01-30,METRO INFRASYS PRIVATE LI,1346.0,0.0,,2018,1,30,CHECK_WITHDRAWAL,1346.0,C298492445
30648,409000362497',2018-01-30,PASFAR TECHNOLOGIES PRIVA,431.0,0.0,,2018,1,30,PAYEMENT,431.0,M1286789823
30649,409000362497',2018-01-30,DISH INFRA SERVICES PRIVA,98.0,0.0,,2018,1,30,PAYEMENT,98.0,M1882843254
30650,409000362497',2018-01-30,MUZAFFARPUR VIDYUT VITARA,19.0,0.0,,2018,1,30,CASH_OUT,19.0,C141458554
30651,409000362497',2018-01-30,E-BILLING SOLUTIONS PRIVA,369.0,0.0,,2018,1,30,DEBIT,369.0,M1832390907
30652,409000362497',2018-01-30,ALT DIGITAL MEDIA ENTERTA,194.0,0.0,,2018,1,30,CASH_OUT,194.0,M247117016
30653,409000362497',2018-01-30,Indiaforensic SERVICES INDIA PVT,439233.0,0.0,,2018,1,30,CHECK_WITHDRAWAL,439233.0,C1918034924
30654,409000362497',2018-01-30,NEFT/SBIN418030840609/Indfor,0.0,4500000.0,,2018,1,30,CHECK_CASHING,4500000.0,C551495160
30655,409000362497',2018-01-30,NEFT/FDRL504548783/Indiaforensic,0.0,2000000.0,,2018,1,30,TRANSFER,2000000.0,M791388509
30656,409000362497',2018-01-30,IMPS 300120184C,5467257.07,0.0,,2018,1,30,DEBIT,5467257.07,M299648206
30657,409000362497',2018-01-30,FDRL/INTERNAL FUND TRANSFE,0.0,10000000.0,,2018,1,30,CASH_IN,10000000.0,M1909087817
30658,409000362497',2018-01-30,FDRL/INTERNAL FUND TRANSFE,0.0,5000000.0,,2018,1,30,CHECK_CASHING,5000000.0,M1261241376
30659,409000362497',2018-01-30,FDRL/INTERNAL FUND TRANSFE,0.0,1000000.0,,2018,1,30,TRANSFER,1000000.0,M584342987
30660,409000362497',2018-01-30,Sweep Trf To: 40900036427,758937.0,0.0,,2018,1,30,CASH_OUT,758937.0,M531603926
30661,409000362497',2018-01-31,IMPS 3001181C,888321.64,0.0,,2018,1,31,CHECK_WITHDRAWAL,888321.64,M1706907771
30662,409000362497',2018-01-31,IMPS 310118 2C,691985.01,0.0,,2018,1,31,CASH_OUT,691985.01,M1043604041
30663,409000362497',2018-01-31,IMPS 310120183C,1551292.09,0.0,,2018,1,31,PAYEMENT,1551292.09,M1866746788
30664,409000362497',2018-01-31,BIGTREE ENTERTAINMENT PRI,1527.0,0.0,,2018,1,31,CHECK_WITHDRAWAL,1527.0,C1401316767
30665,409000362497',2018-01-31,INDIAIDEAS.COM LTD,43565.0,0.0,,2018,1,31,DEBIT,43565.0,M1561338153
30666,409000362497',2018-01-31,IRCTC CORPORATE OFFICE AC,55690.0,0.0,,2018,1,31,DEBIT,55690.0,C1297685781
30667,409000362497',2018-01-31,PAYU PAYMENTS PRIVATE LIM,32336.0,0.0,,2018,1,31,PAYEMENT,32336.0,C1016689071
30668,409000362497',2018-01-31,AVENUES INDIA PRIVATE LIM,7546.0,0.0,,2018,1,31,CASH_OUT,7546.0,M428023976
30669,409000362497',2018-01-31,FUTURE RETAIL LIMITED (OW,1597.0,0.0,,2018,1,31,CASH_OUT,1597.0,C1587143371
30670,409000362497',2018-01-31,PASFAR TECHNOLOGIES PRIVA,3312.0,0.0,,2018,1,31,PAYEMENT,3312.0,C524804429
30671,409000362497',2018-01-31,JUST DIAL LIMITED,581.0,0.0,,2018,1,31,CHECK_WITHDRAWAL,581.0,C2040656033
30672,409000362497',2018-01-31,MEHAR ENTERTAINMENT PRIVA,8151.0,0.0,,2018,1,31,PAYEMENT,8151.0,C1651945012
30673,409000362497',2018-01-31,MUZAFFARPUR VIDYUT VITARA,67.0,0.0,,2018,1,31,PAYEMENT,67.0,C118648358
30674,409000362497',2018-01-31,E-BILLING SOLUTIONS PRIVA,8788.0,0.0,,2018,1,31,CASH_OUT,8788.0,C1169903663
30675,409000362497',2018-01-31,ALT DIGITAL MEDIA ENTERTA,196.0,0.0,,2018,1,31,DEBIT,196.0,C1922859107
30676,409000362497',2018-01-31,Indiaforensic SERVICES INDIA PVT,671433.0,0.0,,2018,1,31,DEBIT,671433.0,C1459757869
30677,409000362497',2018-01-31,FDRL/INTERNAL FUND TRANSFE,0.0,5000000.0,,2018,1,31,CHECK_CASHING,5000000.0,C257999182
30678,409000362497',2018-01-31,NEFT/SBIN618031081212/Indfor,0.0,2000000.0,,2018,1,31,CASH_IN,2000000.0,C727209127
30679,409000362497',2018-01-31,IMPS 310120184C,1103120.46,0.0,,2018,1,31,PAYEMENT,1103120.46,C1894575391
30680,409000362497',2018-01-31,Sweep Trf To: 40900036427,67690.0,0.0,,2018,1,31,DEBIT,67690.0,C1343642221
30681,409000362497',2018-02-01,IMPS 3101181C,1177711.95,0.0,,2018,2,1,CHECK_WITHDRAWAL,1177711.95,C1625687132
30682,409000362497',2018-02-01,IMPS 010218 2C,1662904.1,0.0,,2018,2,1,CHECK_WITHDRAWAL,1662904.1,C1272096944
30683,409000362497',2018-02-01,IMPS 010220183C,11304396.2,0.0,,2018,2,1,CHECK_WITHDRAWAL,11304396.2,C1257117293
30684,409000362497',2018-02-01,IMPS 010220184C,5892395.16,0.0,,2018,2,1,PAYEMENT,5892395.16,M1965741412
30685,409000362497',2018-02-01,NEFT/FDRL504548829/Indiaforensic,0.0,1000000.0,,2018,2,1,CHECK_CASHING,1000000.0,M1194763557
30686,409000362497',2018-02-01,IMPS 803223163020 FROM OX,0.0,200000.0,,2018,2,1,TRANSFER,200000.0,C710987073
30687,409000362497',2018-02-01,IMPS 803223163039 FROM OX,0.0,200000.0,,2018,2,1,TRANSFER,200000.0,M111635863
30688,409000362497',2018-02-01,IMPS 803223163054 FROM OX,0.0,200000.0,,2018,2,1,TRANSFER,200000.0,M1336775962
30689,409000362497',2018-02-01,IMPS 803223163073 FROM OX,0.0,200000.0,,2018,2,1,CASH_IN,200000.0,M2042944492
30690,409000362497',2018-02-01,IMPS 803223163084 FROM OX,0.0,200000.0,,2018,2,1,CASH_IN,200000.0,M2046074269
30691,409000362497',2018-02-01,IMPS 803223163093 FROM OX,0.0,200000.0,,2018,2,1,TRANSFER,200000.0,C1354183876
30692,409000362497',2018-02-01,IMPS 803223163107 FROM OX,0.0,200000.0,,2018,2,1,CASH_IN,200000.0,C1680684273
30693,409000362497',2018-02-01,IMPS 803223163120 FROM OX,0.0,200000.0,,2018,2,1,CHECK_CASHING,200000.0,M1708553693
30694,409000362497',2018-02-01,IMPS 803223163139 FROM OX,0.0,200000.0,,2018,2,1,TRANSFER,200000.0,C1200612373
30695,409000362497',2018-02-01,IMPS 803223163147 FROM OX,0.0,200000.0,,2018,2,1,TRANSFER,200000.0,C1482979717
30696,409000362497',2018-02-01,IMPS 803223163272 FROM OX,0.0,200000.0,,2018,2,1,TRANSFER,200000.0,M1772476922
30697,409000362497',2018-02-01,IMPS 803223163283 FROM OX,0.0,200000.0,,2018,2,1,CHECK_CASHING,200000.0,M258307214
30698,409000362497',2018-02-01,IMPS 803223163295 FROM OX,0.0,200000.0,,2018,2,1,CHECK_CASHING,200000.0,C2109236648
30699,409000362497',2018-02-01,IMPS 803223163302 FROM OX,0.0,200000.0,,2018,2,1,TRANSFER,200000.0,M1520922129
30700,409000362497',2018-02-01,IMPS 803223163310 FROM OX,0.0,200000.0,,2018,2,1,TRANSFER,200000.0,M30524490
30701,409000362497',2018-02-01,IMPS 803223163318 FROM OX,0.0,200000.0,,2018,2,1,CHECK_CASHING,200000.0,C1963862935
30702,409000362497',2018-02-01,IMPS 803223163330 FROM OX,0.0,200000.0,,2018,2,1,CASH_IN,200000.0,M1479336724
30703,409000362497',2018-02-01,IMPS 803223163340 FROM OX,0.0,200000.0,,2018,2,1,TRANSFER,200000.0,C1921483039
30704,409000362497',2018-02-01,IMPS 803223163358 FROM OX,0.0,200000.0,,2018,2,1,CASH_IN,200000.0,M124471510
30705,409000362497',2018-02-01,IMPS 803223163372 FROM OX,0.0,200000.0,,2018,2,1,CHECK_CASHING,200000.0,C859193874
30706,409000362497',2018-02-01,IMPS 803223163488 FROM OX,0.0,200000.0,,2018,2,1,TRANSFER,200000.0,M1063718466
30707,409000362497',2018-02-01,IMPS 803223163500 FROM OX,0.0,200000.0,,2018,2,1,TRANSFER,200000.0,M1538594033
30708,409000362497',2018-02-01,IMPS 803223163510 FROM OX,0.0,200000.0,,2018,2,1,TRANSFER,200000.0,C38997010
30709,409000362497',2018-02-01,IMPS 803223163524 FROM OX,0.0,200000.0,,2018,2,1,TRANSFER,200000.0,C1241128308
30710,409000362497',2018-02-01,IMPS 803223163537 FROM OX,0.0,200000.0,,2018,2,1,CASH_IN,200000.0,C1738973904
30711,409000362497',2018-02-01,IMPS 803223163546 FROM OX,0.0,200000.0,,2018,2,1,CHECK_CASHING,200000.0,C261292810
30712,409000362497',2018-02-01,IMPS 803223163554 FROM OX,0.0,200000.0,,2018,2,1,TRANSFER,200000.0,M1618630986
30713,409000362497',2018-02-01,IMPS 803223163565 FROM OX,0.0,200000.0,,2018,2,1,CHECK_CASHING,200000.0,C1825389809
30714,409000362497',2018-02-01,IMPS 803223163577 FROM OX,0.0,200000.0,,2018,2,1,TRANSFER,200000.0,C646183851
30715,409000362497',2018-02-01,IMPS 803223163585 FROM OX,0.0,200000.0,,2018,2,1,TRANSFER,200000.0,M1576395975
30716,409000362497',2018-02-01,IMPS 803223163734 FROM OX,0.0,200000.0,,2018,2,1,TRANSFER,200000.0,M1829246530
30717,409000362497',2018-02-01,IMPS 803223163751 FROM OX,0.0,200000.0,,2018,2,1,CASH_IN,200000.0,M1250457479
30718,409000362497',2018-02-01,IMPS 803223163760 FROM OX,0.0,200000.0,,2018,2,1,TRANSFER,200000.0,C220766773
30719,409000362497',2018-02-01,IMPS 803223163772 FROM OX,0.0,200000.0,,2018,2,1,CASH_IN,200000.0,M126105364
30720,409000362497',2018-02-01,IMPS 803223163781 FROM OX,0.0,200000.0,,2018,2,1,TRANSFER,200000.0,M2090336811
30721,409000362497',2018-02-01,Sweep Trf From: 709003440,0.0,2369652.19,,2018,2,1,CASH_IN,2369652.19,C1182461167
30722,409000362497',2018-02-01,Repayment credit [7090034,0.0,3272.0,,2018,2,1,TRANSFER,3272.0,C1940189108
30723,409000362497',2018-02-02,FDRL/INTERNAL FUND TRANSFE,0.0,500000.0,,2018,2,2,CASH_IN,500000.0,C59215997
30724,409000362497',2018-02-02,FDRL/INTERNAL FUND TRANSFE,0.0,1000000.0,,2018,2,2,TRANSFER,1000000.0,C620638596
30725,409000362497',2018-02-02,FDRL/INTERNAL FUND TRANSFE,0.0,10000000.0,,2018,2,2,TRANSFER,10000000.0,C1782113663
30726,409000362497',2018-02-02,FDRL/INTERNAL FUND TRANSFE,0.0,5000000.0,,2018,2,2,TRANSFER,5000000.0,C1523536343
30727,409000362497',2018-02-02,IMPS 0102181C,5596414.89,0.0,,2018,2,2,CHECK_WITHDRAWAL,5596414.89,M568142555
30728,409000362497',2018-02-02,IMPS 020218 2C,2621768.02,0.0,,2018,2,2,CASH_OUT,2621768.02,M1577761184
30729,409000362497',2018-02-02,BIGTREE ENTERTAINMENT PRI,1755.0,0.0,,2018,2,2,PAYEMENT,1755.0,M259621443
30730,409000362497',2018-02-02,INDIAIDEAS.COM LTD,34310.0,0.0,,2018,2,2,CASH_OUT,34310.0,C1223591088
30731,409000362497',2018-02-02,IRCTC CORPORATE OFFICE AC,40980.0,0.0,,2018,2,2,DEBIT,40980.0,C478793413
30732,409000362497',2018-02-02,PAYU PAYMENTS PRIVATE LIM,10611.0,0.0,,2018,2,2,DEBIT,10611.0,C928023753
30733,409000362497',2018-02-02,AVENUES INDIA PRIVATE LIM,6089.0,0.0,,2018,2,2,PAYEMENT,6089.0,C1414803985
30734,409000362497',2018-02-02,SYNERGISTIC FINANCIAL NET,489.0,0.0,,2018,2,2,PAYEMENT,489.0,C934085675
30735,409000362497',2018-02-02,ZAAK EPAYMENT SERVICES PR,102.0,0.0,,2018,2,2,PAYEMENT,102.0,C74288440
30736,409000362497',2018-02-02,FUTURE RETAIL LIMITED (OW,551.0,0.0,,2018,2,2,PAYEMENT,551.0,C715819458
30737,409000362497',2018-02-02,METRO INFRASYS PRIVATE LI,7603.0,0.0,,2018,2,2,CASH_OUT,7603.0,C1927159174
30738,409000362497',2018-02-02,PASFAR TECHNOLOGIES PRIVA,7345.0,0.0,,2018,2,2,PAYEMENT,7345.0,C1263845074
30739,409000362497',2018-02-02,DISH INFRA SERVICES PRIVA,482.0,0.0,,2018,2,2,CASH_OUT,482.0,C1058634310
30740,409000362497',2018-02-02,MEHAR ENTERTAINMENT PRIVA,6452.0,0.0,,2018,2,2,PAYEMENT,6452.0,C1697258007
30741,409000362497',2018-02-02,E-BILLING SOLUTIONS PRIVA,2998.0,0.0,,2018,2,2,DEBIT,2998.0,C1050196275
30742,409000362497',2018-02-02,MUZAFFARPUR VIDYUT VITARA,171.0,0.0,,2018,2,2,CASH_OUT,171.0,C46748390
30743,409000362497',2018-02-02,Indiaforensic SERVICES INDIA PVT,612383.0,0.0,,2018,2,2,PAYEMENT,612383.0,C988138425
30744,409000362497',2018-02-02,IMPS 020220183C,9627619.19,0.0,,2018,2,2,DEBIT,9627619.19,C1954824726
30745,409000362497',2018-02-02,BIGTREE ENTERTAINMENT PRI,143.0,0.0,,2018,2,2,CASH_OUT,143.0,C1937962514
30746,409000362497',2018-02-02,INDIAIDEAS.COM LTD,40696.0,0.0,,2018,2,2,CHECK_WITHDRAWAL,40696.0,C1282219807
30747,409000362497',2018-02-02,IRCTC CORPORATE OFFICE AC,45940.0,0.0,,2018,2,2,PAYEMENT,45940.0,C705480294
30748,409000362497',2018-02-02,PAYU PAYMENTS PRIVATE LIM,4905.0,0.0,,2018,2,2,CHECK_WITHDRAWAL,4905.0,C1700852615
30749,409000362497',2018-02-02,AVENUES INDIA PRIVATE LIM,3669.0,0.0,,2018,2,2,PAYEMENT,3669.0,C1814361629
30750,409000362497',2018-02-02,SYNERGISTIC FINANCIAL NET,2165.0,0.0,,2018,2,2,DEBIT,2165.0,C1414803985
30751,409000362497',2018-02-02,PASFAR TECHNOLOGIES PRIVA,8063.0,0.0,,2018,2,2,CASH_OUT,8063.0,C1275435326
30752,409000362497',2018-02-02,DISH INFRA SERVICES PRIVA,62.0,0.0,,2018,2,2,PAYEMENT,62.0,C383296094
30753,409000362497',2018-02-02,JUST DIAL LIMITED,447.0,0.0,,2018,2,2,CHECK_WITHDRAWAL,447.0,C1065997164
30754,409000362497',2018-02-02,MEHAR ENTERTAINMENT PRIVA,2880.0,0.0,,2018,2,2,CASH_OUT,2880.0,C937195105
30755,409000362497',2018-02-02,E-BILLING SOLUTIONS PRIVA,1599.0,0.0,,2018,2,2,CASH_OUT,1599.0,C1141137903
30756,409000362497',2018-02-02,VOUCHER ACTIVATION SERVIC,8969.0,0.0,,2018,2,2,CASH_OUT,8969.0,C1282788025
30757,409000362497',2018-02-02,QWIKCILVER SOLUTIONS PVT,471.0,0.0,,2018,2,2,CHECK_WITHDRAWAL,471.0,C1730752455
30758,409000362497',2018-02-02,Indiaforensic SERVICES INDIA PVT,606803.0,0.0,,2018,2,2,PAYEMENT,606803.0,C551545010
30759,409000362497',2018-02-02,IMPS 020220184C,5805075.9,0.0,,2018,2,2,PAYEMENT,5805075.9,C771303504
30760,409000362497',2018-02-02,FDRL/INTERNAL FUND TRANSFE,0.0,10000000.0,,2018,2,2,CHECK_CASHING,10000000.0,C618155294
30761,409000362497',2018-02-02,FDRL/INTERNAL FUND TRANSFE,0.0,10000000.0,,2018,2,2,CASH_IN,10000000.0,C173247103
30762,409000362497',2018-02-02,FDRL/INTERNAL FUND TRANSFE,0.0,3000000.0,,2018,2,2,CASH_IN,3000000.0,C776404949
30763,409000362497',2018-02-02,Sweep Trf To: 40900036427,1357548.0,0.0,,2018,2,2,DEBIT,1357548.0,C1750665229
30764,409000362497',2018-02-03,IMPS 0202181C,3919527.97,0.0,,2018,2,3,CASH_OUT,3919527.97,C2104652067
30765,409000362497',2018-02-03,IMPS 030218 2C,3124850.7,0.0,,2018,2,3,DEBIT,3124850.7,C796028148
30766,409000362497',2018-02-03,RTGS/SBINH18034056914/Indfor,0.0,4700000.0,,2018,2,3,CHECK_CASHING,4700000.0,C2083562754
30767,409000362497',2018-02-03,IMPS 030220183C,8895294.05,0.0,,2018,2,3,DEBIT,8895294.05,C998255530
30768,409000362497',2018-02-03,NEFT/FDRL504548838/Indiaforensic,0.0,1000000.0,,2018,2,3,TRANSFER,1000000.0,C1669259232
30769,409000362497',2018-02-03,FDRL/INTERNAL FUND TRANSFE,0.0,10000000.0,,2018,2,3,CASH_IN,10000000.0,C1556995360
30770,409000362497',2018-02-03,FDRL/INTERNAL FUND TRANSFE,0.0,10000000.0,,2018,2,3,CASH_IN,10000000.0,C1044117371
30771,409000362497',2018-02-03,FDRL/INTERNAL FUND TRANSFE,0.0,3000000.0,,2018,2,3,TRANSFER,3000000.0,C875917495
30772,409000362497',2018-02-03,FDRL/INTERNAL FUND TRANSFE,0.0,500000.0,,2018,2,3,CASH_IN,500000.0,C1457383927
30773,409000362497',2018-02-03,IMPS 030220184C,5812692.97,0.0,,2018,2,3,DEBIT,5812692.97,C1697258007
30774,409000362497',2018-02-03,Sweep Trf To: 40900036427,419622.0,0.0,,2018,2,3,CHECK_WITHDRAWAL,419622.0,C1245442940
30775,409000362497',2018-02-05,IMPS 0302181C,6611370.49,0.0,,2018,2,5,PAYEMENT,6611370.49,C1282788025
30776,409000362497',2018-02-05,IMPS 040218 1C,3366683.05,0.0,,2018,2,5,CASH_OUT,3366683.05,C1869400026
30777,409000362497',2018-02-05,IMPS 050218 2C,5237663.49,0.0,,2018,2,5,DEBIT,5237663.49,C807247901
30778,409000362497',2018-02-05,NEFT/SBIN218036318616/Indfor,0.0,4000000.0,,2018,2,5,CHECK_CASHING,4000000.0,C35782637
30779,409000362497',2018-02-05,FDRL/INTERNAL FUND TRANSFE,0.0,7000000.0,,2018,2,5,TRANSFER,7000000.0,C861958315
30780,409000362497',2018-02-05,FDRL/INTERNAL FUND TRANSFE,0.0,7000000.0,,2018,2,5,CHECK_CASHING,7000000.0,C1302931951
30781,409000362497',2018-02-05,IMPS 050220183C,10642547.63,0.0,,2018,2,5,CASH_OUT,10642547.63,C1883788127
30782,409000362497',2018-02-05,IMPS 050220184C,1466257.48,0.0,,2018,2,5,DEBIT,1466257.48,C471115623
30783,409000362497',2018-02-05,NEFT/FDRL504548649/Indiaforensic,0.0,3000000.0,,2018,2,5,CHECK_CASHING,3000000.0,C2061354468
30784,409000362497',2018-02-05,NEFT/FDRL504548968/Indiaforensic,0.0,3000000.0,,2018,2,5,CASH_IN,3000000.0,C1832580921
30785,409000362497',2018-02-05,Sweep Trf To: 40900036427,663177.0,0.0,,2018,2,5,PAYEMENT,663177.0,C236282128
30786,409000362497',2018-02-06,IMPS 0502181C,4969107.77,0.0,,2018,2,6,CASH_OUT,4969107.77,C935808590
30787,409000362497',2018-02-06,IMPS 060218 2C,4404332.55,0.0,,2018,2,6,CASH_OUT,4404332.55,C1075238398
30788,409000362497',2018-02-06,BIGTREE ENTERTAINMENT PRI,9552.0,0.0,,2018,2,6,CASH_OUT,9552.0,M309712456
30789,409000362497',2018-02-06,INDIAIDEAS.COM LTD,151724.0,0.0,,2018,2,6,CHECK_WITHDRAWAL,151724.0,C1948558238
30790,409000362497',2018-02-06,IRCTC CORPORATE OFFICE AC,166255.0,0.0,,2018,2,6,PAYEMENT,166255.0,M1185390697
30791,409000362497',2018-02-06,PAYU PAYMENTS PRIVATE LIM,48892.0,0.0,,2018,2,6,PAYEMENT,48892.0,M911434563
30792,409000362497',2018-02-06,AVENUES INDIA PRIVATE LIM,21646.0,0.0,,2018,2,6,DEBIT,21646.0,M357208150
30793,409000362497',2018-02-06,SYNERGISTIC FINANCIAL NET,927.0,0.0,,2018,2,6,DEBIT,927.0,M623167309
30794,409000362497',2018-02-06,PAYGATE INDIA PRIVATE LIM,600.0,0.0,,2018,2,6,CHECK_WITHDRAWAL,600.0,M619729868
30795,409000362497',2018-02-06,FUTURE RETAIL LIMITED (OW,6958.0,0.0,,2018,2,6,CHECK_WITHDRAWAL,6958.0,M671161522
30796,409000362497',2018-02-06,PASFAR TECHNOLOGIES PRIVA,2387.0,0.0,,2018,2,6,CHECK_WITHDRAWAL,2387.0,M648055498
30797,409000362497',2018-02-06,HUNGAMA DIGITAL MEDIA ENT,263.0,0.0,,2018,2,6,PAYEMENT,263.0,M1215764021
30798,409000362497',2018-02-06,JUST DIAL LIMITED,1002.0,0.0,,2018,2,6,DEBIT,1002.0,C1859125434
30799,409000362497',2018-02-06,MEHAR ENTERTAINMENT PRIVA,14171.0,0.0,,2018,2,6,DEBIT,14171.0,M1609322968
30800,409000362497',2018-02-06,E-BILLING SOLUTIONS PRIVA,5051.0,0.0,,2018,2,6,DEBIT,5051.0,C1461788950
30801,409000362497',2018-02-06,ALT DIGITAL MEDIA ENTERTA,127.0,0.0,,2018,2,6,CASH_OUT,127.0,C195600860
30802,409000362497',2018-02-06,QWIKCILVER SOLUTIONS PRIV,11988.0,0.0,,2018,2,6,DEBIT,11988.0,M297546350
30803,409000362497',2018-02-06,Indiaforensic SERVICES INDIA PVT,2315395.0,0.0,,2018,2,6,CHECK_WITHDRAWAL,2315395.0,M1068662222
30804,409000362497',2018-02-06,IMPS 060220183C,8468842.9,0.0,,2018,2,6,CHECK_WITHDRAWAL,8468842.9,M2098809867
30805,409000362497',2018-02-06,FDRL/INTERNAL FUND TRANSFE,0.0,15000000.0,,2018,2,6,CHECK_CASHING,15000000.0,M1460660388
30806,409000362497',2018-02-06,FDRL/INTERNAL FUND TRANSFE,0.0,10000000.0,,2018,2,6,CASH_IN,10000000.0,C1075238398
30807,409000362497',2018-02-06,IMPS 060220184C,3020533.38,0.0,,2018,2,6,CASH_OUT,3020533.38,C2141994208
30808,409000362497',2018-02-06,Sweep Trf To: 40900036427,857072.0,0.0,,2018,2,6,CHECK_WITHDRAWAL,857072.0,M1922315064
30809,409000362497',2018-02-07,IMPS 0602181C,4725340.84,0.0,,2018,2,7,PAYEMENT,4725340.84,M907872955
30810,409000362497',2018-02-07,IMPS 070218 2C,3977719.15,0.0,,2018,2,7,CASH_OUT,3977719.15,M176858489
30811,409000362497',2018-02-07,IMPS 070220183C,4264474.9,0.0,,2018,2,7,DEBIT,4264474.9,M1304430923
30812,409000362497',2018-02-07,BIGTREE ENTERTAINMENT PRI,180.0,0.0,,2018,2,7,CHECK_WITHDRAWAL,180.0,C1632268814
30813,409000362497',2018-02-07,INDIAIDEAS.COM LTD,47631.0,0.0,,2018,2,7,CHECK_WITHDRAWAL,47631.0,M1324223113
30814,409000362497',2018-02-07,IRCTC CORPORATE OFFICE AC,36295.0,0.0,,2018,2,7,CASH_OUT,36295.0,C968614268
30815,409000362497',2018-02-07,PAYU PAYMENTS PRIVATE LIM,8182.0,0.0,,2018,2,7,DEBIT,8182.0,C1105901057
30816,409000362497',2018-02-07,AVENUES INDIA PRIVATE LIM,398.0,0.0,,2018,2,7,PAYEMENT,398.0,C391903689
30817,409000362497',2018-02-07,METRO INFRASYS PRIVATE LI,3286.0,0.0,,2018,2,7,CHECK_WITHDRAWAL,3286.0,C1759482496
30818,409000362497',2018-02-07,PASFAR TECHNOLOGIES PRIVA,1959.0,0.0,,2018,2,7,PAYEMENT,1959.0,C426416592
30819,409000362497',2018-02-07,DISH INFRA SERVICES PRIVA,219.0,0.0,,2018,2,7,DEBIT,219.0,C1671386208
30820,409000362497',2018-02-07,JUST DIAL LIMITED,4961.0,0.0,,2018,2,7,CASH_OUT,4961.0,M1647457101
30821,409000362497',2018-02-07,MEHAR ENTERTAINMENT PRIVA,7489.0,0.0,,2018,2,7,DEBIT,7489.0,C624539461
30822,409000362497',2018-02-07,Indiaforensic SERVICES INDIA PVT,470169.0,0.0,,2018,2,7,DEBIT,470169.0,C928199056
30823,409000362497',2018-02-07,NEFT/FDRL504548544/Indiaforensic,0.0,5000000.0,,2018,2,7,CHECK_CASHING,5000000.0,M1057902389
30824,409000362497',2018-02-07,FDRL/INTERNAL FUND TRANSFE,0.0,10000000.0,,2018,2,7,CASH_IN,10000000.0,M373841805
30825,409000362497',2018-02-07,FDRL/INTERNAL FUND TRANSFE,0.0,10000000.0,,2018,2,7,CHECK_CASHING,10000000.0,C2012495678
30826,409000362497',2018-02-07,FDRL/INTERNAL FUND TRANSFE,0.0,5000000.0,,2018,2,7,CASH_IN,5000000.0,M2383382
30827,409000362497',2018-02-07,IMPS 070220184C,6097833.5,0.0,,2018,2,7,CASH_OUT,6097833.5,C836514715
30828,409000362497',2018-02-07,Sweep Trf To: 40900036427,591767.0,0.0,,2018,2,7,CASH_OUT,591767.0,M1301727203
30829,409000362497',2018-02-08,IMPS 0702181C,7114942.33,0.0,,2018,2,8,CASH_OUT,7114942.33,M498814320
30830,409000362497',2018-02-08,IMPS 080218 2C,3310647.95,0.0,,2018,2,8,CHECK_WITHDRAWAL,3310647.95,M805021640
30831,409000362497',2018-02-08,BIGTREE ENTERTAINMENT PRI,427.0,0.0,,2018,2,8,CASH_OUT,427.0,M4316773
30832,409000362497',2018-02-08,INDIAIDEAS.COM LTD,43094.0,0.0,,2018,2,8,PAYEMENT,43094.0,M1755209269
30833,409000362497',2018-02-08,IRCTC CORPORATE OFFICE AC,27595.0,0.0,,2018,2,8,DEBIT,27595.0,C1907736157
30834,409000362497',2018-02-08,PAYU PAYMENTS PRIVATE LIM,17223.0,0.0,,2018,2,8,CHECK_WITHDRAWAL,17223.0,M1180603971
30835,409000362497',2018-02-08,ZAAK EPAYMENT SERVICES PR,1440.0,0.0,,2018,2,8,CASH_OUT,1440.0,C1898859288
30836,409000362497',2018-02-08,FUTURE RETAIL LIMITED (OW,3993.0,0.0,,2018,2,8,CHECK_WITHDRAWAL,3993.0,C1697258007
30837,409000362497',2018-02-08,PASFAR TECHNOLOGIES PRIVA,196.0,0.0,,2018,2,8,PAYEMENT,196.0,M43536038
30838,409000362497',2018-02-08,MEHAR ENTERTAINMENT PRIVA,4148.0,0.0,,2018,2,8,PAYEMENT,4148.0,C1915307283
30839,409000362497',2018-02-08,SND LIMITED,216.0,0.0,,2018,2,8,DEBIT,216.0,C265845794
30840,409000362497',2018-02-08,Indiaforensic SERVICES INDIA PVT,594070.0,0.0,,2018,2,8,PAYEMENT,594070.0,M1133988396
30841,409000362497',2018-02-08,IMPS 080220183C,8769643.35,0.0,,2018,2,8,CHECK_WITHDRAWAL,8769643.35,M1482443208
30842,409000362497',2018-02-08,NEFT/SBIN518039139247/Indfor,0.0,6000000.0,,2018,2,8,TRANSFER,6000000.0,M1958774824
30843,409000362497',2018-02-08,IMPS 080220184C,4877025.85,0.0,,2018,2,8,CASH_OUT,4877025.85,M2099879886
30844,409000362497',2018-02-08,FDRL/INTERNAL FUND TRANSFE,0.0,10000000.0,,2018,2,8,TRANSFER,10000000.0,M2080208518
30845,409000362497',2018-02-08,FDRL/INTERNAL FUND TRANSFE,0.0,1000000.0,,2018,2,8,CHECK_CASHING,1000000.0,M28726729
30846,409000362497',2018-02-08,Sweep Trf To: 40900036427,738765.0,0.0,,2018,2,8,PAYEMENT,738765.0,M2071539018
30847,409000362497',2018-02-09,IMPS 0802181C,6692020.62,0.0,,2018,2,9,CASH_OUT,6692020.62,M2070825712
30848,409000362497',2018-02-09,IMPS 090218 2C,2918046.1,0.0,,2018,2,9,CHECK_WITHDRAWAL,2918046.1,M603597104
30849,409000362497',2018-02-09,IMPS 090220183C,9074827.26,0.0,,2018,2,9,DEBIT,9074827.26,M1213989970
30850,409000362497',2018-02-09,IMPS 090220184C,6083460.91,0.0,,2018,2,9,PAYEMENT,6083460.91,M1906626725
30851,409000362497',2018-02-09,NEFT/SBIN618040295782/Indfor,0.0,3300000.0,,2018,2,9,CASH_IN,3300000.0,M2135097271
30852,409000362497',2018-02-09,FDRL/INTERNAL FUND TRANSFE,0.0,10000000.0,,2018,2,9,TRANSFER,10000000.0,M86925011
30853,409000362497',2018-02-09,FDRL/INTERNAL FUND TRANSFE,0.0,10000000.0,,2018,2,9,TRANSFER,10000000.0,M451336020
30854,409000362497',2018-02-09,FDRL/INTERNAL FUND TRANSFE,0.0,10000000.0,,2018,2,9,TRANSFER,10000000.0,M2070530149
30855,409000362497',2018-02-09,FDRL/INTERNAL FUND TRANSFE,0.0,3000000.0,,2018,2,9,TRANSFER,3000000.0,M744256381
30856,409000362497',2018-02-09,FDRL/INTERNAL FUND TRANSFE,0.0,2000000.0,,2018,2,9,TRANSFER,2000000.0,C418964192
30857,409000362497',2018-02-09,IMPS 804020625513 FROM OX,0.0,200000.0,,2018,2,9,CASH_IN,200000.0,M1099709044
30858,409000362497',2018-02-09,IMPS 804020625552 FROM OX,0.0,200000.0,,2018,2,9,CASH_IN,200000.0,C904672772
30859,409000362497',2018-02-09,IMPS 804020625579 FROM OX,0.0,200000.0,,2018,2,9,TRANSFER,200000.0,C1023714065
30860,409000362497',2018-02-09,IMPS 804020625599 FROM OX,0.0,200000.0,,2018,2,9,CHECK_CASHING,200000.0,C866710867
30861,409000362497',2018-02-09,IMPS 804020625624 FROM OX,0.0,200000.0,,2018,2,9,CHECK_CASHING,200000.0,C1562946595
30862,409000362497',2018-02-09,IMPS 804020625656 FROM OX,0.0,200000.0,,2018,2,9,CHECK_CASHING,200000.0,M132823399
30863,409000362497',2018-02-09,IMPS 804020625692 FROM OX,0.0,200000.0,,2018,2,9,CASH_IN,200000.0,M1495342056
30864,409000362497',2018-02-09,IMPS 804020625744 FROM OX,0.0,200000.0,,2018,2,9,CHECK_CASHING,200000.0,M1336207639
30865,409000362497',2018-02-09,IMPS 804020625777 FROM OX,0.0,200000.0,,2018,2,9,CHECK_CASHING,200000.0,M45090691
30866,409000362497',2018-02-09,IMPS 804020625804 FROM OX,0.0,200000.0,,2018,2,9,TRANSFER,200000.0,M1301723496
30867,409000362497',2018-02-09,IMPS 804020626099 FROM OX,0.0,200000.0,,2018,2,9,CHECK_CASHING,200000.0,M1642844889
30868,409000362497',2018-02-09,IMPS 804020626141 FROM OX,0.0,200000.0,,2018,2,9,CASH_IN,200000.0,M753735312
30869,409000362497',2018-02-09,IMPS 804020626167 FROM OX,0.0,200000.0,,2018,2,9,TRANSFER,200000.0,M1516958151
30870,409000362497',2018-02-09,IMPS 804020626199 FROM OX,0.0,200000.0,,2018,2,9,TRANSFER,200000.0,M267044882
30871,409000362497',2018-02-09,IMPS 804020626231 FROM OX,0.0,200000.0,,2018,2,9,CHECK_CASHING,200000.0,M601853460
30872,409000362497',2018-02-09,IMPS 804020626266 FROM OX,0.0,200000.0,,2018,2,9,TRANSFER,200000.0,M165361812
30873,409000362497',2018-02-09,IMPS 804020627991 FROM OX,0.0,200000.0,,2018,2,9,CASH_IN,200000.0,M1295051847
30874,409000362497',2018-02-09,IMPS 804020628016 FROM OX,0.0,200000.0,,2018,2,9,CASH_IN,200000.0,C1783873866
30875,409000362497',2018-02-09,IMPS 804020628042 FROM OX,0.0,200000.0,,2018,2,9,CHECK_CASHING,200000.0,C1563323185
30876,409000362497',2018-02-09,IMPS 804020628068 FROM OX,0.0,200000.0,,2018,2,9,TRANSFER,200000.0,C1563929103
30877,409000362497',2018-02-09,IMPS 804020628091 FROM OX,0.0,200000.0,,2018,2,9,CHECK_CASHING,200000.0,C1413871034
30878,409000362497',2018-02-09,IMPS 804020628124 FROM OX,0.0,200000.0,,2018,2,9,CHECK_CASHING,200000.0,C1485647504
30879,409000362497',2018-02-09,IMPS 804020628155 FROM OX,0.0,200000.0,,2018,2,9,TRANSFER,200000.0,M536707312
30880,409000362497',2018-02-09,IMPS 804020628185 FROM OX,0.0,200000.0,,2018,2,9,CASH_IN,200000.0,M1615427209
30881,409000362497',2018-02-09,Sweep Trf To: 40900036427,827644.0,0.0,,2018,2,9,CASH_OUT,827644.0,C221674877
30882,409000362497',2018-02-12,IMPS 0902181C,5169870.02,0.0,,2018,2,12,DEBIT,5169870.02,C1511785794
30883,409000362497',2018-02-12,IMPS 100218 1C,14693957.17,0.0,,2018,2,12,CASH_OUT,14693957.17,M1956154138
30884,409000362497',2018-02-12,IMPS 110218 1C,3799981.05,0.0,,2018,2,12,CHECK_WITHDRAWAL,3799981.05,M1213794462
30885,409000362497',2018-02-12,IMPS 120218 2C,6716198.29,0.0,,2018,2,12,PAYEMENT,6716198.29,C1383454473
30886,409000362497',2018-02-12,BIGTREE ENTERTAINMENT PRI,1060.0,0.0,,2018,2,12,PAYEMENT,1060.0,C1263845074
30887,409000362497',2018-02-12,INDIAIDEAS.COM LTD,69914.0,0.0,,2018,2,12,DEBIT,69914.0,M1841009752
30888,409000362497',2018-02-12,IRCTC CORPORATE OFFICE AC,34495.0,0.0,,2018,2,12,CHECK_WITHDRAWAL,34495.0,M1505781900
30889,409000362497',2018-02-12,PAYU PAYMENTS PRIVATE LIM,16159.0,0.0,,2018,2,12,CASH_OUT,16159.0,M922009845
30890,409000362497',2018-02-12,AVENUES INDIA PRIVATE LIM,739.0,0.0,,2018,2,12,DEBIT,739.0,M888088800
30891,409000362497',2018-02-12,SYNERGISTIC FINANCIAL NET,3244.0,0.0,,2018,2,12,PAYEMENT,3244.0,C1753885705
30892,409000362497',2018-02-12,FUTURE RETAIL LIMITED (OW,2419.0,0.0,,2018,2,12,PAYEMENT,2419.0,C110721357
30893,409000362497',2018-02-12,PASFAR TECHNOLOGIES PRIVA,3917.0,0.0,,2018,2,12,PAYEMENT,3917.0,M1772216232
30894,409000362497',2018-02-12,JUST DIAL LIMITED,93.0,0.0,,2018,2,12,CHECK_WITHDRAWAL,93.0,M1707468017
30895,409000362497',2018-02-12,MEHAR ENTERTAINMENT PRIVA,6682.0,0.0,,2018,2,12,CASH_OUT,6682.0,C1922817437
30896,409000362497',2018-02-12,E-BILLING SOLUTIONS PRIVA,2300.0,0.0,,2018,2,12,CHECK_WITHDRAWAL,2300.0,M1957797785
30897,409000362497',2018-02-12,VOUCHER ACTIVATION SERVIC,6556.0,0.0,,2018,2,12,CHECK_WITHDRAWAL,6556.0,C1150575867
30898,409000362497',2018-02-12,QWIKCILVER SOLUTIONS PRIV,2515.0,0.0,,2018,2,12,DEBIT,2515.0,M132212086
30899,409000362497',2018-02-12,QWIKCILVER SOLUTIONS PVT,471.0,0.0,,2018,2,12,CHECK_WITHDRAWAL,471.0,C1892646174
30900,409000362497',2018-02-12,SHOPPERS STOP LIMITED,1103.0,0.0,,2018,2,12,CHECK_WITHDRAWAL,1103.0,M305545337
30901,409000362497',2018-02-12,Indiaforensic SERVICES INDIA PVT,732904.0,0.0,,2018,2,12,CHECK_WITHDRAWAL,732904.0,M1107472217
30902,409000362497',2018-02-12,BIGTREE ENTERTAINMENT PRI,6964.0,0.0,,2018,2,12,CASH_OUT,6964.0,C1217639236
30903,409000362497',2018-02-12,INDIAIDEAS.COM LTD,161728.0,0.0,,2018,2,12,DEBIT,161728.0,C1269336757
30904,409000362497',2018-02-12,IRCTC CORPORATE OFFICE AC,144690.0,0.0,,2018,2,12,PAYEMENT,144690.0,C1824348154
30905,409000362497',2018-02-12,PAYU PAYMENTS PRIVATE LIM,30314.0,0.0,,2018,2,12,CASH_OUT,30314.0,M1652151806
30906,409000362497',2018-02-12,AVENUES INDIA PRIVATE LIM,29090.0,0.0,,2018,2,12,CHECK_WITHDRAWAL,29090.0,C665576141
30907,409000362497',2018-02-12,FUTURE RETAIL LIMITED (OW,11221.0,0.0,,2018,2,12,CHECK_WITHDRAWAL,11221.0,C391734039
30908,409000362497',2018-02-12,PASFAR TECHNOLOGIES PRIVA,3213.0,0.0,,2018,2,12,CHECK_WITHDRAWAL,3213.0,M374571684
30909,409000362497',2018-02-12,JUST DIAL LIMITED,301.0,0.0,,2018,2,12,CHECK_WITHDRAWAL,301.0,M1973426590
30910,409000362497',2018-02-12,MEHAR ENTERTAINMENT PRIVA,27738.0,0.0,,2018,2,12,DEBIT,27738.0,M235261369
30911,409000362497',2018-02-12,E-BILLING SOLUTIONS PRIVA,7462.0,0.0,,2018,2,12,CHECK_WITHDRAWAL,7462.0,M421325416
30912,409000362497',2018-02-12,Indiaforensic SERVICES INDIA PVT,1700133.0,0.0,,2018,2,12,CHECK_WITHDRAWAL,1700133.0,C1847835159
30913,409000362497',2018-02-12,IMPS 120218 3C,12153948.31,0.0,,2018,2,12,CHECK_WITHDRAWAL,12153948.31,C719097409
30914,409000362497',2018-02-12,FDRL/INTERNAL FUND TRANSFE,0.0,10000000.0,,2018,2,12,TRANSFER,10000000.0,C1669259232
30915,409000362497',2018-02-12,FDRL/INTERNAL FUND TRANSFE,0.0,10000000.0,,2018,2,12,CASH_IN,10000000.0,C67985650
30916,409000362497',2018-02-12,FDRL/INTERNAL FUND TRANSFE,0.0,3000000.0,,2018,2,12,CASH_IN,3000000.0,C1254526270
30917,409000362497',2018-02-12,NEFT/SBIN718043640798/Indfor,0.0,4100000.0,,2018,2,12,TRANSFER,4100000.0,M1702802116
30918,409000362497',2018-02-12,IMPS 120218 4C,2545837.38,0.0,,2018,2,12,PAYEMENT,2545837.38,C1937721430
30919,409000362497',2018-02-12,Sweep Trf To: 40900036427,1443859.0,0.0,,2018,2,12,DEBIT,1443859.0,M442439373
30920,409000362497',2018-02-13,IMPS 1202181C,3567022.99,0.0,,2018,2,13,PAYEMENT,3567022.99,M1540616627
30921,409000362497',2018-02-13,IMPS 130218 2C,5559836.77,0.0,,2018,2,13,CHECK_WITHDRAWAL,5559836.77,M241794472
30922,409000362497',2018-02-13,IMPS 130218 3C,10582390.66,0.0,,2018,2,13,CHECK_WITHDRAWAL,10582390.66,M2073819744
30923,409000362497',2018-02-13,FDRL/INTERNAL FUND TRANSFE,0.0,15000000.0,,2018,2,13,CASH_IN,15000000.0,C244018103
30924,409000362497',2018-02-13,FDRL/INTERNAL FUND TRANSFE,0.0,500000.0,,2018,2,13,TRANSFER,500000.0,C1502143342
30925,409000362497',2018-02-13,IMPS 130218 4C,1594398.94,0.0,,2018,2,13,CASH_OUT,1594398.94,M1349595327
30926,409000362497',2018-02-13,IMPS 804421740160 FROM OX,0.0,200000.0,,2018,2,13,CASH_IN,200000.0,C720179024
30927,409000362497',2018-02-13,IMPS 804421740188 FROM OX,0.0,200000.0,,2018,2,13,CHECK_CASHING,200000.0,M13946341
30928,409000362497',2018-02-13,IMPS 804421740222 FROM OX,0.0,200000.0,,2018,2,13,TRANSFER,200000.0,C1654056127
30929,409000362497',2018-02-13,IMPS 804421740258 FROM OX,0.0,200000.0,,2018,2,13,CHECK_CASHING,200000.0,C1581067516
30930,409000362497',2018-02-13,IMPS 804421740285 FROM OX,0.0,200000.0,,2018,2,13,TRANSFER,200000.0,M278978683
30931,409000362497',2018-02-13,IMPS 804421740314 FROM OX,0.0,200000.0,,2018,2,13,CASH_IN,200000.0,C931548023
30932,409000362497',2018-02-13,IMPS 804421740354 FROM OX,0.0,200000.0,,2018,2,13,TRANSFER,200000.0,M1199461870
30933,409000362497',2018-02-13,IMPS 804421740381 FROM OX,0.0,200000.0,,2018,2,13,CHECK_CASHING,200000.0,M1336195867
30934,409000362497',2018-02-13,IMPS 804421740414 FROM OX,0.0,200000.0,,2018,2,13,CASH_IN,200000.0,M165332700
30935,409000362497',2018-02-13,IMPS 804421740453 FROM OX,0.0,200000.0,,2018,2,13,CASH_IN,200000.0,M1697839087
30936,409000362497',2018-02-13,IMPS 804421741429 FROM OX,0.0,200000.0,,2018,2,13,CHECK_CASHING,200000.0,C1900645000
30937,409000362497',2018-02-13,IMPS 804421741465 FROM OX,0.0,200000.0,,2018,2,13,TRANSFER,200000.0,M1595507682
30938,409000362497',2018-02-13,IMPS 804421741496 FROM OX,0.0,200000.0,,2018,2,13,CASH_IN,200000.0,M1797925133
30939,409000362497',2018-02-13,IMPS 804421741524 FROM OX,0.0,200000.0,,2018,2,13,TRANSFER,200000.0,M2147365188
30940,409000362497',2018-02-13,IMPS 804421741550 FROM OX,0.0,200000.0,,2018,2,13,CHECK_CASHING,200000.0,M1552590542
30941,409000362497',2018-02-13,IMPS 804421741589 FROM OX,0.0,200000.0,,2018,2,13,CASH_IN,200000.0,M1676118760
30942,409000362497',2018-02-13,IMPS 804421741618 FROM OX,0.0,200000.0,,2018,2,13,CASH_IN,200000.0,M414756668
30943,409000362497',2018-02-13,IMPS 804421741650 FROM OX,0.0,200000.0,,2018,2,13,TRANSFER,200000.0,M1163450947
30944,409000362497',2018-02-13,IMPS 804421741680 FROM OX,0.0,200000.0,,2018,2,13,CASH_IN,200000.0,M1737359651
30945,409000362497',2018-02-13,IMPS 804421742259 FROM OX,0.0,200000.0,,2018,2,13,CHECK_CASHING,200000.0,M1133439215
30946,409000362497',2018-02-13,IMPS 804421742284 FROM OX,0.0,200000.0,,2018,2,13,TRANSFER,200000.0,M2061641984
30947,409000362497',2018-02-13,IMPS 804421742311 FROM OX,0.0,200000.0,,2018,2,13,CASH_IN,200000.0,M866542462
30948,409000362497',2018-02-13,IMPS 804421742339 FROM OX,0.0,200000.0,,2018,2,13,CASH_IN,200000.0,M540623826
30949,409000362497',2018-02-13,IMPS 804421742370 FROM OX,0.0,200000.0,,2018,2,13,CHECK_CASHING,200000.0,M2119569637
30950,409000362497',2018-02-13,IMPS 804421742396 FROM OX,0.0,200000.0,,2018,2,13,CHECK_CASHING,200000.0,M421668926
30951,409000362497',2018-02-13,IMPS 804421742423 FROM OX,0.0,200000.0,,2018,2,13,CHECK_CASHING,200000.0,M1895807319
30952,409000362497',2018-02-13,IMPS 804421742448 FROM OX,0.0,200000.0,,2018,2,13,CHECK_CASHING,200000.0,M1977891855
30953,409000362497',2018-02-13,IMPS 804421742479 FROM OX,0.0,200000.0,,2018,2,13,CHECK_CASHING,200000.0,M1153086180
30954,409000362497',2018-02-13,IMPS 804421742654 FROM OX,0.0,200000.0,,2018,2,13,CASH_IN,200000.0,M296154902
30955,409000362497',2018-02-13,IMPS 804421742690 FROM OX,0.0,200000.0,,2018,2,13,CHECK_CASHING,200000.0,M1572414025
30956,409000362497',2018-02-13,IMPS 804421742719 FROM OX,0.0,200000.0,,2018,2,13,CASH_IN,200000.0,M192465731
30957,409000362497',2018-02-13,IMPS 804421742743 FROM OX,0.0,200000.0,,2018,2,13,CASH_IN,200000.0,M2131216939
30958,409000362497',2018-02-13,IMPS 804421742792 FROM OX,0.0,200000.0,,2018,2,13,CASH_IN,200000.0,M465306732
30959,409000362497',2018-02-13,IMPS 804421742821 FROM OX,0.0,200000.0,,2018,2,13,CASH_IN,200000.0,M1896554656
30960,409000362497',2018-02-13,Sweep Trf To: 40900036427,835845.0,0.0,,2018,2,13,PAYEMENT,835845.0,M1124902765
30961,409000362497',2018-02-14,IRCTC CORPORATE OFFICE AC,39855.0,0.0,,2018,2,14,PAYEMENT,39855.0,M1014050094
30962,409000362497',2018-02-14,AVENUES INDIA PRIVATE LIM,13317.0,0.0,,2018,2,14,CASH_OUT,13317.0,M1621750326
30963,409000362497',2018-02-14,FUTURE RETAIL LIMITED (OW,591.0,0.0,,2018,2,14,PAYEMENT,591.0,M2037800270
30964,409000362497',2018-02-14,PASFAR TECHNOLOGIES PRIVA,1142.0,0.0,,2018,2,14,CASH_OUT,1142.0,M1355614006
30965,409000362497',2018-02-14,MEHAR ENTERTAINMENT PRIVA,3802.0,0.0,,2018,2,14,CHECK_WITHDRAWAL,3802.0,M265868106
30966,409000362497',2018-02-14,Indiaforensic SERVICES INDIA PVT,463564.0,0.0,,2018,2,14,CASH_OUT,463564.0,M460845124
30967,409000362497',2018-02-14,IMPS 1302181C,1748404.71,0.0,,2018,2,14,CHECK_WITHDRAWAL,1748404.71,M1838761699
30968,409000362497',2018-02-14,IMPS 140218 2C,1076182.58,0.0,,2018,2,14,CHECK_WITHDRAWAL,1076182.58,M925916605
30969,409000362497',2018-02-14,BIGTREE ENTERTAINMENT PRI,2143.0,0.0,,2018,2,14,CASH_OUT,2143.0,M545716076
30970,409000362497',2018-02-14,INDIAIDEAS.COM LTD,26805.0,0.0,,2018,2,14,CHECK_WITHDRAWAL,26805.0,C1778289781
30971,409000362497',2018-02-14,IRCTC CORPORATE OFFICE AC,52105.0,0.0,,2018,2,14,CASH_OUT,52105.0,M1921830249
30972,409000362497',2018-02-14,PAYU PAYMENTS PRIVATE LIM,28267.0,0.0,,2018,2,14,CHECK_WITHDRAWAL,28267.0,M835192134
30973,409000362497',2018-02-14,AVENUES INDIA PRIVATE LIM,18573.0,0.0,,2018,2,14,DEBIT,18573.0,C1560607671
30974,409000362497',2018-02-14,FUTURE RETAIL LIMITED (OW,608.0,0.0,,2018,2,14,DEBIT,608.0,M1368198404
30975,409000362497',2018-02-14,PASFAR TECHNOLOGIES PRIVA,3334.0,0.0,,2018,2,14,PAYEMENT,3334.0,C1423992712
30976,409000362497',2018-02-14,DISH INFRA SERVICES PRIVA,290.0,0.0,,2018,2,14,DEBIT,290.0,M803661212
30977,409000362497',2018-02-14,JUST DIAL LIMITED,828.0,0.0,,2018,2,14,CHECK_WITHDRAWAL,828.0,M1081136680
30978,409000362497',2018-02-14,MEHAR ENTERTAINMENT PRIVA,6798.0,0.0,,2018,2,14,PAYEMENT,6798.0,M254477147
30979,409000362497',2018-02-14,E-BILLING SOLUTIONS PRIVA,804.0,0.0,,2018,2,14,PAYEMENT,804.0,M244536379
30980,409000362497',2018-02-14,Indiaforensic SERVICES INDIA PVT,764164.0,0.0,,2018,2,14,CHECK_WITHDRAWAL,764164.0,M2395034
30981,409000362497',2018-02-14,IMPS 140218 3C,1798444.0,0.0,,2018,2,14,PAYEMENT,1798444.0,C713039134
30982,409000362497',2018-02-14,FDRL/INTERNAL FUND TRANSFE,0.0,10000000.0,,2018,2,14,TRANSFER,10000000.0,C1876630105
30983,409000362497',2018-02-14,FDRL/INTERNAL FUND TRANSFE,0.0,3000000.0,,2018,2,14,TRANSFER,3000000.0,C1538961175
30984,409000362497',2018-02-14,IMPS 140218 4C,2033285.6,0.0,,2018,2,14,DEBIT,2033285.6,C656400047
30985,409000362497',2018-02-14,Sweep Trf To: 40900036427,84941.0,0.0,,2018,2,14,PAYEMENT,84941.0,M1035284114
30986,409000362497',2018-02-15,IMPS 1402181C,2808523.48,0.0,,2018,2,15,PAYEMENT,2808523.48,M2013961384
30987,409000362497',2018-02-15,IMPS 150218 2C,1654352.67,0.0,,2018,2,15,DEBIT,1654352.67,M1887751090
30988,409000362497',2018-02-15,BIGTREE ENTERTAINMENT PRI,868.0,0.0,,2018,2,15,PAYEMENT,868.0,M991414955
30989,409000362497',2018-02-15,INDIAIDEAS.COM LTD,50503.0,0.0,,2018,2,15,CASH_OUT,50503.0,C1081126121
30990,409000362497',2018-02-15,IRCTC CORPORATE OFFICE AC,44865.0,0.0,,2018,2,15,CASH_OUT,44865.0,M886936075
30991,409000362497',2018-02-15,PAYU PAYMENTS PRIVATE LIM,23913.0,0.0,,2018,2,15,PAYEMENT,23913.0,M427782963
30992,409000362497',2018-02-15,AVENUES INDIA PRIVATE LIM,13370.0,0.0,,2018,2,15,DEBIT,13370.0,M1139746695
30993,409000362497',2018-02-15,ZAAK EPAYMENT SERVICES PR,614.0,0.0,,2018,2,15,CHECK_WITHDRAWAL,614.0,M1119294865
30994,409000362497',2018-02-15,FUTURE RETAIL LIMITED (OW,836.0,0.0,,2018,2,15,CHECK_WITHDRAWAL,836.0,C1679546686
30995,409000362497',2018-02-15,PASFAR TECHNOLOGIES PRIVA,1738.0,0.0,,2018,2,15,PAYEMENT,1738.0,M245001083
30996,409000362497',2018-02-15,JUST DIAL LIMITED,4157.0,0.0,,2018,2,15,CASH_OUT,4157.0,M747765139
30997,409000362497',2018-02-15,MEHAR ENTERTAINMENT PRIVA,4493.0,0.0,,2018,2,15,CASH_OUT,4493.0,C1890258988
30998,409000362497',2018-02-15,E-BILLING SOLUTIONS PRIVA,3729.0,0.0,,2018,2,15,CHECK_WITHDRAWAL,3729.0,M1982322852
30999,409000362497',2018-02-15,Indiaforensic SERVICES INDIA PVT,541151.0,0.0,,2018,2,15,PAYEMENT,541151.0,M639208645
31000,409000362497',2018-02-15,FDRL/INTERNAL FUND TRANSFE,0.0,10000000.0,,2018,2,15,CHECK_CASHING,10000000.0,C653745564
31001,409000362497',2018-02-15,FDRL/INTERNAL FUND TRANSFE,0.0,1000000.0,,2018,2,15,TRANSFER,1000000.0,M946962600
31002,409000362497',2018-02-15,IMPS 150218 3C,4103926.99,0.0,,2018,2,15,PAYEMENT,4103926.99,C618155294
31003,409000362497',2018-02-15,IMPS 150218 4C,1667470.75,0.0,,2018,2,15,CASH_OUT,1667470.75,M1257205956
31004,409000362497',2018-02-15,Sweep Trf To: 40900036427,149781.0,0.0,,2018,2,15,DEBIT,149781.0,M249377943
31005,409000362497',2018-02-16,FDRL/INTERNAL FUND TRANSFE,0.0,15000000.0,,2018,2,16,CASH_IN,15000000.0,M539904431
31006,409000362497',2018-02-16,FDRL/INTERNAL FUND TRANSFE,0.0,15000000.0,,2018,2,16,CASH_IN,15000000.0,M1198532872
31007,409000362497',2018-02-16,FDRL/INTERNAL FUND TRANSFE,0.0,10000000.0,,2018,2,16,CHECK_CASHING,10000000.0,C607874855
31008,409000362497',2018-02-16,IMPS 1502181C,5318354.71,0.0,,2018,2,16,CASH_OUT,5318354.71,C1465478513
31009,409000362497',2018-02-16,IMPS 160218 2C,6164255.62,0.0,,2018,2,16,PAYEMENT,6164255.62,C1635341595
31010,409000362497',2018-02-16,IMPS 160218 3C,11580567.33,0.0,,2018,2,16,CASH_OUT,11580567.33,M1721472517
31011,409000362497',2018-02-16,FDRL/INTERNAL FUND TRANSFE,0.0,4000000.0,,2018,2,16,CASH_IN,4000000.0,M1962106691
31012,409000362497',2018-02-16,NEFT/AXIC180470992573/Indfor,0.0,15000000.0,,2018,2,16,TRANSFER,15000000.0,C929266212
31013,409000362497',2018-02-16,FDRL/INTERNAL FUND TRANSFE,0.0,10000000.0,,2018,2,16,CASH_IN,10000000.0,C392292416
31014,409000362497',2018-02-16,FDRL/INTERNAL FUND TRANSFE,0.0,10000000.0,,2018,2,16,CASH_IN,10000000.0,M985088449
31015,409000362497',2018-02-16,FDRL/INTERNAL FUND TRANSFE,0.0,6000000.0,,2018,2,16,CASH_IN,6000000.0,C1885389259
31016,409000362497',2018-02-16,IMPS 160218 4C,6382674.39,0.0,,2018,2,16,CASH_OUT,6382674.39,C2070626006
31017,409000362497',2018-02-16,Sweep Trf To: 40900036427,1136647.0,0.0,,2018,2,16,DEBIT,1136647.0,M1482765659
31018,409000362497',2018-02-17,NEFT/AXIC180481006263/Indfor,0.0,10000000.0,,2018,2,17,TRANSFER,10000000.0,C2114628469
31019,409000362497',2018-02-17,IMPS 1602181C,6669783.78,0.0,,2018,2,17,CHECK_WITHDRAWAL,6669783.78,M381912716
31020,409000362497',2018-02-17,IMPS 170218 2C,3508815.85,0.0,,2018,2,17,CHECK_WITHDRAWAL,3508815.85,M303331034
31021,409000362497',2018-02-17,IMPS 170218 3C,8123735.77,0.0,,2018,2,17,CASH_OUT,8123735.77,M154480472
31022,409000362497',2018-02-17,FDRL/INTERNAL FUND TRANSFE,0.0,15000000.0,,2018,2,17,CASH_IN,15000000.0,C587433505
31023,409000362497',2018-02-17,FDRL/INTERNAL FUND TRANSFE,0.0,2000000.0,,2018,2,17,CHECK_CASHING,2000000.0,C1510452783
31024,409000362497',2018-02-17,IMPS 170218 4C,5110839.02,0.0,,2018,2,17,CHECK_WITHDRAWAL,5110839.02,M1358275321
31025,409000362497',2018-02-17,Sweep Trf To: 40900036427,242904.0,0.0,,2018,2,17,CHECK_WITHDRAWAL,242904.0,M2045711570
31026,409000362497',2018-02-19,IMPS 1702181C,6737189.17,0.0,,2018,2,19,DEBIT,6737189.17,C1069892822
31027,409000362497',2018-02-19,IMPS 180218 1C,12319054.52,0.0,,2018,2,19,CHECK_WITHDRAWAL,12319054.52,M450750895
31028,409000362497',2018-02-19,IMPS 190218 2C,3121602.98,0.0,,2018,2,19,CHECK_WITHDRAWAL,3121602.98,C1058634310
31029,409000362497',2018-02-19,IMPS 190218 3C,9807846.74,0.0,,2018,2,19,CHECK_WITHDRAWAL,9807846.74,C1763052044
31030,409000362497',2018-02-19,NEFT/SBIN418050202179/Indfor,0.0,4000000.0,,2018,2,19,CHECK_CASHING,4000000.0,M1869807741
31031,409000362497',2018-02-19,IMPS 180218 4C,6181645.2,0.0,,2018,2,19,CASH_OUT,6181645.2,C1519254830
31032,409000362497',2018-02-19,Sweep Trf To: 40900036427,910797.0,0.0,,2018,2,19,CHECK_WITHDRAWAL,910797.0,M1702568569
31033,409000362497',2018-02-20,BIGTREE ENTERTAINMENT PRI,14217.0,0.0,,2018,2,20,DEBIT,14217.0,C1907159141
31034,409000362497',2018-02-20,INDIAIDEAS.COM LTD,92733.0,0.0,,2018,2,20,PAYEMENT,92733.0,C1825389809
31035,409000362497',2018-02-20,IRCTC CORPORATE OFFICE AC,250705.0,0.0,,2018,2,20,PAYEMENT,250705.0,M1306099607
31036,409000362497',2018-02-20,PAYU PAYMENTS PRIVATE LIM,65542.0,0.0,,2018,2,20,PAYEMENT,65542.0,C838411509
31037,409000362497',2018-02-20,MATRIX CELLULAR (INTERNAT,1818.0,0.0,,2018,2,20,CHECK_WITHDRAWAL,1818.0,C1166654566
31038,409000362497',2018-02-20,AVENUES INDIA PRIVATE LIM,62754.0,0.0,,2018,2,20,CHECK_WITHDRAWAL,62754.0,C1721246982
31039,409000362497',2018-02-20,SYNERGISTIC FINANCIAL NET,44.0,0.0,,2018,2,20,CASH_OUT,44.0,C1243393970
31040,409000362497',2018-02-20,ZAAK EPAYMENT SERVICES PR,2968.0,0.0,,2018,2,20,PAYEMENT,2968.0,C358945794
31041,409000362497',2018-02-20,FUTURE RETAIL LIMITED (OW,12358.0,0.0,,2018,2,20,CASH_OUT,12358.0,M1884246089
31042,409000362497',2018-02-20,METRO INFRASYS PRIVATE LI,673.0,0.0,,2018,2,20,PAYEMENT,673.0,M144427211
31043,409000362497',2018-02-20,PASFAR TECHNOLOGIES PRIVA,29143.0,0.0,,2018,2,20,DEBIT,29143.0,M66307889
31044,409000362497',2018-02-20,DISH INFRA SERVICES PRIVA,152.0,0.0,,2018,2,20,PAYEMENT,152.0,M234963857
31045,409000362497',2018-02-20,MEHAR ENTERTAINMENT PRIVA,23734.0,0.0,,2018,2,20,DEBIT,23734.0,M978411178
31046,409000362497',2018-02-20,E-BILLING SOLUTIONS PRIVA,10146.0,0.0,,2018,2,20,DEBIT,10146.0,M912552051
31047,409000362497',2018-02-20,VOUCHER ACTIVATION SERVIC,20343.0,0.0,,2018,2,20,CHECK_WITHDRAWAL,20343.0,M396286129
31048,409000362497',2018-02-20,QWIKCILVER SOLUTIONS PRIV,14869.0,0.0,,2018,2,20,CHECK_WITHDRAWAL,14869.0,M1565368888
31049,409000362497',2018-02-20,JUST DIAL LIMITED,493.0,0.0,,2018,2,20,CHECK_WITHDRAWAL,493.0,M1212075234
31050,409000362497',2018-02-20,ALT DIGITAL MEDIA ENTERTA,196.0,0.0,,2018,2,20,DEBIT,196.0,M1308490301
31051,409000362497',2018-02-20,Indiaforensic SERVICES INDIA PVT,3635365.0,0.0,,2018,2,20,PAYEMENT,3635365.0,M2080420121
31052,409000362497',2018-02-20,BIGTREE ENTERTAINMENT PRI,112.0,0.0,,2018,2,20,DEBIT,112.0,M766655975
31053,409000362497',2018-02-20,INDIAIDEAS.COM LTD,118179.0,0.0,,2018,2,20,PAYEMENT,118179.0,M800858999
31054,409000362497',2018-02-20,IRCTC CORPORATE OFFICE AC,69565.0,0.0,,2018,2,20,CASH_OUT,69565.0,M2082419000
31055,409000362497',2018-02-20,PAYU PAYMENTS PRIVATE LIM,67930.0,0.0,,2018,2,20,DEBIT,67930.0,C418978254
31056,409000362497',2018-02-20,BIDDERBOY CORPORATION,520.0,0.0,,2018,2,20,PAYEMENT,520.0,C918523964
31057,409000362497',2018-02-20,AVENUES INDIA PRIVATE LIM,14894.0,0.0,,2018,2,20,DEBIT,14894.0,C244018103
31058,409000362497',2018-02-20,SYNERGISTIC FINANCIAL NET,44.0,0.0,,2018,2,20,CHECK_WITHDRAWAL,44.0,M418627875
31059,409000362497',2018-02-20,ZAAK EPAYMENT SERVICES PR,486.0,0.0,,2018,2,20,CASH_OUT,486.0,M853068810
31060,409000362497',2018-02-20,FUTURE RETAIL LIMITED (OW,931.0,0.0,,2018,2,20,PAYEMENT,931.0,C2137848242
31061,409000362497',2018-02-20,METRO INFRASYS PRIVATE LI,2019.0,0.0,,2018,2,20,PAYEMENT,2019.0,M1578621447
31062,409000362497',2018-02-20,PASFAR TECHNOLOGIES PRIVA,3007.0,0.0,,2018,2,20,DEBIT,3007.0,M474493839
31063,409000362497',2018-02-20,VOYLLA FASHIONS PRIVATE L,391.0,0.0,,2018,2,20,CHECK_WITHDRAWAL,391.0,M761118396
31064,409000362497',2018-02-20,MEHAR ENTERTAINMENT PRIVA,5761.0,0.0,,2018,2,20,DEBIT,5761.0,M89138166
31065,409000362497',2018-02-20,JUST DIAL LIMITED,133.0,0.0,,2018,2,20,CHECK_WITHDRAWAL,133.0,M1548519934
31066,409000362497',2018-02-20,MUZAFFARPUR VIDYUT VITARA,179.0,0.0,,2018,2,20,CHECK_WITHDRAWAL,179.0,M1307728099
31067,409000362497',2018-02-20,Indiaforensic SERVICES INDIA PVT,600669.0,0.0,,2018,2,20,CHECK_WITHDRAWAL,600669.0,C1409091101
31068,409000362497',2018-02-20,IMPS 1902181C,6988403.03,0.0,,2018,2,20,CASH_OUT,6988403.03,M1332154717
31069,409000362497',2018-02-20,IMPS 200218 2C,2819316.24,0.0,,2018,2,20,CHECK_WITHDRAWAL,2819316.24,M267676831
31070,409000362497',2018-02-20,IMPS 200218 3C,8331004.72,0.0,,2018,2,20,PAYEMENT,8331004.72,M82390437
31071,409000362497',2018-02-20,NEFT/FDRL504548881/Indiaforensic,0.0,5000000.0,,2018,2,20,CASH_IN,5000000.0,C1068824137
31072,409000362497',2018-02-20,NEFT/FDRL504548839/Indiaforensic,0.0,1000000.0,,2018,2,20,TRANSFER,1000000.0,C169904524
31073,409000362497',2018-02-20,FDRL/INTERNAL FUND TRANSFE,0.0,10000000.0,,2018,2,20,TRANSFER,10000000.0,C1006094903
31074,409000362497',2018-02-20,FDRL/INTERNAL FUND TRANSFE,0.0,10000000.0,,2018,2,20,CASH_IN,10000000.0,M843054904
31075,409000362497',2018-02-20,FDRL/INTERNAL FUND TRANSFE,0.0,1000000.0,,2018,2,20,CHECK_CASHING,1000000.0,M1284109170
31076,409000362497',2018-02-20,IMPS 200218 4C,5572067.1,0.0,,2018,2,20,PAYEMENT,5572067.1,M1954061881
31077,409000362497',2018-02-20,Sweep Trf To: 40900036427,691085.0,0.0,,2018,2,20,CASH_OUT,691085.0,M877553242
31078,409000362497',2018-02-21,IMPS 2002181C,6387245.57,0.0,,2018,2,21,DEBIT,6387245.57,M648461839
31079,409000362497',2018-02-21,IMPS 210218 2C,2628607.42,0.0,,2018,2,21,CASH_OUT,2628607.42,M780185265
31080,409000362497',2018-02-21,IMPS 210220183C,7182011.19,0.0,,2018,2,21,PAYEMENT,7182011.19,C1567808902
31081,409000362497',2018-02-21,BIGTREE ENTERTAINMENT PRI,699.0,0.0,,2018,2,21,PAYEMENT,699.0,C1121453612
31082,409000362497',2018-02-21,INDIAIDEAS.COM LTD,55265.0,0.0,,2018,2,21,PAYEMENT,55265.0,C1473237843
31083,409000362497',2018-02-21,IRCTC CORPORATE OFFICE AC,82370.0,0.0,,2018,2,21,PAYEMENT,82370.0,M1953611540
31084,409000362497',2018-02-21,PAYU PAYMENTS PRIVATE LIM,15000.0,0.0,,2018,2,21,CHECK_WITHDRAWAL,15000.0,C2085805920
31085,409000362497',2018-02-21,AVENUES INDIA PRIVATE LIM,6114.0,0.0,,2018,2,21,CHECK_WITHDRAWAL,6114.0,C2072201071
31086,409000362497',2018-02-21,ZAAK EPAYMENT SERVICES PR,358.0,0.0,,2018,2,21,CHECK_WITHDRAWAL,358.0,C1816986148
31087,409000362497',2018-02-21,FUTURE RETAIL LIMITED (OW,2987.0,0.0,,2018,2,21,CHECK_WITHDRAWAL,2987.0,C173247103
31088,409000362497',2018-02-21,PASFAR TECHNOLOGIES PRIVA,11786.0,0.0,,2018,2,21,CASH_OUT,11786.0,C2137848242
31089,409000362497',2018-02-21,HUNGAMA DIGITAL MEDIA ENT,750.0,0.0,,2018,2,21,CHECK_WITHDRAWAL,750.0,C787040724
31090,409000362497',2018-02-21,MEHAR ENTERTAINMENT PRIVA,6538.0,0.0,,2018,2,21,DEBIT,6538.0,C1556875182
31091,409000362497',2018-02-21,Indiaforensic SERVICES INDIA PVT,876856.0,0.0,,2018,2,21,CHECK_WITHDRAWAL,876856.0,C674913323
31092,409000362497',2018-02-21,NEFT/FDRL504548797/Indiaforensic,0.0,2000000.0,,2018,2,21,TRANSFER,2000000.0,C747869108
31093,409000362497',2018-02-21,NEFT/SBIN618052102901/Indfor,0.0,6000000.0,,2018,2,21,CASH_IN,6000000.0,M1136574740
31094,409000362497',2018-02-21,NEFT/FDRL504548794/Indiaforensic,0.0,2000000.0,,2018,2,21,CHECK_CASHING,2000000.0,M419463242
31095,409000362497',2018-02-21,FDRL/INTERNAL FUND TRANSFE,0.0,10000000.0,,2018,2,21,CASH_IN,10000000.0,M1482394502
31096,409000362497',2018-02-21,FDRL/INTERNAL FUND TRANSFE,0.0,10000000.0,,2018,2,21,CASH_IN,10000000.0,C14440699
31097,409000362497',2018-02-21,FDRL/INTERNAL FUND TRANSFE,0.0,3000000.0,,2018,2,21,CHECK_CASHING,3000000.0,C748241311
31098,409000362497',2018-02-21,FDRL/INTERNAL FUND TRANSFE,0.0,4000000.0,,2018,2,21,CHECK_CASHING,4000000.0,C985537694
31099,409000362497',2018-02-21,IMPS 210218 4C,5684586.23,0.0,,2018,2,21,CASH_OUT,5684586.23,C57497207
31100,409000362497',2018-02-21,Sweep Trf To: 40900036427,496581.0,0.0,,2018,2,21,CHECK_WITHDRAWAL,496581.0,M259075709
31101,409000362497',2018-02-22,NEFT/BARBT18053500591/MAI,0.0,10000.0,,2018,2,22,CHECK_CASHING,10000.0,M375566378
31102,409000362497',2018-02-22,IMPS 2102181C,5778313.81,0.0,,2018,2,22,DEBIT,5778313.81,M1225444842
31103,409000362497',2018-02-22,IMPS 220218 2C,2667545.1,0.0,,2018,2,22,CASH_OUT,2667545.1,C1253373655
31104,409000362497',2018-02-22,BIGTREE ENTERTAINMENT PRI,588.0,0.0,,2018,2,22,CASH_OUT,588.0,M1709995863
31105,409000362497',2018-02-22,INDIAIDEAS.COM LTD,42155.0,0.0,,2018,2,22,DEBIT,42155.0,M1690970473
31106,409000362497',2018-02-22,IRCTC CORPORATE OFFICE AC,104820.0,0.0,,2018,2,22,CASH_OUT,104820.0,M2145538549
31107,409000362497',2018-02-22,PAYU PAYMENTS PRIVATE LIM,19234.0,0.0,,2018,2,22,CHECK_WITHDRAWAL,19234.0,M68344259
31108,409000362497',2018-02-22,AVENUES INDIA PRIVATE LIM,16723.0,0.0,,2018,2,22,CASH_OUT,16723.0,C320919849
31109,409000362497',2018-02-22,SYNERGISTIC FINANCIAL NET,1728.0,0.0,,2018,2,22,CHECK_WITHDRAWAL,1728.0,M111954305
31110,409000362497',2018-02-22,ZAAK EPAYMENT SERVICES PR,174.0,0.0,,2018,2,22,CHECK_WITHDRAWAL,174.0,C2144240673
31111,409000362497',2018-02-22,FUTURE RETAIL LIMITED (OW,1696.0,0.0,,2018,2,22,PAYEMENT,1696.0,C618155294
31112,409000362497',2018-02-22,PASFAR TECHNOLOGIES PRIVA,3529.0,0.0,,2018,2,22,CHECK_WITHDRAWAL,3529.0,M423932013
31113,409000362497',2018-02-22,DISH INFRA SERVICES PRIVA,551.0,0.0,,2018,2,22,DEBIT,551.0,M1607329475
31114,409000362497',2018-02-22,MEHAR ENTERTAINMENT PRIVA,4609.0,0.0,,2018,2,22,CHECK_WITHDRAWAL,4609.0,M511406332
31115,409000362497',2018-02-22,E-BILLING SOLUTIONS PRIVA,2528.0,0.0,,2018,2,22,DEBIT,2528.0,M553805551
31116,409000362497',2018-02-22,Indiaforensic SERVICES INDIA PVT,947958.0,0.0,,2018,2,22,DEBIT,947958.0,M1162016150
31117,409000362497',2018-02-22,NEFT/000040901741/RTGS PO,0.0,5000.0,,2018,2,22,CASH_IN,5000.0,M769206886
31118,409000362497',2018-02-22,NEFT/000040901860/RTGS PO,0.0,5000.0,,2018,2,22,CASH_IN,5000.0,M596451324
31119,409000362497',2018-02-22,NEFT/000040902268/RTGS PO,0.0,1000.0,,2018,2,22,TRANSFER,1000.0,M675397114
31120,409000362497',2018-02-22,IMPS 220220183C,7770162.83,0.0,,2018,2,22,DEBIT,7770162.83,M535149585
31121,409000362497',2018-02-22,NEFT/FDRL504548800/Indiaforensic,0.0,1000000.0,,2018,2,22,TRANSFER,1000000.0,M265570846
31122,409000362497',2018-02-22,NEFT/SBIN618053937082/Indfor,0.0,4100000.0,,2018,2,22,CASH_IN,4100000.0,M148282983
31123,409000362497',2018-02-22,FDRL/INTERNAL FUND TRANSFE,0.0,10000000.0,,2018,2,22,TRANSFER,10000000.0,M1938857936
31124,409000362497',2018-02-22,FDRL/INTERNAL FUND TRANSFE,0.0,1000000.0,,2018,2,22,TRANSFER,1000000.0,M2023744293
31125,409000362497',2018-02-22,IMPS 220220184C,5442909.17,0.0,,2018,2,22,PAYEMENT,5442909.17,M477716100
31126,409000362497',2018-02-22,Sweep Trf To: 40900036427,562593.0,0.0,,2018,2,22,CASH_OUT,562593.0,M1825181728
31127,409000362497',2018-02-23,IMPS 2202181C,5923444.35,0.0,,2018,2,23,PAYEMENT,5923444.35,M1351255332
31128,409000362497',2018-02-23,IMPS 230218 2C,2488163.23,0.0,,2018,2,23,CASH_OUT,2488163.23,M1568865908
31129,409000362497',2018-02-23,BIGTREE ENTERTAINMENT PRI,226.0,0.0,,2018,2,23,PAYEMENT,226.0,M1414127258
31130,409000362497',2018-02-23,INDIAIDEAS.COM LTD,68341.0,0.0,,2018,2,23,DEBIT,68341.0,M1384165165
31131,409000362497',2018-02-23,IRCTC CORPORATE OFFICE AC,64680.0,0.0,,2018,2,23,DEBIT,64680.0,M1853850774
31132,409000362497',2018-02-23,PAYU PAYMENTS PRIVATE LIM,20874.0,0.0,,2018,2,23,DEBIT,20874.0,M2109080163
31133,409000362497',2018-02-23,AVENUES INDIA PRIVATE LIM,1950.0,0.0,,2018,2,23,CASH_OUT,1950.0,M1516117517
31134,409000362497',2018-02-23,ZAAK EPAYMENT SERVICES PR,358.0,0.0,,2018,2,23,CHECK_WITHDRAWAL,358.0,M2081096496
31135,409000362497',2018-02-23,FUTURE RETAIL LIMITED (OW,2285.0,0.0,,2018,2,23,DEBIT,2285.0,C1297873690
31136,409000362497',2018-02-23,PASFAR TECHNOLOGIES PRIVA,2816.0,0.0,,2018,2,23,CASH_OUT,2816.0,C523154252
31137,409000362497',2018-02-23,JUST DIAL LIMITED,138.0,0.0,,2018,2,23,DEBIT,138.0,C1691272400
31138,409000362497',2018-02-23,MEHAR ENTERTAINMENT PRIVA,6567.0,0.0,,2018,2,23,CASH_OUT,6567.0,C1646561071
31139,409000362497',2018-02-23,E-BILLING SOLUTIONS PRIVA,1300.0,0.0,,2018,2,23,CHECK_WITHDRAWAL,1300.0,M566254546
31140,409000362497',2018-02-23,Indiaforensic SERVICES INDIA PVT,1019029.0,0.0,,2018,2,23,CASH_OUT,1019029.0,C1778289781
31141,409000362497',2018-02-23,IMPS 230220183C,8407977.53,0.0,,2018,2,23,DEBIT,8407977.53,M1527626232
31142,409000362497',2018-02-23,NEFT/SBIN718054880363/Indfor,0.0,8700000.0,,2018,2,23,CASH_IN,8700000.0,M1669047811
31143,409000362497',2018-02-23,FDRL/INTERNAL FUND TRANSFE,0.0,6000000.0,,2018,2,23,CASH_IN,6000000.0,M1985864345
31144,409000362497',2018-02-23,FDRL/INTERNAL FUND TRANSFE,0.0,6000000.0,,2018,2,23,CASH_IN,6000000.0,C1729548294
31145,409000362497',2018-02-23,FDRL/INTERNAL FUND TRANSFE,0.0,6000000.0,,2018,2,23,TRANSFER,6000000.0,C1196307684
31146,409000362497',2018-02-23,IMPS 805420510925 FROM OX,0.0,200000.0,,2018,2,23,TRANSFER,200000.0,M539236863
31147,409000362497',2018-02-23,IMPS 805420510950 FROM OX,0.0,200000.0,,2018,2,23,CHECK_CASHING,200000.0,M828437482
31148,409000362497',2018-02-23,IMPS 805420510989 FROM OX,0.0,200000.0,,2018,2,23,TRANSFER,200000.0,C188878238
31149,409000362497',2018-02-23,IMPS 805420511034 FROM OX,0.0,200000.0,,2018,2,23,CHECK_CASHING,200000.0,C1516565803
31150,409000362497',2018-02-23,IMPS 805420511061 FROM OX,0.0,200000.0,,2018,2,23,CHECK_CASHING,200000.0,M286145959
31151,409000362497',2018-02-23,IMPS 805420511093 FROM OX,0.0,200000.0,,2018,2,23,CASH_IN,200000.0,C1299829127
31152,409000362497',2018-02-23,IMPS 805420511116 FROM OX,0.0,200000.0,,2018,2,23,TRANSFER,200000.0,C978740207
31153,409000362497',2018-02-23,IMPS 805420511143 FROM OX,0.0,200000.0,,2018,2,23,TRANSFER,200000.0,C624539461
31154,409000362497',2018-02-23,IMPS 805420511175 FROM OX,0.0,200000.0,,2018,2,23,TRANSFER,200000.0,C1318038292
31155,409000362497',2018-02-23,IMPS 805420511751 FROM OX,0.0,200000.0,,2018,2,23,CHECK_CASHING,200000.0,C1623014027
31156,409000362497',2018-02-23,IMPS 805420511772 FROM OX,0.0,200000.0,,2018,2,23,CHECK_CASHING,200000.0,M938930898
31157,409000362497',2018-02-23,IMPS 805420511798 FROM OX,0.0,200000.0,,2018,2,23,CASH_IN,200000.0,M1546132683
31158,409000362497',2018-02-23,IMPS 805420511828 FROM OX,0.0,200000.0,,2018,2,23,CHECK_CASHING,200000.0,C198210775
31159,409000362497',2018-02-23,IMPS 805420511852 FROM OX,0.0,200000.0,,2018,2,23,CHECK_CASHING,200000.0,C1261309973
31160,409000362497',2018-02-23,IMPS 805420511873 FROM OX,0.0,200000.0,,2018,2,23,CASH_IN,200000.0,C1894207825
31161,409000362497',2018-02-23,IMPS 805420511906 FROM OX,0.0,200000.0,,2018,2,23,CASH_IN,200000.0,C1245472829
31162,409000362497',2018-02-23,IMPS 805420511934 FROM OX,0.0,200000.0,,2018,2,23,CASH_IN,200000.0,M1584962518
31163,409000362497',2018-02-23,IMPS 805420511969 FROM OX,0.0,200000.0,,2018,2,23,CHECK_CASHING,200000.0,M1454696640
31164,409000362497',2018-02-23,IMPS 805420512525 FROM OX,0.0,200000.0,,2018,2,23,TRANSFER,200000.0,M1968504845
31165,409000362497',2018-02-23,IMPS 805420512559 FROM OX,0.0,200000.0,,2018,2,23,CHECK_CASHING,200000.0,M159672884
31166,409000362497',2018-02-23,IMPS 805420512588 FROM OX,0.0,200000.0,,2018,2,23,CASH_IN,200000.0,M2009485901
31167,409000362497',2018-02-23,IMPS 805420512628 FROM OX,0.0,200000.0,,2018,2,23,CHECK_CASHING,200000.0,M512042311
31168,409000362497',2018-02-23,IMPS 805420512659 FROM OX,0.0,200000.0,,2018,2,23,CHECK_CASHING,200000.0,C1046160944
31169,409000362497',2018-02-23,IMPS 805420512705 FROM OX,0.0,200000.0,,2018,2,23,TRANSFER,200000.0,C1809373351
31170,409000362497',2018-02-23,IMPS 230218 4C,5723387.74,0.0,,2018,2,23,CHECK_WITHDRAWAL,5723387.74,M1354139348
31171,409000362497',2018-02-23,IMPS 805423541836 FROM OX,0.0,200000.0,,2018,2,23,CASH_IN,200000.0,C1090263069
31172,409000362497',2018-02-23,IMPS 805423541847 FROM OX,0.0,200000.0,,2018,2,23,CHECK_CASHING,200000.0,C220766773
31173,409000362497',2018-02-23,IMPS 805423541856 FROM OX,0.0,200000.0,,2018,2,23,CASH_IN,200000.0,C1847835159
31174,409000362497',2018-02-23,IMPS 805423541864 FROM OX,0.0,200000.0,,2018,2,23,CASH_IN,200000.0,C1359484306
31175,409000362497',2018-02-23,IMPS 805423541869 FROM OX,0.0,200000.0,,2018,2,23,CHECK_CASHING,200000.0,C663202788
31176,409000362497',2018-02-23,IMPS 805423541880 FROM OX,0.0,200000.0,,2018,2,23,CHECK_CASHING,200000.0,C1759482496
31177,409000362497',2018-02-23,IMPS 805423541886 FROM OX,0.0,200000.0,,2018,2,23,CASH_IN,200000.0,C966526472
31178,409000362497',2018-02-23,IMPS 805423541897 FROM OX,0.0,200000.0,,2018,2,23,TRANSFER,200000.0,C1540720037
31179,409000362497',2018-02-23,IMPS 805423541903 FROM OX,0.0,200000.0,,2018,2,23,CASH_IN,200000.0,C1772085663
31180,409000362497',2018-02-23,IMPS 805423541979 FROM OX,0.0,200000.0,,2018,2,23,CHECK_CASHING,200000.0,C1025031603
31181,409000362497',2018-02-23,IMPS 805423541985 FROM OX,0.0,200000.0,,2018,2,23,CASH_IN,200000.0,C1651924497
31182,409000362497',2018-02-23,Sweep Trf To: 40900036427,502969.0,0.0,,2018,2,23,CASH_OUT,502969.0,C2003486581
31183,409000362497',2018-02-26,IMPS 2302181C,5628682.05,0.0,,2018,2,26,PAYEMENT,5628682.05,C939693702
31184,409000362497',2018-02-26,IMPS 2402181C,17434966.95,0.0,,2018,2,26,CASH_OUT,17434966.95,C506046490
31185,409000362497',2018-02-26,IMPS 2502181C,12055408.27,0.0,,2018,2,26,PAYEMENT,12055408.27,C556534527
31186,409000362497',2018-02-26,IMPS 2602182C,2746018.36,0.0,,2018,2,26,DEBIT,2746018.36,C464451704
31187,409000362497',2018-02-26,RTGS/SBINH18057034673/Indfor,0.0,3000000.0,,2018,2,26,CASH_IN,3000000.0,C1167066016
31188,409000362497',2018-02-26,IMPS 260220183C,8189936.53,0.0,,2018,2,26,CHECK_WITHDRAWAL,8189936.53,C848064357
31189,409000362497',2018-02-26,IMPS 805719198199 FROM OX,0.0,200000.0,,2018,2,26,TRANSFER,200000.0,C278738215
31190,409000362497',2018-02-26,IMPS 805719198243 FROM OX,0.0,200000.0,,2018,2,26,CHECK_CASHING,200000.0,C401424608
31191,409000362497',2018-02-26,IMPS 805719198293 FROM OX,0.0,200000.0,,2018,2,26,CHECK_CASHING,200000.0,C2145319283
31192,409000362497',2018-02-26,IMPS 805719198349 FROM OX,0.0,200000.0,,2018,2,26,CASH_IN,200000.0,C1031639563
31193,409000362497',2018-02-26,IMPS 805719198416 FROM OX,0.0,200000.0,,2018,2,26,CASH_IN,200000.0,C155439298
31194,409000362497',2018-02-26,IMPS 805719198462 FROM OX,0.0,200000.0,,2018,2,26,CHECK_CASHING,200000.0,C102537461
31195,409000362497',2018-02-26,IMPS 805719198518 FROM OX,0.0,200000.0,,2018,2,26,CHECK_CASHING,200000.0,C131837504
31196,409000362497',2018-02-26,IMPS 805719198597 FROM OX,0.0,200000.0,,2018,2,26,TRANSFER,200000.0,C500153041
31197,409000362497',2018-02-26,IMPS 805719198642 FROM OX,0.0,200000.0,,2018,2,26,CHECK_CASHING,200000.0,C2018975718
31198,409000362497',2018-02-26,NEFT/SBIN818057996365/Indfor,0.0,6500000.0,,2018,2,26,TRANSFER,6500000.0,C977993101
31199,409000362497',2018-02-26,FDRL/INTERNAL FUND TRANSFE,0.0,15000000.0,,2018,2,26,CASH_IN,15000000.0,C1624533975
31200,409000362497',2018-02-26,FDRL/INTERNAL FUND TRANSFE,0.0,15000000.0,,2018,2,26,TRANSFER,15000000.0,C1833467691
31201,409000362497',2018-02-26,FDRL/INTERNAL FUND TRANSFE,0.0,15000000.0,,2018,2,26,CHECK_CASHING,15000000.0,C1890258988
31202,409000362497',2018-02-26,FDRL/INTERNAL FUND TRANSFE,0.0,3000000.0,,2018,2,26,CASH_IN,3000000.0,C599726537
31203,409000362497',2018-02-26,IMPS 260220184C,4776610.93,0.0,,2018,2,26,CHECK_WITHDRAWAL,4776610.93,C1272615921
31204,409000362497',2018-02-26,Sweep Trf To: 40900036427,840183.0,0.0,,2018,2,26,CHECK_WITHDRAWAL,840183.0,C711850930
31205,409000362497',2018-02-27,NEFT/AXIC180583224885/Indfor,0.0,12000000.0,,2018,2,27,TRANSFER,12000000.0,C1703397679
31206,409000362497',2018-02-27,IMPS 2602181C,5073493.31,0.0,,2018,2,27,DEBIT,5073493.31,C483817115
31207,409000362497',2018-02-27,IMPS 270218 2C,2936589.59,0.0,,2018,2,27,CASH_OUT,2936589.59,C207471579
31208,409000362497',2018-02-27,BIGTREE ENTERTAINMENT PRI,13845.0,0.0,,2018,2,27,CHECK_WITHDRAWAL,13845.0,C1245522769
31209,409000362497',2018-02-27,INDIAIDEAS.COM LTD,170606.0,0.0,,2018,2,27,PAYEMENT,170606.0,C875761527
31210,409000362497',2018-02-27,IRCTC CORPORATE OFFICE AC,322130.0,0.0,,2018,2,27,PAYEMENT,322130.0,C1503386238
31211,409000362497',2018-02-27,PAYU PAYMENTS PRIVATE LIM,39799.0,0.0,,2018,2,27,PAYEMENT,39799.0,C320737482
31212,409000362497',2018-02-27,MATRIX CELLULAR (INTERNAT,388.0,0.0,,2018,2,27,DEBIT,388.0,C1696218625
31213,409000362497',2018-02-27,AVENUES INDIA PRIVATE LIM,42319.0,0.0,,2018,2,27,CHECK_WITHDRAWAL,42319.0,C1839337592
31214,409000362497',2018-02-27,SYNERGISTIC FINANCIAL NET,1214.0,0.0,,2018,2,27,PAYEMENT,1214.0,C1935365522
31215,409000362497',2018-02-27,ZAAK EPAYMENT SERVICES PR,1122.0,0.0,,2018,2,27,CASH_OUT,1122.0,C796028148
31216,409000362497',2018-02-27,FUTURE RETAIL LIMITED (OW,15384.0,0.0,,2018,2,27,PAYEMENT,15384.0,C1994035663
31217,409000362497',2018-02-27,METRO INFRASYS PRIVATE LI,1346.0,0.0,,2018,2,27,CASH_OUT,1346.0,C1247658278
31218,409000362497',2018-02-27,PASFAR TECHNOLOGIES PRIVA,21694.0,0.0,,2018,2,27,DEBIT,21694.0,C824197891
31219,409000362497',2018-02-27,DISH INFRA SERVICES PRIVA,4565.0,0.0,,2018,2,27,DEBIT,4565.0,C1346667529
31220,409000362497',2018-02-27,JUST DIAL LIMITED,40.0,0.0,,2018,2,27,DEBIT,40.0,C186847111
31221,409000362497',2018-02-27,MEHAR ENTERTAINMENT PRIVA,19817.0,0.0,,2018,2,27,CASH_OUT,19817.0,C1157297801
31222,409000362497',2018-02-27,E-BILLING SOLUTIONS PRIVA,600.0,0.0,,2018,2,27,CHECK_WITHDRAWAL,600.0,C1930040331
31223,409000362497',2018-02-27,ALT DIGITAL MEDIA ENTERTA,196.0,0.0,,2018,2,27,PAYEMENT,196.0,C824781215
31224,409000362497',2018-02-27,Indiaforensic SERVICES INDIA PVT,2436199.0,0.0,,2018,2,27,CASH_OUT,2436199.0,C118648358
31225,409000362497',2018-02-27,IMPS 270220183C,7672135.29,0.0,,2018,2,27,CHECK_WITHDRAWAL,7672135.29,C1838584624
31226,409000362497',2018-02-27,FDRL/INTERNAL FUND TRANSFE,0.0,8000000.0,,2018,2,27,TRANSFER,8000000.0,C2073764942
31227,409000362497',2018-02-27,FDRL/INTERNAL FUND TRANSFE,0.0,8000000.0,,2018,2,27,CASH_IN,8000000.0,C1672788422
31228,409000362497',2018-02-27,NEFT/SBIN118058145633/Indfor,0.0,5000000.0,,2018,2,27,TRANSFER,5000000.0,C2013854563
31229,409000362497',2018-02-27,IMPS 2702184C,5218675.08,0.0,,2018,2,27,CASH_OUT,5218675.08,C2095032356
31230,409000362497',2018-02-27,Sweep Trf To: 40900036427,754932.0,0.0,,2018,2,27,PAYEMENT,754932.0,C1682576062
31231,409000362497',2018-02-28,IMPS 2702181C,6234701.8,0.0,,2018,2,28,CHECK_WITHDRAWAL,6234701.8,C275925618
31232,409000362497',2018-02-28,IMPS 280218 2C,3103230.99,0.0,,2018,2,28,DEBIT,3103230.99,C294900736
31233,409000362497',2018-02-28,INDIAIDEAS.COM LTD,66776.0,0.0,,2018,2,28,PAYEMENT,66776.0,M451640058
31234,409000362497',2018-02-28,IRCTC CORPORATE OFFICE AC,84390.0,0.0,,2018,2,28,DEBIT,84390.0,M1380794224
31235,409000362497',2018-02-28,PAYU PAYMENTS PRIVATE LIM,11868.0,0.0,,2018,2,28,PAYEMENT,11868.0,M1211333787
31236,409000362497',2018-02-28,AVENUES INDIA PRIVATE LIM,14047.0,0.0,,2018,2,28,CASH_OUT,14047.0,C904383922
31237,409000362497',2018-02-28,ZAAK EPAYMENT SERVICES PR,1324.0,0.0,,2018,2,28,CHECK_WITHDRAWAL,1324.0,M1562316969
31238,409000362497',2018-02-28,FUTURE RETAIL LIMITED (OW,8313.0,0.0,,2018,2,28,CASH_OUT,8313.0,M2033266940
31239,409000362497',2018-02-28,PASFAR TECHNOLOGIES PRIVA,6120.0,0.0,,2018,2,28,PAYEMENT,6120.0,M2016177753
31240,409000362497',2018-02-28,DISH INFRA SERVICES PRIVA,322.0,0.0,,2018,2,28,DEBIT,322.0,C1223591088
31241,409000362497',2018-02-28,JUST DIAL LIMITED,1610.0,0.0,,2018,2,28,DEBIT,1610.0,M487481184
31242,409000362497',2018-02-28,MEHAR ENTERTAINMENT PRIVA,6222.0,0.0,,2018,2,28,CASH_OUT,6222.0,C1636050357
31243,409000362497',2018-02-28,E-BILLING SOLUTIONS PRIVA,600.0,0.0,,2018,2,28,CASH_OUT,600.0,C899625985
31244,409000362497',2018-02-28,Indiaforensic SERVICES INDIA PVT,773169.0,0.0,,2018,2,28,CASH_OUT,773169.0,M709388633
31245,409000362497',2018-02-28,IMPS 280220183C,7232958.11,0.0,,2018,2,28,PAYEMENT,7232958.11,C1740509828
31246,409000362497',2018-02-28,IMPS 280220184C,5754156.1,0.0,,2018,2,28,CASH_OUT,5754156.1,M761380249
31247,409000362497',2018-02-28,Sweep Trf To: 40900036427,478854.0,0.0,,2018,2,28,DEBIT,478854.0,M2069855028
31248,409000362497',2018-02-28,409000362497:Int.Coll:01-,1097.34,0.0,,2018,2,28,PAYEMENT,1097.34,C1722141669
31249,409000362497',2018-03-01,FDRL/INTERNAL FUND TRANSFE,0.0,1000000.0,,2018,3,1,CASH_IN,1000000.0,C1046102247
31250,409000362497',2018-03-01,FDRL/INTERNAL FUND TRANSFE,0.0,1000000.0,,2018,3,1,TRANSFER,1000000.0,M1169007798
31251,409000362497',2018-03-01,BIGTREE ENTERTAINMENT PRI,1619.0,0.0,,2018,3,1,PAYEMENT,1619.0,C87923441
31252,409000362497',2018-03-01,INDIAIDEAS.COM LTD,62065.0,0.0,,2018,3,1,DEBIT,62065.0,C769298867
31253,409000362497',2018-03-01,IRCTC CORPORATE OFFICE AC,109775.0,0.0,,2018,3,1,CASH_OUT,109775.0,C508000580
31254,409000362497',2018-03-01,PAYU PAYMENTS PRIVATE LIM,32669.0,0.0,,2018,3,1,CHECK_WITHDRAWAL,32669.0,M1333842413
31255,409000362497',2018-03-01,AVENUES INDIA PRIVATE LIM,13922.0,0.0,,2018,3,1,CHECK_WITHDRAWAL,13922.0,C2088652549
31256,409000362497',2018-03-01,ZAAK EPAYMENT SERVICES PR,815.0,0.0,,2018,3,1,DEBIT,815.0,C281656657
31257,409000362497',2018-03-01,FUTURE RETAIL LIMITED (OW,4444.0,0.0,,2018,3,1,PAYEMENT,4444.0,M1804502419
31258,409000362497',2018-03-01,PASFAR TECHNOLOGIES PRIVA,4113.0,0.0,,2018,3,1,CASH_OUT,4113.0,M1328855072
31259,409000362497',2018-03-01,DISH INFRA SERVICES PRIVA,488.0,0.0,,2018,3,1,CASH_OUT,488.0,M866039829
31260,409000362497',2018-03-01,JUST DIAL LIMITED,50.0,0.0,,2018,3,1,CHECK_WITHDRAWAL,50.0,M528044602
31261,409000362497',2018-03-01,MEHAR ENTERTAINMENT PRIVA,8295.0,0.0,,2018,3,1,CASH_OUT,8295.0,M1843844058
31262,409000362497',2018-03-01,E-BILLING SOLUTIONS PRIVA,1596.0,0.0,,2018,3,1,CASH_OUT,1596.0,C1234059684
31263,409000362497',2018-03-01,VOUCHER ACTIVATION SERVIC,45591.0,0.0,,2018,3,1,PAYEMENT,45591.0,M580129342
31264,409000362497',2018-03-01,QWIKCILVER SOLUTIONS PRIV,35646.0,0.0,,2018,3,1,PAYEMENT,35646.0,C180183079
31265,409000362497',2018-03-01,Indiaforensic SERVICES INDIA PVT,874349.0,0.0,,2018,3,1,CHECK_WITHDRAWAL,874349.0,M1195987491
31266,409000362497',2018-03-01,IMPS 2802181C,4994560.06,0.0,,2018,3,1,DEBIT,4994560.06,C1178471274
31267,409000362497',2018-03-01,IMPS 010318 2C,1028241.62,0.0,,2018,3,1,CASH_OUT,1028241.62,C381390837
31268,409000362497',2018-03-01,IMPS 010318 3C,1686952.72,0.0,,2018,3,1,PAYEMENT,1686952.72,M350047560
31269,409000362497',2018-03-01,BIGTREE ENTERTAINMENT PRI,1015.0,0.0,,2018,3,1,CHECK_WITHDRAWAL,1015.0,M318579276
31270,409000362497',2018-03-01,INDIAIDEAS.COM LTD,49192.0,0.0,,2018,3,1,PAYEMENT,49192.0,C341552838
31271,409000362497',2018-03-01,IRCTC CORPORATE OFFICE AC,64355.0,0.0,,2018,3,1,CHECK_WITHDRAWAL,64355.0,M1276209343
31272,409000362497',2018-03-01,PAYU PAYMENTS PRIVATE LIM,35494.0,0.0,,2018,3,1,DEBIT,35494.0,C451433836
31273,409000362497',2018-03-01,AVENUES INDIA PRIVATE LIM,11743.0,0.0,,2018,3,1,PAYEMENT,11743.0,M73452082
31274,409000362497',2018-03-01,PAYGATE INDIA PRIVATE LIM,20.0,0.0,,2018,3,1,CHECK_WITHDRAWAL,20.0,M1510876808
31275,409000362497',2018-03-01,FUTURE RETAIL LIMITED (OW,7087.0,0.0,,2018,3,1,CASH_OUT,7087.0,C810576909
31276,409000362497',2018-03-01,METRO INFRASYS PRIVATE LI,673.0,0.0,,2018,3,1,DEBIT,673.0,M734661326
31277,409000362497',2018-03-01,PASFAR TECHNOLOGIES PRIVA,5371.0,0.0,,2018,3,1,DEBIT,5371.0,C1777285191
31278,409000362497',2018-03-01,HUNGAMA DIGITAL MEDIA ENT,97.0,0.0,,2018,3,1,PAYEMENT,97.0,C1286885448
31279,409000362497',2018-03-01,DISH INFRA SERVICES PRIVA,83.0,0.0,,2018,3,1,CHECK_WITHDRAWAL,83.0,C1161865950
31280,409000362497',2018-03-01,JUST DIAL LIMITED,501.0,0.0,,2018,3,1,CASH_OUT,501.0,M950330453
31281,409000362497',2018-03-01,MEHAR ENTERTAINMENT PRIVA,9448.0,0.0,,2018,3,1,DEBIT,9448.0,M529173643
31282,409000362497',2018-03-01,E-BILLING SOLUTIONS PRIVA,254.0,0.0,,2018,3,1,DEBIT,254.0,C284399568
31283,409000362497',2018-03-01,Indiaforensic SERVICES INDIA PVT,759352.0,0.0,,2018,3,1,PAYEMENT,759352.0,M1638110398
31284,409000362497',2018-03-01,FDRL/INTERNAL FUND TRANSFE,0.0,7000000.0,,2018,3,1,CHECK_CASHING,7000000.0,C1766597604
31285,409000362497',2018-03-01,FDRL/INTERNAL FUND TRANSFE,0.0,10000000.0,,2018,3,1,CHECK_CASHING,10000000.0,C75457651
31286,409000362497',2018-03-01,NEFT/SBIN418060788010/Indfor,0.0,3000000.0,,2018,3,1,TRANSFER,3000000.0,C505855829
31287,409000362497',2018-03-01,IMPS 010320184C,2638710.37,0.0,,2018,3,1,CASH_OUT,2638710.37,C1298177219
31288,409000362497',2018-03-01,Sweep Trf To: 40900036427,125559.0,0.0,,2018,3,1,CHECK_WITHDRAWAL,125559.0,M72821267
31289,409000362497',2018-03-02,IMPS 0103181C,1963726.07,0.0,,2018,3,2,CASH_OUT,1963726.07,M577178676
31290,409000362497',2018-03-02,IMPS 020318 2C,797404.83,0.0,,2018,3,2,CHECK_WITHDRAWAL,797404.83,C414409410
31291,409000362497',2018-03-02,IMPS 020318 3C,1087717.55,0.0,,2018,3,2,PAYEMENT,1087717.55,C130777353
31292,409000362497',2018-03-02,IMPS 020320184C,953292.1,0.0,,2018,3,2,CASH_OUT,953292.1,C551545010
31293,409000362497',2018-03-02,Sweep Trf To: 40900036427,16701.0,0.0,,2018,3,2,CHECK_WITHDRAWAL,16701.0,C1014923261
31294,409000362497',2018-03-03,IMPS 0203181C,939954.5,0.0,,2018,3,3,DEBIT,939954.5,C2036368507
31295,409000362497',2018-03-03,IMPS 030318 2C,1073877.74,0.0,,2018,3,3,DEBIT,1073877.74,C194988831
31296,409000362497',2018-03-03,IMPS 030318 3C,2559107.52,0.0,,2018,3,3,PAYEMENT,2559107.52,C803116137
31297,409000362497',2018-03-03,FDRL/INTERNAL FUND TRANSFE,0.0,10000000.0,,2018,3,3,CHECK_CASHING,10000000.0,C1852790850
31298,409000362497',2018-03-03,NEFT/SBIN618062156452/Indfor,0.0,4000000.0,,2018,3,3,TRANSFER,4000000.0,C1238707698
31299,409000362497',2018-03-03,IMPS 030320184C,1975358.44,0.0,,2018,3,3,CHECK_WITHDRAWAL,1975358.44,C1866827563
31300,409000362497',2018-03-03,Sweep Trf To: 40900036427,87695.0,0.0,,2018,3,3,DEBIT,87695.0,C204540579
31301,409000362497',2018-03-05,IMPS 0302181C,2077254.05,0.0,,2018,3,5,CHECK_WITHDRAWAL,2077254.05,C521284795
31302,409000362497',2018-03-05,IMPS 040318 1C,7266274.19,0.0,,2018,3,5,CHECK_WITHDRAWAL,7266274.19,C1856885570
31303,409000362497',2018-03-05,IMPS 050318 2C,2270936.57,0.0,,2018,3,5,CASH_OUT,2270936.57,C1723463463
31304,409000362497',2018-03-05,BIGTREE ENTERTAINMENT PRI,8887.0,0.0,,2018,3,5,PAYEMENT,8887.0,C1515704208
31305,409000362497',2018-03-05,INDIAIDEAS.COM LTD,93855.0,0.0,,2018,3,5,DEBIT,93855.0,C50060430
31306,409000362497',2018-03-05,IRCTC CORPORATE OFFICE AC,239925.0,0.0,,2018,3,5,CHECK_WITHDRAWAL,239925.0,C1848415041
31307,409000362497',2018-03-05,PAYU PAYMENTS PRIVATE LIM,22732.0,0.0,,2018,3,5,CHECK_WITHDRAWAL,22732.0,C346546542
31308,409000362497',2018-03-05,AVENUES INDIA PRIVATE LIM,53220.0,0.0,,2018,3,5,DEBIT,53220.0,C599968109
31309,409000362497',2018-03-05,FUTURE RETAIL LIMITED (OW,10594.0,0.0,,2018,3,5,CHECK_WITHDRAWAL,10594.0,C145693769
31310,409000362497',2018-03-05,PASFAR TECHNOLOGIES PRIVA,3806.0,0.0,,2018,3,5,DEBIT,3806.0,C1632268814
31311,409000362497',2018-03-05,JUST DIAL LIMITED,7835.0,0.0,,2018,3,5,DEBIT,7835.0,C801142660
31312,409000362497',2018-03-05,MEHAR ENTERTAINMENT PRIVA,14056.0,0.0,,2018,3,5,DEBIT,14056.0,C1197606915
31313,409000362497',2018-03-05,E-BILLING SOLUTIONS PRIVA,1948.0,0.0,,2018,3,5,CHECK_WITHDRAWAL,1948.0,C1570256460
31314,409000362497',2018-03-05,Indiaforensic SERVICES INDIA PVT,761185.0,0.0,,2018,3,5,PAYEMENT,761185.0,C1656107232
31315,409000362497',2018-03-05,IMPS 050318 3C,3700228.26,0.0,,2018,3,5,DEBIT,3700228.26,C1066166621
31316,409000362497',2018-03-05,FDRL/INTERNAL FUND TRANSFE,0.0,15000000.0,,2018,3,5,CASH_IN,15000000.0,C1669259232
31317,409000362497',2018-03-05,IMPS 050318 4C,3276975.32,0.0,,2018,3,5,CHECK_WITHDRAWAL,3276975.32,C2057394816
31318,409000362497',2018-03-05,Sweep Trf To: 40900036427,143659.0,0.0,,2018,3,5,CHECK_WITHDRAWAL,143659.0,C58333888
31319,409000362497',2018-03-06,IMPS 0503181C,3309247.89,0.0,,2018,3,6,CHECK_WITHDRAWAL,3309247.89,C1698593276
31320,409000362497',2018-03-06,IMPS 060318 2C,2050284.12,0.0,,2018,3,6,PAYEMENT,2050284.12,C966704622
31321,409000362497',2018-03-06,INDIAIDEAS.COM LTD,62655.0,0.0,,2018,3,6,CHECK_WITHDRAWAL,62655.0,C508000580
31322,409000362497',2018-03-06,IRCTC CORPORATE OFFICE AC,87915.0,0.0,,2018,3,6,CASH_OUT,87915.0,C1380361139
31323,409000362497',2018-03-06,PAYU PAYMENTS PRIVATE LIM,6658.0,0.0,,2018,3,6,DEBIT,6658.0,C1700355047
31324,409000362497',2018-03-06,AVENUES INDIA PRIVATE LIM,11650.0,0.0,,2018,3,6,PAYEMENT,11650.0,C756475678
31325,409000362497',2018-03-06,FUTURE RETAIL LIMITED (OW,799.0,0.0,,2018,3,6,PAYEMENT,799.0,C917768476
31326,409000362497',2018-03-06,METRO INFRASYS PRIVATE LI,673.0,0.0,,2018,3,6,CASH_OUT,673.0,C1096283470
31327,409000362497',2018-03-06,PASFAR TECHNOLOGIES PRIVA,2534.0,0.0,,2018,3,6,CASH_OUT,2534.0,C1892922524
31328,409000362497',2018-03-06,MEHAR ENTERTAINMENT PRIVA,807.0,0.0,,2018,3,6,PAYEMENT,807.0,C1922859107
31329,409000362497',2018-03-06,Indiaforensic SERVICES INDIA PVT,208791.31,0.0,,2018,3,6,PAYEMENT,208791.31,C1195378184
31330,409000362497',2018-03-06,BIGTREE ENTERTAINMENT PRI,903.0,0.0,,2018,3,6,PAYEMENT,903.0,C1325626015
31331,409000362497',2018-03-06,FDRL/INTERNAL FUND TRANSFE,0.0,5000000.0,,2018,3,6,TRANSFER,5000000.0,C208427878
31332,409000362497',2018-03-06,IMPS 060318 3C,3464842.4,0.0,,2018,3,6,PAYEMENT,3464842.4,C1894207825
31333,409000362497',2018-03-06,IMPS 0603184C,2839240.42,0.0,,2018,3,6,CHECK_WITHDRAWAL,2839240.42,C1240730624
31334,409000362497',2018-03-06,Sweep Trf To: 40900036427,231607.0,0.0,,2018,3,6,DEBIT,231607.0,C1643855278
31335,409000362497',2018-03-07,IMPS 0603181C,2912302.84,0.0,,2018,3,7,DEBIT,2912302.84,C858007309
31336,409000362497',2018-03-07,IMPS 070318 2C,2186248.17,0.0,,2018,3,7,CASH_OUT,2186248.17,C1947645280
31337,409000362497',2018-03-07,RTGS/YESBH18066919117/IRC,0.0,274950.0,,2018,3,7,TRANSFER,274950.0,C728885526
31338,409000362497',2018-03-07,BIGTREE ENTERTAINMENT PRI,105.0,0.0,,2018,3,7,CASH_OUT,105.0,C1937962514
31339,409000362497',2018-03-07,INDIAIDEAS.COM LTD,74814.0,0.0,,2018,3,7,DEBIT,74814.0,C440082302
31340,409000362497',2018-03-07,IRCTC CORPORATE OFFICE AC,85610.0,0.0,,2018,3,7,CHECK_WITHDRAWAL,85610.0,C940159462
31341,409000362497',2018-03-07,PAYU PAYMENTS PRIVATE LIM,19328.0,0.0,,2018,3,7,PAYEMENT,19328.0,C418978254
31342,409000362497',2018-03-07,AVENUES INDIA PRIVATE LIM,4639.0,0.0,,2018,3,7,PAYEMENT,4639.0,C1530856786
31343,409000362497',2018-03-07,FUTURE RETAIL LIMITED (OW,324.0,0.0,,2018,3,7,CASH_OUT,324.0,C341552838
31344,409000362497',2018-03-07,PASFAR TECHNOLOGIES PRIVA,9796.0,0.0,,2018,3,7,DEBIT,9796.0,C1297685781
31345,409000362497',2018-03-07,MEHAR ENTERTAINMENT PRIVA,4493.0,0.0,,2018,3,7,PAYEMENT,4493.0,C1761324386
31346,409000362497',2018-03-07,E-BILLING SOLUTIONS PRIVA,1599.0,0.0,,2018,3,7,PAYEMENT,1599.0,C341156724
31347,409000362497',2018-03-07,VOUCHER ACTIVATION SERVIC,16028.0,0.0,,2018,3,7,CASH_OUT,16028.0,C1195378184
31348,409000362497',2018-03-07,VOUCHER ACTIVATION SERVIC,10498.0,0.0,,2018,3,7,PAYEMENT,10498.0,C1234776885
31349,409000362497',2018-03-07,QWIKCILVER SOLUTIONS PRIV,11913.0,0.0,,2018,3,7,CHECK_WITHDRAWAL,11913.0,C1218365329
31350,409000362497',2018-03-07,QWIKCILVER SOLUTIONS PRIV,6258.0,0.0,,2018,3,7,DEBIT,6258.0,C59941009
31351,409000362497',2018-03-07,Indiaforensic SERVICES INDIA PVT,189628.0,0.0,,2018,3,7,PAYEMENT,189628.0,C624685600
31352,409000362497',2018-03-07,IMPS 070318 3C,3609144.75,0.0,,2018,3,7,PAYEMENT,3609144.75,C2029310301
31353,409000362497',2018-03-07,IMPS 070318 4C,2398865.29,0.0,,2018,3,7,PAYEMENT,2398865.29,C1255024717
31354,409000362497',2018-03-07,Sweep Trf To: 40900036427,251780.0,0.0,,2018,3,7,PAYEMENT,251780.0,C563780374
31355,409000362497',2018-03-08,IMPS 0703181C,2820449.1,0.0,,2018,3,8,PAYEMENT,2820449.1,C1050406642
31356,409000362497',2018-03-08,IMPS 080318 2C,1481193.49,0.0,,2018,3,8,CASH_OUT,1481193.49,C1379289710
31357,409000362497',2018-03-08,IRCTC CORPORATE OFFICE AC,98730.0,0.0,,2018,3,8,CASH_OUT,98730.0,M26113294
31358,409000362497',2018-03-08,PAYU PAYMENTS PRIVATE LIM,17685.0,0.0,,2018,3,8,DEBIT,17685.0,C992713622
31359,409000362497',2018-03-08,AVENUES INDIA PRIVATE LIM,8048.0,0.0,,2018,3,8,PAYEMENT,8048.0,C1455826282
31360,409000362497',2018-03-08,FUTURE RETAIL LIMITED (OW,4200.0,0.0,,2018,3,8,CHECK_WITHDRAWAL,4200.0,C666410506
31361,409000362497',2018-03-08,PASFAR TECHNOLOGIES PRIVA,1199.0,0.0,,2018,3,8,CHECK_WITHDRAWAL,1199.0,C699026377
31362,409000362497',2018-03-08,MEHAR ENTERTAINMENT PRIVA,2189.0,0.0,,2018,3,8,PAYEMENT,2189.0,M375564671
31363,409000362497',2018-03-08,Indiaforensic SERVICES INDIA PVT,273268.0,0.0,,2018,3,8,DEBIT,273268.0,M1168204097
31364,409000362497',2018-03-08,IMPS 080320183C,3503744.84,0.0,,2018,3,8,CASH_OUT,3503744.84,M1357787394
31365,409000362497',2018-03-08,IMPS 080320184C,2913189.1,0.0,,2018,3,8,PAYEMENT,2913189.1,M281674183
31366,409000362497',2018-03-08,NEFT/SBIN118067388450/Indfor,0.0,3700000.0,,2018,3,8,CHECK_CASHING,3700000.0,M1084421494
31367,409000362497',2018-03-08,FDRL/INTERNAL FUND TRANSFE,0.0,5000000.0,,2018,3,8,TRANSFER,5000000.0,C1406026215
31368,409000362497',2018-03-08,FDRL/INTERNAL FUND TRANSFE,0.0,5000000.0,,2018,3,8,CASH_IN,5000000.0,C339924917
31369,409000362497',2018-03-08,Sweep Trf To: 40900036427,203974.0,0.0,,2018,3,8,CASH_OUT,203974.0,C54469808
31370,409000362497',2018-03-09,IMPS 0803181C,3024723.67,0.0,,2018,3,9,DEBIT,3024723.67,C1076835071
31371,409000362497',2018-03-09,IMPS 090318 2C,958763.91,0.0,,2018,3,9,DEBIT,958763.91,M1551940888
31372,409000362497',2018-03-09,BIGTREE ENTERTAINMENT PRI,730.0,0.0,,2018,3,9,PAYEMENT,730.0,C1292435170
31373,409000362497',2018-03-09,INDIAIDEAS.COM LTD,73488.0,0.0,,2018,3,9,DEBIT,73488.0,C1315942706
31374,409000362497',2018-03-09,IRCTC CORPORATE OFFICE AC,68540.0,0.0,,2018,3,9,DEBIT,68540.0,C372017580
31375,409000362497',2018-03-09,PAYU PAYMENTS PRIVATE LIM,17012.0,0.0,,2018,3,9,CASH_OUT,17012.0,C1697002056
31376,409000362497',2018-03-09,AVENUES INDIA PRIVATE LIM,4001.0,0.0,,2018,3,9,CASH_OUT,4001.0,M1526215930
31377,409000362497',2018-03-09,FUTURE RETAIL LIMITED (OW,927.0,0.0,,2018,3,9,CASH_OUT,927.0,C1627965794
31378,409000362497',2018-03-09,PASFAR TECHNOLOGIES PRIVA,8381.0,0.0,,2018,3,9,DEBIT,8381.0,C1545121117
31379,409000362497',2018-03-09,MEHAR ENTERTAINMENT PRIVA,1843.0,0.0,,2018,3,9,CASH_OUT,1843.0,C1433627902
31380,409000362497',2018-03-09,E-BILLING SOLUTIONS PRIVA,2400.0,0.0,,2018,3,9,PAYEMENT,2400.0,C388910394
31381,409000362497',2018-03-09,Indiaforensic SERVICES INDIA PVT,211644.0,0.0,,2018,3,9,DEBIT,211644.0,C91463800
31382,409000362497',2018-03-09,NEFT/SBIN218068484327/Indfor,0.0,5000000.0,,2018,3,9,CHECK_CASHING,5000000.0,C1404112538
31383,409000362497',2018-03-09,FDRL/INTERNAL FUND TRANSFE,0.0,5000000.0,,2018,3,9,CASH_IN,5000000.0,C665576141
31384,409000362497',2018-03-09,IMPS 0903183C,1994554.24,0.0,,2018,3,9,PAYEMENT,1994554.24,C998255530
31385,409000362497',2018-03-09,IMPS 090318 4C,2091939.67,0.0,,2018,3,9,PAYEMENT,2091939.67,C1804883318
31386,409000362497',2018-03-09,Sweep Trf To: 40900036427,221061.0,0.0,,2018,3,9,CASH_OUT,221061.0,C360898540
31387,409000362497',2018-03-12,IMPS 0903181C,2452285.41,0.0,,2018,3,12,DEBIT,2452285.41,C1495761010
31388,409000362497',2018-03-12,IMPS 080318 2C,9643493.02,0.0,,2018,3,12,PAYEMENT,9643493.02,C1671386208
31389,409000362497',2018-03-12,IMPS 1103181C,6216084.56,0.0,,2018,3,12,PAYEMENT,6216084.56,C8290162
31390,409000362497',2018-03-12,IMPS 1203182C,2143694.56,0.0,,2018,3,12,PAYEMENT,2143694.56,C635281078
31391,409000362497',2018-03-12,FDRL/INTERNAL FUND TRANSFE,0.0,15000000.0,,2018,3,12,CASH_IN,15000000.0,C1535481925
31392,409000362497',2018-03-12,NEFT/SBIN318071927189/Indfor,0.0,3000000.0,,2018,3,12,TRANSFER,3000000.0,C1201057368
31393,409000362497',2018-03-12,IMPS 120318 3C,4508913.46,0.0,,2018,3,12,PAYEMENT,4508913.46,C1440282299
31394,409000362497',2018-03-12,IMPS 1203184C,2504859.82,0.0,,2018,3,12,DEBIT,2504859.82,C1657769946
31395,409000362497',2018-03-12,Sweep Trf To: 40900036427,573799.0,0.0,,2018,3,12,CHECK_WITHDRAWAL,573799.0,C1204684191
31396,409000362497',2018-03-13,BIGTREE ENTERTAINMENT PRI,3324.0,0.0,,2018,3,13,CHECK_WITHDRAWAL,3324.0,M1131570905
31397,409000362497',2018-03-13,INDIAIDEAS.COM LTD,64739.0,0.0,,2018,3,13,DEBIT,64739.0,C1195378184
31398,409000362497',2018-03-13,IRCTC CORPORATE OFFICE AC,149005.0,0.0,,2018,3,13,DEBIT,149005.0,M127096392
31399,409000362497',2018-03-13,PAYU PAYMENTS PRIVATE LIM,48254.0,0.0,,2018,3,13,CHECK_WITHDRAWAL,48254.0,C106196025
31400,409000362497',2018-03-13,AVENUES INDIA PRIVATE LIM,15255.0,0.0,,2018,3,13,CHECK_WITHDRAWAL,15255.0,C2029406675
31401,409000362497',2018-03-13,FUTURE RETAIL LIMITED (OW,4184.0,0.0,,2018,3,13,CASH_OUT,4184.0,M52790751
31402,409000362497',2018-03-13,METRO INFRASYS PRIVATE LI,673.0,0.0,,2018,3,13,DEBIT,673.0,C1531514206
31403,409000362497',2018-03-13,PASFAR TECHNOLOGIES PRIVA,8901.0,0.0,,2018,3,13,DEBIT,8901.0,C1200612373
31404,409000362497',2018-03-13,JUST DIAL LIMITED,2302.0,0.0,,2018,3,13,DEBIT,2302.0,C1435804085
31405,409000362497',2018-03-13,MEHAR ENTERTAINMENT PRIVA,5991.0,0.0,,2018,3,13,CASH_OUT,5991.0,C346008447
31406,409000362497',2018-03-13,E-BILLING SOLUTIONS PRIVA,4157.0,0.0,,2018,3,13,PAYEMENT,4157.0,C1518728219
31407,409000362497',2018-03-13,ALT DIGITAL MEDIA ENTERTA,98.0,0.0,,2018,3,13,PAYEMENT,98.0,C1459757869
31408,409000362497',2018-03-13,Indiaforensic SERVICES INDIA PVT,453230.0,0.0,,2018,3,13,CHECK_WITHDRAWAL,453230.0,C935808590
31409,409000362497',2018-03-13,IMPS 1203181C,2292920.28,0.0,,2018,3,13,PAYEMENT,2292920.28,C830831744
31410,409000362497',2018-03-13,IMPS 130318 2C,1177227.16,0.0,,2018,3,13,CASH_OUT,1177227.16,C1257704323
31411,409000362497',2018-03-13,BIGTREE ENTERTAINMENT PRI,35700.0,0.0,,2018,3,13,PAYEMENT,35700.0,C1669259232
31412,409000362497',2018-03-13,IRCTC CORPORATE OFFICE AC,66190.0,0.0,,2018,3,13,CASH_OUT,66190.0,C2141459588
31413,409000362497',2018-03-13,PAYU PAYMENTS PRIVATE LIM,11573.0,0.0,,2018,3,13,CHECK_WITHDRAWAL,11573.0,C426416592
31414,409000362497',2018-03-13,AVENUES INDIA PRIVATE LIM,8239.0,0.0,,2018,3,13,CASH_OUT,8239.0,C578102596
31415,409000362497',2018-03-13,SYNERGISTIC FINANCIAL NET,45.0,0.0,,2018,3,13,PAYEMENT,45.0,C1583408697
31416,409000362497',2018-03-13,FUTURE RETAIL LIMITED (OW,285.0,0.0,,2018,3,13,PAYEMENT,285.0,C2109470512
31417,409000362497',2018-03-13,PASFAR TECHNOLOGIES PRIVA,5549.0,0.0,,2018,3,13,PAYEMENT,5549.0,C1768641212
31418,409000362497',2018-03-13,JUST DIAL LIMITED,486.0,0.0,,2018,3,13,DEBIT,486.0,C497806226
31419,409000362497',2018-03-13,MEHAR ENTERTAINMENT PRIVA,2996.0,0.0,,2018,3,13,CASH_OUT,2996.0,C1564931235
31420,409000362497',2018-03-13,E-BILLING SOLUTIONS PRIVA,5856.0,0.0,,2018,3,13,DEBIT,5856.0,C2065199032
31421,409000362497',2018-03-13,Indiaforensic SERVICES INDIA PVT,241574.0,0.0,,2018,3,13,PAYEMENT,241574.0,C766671686
31422,409000362497',2018-03-13,NEFT/AXIC180728308075/Indfor,0.0,10000000.0,,2018,3,13,CHECK_CASHING,10000000.0,C2007149130
31423,409000362497',2018-03-13,NEFT/SBIN418072917327/Indfor,0.0,2500000.0,,2018,3,13,CHECK_CASHING,2500000.0,C904672772
31424,409000362497',2018-03-13,FDRL/INTERNAL FUND TRANSFE,0.0,5000000.0,,2018,3,13,CASH_IN,5000000.0,M1850526815
31425,409000362497',2018-03-13,IMPS 130318 3C,5252249.2,0.0,,2018,3,13,DEBIT,5252249.2,M685005872
31426,409000362497',2018-03-13,IMPS 130318 4C,3145840.17,0.0,,2018,3,13,DEBIT,3145840.17,M1952612086
31427,409000362497',2018-03-13,Sweep Trf To: 40900036427,483655.0,0.0,,2018,3,13,PAYEMENT,483655.0,M584341178
31428,409000362497',2018-03-14,IMPS 1303181C,3400797.04,0.0,,2018,3,14,CHECK_WITHDRAWAL,3400797.04,M451238316
31429,409000362497',2018-03-14,IMPS 140318 2C,1615122.96,0.0,,2018,3,14,CHECK_WITHDRAWAL,1615122.96,C403254166
31430,409000362497',2018-03-14,BIGTREE ENTERTAINMENT PRI,182.0,0.0,,2018,3,14,CASH_OUT,182.0,C54469808
31431,409000362497',2018-03-14,IRCTC CORPORATE OFFICE AC,68850.0,0.0,,2018,3,14,CHECK_WITHDRAWAL,68850.0,C1983025922
31432,409000362497',2018-03-14,PAYU PAYMENTS PRIVATE LIM,15088.0,0.0,,2018,3,14,DEBIT,15088.0,C1407083386
31433,409000362497',2018-03-14,AVENUES INDIA PRIVATE LIM,8052.0,0.0,,2018,3,14,CHECK_WITHDRAWAL,8052.0,M357806130
31434,409000362497',2018-03-14,FUTURE RETAIL LIMITED (OW,33.0,0.0,,2018,3,14,PAYEMENT,33.0,C12793273
31435,409000362497',2018-03-14,PASFAR TECHNOLOGIES PRIVA,1469.0,0.0,,2018,3,14,PAYEMENT,1469.0,C1018394275
31436,409000362497',2018-03-14,JUST DIAL LIMITED,392.0,0.0,,2018,3,14,CASH_OUT,392.0,C727209127
31437,409000362497',2018-03-14,MEHAR ENTERTAINMENT PRIVA,807.0,0.0,,2018,3,14,DEBIT,807.0,C362966988
31438,409000362497',2018-03-14,E-BILLING SOLUTIONS PRIVA,6197.0,0.0,,2018,3,14,DEBIT,6197.0,C1900380282
31439,409000362497',2018-03-14,Indiaforensic SERVICES INDIA PVT,230171.0,0.0,,2018,3,14,CASH_OUT,230171.0,M1394192747
31440,409000362497',2018-03-14,FDRL/INTERNAL FUND TRANSFE,0.0,5000000.0,,2018,3,14,CHECK_CASHING,5000000.0,M619558760
31441,409000362497',2018-03-14,FDRL/INTERNAL FUND TRANSFE,0.0,2000000.0,,2018,3,14,TRANSFER,2000000.0,M774599836
31442,409000362497',2018-03-14,IMPS 1403183C,4861739.94,0.0,,2018,3,14,PAYEMENT,4861739.94,C1079554968
31443,409000362497',2018-03-14,IMPS 1403184C,3050669.17,0.0,,2018,3,14,DEBIT,3050669.17,C471450373
31444,409000362497',2018-03-14,Sweep Trf To: 40900036427,327839.0,0.0,,2018,3,14,CHECK_WITHDRAWAL,327839.0,C716083600
31445,409000362497',2018-03-15,IMPS 1403181C,3166809.41,0.0,,2018,3,15,CHECK_WITHDRAWAL,3166809.41,M560748648
31446,409000362497',2018-03-15,IMPS 150318 2C,1564500.31,0.0,,2018,3,15,CHECK_WITHDRAWAL,1564500.31,M281002334
31447,409000362497',2018-03-15,BIGTREE ENTERTAINMENT PRI,921.0,0.0,,2018,3,15,CASH_OUT,921.0,M484285535
31448,409000362497',2018-03-15,IRCTC CORPORATE OFFICE AC,84745.0,0.0,,2018,3,15,PAYEMENT,84745.0,C1263845074
31449,409000362497',2018-03-15,AVENUES INDIA PRIVATE LIM,10644.0,0.0,,2018,3,15,CHECK_WITHDRAWAL,10644.0,C977990184
31450,409000362497',2018-03-15,ZAAK EPAYMENT SERVICES PR,110.0,0.0,,2018,3,15,PAYEMENT,110.0,C1162775738
31451,409000362497',2018-03-15,FUTURE RETAIL LIMITED (OW,653.0,0.0,,2018,3,15,DEBIT,653.0,C2107464159
31452,409000362497',2018-03-15,PASFAR TECHNOLOGIES PRIVA,979.0,0.0,,2018,3,15,CHECK_WITHDRAWAL,979.0,M1928831414
31453,409000362497',2018-03-15,DISH INFRA SERVICES PRIVA,98.0,0.0,,2018,3,15,PAYEMENT,98.0,M2019255900
31454,409000362497',2018-03-15,JUST DIAL LIMITED,3929.0,0.0,,2018,3,15,CHECK_WITHDRAWAL,3929.0,M50538573
31455,409000362497',2018-03-15,MEHAR ENTERTAINMENT PRIVA,2074.0,0.0,,2018,3,15,CASH_OUT,2074.0,M1503598474
31456,409000362497',2018-03-15,QWIKCILVER SOLUTIONS PRIV,45255.0,0.0,,2018,3,15,CHECK_WITHDRAWAL,45255.0,M970704402
31457,409000362497',2018-03-15,ZAAK EPAYMENT SERVICES PR,8052.0,0.0,,2018,3,15,PAYEMENT,8052.0,M1306620485
31458,409000362497',2018-03-15,VOUCHER ACTIVATION SERVIC,18507.0,0.0,,2018,3,15,PAYEMENT,18507.0,M257158114
31459,409000362497',2018-03-15,INDIAIDEAS.COM LTD,39373.0,0.0,,2018,3,15,DEBIT,39373.0,C720759478
31460,409000362497',2018-03-15,Indiaforensic SERVICES INDIA PVT,219039.0,0.0,,2018,3,15,CHECK_WITHDRAWAL,219039.0,M800717424
31461,409000362497',2018-03-15,IMPS 1503183C,4420219.5,0.0,,2018,3,15,CASH_OUT,4420219.5,M670303375
31462,409000362497',2018-03-15,FDRL/INTERNAL FUND TRANSFE,0.0,10000000.0,,2018,3,15,CHECK_CASHING,10000000.0,M818331949
31463,409000362497',2018-03-15,IMPS 1503174C,2726757.81,0.0,,2018,3,15,CHECK_WITHDRAWAL,2726757.81,C15445402
31464,409000362497',2018-03-15,Sweep Trf To: 40900036427,463261.0,0.0,,2018,3,15,PAYEMENT,463261.0,M382000207
31465,409000362497',2018-03-16,IMPS 1503181C,2835370.22,0.0,,2018,3,16,DEBIT,2835370.22,C2049813033
31466,409000362497',2018-03-16,IMPS 1603182C,1461058.38,0.0,,2018,3,16,CHECK_WITHDRAWAL,1461058.38,C1577420620
31467,409000362497',2018-03-16,IMPS 1603183C,3793582.4,0.0,,2018,3,16,PAYEMENT,3793582.4,C912252532
31468,409000362497',2018-03-16,BIGTREE ENTERTAINMENT PRI,75.0,0.0,,2018,3,16,CHECK_WITHDRAWAL,75.0,C1722902384
31469,409000362497',2018-03-16,INDIAIDEAS.COM LTD,74331.0,0.0,,2018,3,16,CASH_OUT,74331.0,C256902273
31470,409000362497',2018-03-16,IRCTC CORPORATE OFFICE AC,69205.0,0.0,,2018,3,16,CASH_OUT,69205.0,C262828207
31471,409000362497',2018-03-16,PAYU PAYMENTS PRIVATE LIM,35735.0,0.0,,2018,3,16,PAYEMENT,35735.0,C738590621
31472,409000362497',2018-03-16,AVENUES INDIA PRIVATE LIM,14866.0,0.0,,2018,3,16,PAYEMENT,14866.0,C1373172466
31473,409000362497',2018-03-16,ZAAK EPAYMENT SERVICES PR,110.0,0.0,,2018,3,16,DEBIT,110.0,C323287038
31474,409000362497',2018-03-16,FUTURE RETAIL LIMITED (OW,157.0,0.0,,2018,3,16,PAYEMENT,157.0,C1438689128
31475,409000362497',2018-03-16,PASFAR TECHNOLOGIES PRIVA,979.0,0.0,,2018,3,16,CASH_OUT,979.0,C420398953
31476,409000362497',2018-03-16,JUST DIAL LIMITED,3045.0,0.0,,2018,3,16,DEBIT,3045.0,C656977363
31477,409000362497',2018-03-16,MEHAR ENTERTAINMENT PRIVA,691.0,0.0,,2018,3,16,PAYEMENT,691.0,C758750856
31478,409000362497',2018-03-16,E-BILLING SOLUTIONS PRIVA,2059.0,0.0,,2018,3,16,PAYEMENT,2059.0,C2011869283
31479,409000362497',2018-03-16,Indiaforensic SERVICES INDIA PVT,212039.0,0.0,,2018,3,16,PAYEMENT,212039.0,C349015546
31480,409000362497',2018-03-16,NEFT/SBIN818075051179/Indfor,0.0,2000000.0,,2018,3,16,TRANSFER,2000000.0,C1276424637
31481,409000362497',2018-03-16,FDRL/INTERNAL FUND TRANSFE,0.0,15000000.0,,2018,3,16,CHECK_CASHING,15000000.0,C699026377
31482,409000362497',2018-03-16,IMPS 1603184C,2544380.33,0.0,,2018,3,16,PAYEMENT,2544380.33,C711278951
31483,409000362497',2018-03-16,Sweep Trf To: 40900036427,308252.0,0.0,,2018,3,16,CHECK_WITHDRAWAL,308252.0,C861720625
31484,409000362497',2018-03-17,IMPS 1603181C,2491030.48,0.0,,2018,3,17,DEBIT,2491030.48,C1359484306
31485,409000362497',2018-03-17,IMPS 1703182C,1529577.76,0.0,,2018,3,17,CHECK_WITHDRAWAL,1529577.76,C594250212
31486,409000362497',2018-03-17,IMPS 17032018 3C,3358208.38,0.0,,2018,3,17,DEBIT,3358208.38,C305259590
31487,409000362497',2018-03-17,FDRL/INTERNAL FUND TRANSFE,0.0,5000000.0,,2018,3,17,CHECK_CASHING,5000000.0,C1638372110
31488,409000362497',2018-03-17,FDRL/INTERNAL FUND TRANSFE,0.0,4000000.0,,2018,3,17,TRANSFER,4000000.0,C1439007204
31489,409000362497',2018-03-17,FDRL/INTERNAL FUND TRANSFE,0.0,500000.0,,2018,3,17,CASH_IN,500000.0,C346546542
31490,409000362497',2018-03-17,NEFT/SBIN918076158534/Indfor,0.0,1000000.0,,2018,3,17,TRANSFER,1000000.0,C998351292
31491,409000362497',2018-03-17,IMPS 170320184C,2377752.17,0.0,,2018,3,17,CHECK_WITHDRAWAL,2377752.17,C688425953
31492,409000362497',2018-03-17,Sweep Trf To: 40900036427,221300.0,0.0,,2018,3,17,PAYEMENT,221300.0,C406477119
31493,409000362497',2018-03-19,IMPS 1703181C,2535337.5,0.0,,2018,3,19,CHECK_WITHDRAWAL,2535337.5,C1493448513
31494,409000362497',2018-03-19,IMPS 1803181C,3782554.73,0.0,,2018,3,19,DEBIT,3782554.73,C2116873183
31495,409000362497',2018-03-19,IMPS 1903182C,1418373.88,0.0,,2018,3,19,CHECK_WITHDRAWAL,1418373.88,C1549086472
31496,409000362497',2018-03-19,IMPS 190318 3C,3829772.61,0.0,,2018,3,19,PAYEMENT,3829772.61,C624539461
31497,409000362497',2018-03-19,NEFT/SBIN118078158698/Indfor,0.0,2000000.0,,2018,3,19,CHECK_CASHING,2000000.0,C1740764606
31498,409000362497',2018-03-19,FDRL/INTERNAL FUND TRANSFE,0.0,10000000.0,,2018,3,19,TRANSFER,10000000.0,C374625527
31499,409000362497',2018-03-19,IMPS 190320184C,3202097.32,0.0,,2018,3,19,PAYEMENT,3202097.32,C716442925
31500,409000362497',2018-03-19,Sweep Trf To: 40900036427,476643.0,0.0,,2018,3,19,PAYEMENT,476643.0,C189963646
31501,409000362497',2018-03-20,IMPS 1903181C,2417102.18,0.0,,2018,3,20,PAYEMENT,2417102.18,C1479553213
31502,409000362497',2018-03-20,IMPS 2003182C,1654510.93,0.0,,2018,3,20,CASH_OUT,1654510.93,C1017767725
31503,409000362497',2018-03-20,BIGTREE ENTERTAINMENT PRI,6703.0,0.0,,2018,3,20,CHECK_WITHDRAWAL,6703.0,C1926673338
31504,409000362497',2018-03-20,INDIAIDEAS.COM LTD,169048.0,0.0,,2018,3,20,CASH_OUT,169048.0,C1909597726
31505,409000362497',2018-03-20,IRCTC CORPORATE OFFICE AC,278240.0,0.0,,2018,3,20,DEBIT,278240.0,C1746371201
31506,409000362497',2018-03-20,PAYU PAYMENTS PRIVATE LIM,52935.0,0.0,,2018,3,20,DEBIT,52935.0,C264843581
31507,409000362497',2018-03-20,AVENUES INDIA PRIVATE LIM,62591.0,0.0,,2018,3,20,PAYEMENT,62591.0,C1401316767
31508,409000362497',2018-03-20,PAYGATE INDIA PRIVATE LIM,705.0,0.0,,2018,3,20,CHECK_WITHDRAWAL,705.0,C582320549
31509,409000362497',2018-03-20,FUTURE RETAIL LIMITED (OW,15470.0,0.0,,2018,3,20,CASH_OUT,15470.0,C267527788
31510,409000362497',2018-03-20,METRO INFRASYS PRIVATE LI,673.0,0.0,,2018,3,20,CASH_OUT,673.0,C339099861
31511,409000362497',2018-03-20,DISH INFRA SERVICES PRIVA,1584.0,0.0,,2018,3,20,CHECK_WITHDRAWAL,1584.0,C1387567249
31512,409000362497',2018-03-20,JUST DIAL LIMITED,2840.0,0.0,,2018,3,20,CHECK_WITHDRAWAL,2840.0,C79685693
31513,409000362497',2018-03-20,MEHAR ENTERTAINMENT PRIVA,5645.0,0.0,,2018,3,20,DEBIT,5645.0,C1641587857
31514,409000362497',2018-03-20,E-BILLING SOLUTIONS PRIVA,10124.0,0.0,,2018,3,20,DEBIT,10124.0,C1186449563
31515,409000362497',2018-03-20,Indiaforensic SERVICES INDIA PVT,753729.0,0.0,,2018,3,20,CHECK_WITHDRAWAL,753729.0,C391734039
31516,409000362497',2018-03-20,IMPS 200320183C,3652823.8,0.0,,2018,3,20,CHECK_WITHDRAWAL,3652823.8,C70895366
31517,409000362497',2018-03-20,FDRL/INTERNAL FUND TRANSFE,0.0,5000000.0,,2018,3,20,TRANSFER,5000000.0,C1746371201
31518,409000362497',2018-03-20,FDRL/INTERNAL FUND TRANSFE,0.0,5000000.0,,2018,3,20,CHECK_CASHING,5000000.0,C1661355634
31519,409000362497',2018-03-20,FDRL/INTERNAL FUND TRANSFE,0.0,500000.0,,2018,3,20,CASH_IN,500000.0,C1504420803
31520,409000362497',2018-03-20,IMPS 2003184C,2562178.8,0.0,,2018,3,20,DEBIT,2562178.8,C748014372
31521,409000362497',2018-03-20,Sweep Trf To: 40900036427,309760.0,0.0,,2018,3,20,CHECK_WITHDRAWAL,309760.0,C1320515149
31522,409000362497',2018-03-21,IMPS 2003181C,3000007.03,0.0,,2018,3,21,PAYEMENT,3000007.03,C2038994826
31523,409000362497',2018-03-21,IMPS 2103182C,1466204.53,0.0,,2018,3,21,CHECK_WITHDRAWAL,1466204.53,C1747713912
31524,409000362497',2018-03-21,IMPS 210320183C,3637680.44,0.0,,2018,3,21,DEBIT,3637680.44,C1477979030
31525,409000362497',2018-03-21,NEFT/SBIN318080557479/Indfor,0.0,3000000.0,,2018,3,21,CHECK_CASHING,3000000.0,C639015907
31526,409000362497',2018-03-21,FDRL/INTERNAL FUND TRANSFE,0.0,5000000.0,,2018,3,21,CHECK_CASHING,5000000.0,C16344660
31527,409000362497',2018-03-21,FDRL/INTERNAL FUND TRANSFE,0.0,3000000.0,,2018,3,21,CHECK_CASHING,3000000.0,C1970982612
31528,409000362497',2018-03-21,IMPS 210320184C,2742042.15,0.0,,2018,3,21,CASH_OUT,2742042.15,M2108235144
31529,409000362497',2018-03-21,Sweep Trf To: 40900036427,291633.0,0.0,,2018,3,21,PAYEMENT,291633.0,M1601497364
31530,409000362497',2018-03-22,IMPS 2103181C,2843458.36,0.0,,2018,3,22,CHECK_WITHDRAWAL,2843458.36,C726752092
31531,409000362497',2018-03-22,IMPS 2203182C,1405211.85,0.0,,2018,3,22,CHECK_WITHDRAWAL,1405211.85,C1505755152
31532,409000362497',2018-03-22,IMPS 220320183C,4343314.14,0.0,,2018,3,22,CHECK_WITHDRAWAL,4343314.14,M1998915304
31533,409000362497',2018-03-22,BIGTREE ENTERTAINMENT PRI,2651.0,0.0,,2018,3,22,DEBIT,2651.0,M1123655244
31534,409000362497',2018-03-22,INDIAIDEAS.COM LTD,138564.0,0.0,,2018,3,22,DEBIT,138564.0,M432210703
31535,409000362497',2018-03-22,IRCTC CORPORATE OFFICE AC,110160.0,0.0,,2018,3,22,CASH_OUT,110160.0,M118164836
31536,409000362497',2018-03-22,PAYU PAYMENTS PRIVATE LIM,34705.0,0.0,,2018,3,22,CHECK_WITHDRAWAL,34705.0,M839942439
31537,409000362497',2018-03-22,AVENUES INDIA PRIVATE LIM,17173.0,0.0,,2018,3,22,PAYEMENT,17173.0,M319865759
31538,409000362497',2018-03-22,FUTURE RETAIL LIMITED (OW,8395.0,0.0,,2018,3,22,PAYEMENT,8395.0,M1202613150
31539,409000362497',2018-03-22,METRO INFRASYS PRIVATE LI,673.0,0.0,,2018,3,22,DEBIT,673.0,M1653788770
31540,409000362497',2018-03-22,JUST DIAL LIMITED,7907.0,0.0,,2018,3,22,PAYEMENT,7907.0,M696474472
31541,409000362497',2018-03-22,MEHAR ENTERTAINMENT PRIVA,3341.0,0.0,,2018,3,22,CASH_OUT,3341.0,M1972116657
31542,409000362497',2018-03-22,E-BILLING SOLUTIONS PRIVA,5397.0,0.0,,2018,3,22,CASH_OUT,5397.0,M1914211073
31543,409000362497',2018-03-22,DISH INFRA SERVICES PRIVA,296.0,0.0,,2018,3,22,DEBIT,296.0,M673956574
31544,409000362497',2018-03-22,VOUCHER ACTIVATION SERVIC,11242.0,0.0,,2018,3,22,PAYEMENT,11242.0,M1098074965
31545,409000362497',2018-03-22,DISH INFRA SERVICES PRIVA,296.0,0.0,,2018,3,22,PAYEMENT,296.0,M858354138
31546,409000362497',2018-03-22,Indiaforensic SERVICES INDIA PVT,392851.0,0.0,,2018,3,22,CASH_OUT,392851.0,M859060760
31547,409000362497',2018-03-22,FDRL/INTERNAL FUND TRANSFE,0.0,5000000.0,,2018,3,22,CHECK_CASHING,5000000.0,M493569679
31548,409000362497',2018-03-22,NEFT/SBIN418081956067/Indfor,0.0,6100000.0,,2018,3,22,TRANSFER,6100000.0,M1349105128
31549,409000362497',2018-03-22,IMPS 220320184C,2652253.85,0.0,,2018,3,22,CASH_OUT,2652253.85,C1526401615
31550,409000362497',2018-03-22,Sweep Trf To: 40900036427,254749.0,0.0,,2018,3,22,CHECK_WITHDRAWAL,254749.0,M1876570779
31551,409000362497',2018-03-23,IMPS 2203181C,2813210.57,0.0,,2018,3,23,CHECK_WITHDRAWAL,2813210.57,C1219349215
31552,409000362497',2018-03-23,IMPS 2303182C,1679097.89,0.0,,2018,3,23,CASH_OUT,1679097.89,C1195378184
31553,409000362497',2018-03-23,IMPS 230320183C,4009753.99,0.0,,2018,3,23,PAYEMENT,4009753.99,M1215802689
31554,409000362497',2018-03-23,BIGTREE ENTERTAINMENT PRI,446.0,0.0,,2018,3,23,CHECK_WITHDRAWAL,446.0,C181168745
31555,409000362497',2018-03-23,INDIAIDEAS.COM LTD,31145.0,0.0,,2018,3,23,PAYEMENT,31145.0,M2044307522
31556,409000362497',2018-03-23,IRCTC CORPORATE OFFICE AC,74440.0,0.0,,2018,3,23,DEBIT,74440.0,C1885738296
31557,409000362497',2018-03-23,PAYU PAYMENTS PRIVATE LIM,23494.0,0.0,,2018,3,23,CHECK_WITHDRAWAL,23494.0,M141150718
31558,409000362497',2018-03-23,AVENUES INDIA PRIVATE LIM,6120.0,0.0,,2018,3,23,CASH_OUT,6120.0,M948913899
31559,409000362497',2018-03-23,FUTURE RETAIL LIMITED (OW,1232.0,0.0,,2018,3,23,PAYEMENT,1232.0,M572159584
31560,409000362497',2018-03-23,METRO INFRASYS PRIVATE LI,673.0,0.0,,2018,3,23,DEBIT,673.0,C1149273771
31561,409000362497',2018-03-23,PASFAR TECHNOLOGIES PRIVA,153.0,0.0,,2018,3,23,PAYEMENT,153.0,C1444624884
31562,409000362497',2018-03-23,MEHAR ENTERTAINMENT PRIVA,5300.0,0.0,,2018,3,23,DEBIT,5300.0,M759776058
31563,409000362497',2018-03-23,E-BILLING SOLUTIONS PRIVA,8595.0,0.0,,2018,3,23,CASH_OUT,8595.0,C1703397679
31564,409000362497',2018-03-23,QWIKCILVER SOLUTIONS PRIV,32718.0,0.0,,2018,3,23,PAYEMENT,32718.0,M1783030423
31565,409000362497',2018-03-23,Indiaforensic SERVICES INDIA PVT,211019.0,0.0,,2018,3,23,PAYEMENT,211019.0,M985336335
31566,409000362497',2018-03-23,NEFT/SBIN618082258857/Indfor,0.0,4000000.0,,2018,3,23,CASH_IN,4000000.0,M211133401
31567,409000362497',2018-03-23,FDRL/INTERNAL FUND TRANSFE,0.0,5000000.0,,2018,3,23,CASH_IN,5000000.0,M1779086540
31568,409000362497',2018-03-23,FDRL/INTERNAL FUND TRANSFE,0.0,10000000.0,,2018,3,23,TRANSFER,10000000.0,M1329024706
31569,409000362497',2018-03-23,FDRL/INTERNAL FUND TRANSFE,0.0,1000000.0,,2018,3,23,TRANSFER,1000000.0,M1632892641
31570,409000362497',2018-03-23,IMPS 2303184C,2846329.25,0.0,,2018,3,23,PAYEMENT,2846329.25,M400867845
31571,409000362497',2018-03-23,Sweep Trf To: 40900036427,309673.0,0.0,,2018,3,23,CASH_OUT,309673.0,M860731232
31572,409000362497',2018-03-26,IMPS 2303181C,2808823.37,0.0,,2018,3,26,CASH_OUT,2808823.37,M1714561682
31573,409000362497',2018-03-26,IMPS 2403181C,13346353.18,0.0,,2018,3,26,DEBIT,13346353.18,M1209761820
31574,409000362497',2018-03-26,IMPS 2503181C,1998247.33,0.0,,2018,3,26,DEBIT,1998247.33,M1365730500
31575,409000362497',2018-03-26,IMPS 2603182C,4044386.88,0.0,,2018,3,26,DEBIT,4044386.88,M1296764442
31576,409000362497',2018-03-26,NEFT/SBIN818085339168/Indfor,0.0,4000000.0,,2018,3,26,CHECK_CASHING,4000000.0,M921102956
31577,409000362497',2018-03-26,FDRL/INTERNAL FUND TRANSFE,0.0,10000000.0,,2018,3,26,CASH_IN,10000000.0,M1501837345
31578,409000362497',2018-03-26,FDRL/INTERNAL FUND TRANSFE,0.0,10000000.0,,2018,3,26,TRANSFER,10000000.0,M1810735877
31579,409000362497',2018-03-26,FDRL/INTERNAL FUND TRANSFE,0.0,3000000.0,,2018,3,26,CASH_IN,3000000.0,M163809394
31580,409000362497',2018-03-26,IMPS 260320183C,6334000.21,0.0,,2018,3,26,CASH_OUT,6334000.21,M692250571
31581,409000362497',2018-03-26,IMPS 260320184C,4026735.07,0.0,,2018,3,26,PAYEMENT,4026735.07,M984979490
31582,409000362497',2018-03-26,Sweep Trf To: 40900036427,621239.0,0.0,,2018,3,26,PAYEMENT,621239.0,M654319391
31583,409000362497',2018-03-27,IMPS 2603181C,3953879.33,0.0,,2018,3,27,DEBIT,3953879.33,M507514376
31584,409000362497',2018-03-27,IMPS 2703182C,2383805.26,0.0,,2018,3,27,DEBIT,2383805.26,C266418454
31585,409000362497',2018-03-27,INDIAIDEAS.COM LTD,35700.0,0.0,,2018,3,27,CASH_OUT,35700.0,M696784162
31586,409000362497',2018-03-27,INDIAIDEAS.COM LTD,55673.0,0.0,,2018,3,27,PAYEMENT,55673.0,M434752423
31587,409000362497',2018-03-27,IRCTC CORPORATE OFFICE AC,152275.0,0.0,,2018,3,27,PAYEMENT,152275.0,M25190089
31588,409000362497',2018-03-27,PAYU PAYMENTS PRIVATE LIM,52456.0,0.0,,2018,3,27,CHECK_WITHDRAWAL,52456.0,M1387465620
31589,409000362497',2018-03-27,AVENUES INDIA PRIVATE LIM,3842.0,0.0,,2018,3,27,DEBIT,3842.0,M2048546312
31590,409000362497',2018-03-27,SYNERGISTIC FINANCIAL NET,21.0,0.0,,2018,3,27,CASH_OUT,21.0,M923512231
31591,409000362497',2018-03-27,ZAAK EPAYMENT SERVICES PR,2406.0,0.0,,2018,3,27,CHECK_WITHDRAWAL,2406.0,M531191870
31592,409000362497',2018-03-27,PAYGATE INDIA PRIVATE LIM,1267.0,0.0,,2018,3,27,CHECK_WITHDRAWAL,1267.0,M2142256109
31593,409000362497',2018-03-27,FUTURE RETAIL LIMITED (OW,9564.0,0.0,,2018,3,27,DEBIT,9564.0,M1113096558
31594,409000362497',2018-03-27,PASFAR TECHNOLOGIES PRIVA,5014.0,0.0,,2018,3,27,DEBIT,5014.0,M1339410129
31595,409000362497',2018-03-27,HUNGAMA DIGITAL MEDIA ENT,97.0,0.0,,2018,3,27,CASH_OUT,97.0,M1950416273
31596,409000362497',2018-03-27,DISH INFRA SERVICES PRIVA,68.0,0.0,,2018,3,27,CHECK_WITHDRAWAL,68.0,M57815259
31597,409000362497',2018-03-27,MEHAR ENTERTAINMENT PRIVA,7719.0,0.0,,2018,3,27,PAYEMENT,7719.0,M686447690
31598,409000362497',2018-03-27,E-BILLING SOLUTIONS PRIVA,25986.0,0.0,,2018,3,27,CASH_OUT,25986.0,M1544709489
31599,409000362497',2018-03-27,MUZAFFARPUR VIDYUT VITARA,337.0,0.0,,2018,3,27,CASH_OUT,337.0,M1372910279
31600,409000362497',2018-03-27,ALT DIGITAL MEDIA ENTERTA,98.0,0.0,,2018,3,27,DEBIT,98.0,M1933532148
31601,409000362497',2018-03-27,Indiaforensic SERVICES INDIA PVT,441721.0,0.0,,2018,3,27,CHECK_WITHDRAWAL,441721.0,M430879443
31602,409000362497',2018-03-27,IMPS 270320183C,6172483.51,0.0,,2018,3,27,CHECK_WITHDRAWAL,6172483.51,M1622747570
31603,409000362497',2018-03-27,INDIAIDEAS.COM LTD,82840.0,0.0,,2018,3,27,DEBIT,82840.0,M846221418
31604,409000362497',2018-03-27,IRCTC CORPORATE OFFICE AC,64090.0,0.0,,2018,3,27,CASH_OUT,64090.0,M1944693737
31605,409000362497',2018-03-27,PAYU PAYMENTS PRIVATE LIM,39029.0,0.0,,2018,3,27,DEBIT,39029.0,M1060653111
31606,409000362497',2018-03-27,AVENUES INDIA PRIVATE LIM,2491.0,0.0,,2018,3,27,CASH_OUT,2491.0,M2081724000
31607,409000362497',2018-03-27,FUTURE RETAIL LIMITED (OW,1833.0,0.0,,2018,3,27,CHECK_WITHDRAWAL,1833.0,M1399619952
31608,409000362497',2018-03-27,PASFAR TECHNOLOGIES PRIVA,3012.0,0.0,,2018,3,27,CASH_OUT,3012.0,M796025520
31609,409000362497',2018-03-27,HAPPYDEAL18,315.0,0.0,,2018,3,27,CHECK_WITHDRAWAL,315.0,M1984944043
31610,409000362497',2018-03-27,DISH INFRA SERVICES PRIVA,98.0,0.0,,2018,3,27,CHECK_WITHDRAWAL,98.0,M1466520596
31611,409000362497',2018-03-27,E-BILLING SOLUTIONS PRIVA,2617.0,0.0,,2018,3,27,PAYEMENT,2617.0,M1669275429
31612,409000362497',2018-03-27,MUZAFFARPUR VIDYUT VITARA,298.0,0.0,,2018,3,27,PAYEMENT,298.0,M59060892
31613,409000362497',2018-03-27,Indiaforensic SERVICES INDIA PVT,186746.0,0.0,,2018,3,27,CHECK_WITHDRAWAL,186746.0,C1029125570
31614,409000362497',2018-03-27,FDRL/INTERNAL FUND TRANSFE,0.0,10000000.0,,2018,3,27,CASH_IN,10000000.0,M1317278081
31615,409000362497',2018-03-27,FDRL/INTERNAL FUND TRANSFE,0.0,10000000.0,,2018,3,27,CASH_IN,10000000.0,M2126596121
31616,409000362497',2018-03-27,IMPS 270320184C,3976033.63,0.0,,2018,3,27,DEBIT,3976033.63,C2040656033
31617,409000362497',2018-03-27,Sweep Trf To: 40900036427,492021.0,0.0,,2018,3,27,DEBIT,492021.0,C465499079
31618,409000362497',2018-03-28,RTGS/YESBH18087262896/IRC,0.0,554400.0,,2018,3,28,CHECK_CASHING,554400.0,C1876351111
31619,409000362497',2018-03-28,IMPS 2703181C,3833614.84,0.0,,2018,3,28,PAYEMENT,3833614.84,C2067546399
31620,409000362497',2018-03-28,IMPS 280318 2C,2411982.88,0.0,,2018,3,28,PAYEMENT,2411982.88,M1280799940
31621,409000362497',2018-03-28,INDIAIDEAS.COM LTD,14984.0,0.0,,2018,3,28,PAYEMENT,14984.0,C818343975
31622,409000362497',2018-03-28,IRCTC CORPORATE OFFICE AC,75390.0,0.0,,2018,3,28,PAYEMENT,75390.0,C1786622318
31623,409000362497',2018-03-28,PAYU PAYMENTS PRIVATE LIM,16528.0,0.0,,2018,3,28,CASH_OUT,16528.0,C1733581655
31624,409000362497',2018-03-28,AVENUES INDIA PRIVATE LIM,8183.0,0.0,,2018,3,28,CASH_OUT,8183.0,M876522781
31625,409000362497',2018-03-28,ZAAK EPAYMENT SERVICES PR,367.0,0.0,,2018,3,28,DEBIT,367.0,C1907159141
31626,409000362497',2018-03-28,FUTURE RETAIL LIMITED (OW,315.0,0.0,,2018,3,28,CASH_OUT,315.0,C973641248
31627,409000362497',2018-03-28,PASFAR TECHNOLOGIES PRIVA,5056.0,0.0,,2018,3,28,CHECK_WITHDRAWAL,5056.0,M49434695
31628,409000362497',2018-03-28,MEHAR ENTERTAINMENT PRIVA,2535.0,0.0,,2018,3,28,DEBIT,2535.0,C1241878571
31629,409000362497',2018-03-28,E-BILLING SOLUTIONS PRIVA,3898.0,0.0,,2018,3,28,CASH_OUT,3898.0,M873231385
31630,409000362497',2018-03-28,Indiaforensic SERVICES INDIA PVT,222628.0,0.0,,2018,3,28,PAYEMENT,222628.0,C780003722
31631,409000362497',2018-03-28,IMPS 2803183C,6299250.43,0.0,,2018,3,28,PAYEMENT,6299250.43,C2123455914
31632,409000362497',2018-03-28,FDRL/INTERNAL FUND TRANSFE,0.0,15000000.0,,2018,3,28,TRANSFER,15000000.0,C1478160170
31633,409000362497',2018-03-28,FDRL/INTERNAL FUND TRANSFE,0.0,2000000.0,,2018,3,28,TRANSFER,2000000.0,C104012589
31634,409000362497',2018-03-28,IMPS 2803184C,4217400.54,0.0,,2018,3,28,CHECK_WITHDRAWAL,4217400.54,C1038678108
31635,409000362497',2018-03-28,Sweep Trf To: 40900036427,498135.0,0.0,,2018,3,28,PAYEMENT,498135.0,C304406966
31636,409000362497',2018-03-29,IMPS 2803181C,3751892.5,0.0,,2018,3,29,CASH_OUT,3751892.5,C182799539
31637,409000362497',2018-03-29,IMPS 2903182C,1859543.05,0.0,,2018,3,29,DEBIT,1859543.05,M1515652018
31638,409000362497',2018-03-29,IMPS 290320183C,4948902.87,0.0,,2018,3,29,CASH_OUT,4948902.87,C641763646
31639,409000362497',2018-03-29,NEFT/SBIN318088950089/Indfor,0.0,3000000.0,,2018,3,29,TRANSFER,3000000.0,M466193698
31640,409000362497',2018-03-29,FDRL/INTERNAL FUND TRANSFE,0.0,1000000.0,,2018,3,29,TRANSFER,1000000.0,M1560904125
31641,409000362497',2018-03-29,IMPS 808819090369 FROM OX,0.0,200000.0,,2018,3,29,CHECK_CASHING,200000.0,M292254279
31642,409000362497',2018-03-29,IMPS 808819090411 FROM OX,0.0,200000.0,,2018,3,29,TRANSFER,200000.0,C420398953
31643,409000362497',2018-03-29,IMPS 808819090459 FROM OX,0.0,200000.0,,2018,3,29,TRANSFER,200000.0,C1489275794
31644,409000362497',2018-03-29,IMPS 808819090503 FROM OX,0.0,200000.0,,2018,3,29,TRANSFER,200000.0,C755583709
31645,409000362497',2018-03-29,IMPS 808819090534 FROM OX,0.0,200000.0,,2018,3,29,TRANSFER,200000.0,M1782348172
31646,409000362497',2018-03-29,IMPS 808819090578 FROM OX,0.0,200000.0,,2018,3,29,TRANSFER,200000.0,C1154280433
31647,409000362497',2018-03-29,IMPS 808819090611 FROM OX,0.0,200000.0,,2018,3,29,TRANSFER,200000.0,C620532131
31648,409000362497',2018-03-29,IMPS 808819090634 FROM OX,0.0,200000.0,,2018,3,29,TRANSFER,200000.0,C1568275166
31649,409000362497',2018-03-29,IMPS 808819090669 FROM OX,0.0,200000.0,,2018,3,29,TRANSFER,200000.0,M1828311333
31650,409000362497',2018-03-29,IMPS 808819090709 FROM OX,0.0,200000.0,,2018,3,29,CASH_IN,200000.0,M48538070
31651,409000362497',2018-03-29,IMPS 808819091095 FROM OX,0.0,200000.0,,2018,3,29,CASH_IN,200000.0,M2138333111
31652,409000362497',2018-03-29,IMPS 808819091150 FROM OX,0.0,200000.0,,2018,3,29,CHECK_CASHING,200000.0,M1783367946
31653,409000362497',2018-03-29,IMPS 808819091246 FROM OX,0.0,200000.0,,2018,3,29,TRANSFER,200000.0,M1555760964
31654,409000362497',2018-03-29,IMPS 808819091273 FROM OX,0.0,200000.0,,2018,3,29,CHECK_CASHING,200000.0,M338533290
31655,409000362497',2018-03-29,IMPS 808819091318 FROM OX,0.0,200000.0,,2018,3,29,CHECK_CASHING,200000.0,M1786033562
31656,409000362497',2018-03-29,IMPS 2903184C,3850230.69,0.0,,2018,3,29,PAYEMENT,3850230.69,C365897166
31657,409000362497',2018-03-29,Sweep Trf To: 40900036427,254818.0,0.0,,2018,3,29,PAYEMENT,254818.0,M1947241909
31658,409000362497',2018-03-30,FUND TRF FROM  Indiaforensic SER,0.0,15000000.0,,2018,3,30,CHECK_CASHING,15000000.0,C92373025
31659,409000362497',2018-03-31,IMPS 2903181C,3023526.49,0.0,,2018,3,31,PAYEMENT,3023526.49,C1249000159
31660,409000362497',2018-03-31,IMPS 3003181C,12506118.8,0.0,,2018,3,31,CASH_OUT,12506118.8,M1913264819
31661,409000362497',2018-03-31,IMPS 3103182C,1745687.44,0.0,,2018,3,31,CHECK_WITHDRAWAL,1745687.44,M498803718
31662,409000362497',2018-03-31,IRCTC CORPORATE OFFICE AC,305195.0,0.0,,2018,3,31,CHECK_WITHDRAWAL,305195.0,C1498878963
31663,409000362497',2018-03-31,PAYU PAYMENTS PRIVATE LIM,107537.0,0.0,,2018,3,31,DEBIT,107537.0,M1072805913
31664,409000362497',2018-03-31,AVENUES INDIA PRIVATE LIM,96192.0,0.0,,2018,3,31,CASH_OUT,96192.0,M1709956385
31665,409000362497',2018-03-31,ZAAK EPAYMENT SERVICES PR,972.0,0.0,,2018,3,31,PAYEMENT,972.0,M22287612
31666,409000362497',2018-03-31,FUTURE RETAIL LIMITED (OW,5247.0,0.0,,2018,3,31,PAYEMENT,5247.0,M810476321
31667,409000362497',2018-03-31,PASFAR TECHNOLOGIES PRIVA,11263.0,0.0,,2018,3,31,PAYEMENT,11263.0,M417142341
31668,409000362497',2018-03-31,MEHAR ENTERTAINMENT PRIVA,11061.0,0.0,,2018,3,31,CASH_OUT,11061.0,C442364016
31669,409000362497',2018-03-31,E-BILLING SOLUTIONS PRIVA,326.0,0.0,,2018,3,31,CASH_OUT,326.0,C480500119
31670,409000362497',2018-03-31,VOUCHER ACTIVATION SERVIC,6222.0,0.0,,2018,3,31,PAYEMENT,6222.0,C708992245
31671,409000362497',2018-03-31,DISH INFRA SERVICES PRIVA,871.0,0.0,,2018,3,31,DEBIT,871.0,M1533137064
31672,409000362497',2018-03-31,Indiaforensic SERVICES INDIA PVT,654973.0,0.0,,2018,3,31,CHECK_WITHDRAWAL,654973.0,C560041895
31673,409000362497',2018-03-31,IMPS 310320183C,1656437.71,0.0,,2018,3,31,DEBIT,1656437.71,C1725571079
31674,409000362497',2018-03-31,FDRL/INTERNAL FUND TRANSFE,0.0,5000000.0,,2018,3,31,CASH_IN,5000000.0,M1104841376
31675,409000362497',2018-03-31,FDRL/INTERNAL FUND TRANSFE,0.0,3000000.0,,2018,3,31,CHECK_CASHING,3000000.0,M382279259
31676,409000362497',2018-03-31,FDRL/INTERNAL FUND TRANSFE,0.0,3000000.0,,2018,3,31,CASH_IN,3000000.0,C2116153614
31677,409000362497',2018-03-31,FDRL/INTERNAL FUND TRANSFE,0.0,1000000.0,,2018,3,31,TRANSFER,1000000.0,C507538622
31678,409000362497',2018-03-31,IMPS 3103184C,330559.52,0.0,,2018,3,31,PAYEMENT,330559.52,C1257704323
31679,409000362497',2018-03-31,Sweep Trf To: 40900036427,143180.0,0.0,,2018,3,31,DEBIT,143180.0,C1899458851
31680,409000362497',2018-04-02,IMPS 809212178389 FROM OX,0.0,102000.0,,2018,4,2,TRANSFER,102000.0,C1411134174
31681,409000362497',2018-04-03,FDRL/INTERNAL FUND TRANSFE,0.0,2000000.0,,2018,4,3,CASH_IN,2000000.0,C1450417897
31682,409000362497',2018-04-03,IMPS 3103181C,2534256.86,0.0,,2018,4,3,DEBIT,2534256.86,C240259175
31683,409000362497',2018-04-03,IMPS 010420181C,6788560.22,0.0,,2018,4,3,DEBIT,6788560.22,C1761861940
31684,409000362497',2018-04-03,IMPS 020420181C,2026590.4,0.0,,2018,4,3,PAYEMENT,2026590.4,M1796970820
31685,409000362497',2018-04-03,IMPS 030420182C,7691546.02,0.0,,2018,4,3,PAYEMENT,7691546.02,M1895840844
31686,409000362497',2018-04-03,BIGTREE ENTERTAINMENT PRI,990.0,0.0,,2018,4,3,CHECK_WITHDRAWAL,990.0,M1721949795
31687,409000362497',2018-04-03,INDIAIDEAS.COM LTD,194338.0,0.0,,2018,4,3,CHECK_WITHDRAWAL,194338.0,M237980116
31688,409000362497',2018-04-03,IRCTC CORPORATE OFFICE AC,357185.0,0.0,,2018,4,3,PAYEMENT,357185.0,M173800769
31689,409000362497',2018-04-03,PAYU PAYMENTS PRIVATE LIM,34263.0,0.0,,2018,4,3,CASH_OUT,34263.0,M1864563234
31690,409000362497',2018-04-03,AVENUES INDIA PRIVATE LIM,10549.0,0.0,,2018,4,3,PAYEMENT,10549.0,M330875327
31691,409000362497',2018-04-03,ZAAK EPAYMENT SERVICES PR,239.0,0.0,,2018,4,3,CHECK_WITHDRAWAL,239.0,M1269778724
31692,409000362497',2018-04-03,FUTURE RETAIL LIMITED (OW,15503.0,0.0,,2018,4,3,PAYEMENT,15503.0,M1021308589
31693,409000362497',2018-04-03,PASFAR TECHNOLOGIES PRIVA,5790.0,0.0,,2018,4,3,CHECK_WITHDRAWAL,5790.0,M470377822
31694,409000362497',2018-04-03,DISH INFRA SERVICES PRIVA,1063.0,0.0,,2018,4,3,DEBIT,1063.0,M1295356732
31695,409000362497',2018-04-03,MEHAR ENTERTAINMENT PRIVA,5646.0,0.0,,2018,4,3,DEBIT,5646.0,C1523536343
31696,409000362497',2018-04-03,DIGIVIVE SERVICES PRIVATE,44.0,0.0,,2018,4,3,PAYEMENT,44.0,M737758778
31697,409000362497',2018-04-03,E-BILLING SOLUTIONS PRIVA,3493.0,0.0,,2018,4,3,DEBIT,3493.0,C653305407
31698,409000362497',2018-04-03,ALT DIGITAL MEDIA ENTERTA,98.0,0.0,,2018,4,3,CHECK_WITHDRAWAL,98.0,M940833645
31699,409000362497',2018-04-03,METRO INFRASYS PRIVATE LI,697.0,0.0,,2018,4,3,CASH_OUT,697.0,C1889395764
31700,409000362497',2018-04-03,Indiaforensic SERVICES INDIA PVT,488801.0,0.0,,2018,4,3,PAYEMENT,488801.0,M1378027138
31701,409000362497',2018-04-03,IMPS 0304183C,9156110.67,0.0,,2018,4,3,PAYEMENT,9156110.67,C778306577
31702,409000362497',2018-04-03,NEFT/SBIN818093753645/Indfor,0.0,6100000.0,,2018,4,3,CASH_IN,6100000.0,M1305555150
31703,409000362497',2018-04-03,FDRL/INTERNAL FUND TRANSFE,0.0,15000000.0,,2018,4,3,CHECK_CASHING,15000000.0,M275667646
31704,409000362497',2018-04-03,FDRL/INTERNAL FUND TRANSFE,0.0,10000000.0,,2018,4,3,TRANSFER,10000000.0,C1240091493
31705,409000362497',2018-04-03,IMPS 0304184C,2581939.0,0.0,,2018,4,3,CASH_OUT,2581939.0,C1047634424
31706,409000362497',2018-04-03,Sweep Trf To: 40900036427,736801.0,0.0,,2018,4,3,CASH_OUT,736801.0,M1574266109
31707,409000362497',2018-04-04,BIGTREE ENTERTAINMENT PRI,493.0,0.0,,2018,4,4,CHECK_WITHDRAWAL,493.0,M20648744
31708,409000362497',2018-04-04,INDIAIDEAS.COM LTD,21300.0,0.0,,2018,4,4,CASH_OUT,21300.0,M729762027
31709,409000362497',2018-04-04,IRCTC CORPORATE OFFICE AC,86225.0,0.0,,2018,4,4,PAYEMENT,86225.0,C1840046890
31710,409000362497',2018-04-04,PAYU PAYMENTS PRIVATE LIM,23248.0,0.0,,2018,4,4,DEBIT,23248.0,M1689480936
31711,409000362497',2018-04-04,AVENUES INDIA PRIVATE LIM,8177.0,0.0,,2018,4,4,PAYEMENT,8177.0,M2027253185
31712,409000362497',2018-04-04,SYNERGISTIC FINANCIAL NET,22.0,0.0,,2018,4,4,CHECK_WITHDRAWAL,22.0,C1343134043
31713,409000362497',2018-04-04,FUTURE RETAIL LIMITED (OW,849.0,0.0,,2018,4,4,CASH_OUT,849.0,M726132036
31714,409000362497',2018-04-04,PASFAR TECHNOLOGIES PRIVA,4300.0,0.0,,2018,4,4,CASH_OUT,4300.0,C1827559894
31715,409000362497',2018-04-04,MEHAR ENTERTAINMENT PRIVA,691.0,0.0,,2018,4,4,PAYEMENT,691.0,C645187727
31716,409000362497',2018-04-04,E-BILLING SOLUTIONS PRIVA,684.0,0.0,,2018,4,4,PAYEMENT,684.0,C1631408038
31717,409000362497',2018-04-04,QWIKCILVER SOLUTIONS PRIV,57395.0,0.0,,2018,4,4,CASH_OUT,57395.0,M1299361813
31718,409000362497',2018-04-04,Indiaforensic SERVICES INDIA PVT,211519.0,0.0,,2018,4,4,PAYEMENT,211519.0,M1834604114
31719,409000362497',2018-04-04,IMPS 030420181C,5643625.51,0.0,,2018,4,4,CASH_OUT,5643625.51,M1026611869
31720,409000362497',2018-04-04,IMPS 040420182C,3315463.89,0.0,,2018,4,4,CASH_OUT,3315463.89,M319871888
31721,409000362497',2018-04-04,IMPS 040420183C,8009271.41,0.0,,2018,4,4,DEBIT,8009271.41,C1782113663
31722,409000362497',2018-04-04,NEFT/AXIC180945064106/Indfor,0.0,10000000.0,,2018,4,4,TRANSFER,10000000.0,C1305830291
31723,409000362497',2018-04-04,NEFT/SBIN918094716693/Indfor,0.0,3500000.0,,2018,4,4,TRANSFER,3500000.0,M2062981400
31724,409000362497',2018-04-04,IMPS 0404184C,4605076.86,0.0,,2018,4,4,PAYEMENT,4605076.86,C563567188
31725,409000362497',2018-04-04,Sweep Trf To: 40900036427,470769.0,0.0,,2018,4,4,DEBIT,470769.0,M677330738
31726,409000362497',2018-04-05,IMPS 040420181C,5613715.73,0.0,,2018,4,5,CHECK_WITHDRAWAL,5613715.73,M1776363656
31727,409000362497',2018-04-05,IMPS 050420182C,3745541.8,0.0,,2018,4,5,DEBIT,3745541.8,M1984741883
31728,409000362497',2018-04-05,IMPS 050420183C,7955707.11,0.0,,2018,4,5,DEBIT,7955707.11,M173102693
31729,409000362497',2018-04-05,BIGTREE ENTERTAINMENT PRI,2162.0,0.0,,2018,4,5,DEBIT,2162.0,C22918364
31730,409000362497',2018-04-05,INDIAIDEAS.COM LTD,13152.0,0.0,,2018,4,5,DEBIT,13152.0,C749672494
31731,409000362497',2018-04-05,IRCTC CORPORATE OFFICE AC,101595.0,0.0,,2018,4,5,DEBIT,101595.0,C955397163
31732,409000362497',2018-04-05,PAYU PAYMENTS PRIVATE LIM,29870.0,0.0,,2018,4,5,CHECK_WITHDRAWAL,29870.0,M1626541210
31733,409000362497',2018-04-05,AVENUES INDIA PRIVATE LIM,8537.0,0.0,,2018,4,5,CHECK_WITHDRAWAL,8537.0,M1244730379
31734,409000362497',2018-04-05,FUTURE RETAIL LIMITED (OW,529.0,0.0,,2018,4,5,CASH_OUT,529.0,C525141182
31735,409000362497',2018-04-05,METRO INFRASYS PRIVATE LI,697.0,0.0,,2018,4,5,PAYEMENT,697.0,C1434651019
31736,409000362497',2018-04-05,PASFAR TECHNOLOGIES PRIVA,3273.0,0.0,,2018,4,5,DEBIT,3273.0,M339768658
31737,409000362497',2018-04-05,MEHAR ENTERTAINMENT PRIVA,2074.0,0.0,,2018,4,5,CHECK_WITHDRAWAL,2074.0,M373583099
31738,409000362497',2018-04-05,E-BILLING SOLUTIONS PRIVA,535.0,0.0,,2018,4,5,CASH_OUT,535.0,M1257727480
31739,409000362497',2018-04-05,VOUCHER ACTIVATION SERVIC,10320.0,0.0,,2018,4,5,DEBIT,10320.0,C1427825258
31740,409000362497',2018-04-05,Indiaforensic SERVICES INDIA PVT,203667.0,0.0,,2018,4,5,CHECK_WITHDRAWAL,203667.0,C643585161
31741,409000362497',2018-04-05,FDRL/INTERNAL FUND TRANSFE,0.0,10000000.0,,2018,4,5,CHECK_CASHING,10000000.0,M277164974
31742,409000362497',2018-04-05,FDRL/INTERNAL FUND TRANSFE,0.0,2000000.0,,2018,4,5,CASH_IN,2000000.0,M292719480
31743,409000362497',2018-04-05,IMPS 050418 4C,4571743.9,0.0,,2018,4,5,CASH_OUT,4571743.9,M728373334
31744,409000362497',2018-04-05,Sweep Trf To: 40900036427,432161.0,0.0,,2018,4,5,CHECK_WITHDRAWAL,432161.0,M474120093
31745,409000362497',2018-04-06,IMPS 050420181C,4664414.82,0.0,,2018,4,6,DEBIT,4664414.82,M798876609
31746,409000362497',2018-04-06,IMPS 060420182C,2210126.02,0.0,,2018,4,6,PAYEMENT,2210126.02,M1231018976
31747,409000362497',2018-04-06,IMPS 060420183C,6182202.53,0.0,,2018,4,6,CASH_OUT,6182202.53,C365212068
31748,409000362497',2018-04-06,BIGTREE ENTERTAINMENT PRI,2553.0,0.0,,2018,4,6,DEBIT,2553.0,C824197891
31749,409000362497',2018-04-06,INDIAIDEAS.COM LTD,51562.0,0.0,,2018,4,6,CASH_OUT,51562.0,C866970718
31750,409000362497',2018-04-06,IRCTC CORPORATE OFFICE AC,104695.0,0.0,,2018,4,6,CASH_OUT,104695.0,C15445402
31751,409000362497',2018-04-06,PAYU PAYMENTS PRIVATE LIM,37971.0,0.0,,2018,4,6,PAYEMENT,37971.0,C673068808
31752,409000362497',2018-04-06,AVENUES INDIA PRIVATE LIM,3171.0,0.0,,2018,4,6,DEBIT,3171.0,C85102332
31753,409000362497',2018-04-06,FUTURE RETAIL LIMITED (OW,570.0,0.0,,2018,4,6,CHECK_WITHDRAWAL,570.0,M2051976924
31754,409000362497',2018-04-06,METRO INFRASYS PRIVATE LI,697.0,0.0,,2018,4,6,DEBIT,697.0,M1247937540
31755,409000362497',2018-04-06,PASFAR TECHNOLOGIES PRIVA,3720.0,0.0,,2018,4,6,CHECK_WITHDRAWAL,3720.0,C1014923261
31756,409000362497',2018-04-06,DISH INFRA SERVICES PRIVA,1619.0,0.0,,2018,4,6,DEBIT,1619.0,C1062791125
31757,409000362497',2018-04-06,JUST DIAL LIMITED,392.0,0.0,,2018,4,6,PAYEMENT,392.0,M1584636132
31758,409000362497',2018-04-06,MEHAR ENTERTAINMENT PRIVA,2189.0,0.0,,2018,4,6,PAYEMENT,2189.0,M1792407296
31759,409000362497',2018-04-06,E-BILLING SOLUTIONS PRIVA,2399.0,0.0,,2018,4,6,DEBIT,2399.0,C1554282047
31760,409000362497',2018-04-06,Indiaforensic SERVICES INDIA PVT,241758.0,0.0,,2018,4,6,CASH_OUT,241758.0,C812586739
31761,409000362497',2018-04-06,FDRL/INTERNAL FUND TRANSFE,0.0,10000000.0,,2018,4,6,TRANSFER,10000000.0,M1312745318
31762,409000362497',2018-04-06,FDRL/INTERNAL FUND TRANSFE,0.0,4000000.0,,2018,4,6,CHECK_CASHING,4000000.0,M853987629
31763,409000362497',2018-04-06,IMPS 0604184C,4954735.99,0.0,,2018,4,6,DEBIT,4954735.99,M865304850
31764,409000362497',2018-04-06,Sweep Trf To: 40900036427,554999.0,0.0,,2018,4,6,CHECK_WITHDRAWAL,554999.0,C1170794006
31765,409000362497',2018-04-07,NEFT/SBIN218096504522/Indfor,0.0,3000000.0,,2018,4,7,TRANSFER,3000000.0,M620330073
31766,409000362497',2018-04-07,IMPS 060420181C,4881305.74,0.0,,2018,4,7,PAYEMENT,4881305.74,M143818552
31767,409000362497',2018-04-07,IMPS 070420182C,2663653.41,0.0,,2018,4,7,DEBIT,2663653.41,C1675375648
31768,409000362497',2018-04-07,IMPS 070420183C,7149753.89,0.0,,2018,4,7,CASH_OUT,7149753.89,M1523837465
31769,409000362497',2018-04-07,FDRL/INTERNAL FUND TRANSFE,0.0,5000000.0,,2018,4,7,CASH_IN,5000000.0,M1449434260
31770,409000362497',2018-04-07,FDRL/INTERNAL FUND TRANSFE,0.0,2000000.0,,2018,4,7,CASH_IN,2000000.0,M1324718202
31771,409000362497',2018-04-07,NEFT/AXIC180976983616/Indfor,0.0,4100000.0,,2018,4,7,CHECK_CASHING,4100000.0,M1683109641
31772,409000362497',2018-04-07,NEFT/SBIN318097592035/Indfor,0.0,4900000.0,,2018,4,7,CHECK_CASHING,4900000.0,M342239680
31773,409000362497',2018-04-07,IMPS 070420184C,4369122.15,0.0,,2018,4,7,DEBIT,4369122.15,C332911016
31774,409000362497',2018-04-07,Sweep Trf To: 40900036427,74018.76,0.0,,2018,4,7,CASH_OUT,74018.76,C1508456612
31775,409000362497',2018-04-07,Repayment credit [7090035,0.0,1433.0,,2018,4,7,CASH_IN,1433.0,C897697267
31776,409000362497',2018-04-09,IMPS 070420181C,4244125.49,0.0,,2018,4,9,CHECK_WITHDRAWAL,4244125.49,C1345886082
31777,409000362497',2018-04-09,IMPS 080420181C,12565873.54,0.0,,2018,4,9,PAYEMENT,12565873.54,M1000995775
31778,409000362497',2018-04-09,IMPS 090420182C,2669377.96,0.0,,2018,4,9,PAYEMENT,2669377.96,M1987158112
31779,409000362497',2018-04-09,IMPS 090420183C,7591172.65,0.0,,2018,4,9,CASH_OUT,7591172.65,M729490015
31780,409000362497',2018-04-09,BIGTREE ENTERTAINMENT PRI,9332.0,0.0,,2018,4,9,CHECK_WITHDRAWAL,9332.0,M1899022554
31781,409000362497',2018-04-09,INDIAIDEAS.COM LTD,120310.0,0.0,,2018,4,9,CHECK_WITHDRAWAL,120310.0,C1674513830
31782,409000362497',2018-04-09,IRCTC CORPORATE OFFICE AC,428310.0,0.0,,2018,4,9,CASH_OUT,428310.0,C403254166
31783,409000362497',2018-04-09,PAYU PAYMENTS PRIVATE LIM,100611.0,0.0,,2018,4,9,CASH_OUT,100611.0,C100555887
31784,409000362497',2018-04-09,AVENUES INDIA PRIVATE LIM,30680.0,0.0,,2018,4,9,CHECK_WITHDRAWAL,30680.0,C1619490345
31785,409000362497',2018-04-09,ZAAK EPAYMENT SERVICES PR,235.0,0.0,,2018,4,9,DEBIT,235.0,M484046511
31786,409000362497',2018-04-09,FUTURE RETAIL LIMITED (OW,13594.0,0.0,,2018,4,9,DEBIT,13594.0,M1612103641
31787,409000362497',2018-04-09,PASFAR TECHNOLOGIES PRIVA,6696.0,0.0,,2018,4,9,DEBIT,6696.0,C611621587
31788,409000362497',2018-04-09,DISH INFRA SERVICES PRIVA,829.0,0.0,,2018,4,9,PAYEMENT,829.0,C1406193485
31789,409000362497',2018-04-09,JUST DIAL LIMITED,441.0,0.0,,2018,4,9,CHECK_WITHDRAWAL,441.0,C111636207
31790,409000362497',2018-04-09,MEHAR ENTERTAINMENT PRIVA,18319.0,0.0,,2018,4,9,CHECK_WITHDRAWAL,18319.0,C1219273867
31791,409000362497',2018-04-09,E-BILLING SOLUTIONS PRIVA,646.0,0.0,,2018,4,9,CHECK_WITHDRAWAL,646.0,C1297873690
31792,409000362497',2018-04-09,ALT DIGITAL MEDIA ENTERTA,29.0,0.0,,2018,4,9,DEBIT,29.0,M1474601083
31793,409000362497',2018-04-09,Indiaforensic SERVICES INDIA PVT,729667.0,0.0,,2018,4,9,PAYEMENT,729667.0,M245196293
31794,409000362497',2018-04-09,NEFT/FDRL504548960/Indiaforensic,0.0,3000000.0,,2018,4,9,TRANSFER,3000000.0,M1860994773
31795,409000362497',2018-04-09,NEFT/SBIN418099568754/Indfor,0.0,4000000.0,,2018,4,9,CASH_IN,4000000.0,M461617080
31796,409000362497',2018-04-09,FDRL/INTERNAL FUND TRANSFE,0.0,10000000.0,,2018,4,9,CHECK_CASHING,10000000.0,C771303504
31797,409000362497',2018-04-09,FDRL/INTERNAL FUND TRANSFE,0.0,2000000.0,,2018,4,9,CHECK_CASHING,2000000.0,C1345063038
31798,409000362497',2018-04-09,IMPS 0409184C,4949515.14,0.0,,2018,4,9,DEBIT,4949515.14,M1730344127
31799,409000362497',2018-04-09,Sweep Trf From: 709003587,0.0,634651.74,,2018,4,9,TRANSFER,634651.74,M1788314833
31800,409000362497',2018-04-09,Repayment credit [7090035,0.0,2512.0,,2018,4,9,CASH_IN,2512.0,M784605324
31801,409000362497',2018-04-10,IMPS 090420181C,4782129.69,0.0,,2018,4,10,PAYEMENT,4782129.69,M2078775735
31802,409000362497',2018-04-10,IMPS 100420182C,3689222.68,0.0,,2018,4,10,CHECK_WITHDRAWAL,3689222.68,M929029380
31803,409000362497',2018-04-10,IMPS 100420183C,7469866.66,0.0,,2018,4,10,CHECK_WITHDRAWAL,7469866.66,M1552952509
31804,409000362497',2018-04-10,BIGTREE ENTERTAINMENT PRI,1390.0,0.0,,2018,4,10,PAYEMENT,1390.0,M798113115
31805,409000362497',2018-04-10,INDIAIDEAS.COM LTD,30611.0,0.0,,2018,4,10,CHECK_WITHDRAWAL,30611.0,M9914679
31806,409000362497',2018-04-10,IRCTC CORPORATE OFFICE AC,120570.0,0.0,,2018,4,10,CASH_OUT,120570.0,M996401219
31807,409000362497',2018-04-10,PAYU PAYMENTS PRIVATE LIM,2826.0,0.0,,2018,4,10,PAYEMENT,2826.0,C749013731
31808,409000362497',2018-04-10,AVENUES INDIA PRIVATE LIM,4610.0,0.0,,2018,4,10,PAYEMENT,4610.0,C124017533
31809,409000362497',2018-04-10,ZAAK EPAYMENT SERVICES PR,120.0,0.0,,2018,4,10,PAYEMENT,120.0,C2122200303
31810,409000362497',2018-04-10,FUTURE RETAIL LIMITED (OW,173.0,0.0,,2018,4,10,PAYEMENT,173.0,M454145489
31811,409000362497',2018-04-10,PASFAR TECHNOLOGIES PRIVA,1224.0,0.0,,2018,4,10,DEBIT,1224.0,C1331026587
31812,409000362497',2018-04-10,MEHAR ENTERTAINMENT PRIVA,4148.0,0.0,,2018,4,10,DEBIT,4148.0,M1043397496
31813,409000362497',2018-04-10,Indiaforensic SERVICES INDIA PVT,191870.0,0.0,,2018,4,10,PAYEMENT,191870.0,M1409460006
31814,409000362497',2018-04-10,FDRL/INTERNAL FUND TRANSFE,0.0,3000000.0,,2018,4,10,CASH_IN,3000000.0,M1513960545
31815,409000362497',2018-04-10,FDRL/INTERNAL FUND TRANSFE,0.0,3000000.0,,2018,4,10,TRANSFER,3000000.0,C979719862
31816,409000362497',2018-04-10,FDRL/INTERNAL FUND TRANSFE,0.0,1000000.0,,2018,4,10,TRANSFER,1000000.0,C1477979030
31817,409000362497',2018-04-10,FDRL/INTERNAL FUND TRANSFE,0.0,2000000.0,,2018,4,10,CHECK_CASHING,2000000.0,M1465097609
31818,409000362497',2018-04-10,FDRL/INTERNAL FUND TRANSFE,0.0,500000.0,,2018,4,10,TRANSFER,500000.0,C1153596299
31819,409000362497',2018-04-10,IMPS 100420184C,4433102.02,0.0,,2018,4,10,DEBIT,4433102.02,C611621587
31820,409000362497',2018-04-10,Sweep Trf From: 709001931,0.0,1810584.0,,2018,4,10,CASH_IN,1810584.0,C1827559894
31821,409000362497',2018-04-10,TO For 709001931954,0.0,52668.0,,2018,4,10,TRANSFER,52668.0,C1321640594
31822,409000362497',2018-04-11,TRF FROM  Indiaforensic SERVICES,0.0,15000000.0,,2018,4,11,CHECK_CASHING,15000000.0,M2100010849
31823,409000362497',2018-04-11,IMPS 100420181C,3524744.61,0.0,,2018,4,11,CASH_OUT,3524744.61,M1029964345
31824,409000362497',2018-04-11,IMPS 110420182C,1319843.42,0.0,,2018,4,11,CHECK_WITHDRAWAL,1319843.42,C1459757869
31825,409000362497',2018-04-11,IMPS 110420183C,9022743.11,0.0,,2018,4,11,CASH_OUT,9022743.11,M2049259784
31826,409000362497',2018-04-11,NEFT/SBIN618101492535/Indfor,0.0,3000000.0,,2018,4,11,CASH_IN,3000000.0,M2085987910
31827,409000362497',2018-04-11,FDRL/INTERNAL FUND TRANSFE,0.0,10000000.0,,2018,4,11,CASH_IN,10000000.0,M530067945
31828,409000362497',2018-04-11,FDRL/INTERNAL FUND TRANSFE,0.0,1000000.0,,2018,4,11,TRANSFER,1000000.0,M1160097942
31829,409000362497',2018-04-11,FDRL/INTERNAL FUND TRANSFE,0.0,2000000.0,,2018,4,11,CHECK_CASHING,2000000.0,M1649630049
31830,409000362497',2018-04-11,IMPS 1104184C,5783087.25,0.0,,2018,4,11,CASH_OUT,5783087.25,M77137168
31831,409000362497',2018-04-11,Sweep Trf From: 709002457,0.0,1577552.05,,2018,4,11,CASH_IN,1577552.05,M286091342
31832,409000362497',2018-04-12,BIGTREE ENTERTAINMENT PRI,987.0,0.0,,2018,4,12,CASH_OUT,987.0,M872484912
31833,409000362497',2018-04-12,INDIAIDEAS.COM LTD,38077.0,0.0,,2018,4,12,CASH_OUT,38077.0,M1245675010
31834,409000362497',2018-04-12,IRCTC CORPORATE OFFICE AC,161840.0,0.0,,2018,4,12,PAYEMENT,161840.0,M1866180564
31835,409000362497',2018-04-12,PAYU PAYMENTS PRIVATE LIM,7780.0,0.0,,2018,4,12,DEBIT,7780.0,M1070890456
31836,409000362497',2018-04-12,AVENUES INDIA PRIVATE LIM,4253.0,0.0,,2018,4,12,CHECK_WITHDRAWAL,4253.0,M1667399890
31837,409000362497',2018-04-12,ZAAK EPAYMENT SERVICES PR,278.0,0.0,,2018,4,12,PAYEMENT,278.0,M660445184
31838,409000362497',2018-04-12,FUTURE RETAIL LIMITED (OW,398.0,0.0,,2018,4,12,CHECK_WITHDRAWAL,398.0,M757577620
31839,409000362497',2018-04-12,PASFAR TECHNOLOGIES PRIVA,6148.0,0.0,,2018,4,12,PAYEMENT,6148.0,M95018293
31840,409000362497',2018-04-12,MEHAR ENTERTAINMENT PRIVA,2420.0,0.0,,2018,4,12,CHECK_WITHDRAWAL,2420.0,C76471942
31841,409000362497',2018-04-12,E-BILLING SOLUTIONS PRIVA,500.0,0.0,,2018,4,12,DEBIT,500.0,C580735116
31842,409000362497',2018-04-12,VOUCHER ACTIVATION SERVIC,20951.0,0.0,,2018,4,12,DEBIT,20951.0,C896393489
31843,409000362497',2018-04-12,QWIKCILVER SOLUTIONS PRIV,27967.0,0.0,,2018,4,12,CHECK_WITHDRAWAL,27967.0,C751041776
31844,409000362497',2018-04-12,Indiaforensic SERVICES INDIA PVT,276658.0,0.0,,2018,4,12,PAYEMENT,276658.0,M1589594051
31845,409000362497',2018-04-12,IMPS 110420181C,4682853.41,0.0,,2018,4,12,PAYEMENT,4682853.41,C1011433682
31846,409000362497',2018-04-12,IMPS 120420182C,2653150.99,0.0,,2018,4,12,PAYEMENT,2653150.99,C155439298
31847,409000362497',2018-04-12,BIGTREE ENTERTAINMENT PRI,699.0,0.0,,2018,4,12,DEBIT,699.0,M1797951272
31848,409000362497',2018-04-12,INDIAIDEAS.COM LTD,37379.0,0.0,,2018,4,12,PAYEMENT,37379.0,M315927727
31849,409000362497',2018-04-12,IRCTC CORPORATE OFFICE AC,118410.0,0.0,,2018,4,12,PAYEMENT,118410.0,C114159191
31850,409000362497',2018-04-12,AVENUES INDIA PRIVATE LIM,2746.0,0.0,,2018,4,12,PAYEMENT,2746.0,C1735367878
31851,409000362497',2018-04-12,ZAAK EPAYMENT SERVICES PR,149.0,0.0,,2018,4,12,CASH_OUT,149.0,M1876811488
31852,409000362497',2018-04-12,FUTURE RETAIL LIMITED (OW,797.0,0.0,,2018,4,12,CASH_OUT,797.0,M875229716
31853,409000362497',2018-04-12,METRO INFRASYS PRIVATE LI,697.0,0.0,,2018,4,12,DEBIT,697.0,C553602983
31854,409000362497',2018-04-12,DISH INFRA SERVICES PRIVA,3419.0,0.0,,2018,4,12,CASH_OUT,3419.0,M1535797200
31855,409000362497',2018-04-12,MEHAR ENTERTAINMENT PRIVA,923.0,0.0,,2018,4,12,CHECK_WITHDRAWAL,923.0,M155924815
31856,409000362497',2018-04-12,LOCALCUBE COMMERCE PRIVAT,37192.0,0.0,,2018,4,12,CHECK_WITHDRAWAL,37192.0,M1846182983
31857,409000362497',2018-04-12,MUZAFFARPUR VIDYUT VITARA,145.0,0.0,,2018,4,12,PAYEMENT,145.0,M445352088
31858,409000362497',2018-04-12,Indiaforensic SERVICES INDIA PVT,215978.0,0.0,,2018,4,12,CHECK_WITHDRAWAL,215978.0,M1889666729
31859,409000362497',2018-04-12,IMPS 120420183C,6344836.81,0.0,,2018,4,12,PAYEMENT,6344836.81,M778563460
31860,409000362497',2018-04-12,NEFT/SBIN718102357562/Indfor,0.0,14900000.0,,2018,4,12,CASH_IN,14900000.0,C1247615506
31861,409000362497',2018-04-12,FDRL/INTERNAL FUND TRANSFE,0.0,5000000.0,,2018,4,12,CASH_IN,5000000.0,C1414581773
31862,409000362497',2018-04-12,IMPS 120420184C,4169832.64,0.0,,2018,4,12,CASH_OUT,4169832.64,C734236179
31863,409000362497',2018-04-13,IMPS 120420181C,5034900.85,0.0,,2018,4,13,CHECK_WITHDRAWAL,5034900.85,C754244871
31864,409000362497',2018-04-13,IMPS 120420182C,3033116.08,0.0,,2018,4,13,CASH_OUT,3033116.08,C1092465037
31865,409000362497',2018-04-13,BIGTREE ENTERTAINMENT PRI,446.0,0.0,,2018,4,13,DEBIT,446.0,C1327907419
31866,409000362497',2018-04-13,INDIAIDEAS.COM LTD,17743.0,0.0,,2018,4,13,CASH_OUT,17743.0,C1031639563
31867,409000362497',2018-04-13,IRCTC CORPORATE OFFICE AC,157190.0,0.0,,2018,4,13,CHECK_WITHDRAWAL,157190.0,C580431625
31868,409000362497',2018-04-13,PAYU PAYMENTS PRIVATE LIM,56640.0,0.0,,2018,4,13,CASH_OUT,56640.0,C531593626
31869,409000362497',2018-04-13,AVENUES INDIA PRIVATE LIM,29399.0,0.0,,2018,4,13,DEBIT,29399.0,M227810278
31870,409000362497',2018-04-13,ZAAK EPAYMENT SERVICES PR,278.0,0.0,,2018,4,13,PAYEMENT,278.0,M2081204290
31871,409000362497',2018-04-13,FUTURE RETAIL LIMITED (OW,137.0,0.0,,2018,4,13,CHECK_WITHDRAWAL,137.0,C1178471274
31872,409000362497',2018-04-13,PASFAR TECHNOLOGIES PRIVA,1049.0,0.0,,2018,4,13,CHECK_WITHDRAWAL,1049.0,C2022767113
31873,409000362497',2018-04-13,DISH INFRA SERVICES PRIVA,369.0,0.0,,2018,4,13,DEBIT,369.0,C686592713
31874,409000362497',2018-04-13,JUST DIAL LIMITED,392.0,0.0,,2018,4,13,DEBIT,392.0,C823592993
31875,409000362497',2018-04-13,MEHAR ENTERTAINMENT PRIVA,2650.0,0.0,,2018,4,13,CASH_OUT,2650.0,C1049804269
31876,409000362497',2018-04-13,Indiaforensic SERVICES INDIA PVT,259910.0,0.0,,2018,4,13,DEBIT,259910.0,C651445737
31877,409000362497',2018-04-13,IMPS 130420183C,7879780.26,0.0,,2018,4,13,CASH_OUT,7879780.26,C1790598448
31878,409000362497',2018-04-13,FDRL/INTERNAL FUND TRANSFE,0.0,5000000.0,,2018,4,13,TRANSFER,5000000.0,C2034160388
31879,409000362497',2018-04-13,FDRL/INTERNAL FUND TRANSFE,0.0,5000000.0,,2018,4,13,CHECK_CASHING,5000000.0,C388286025
31880,409000362497',2018-04-13,FDRL/INTERNAL FUND TRANSFE,0.0,10000000.0,,2018,4,13,TRANSFER,10000000.0,C2041281014
31881,409000362497',2018-04-13,FDRL/INTERNAL FUND TRANSFE,0.0,5000000.0,,2018,4,13,TRANSFER,5000000.0,C1263845074
31882,409000362497',2018-04-13,FDRL/INTERNAL FUND TRANSFE,0.0,1000000.0,,2018,4,13,CASH_IN,1000000.0,C1684776894
31883,409000362497',2018-04-13,IMPS 130420184C,5062434.05,0.0,,2018,4,13,CASH_OUT,5062434.05,C1404112538
31884,409000362497',2018-04-16,IMPS 130420181C,4222945.94,0.0,,2018,4,16,CASH_OUT,4222945.94,C1476213591
31885,409000362497',2018-04-16,IMPS 140420181C,10542107.39,0.0,,2018,4,16,CASH_OUT,10542107.39,C145693769
31886,409000362497',2018-04-16,IMPS 150420181C,709922.2,0.0,,2018,4,16,CHECK_WITHDRAWAL,709922.2,C928023753
31887,409000362497',2018-04-16,IMPS 160420182C,7323561.68,0.0,,2018,4,16,CHECK_WITHDRAWAL,7323561.68,M1218372614
31888,409000362497',2018-04-16,IMPS 160420183C,10163094.78,0.0,,2018,4,16,PAYEMENT,10163094.78,C1639464943
31889,409000362497',2018-04-16,NEFT/SBIN918106382669/Indfor,0.0,3000000.0,,2018,4,16,CASH_IN,3000000.0,M1434420616
31890,409000362497',2018-04-16,FDRL/INTERNAL FUND TRANSFE,0.0,15000000.0,,2018,4,16,TRANSFER,15000000.0,M395253303
31891,409000362497',2018-04-16,FDRL/INTERNAL FUND TRANSFE,0.0,15000000.0,,2018,4,16,TRANSFER,15000000.0,M1911144089
31892,409000362497',2018-04-16,FDRL/INTERNAL FUND TRANSFE,0.0,2000000.0,,2018,4,16,CASH_IN,2000000.0,C1179975227
31893,409000362497',2018-04-16,IMPS 810619065495 FROM OX,0.0,200000.0,,2018,4,16,TRANSFER,200000.0,M1119399738
31894,409000362497',2018-04-16,IMPS 810619065532 FROM OX,0.0,200000.0,,2018,4,16,CHECK_CASHING,200000.0,M1067305473
31895,409000362497',2018-04-16,IMPS 810619065568 FROM OX,0.0,200000.0,,2018,4,16,TRANSFER,200000.0,M436544935
31896,409000362497',2018-04-16,IMPS 810619065621 FROM OX,0.0,200000.0,,2018,4,16,CASH_IN,200000.0,M2077494563
31897,409000362497',2018-04-16,IMPS 810619065655 FROM OX,0.0,200000.0,,2018,4,16,TRANSFER,200000.0,C1338852367
31898,409000362497',2018-04-16,IMPS 810619065699 FROM OX,0.0,200000.0,,2018,4,16,CASH_IN,200000.0,M600883812
31899,409000362497',2018-04-16,IMPS 810619065727 FROM OX,0.0,200000.0,,2018,4,16,CASH_IN,200000.0,M543190118
31900,409000362497',2018-04-16,IMPS 810619065765 FROM OX,0.0,200000.0,,2018,4,16,TRANSFER,200000.0,M938881084
31901,409000362497',2018-04-16,IMPS 810619066030 FROM OX,0.0,200000.0,,2018,4,16,CASH_IN,200000.0,M1599741809
31902,409000362497',2018-04-16,IMPS 1604184C,5524708.13,0.0,,2018,4,16,DEBIT,5524708.13,M1261860453
31903,409000362497',2018-04-17,BIGTREE ENTERTAINMENT PRI,7503.0,0.0,,2018,4,17,DEBIT,7503.0,M1781710573
31904,409000362497',2018-04-17,IRCTC CORPORATE OFFICE AC,520140.0,0.0,,2018,4,17,DEBIT,520140.0,M1631239625
31905,409000362497',2018-04-17,PAYU PAYMENTS PRIVATE LIM,65222.0,0.0,,2018,4,17,CASH_OUT,65222.0,M523780905
31906,409000362497',2018-04-17,AVENUES INDIA PRIVATE LIM,11150.0,0.0,,2018,4,17,CASH_OUT,11150.0,M152255011
31907,409000362497',2018-04-17,ZAAK EPAYMENT SERVICES PR,563.0,0.0,,2018,4,17,CHECK_WITHDRAWAL,563.0,M645902493
31908,409000362497',2018-04-17,FUTURE RETAIL LIMITED (OW,10747.0,0.0,,2018,4,17,DEBIT,10747.0,M320783887
31909,409000362497',2018-04-17,PASFAR TECHNOLOGIES PRIVA,3305.0,0.0,,2018,4,17,DEBIT,3305.0,M796141841
31910,409000362497',2018-04-17,DISH INFRA SERVICES PRIVA,215.0,0.0,,2018,4,17,DEBIT,215.0,M673371290
31911,409000362497',2018-04-17,JUST DIAL LIMITED,190.0,0.0,,2018,4,17,DEBIT,190.0,M1991659796
31912,409000362497',2018-04-17,MEHAR ENTERTAINMENT PRIVA,7143.0,0.0,,2018,4,17,DEBIT,7143.0,M1334586241
31913,409000362497',2018-04-17,E-BILLING SOLUTIONS PRIVA,5183.0,0.0,,2018,4,17,CHECK_WITHDRAWAL,5183.0,M1437668715
31914,409000362497',2018-04-17,ALT DIGITAL MEDIA ENTERTA,196.0,0.0,,2018,4,17,CHECK_WITHDRAWAL,196.0,M789978772
31915,409000362497',2018-04-17,Indiaforensic SERVICES INDIA PVT,508526.0,0.0,,2018,4,17,DEBIT,508526.0,C1136186114
31916,409000362497',2018-04-17,IMPS 160420181C,6151877.75,0.0,,2018,4,17,CASH_OUT,6151877.75,M2069273617
31917,409000362497',2018-04-17,IMPS 170420182C,3918810.11,0.0,,2018,4,17,PAYEMENT,3918810.11,C2122967975
31918,409000362497',2018-04-17,BIGTREE ENTERTAINMENT PRI,359.0,0.0,,2018,4,17,DEBIT,359.0,C1380698841
31919,409000362497',2018-04-17,INDIAIDEAS.COM LTD,99633.0,0.0,,2018,4,17,CHECK_WITHDRAWAL,99633.0,M1286329293
31920,409000362497',2018-04-17,IRCTC CORPORATE OFFICE AC,159180.0,0.0,,2018,4,17,PAYEMENT,159180.0,C644345897
31921,409000362497',2018-04-17,PAYU PAYMENTS PRIVATE LIM,19775.0,0.0,,2018,4,17,PAYEMENT,19775.0,C488624810
31922,409000362497',2018-04-17,BIDDERBOY CORPORATION,146.0,0.0,,2018,4,17,CASH_OUT,146.0,C435161028
31923,409000362497',2018-04-17,AVENUES INDIA PRIVATE LIM,6175.0,0.0,,2018,4,17,PAYEMENT,6175.0,C2044792756
31924,409000362497',2018-04-17,FUTURE RETAIL LIMITED (OW,332.0,0.0,,2018,4,17,CASH_OUT,332.0,C1189106564
31925,409000362497',2018-04-17,METRO INFRASYS PRIVATE LI,697.0,0.0,,2018,4,17,CHECK_WITHDRAWAL,697.0,M618021955
31926,409000362497',2018-04-17,PASFAR TECHNOLOGIES PRIVA,2448.0,0.0,,2018,4,17,CHECK_WITHDRAWAL,2448.0,C1621383518
31927,409000362497',2018-04-17,JUST DIAL LIMITED,150.0,0.0,,2018,4,17,DEBIT,150.0,C1479557064
31928,409000362497',2018-04-17,E-BILLING SOLUTIONS PRIVA,2397.0,0.0,,2018,4,17,CHECK_WITHDRAWAL,2397.0,M1739144712
31929,409000362497',2018-04-17,Indiaforensic SERVICES INDIA PVT,229388.0,0.0,,2018,4,17,DEBIT,229388.0,C82311106
31930,409000362497',2018-04-17,IMPS 170420183C,8447661.36,0.0,,2018,4,17,PAYEMENT,8447661.36,M1283839671
31931,409000362497',2018-04-17,NEFT/SBIN118107394970/Indfor,0.0,3800000.0,,2018,4,17,CASH_IN,3800000.0,M311808843
31932,409000362497',2018-04-17,NEFT/AXIC181079831426/Indfor,0.0,4000000.0,,2018,4,17,CASH_IN,4000000.0,M72869829
31933,409000362497',2018-04-17,FDRL/INTERNAL FUND TRANSFE,0.0,5000000.0,,2018,4,17,CASH_IN,5000000.0,M1294019980
31934,409000362497',2018-04-17,FDRL/INTERNAL FUND TRANSFE,0.0,5000000.0,,2018,4,17,TRANSFER,5000000.0,C710987073
31935,409000362497',2018-04-17,FDRL/INTERNAL FUND TRANSFE,0.0,4000000.0,,2018,4,17,CHECK_CASHING,4000000.0,C1684776894
31936,409000362497',2018-04-17,FDRL/INTERNAL FUND TRANSFE,0.0,500000.0,,2018,4,17,CHECK_CASHING,500000.0,M500670098
31937,409000362497',2018-04-17,IMPS 1704184C,5146982.62,0.0,,2018,4,17,PAYEMENT,5146982.62,M865979877
31938,409000362497',2018-04-18,IMPS 1704183C,4411729.27,0.0,,2018,4,18,DEBIT,4411729.27,M1070028287
31939,409000362497',2018-04-18,IMPS 1804183C,2889493.34,0.0,,2018,4,18,DEBIT,2889493.34,M154598872
31940,409000362497',2018-04-18,NEFT/AXIC181080090721/Indfor,0.0,4000000.0,,2018,4,18,TRANSFER,4000000.0,C776447774
31941,409000362497',2018-04-18,FDRL/INTERNAL FUND TRANSFE,0.0,10000000.0,,2018,4,18,TRANSFER,10000000.0,M578204010
31942,409000362497',2018-04-18,NEFT/SBIN218108298960/Indfor,0.0,2000000.0,,2018,4,18,CASH_IN,2000000.0,M2127986898
31943,409000362497',2018-04-18,FDRL/INTERNAL FUND TRANSFE,0.0,2000000.0,,2018,4,18,TRANSFER,2000000.0,C1106744673
31944,409000362497',2018-04-18,FDRL/INTERNAL FUND TRANSFE,0.0,500000.0,,2018,4,18,CHECK_CASHING,500000.0,M2120400365
31945,409000362497',2018-04-18,FDRL/INTERNAL FUND TRANSFE,0.0,500000.0,,2018,4,18,TRANSFER,500000.0,C159359298
31946,409000362497',2018-04-18,IMPS 1804183C,7021123.22,0.0,,2018,4,18,DEBIT,7021123.22,C2049813033
31947,409000362497',2018-04-18,IMPS 1804184C,4749470.05,0.0,,2018,4,18,CASH_OUT,4749470.05,M413141393
31948,409000362497',2018-04-19,IMPS 1804184C,4349207.38,0.0,,2018,4,19,PAYEMENT,4349207.38,M146215825
31949,409000362497',2018-04-19,IMPS 1904182C,2445441.48,0.0,,2018,4,19,CASH_OUT,2445441.48,C440708502
31950,409000362497',2018-04-19,BIGTREE ENTERTAINMENT PRI,3312.0,0.0,,2018,4,19,DEBIT,3312.0,C1325349830
31951,409000362497',2018-04-19,INDIAIDEAS.COM LTD,29585.0,0.0,,2018,4,19,CHECK_WITHDRAWAL,29585.0,C2022767113
31952,409000362497',2018-04-19,IRCTC CORPORATE OFFICE AC,193135.0,0.0,,2018,4,19,CASH_OUT,193135.0,M1951849857
31953,409000362497',2018-04-19,PAYU PAYMENTS PRIVATE LIM,28878.0,0.0,,2018,4,19,CASH_OUT,28878.0,M115673470
31954,409000362497',2018-04-19,BIDDERBOY CORPORATION,877.0,0.0,,2018,4,19,CASH_OUT,877.0,C1004330633
31955,409000362497',2018-04-19,AVENUES INDIA PRIVATE LIM,7438.0,0.0,,2018,4,19,CHECK_WITHDRAWAL,7438.0,C1562773081
31956,409000362497',2018-04-19,PASFAR TECHNOLOGIES PRIVA,2151.0,0.0,,2018,4,19,DEBIT,2151.0,C941250063
31957,409000362497',2018-04-19,JUST DIAL LIMITED,146.0,0.0,,2018,4,19,DEBIT,146.0,C551505628
31958,409000362497',2018-04-19,MEHAR ENTERTAINMENT PRIVA,3802.0,0.0,,2018,4,19,DEBIT,3802.0,C583769148
31959,409000362497',2018-04-19,VOUCHER ACTIVATION SERVIC,15889.0,0.0,,2018,4,19,CASH_OUT,15889.0,C1024818788
31960,409000362497',2018-04-19,Indiaforensic SERVICES INDIA PVT,274431.0,0.0,,2018,4,19,CHECK_WITHDRAWAL,274431.0,C1394526584
31961,409000362497',2018-04-19,IMPS 1904183C,6539841.9,0.0,,2018,4,19,DEBIT,6539841.9,M1807685891
31962,409000362497',2018-04-19,NEFT/SBIN318109156333/Indfor,0.0,5200000.0,,2018,4,19,CASH_IN,5200000.0,C1929496638
31963,409000362497',2018-04-19,FDRL/INTERNAL FUND TRANSFE,0.0,10000000.0,,2018,4,19,TRANSFER,10000000.0,C339099861
31964,409000362497',2018-04-19,FDRL/INTERNAL FUND TRANSFE,0.0,4000000.0,,2018,4,19,CASH_IN,4000000.0,C1983541759
31965,409000362497',2018-04-19,IMPS 1904184C,4431103.64,0.0,,2018,4,19,DEBIT,4431103.64,M1749368969
31966,409000362497',2018-04-20,IMPS 1904181C,4356020.35,0.0,,2018,4,20,CHECK_WITHDRAWAL,4356020.35,M1939063502
31967,409000362497',2018-04-20,IMPS 2004182C,2761797.54,0.0,,2018,4,20,DEBIT,2761797.54,M855715576
31968,409000362497',2018-04-20,IMPS 2004183C,6271844.99,0.0,,2018,4,20,PAYEMENT,6271844.99,C1403282300
31969,409000362497',2018-04-20,NEFT/SBIN418110032848/Indfor,0.0,4700000.0,,2018,4,20,CHECK_CASHING,4700000.0,C1335050193
31970,409000362497',2018-04-20,IMPS 811019227545 FROM OX,0.0,200000.0,,2018,4,20,TRANSFER,200000.0,M292668777
31971,409000362497',2018-04-20,IMPS 811019227590 FROM OX,0.0,200000.0,,2018,4,20,CHECK_CASHING,200000.0,M1034584638
31972,409000362497',2018-04-20,IMPS 811019227634 FROM OX,0.0,200000.0,,2018,4,20,TRANSFER,200000.0,C1937962514
31973,409000362497',2018-04-20,IMPS 811019227674 FROM OX,0.0,200000.0,,2018,4,20,CASH_IN,200000.0,M1968792104
31974,409000362497',2018-04-20,IMPS 811019227717 FROM OX,0.0,200000.0,,2018,4,20,CASH_IN,200000.0,C672302234
31975,409000362497',2018-04-20,IMPS 811019227760 FROM OX,0.0,200000.0,,2018,4,20,CHECK_CASHING,200000.0,M758960826
31976,409000362497',2018-04-20,IMPS 811019227798 FROM OX,0.0,200000.0,,2018,4,20,TRANSFER,200000.0,M1378768764
31977,409000362497',2018-04-20,IMPS 811019227843 FROM OX,0.0,200000.0,,2018,4,20,CHECK_CASHING,200000.0,M2124035511
31978,409000362497',2018-04-20,IMPS 811019227907 FROM OX,0.0,200000.0,,2018,4,20,TRANSFER,200000.0,M415967410
31979,409000362497',2018-04-20,IMPS 811019227934 FROM OX,0.0,200000.0,,2018,4,20,CHECK_CASHING,200000.0,M1176480025
31980,409000362497',2018-04-20,FDRL/INTERNAL FUND TRANSFE,0.0,4000000.0,,2018,4,20,CHECK_CASHING,4000000.0,M1326264003
31981,409000362497',2018-04-20,IMPS 811019229413 FROM OX,0.0,200000.0,,2018,4,20,CHECK_CASHING,200000.0,M633824154
31982,409000362497',2018-04-20,IMPS 811019229450 FROM OX,0.0,100000.0,,2018,4,20,CHECK_CASHING,100000.0,M495892013
31983,409000362497',2018-04-20,IMPS 811019229485 FROM OX,0.0,200000.0,,2018,4,20,TRANSFER,200000.0,C1790096045
31984,409000362497',2018-04-20,IMPS 811019229527 FROM OX,0.0,200000.0,,2018,4,20,TRANSFER,200000.0,M1661464810
31985,409000362497',2018-04-20,FDRL/INTERNAL FUND TRANSFE,0.0,500000.0,,2018,4,20,TRANSFER,500000.0,M1423294271
31986,409000362497',2018-04-20,IMPS 811019229562 FROM OX,0.0,200000.0,,2018,4,20,CASH_IN,200000.0,C1163480574
31987,409000362497',2018-04-20,IMPS 811019229608 FROM OX,0.0,200000.0,,2018,4,20,CASH_IN,200000.0,C921424481
31988,409000362497',2018-04-20,IMPS 2004184C,3975355.1,0.0,,2018,4,20,PAYEMENT,3975355.1,M268534622
31989,409000362497',2018-04-21,IMPS 2004181C,3625575.88,0.0,,2018,4,21,PAYEMENT,3625575.88,C256516555
31990,409000362497',2018-04-21,IMPS 2104182C,2214488.48,0.0,,2018,4,21,CHECK_WITHDRAWAL,2214488.48,M1668173782
31991,409000362497',2018-04-21,NEFT/BARBU18111104913/BAN,0.0,1960.0,,2018,4,21,TRANSFER,1960.0,M475779030
31992,409000362497',2018-04-21,FDRL/INTERNAL FUND TRANSFE,0.0,10000000.0,,2018,4,21,CASH_IN,10000000.0,C1981752351
31993,409000362497',2018-04-21,FDRL/INTERNAL FUND TRANSFE,0.0,2000000.0,,2018,4,21,CASH_IN,2000000.0,M2010533694
31994,409000362497',2018-04-21,FDRL/INTERNAL FUND TRANSFE,0.0,6000000.0,,2018,4,21,TRANSFER,6000000.0,M1173681213
31995,409000362497',2018-04-21,IMPS 2104184C,6159798.53,0.0,,2018,4,21,DEBIT,6159798.53,M1852691786
31996,409000362497',2018-04-21,NEFT/SBIN418111805638/Indfor,0.0,5000000.0,,2018,4,21,CHECK_CASHING,5000000.0,C672302234
31997,409000362497',2018-04-21,IMPS 2104184C,2939780.06,0.0,,2018,4,21,CHECK_WITHDRAWAL,2939780.06,C1421330107
31998,409000362497',2018-04-23,IMPS 210420181C,4197056.86,0.0,,2018,4,23,DEBIT,4197056.86,C372017580
31999,409000362497',2018-04-23,IMPS 220420181C,4194826.85,0.0,,2018,4,23,PAYEMENT,4194826.85,C1655743612
32000,409000362497',2018-04-23,IMPS 230420182C,5048968.55,0.0,,2018,4,23,CHECK_WITHDRAWAL,5048968.55,C1897050650
32001,409000362497',2018-04-23,NEFT/SBIN518113473946/Indfor,0.0,7500000.0,,2018,4,23,CHECK_CASHING,7500000.0,C115095474
32002,409000362497',2018-04-23,FDRL/INTERNAL FUND TRANSFE,0.0,7000000.0,,2018,4,23,CASH_IN,7000000.0,C1925300085
32003,409000362497',2018-04-23,FDRL/INTERNAL FUND TRANSFE,0.0,8000000.0,,2018,4,23,CASH_IN,8000000.0,C446905487
32004,409000362497',2018-04-23,IMPS 230420183C,8717097.1,0.0,,2018,4,23,PAYEMENT,8717097.1,C2059996587
32005,409000362497',2018-04-23,IMPS 230420184C,4356892.94,0.0,,2018,4,23,PAYEMENT,4356892.94,C1950696591
32006,409000362497',2018-04-24,IMPS 230420181C,2394158.02,0.0,,2018,4,24,CASH_OUT,2394158.02,C68113386
32007,409000362497',2018-04-24,IMPS 240420182C,3988684.92,0.0,,2018,4,24,PAYEMENT,3988684.92,C1446521801
32008,409000362497',2018-04-24,BIGTREE ENTERTAINMENT PRI,2194.0,0.0,,2018,4,24,CHECK_WITHDRAWAL,2194.0,C1593015411
32009,409000362497',2018-04-24,IRCTC CORPORATE OFFICE AC,94760.0,0.0,,2018,4,24,PAYEMENT,94760.0,C2106812355
32010,409000362497',2018-04-24,PAYU PAYMENTS PRIVATE LIM,22113.0,0.0,,2018,4,24,DEBIT,22113.0,C1808652004
32011,409000362497',2018-04-24,AVENUES INDIA PRIVATE LIM,9250.0,0.0,,2018,4,24,PAYEMENT,9250.0,C1809373351
32012,409000362497',2018-04-24,FUTURE RETAIL LIMITED (OW,782.0,0.0,,2018,4,24,PAYEMENT,782.0,C1943497629
32013,409000362497',2018-04-24,PASFAR TECHNOLOGIES PRIVA,6138.0,0.0,,2018,4,24,DEBIT,6138.0,C1132795252
32014,409000362497',2018-04-24,VOYLLA FASHIONS PRIVATE L,684.0,0.0,,2018,4,24,PAYEMENT,684.0,C2012808675
32015,409000362497',2018-04-24,MEHAR ENTERTAINMENT PRIVA,1152.0,0.0,,2018,4,24,DEBIT,1152.0,C1692434834
32016,409000362497',2018-04-24,VOUCHER ACTIVATION SERVIC,7903.0,0.0,,2018,4,24,PAYEMENT,7903.0,C1910163007
32017,409000362497',2018-04-24,QWIKCILVER SOLUTIONS PRIV,6464.0,0.0,,2018,4,24,DEBIT,6464.0,C232812328
32018,409000362497',2018-04-24,Indiaforensic SERVICES INDIA PVT,299733.0,0.0,,2018,4,24,CASH_OUT,299733.0,C1476213591
32019,409000362497',2018-04-24,BIGTREE ENTERTAINMENT PRI,13777.0,0.0,,2018,4,24,DEBIT,13777.0,C1408337297
32020,409000362497',2018-04-24,INDIAIDEAS.COM LTD,155023.0,0.0,,2018,4,24,PAYEMENT,155023.0,C634440506
32021,409000362497',2018-04-24,IRCTC CORPORATE OFFICE AC,661715.0,0.0,,2018,4,24,CASH_OUT,661715.0,C394935572
32022,409000362497',2018-04-24,PAYU PAYMENTS PRIVATE LIM,135831.0,0.0,,2018,4,24,DEBIT,135831.0,C301121080
32023,409000362497',2018-04-24,AVENUES INDIA PRIVATE LIM,68993.0,0.0,,2018,4,24,PAYEMENT,68993.0,C904861071
32024,409000362497',2018-04-24,FUTURE RETAIL LIMITED (OW,15667.0,0.0,,2018,4,24,CHECK_WITHDRAWAL,15667.0,C619068319
32025,409000362497',2018-04-24,PASFAR TECHNOLOGIES PRIVA,23854.0,0.0,,2018,4,24,CHECK_WITHDRAWAL,23854.0,C943512909
32026,409000362497',2018-04-24,MEHAR ENTERTAINMENT PRIVA,15669.0,0.0,,2018,4,24,PAYEMENT,15669.0,M1480280218
32027,409000362497',2018-04-24,E-BILLING SOLUTIONS PRIVA,54126.0,0.0,,2018,4,24,CHECK_WITHDRAWAL,54126.0,M255980706
32028,409000362497',2018-04-24,JUST DIAL LIMITED,1225.0,0.0,,2018,4,24,CHECK_WITHDRAWAL,1225.0,M427249966
32029,409000362497',2018-04-24,QWIKCILVER SOLUTIONS PRIV,19451.0,0.0,,2018,4,24,DEBIT,19451.0,M186249907
32030,409000362497',2018-04-24,AXEL RETAIL PRIVATE LIMIT,140.0,0.0,,2018,4,24,PAYEMENT,140.0,M1722440049
32031,409000362497',2018-04-24,SYNERGISTIC FINANCIAL NET,91.0,0.0,,2018,4,24,CASH_OUT,91.0,C1104197405
32032,409000362497',2018-04-24,ZAAK EPAYMENT SERVICES PR,218.0,0.0,,2018,4,24,CHECK_WITHDRAWAL,218.0,C2145961947
32033,409000362497',2018-04-24,DIGIVIVE SERVICES PRIVATE,144.0,0.0,,2018,4,24,PAYEMENT,144.0,M197837136
32034,409000362497',2018-04-24,Indiaforensic SERVICES INDIA PVT,1090598.0,0.0,,2018,4,24,PAYEMENT,1090598.0,M146125975
32035,409000362497',2018-04-24,IMPS 240420183C,7855181.18,0.0,,2018,4,24,CHECK_WITHDRAWAL,7855181.18,M289664230
32036,409000362497',2018-04-24,NEFT/SBIN618114239247/Indfor,0.0,2800000.0,,2018,4,24,CHECK_CASHING,2800000.0,C77635419
32037,409000362497',2018-04-24,FDRL/INTERNAL FUND TRANSFE,0.0,10000000.0,,2018,4,24,TRANSFER,10000000.0,M1738025780
32038,409000362497',2018-04-24,FDRL/INTERNAL FUND TRANSFE,0.0,4000000.0,,2018,4,24,CASH_IN,4000000.0,M1653355753
32039,409000362497',2018-04-24,FDRL/INTERNAL FUND TRANSFE,0.0,2000000.0,,2018,4,24,CHECK_CASHING,2000000.0,C1061940664
32040,409000362497',2018-04-24,IMPS 240420184C,3664309.48,0.0,,2018,4,24,DEBIT,3664309.48,M893873575
32041,409000362497',2018-04-25,IMPS 240420181C,1962713.09,0.0,,2018,4,25,DEBIT,1962713.09,M1280268656
32042,409000362497',2018-04-25,IMPS 250420182C,4004667.21,0.0,,2018,4,25,CASH_OUT,4004667.21,M613001451
32043,409000362497',2018-04-25,IMPS 250420183C,8013445.79,0.0,,2018,4,25,DEBIT,8013445.79,C1284879016
32044,409000362497',2018-04-25,RTGS/YESBH18115677392/IRC,0.0,1194745.0,,2018,4,25,CASH_IN,1194745.0,M428084493
32045,409000362497',2018-04-25,FDRL/INTERNAL FUND TRANSFE,0.0,6000000.0,,2018,4,25,CASH_IN,6000000.0,M1899434117
32046,409000362497',2018-04-25,FDRL/INTERNAL FUND TRANSFE,0.0,7000000.0,,2018,4,25,CASH_IN,7000000.0,M1835456362
32047,409000362497',2018-04-25,NEFT/SBIN618115869501/Indfor,0.0,2500000.0,,2018,4,25,CASH_IN,2500000.0,C910539221
32048,409000362497',2018-04-25,NEFT/AXIC181151636624/Indfor,0.0,2500000.0,,2018,4,25,CHECK_CASHING,2500000.0,M59640194
32049,409000362497',2018-04-25,IMPS 2504184C,4152235.58,0.0,,2018,4,25,PAYEMENT,4152235.58,M856283783
32050,409000362497',2018-04-26,IMPS 250420181C,1523455.98,0.0,,2018,4,26,PAYEMENT,1523455.98,M906487200
32051,409000362497',2018-04-26,IMPS 260420182C,3485084.61,0.0,,2018,4,26,CHECK_WITHDRAWAL,3485084.61,M1370352169
32052,409000362497',2018-04-26,IMPS 260420183C,7012551.53,0.0,,2018,4,26,CHECK_WITHDRAWAL,7012551.53,M746088225
32053,409000362497',2018-04-26,NEFT/SBIN718116619162/Indfor,0.0,3500000.0,,2018,4,26,CHECK_CASHING,3500000.0,M1349714438
32054,409000362497',2018-04-26,NEFT/AXIC181161903254/Indfor,0.0,3000000.0,,2018,4,26,TRANSFER,3000000.0,M1192811083
32055,409000362497',2018-04-26,FDRL/INTERNAL FUND TRANSFE,0.0,5000000.0,,2018,4,26,CHECK_CASHING,5000000.0,M1802249654
32056,409000362497',2018-04-26,FDRL/INTERNAL FUND TRANSFE,0.0,5000000.0,,2018,4,26,CHECK_CASHING,5000000.0,M1963338225
32057,409000362497',2018-04-26,FDRL/INTERNAL FUND TRANSFE,0.0,500000.0,,2018,4,26,CHECK_CASHING,500000.0,M1737825795
32058,409000362497',2018-04-26,FDRL/INTERNAL FUND TRANSFE,0.0,500000.0,,2018,4,26,CASH_IN,500000.0,M1018667632
32059,409000362497',2018-04-26,IMPS 2604184C,3450348.54,0.0,,2018,4,26,PAYEMENT,3450348.54,M1759817614
32060,409000362497',2018-04-27,IMPS 260420181C,1878064.18,0.0,,2018,4,27,DEBIT,1878064.18,M1140347601
32061,409000362497',2018-04-27,IMPS 270420182C,3954342.6,0.0,,2018,4,27,PAYEMENT,3954342.6,M1601260161
32062,409000362497',2018-04-27,TO For 709003779660,0.0,27663017.91,,2018,4,27,CASH_IN,27663017.91,M1921633372
32063,409000362497',2018-04-27,NEFT/AXIC181172298892/Indfor,0.0,5000000.0,,2018,4,27,CASH_IN,5000000.0,M353622777
32064,409000362497',2018-04-27,IMPS 270420183C,6507372.21,0.0,,2018,4,27,CHECK_WITHDRAWAL,6507372.21,M1767107614
32065,409000362497',2018-04-27,IMPS 811718976538 FROM OX,0.0,200000.0,,2018,4,27,TRANSFER,200000.0,M1057717988
32066,409000362497',2018-04-27,IMPS 811718976578 FROM OX,0.0,200000.0,,2018,4,27,TRANSFER,200000.0,M1034978406
32067,409000362497',2018-04-27,IMPS 811718976607 FROM OX,0.0,200000.0,,2018,4,27,TRANSFER,200000.0,C280164607
32068,409000362497',2018-04-27,IMPS 811718976647 FROM OX,0.0,200000.0,,2018,4,27,TRANSFER,200000.0,C1557753656
32069,409000362497',2018-04-27,IMPS 811718976674 FROM OX,0.0,200000.0,,2018,4,27,CASH_IN,200000.0,C2123604590
32070,409000362497',2018-04-27,IMPS 811718976712 FROM OX,0.0,200000.0,,2018,4,27,CASH_IN,200000.0,M851095179
32071,409000362497',2018-04-27,IMPS 811718976749 FROM OX,0.0,200000.0,,2018,4,27,CASH_IN,200000.0,M1211140151
32072,409000362497',2018-04-27,IMPS 811718976788 FROM OX,0.0,200000.0,,2018,4,27,CASH_IN,200000.0,C1014681106
32073,409000362497',2018-04-27,IMPS 811718976821 FROM OX,0.0,200000.0,,2018,4,27,CASH_IN,200000.0,C1469007495
32074,409000362497',2018-04-27,IMPS 811718976853 FROM OX,0.0,200000.0,,2018,4,27,CHECK_CASHING,200000.0,M1150342245
32075,409000362497',2018-04-27,IMPS 811718977429 FROM OX,0.0,200000.0,,2018,4,27,CASH_IN,200000.0,M1787482713
32076,409000362497',2018-04-27,IMPS 811718977468 FROM OX,0.0,200000.0,,2018,4,27,CASH_IN,200000.0,M1276195606
32077,409000362497',2018-04-27,IMPS 811718977506 FROM OX,0.0,200000.0,,2018,4,27,CHECK_CASHING,200000.0,C116589395
32078,409000362497',2018-04-27,IMPS 811718977543 FROM OX,0.0,200000.0,,2018,4,27,TRANSFER,200000.0,M1866378032
32079,409000362497',2018-04-27,IMPS 811718977579 FROM OX,0.0,200000.0,,2018,4,27,CHECK_CASHING,200000.0,M980772740
32080,409000362497',2018-04-27,IMPS 811718977624 FROM OX,0.0,200000.0,,2018,4,27,TRANSFER,200000.0,C1870252780
32081,409000362497',2018-04-27,IMPS 811718977655 FROM OX,0.0,200000.0,,2018,4,27,CASH_IN,200000.0,C1383831706
32082,409000362497',2018-04-27,IMPS 811718977688 FROM OX,0.0,200000.0,,2018,4,27,TRANSFER,200000.0,M34092248
32083,409000362497',2018-04-27,IMPS 811718977728 FROM OX,0.0,200000.0,,2018,4,27,CASH_IN,200000.0,C1048855692
32084,409000362497',2018-04-27,IMPS 811718977762 FROM OX,0.0,200000.0,,2018,4,27,TRANSFER,200000.0,C1241827956
32085,409000362497',2018-04-27,FDRL/INTERNAL FUND TRANSFE,0.0,6000000.0,,2018,4,27,CASH_IN,6000000.0,C1380252219
32086,409000362497',2018-04-27,FDRL/INTERNAL FUND TRANSFE,0.0,2000000.0,,2018,4,27,TRANSFER,2000000.0,M647277414
32087,409000362497',2018-04-27,FDRL/INTERNAL FUND TRANSFE,0.0,500000.0,,2018,4,27,CHECK_CASHING,500000.0,M971160150
32088,409000362497',2018-04-27,FDRL/INTERNAL FUND TRANSFE,0.0,500000.0,,2018,4,27,CASH_IN,500000.0,C1874679514
32089,409000362497',2018-04-27,TRF FROM  Indiaforensic SERVICES,0.0,3000000.0,,2018,4,27,CHECK_CASHING,3000000.0,C76416903
32090,409000362497',2018-04-27,IMPS 811720009642 FROM OX,0.0,200000.0,,2018,4,27,CHECK_CASHING,200000.0,C22448303
32091,409000362497',2018-04-27,IMPS 811720009669 FROM OX,0.0,200000.0,,2018,4,27,CASH_IN,200000.0,C444613285
32092,409000362497',2018-04-27,IMPS 811720009709 FROM OX,0.0,200000.0,,2018,4,27,CASH_IN,200000.0,C1197114389
32093,409000362497',2018-04-27,IMPS 811720009734 FROM OX,0.0,200000.0,,2018,4,27,CASH_IN,200000.0,C1243712710
32094,409000362497',2018-04-27,IMPS 811720009766 FROM OX,0.0,200000.0,,2018,4,27,CASH_IN,200000.0,M551934503
32095,409000362497',2018-04-27,IMPS 811720009800 FROM OX,0.0,200000.0,,2018,4,27,CASH_IN,200000.0,M114076034
32096,409000362497',2018-04-27,IMPS 811720009837 FROM OX,0.0,200000.0,,2018,4,27,CHECK_CASHING,200000.0,C944036866
32097,409000362497',2018-04-27,IMPS 811720009865 FROM OX,0.0,200000.0,,2018,4,27,TRANSFER,200000.0,C265845794
32098,409000362497',2018-04-27,IMPS 811720009892 FROM OX,0.0,200000.0,,2018,4,27,TRANSFER,200000.0,M257656875
32099,409000362497',2018-04-27,IMPS 811720009917 FROM OX,0.0,200000.0,,2018,4,27,CASH_IN,200000.0,C1790831319
32100,409000362497',2018-04-27,IMPS 811720011341 FROM OX,0.0,200000.0,,2018,4,27,CHECK_CASHING,200000.0,C1675401022
32101,409000362497',2018-04-27,IMPS 811720011360 FROM OX,0.0,200000.0,,2018,4,27,CASH_IN,200000.0,M768794333
32102,409000362497',2018-04-27,IMPS 811720011396 FROM OX,0.0,200000.0,,2018,4,27,CASH_IN,200000.0,C106347918
32103,409000362497',2018-04-27,IMPS 811720011417 FROM OX,0.0,200000.0,,2018,4,27,TRANSFER,200000.0,C773216199
32104,409000362497',2018-04-27,IMPS 811720011444 FROM OX,0.0,200000.0,,2018,4,27,CHECK_CASHING,200000.0,C171294561
32105,409000362497',2018-04-27,IMPS 811720011468 FROM OX,0.0,200000.0,,2018,4,27,CHECK_CASHING,200000.0,M1224166768
32106,409000362497',2018-04-27,IMPS 811720011497 FROM OX,0.0,200000.0,,2018,4,27,TRANSFER,200000.0,C1174935745
32107,409000362497',2018-04-27,IMPS 811720011534 FROM OX,0.0,200000.0,,2018,4,27,CHECK_CASHING,200000.0,C1508330669
32108,409000362497',2018-04-27,IMPS 811720011567 FROM OX,0.0,200000.0,,2018,4,27,CHECK_CASHING,200000.0,C823592993
32109,409000362497',2018-04-27,IMPS 811720011589 FROM OX,0.0,200000.0,,2018,4,27,CHECK_CASHING,200000.0,M1403020966
32110,409000362497',2018-04-27,IMPS 811720012275 FROM OX,0.0,200000.0,,2018,4,27,CHECK_CASHING,200000.0,M1252004915
32111,409000362497',2018-04-27,IMPS 811720012297 FROM OX,0.0,200000.0,,2018,4,27,CHECK_CASHING,200000.0,C404766837
32112,409000362497',2018-04-27,IMPS 811720012314 FROM OX,0.0,200000.0,,2018,4,27,CASH_IN,200000.0,M1699918280
32113,409000362497',2018-04-27,IMPS 811720012350 FROM OX,0.0,200000.0,,2018,4,27,CHECK_CASHING,200000.0,C1168382976
32114,409000362497',2018-04-27,IMPS 811720012383 FROM OX,0.0,200000.0,,2018,4,27,TRANSFER,200000.0,M1362343584
32115,409000362497',2018-04-27,IMPS 811720012408 FROM OX,0.0,200000.0,,2018,4,27,TRANSFER,200000.0,M1206305433
32116,409000362497',2018-04-27,IMPS 811720012433 FROM OX,0.0,200000.0,,2018,4,27,CHECK_CASHING,200000.0,M363865605
32117,409000362497',2018-04-27,IMPS 811720012459 FROM OX,0.0,200000.0,,2018,4,27,CHECK_CASHING,200000.0,M964476665
32118,409000362497',2018-04-27,IMPS 811720012484 FROM OX,0.0,200000.0,,2018,4,27,TRANSFER,200000.0,M619892608
32119,409000362497',2018-04-27,IMPS 811720012504 FROM OX,0.0,200000.0,,2018,4,27,CASH_IN,200000.0,M1242810187
32120,409000362497',2018-04-27,IMPS 811720012811 FROM OX,0.0,200000.0,,2018,4,27,TRANSFER,200000.0,C235386075
32121,409000362497',2018-04-27,IMPS 811720012840 FROM OX,0.0,200000.0,,2018,4,27,TRANSFER,200000.0,M1304748093
32122,409000362497',2018-04-27,IMPS 811720012860 FROM OX,0.0,200000.0,,2018,4,27,CASH_IN,200000.0,M247349236
32123,409000362497',2018-04-27,IMPS 811720012889 FROM OX,0.0,200000.0,,2018,4,27,CHECK_CASHING,200000.0,M590913304
32124,409000362497',2018-04-27,IMPS 270418 4C,4710064.11,0.0,,2018,4,27,PAYEMENT,4710064.11,M253157271
32125,409000362497',2018-04-27,Sweep Trf To: 40900036427,9176351.0,0.0,,2018,4,27,CASH_OUT,9176351.0,C694467240
32126,409000362497',2018-04-29,IMPS 811912345766 FROM OX,0.0,200000.0,,2018,4,29,CASH_IN,200000.0,C1381846905
32127,409000362497',2018-04-29,IMPS 811912345793 FROM OX,0.0,200000.0,,2018,4,29,CASH_IN,200000.0,C1621418276
32128,409000362497',2018-04-29,IMPS 811912345804 FROM OX,0.0,200000.0,,2018,4,29,TRANSFER,200000.0,C1773326555
32129,409000362497',2018-04-29,IMPS 811912345820 FROM OX,0.0,200000.0,,2018,4,29,CASH_IN,200000.0,M1237552569
32130,409000362497',2018-04-29,IMPS 811912345838 FROM OX,0.0,200000.0,,2018,4,29,CHECK_CASHING,200000.0,C2026975295
32131,409000362497',2018-04-29,IMPS 811912345852 FROM OX,0.0,200000.0,,2018,4,29,CHECK_CASHING,200000.0,C13329486
32132,409000362497',2018-04-29,IMPS 811912345864 FROM OX,0.0,200000.0,,2018,4,29,TRANSFER,200000.0,C384735911
32133,409000362497',2018-04-29,IMPS 811912345888 FROM OX,0.0,200000.0,,2018,4,29,CHECK_CASHING,200000.0,C2024609461
32134,409000362497',2018-04-29,IMPS 811912345906 FROM OX,0.0,200000.0,,2018,4,29,CASH_IN,200000.0,C158424358
32135,409000362497',2018-04-29,IMPS 811912345921 FROM OX,0.0,200000.0,,2018,4,29,TRANSFER,200000.0,C2000574989
32136,409000362497',2018-04-30,IMPS 270420181C,3303155.53,0.0,,2018,4,30,PAYEMENT,3303155.53,C97730845
32137,409000362497',2018-04-30,IMPS 280420181C,10441065.3,0.0,,2018,4,30,CASH_OUT,10441065.3,M262412690
32138,409000362497',2018-04-30,IMPS 290420181C,596176.25,0.0,,2018,4,30,CHECK_WITHDRAWAL,596176.25,M391636440
32139,409000362497',2018-04-30,IMPS 300420182C,1508684.96,0.0,,2018,4,30,CHECK_WITHDRAWAL,1508684.96,C1487105431
32140,409000362497',2018-04-30,IMPS 3004183C,9289074.74,0.0,,2018,4,30,CASH_OUT,9289074.74,C264843581
32141,409000362497',2018-04-30,NEFT/SBIN918120935894/Indfor,0.0,5000000.0,,2018,4,30,CASH_IN,5000000.0,C2083117811
32142,409000362497',2018-04-30,NEFT/AXIC181202852946/Indfor,0.0,11000000.0,,2018,4,30,TRANSFER,11000000.0,C1786622318
32143,409000362497',2018-04-30,FDRL/INTERNAL FUND TRANSFE,0.0,2000000.0,,2018,4,30,CHECK_CASHING,2000000.0,C471192303
32144,409000362497',2018-04-30,IMPS 3004184C,5056371.43,0.0,,2018,4,30,CHECK_WITHDRAWAL,5056371.43,C1218365329
32145,409000362497',2018-04-30,Sweep Trf To: 40900036427,308130.0,0.0,,2018,4,30,PAYEMENT,308130.0,C208427878
32146,409000362497',2018-04-30,409000362497:Int.Coll:01-,187076.12,0.0,,2018,4,30,PAYEMENT,187076.12,C826383690
32147,409000362497',2018-05-01,IMPS 300420181C,809579.71,0.0,,2018,5,1,PAYEMENT,809579.71,C1927159174
32148,409000362497',2018-05-01,IMPS 010520182C,4732361.52,0.0,,2018,5,1,PAYEMENT,4732361.52,C1575652338
32149,409000362497',2018-05-01,IMPS 010520183C,8284334.65,0.0,,2018,5,1,CASH_OUT,8284334.65,C1761353343
32150,409000362497',2018-05-01,FDRL/INTERNAL FUND TRANSFE,0.0,7000000.0,,2018,5,1,CHECK_CASHING,7000000.0,C1812627994
32151,409000362497',2018-05-01,FDRL/INTERNAL FUND TRANSFE,0.0,7000000.0,,2018,5,1,TRANSFER,7000000.0,C1787868648
32152,409000362497',2018-05-01,FDRL/INTERNAL FUND TRANSFE,0.0,7000000.0,,2018,5,1,CHECK_CASHING,7000000.0,C1408474568
32153,409000362497',2018-05-01,FDRL/INTERNAL FUND TRANSFE,0.0,2000000.0,,2018,5,1,TRANSFER,2000000.0,C547644464
32154,409000362497',2018-05-01,IMPS 0105184C,4417926.47,0.0,,2018,5,1,DEBIT,4417926.47,C418902856
32155,409000362497',2018-05-01,Sweep Trf To: 40900036427,662887.0,0.0,,2018,5,1,DEBIT,662887.0,C1515979807
32156,409000362497',2018-05-02,NEFT/SBIN218121265247/Indfor,0.0,3400000.0,,2018,5,2,CHECK_CASHING,3400000.0,C1797449963
32157,409000362497',2018-05-02,IMPS 010520181C,3820088.64,0.0,,2018,5,2,CHECK_WITHDRAWAL,3820088.64,C170954749
32158,409000362497',2018-05-02,IMPS 020520182C,2486938.56,0.0,,2018,5,2,PAYEMENT,2486938.56,C2089016471
32159,409000362497',2018-05-02,IMPS 020520183C,6541946.8,0.0,,2018,5,2,CHECK_WITHDRAWAL,6541946.8,C943901945
32160,409000362497',2018-05-02,BIGTREE ENTERTAINMENT PRI,15452.0,0.0,,2018,5,2,PAYEMENT,15452.0,C464094472
32161,409000362497',2018-05-02,IRCTC CORPORATE OFFICE AC,204540.0,0.0,,2018,5,2,DEBIT,204540.0,C185353840
32162,409000362497',2018-05-02,PAYU PAYMENTS PRIVATE LIM,53966.0,0.0,,2018,5,2,PAYEMENT,53966.0,C1967017653
32163,409000362497',2018-05-02,AVENUES INDIA PRIVATE LIM,17406.0,0.0,,2018,5,2,CHECK_WITHDRAWAL,17406.0,C1298316171
32164,409000362497',2018-05-02,ZAAK EPAYMENT SERVICES PR,781.0,0.0,,2018,5,2,CHECK_WITHDRAWAL,781.0,C663641998
32165,409000362497',2018-05-02,FUTURE RETAIL LIMITED (OW,7327.0,0.0,,2018,5,2,DEBIT,7327.0,C732398219
32166,409000362497',2018-05-02,PASFAR TECHNOLOGIES PRIVA,15332.0,0.0,,2018,5,2,DEBIT,15332.0,C502075429
32167,409000362497',2018-05-02,VOYLLA FASHIONS PRIVATE L,1613.0,0.0,,2018,5,2,CHECK_WITHDRAWAL,1613.0,C2081834559
32168,409000362497',2018-05-02,JUST DIAL LIMITED,392.0,0.0,,2018,5,2,PAYEMENT,392.0,C2073764942
32169,409000362497',2018-05-02,MEHAR ENTERTAINMENT PRIVA,10024.0,0.0,,2018,5,2,CASH_OUT,10024.0,C1048787487
32170,409000362497',2018-05-02,E-BILLING SOLUTIONS PRIVA,793.0,0.0,,2018,5,2,DEBIT,793.0,C54274682
32171,409000362497',2018-05-02,Indiaforensic SERVICES INDIA PVT,776375.95,0.0,,2018,5,2,DEBIT,776375.95,C1684776894
32172,409000362497',2018-05-02,NEFT/SBIN318122208124/Indfor,0.0,5000000.0,,2018,5,2,CASH_IN,5000000.0,C1778289781
32173,409000362497',2018-05-02,FDRL/INTERNAL FUND TRANSFE,0.0,6000000.0,,2018,5,2,CASH_IN,6000000.0,C907892387
32174,409000362497',2018-05-02,FDRL/INTERNAL FUND TRANSFE,0.0,5000000.0,,2018,5,2,CHECK_CASHING,5000000.0,C1284879016
32175,409000362497',2018-05-02,IMPS 0205184C,3886521.94,0.0,,2018,5,2,PAYEMENT,3886521.94,C1788961047
32176,409000362497',2018-05-02,Sweep Trf To: 40900036427,377457.0,0.0,,2018,5,2,DEBIT,377457.0,C542837562
32177,409000362497',2018-05-03,BIGTREE ENTERTAINMENT PRI,614.0,0.0,,2018,5,3,CASH_OUT,614.0,C94428170
32178,409000362497',2018-05-03,INDIAIDEAS.COM LTD,50311.0,0.0,,2018,5,3,PAYEMENT,50311.0,C1793325972
32179,409000362497',2018-05-03,IRCTC CORPORATE OFFICE AC,79875.0,0.0,,2018,5,3,CHECK_WITHDRAWAL,79875.0,C1141049797
32180,409000362497',2018-05-03,PAYU PAYMENTS PRIVATE LIM,23879.0,0.0,,2018,5,3,CASH_OUT,23879.0,C2010664081
32181,409000362497',2018-05-03,AVENUES INDIA PRIVATE LIM,4430.0,0.0,,2018,5,3,PAYEMENT,4430.0,C524804429
32182,409000362497',2018-05-03,ZAAK EPAYMENT SERVICES PR,149.0,0.0,,2018,5,3,PAYEMENT,149.0,C339099861
32183,409000362497',2018-05-03,FUTURE RETAIL LIMITED (OW,1003.0,0.0,,2018,5,3,CHECK_WITHDRAWAL,1003.0,C954723689
32184,409000362497',2018-05-03,PASFAR TECHNOLOGIES PRIVA,3341.0,0.0,,2018,5,3,CASH_OUT,3341.0,C1909597726
32185,409000362497',2018-05-03,JUST DIAL LIMITED,392.0,0.0,,2018,5,3,DEBIT,392.0,C470217116
32186,409000362497',2018-05-03,MEHAR ENTERTAINMENT PRIVA,923.0,0.0,,2018,5,3,CHECK_WITHDRAWAL,923.0,C1953886321
32187,409000362497',2018-05-03,Indiaforensic SERVICES INDIA PVT,230997.0,0.0,,2018,5,3,CHECK_WITHDRAWAL,230997.0,C305793941
32188,409000362497',2018-05-03,BIGTREE ENTERTAINMENT PRI,5349.0,0.0,,2018,5,3,CHECK_WITHDRAWAL,5349.0,C1567372422
32189,409000362497',2018-05-03,INDIAIDEAS.COM LTD,91155.0,0.0,,2018,5,3,CASH_OUT,91155.0,C811413419
32190,409000362497',2018-05-03,IRCTC CORPORATE OFFICE AC,137390.0,0.0,,2018,5,3,DEBIT,137390.0,C2074601041
32191,409000362497',2018-05-03,PAYU PAYMENTS PRIVATE LIM,54973.0,0.0,,2018,5,3,CASH_OUT,54973.0,C582410861
32192,409000362497',2018-05-03,AVENUES INDIA PRIVATE LIM,6734.0,0.0,,2018,5,3,CASH_OUT,6734.0,C1242586395
32193,409000362497',2018-05-03,ZAAK EPAYMENT SERVICES PR,437.0,0.0,,2018,5,3,CHECK_WITHDRAWAL,437.0,C800572196
32194,409000362497',2018-05-03,FUTURE RETAIL LIMITED (OW,2592.0,0.0,,2018,5,3,PAYEMENT,2592.0,C1446521801
32195,409000362497',2018-05-03,PASFAR TECHNOLOGIES PRIVA,7893.0,0.0,,2018,5,3,DEBIT,7893.0,C313124964
32196,409000362497',2018-05-03,DISH INFRA SERVICES PRIVA,215.0,0.0,,2018,5,3,CHECK_WITHDRAWAL,215.0,C198998678
32197,409000362497',2018-05-03,JUST DIAL LIMITED,784.0,0.0,,2018,5,3,DEBIT,784.0,C1801506216
32198,409000362497',2018-05-03,MEHAR ENTERTAINMENT PRIVA,576.0,0.0,,2018,5,3,PAYEMENT,576.0,C176203926
32199,409000362497',2018-05-03,E-BILLING SOLUTIONS PRIVA,2041.0,0.0,,2018,5,3,CASH_OUT,2041.0,C534662976
32200,409000362497',2018-05-03,SND LIMITED,176.0,0.0,,2018,5,3,CASH_OUT,176.0,C804372771
32201,409000362497',2018-05-03,ALT DIGITAL MEDIA ENTERTA,98.0,0.0,,2018,5,3,CASH_OUT,98.0,M1006873855
32202,409000362497',2018-05-03,Indiaforensic SERVICES INDIA PVT,534976.0,0.0,,2018,5,3,CASH_OUT,534976.0,M1392675094
32203,409000362497',2018-05-03,IMPS 020520181C,3538728.51,0.0,,2018,5,3,PAYEMENT,3538728.51,C1315078366
32204,409000362497',2018-05-03,IMPS 030520182C,2252351.26,0.0,,2018,5,3,CHECK_WITHDRAWAL,2252351.26,M1196449454
32205,409000362497',2018-05-03,IMPS 030520183C,4646577.83,0.0,,2018,5,3,DEBIT,4646577.83,C1576036401
32206,409000362497',2018-05-03,BIGTREE ENTERTAINMENT PRI,4275.0,0.0,,2018,5,3,DEBIT,4275.0,C708099852
32207,409000362497',2018-05-03,INDIAIDEAS.COM LTD,166762.0,0.0,,2018,5,3,CASH_OUT,166762.0,C41481250
32208,409000362497',2018-05-03,IRCTC CORPORATE OFFICE AC,140845.0,0.0,,2018,5,3,PAYEMENT,140845.0,C1270516
32209,409000362497',2018-05-03,PAYU PAYMENTS PRIVATE LIM,47486.0,0.0,,2018,5,3,CHECK_WITHDRAWAL,47486.0,C562930169
32210,409000362497',2018-05-03,AVENUES INDIA PRIVATE LIM,22219.0,0.0,,2018,5,3,DEBIT,22219.0,C1372252045
32211,409000362497',2018-05-03,ZAAK EPAYMENT SERVICES PR,759.0,0.0,,2018,5,3,CASH_OUT,759.0,M945665862
32212,409000362497',2018-05-03,FUTURE RETAIL LIMITED (OW,752.0,0.0,,2018,5,3,CHECK_WITHDRAWAL,752.0,C1030240625
32213,409000362497',2018-05-03,PASFAR TECHNOLOGIES PRIVA,6892.0,0.0,,2018,5,3,CASH_OUT,6892.0,M2008318346
32214,409000362497',2018-05-03,MEHAR ENTERTAINMENT PRIVA,2765.0,0.0,,2018,5,3,CASH_OUT,2765.0,M1001107335
32215,409000362497',2018-05-03,VOUCHER ACTIVATION SERVIC,34931.0,0.0,,2018,5,3,DEBIT,34931.0,M887276312
32216,409000362497',2018-05-03,QWIKCILVER SOLUTIONS PRIV,13553.0,0.0,,2018,5,3,DEBIT,13553.0,M1203596575
32217,409000362497',2018-05-03,DISH INFRA SERVICES PRIVA,247.0,0.0,,2018,5,3,PAYEMENT,247.0,M1332943826
32218,409000362497',2018-05-03,MUZAFFARPUR VIDYUT VITARA,260.0,0.0,,2018,5,3,CASH_OUT,260.0,C985004233
32219,409000362497',2018-05-03,Indiaforensic SERVICES INDIA PVT,469329.0,0.0,,2018,5,3,CASH_OUT,469329.0,C147916733
32220,409000362497',2018-05-03,NEFT/SBIN418123091989/Indfor,0.0,4900000.0,,2018,5,3,TRANSFER,4900000.0,M1175924809
32221,409000362497',2018-05-03,FDRL/INTERNAL FUND TRANSFE,0.0,10000000.0,,2018,5,3,CHECK_CASHING,10000000.0,M537080891
32222,409000362497',2018-05-03,FDRL/INTERNAL FUND TRANSFE,0.0,500000.0,,2018,5,3,TRANSFER,500000.0,M651978477
32223,409000362497',2018-05-03,FDRL/INTERNAL FUND TRANSFE,0.0,500000.0,,2018,5,3,TRANSFER,500000.0,M622935486
32224,409000362497',2018-05-03,IMPS 0305184C,4835569.55,0.0,,2018,5,3,CHECK_WITHDRAWAL,4835569.55,M231974092
32225,409000362497',2018-05-03,Sweep Trf To: 40900036427,316545.0,0.0,,2018,5,3,CASH_OUT,316545.0,C1752591265
32226,409000362497',2018-05-04,RF For 709002537773,0.0,133033.0,,2018,5,4,CHECK_CASHING,133033.0,M1281325071
32227,409000362497',2018-05-04,IMPS 0305181C,4093080.44,0.0,,2018,5,4,DEBIT,4093080.44,M378922571
32228,409000362497',2018-05-04,IMPS 040520182C,2270134.04,0.0,,2018,5,4,CASH_OUT,2270134.04,C1859965144
32229,409000362497',2018-05-04,IMPS 0405183C,5604816.96,0.0,,2018,5,4,CASH_OUT,5604816.96,M1235736217
32230,409000362497',2018-05-04,BIGTREE ENTERTAINMENT PRI,6132.0,0.0,,2018,5,4,CHECK_WITHDRAWAL,6132.0,M2114371769
32231,409000362497',2018-05-04,INDIAIDEAS.COM LTD,37378.0,0.0,,2018,5,4,PAYEMENT,37378.0,C1769233874
32232,409000362497',2018-05-04,IRCTC CORPORATE OFFICE AC,52630.0,0.0,,2018,5,4,CHECK_WITHDRAWAL,52630.0,C492997256
32233,409000362497',2018-05-04,PAYU PAYMENTS PRIVATE LIM,27946.0,0.0,,2018,5,4,CASH_OUT,27946.0,C875917495
32234,409000362497',2018-05-04,AVENUES INDIA PRIVATE LIM,4066.0,0.0,,2018,5,4,CHECK_WITHDRAWAL,4066.0,C1858098329
32235,409000362497',2018-05-04,FUTURE RETAIL LIMITED (OW,504.0,0.0,,2018,5,4,CASH_OUT,504.0,C555334025
32236,409000362497',2018-05-04,PASFAR TECHNOLOGIES PRIVA,1294.0,0.0,,2018,5,4,PAYEMENT,1294.0,C1589547066
32237,409000362497',2018-05-04,HUNGAMA DIGITAL MEDIA ENT,897.0,0.0,,2018,5,4,DEBIT,897.0,C90486891
32238,409000362497',2018-05-04,JUST DIAL LIMITED,784.0,0.0,,2018,5,4,DEBIT,784.0,C2114147305
32239,409000362497',2018-05-04,MEHAR ENTERTAINMENT PRIVA,3341.0,0.0,,2018,5,4,DEBIT,3341.0,C1380252219
32240,409000362497',2018-05-04,ALT DIGITAL MEDIA ENTERTA,392.0,0.0,,2018,5,4,CASH_OUT,392.0,C1439007204
32241,409000362497',2018-05-04,Indiaforensic SERVICES INDIA PVT,282667.0,0.0,,2018,5,4,PAYEMENT,282667.0,C1607998252
32242,409000362497',2018-05-04,NEFT/SBIN418124952477/Indfor,0.0,2000000.0,,2018,5,4,CHECK_CASHING,2000000.0,C1678035039
32243,409000362497',2018-05-04,FDRL/INTERNAL FUND TRANSFE,0.0,10000000.0,,2018,5,4,CASH_IN,10000000.0,C310737318
32244,409000362497',2018-05-04,FDRL/INTERNAL FUND TRANSFE,0.0,3000000.0,,2018,5,4,CASH_IN,3000000.0,C441880784
32245,409000362497',2018-05-04,FDRL/INTERNAL FUND TRANSFE,0.0,500000.0,,2018,5,4,TRANSFER,500000.0,M1762109972
32246,409000362497',2018-05-04,IMPS 0405184C,3694415.0,0.0,,2018,5,4,PAYEMENT,3694415.0,M1503109785
32247,409000362497',2018-05-04,Sweep Trf To: 40900036427,331004.0,0.0,,2018,5,4,CHECK_WITHDRAWAL,331004.0,M1549797489
32248,409000362497',2018-05-05,IMPS 040520181C,3546472.47,0.0,,2018,5,5,CHECK_WITHDRAWAL,3546472.47,C1464984894
32249,409000362497',2018-05-05,IMPS 050520182C,2459293.88,0.0,,2018,5,5,CHECK_WITHDRAWAL,2459293.88,M366878600
32250,409000362497',2018-05-05,IMPS 050520183C,5133368.0,0.0,,2018,5,5,CASH_OUT,5133368.0,M1900042376
32251,409000362497',2018-05-05,NEFT/SBIN518125817025/Indfor,0.0,8100000.0,,2018,5,5,CASH_IN,8100000.0,M2012649556
32252,409000362497',2018-05-05,FDRL/INTERNAL FUND TRANSFE,0.0,10000000.0,,2018,5,5,CASH_IN,10000000.0,M1074947370
32253,409000362497',2018-05-05,FDRL/INTERNAL FUND TRANSFE,0.0,8000000.0,,2018,5,5,TRANSFER,8000000.0,M519551742
32254,409000362497',2018-05-05,IMPS 050520184C,3432406.33,0.0,,2018,5,5,PAYEMENT,3432406.33,C128053256
32255,409000362497',2018-05-05,Sweep Trf To: 40900036427,364384.0,0.0,,2018,5,5,CASH_OUT,364384.0,M153697748
32256,409000362497',2018-05-07,IMPS 050520181C,3319002.56,0.0,,2018,5,7,CASH_OUT,3319002.56,C1192240143
32257,409000362497',2018-05-07,IMPS 060520181C,7957466.29,0.0,,2018,5,7,PAYEMENT,7957466.29,C426416592
32258,409000362497',2018-05-07,IMPS 070520183C,2292804.82,0.0,,2018,5,7,DEBIT,2292804.82,C687292566
32259,409000362497',2018-05-07,IMPS 070520183C,5504079.67,0.0,,2018,5,7,CASH_OUT,5504079.67,M21266003
32260,409000362497',2018-05-07,NEFT/SBIN618127735504/Indfor,0.0,2000000.0,,2018,5,7,TRANSFER,2000000.0,M442965053
32261,409000362497',2018-05-07,FDRL/INTERNAL FUND TRANSFE,0.0,10000000.0,,2018,5,7,CASH_IN,10000000.0,M1630813835
32262,409000362497',2018-05-07,IMPS 0705184C,3787827.2,0.0,,2018,5,7,CASH_OUT,3787827.2,M1274109789
32263,409000362497',2018-05-07,IMPS 812719890480 FROM OX,0.0,200000.0,,2018,5,7,TRANSFER,200000.0,C1136186114
32264,409000362497',2018-05-07,IMPS 812719890527 FROM OX,0.0,200000.0,,2018,5,7,CASH_IN,200000.0,M187911388
32265,409000362497',2018-05-07,IMPS 812719890561 FROM OX,0.0,200000.0,,2018,5,7,CASH_IN,200000.0,C388286025
32266,409000362497',2018-05-07,IMPS 812719890608 FROM OX,0.0,200000.0,,2018,5,7,CASH_IN,200000.0,C329829198
32267,409000362497',2018-05-07,IMPS 812719890653 FROM OX,0.0,200000.0,,2018,5,7,CASH_IN,200000.0,C2078250226
32268,409000362497',2018-05-07,IMPS 812719890701 FROM OX,0.0,200000.0,,2018,5,7,CASH_IN,200000.0,C836903727
32269,409000362497',2018-05-07,IMPS 812719890745 FROM OX,0.0,200000.0,,2018,5,7,CHECK_CASHING,200000.0,M132946804
32270,409000362497',2018-05-07,IMPS 812719890787 FROM OX,0.0,200000.0,,2018,5,7,CHECK_CASHING,200000.0,C1619434640
32271,409000362497',2018-05-07,IMPS 812720895124 FROM OX,0.0,100000.0,,2018,5,7,TRANSFER,100000.0,M1009749420
32272,409000362497',2018-05-07,IMPS 812720895165 FROM OX,0.0,200000.0,,2018,5,7,TRANSFER,200000.0,C2059109138
32273,409000362497',2018-05-07,IMPS 812720895204 FROM OX,0.0,200000.0,,2018,5,7,CASH_IN,200000.0,C510382951
32274,409000362497',2018-05-07,IMPS 812720895239 FROM OX,0.0,200000.0,,2018,5,7,CHECK_CASHING,200000.0,C884262954
32275,409000362497',2018-05-07,IMPS 812720895267 FROM OX,0.0,200000.0,,2018,5,7,CHECK_CASHING,200000.0,C997470268
32276,409000362497',2018-05-07,IMPS 812720895303 FROM OX,0.0,200000.0,,2018,5,7,TRANSFER,200000.0,C1677727024
32277,409000362497',2018-05-07,IMPS 812720895349 FROM OX,0.0,200000.0,,2018,5,7,TRANSFER,200000.0,C1697243488
32278,409000362497',2018-05-07,IMPS 812720895381 FROM OX,0.0,200000.0,,2018,5,7,CHECK_CASHING,200000.0,C1630293008
32279,409000362497',2018-05-07,Sweep Trf To: 40900036427,411414.0,0.0,,2018,5,7,CASH_OUT,411414.0,C1167716832
32280,409000362497',2018-05-08,BIGTREE ENTERTAINMENT PRI,5943.0,0.0,,2018,5,8,DEBIT,5943.0,C820910648
32281,409000362497',2018-05-08,INDIAIDEAS.COM LTD,65618.0,0.0,,2018,5,8,CHECK_WITHDRAWAL,65618.0,C899455803
32282,409000362497',2018-05-08,IRCTC CORPORATE OFFICE AC,150757.0,0.0,,2018,5,8,PAYEMENT,150757.0,C1851222027
32283,409000362497',2018-05-08,PAYU PAYMENTS PRIVATE LIM,60668.0,0.0,,2018,5,8,PAYEMENT,60668.0,C623476050
32284,409000362497',2018-05-08,AVENUES INDIA PRIVATE LIM,27097.0,0.0,,2018,5,8,DEBIT,27097.0,C1805253792
32285,409000362497',2018-05-08,SYNERGISTIC FINANCIAL NET,506.0,0.0,,2018,5,8,CHECK_WITHDRAWAL,506.0,C1805708874
32286,409000362497',2018-05-08,ZAAK EPAYMENT SERVICES PR,814.0,0.0,,2018,5,8,CHECK_WITHDRAWAL,814.0,C382329720
32287,409000362497',2018-05-08,FUTURE RETAIL LIMITED (OW,8623.0,0.0,,2018,5,8,CASH_OUT,8623.0,C580431625
32288,409000362497',2018-05-08,METRO INFRASYS PRIVATE LI,697.0,0.0,,2018,5,8,PAYEMENT,697.0,C541484789
32289,409000362497',2018-05-08,PASFAR TECHNOLOGIES PRIVA,5302.0,0.0,,2018,5,8,DEBIT,5302.0,C1929902741
32290,409000362497',2018-05-08,JUST DIAL LIMITED,689.0,0.0,,2018,5,8,DEBIT,689.0,C1948233127
32291,409000362497',2018-05-08,MEHAR ENTERTAINMENT PRIVA,5185.0,0.0,,2018,5,8,DEBIT,5185.0,C388910394
32292,409000362497',2018-05-08,ALT DIGITAL MEDIA ENTERTA,392.0,0.0,,2018,5,8,CHECK_WITHDRAWAL,392.0,M2095785382
32293,409000362497',2018-05-08,Indiaforensic SERVICES INDIA PVT,640695.0,0.0,,2018,5,8,PAYEMENT,640695.0,C387901692
32294,409000362497',2018-05-08,IMPS 070520181C,4001118.96,0.0,,2018,5,8,DEBIT,4001118.96,C656990981
32295,409000362497',2018-05-08,IMPS 080520182C,2227910.39,0.0,,2018,5,8,CHECK_WITHDRAWAL,2227910.39,M1986871874
32296,409000362497',2018-05-08,IMPS 080520183C,5586787.28,0.0,,2018,5,8,CHECK_WITHDRAWAL,5586787.28,M634812584
32297,409000362497',2018-05-08,BIGTREE ENTERTAINMENT PRI,460.0,0.0,,2018,5,8,CHECK_WITHDRAWAL,460.0,M507517149
32298,409000362497',2018-05-08,INDIAIDEAS.COM LTD,53829.0,0.0,,2018,5,8,DEBIT,53829.0,M587301402
32299,409000362497',2018-05-08,IRCTC CORPORATE OFFICE AC,57970.0,0.0,,2018,5,8,DEBIT,57970.0,C1859965144
32300,409000362497',2018-05-08,PAYU PAYMENTS PRIVATE LIM,14591.0,0.0,,2018,5,8,CHECK_WITHDRAWAL,14591.0,M912298789
32301,409000362497',2018-05-08,FUTURE RETAIL LIMITED (OW,2317.0,0.0,,2018,5,8,CASH_OUT,2317.0,C1360092022
32302,409000362497',2018-05-08,METRO INFRASYS PRIVATE LI,697.0,0.0,,2018,5,8,CASH_OUT,697.0,C1463361810
32303,409000362497',2018-05-08,PASFAR TECHNOLOGIES PRIVA,1405.0,0.0,,2018,5,8,DEBIT,1405.0,M1985550063
32304,409000362497',2018-05-08,JUST DIAL LIMITED,146.0,0.0,,2018,5,8,PAYEMENT,146.0,M1416148496
32305,409000362497',2018-05-08,MEHAR ENTERTAINMENT PRIVA,4724.0,0.0,,2018,5,8,PAYEMENT,4724.0,C1763629640
32306,409000362497',2018-05-08,ALT DIGITAL MEDIA ENTERTA,196.0,0.0,,2018,5,8,DEBIT,196.0,C1327282178
32307,409000362497',2018-05-08,VOUCHER ACTIVATION SERVIC,21130.0,0.0,,2018,5,8,DEBIT,21130.0,M1502691186
32308,409000362497',2018-05-08,QWIKCILVER SOLUTIONS PRIV,7452.0,0.0,,2018,5,8,CASH_OUT,7452.0,C1818375095
32309,409000362497',2018-05-08,Indiaforensic SERVICES INDIA PVT,298403.0,0.0,,2018,5,8,DEBIT,298403.0,C1478160170
32310,409000362497',2018-05-08,NEFT/SBIN718128590581/Indfor,0.0,3300000.0,,2018,5,8,CHECK_CASHING,3300000.0,C2013342140
32311,409000362497',2018-05-08,FDRL/INTERNAL FUND TRANSFE,0.0,10000000.0,,2018,5,8,TRANSFER,10000000.0,C1377194794
32312,409000362497',2018-05-08,FDRL/INTERNAL FUND TRANSFE,0.0,1000000.0,,2018,5,8,CHECK_CASHING,1000000.0,C405881980
32313,409000362497',2018-05-08,FDRL/INTERNAL FUND TRANSFE,0.0,1000000.0,,2018,5,8,TRANSFER,1000000.0,C1298333001
32314,409000362497',2018-05-08,IMPS 0805184C,3850668.01,0.0,,2018,5,8,PAYEMENT,3850668.01,C1643855278
32315,409000362497',2018-05-08,IMPS 812821232602 FROM OX,0.0,200000.0,,2018,5,8,CASH_IN,200000.0,C1450133081
32316,409000362497',2018-05-08,IMPS 812821232652 FROM OX,0.0,200000.0,,2018,5,8,TRANSFER,200000.0,C221687564
32317,409000362497',2018-05-08,IMPS 812821232680 FROM OX,0.0,200000.0,,2018,5,8,TRANSFER,200000.0,C1750002155
32318,409000362497',2018-05-08,Sweep Trf To: 40900036427,478404.0,0.0,,2018,5,8,DEBIT,478404.0,C1802632685
32319,409000362497',2018-05-09,IMPS 080520181C,4181045.15,0.0,,2018,5,9,CASH_OUT,4181045.15,C1921483039
32320,409000362497',2018-05-09,IMPS 090520182C,2662502.3,0.0,,2018,5,9,CHECK_WITHDRAWAL,2662502.3,C1244093207
32321,409000362497',2018-05-09,IMPS 090520183C,5165406.37,0.0,,2018,5,9,CHECK_WITHDRAWAL,5165406.37,C1187520756
32322,409000362497',2018-05-09,FDRL/INTERNAL FUND TRANSFE,0.0,6000000.0,,2018,5,9,CHECK_CASHING,6000000.0,C534252259
32323,409000362497',2018-05-09,FDRL/INTERNAL FUND TRANSFE,0.0,7000000.0,,2018,5,9,TRANSFER,7000000.0,C158876320
32324,409000362497',2018-05-09,FDRL/INTERNAL FUND TRANSFE,0.0,3000000.0,,2018,5,9,TRANSFER,3000000.0,C1937962514
32325,409000362497',2018-05-09,IMPS 0905184C,3996377.53,0.0,,2018,5,9,DEBIT,3996377.53,C657255537
32326,409000362497',2018-05-09,Sweep Trf To: 40900036427,354451.0,0.0,,2018,5,9,CASH_OUT,354451.0,C1582765215
32327,409000362497',2018-05-10,IMPS 090520181C,3929778.59,0.0,,2018,5,10,PAYEMENT,3929778.59,C126778243
32328,409000362497',2018-05-10,IMPS 100520182C,2739887.9,0.0,,2018,5,10,PAYEMENT,2739887.9,C1054041144
32329,409000362497',2018-05-10,BIGTREE ENTERTAINMENT PRI,2267.0,0.0,,2018,5,10,CHECK_WITHDRAWAL,2267.0,M619831912
32330,409000362497',2018-05-10,INDIAIDEAS.COM LTD,98082.0,0.0,,2018,5,10,PAYEMENT,98082.0,C1642948718
32331,409000362497',2018-05-10,IRCTC CORPORATE OFFICE AC,125995.0,0.0,,2018,5,10,CASH_OUT,125995.0,C2135727675
32332,409000362497',2018-05-10,PAYU PAYMENTS PRIVATE LIM,43520.0,0.0,,2018,5,10,PAYEMENT,43520.0,C2124522667
32333,409000362497',2018-05-10,AVENUES INDIA PRIVATE LIM,10993.0,0.0,,2018,5,10,DEBIT,10993.0,M803336535
32334,409000362497',2018-05-10,ZAAK EPAYMENT SERVICES PR,392.0,0.0,,2018,5,10,PAYEMENT,392.0,M879864026
32335,409000362497',2018-05-10,FUTURE RETAIL LIMITED (OW,4028.0,0.0,,2018,5,10,DEBIT,4028.0,M1894919637
32336,409000362497',2018-05-10,PASFAR TECHNOLOGIES PRIVA,2201.0,0.0,,2018,5,10,DEBIT,2201.0,M569549548
32337,409000362497',2018-05-10,JUST DIAL LIMITED,196.0,0.0,,2018,5,10,CASH_OUT,196.0,C709906087
32338,409000362497',2018-05-10,MEHAR ENTERTAINMENT PRIVA,4955.0,0.0,,2018,5,10,CASH_OUT,4955.0,C1670297251
32339,409000362497',2018-05-10,ALT DIGITAL MEDIA ENTERTA,294.0,0.0,,2018,5,10,DEBIT,294.0,M320899683
32340,409000362497',2018-05-10,METRO INFRASYS PRIVATE LI,697.0,0.0,,2018,5,10,CHECK_WITHDRAWAL,697.0,C1921483039
32341,409000362497',2018-05-10,Indiaforensic SERVICES INDIA PVT,480821.0,0.0,,2018,5,10,CASH_OUT,480821.0,C1103621993
32342,409000362497',2018-05-10,IMPS 100520183C,4753918.33,0.0,,2018,5,10,CHECK_WITHDRAWAL,4753918.33,C1209312887
32343,409000362497',2018-05-10,NEFT/SBIN918130381304/Indfor,0.0,6100000.0,,2018,5,10,TRANSFER,6100000.0,M228656494
32344,409000362497',2018-05-10,FDRL/INTERNAL FUND TRANSFE,0.0,10000000.0,,2018,5,10,CHECK_CASHING,10000000.0,M391860142
32345,409000362497',2018-05-10,IMPS 1005184C,3098755.71,0.0,,2018,5,10,DEBIT,3098755.71,M419899572
32346,409000362497',2018-05-10,Sweep Trf To: 40900036427,370913.0,0.0,,2018,5,10,PAYEMENT,370913.0,C1962347131
32347,409000362497',2018-05-11,IMPS 100520181C,4203516.95,0.0,,2018,5,11,CHECK_WITHDRAWAL,4203516.95,M955359500
32348,409000362497',2018-05-11,IMPS 110520182C,2195900.88,0.0,,2018,5,11,CASH_OUT,2195900.88,C360746389
32349,409000362497',2018-05-11,IMPS 110520183C,4918961.07,0.0,,2018,5,11,CASH_OUT,4918961.07,M227411059
32350,409000362497',2018-05-11,NEFT/SBIN118131274094/Indfor,0.0,3500000.0,,2018,5,11,TRANSFER,3500000.0,M993215525
32351,409000362497',2018-05-11,FDRL/INTERNAL FUND TRANSFE,0.0,3000000.0,,2018,5,11,TRANSFER,3000000.0,C517284908
32352,409000362497',2018-05-11,FDRL/INTERNAL FUND TRANSFE,0.0,3000000.0,,2018,5,11,CHECK_CASHING,3000000.0,C2136310491
32353,409000362497',2018-05-11,FDRL/INTERNAL FUND TRANSFE,0.0,500000.0,,2018,5,11,TRANSFER,500000.0,C289751605
32354,409000362497',2018-05-11,FDRL/INTERNAL FUND TRANSFE,0.0,3000000.0,,2018,5,11,CASH_IN,3000000.0,M1820585806
32355,409000362497',2018-05-11,FDRL/INTERNAL FUND TRANSFE,0.0,1000000.0,,2018,5,11,CHECK_CASHING,1000000.0,C2063239007
32356,409000362497',2018-05-11,IMPS 813120127142 FROM OX,0.0,200000.0,,2018,5,11,TRANSFER,200000.0,M1053818065
32357,409000362497',2018-05-11,IMPS 813120127170 FROM OX,0.0,200000.0,,2018,5,11,CASH_IN,200000.0,M542135930
32358,409000362497',2018-05-11,IMPS 813120127198 FROM OX,0.0,200000.0,,2018,5,11,CHECK_CASHING,200000.0,M2119039101
32359,409000362497',2018-05-11,IMPS 813120127232 FROM OX,0.0,200000.0,,2018,5,11,TRANSFER,200000.0,M1028058916
32360,409000362497',2018-05-11,IMPS 813120127262 FROM OX,0.0,200000.0,,2018,5,11,CHECK_CASHING,200000.0,M1048544739
32361,409000362497',2018-05-11,IMPS 813120127291 FROM OX,0.0,200000.0,,2018,5,11,CASH_IN,200000.0,M388494980
32362,409000362497',2018-05-11,IMPS 813120127339 FROM OX,0.0,200000.0,,2018,5,11,TRANSFER,200000.0,C275240684
32363,409000362497',2018-05-11,IMPS 813120127365 FROM OX,0.0,200000.0,,2018,5,11,TRANSFER,200000.0,M2008579472
32364,409000362497',2018-05-11,IMPS 813120127390 FROM OX,0.0,200000.0,,2018,5,11,TRANSFER,200000.0,C435224506
32365,409000362497',2018-05-11,IMPS 813120127422 FROM OX,0.0,200000.0,,2018,5,11,TRANSFER,200000.0,C1538264524
32366,409000362497',2018-05-11,IMPS 813120128012 FROM OX,0.0,200000.0,,2018,5,11,CHECK_CASHING,200000.0,M1073111299
32367,409000362497',2018-05-11,IMPS 813120128033 FROM OX,0.0,200000.0,,2018,5,11,TRANSFER,200000.0,M2049478469
32368,409000362497',2018-05-11,IMPS 813120128057 FROM OX,0.0,200000.0,,2018,5,11,TRANSFER,200000.0,M1270442166
32369,409000362497',2018-05-11,IMPS 813120128089 FROM OX,0.0,200000.0,,2018,5,11,CASH_IN,200000.0,C655702946
32370,409000362497',2018-05-11,IMPS 813120128121 FROM OX,0.0,200000.0,,2018,5,11,TRANSFER,200000.0,C212161362
32371,409000362497',2018-05-11,IMPS 813120128151 FROM OX,0.0,200000.0,,2018,5,11,CHECK_CASHING,200000.0,M50077846
32372,409000362497',2018-05-11,IMPS 813120128175 FROM OX,0.0,200000.0,,2018,5,11,CASH_IN,200000.0,C1015529677
32373,409000362497',2018-05-11,IMPS 813120128204 FROM OX,0.0,200000.0,,2018,5,11,CHECK_CASHING,200000.0,M1508237016
32374,409000362497',2018-05-11,IMPS 813120128226 FROM OX,0.0,200000.0,,2018,5,11,TRANSFER,200000.0,M808655692
32375,409000362497',2018-05-11,IMPS 813120128251 FROM OX,0.0,200000.0,,2018,5,11,TRANSFER,200000.0,M159203159
32376,409000362497',2018-05-11,IMPS 813120128710 FROM OX,0.0,200000.0,,2018,5,11,CASH_IN,200000.0,C989474203
32377,409000362497',2018-05-11,IMPS 813120128741 FROM OX,0.0,200000.0,,2018,5,11,CHECK_CASHING,200000.0,C1563812201
32378,409000362497',2018-05-11,IMPS 813120128767 FROM OX,0.0,200000.0,,2018,5,11,CHECK_CASHING,200000.0,C577034657
32379,409000362497',2018-05-11,IMPS 813120128793 FROM OX,0.0,200000.0,,2018,5,11,TRANSFER,200000.0,C358945794
32380,409000362497',2018-05-11,IMPS 813120128814 FROM OX,0.0,200000.0,,2018,5,11,CASH_IN,200000.0,C409975763
32381,409000362497',2018-05-11,IMPS 813120128836 FROM OX,0.0,200000.0,,2018,5,11,CASH_IN,200000.0,M1986380293
32382,409000362497',2018-05-11,IMPS 813120128869 FROM OX,0.0,200000.0,,2018,5,11,CHECK_CASHING,200000.0,C151015751
32383,409000362497',2018-05-11,IMPS 813120128898 FROM OX,0.0,200000.0,,2018,5,11,CHECK_CASHING,200000.0,C1880444391
32384,409000362497',2018-05-11,IMPS 813120128933 FROM OX,0.0,200000.0,,2018,5,11,CASH_IN,200000.0,C644165296
32385,409000362497',2018-05-11,IMPS 813120128975 FROM OX,0.0,200000.0,,2018,5,11,CHECK_CASHING,200000.0,C1538794629
32386,409000362497',2018-05-11,IMPS 813120129487 FROM OX,0.0,200000.0,,2018,5,11,CHECK_CASHING,200000.0,C1837057885
32387,409000362497',2018-05-11,IMPS 813120129511 FROM OX,0.0,200000.0,,2018,5,11,CASH_IN,200000.0,C1606884481
32388,409000362497',2018-05-11,IMPS 813120129533 FROM OX,0.0,200000.0,,2018,5,11,CASH_IN,200000.0,M1136779182
32389,409000362497',2018-05-11,IMPS 813120129556 FROM OX,0.0,200000.0,,2018,5,11,CHECK_CASHING,200000.0,C1531333864
32390,409000362497',2018-05-11,IMPS 813120129585 FROM OX,0.0,200000.0,,2018,5,11,TRANSFER,200000.0,M87013737
32391,409000362497',2018-05-11,IMPS 813120129618 FROM OX,0.0,200000.0,,2018,5,11,TRANSFER,200000.0,M1061255250
32392,409000362497',2018-05-11,IMPS 813120129647 FROM OX,0.0,200000.0,,2018,5,11,TRANSFER,200000.0,M1150437241
32393,409000362497',2018-05-11,IMPS 813120129675 FROM OX,0.0,200000.0,,2018,5,11,CHECK_CASHING,200000.0,M1234465146
32394,409000362497',2018-05-11,IMPS 813120129705 FROM OX,0.0,200000.0,,2018,5,11,CHECK_CASHING,200000.0,M1367354996
32395,409000362497',2018-05-11,IMPS 813120129732 FROM OX,0.0,200000.0,,2018,5,11,CASH_IN,200000.0,M1587028291
32396,409000362497',2018-05-11,IMPS 813120130224 FROM OX,0.0,200000.0,,2018,5,11,TRANSFER,200000.0,C1735099891
32397,409000362497',2018-05-11,IMPS 813120130238 FROM OX,0.0,200000.0,,2018,5,11,CHECK_CASHING,200000.0,M696616263
32398,409000362497',2018-05-11,IMPS 813120130266 FROM OX,0.0,200000.0,,2018,5,11,TRANSFER,200000.0,C380928130
32399,409000362497',2018-05-11,IMPS 813120130291 FROM OX,0.0,200000.0,,2018,5,11,CHECK_CASHING,200000.0,C86702216
32400,409000362497',2018-05-11,IMPS 813120130316 FROM OX,0.0,200000.0,,2018,5,11,CASH_IN,200000.0,C2095263022
32401,409000362497',2018-05-11,IMPS 813120130348 FROM OX,0.0,200000.0,,2018,5,11,CHECK_CASHING,200000.0,C1352679499
32402,409000362497',2018-05-11,IMPS 813120130376 FROM OX,0.0,200000.0,,2018,5,11,TRANSFER,200000.0,C1554622120
32403,409000362497',2018-05-11,IMPS 813120130394 FROM OX,0.0,200000.0,,2018,5,11,CHECK_CASHING,200000.0,M96426981
32404,409000362497',2018-05-11,IMPS 813120130418 FROM OX,0.0,200000.0,,2018,5,11,CHECK_CASHING,200000.0,M1320253817
32405,409000362497',2018-05-11,IMPS 813120130446 FROM OX,0.0,200000.0,,2018,5,11,TRANSFER,200000.0,M1806786358
32406,409000362497',2018-05-11,IMPS 813120130669 FROM OX,0.0,200000.0,,2018,5,11,CHECK_CASHING,200000.0,C1794549600
32407,409000362497',2018-05-11,IMPS 813120130697 FROM OX,0.0,200000.0,,2018,5,11,CASH_IN,200000.0,C786583473
32408,409000362497',2018-05-11,IMPS 813120130724 FROM OX,0.0,200000.0,,2018,5,11,CHECK_CASHING,200000.0,M265128129
32409,409000362497',2018-05-11,IMPS 813120130753 FROM OX,0.0,200000.0,,2018,5,11,TRANSFER,200000.0,M886721960
32410,409000362497',2018-05-11,IMPS 813120130774 FROM OX,0.0,200000.0,,2018,5,11,CASH_IN,200000.0,M403652552
32411,409000362497',2018-05-11,IMPS 813120130793 FROM OX,0.0,200000.0,,2018,5,11,CASH_IN,200000.0,M931592570
32412,409000362497',2018-05-11,IMPS 813120130816 FROM OX,0.0,200000.0,,2018,5,11,CHECK_CASHING,200000.0,C136383086
32413,409000362497',2018-05-11,IMPS 813120130843 FROM OX,0.0,200000.0,,2018,5,11,TRANSFER,200000.0,M2141138813
32414,409000362497',2018-05-11,IMPS 813120130865 FROM OX,0.0,200000.0,,2018,5,11,CHECK_CASHING,200000.0,M1822339311
32415,409000362497',2018-05-11,IMPS 813120130893 FROM OX,0.0,200000.0,,2018,5,11,CASH_IN,200000.0,M482686466
32416,409000362497',2018-05-11,IMPS 813120131263 FROM OX,0.0,200000.0,,2018,5,11,CHECK_CASHING,200000.0,M1759257319
32417,409000362497',2018-05-11,IMPS 813120131297 FROM OX,0.0,200000.0,,2018,5,11,CHECK_CASHING,200000.0,M2133726111
32418,409000362497',2018-05-11,IMPS 813120131320 FROM OX,0.0,200000.0,,2018,5,11,TRANSFER,200000.0,M1623836264
32419,409000362497',2018-05-11,IMPS 813120131344 FROM OX,0.0,200000.0,,2018,5,11,CASH_IN,200000.0,C842729010
32420,409000362497',2018-05-11,IMPS 813120131366 FROM OX,0.0,200000.0,,2018,5,11,CHECK_CASHING,200000.0,C1425517471
32421,409000362497',2018-05-11,IMPS 813120131382 FROM OX,0.0,200000.0,,2018,5,11,CHECK_CASHING,200000.0,C1377194794
32422,409000362497',2018-05-11,IMPS 813120131410 FROM OX,0.0,200000.0,,2018,5,11,CHECK_CASHING,200000.0,C388286025
32423,409000362497',2018-05-11,IMPS 813120131430 FROM OX,0.0,200000.0,,2018,5,11,CASH_IN,200000.0,C562195832
32424,409000362497',2018-05-11,IMPS 813120131449 FROM OX,0.0,200000.0,,2018,5,11,CHECK_CASHING,200000.0,C1638543071
32425,409000362497',2018-05-11,IMPS 813120131471 FROM OX,0.0,200000.0,,2018,5,11,TRANSFER,200000.0,C1394526584
32426,409000362497',2018-05-11,IMPS 1105184C,3424784.74,0.0,,2018,5,11,DEBIT,3424784.74,C64133603
32427,409000362497',2018-05-11,IMPS 813120131847 FROM OX,0.0,200000.0,,2018,5,11,CHECK_CASHING,200000.0,C1588901702
32428,409000362497',2018-05-11,IMPS 813120131870 FROM OX,0.0,200000.0,,2018,5,11,CASH_IN,200000.0,C773919571
32429,409000362497',2018-05-11,IMPS 813120131891 FROM OX,0.0,200000.0,,2018,5,11,TRANSFER,200000.0,C646059443
32430,409000362497',2018-05-11,IMPS 813120131917 FROM OX,0.0,200000.0,,2018,5,11,TRANSFER,200000.0,C651445737
32431,409000362497',2018-05-11,IMPS 813120131940 FROM OX,0.0,200000.0,,2018,5,11,CHECK_CASHING,200000.0,C191614132
32432,409000362497',2018-05-11,IMPS 813120131962 FROM OX,0.0,200000.0,,2018,5,11,TRANSFER,200000.0,C1703196166
32433,409000362497',2018-05-11,IMPS 813120131983 FROM OX,0.0,200000.0,,2018,5,11,CASH_IN,200000.0,C1929902741
32434,409000362497',2018-05-11,IMPS 813120132006 FROM OX,0.0,200000.0,,2018,5,11,CASH_IN,200000.0,C1238707698
32435,409000362497',2018-05-11,IMPS 813120132026 FROM OX,0.0,200000.0,,2018,5,11,CASH_IN,200000.0,C1892646174
32436,409000362497',2018-05-11,IMPS 813120132056 FROM OX,0.0,200000.0,,2018,5,11,CASH_IN,200000.0,C1570076320
32437,409000362497',2018-05-11,IMPS 813120132504 FROM OX,0.0,200000.0,,2018,5,11,CHECK_CASHING,200000.0,C1107146140
32438,409000362497',2018-05-11,IMPS 813120132543 FROM OX,0.0,200000.0,,2018,5,11,TRANSFER,200000.0,C1556875182
32439,409000362497',2018-05-11,IMPS 813120132578 FROM OX,0.0,200000.0,,2018,5,11,CASH_IN,200000.0,C986473968
32440,409000362497',2018-05-11,IMPS 813120132613 FROM OX,0.0,200000.0,,2018,5,11,TRANSFER,200000.0,C1067936865
32441,409000362497',2018-05-11,IMPS 813120132648 FROM OX,0.0,200000.0,,2018,5,11,TRANSFER,200000.0,M957220660
32442,409000362497',2018-05-11,IMPS 813120132671 FROM OX,0.0,200000.0,,2018,5,11,CASH_IN,200000.0,M1369483401
32443,409000362497',2018-05-11,IMPS 813120132697 FROM OX,0.0,200000.0,,2018,5,11,TRANSFER,200000.0,M1330265126
32444,409000362497',2018-05-11,IMPS 813120132730 FROM OX,0.0,200000.0,,2018,5,11,CASH_IN,200000.0,M1703204250
32445,409000362497',2018-05-11,IMPS 813120132752 FROM OX,0.0,200000.0,,2018,5,11,CHECK_CASHING,200000.0,C262737815
32446,409000362497',2018-05-11,IMPS 813120132781 FROM OX,0.0,200000.0,,2018,5,11,CASH_IN,200000.0,C1337741679
32447,409000362497',2018-05-11,IMPS 813120133227 FROM OX,0.0,200000.0,,2018,5,11,CHECK_CASHING,200000.0,C182908323
32448,409000362497',2018-05-11,IMPS 813120133250 FROM OX,0.0,200000.0,,2018,5,11,CASH_IN,200000.0,C14057327
32449,409000362497',2018-05-11,IMPS 813120133281 FROM OX,0.0,200000.0,,2018,5,11,TRANSFER,200000.0,M1061851864
32450,409000362497',2018-05-11,IMPS 813121133304 FROM OX,0.0,200000.0,,2018,5,11,CHECK_CASHING,200000.0,C1113848808
32451,409000362497',2018-05-11,IMPS 813121133327 FROM OX,0.0,200000.0,,2018,5,11,TRANSFER,200000.0,C800572196
32452,409000362497',2018-05-11,IMPS 813121133349 FROM OX,0.0,200000.0,,2018,5,11,TRANSFER,200000.0,M947223681
32453,409000362497',2018-05-11,IMPS 813121133371 FROM OX,0.0,200000.0,,2018,5,11,CASH_IN,200000.0,M1434950311
32454,409000362497',2018-05-11,IMPS 813121133383 FROM OX,0.0,200000.0,,2018,5,11,TRANSFER,200000.0,M46143177
32455,409000362497',2018-05-11,Sweep Trf To: 40900036427,262697.0,0.0,,2018,5,11,CASH_OUT,262697.0,M1913725070
32456,409000362497',2018-05-12,IMPS 813217332053 FROM OX,0.0,200000.0,,2018,5,12,CASH_IN,200000.0,M1990824709
32457,409000362497',2018-05-12,IMPS 813217332078 FROM OX,0.0,200000.0,,2018,5,12,CASH_IN,200000.0,C770030446
32458,409000362497',2018-05-12,IMPS 813217332089 FROM OX,0.0,200000.0,,2018,5,12,TRANSFER,200000.0,C1589547066
32459,409000362497',2018-05-12,IMPS 813217332122 FROM OX,0.0,200000.0,,2018,5,12,TRANSFER,200000.0,M1666767070
32460,409000362497',2018-05-12,IMPS 813217332147 FROM OX,0.0,200000.0,,2018,5,12,TRANSFER,200000.0,M1789548399
32461,409000362497',2018-05-12,IMPS 813217332177 FROM OX,0.0,200000.0,,2018,5,12,CHECK_CASHING,200000.0,M206301473
32462,409000362497',2018-05-12,IMPS 813217332206 FROM OX,0.0,200000.0,,2018,5,12,CASH_IN,200000.0,M1897373046
32463,409000362497',2018-05-12,IMPS 813217332225 FROM OX,0.0,200000.0,,2018,5,12,CHECK_CASHING,200000.0,C267527788
32464,409000362497',2018-05-12,IMPS 813217332254 FROM OX,0.0,200000.0,,2018,5,12,TRANSFER,200000.0,C1467301185
32465,409000362497',2018-05-12,IMPS 813217332277 FROM OX,0.0,200000.0,,2018,5,12,CASH_IN,200000.0,C1040847151
32466,409000362497',2018-05-12,IMPS 813217332784 FROM OX,0.0,200000.0,,2018,5,12,CASH_IN,200000.0,C1671386208
32467,409000362497',2018-05-12,IMPS 813217332811 FROM OX,0.0,200000.0,,2018,5,12,CASH_IN,200000.0,C498177314
32468,409000362497',2018-05-12,IMPS 813217332830 FROM OX,0.0,200000.0,,2018,5,12,TRANSFER,200000.0,C384735911
32469,409000362497',2018-05-12,IMPS 813217332857 FROM OX,0.0,200000.0,,2018,5,12,TRANSFER,200000.0,C901438460
32470,409000362497',2018-05-12,IMPS 813217332880 FROM OX,0.0,200000.0,,2018,5,12,CHECK_CASHING,200000.0,C24955689
32471,409000362497',2018-05-12,IMPS 813217332907 FROM OX,0.0,200000.0,,2018,5,12,TRANSFER,200000.0,C1958036068
32472,409000362497',2018-05-12,IMPS 813217332940 FROM OX,0.0,200000.0,,2018,5,12,CASH_IN,200000.0,C763197395
32473,409000362497',2018-05-12,IMPS 813217332960 FROM OX,0.0,200000.0,,2018,5,12,CHECK_CASHING,200000.0,C2061011390
32474,409000362497',2018-05-12,IMPS 813217332977 FROM OX,0.0,200000.0,,2018,5,12,TRANSFER,200000.0,C1208032448
32475,409000362497',2018-05-12,IMPS 813217333010 FROM OX,0.0,200000.0,,2018,5,12,CHECK_CASHING,200000.0,C1948471365
32476,409000362497',2018-05-12,IMPS 813217333392 FROM OX,0.0,200000.0,,2018,5,12,CHECK_CASHING,200000.0,C384209960
32477,409000362497',2018-05-12,IMPS 813217333417 FROM OX,0.0,200000.0,,2018,5,12,CASH_IN,200000.0,C128846374
32478,409000362497',2018-05-12,IMPS 813217333440 FROM OX,0.0,200000.0,,2018,5,12,CHECK_CASHING,200000.0,C1732817669
32479,409000362497',2018-05-12,IMPS 813217333471 FROM OX,0.0,200000.0,,2018,5,12,CASH_IN,200000.0,C1292435170
32480,409000362497',2018-05-12,IMPS 813217333496 FROM OX,0.0,200000.0,,2018,5,12,TRANSFER,200000.0,C137840913
32481,409000362497',2018-05-12,IMPS 813217333531 FROM OX,0.0,200000.0,,2018,5,12,CASH_IN,200000.0,C861720625
32482,409000362497',2018-05-13,IMPS 813314489653 FROM OX,0.0,200000.0,,2018,5,13,CHECK_CASHING,200000.0,C727209127
32483,409000362497',2018-05-13,IMPS 813314489667 FROM OX,0.0,200000.0,,2018,5,13,TRANSFER,200000.0,C518953848
32484,409000362497',2018-05-13,IMPS 813314489683 FROM OX,0.0,200000.0,,2018,5,13,CHECK_CASHING,200000.0,C594250212
32485,409000362497',2018-05-13,IMPS 813314489703 FROM OX,0.0,200000.0,,2018,5,13,TRANSFER,200000.0,C1443373883
32486,409000362497',2018-05-13,IMPS 813314489717 FROM OX,0.0,200000.0,,2018,5,13,CHECK_CASHING,200000.0,C1012785532
32487,409000362497',2018-05-13,IMPS 813314489736 FROM OX,0.0,200000.0,,2018,5,13,TRANSFER,200000.0,C1052117080
32488,409000362497',2018-05-13,IMPS 813314489755 FROM OX,0.0,200000.0,,2018,5,13,TRANSFER,200000.0,C1060563153
32489,409000362497',2018-05-14,BIGTREE ENTERTAINMENT PRI,2181.0,0.0,,2018,5,14,CASH_OUT,2181.0,C1851336450
32490,409000362497',2018-05-14,INDIAIDEAS.COM LTD,41565.0,0.0,,2018,5,14,CHECK_WITHDRAWAL,41565.0,C132379888
32491,409000362497',2018-05-14,IRCTC CORPORATE OFFICE AC,37000.0,0.0,,2018,5,14,DEBIT,37000.0,C1465813088
32492,409000362497',2018-05-14,PAYU PAYMENTS PRIVATE LIM,24422.0,0.0,,2018,5,14,DEBIT,24422.0,C1014923261
32493,409000362497',2018-05-14,AVENUES INDIA PRIVATE LIM,11457.0,0.0,,2018,5,14,CHECK_WITHDRAWAL,11457.0,C1185525558
32494,409000362497',2018-05-14,FUTURE RETAIL LIMITED (OW,3583.0,0.0,,2018,5,14,PAYEMENT,3583.0,C855085682
32495,409000362497',2018-05-14,PASFAR TECHNOLOGIES PRIVA,3655.0,0.0,,2018,5,14,CHECK_WITHDRAWAL,3655.0,C579802590
32496,409000362497',2018-05-14,DISH INFRA SERVICES PRIVA,244.0,0.0,,2018,5,14,DEBIT,244.0,C126351739
32497,409000362497',2018-05-14,JUST DIAL LIMITED,166.0,0.0,,2018,5,14,CASH_OUT,166.0,C70895366
32498,409000362497',2018-05-14,MEHAR ENTERTAINMENT PRIVA,3456.0,0.0,,2018,5,14,CASH_OUT,3456.0,C739289034
32499,409000362497',2018-05-14,Indiaforensic SERVICES INDIA PVT,261599.0,0.0,,2018,5,14,DEBIT,261599.0,C836903727
32500,409000362497',2018-05-14,IMPS 110520181C,3216056.59,0.0,,2018,5,14,CASH_OUT,3216056.59,C1481468605
32501,409000362497',2018-05-14,IMPS 120520181C,13872060.49,0.0,,2018,5,14,PAYEMENT,13872060.49,C346008447
32502,409000362497',2018-05-14,IMPS 130520181C,9749384.18,0.0,,2018,5,14,CASH_OUT,9749384.18,C392060481
32503,409000362497',2018-05-14,IMPS 140520182C,2520195.92,0.0,,2018,5,14,PAYEMENT,2520195.92,C498177314
32504,409000362497',2018-05-14,BIGTREE ENTERTAINMENT PRI,13736.0,0.0,,2018,5,14,DEBIT,13736.0,C1588635270
32505,409000362497',2018-05-14,INDIAIDEAS.COM LTD,113724.0,0.0,,2018,5,14,DEBIT,113724.0,C358804045
32506,409000362497',2018-05-14,IRCTC CORPORATE OFFICE AC,121355.0,0.0,,2018,5,14,CHECK_WITHDRAWAL,121355.0,C1988852187
32507,409000362497',2018-05-14,PAYU PAYMENTS PRIVATE LIM,76160.0,0.0,,2018,5,14,PAYEMENT,76160.0,C1251600325
32508,409000362497',2018-05-14,AVENUES INDIA PRIVATE LIM,15394.0,0.0,,2018,5,14,CHECK_WITHDRAWAL,15394.0,C434885441
32509,409000362497',2018-05-14,SYNERGISTIC FINANCIAL NET,98.0,0.0,,2018,5,14,PAYEMENT,98.0,C2107935820
32510,409000362497',2018-05-14,ZAAK EPAYMENT SERVICES PR,120.0,0.0,,2018,5,14,PAYEMENT,120.0,C779874418
32511,409000362497',2018-05-14,FUTURE RETAIL LIMITED (OW,2914.0,0.0,,2018,5,14,CASH_OUT,2914.0,C1348373832
32512,409000362497',2018-05-14,PASFAR TECHNOLOGIES PRIVA,23143.0,0.0,,2018,5,14,PAYEMENT,23143.0,C2139106882
32513,409000362497',2018-05-14,DISH INFRA SERVICES PRIVA,342.0,0.0,,2018,5,14,DEBIT,342.0,C1474346966
32514,409000362497',2018-05-14,MEHAR ENTERTAINMENT PRIVA,8526.0,0.0,,2018,5,14,DEBIT,8526.0,C717951588
32515,409000362497',2018-05-14,ALT DIGITAL MEDIA ENTERTA,98.0,0.0,,2018,5,14,DEBIT,98.0,C1951887558
32516,409000362497',2018-05-14,Indiaforensic SERVICES INDIA PVT,582810.0,0.0,,2018,5,14,DEBIT,582810.0,C1121686878
32517,409000362497',2018-05-14,IMPS 140520183C,5647663.89,0.0,,2018,5,14,CASH_OUT,5647663.89,C1104197405
32518,409000362497',2018-05-14,NEFT/SBIN218134230685/Indfor,0.0,3600000.0,,2018,5,14,CHECK_CASHING,3600000.0,C1883788127
32519,409000362497',2018-05-14,FDRL/INTERNAL FUND TRANSFE,0.0,3000000.0,,2018,5,14,CASH_IN,3000000.0,C1815271991
32520,409000362497',2018-05-14,FDRL/INTERNAL FUND TRANSFE,0.0,5000000.0,,2018,5,14,TRANSFER,5000000.0,C478124129
32521,409000362497',2018-05-14,FDRL/INTERNAL FUND TRANSFE,0.0,5000000.0,,2018,5,14,TRANSFER,5000000.0,C219913687
32522,409000362497',2018-05-14,IMPS 1405184C,4118729.47,0.0,,2018,5,14,DEBIT,4118729.47,C2082035934
32523,409000362497',2018-05-14,Sweep Trf To: 40900036427,491668.0,0.0,,2018,5,14,PAYEMENT,491668.0,C312537393
32524,409000362497',2018-05-15,IMPS 150520182C,2473115.83,0.0,,2018,5,15,PAYEMENT,2473115.83,C664038638
32525,409000362497',2018-05-15,IMPS 140520181C,4204082.79,0.0,,2018,5,15,PAYEMENT,4204082.79,C545710008
32526,409000362497',2018-05-15,IMPS 150520183C,4720508.06,0.0,,2018,5,15,DEBIT,4720508.06,C278407008
32527,409000362497',2018-05-15,BIGTREE ENTERTAINMENT PRI,1015.0,0.0,,2018,5,15,PAYEMENT,1015.0,C1549086472
32528,409000362497',2018-05-15,INDIAIDEAS.COM LTD,25895.0,0.0,,2018,5,15,DEBIT,25895.0,C275240684
32529,409000362497',2018-05-15,IRCTC CORPORATE OFFICE AC,27905.0,0.0,,2018,5,15,PAYEMENT,27905.0,C1308497108
32530,409000362497',2018-05-15,PAYU PAYMENTS PRIVATE LIM,23167.0,0.0,,2018,5,15,PAYEMENT,23167.0,C820910648
32531,409000362497',2018-05-15,AVENUES INDIA PRIVATE LIM,789.0,0.0,,2018,5,15,PAYEMENT,789.0,C548497314
32532,409000362497',2018-05-15,ZAAK EPAYMENT SERVICES PR,196.0,0.0,,2018,5,15,CHECK_WITHDRAWAL,196.0,C151015751
32533,409000362497',2018-05-15,FUTURE RETAIL LIMITED (OW,1597.0,0.0,,2018,5,15,CASH_OUT,1597.0,C767904468
32534,409000362497',2018-05-15,PASFAR TECHNOLOGIES PRIVA,1698.0,0.0,,2018,5,15,DEBIT,1698.0,C536171536
32535,409000362497',2018-05-15,MEHAR ENTERTAINMENT PRIVA,3111.0,0.0,,2018,5,15,PAYEMENT,3111.0,C1747713912
32536,409000362497',2018-05-15,QWIKCILVER SOLUTIONS PRIV,7646.0,0.0,,2018,5,15,DEBIT,7646.0,C2072302823
32537,409000362497',2018-05-15,Indiaforensic SERVICES INDIA PVT,242666.0,0.0,,2018,5,15,CASH_OUT,242666.0,C618018140
32538,409000362497',2018-05-15,NEFT/SBIN218135983677/Indfor,0.0,3000000.0,,2018,5,15,TRANSFER,3000000.0,M1370162365
32539,409000362497',2018-05-15,IMPS 1505184C,2386053.93,0.0,,2018,5,15,CASH_OUT,2386053.93,C1790831319
32540,409000362497',2018-05-15,FDRL/INTERNAL FUND TRANSFE,0.0,4000000.0,,2018,5,15,CHECK_CASHING,4000000.0,M1460097403
32541,409000362497',2018-05-15,FDRL/INTERNAL FUND TRANSFE,0.0,6000000.0,,2018,5,15,CASH_IN,6000000.0,M896242697
32542,409000362497',2018-05-15,Sweep Trf To: 40900036427,438010.0,0.0,,2018,5,15,CHECK_WITHDRAWAL,438010.0,C1643217922
32543,409000362497',2018-05-16,IMPS 150520181C,4289250.74,0.0,,2018,5,16,CHECK_WITHDRAWAL,4289250.74,M1796789448
32544,409000362497',2018-05-16,IMPS 160520182C,2608411.45,0.0,,2018,5,16,PAYEMENT,2608411.45,M403815503
32545,409000362497',2018-05-16,IMPS 160520183C,4568194.3,0.0,,2018,5,16,CHECK_WITHDRAWAL,4568194.3,C482045746
32546,409000362497',2018-05-16,BIGTREE ENTERTAINMENT PRI,1101.0,0.0,,2018,5,16,DEBIT,1101.0,C569022831
32547,409000362497',2018-05-16,INDIAIDEAS.COM LTD,39019.0,0.0,,2018,5,16,CASH_OUT,39019.0,M186699903
32548,409000362497',2018-05-16,IRCTC CORPORATE OFFICE AC,41065.0,0.0,,2018,5,16,PAYEMENT,41065.0,M1060273173
32549,409000362497',2018-05-16,PAYU PAYMENTS PRIVATE LIM,16805.0,0.0,,2018,5,16,DEBIT,16805.0,M466751811
32550,409000362497',2018-05-16,AVENUES INDIA PRIVATE LIM,19821.0,0.0,,2018,5,16,DEBIT,19821.0,M1290847797
32551,409000362497',2018-05-16,FUTURE RETAIL LIMITED (OW,931.0,0.0,,2018,5,16,DEBIT,931.0,C358804045
32552,409000362497',2018-05-16,PASFAR TECHNOLOGIES PRIVA,1854.0,0.0,,2018,5,16,CASH_OUT,1854.0,M588544145
32553,409000362497',2018-05-16,MEHAR ENTERTAINMENT PRIVA,4724.0,0.0,,2018,5,16,CHECK_WITHDRAWAL,4724.0,C1632648448
32554,409000362497',2018-05-16,VOUCHER ACTIVATION SERVIC,8772.0,0.0,,2018,5,16,PAYEMENT,8772.0,M2028574070
32555,409000362497',2018-05-16,Indiaforensic SERVICES INDIA PVT,213015.0,0.0,,2018,5,16,PAYEMENT,213015.0,C706331499
32556,409000362497',2018-05-16,NEFT/SBIN318136774765/Indfor,0.0,2100000.0,,2018,5,16,CASH_IN,2100000.0,M1913684695
32557,409000362497',2018-05-16,FDRL/INTERNAL FUND TRANSFE,0.0,10000000.0,,2018,5,16,CHECK_CASHING,10000000.0,C1945176140
32558,409000362497',2018-05-16,FDRL/INTERNAL FUND TRANSFE,0.0,3000000.0,,2018,5,16,CHECK_CASHING,3000000.0,M2034100031
32559,409000362497',2018-05-16,IMPS 1605184C,3033545.78,0.0,,2018,5,16,DEBIT,3033545.78,M2122622481
32560,409000362497',2018-05-16,Sweep Trf To: 40900036427,160300.0,0.0,,2018,5,16,PAYEMENT,160300.0,M1276093672
32561,409000362497',2018-05-17,IMPS 160520181C,3844485.4,0.0,,2018,5,17,DEBIT,3844485.4,M1986737263
32562,409000362497',2018-05-17,IMPS 170520182C,1989925.32,0.0,,2018,5,17,DEBIT,1989925.32,M1895578485
32563,409000362497',2018-05-17,BIGTREE ENTERTAINMENT PRI,1384.0,0.0,,2018,5,17,CHECK_WITHDRAWAL,1384.0,M1464356375
32564,409000362497',2018-05-17,INDIAIDEAS.COM LTD,25124.0,0.0,,2018,5,17,CASH_OUT,25124.0,C1556993174
32565,409000362497',2018-05-17,IRCTC CORPORATE OFFICE AC,30205.0,0.0,,2018,5,17,CASH_OUT,30205.0,C596299019
32566,409000362497',2018-05-17,PAYU PAYMENTS PRIVATE LIM,37324.0,0.0,,2018,5,17,CASH_OUT,37324.0,C1186157294
32567,409000362497',2018-05-17,AVENUES INDIA PRIVATE LIM,7840.0,0.0,,2018,5,17,CASH_OUT,7840.0,M1242143492
32568,409000362497',2018-05-17,SYNERGISTIC FINANCIAL NET,108.0,0.0,,2018,5,17,PAYEMENT,108.0,C1003872245
32569,409000362497',2018-05-17,FUTURE RETAIL LIMITED (OW,9563.0,0.0,,2018,5,17,DEBIT,9563.0,M1688273534
32570,409000362497',2018-05-17,PASFAR TECHNOLOGIES PRIVA,11911.0,0.0,,2018,5,17,CASH_OUT,11911.0,C1244947864
32571,409000362497',2018-05-17,MEHAR ENTERTAINMENT PRIVA,2304.0,0.0,,2018,5,17,CHECK_WITHDRAWAL,2304.0,C15445402
32572,409000362497',2018-05-17,Indiaforensic SERVICES INDIA PVT,179253.12,0.0,,2018,5,17,CASH_OUT,179253.12,C1750956965
32573,409000362497',2018-05-17,IMPS 170520183C,5067573.16,0.0,,2018,5,17,DEBIT,5067573.16,C910539221
32574,409000362497',2018-05-17,NEFT/SBIN418137577459/Indfor,0.0,2000000.0,,2018,5,17,TRANSFER,2000000.0,C237685833
32575,409000362497',2018-05-17,FDRL/INTERNAL FUND TRANSFE,0.0,5000000.0,,2018,5,17,TRANSFER,5000000.0,C129529297
32576,409000362497',2018-05-17,FDRL/INTERNAL FUND TRANSFE,0.0,5000000.0,,2018,5,17,TRANSFER,5000000.0,C323287038
32577,409000362497',2018-05-17,FDRL/INTERNAL FUND TRANSFE,0.0,1000000.0,,2018,5,17,TRANSFER,1000000.0,M1116034165
32578,409000362497',2018-05-17,FDRL/INTERNAL FUND TRANSFE,0.0,500000.0,,2018,5,17,CASH_IN,500000.0,C1590351968
32579,409000362497',2018-05-17,IMPS 1705184C,2708255.51,0.0,,2018,5,17,PAYEMENT,2708255.51,C1037045436
32580,409000362497',2018-05-17,Sweep Trf To: 40900036427,242487.0,0.0,,2018,5,17,CASH_OUT,242487.0,C1506782127
32581,409000362497',2018-05-18,ACH DR NATIONAL PAYMENT C,10000.0,0.0,,2018,5,18,PAYEMENT,10000.0,C2096057945
32582,409000362497',2018-05-18,ACH DR NATIONAL PAYMENT C,5524.97,0.0,,2018,5,18,PAYEMENT,5524.97,C1775175845
32583,409000362497',2018-05-18,IMPS 170520181C,3496871.2,0.0,,2018,5,18,PAYEMENT,3496871.2,M45422147
32584,409000362497',2018-05-18,IMPS 180520182C,2163923.06,0.0,,2018,5,18,CASH_OUT,2163923.06,C1749476584
32585,409000362497',2018-05-18,BIGTREE ENTERTAINMENT PRI,1593.0,0.0,,2018,5,18,PAYEMENT,1593.0,M1286190782
32586,409000362497',2018-05-18,INDIAIDEAS.COM LTD,26540.0,0.0,,2018,5,18,CASH_OUT,26540.0,C424918165
32587,409000362497',2018-05-18,IRCTC CORPORATE OFFICE AC,53700.0,0.0,,2018,5,18,DEBIT,53700.0,M2075269712
32588,409000362497',2018-05-18,PAYU PAYMENTS PRIVATE LIM,28159.0,0.0,,2018,5,18,CASH_OUT,28159.0,M962326891
32589,409000362497',2018-05-18,AXEL RETAIL PRIVATE LIMIT,415.0,0.0,,2018,5,18,DEBIT,415.0,M303971511
32590,409000362497',2018-05-18,AVENUES INDIA PRIVATE LIM,18273.0,0.0,,2018,5,18,DEBIT,18273.0,M1954134798
32591,409000362497',2018-05-18,FUTURE RETAIL LIMITED (OW,266.0,0.0,,2018,5,18,PAYEMENT,266.0,C1014923261
32592,409000362497',2018-05-18,PASFAR TECHNOLOGIES PRIVA,2730.0,0.0,,2018,5,18,CASH_OUT,2730.0,M743312322
32593,409000362497',2018-05-18,MEHAR ENTERTAINMENT PRIVA,2074.0,0.0,,2018,5,18,CHECK_WITHDRAWAL,2074.0,M953286520
32594,409000362497',2018-05-18,Indiaforensic SERVICES INDIA PVT,218875.0,0.0,,2018,5,18,DEBIT,218875.0,M1777872287
32595,409000362497',2018-05-18,IMPS 180520183C,4681819.8,0.0,,2018,5,18,PAYEMENT,4681819.8,M2016533144
32596,409000362497',2018-05-18,NEFT/SBIN518138340500/Indfor,0.0,2500000.0,,2018,5,18,TRANSFER,2500000.0,M1151998614
32597,409000362497',2018-05-18,IMPS 813819876618 FROM OX,0.0,200000.0,,2018,5,18,CASH_IN,200000.0,M453864334
32598,409000362497',2018-05-18,IMPS 813819876651 FROM OX,0.0,200000.0,,2018,5,18,CASH_IN,200000.0,M1360897541
32599,409000362497',2018-05-18,IMPS 813819876675 FROM OX,0.0,200000.0,,2018,5,18,CASH_IN,200000.0,M955698679
32600,409000362497',2018-05-18,IMPS 813819876705 FROM OX,0.0,200000.0,,2018,5,18,CASH_IN,200000.0,C735889364
32601,409000362497',2018-05-18,IMPS 813819876737 FROM OX,0.0,200000.0,,2018,5,18,CASH_IN,200000.0,C747551263
32602,409000362497',2018-05-18,IMPS 813819876768 FROM OX,0.0,200000.0,,2018,5,18,TRANSFER,200000.0,M8194268
32603,409000362497',2018-05-18,IMPS 813819876801 FROM OX,0.0,200000.0,,2018,5,18,CHECK_CASHING,200000.0,C1380404490
32604,409000362497',2018-05-18,IMPS 813819876841 FROM OX,0.0,200000.0,,2018,5,18,CASH_IN,200000.0,M1746417258
32605,409000362497',2018-05-18,IMPS 813819876865 FROM OX,0.0,200000.0,,2018,5,18,CASH_IN,200000.0,C1436136891
32606,409000362497',2018-05-18,IMPS 813819877224 FROM OX,0.0,200000.0,,2018,5,18,TRANSFER,200000.0,M926914083
32607,409000362497',2018-05-18,IMPS 813819877262 FROM OX,0.0,200000.0,,2018,5,18,TRANSFER,200000.0,C649699940
32608,409000362497',2018-05-18,FDRL/INTERNAL FUND TRANSFE,0.0,7000000.0,,2018,5,18,CHECK_CASHING,7000000.0,C929286459
32609,409000362497',2018-05-18,IMPS 813820891861 FROM OX,0.0,200000.0,,2018,5,18,TRANSFER,200000.0,M1471971264
32610,409000362497',2018-05-18,IMPS 813820891881 FROM OX,0.0,200000.0,,2018,5,18,TRANSFER,200000.0,M1020602772
32611,409000362497',2018-05-18,IMPS 813820891912 FROM OX,0.0,200000.0,,2018,5,18,CASH_IN,200000.0,M1609202780
32612,409000362497',2018-05-18,IMPS 813820891949 FROM OX,0.0,200000.0,,2018,5,18,TRANSFER,200000.0,M886869071
32613,409000362497',2018-05-18,IMPS 813820891974 FROM OX,0.0,200000.0,,2018,5,18,TRANSFER,200000.0,M824819181
32614,409000362497',2018-05-18,IMPS 813820892000 FROM OX,0.0,200000.0,,2018,5,18,CHECK_CASHING,200000.0,M1156688064
32615,409000362497',2018-05-18,IMPS 1805184C,2949039.02,0.0,,2018,5,18,DEBIT,2949039.02,M1824917007
32616,409000362497',2018-05-18,Sweep Trf To: 40900036427,171890.0,0.0,,2018,5,18,DEBIT,171890.0,C1189861498
32617,409000362497',2018-05-19,IMPS 180520181C,2983938.97,0.0,,2018,5,19,DEBIT,2983938.97,C678279746
32618,409000362497',2018-05-19,IMPS 190520182C,2055246.58,0.0,,2018,5,19,CHECK_WITHDRAWAL,2055246.58,C386349248
32619,409000362497',2018-05-19,IMPS 190520183C,5444767.83,0.0,,2018,5,19,DEBIT,5444767.83,C1321802524
32620,409000362497',2018-05-19,NEFT/SBIN618139147887/Indfor,0.0,5000000.0,,2018,5,19,CASH_IN,5000000.0,C963800974
32621,409000362497',2018-05-19,FDRL/INTERNAL FUND TRANSFE,0.0,500000.0,,2018,5,19,CASH_IN,500000.0,C2131465140
32622,409000362497',2018-05-19,FDRL/INTERNAL FUND TRANSFE,0.0,7000000.0,,2018,5,19,CASH_IN,7000000.0,M1404072392
32623,409000362497',2018-05-19,IMPS 190520184C,2624974.28,0.0,,2018,5,19,PAYEMENT,2624974.28,C1778300121
32624,409000362497',2018-05-19,Sweep Trf To: 40900036427,394345.0,0.0,,2018,5,19,PAYEMENT,394345.0,C515442419
32625,409000362497',2018-05-21,IMPS 190520181C,2274547.0,0.0,,2018,5,21,DEBIT,2274547.0,M2094138350
32626,409000362497',2018-05-21,IMPS 200520181C,787422.91,0.0,,2018,5,21,DEBIT,787422.91,C1642006480
32627,409000362497',2018-05-21,IMPS 210520182C,5103664.72,0.0,,2018,5,21,CASH_OUT,5103664.72,M1520126130
32628,409000362497',2018-05-21,BIGTREE ENTERTAINMENT PRI,8783.0,0.0,,2018,5,21,CHECK_WITHDRAWAL,8783.0,M39654379
32629,409000362497',2018-05-21,INDIAIDEAS.COM LTD,70197.0,0.0,,2018,5,21,PAYEMENT,70197.0,M756347719
32630,409000362497',2018-05-21,IRCTC CORPORATE OFFICE AC,76785.0,0.0,,2018,5,21,CHECK_WITHDRAWAL,76785.0,C1337860097
32631,409000362497',2018-05-21,PAYU PAYMENTS PRIVATE LIM,48810.0,0.0,,2018,5,21,CASH_OUT,48810.0,C1371191175
32632,409000362497',2018-05-21,AVENUES INDIA PRIVATE LIM,38443.0,0.0,,2018,5,21,DEBIT,38443.0,C1566423339
32633,409000362497',2018-05-21,FUTURE RETAIL LIMITED (OW,6395.0,0.0,,2018,5,21,CHECK_WITHDRAWAL,6395.0,C899455803
32634,409000362497',2018-05-21,METRO INFRASYS PRIVATE LI,697.0,0.0,,2018,5,21,CHECK_WITHDRAWAL,697.0,C1016316711
32635,409000362497',2018-05-21,PASFAR TECHNOLOGIES PRIVA,7509.0,0.0,,2018,5,21,CHECK_WITHDRAWAL,7509.0,C105198636
32636,409000362497',2018-05-21,JUST DIAL LIMITED,60.0,0.0,,2018,5,21,CASH_OUT,60.0,C562195832
32637,409000362497',2018-05-21,MEHAR ENTERTAINMENT PRIVA,5069.0,0.0,,2018,5,21,CHECK_WITHDRAWAL,5069.0,C1183266411
32638,409000362497',2018-05-21,ALT DIGITAL MEDIA ENTERTA,392.0,0.0,,2018,5,21,CASH_OUT,392.0,C1569007457
32639,409000362497',2018-05-21,Indiaforensic SERVICES INDIA PVT,453987.0,0.0,,2018,5,21,CASH_OUT,453987.0,C2109097173
32640,409000362497',2018-05-21,IMPS 210520183C,6853164.32,0.0,,2018,5,21,CHECK_WITHDRAWAL,6853164.32,C8271807
32641,409000362497',2018-05-21,NEFT/SBIN618141803160/Indfor,0.0,1200000.0,,2018,5,21,CASH_IN,1200000.0,C361268035
32642,409000362497',2018-05-21,FDRL/INTERNAL FUND TRANSFE,0.0,500000.0,,2018,5,21,CHECK_CASHING,500000.0,C488624810
32643,409000362497',2018-05-21,FDRL/INTERNAL FUND TRANSFE,0.0,5000000.0,,2018,5,21,CASH_IN,5000000.0,C501402989
32644,409000362497',2018-05-21,FDRL/INTERNAL FUND TRANSFE,0.0,5000000.0,,2018,5,21,TRANSFER,5000000.0,C1949097464
32645,409000362497',2018-05-21,FDRL/INTERNAL FUND TRANSFE,0.0,5000000.0,,2018,5,21,CASH_IN,5000000.0,C1315729466
32646,409000362497',2018-05-21,FDRL/INTERNAL FUND TRANSFE,0.0,500000.0,,2018,5,21,CASH_IN,500000.0,C815311450
32647,409000362497',2018-05-21,IMPS 2105184C,3127143.84,0.0,,2018,5,21,PAYEMENT,3127143.84,C928023753
32648,409000362497',2018-05-21,Sweep Trf To: 40900036427,481179.0,0.0,,2018,5,21,CHECK_WITHDRAWAL,481179.0,C1345886082
32649,409000362497',2018-05-22,IMPS 210520181C,3304963.48,0.0,,2018,5,22,CASH_OUT,3304963.48,C1801731493
32650,409000362497',2018-05-22,IMPS 220520182C,2603571.92,0.0,,2018,5,22,DEBIT,2603571.92,C489693281
32651,409000362497',2018-05-22,NEFT/P18052224983918/SAID,0.0,3000.0,,2018,5,22,CHECK_CASHING,3000.0,C81639848
32652,409000362497',2018-05-22,IMPS 220520183C,5509664.19,0.0,,2018,5,22,CASH_OUT,5509664.19,C2012495678
32653,409000362497',2018-05-22,NEFT/SBIN718142601752/Indfor,0.0,2000000.0,,2018,5,22,CHECK_CASHING,2000000.0,C261489134
32654,409000362497',2018-05-22,FDRL/INTERNAL FUND TRANSFE,0.0,7000000.0,,2018,5,22,TRANSFER,7000000.0,C1335050193
32655,409000362497',2018-05-22,FDRL/INTERNAL FUND TRANSFE,0.0,8000000.0,,2018,5,22,CHECK_CASHING,8000000.0,C2116955517
32656,409000362497',2018-05-22,IMPS 2205184C,3009324.77,0.0,,2018,5,22,PAYEMENT,3009324.77,C824208363
32657,409000362497',2018-05-22,Sweep Trf To: 40900036427,388880.0,0.0,,2018,5,22,DEBIT,388880.0,C1063299937
32658,409000362497',2018-05-23,IMPS 220520181C,3138999.47,0.0,,2018,5,23,PAYEMENT,3138999.47,C1286084959
32659,409000362497',2018-05-23,IMPS 230520182C,1998143.0,0.0,,2018,5,23,PAYEMENT,1998143.0,C842729010
32660,409000362497',2018-05-23,IMPS 230520183C,5855740.49,0.0,,2018,5,23,CHECK_WITHDRAWAL,5855740.49,C1406749291
32661,409000362497',2018-05-23,NEFT/SBIN818143461315/Indfor,0.0,1000000.0,,2018,5,23,CHECK_CASHING,1000000.0,C978609035
32662,409000362497',2018-05-23,FDRL/INTERNAL FUND TRANSFE,0.0,5000000.0,,2018,5,23,CHECK_CASHING,5000000.0,C79685693
32663,409000362497',2018-05-23,FDRL/INTERNAL FUND TRANSFE,0.0,5000000.0,,2018,5,23,CASH_IN,5000000.0,C614438306
32664,409000362497',2018-05-23,FDRL/INTERNAL FUND TRANSFE,0.0,1000000.0,,2018,5,23,TRANSFER,1000000.0,C2011240480
32665,409000362497',2018-05-23,FDRL/INTERNAL FUND TRANSFE,0.0,500000.0,,2018,5,23,CHECK_CASHING,500000.0,C434091818
32666,409000362497',2018-05-23,FDRL/INTERNAL FUND TRANSFE,0.0,1000000.0,,2018,5,23,CASH_IN,1000000.0,C1282235415
32667,409000362497',2018-05-23,IMPS 2305184C,2293457.16,0.0,,2018,5,23,DEBIT,2293457.16,C1065349988
32668,409000362497',2018-05-23,Sweep Trf To: 40900036427,276658.0,0.0,,2018,5,23,DEBIT,276658.0,C1005941472
32669,409000362497',2018-05-24,IMPS 230520181C,2219853.1,0.0,,2018,5,24,DEBIT,2219853.1,C2055616959
32670,409000362497',2018-05-24,IMPS 240520182C,2381184.27,0.0,,2018,5,24,CASH_OUT,2381184.27,C1068824137
32671,409000362497',2018-05-24,BIGTREE ENTERTAINMENT PRI,435.0,0.0,,2018,5,24,CHECK_WITHDRAWAL,435.0,C2008394397
32672,409000362497',2018-05-24,INDIAIDEAS.COM LTD,31353.0,0.0,,2018,5,24,DEBIT,31353.0,C499807144
32673,409000362497',2018-05-24,IRCTC CORPORATE OFFICE AC,64590.0,0.0,,2018,5,24,CASH_OUT,64590.0,C1696758742
32674,409000362497',2018-05-24,PAYU PAYMENTS PRIVATE LIM,55432.0,0.0,,2018,5,24,CHECK_WITHDRAWAL,55432.0,C1937721430
32675,409000362497',2018-05-24,AVENUES INDIA PRIVATE LIM,8171.0,0.0,,2018,5,24,DEBIT,8171.0,C926957414
32676,409000362497',2018-05-24,FUTURE RETAIL LIMITED (OW,272.0,0.0,,2018,5,24,CASH_OUT,272.0,C593210287
32677,409000362497',2018-05-24,PASFAR TECHNOLOGIES PRIVA,7391.0,0.0,,2018,5,24,CASH_OUT,7391.0,C1558468137
32678,409000362497',2018-05-24,QWIKCILVER SOLUTIONS PRIV,10144.0,0.0,,2018,5,24,DEBIT,10144.0,C776447774
32679,409000362497',2018-05-24,JUST DIAL LIMITED,392.0,0.0,,2018,5,24,DEBIT,392.0,C1654583020
32680,409000362497',2018-05-24,MEHAR ENTERTAINMENT PRIVA,807.0,0.0,,2018,5,24,CHECK_WITHDRAWAL,807.0,C302870502
32681,409000362497',2018-05-24,Indiaforensic SERVICES INDIA PVT,346042.0,0.0,,2018,5,24,CASH_OUT,346042.0,C1232925466
32682,409000362497',2018-05-24,IMPS 240520183C,5848560.6,0.0,,2018,5,24,PAYEMENT,5848560.6,C1188916648
32683,409000362497',2018-05-24,NEFT/SBIN918144251490/Indfor,0.0,2100000.0,,2018,5,24,TRANSFER,2100000.0,C166428193
32684,409000362497',2018-05-24,FDRL/INTERNAL FUND TRANSFE,0.0,3000000.0,,2018,5,24,CASH_IN,3000000.0,C1782580546
32685,409000362497',2018-05-24,FDRL/INTERNAL FUND TRANSFE,0.0,1000000.0,,2018,5,24,CHECK_CASHING,1000000.0,C1168382976
32686,409000362497',2018-05-24,FDRL/INTERNAL FUND TRANSFE,0.0,3000000.0,,2018,5,24,TRANSFER,3000000.0,C930580526
32687,409000362497',2018-05-24,FDRL/INTERNAL FUND TRANSFE,0.0,3000000.0,,2018,5,24,CASH_IN,3000000.0,C2028021349
32688,409000362497',2018-05-24,FDRL/INTERNAL FUND TRANSFE,0.0,1000000.0,,2018,5,24,CHECK_CASHING,1000000.0,C25789843
32689,409000362497',2018-05-24,FDRL/INTERNAL FUND TRANSFE,0.0,1000000.0,,2018,5,24,TRANSFER,1000000.0,C81548917
32690,409000362497',2018-05-24,IMPS 240520184C,2724522.51,0.0,,2018,5,24,PAYEMENT,2724522.51,C363333282
32691,409000362497',2018-05-24,Sweep Trf To: 40900036427,325853.0,0.0,,2018,5,24,CASH_OUT,325853.0,C510113906
32692,409000362497',2018-05-25,IMPS 240520181C,3344239.54,0.0,,2018,5,25,DEBIT,3344239.54,C711248671
32693,409000362497',2018-05-25,IMPS 250520182C,1884042.22,0.0,,2018,5,25,CHECK_WITHDRAWAL,1884042.22,C363333282
32694,409000362497',2018-05-25,BIGTREE ENTERTAINMENT PRI,10616.0,0.0,,2018,5,25,DEBIT,10616.0,C1933965693
32695,409000362497',2018-05-25,INDIAIDEAS.COM LTD,16223.0,0.0,,2018,5,25,PAYEMENT,16223.0,C1115404972
32696,409000362497',2018-05-25,IRCTC CORPORATE OFFICE AC,73580.0,0.0,,2018,5,25,DEBIT,73580.0,C830615916
32697,409000362497',2018-05-25,PAYU PAYMENTS PRIVATE LIM,36753.0,0.0,,2018,5,25,CASH_OUT,36753.0,C1339678445
32698,409000362497',2018-05-25,AVENUES INDIA PRIVATE LIM,11977.0,0.0,,2018,5,25,CHECK_WITHDRAWAL,11977.0,C361931733
32699,409000362497',2018-05-25,FUTURE RETAIL LIMITED (OW,668.0,0.0,,2018,5,25,CASH_OUT,668.0,C1404112538
32700,409000362497',2018-05-25,PASFAR TECHNOLOGIES PRIVA,2770.0,0.0,,2018,5,25,PAYEMENT,2770.0,C2067546399
32701,409000362497',2018-05-25,MEHAR ENTERTAINMENT PRIVA,4839.0,0.0,,2018,5,25,DEBIT,4839.0,C85102332
32702,409000362497',2018-05-25,MATRIX CELLULAR (INTERNAT,1644.0,0.0,,2018,5,25,CHECK_WITHDRAWAL,1644.0,C738831755
32703,409000362497',2018-05-25,ZAAK EPAYMENT SERVICES PR,218.0,0.0,,2018,5,25,CASH_OUT,218.0,C1298314970
32704,409000362497',2018-05-25,Indiaforensic SERVICES INDIA PVT,311640.0,0.0,,2018,5,25,CASH_OUT,311640.0,C444920847
32705,409000362497',2018-05-25,IMPS 250520183C,4978712.15,0.0,,2018,5,25,CHECK_WITHDRAWAL,4978712.15,C1865794570
32706,409000362497',2018-05-25,NEFT/SBIN118145142330/Indfor,0.0,1700000.0,,2018,5,25,TRANSFER,1700000.0,C2090186380
32707,409000362497',2018-05-25,FDRL/INTERNAL FUND TRANSFE,0.0,10000000.0,,2018,5,25,CHECK_CASHING,10000000.0,C295372946
32708,409000362497',2018-05-25,FDRL/INTERNAL FUND TRANSFE,0.0,10000000.0,,2018,5,25,CASH_IN,10000000.0,C1811787479
32709,409000362497',2018-05-25,FDRL/INTERNAL FUND TRANSFE,0.0,3000000.0,,2018,5,25,CHECK_CASHING,3000000.0,C852033104
32710,409000362497',2018-05-25,FDRL/INTERNAL FUND TRANSFE,0.0,500000.0,,2018,5,25,CHECK_CASHING,500000.0,C34973797
32711,409000362497',2018-05-25,FDRL/INTERNAL FUND TRANSFE,0.0,500000.0,,2018,5,25,TRANSFER,500000.0,C1845848960
32712,409000362497',2018-05-25,IMPS 2505184C,3963355.28,0.0,,2018,5,25,PAYEMENT,3963355.28,C1286084959
32713,409000362497',2018-05-25,Sweep Trf To: 40900036427,282249.0,0.0,,2018,5,25,CASH_OUT,282249.0,C2016335685
32714,409000362497',2018-05-26,IMPS 814621837078 FROM OX,0.0,200000.0,,2018,5,26,TRANSFER,200000.0,C320919849
32715,409000362497',2018-05-26,IMPS 814621837094 FROM OX,0.0,200000.0,,2018,5,26,CASH_IN,200000.0,C1728083442
32716,409000362497',2018-05-26,IMPS 814621837110 FROM OX,0.0,200000.0,,2018,5,26,CASH_IN,200000.0,C1473422490
32717,409000362497',2018-05-26,IMPS 814621837130 FROM OX,0.0,200000.0,,2018,5,26,CASH_IN,200000.0,C447680780
32718,409000362497',2018-05-26,IMPS 814621837151 FROM OX,0.0,200000.0,,2018,5,26,CHECK_CASHING,200000.0,C665639335
32719,409000362497',2018-05-26,IMPS 814621837165 FROM OX,0.0,200000.0,,2018,5,26,CHECK_CASHING,200000.0,C1954751748
32720,409000362497',2018-05-26,IMPS 814621837174 FROM OX,0.0,200000.0,,2018,5,26,CASH_IN,200000.0,C1538264524
32721,409000362497',2018-05-26,IMPS 814621837192 FROM OX,0.0,200000.0,,2018,5,26,CHECK_CASHING,200000.0,C985934102
32722,409000362497',2018-05-26,IMPS 814621837215 FROM OX,0.0,200000.0,,2018,5,26,TRANSFER,200000.0,C1007135217
32723,409000362497',2018-05-26,IMPS 814621837237 FROM OX,0.0,200000.0,,2018,5,26,CASH_IN,200000.0,C170133906
32724,409000362497',2018-05-26,IMPS 814621837546 FROM OX,0.0,200000.0,,2018,5,26,TRANSFER,200000.0,C1988852187
32725,409000362497',2018-05-26,IMPS 814621837567 FROM OX,0.0,200000.0,,2018,5,26,CHECK_CASHING,200000.0,C2131465140
32726,409000362497',2018-05-26,IMPS 814621837583 FROM OX,0.0,200000.0,,2018,5,26,TRANSFER,200000.0,M75216022
32727,409000362497',2018-05-26,IMPS 814621837601 FROM OX,0.0,200000.0,,2018,5,26,CHECK_CASHING,200000.0,M412572841
32728,409000362497',2018-05-26,IMPS 814621837620 FROM OX,0.0,200000.0,,2018,5,26,CHECK_CASHING,200000.0,M1677076929
32729,409000362497',2018-05-26,IMPS 814621837637 FROM OX,0.0,200000.0,,2018,5,26,CHECK_CASHING,200000.0,M291002536
32730,409000362497',2018-05-26,IMPS 814621837656 FROM OX,0.0,200000.0,,2018,5,26,TRANSFER,200000.0,C1569007457
32731,409000362497',2018-05-26,IMPS 814621837667 FROM OX,0.0,200000.0,,2018,5,26,CASH_IN,200000.0,C1628737580
32732,409000362497',2018-05-26,IMPS 814621837687 FROM OX,0.0,200000.0,,2018,5,26,TRANSFER,200000.0,C1448947115
32733,409000362497',2018-05-26,IMPS 814621837705 FROM OX,0.0,200000.0,,2018,5,26,CASH_IN,200000.0,M522258063
32734,409000362497',2018-05-26,IMPS 814621838354 FROM OX,0.0,200000.0,,2018,5,26,CHECK_CASHING,200000.0,M667266580
32735,409000362497',2018-05-26,IMPS 814621838373 FROM OX,0.0,200000.0,,2018,5,26,CASH_IN,200000.0,M1776653853
32736,409000362497',2018-05-26,IMPS 814621838384 FROM OX,0.0,200000.0,,2018,5,26,CHECK_CASHING,200000.0,C510508465
32737,409000362497',2018-05-26,IMPS 814621838405 FROM OX,0.0,200000.0,,2018,5,26,TRANSFER,200000.0,M76640668
32738,409000362497',2018-05-26,IMPS 814621838416 FROM OX,0.0,200000.0,,2018,5,26,CASH_IN,200000.0,M1080422425
32739,409000362497',2018-05-26,IMPS 814621838438 FROM OX,0.0,200000.0,,2018,5,26,CASH_IN,200000.0,C214903747
32740,409000362497',2018-05-26,IMPS 814621838452 FROM OX,0.0,200000.0,,2018,5,26,CHECK_CASHING,200000.0,M1918203362
32741,409000362497',2018-05-26,IMPS 814621838465 FROM OX,0.0,200000.0,,2018,5,26,TRANSFER,200000.0,M1535484264
32742,409000362497',2018-05-26,IMPS 814621838487 FROM OX,0.0,200000.0,,2018,5,26,CHECK_CASHING,200000.0,M1604538233
32743,409000362497',2018-05-26,IMPS 814621838503 FROM OX,0.0,200000.0,,2018,5,26,TRANSFER,200000.0,M1229994390
32744,409000362497',2018-05-28,IMPS 250520181C,2723044.12,0.0,,2018,5,28,PAYEMENT,2723044.12,M214714358
32745,409000362497',2018-05-28,IMPS 260520181C,10491466.61,0.0,,2018,5,28,CHECK_WITHDRAWAL,10491466.61,M960691129
32746,409000362497',2018-05-28,IMPS 270520181C,6919264.91,0.0,,2018,5,28,DEBIT,6919264.91,C1153794827
32747,409000362497',2018-05-28,IMPS 280520182C,3368216.27,0.0,,2018,5,28,CHECK_WITHDRAWAL,3368216.27,C91152114
32748,409000362497',2018-05-28,IMPS 280520183C,6476012.0,0.0,,2018,5,28,CASH_OUT,6476012.0,M2124666940
32749,409000362497',2018-05-28,NEFT/SBIN218148292586/Indfor,0.0,2100000.0,,2018,5,28,CHECK_CASHING,2100000.0,C1692066743
32750,409000362497',2018-05-28,FDRL/INTERNAL FUND TRANSFE,0.0,15000000.0,,2018,5,28,CHECK_CASHING,15000000.0,C201474654
32751,409000362497',2018-05-28,FDRL/INTERNAL FUND TRANSFE,0.0,5000000.0,,2018,5,28,CASH_IN,5000000.0,C703568637
32752,409000362497',2018-05-28,IMPS 2805184C,3442002.25,0.0,,2018,5,28,DEBIT,3442002.25,C1457728035
32753,409000362497',2018-05-28,Sweep Trf To: 40900036427,493577.0,0.0,,2018,5,28,PAYEMENT,493577.0,C503485607
32754,409000362497',2018-05-29,IMPS 280520181C,3667584.74,0.0,,2018,5,29,DEBIT,3667584.74,C1562733253
32755,409000362497',2018-05-29,IMPS 290520182C,1913735.82,0.0,,2018,5,29,DEBIT,1913735.82,C1552859894
32756,409000362497',2018-05-29,BIGTREE ENTERTAINMENT PRI,5953.0,0.0,,2018,5,29,DEBIT,5953.0,C1914772936
32757,409000362497',2018-05-29,IRCTC CORPORATE OFFICE AC,51195.0,0.0,,2018,5,29,PAYEMENT,51195.0,C2016282692
32758,409000362497',2018-05-29,PAYU PAYMENTS PRIVATE LIM,18433.0,0.0,,2018,5,29,DEBIT,18433.0,C1670445212
32759,409000362497',2018-05-29,AVENUES INDIA PRIVATE LIM,5056.0,0.0,,2018,5,29,PAYEMENT,5056.0,C1413677222
32760,409000362497',2018-05-29,SYNERGISTIC FINANCIAL NET,2520.0,0.0,,2018,5,29,CASH_OUT,2520.0,C1130075212
32761,409000362497',2018-05-29,FUTURE RETAIL LIMITED (OW,13890.0,0.0,,2018,5,29,CHECK_WITHDRAWAL,13890.0,C1757533511
32762,409000362497',2018-05-29,PASFAR TECHNOLOGIES PRIVA,9490.0,0.0,,2018,5,29,DEBIT,9490.0,C2120528456
32763,409000362497',2018-05-29,DISH INFRA SERVICES PRIVA,449.0,0.0,,2018,5,29,CHECK_WITHDRAWAL,449.0,C916869225
32764,409000362497',2018-05-29,JUST DIAL LIMITED,2144.0,0.0,,2018,5,29,CASH_OUT,2144.0,C28125426
32765,409000362497',2018-05-29,MEHAR ENTERTAINMENT PRIVA,6567.0,0.0,,2018,5,29,DEBIT,6567.0,C505973878
32766,409000362497',2018-05-29,Indiaforensic SERVICES INDIA PVT,312870.0,0.0,,2018,5,29,CHECK_WITHDRAWAL,312870.0,C1046160944
32767,409000362497',2018-05-29,IMPS 290520183C,5939161.83,0.0,,2018,5,29,PAYEMENT,5939161.83,C524776274
32768,409000362497',2018-05-29,BIGTREE ENTERTAINMENT PRI,327.0,0.0,,2018,5,29,CHECK_WITHDRAWAL,327.0,C349015546
32769,409000362497',2018-05-29,INDIAIDEAS.COM LTD,48411.0,0.0,,2018,5,29,DEBIT,48411.0,C818570949
32770,409000362497',2018-05-29,IRCTC CORPORATE OFFICE AC,33635.0,0.0,,2018,5,29,CASH_OUT,33635.0,C769342184
32771,409000362497',2018-05-29,PAYU PAYMENTS PRIVATE LIM,20871.0,0.0,,2018,5,29,CHECK_WITHDRAWAL,20871.0,C1246142195
32772,409000362497',2018-05-29,MATRIX CELLULAR (INTERNAT,1261.0,0.0,,2018,5,29,DEBIT,1261.0,C888005223
32773,409000362497',2018-05-29,AVENUES INDIA PRIVATE LIM,3368.0,0.0,,2018,5,29,DEBIT,3368.0,C1005941472
32774,409000362497',2018-05-29,SYNERGISTIC FINANCIAL NET,824.0,0.0,,2018,5,29,DEBIT,824.0,C998255530
32775,409000362497',2018-05-29,FUTURE RETAIL LIMITED (OW,45.0,0.0,,2018,5,29,CHECK_WITHDRAWAL,45.0,M1674214153
32776,409000362497',2018-05-29,METRO INFRASYS PRIVATE LI,697.0,0.0,,2018,5,29,DEBIT,697.0,C8733802
32777,409000362497',2018-05-29,PASFAR TECHNOLOGIES PRIVA,966.0,0.0,,2018,5,29,PAYEMENT,966.0,M1029751061
32778,409000362497',2018-05-29,QWIKCILVER SOLUTIONS PRIV,2353.0,0.0,,2018,5,29,CHECK_WITHDRAWAL,2353.0,C99219259
32779,409000362497',2018-05-29,Indiaforensic SERVICES INDIA PVT,167712.0,0.0,,2018,5,29,DEBIT,167712.0,C797657283
32780,409000362497',2018-05-29,FDRL/INTERNAL FUND TRANSFE,0.0,10000000.0,,2018,5,29,TRANSFER,10000000.0,C1893940428
32781,409000362497',2018-05-29,FDRL/INTERNAL FUND TRANSFE,0.0,1000000.0,,2018,5,29,CHECK_CASHING,1000000.0,M614793946
32782,409000362497',2018-05-29,NEFT/AXIC181491391875/Indfor,0.0,3000000.0,,2018,5,29,TRANSFER,3000000.0,C1177315507
32783,409000362497',2018-05-29,IMPS 290520184C,3616765.85,0.0,,2018,5,29,PAYEMENT,3616765.85,M955823334
32784,409000362497',2018-05-29,Sweep Trf To: 40900036427,364490.0,0.0,,2018,5,29,CHECK_WITHDRAWAL,364490.0,M456785919
32785,409000362497',2018-05-30,IMPS 290520181C,4279124.91,0.0,,2018,5,30,CHECK_WITHDRAWAL,4279124.91,C151015751
32786,409000362497',2018-05-30,IMPS 300520182C,2333493.76,0.0,,2018,5,30,CASH_OUT,2333493.76,C1242503746
32787,409000362497',2018-05-30,BIGTREE ENTERTAINMENT PRI,614.0,0.0,,2018,5,30,CASH_OUT,614.0,M2007838136
32788,409000362497',2018-05-30,INDIAIDEAS.COM LTD,32899.0,0.0,,2018,5,30,PAYEMENT,32899.0,C349350443
32789,409000362497',2018-05-30,IRCTC CORPORATE OFFICE AC,24545.0,0.0,,2018,5,30,DEBIT,24545.0,C361268035
32790,409000362497',2018-05-30,PAYU PAYMENTS PRIVATE LIM,23353.0,0.0,,2018,5,30,CASH_OUT,23353.0,C306206744
32791,409000362497',2018-05-30,AVENUES INDIA PRIVATE LIM,9906.0,0.0,,2018,5,30,CHECK_WITHDRAWAL,9906.0,C599968109
32792,409000362497',2018-05-30,FUTURE RETAIL LIMITED (OW,61.0,0.0,,2018,5,30,CHECK_WITHDRAWAL,61.0,C843031928
32793,409000362497',2018-05-30,PASFAR TECHNOLOGIES PRIVA,6567.0,0.0,,2018,5,30,CHECK_WITHDRAWAL,6567.0,C188633062
32794,409000362497',2018-05-30,QWIKCILVER SOLUTIONS PRIV,3941.0,0.0,,2018,5,30,CASH_OUT,3941.0,C1693783990
32795,409000362497',2018-05-30,JUST DIAL LIMITED,1589.0,0.0,,2018,5,30,CASH_OUT,1589.0,C1060563153
32796,409000362497',2018-05-30,MEHAR ENTERTAINMENT PRIVA,3802.0,0.0,,2018,5,30,PAYEMENT,3802.0,C1531333864
32797,409000362497',2018-05-30,Indiaforensic SERVICES INDIA PVT,182780.0,0.0,,2018,5,30,PAYEMENT,182780.0,C794295331
32798,409000362497',2018-05-30,IMPS 300520183C,5839127.26,0.0,,2018,5,30,PAYEMENT,5839127.26,C323287038
32799,409000362497',2018-05-30,NEFT/SBIN318150757299/Indfor,0.0,1500000.0,,2018,5,30,TRANSFER,1500000.0,M22184766
32800,409000362497',2018-05-30,FDRL/INTERNAL FUND TRANSFE,0.0,5000000.0,,2018,5,30,TRANSFER,5000000.0,M1525504426
32801,409000362497',2018-05-30,FDRL/INTERNAL FUND TRANSFE,0.0,5000000.0,,2018,5,30,CASH_IN,5000000.0,M1593589289
32802,409000362497',2018-05-30,IMPS 815019738117 FROM OX,0.0,200000.0,,2018,5,30,CHECK_CASHING,200000.0,M1580327965
32803,409000362497',2018-05-30,IMPS 815019738139 FROM OX,0.0,200000.0,,2018,5,30,CASH_IN,200000.0,M973259181
32804,409000362497',2018-05-30,IMPS 815019738163 FROM OX,0.0,200000.0,,2018,5,30,CASH_IN,200000.0,C1233454027
32805,409000362497',2018-05-30,IMPS 815019738189 FROM OX,0.0,200000.0,,2018,5,30,TRANSFER,200000.0,M191007712
32806,409000362497',2018-05-30,IMPS 815019738207 FROM OX,0.0,200000.0,,2018,5,30,TRANSFER,200000.0,M2054947899
32807,409000362497',2018-05-30,IMPS 815019738252 FROM OX,0.0,200000.0,,2018,5,30,TRANSFER,200000.0,M1774203791
32808,409000362497',2018-05-30,FDRL/INTERNAL FUND TRANSFE,0.0,3000000.0,,2018,5,30,CHECK_CASHING,3000000.0,M1561132621
32809,409000362497',2018-05-30,IMPS 815019740947 FROM OX,0.0,200000.0,,2018,5,30,CHECK_CASHING,200000.0,M1474368929
32810,409000362497',2018-05-30,IMPS 815019740978 FROM OX,0.0,200000.0,,2018,5,30,TRANSFER,200000.0,C830615916
32811,409000362497',2018-05-30,IMPS 815019740998 FROM OX,0.0,200000.0,,2018,5,30,TRANSFER,200000.0,C2140245843
32812,409000362497',2018-05-30,IMPS 815019741024 FROM OX,0.0,200000.0,,2018,5,30,TRANSFER,200000.0,C1664951631
32813,409000362497',2018-05-30,IMPS 300520184C,4017165.82,0.0,,2018,5,30,PAYEMENT,4017165.82,M379169334
32814,409000362497',2018-05-30,Sweep Trf To: 40900036427,294380.0,0.0,,2018,5,30,CASH_OUT,294380.0,C1298314970
32815,409000362497',2018-05-31,IMPS 300520181C,4086617.89,0.0,,2018,5,31,DEBIT,4086617.89,M1700312519
32816,409000362497',2018-05-31,IMPS 310520182C,1987226.98,0.0,,2018,5,31,PAYEMENT,1987226.98,M821076981
32817,409000362497',2018-05-31,BIGTREE ENTERTAINMENT PRI,1393.0,0.0,,2018,5,31,DEBIT,1393.0,C635371680
32818,409000362497',2018-05-31,INDIAIDEAS.COM LTD,78902.0,0.0,,2018,5,31,DEBIT,78902.0,C1837057885
32819,409000362497',2018-05-31,IRCTC CORPORATE OFFICE AC,37930.0,0.0,,2018,5,31,DEBIT,37930.0,C1722141669
32820,409000362497',2018-05-31,PAYU PAYMENTS PRIVATE LIM,15968.0,0.0,,2018,5,31,CHECK_WITHDRAWAL,15968.0,C1825174365
32821,409000362497',2018-05-31,AVENUES INDIA PRIVATE LIM,4712.0,0.0,,2018,5,31,DEBIT,4712.0,C75629578
32822,409000362497',2018-05-31,SYNERGISTIC FINANCIAL NET,98.0,0.0,,2018,5,31,PAYEMENT,98.0,C571435580
32823,409000362497',2018-05-31,ZAAK EPAYMENT SERVICES PR,196.0,0.0,,2018,5,31,DEBIT,196.0,C646059443
32824,409000362497',2018-05-31,FUTURE RETAIL LIMITED (OW,5588.0,0.0,,2018,5,31,CHECK_WITHDRAWAL,5588.0,C909295153
32825,409000362497',2018-05-31,METRO INFRASYS PRIVATE LI,697.0,0.0,,2018,5,31,CASH_OUT,697.0,C1162775738
32826,409000362497',2018-05-31,PASFAR TECHNOLOGIES PRIVA,17527.0,0.0,,2018,5,31,DEBIT,17527.0,C1504217374
32827,409000362497',2018-05-31,JUST DIAL LIMITED,274.0,0.0,,2018,5,31,PAYEMENT,274.0,M424825250
32828,409000362497',2018-05-31,MEHAR ENTERTAINMENT PRIVA,2996.0,0.0,,2018,5,31,PAYEMENT,2996.0,C703976121
32829,409000362497',2018-05-31,Indiaforensic SERVICES INDIA PVT,158699.0,0.0,,2018,5,31,CHECK_WITHDRAWAL,158699.0,C1608602720
32830,409000362497',2018-05-31,IMPS 310520183C,6035389.78,0.0,,2018,5,31,CASH_OUT,6035389.78,C843774579
32831,409000362497',2018-05-31,NEFT/SBIN418151071480/Indfor,0.0,2500000.0,,2018,5,31,TRANSFER,2500000.0,C2141140246
32832,409000362497',2018-05-31,FDRL/INTERNAL FUND TRANSFE,0.0,5000000.0,,2018,5,31,CHECK_CASHING,5000000.0,C1041292312
32833,409000362497',2018-05-31,FDRL/INTERNAL FUND TRANSFE,0.0,5000000.0,,2018,5,31,CASH_IN,5000000.0,M1563532733
32834,409000362497',2018-05-31,FDRL/INTERNAL FUND TRANSFE,0.0,500000.0,,2018,5,31,TRANSFER,500000.0,M1189975201
32835,409000362497',2018-05-31,FDRL/INTERNAL FUND TRANSFE,0.0,1000000.0,,2018,5,31,TRANSFER,1000000.0,M1565933888
32836,409000362497',2018-05-31,FDRL/INTERNAL FUND TRANSFE,0.0,1000000.0,,2018,5,31,CHECK_CASHING,1000000.0,M2130867759
32837,409000362497',2018-05-31,IMPS 310520184C,3821606.18,0.0,,2018,5,31,PAYEMENT,3821606.18,C67789002
32838,409000362497',2018-05-31,Sweep Trf To: 40900036427,251131.0,0.0,,2018,5,31,CHECK_WITHDRAWAL,251131.0,C1059781259
32839,409000362497',2018-06-01,IMPS 310520181C,3234067.3,0.0,,2018,6,1,CASH_OUT,3234067.3,M2136693229
32840,409000362497',2018-06-01,IMPS 010620182C,2239335.14,0.0,,2018,6,1,DEBIT,2239335.14,C866356999
32841,409000362497',2018-06-01,BIGTREE ENTERTAINMENT PRI,1327.0,0.0,,2018,6,1,DEBIT,1327.0,C22805895
32842,409000362497',2018-06-01,INDIAIDEAS.COM LTD,27399.0,0.0,,2018,6,1,DEBIT,27399.0,M435121606
32843,409000362497',2018-06-01,IRCTC CORPORATE OFFICE AC,42615.0,0.0,,2018,6,1,PAYEMENT,42615.0,C2070157789
32844,409000362497',2018-06-01,PAYU PAYMENTS PRIVATE LIM,10228.0,0.0,,2018,6,1,PAYEMENT,10228.0,M38406698
32845,409000362497',2018-06-01,AVENUES INDIA PRIVATE LIM,36959.0,0.0,,2018,6,1,PAYEMENT,36959.0,M1136335298
32846,409000362497',2018-06-01,FUTURE RETAIL LIMITED (OW,1961.0,0.0,,2018,6,1,CHECK_WITHDRAWAL,1961.0,C704432916
32847,409000362497',2018-06-01,PASFAR TECHNOLOGIES PRIVA,9783.0,0.0,,2018,6,1,DEBIT,9783.0,M1678537148
32848,409000362497',2018-06-01,JUST DIAL LIMITED,634.0,0.0,,2018,6,1,CASH_OUT,634.0,M1312133643
32849,409000362497',2018-06-01,MEHAR ENTERTAINMENT PRIVA,3572.0,0.0,,2018,6,1,DEBIT,3572.0,M1613132761
32850,409000362497',2018-06-01,Indiaforensic SERVICES INDIA PVT,177287.0,0.0,,2018,6,1,CASH_OUT,177287.0,M1835261359
32851,409000362497',2018-06-01,IMPS 010620183C,5947440.24,0.0,,2018,6,1,CHECK_WITHDRAWAL,5947440.24,C607938937
32852,409000362497',2018-06-01,NEFT/SBIN618152063109/Indfor,0.0,2700000.0,,2018,6,1,CASH_IN,2700000.0,C749610836
32853,409000362497',2018-06-01,FDRL/INTERNAL FUND TRANSFE,0.0,15000000.0,,2018,6,1,CASH_IN,15000000.0,M56332436
32854,409000362497',2018-06-01,IMPS 010620184C,4077710.9,0.0,,2018,6,1,DEBIT,4077710.9,M145341893
32855,409000362497',2018-06-01,Sweep Trf To: 40900036427,408383.0,0.0,,2018,6,1,DEBIT,408383.0,M317109671
32856,409000362497',2018-06-02,IMPS 010620181C,3619803.38,0.0,,2018,6,2,CHECK_WITHDRAWAL,3619803.38,M1839944317
32857,409000362497',2018-06-02,IMPS 020620182C,2188427.33,0.0,,2018,6,2,DEBIT,2188427.33,M902024115
32858,409000362497',2018-06-02,IMPS 020620183C,6884200.8,0.0,,2018,6,2,CHECK_WITHDRAWAL,6884200.8,M1722286085
32859,409000362497',2018-06-02,FDRL/INTERNAL FUND TRANSFE,0.0,7000000.0,,2018,6,2,TRANSFER,7000000.0,C218598269
32860,409000362497',2018-06-02,FDRL/INTERNAL FUND TRANSFE,0.0,4000000.0,,2018,6,2,CHECK_CASHING,4000000.0,C1095666481
32861,409000362497',2018-06-02,FDRL/INTERNAL FUND TRANSFE,0.0,6000000.0,,2018,6,2,CASH_IN,6000000.0,C155169291
32862,409000362497',2018-06-02,NEFT/SBIN718153212474/Indfor,0.0,3500000.0,,2018,6,2,CASH_IN,3500000.0,M2033228942
32863,409000362497',2018-06-02,NEFT/AXIC181532901848/Indfor,0.0,5000000.0,,2018,6,2,CHECK_CASHING,5000000.0,C168356446
32864,409000362497',2018-06-02,IMPS 020620184C,3288149.8,0.0,,2018,6,2,CASH_OUT,3288149.8,M996228379
32865,409000362497',2018-06-02,FDRL/INTERNAL FUND TRANSFE,0.0,1000000.0,,2018,6,2,CASH_IN,1000000.0,C1620621442
32866,409000362497',2018-06-02,FDRL/INTERNAL FUND TRANSFE,0.0,500000.0,,2018,6,2,TRANSFER,500000.0,C1341043251
32867,409000362497',2018-06-02,FDRL/INTERNAL FUND TRANSFE,0.0,1000000.0,,2018,6,2,CHECK_CASHING,1000000.0,C219843173
32868,409000362497',2018-06-02,Sweep Trf To: 40900036427,336327.0,0.0,,2018,6,2,DEBIT,336327.0,M800257615
32869,409000362497',2018-06-04,IMPS 020620181C,3136579.44,0.0,,2018,6,4,DEBIT,3136579.44,M1425704316
32870,409000362497',2018-06-04,IMPS 030620181C,7221449.39,0.0,,2018,6,4,DEBIT,7221449.39,M627640764
32871,409000362497',2018-06-04,IMPS 040620182C,2394436.64,0.0,,2018,6,4,CASH_OUT,2394436.64,M756022087
32872,409000362497',2018-06-04,IMPS 040620183C,6978571.63,0.0,,2018,6,4,DEBIT,6978571.63,M1369468741
32873,409000362497',2018-06-04,NEFT/SBIN818155285870/Indfor,0.0,300000.0,,2018,6,4,TRANSFER,300000.0,M1559300540
32874,409000362497',2018-06-04,NEFT/SBIN818155312516/Indfor,0.0,2700000.0,,2018,6,4,CHECK_CASHING,2700000.0,M2144178760
32875,409000362497',2018-06-04,FDRL/INTERNAL FUND TRANSFE,0.0,4000000.0,,2018,6,4,TRANSFER,4000000.0,M354058002
32876,409000362497',2018-06-04,FDRL/INTERNAL FUND TRANSFE,0.0,6000000.0,,2018,6,4,CHECK_CASHING,6000000.0,M54655570
32877,409000362497',2018-06-04,FDRL/INTERNAL FUND TRANSFE,0.0,3000000.0,,2018,6,4,TRANSFER,3000000.0,M366241450
32878,409000362497',2018-06-04,FDRL/INTERNAL FUND TRANSFE,0.0,1000000.0,,2018,6,4,CHECK_CASHING,1000000.0,M1653804701
32879,409000362497',2018-06-04,IMPS 040620184C,5238380.15,0.0,,2018,6,4,CASH_OUT,5238380.15,M82678548
32880,409000362497',2018-06-04,Sweep Trf To: 40900036427,579222.0,0.0,,2018,6,4,CASH_OUT,579222.0,M1999017579
32881,409000362497',2018-06-05,BIGTREE ENTERTAINMENT PRI,9398.0,0.0,,2018,6,5,DEBIT,9398.0,M2138528304
32882,409000362497',2018-06-05,INDIAIDEAS.COM LTD,25702.0,0.0,,2018,6,5,DEBIT,25702.0,M1837022119
32883,409000362497',2018-06-05,IRCTC CORPORATE OFFICE AC,92300.0,0.0,,2018,6,5,DEBIT,92300.0,M1875352706
32884,409000362497',2018-06-05,PAYU PAYMENTS PRIVATE LIM,28824.0,0.0,,2018,6,5,CASH_OUT,28824.0,M513010177
32885,409000362497',2018-06-05,AVENUES INDIA PRIVATE LIM,12077.0,0.0,,2018,6,5,DEBIT,12077.0,M1080249494
32886,409000362497',2018-06-05,FUTURE RETAIL LIMITED (OW,3746.0,0.0,,2018,6,5,DEBIT,3746.0,M27152456
32887,409000362497',2018-06-05,JUST DIAL LIMITED,800.0,0.0,,2018,6,5,CHECK_WITHDRAWAL,800.0,M1465096059
32888,409000362497',2018-06-05,MEHAR ENTERTAINMENT PRIVA,14863.0,0.0,,2018,6,5,CHECK_WITHDRAWAL,14863.0,M1192142724
32889,409000362497',2018-06-05,SYNERGISTIC FINANCIAL NET,367.0,0.0,,2018,6,5,CASH_OUT,367.0,M1915781422
32890,409000362497',2018-06-05,PASFAR TECHNOLOGIES PRIVA,17622.0,0.0,,2018,6,5,DEBIT,17622.0,M2030179702
32891,409000362497',2018-06-05,Indiaforensic SERVICES INDIA PVT,496220.0,0.0,,2018,6,5,CHECK_WITHDRAWAL,496220.0,M804729447
32892,409000362497',2018-06-05,IMPS 040620181C,4616409.99,0.0,,2018,6,5,DEBIT,4616409.99,M413400690
32893,409000362497',2018-06-05,IMPS 050620182C,3269317.43,0.0,,2018,6,5,CHECK_WITHDRAWAL,3269317.43,M284901068
32894,409000362497',2018-06-05,IMPS 050620183C,6336146.02,0.0,,2018,6,5,CASH_OUT,6336146.02,M2042994308
32895,409000362497',2018-06-05,NEFT/SBIN918156374567/Indfor,0.0,1500000.0,,2018,6,5,TRANSFER,1500000.0,C398673379
32896,409000362497',2018-06-05,FDRL/INTERNAL FUND TRANSFE,0.0,6000000.0,,2018,6,5,CASH_IN,6000000.0,M398722707
32897,409000362497',2018-06-05,FDRL/INTERNAL FUND TRANSFE,0.0,5000000.0,,2018,6,5,CASH_IN,5000000.0,C265845794
32898,409000362497',2018-06-05,FDRL/INTERNAL FUND TRANSFE,0.0,6000000.0,,2018,6,5,TRANSFER,6000000.0,C866356999
32899,409000362497',2018-06-05,IMPS 060520184C,4132135.64,0.0,,2018,6,5,DEBIT,4132135.64,M518082033
32900,409000362497',2018-06-05,Sweep Trf To: 40900036427,521549.0,0.0,,2018,6,5,CASH_OUT,521549.0,C151599046
32901,409000362497',2018-06-06,BIGTREE ENTERTAINMENT PRI,2365.0,0.0,,2018,6,6,CASH_OUT,2365.0,M242370128
32902,409000362497',2018-06-06,INDIAIDEAS.COM LTD,52897.0,0.0,,2018,6,6,CASH_OUT,52897.0,M792442439
32903,409000362497',2018-06-06,IRCTC CORPORATE OFFICE AC,27235.0,0.0,,2018,6,6,DEBIT,27235.0,M1959520703
32904,409000362497',2018-06-06,PAYU PAYMENTS PRIVATE LIM,17917.0,0.0,,2018,6,6,CASH_OUT,17917.0,M1558656218
32905,409000362497',2018-06-06,AVENUES INDIA PRIVATE LIM,6236.0,0.0,,2018,6,6,PAYEMENT,6236.0,M614401295
32906,409000362497',2018-06-06,FUTURE RETAIL LIMITED (OW,258.0,0.0,,2018,6,6,DEBIT,258.0,C911093380
32907,409000362497',2018-06-06,JUST DIAL LIMITED,1232.0,0.0,,2018,6,6,DEBIT,1232.0,C154319946
32908,409000362497',2018-06-06,MEHAR ENTERTAINMENT PRIVA,115.0,0.0,,2018,6,6,CHECK_WITHDRAWAL,115.0,C923910351
32909,409000362497',2018-06-06,SYNERGISTIC FINANCIAL NET,747.0,0.0,,2018,6,6,CASH_OUT,747.0,C1289453529
32910,409000362497',2018-06-06,PASFAR TECHNOLOGIES PRIVA,1414.0,0.0,,2018,6,6,PAYEMENT,1414.0,C1245689449
32911,409000362497',2018-06-06,QWIKCILVER SOLUTIONS PRIV,6270.0,0.0,,2018,6,6,CASH_OUT,6270.0,C1508595070
32912,409000362497',2018-06-06,ZAAK EPAYMENT SERVICES PR,317.0,0.0,,2018,6,6,PAYEMENT,317.0,C314375431
32913,409000362497',2018-06-06,Indiaforensic SERVICES INDIA PVT,208556.0,0.0,,2018,6,6,CASH_OUT,208556.0,C1007717381
32914,409000362497',2018-06-06,IMPS 050620181C,4133521.99,0.0,,2018,6,6,PAYEMENT,4133521.99,C997470268
32915,409000362497',2018-06-06,IMPS 060620182C,2397437.85,0.0,,2018,6,6,CHECK_WITHDRAWAL,2397437.85,M147100941
32916,409000362497',2018-06-06,IMPS 060620183C,5509768.77,0.0,,2018,6,6,CHECK_WITHDRAWAL,5509768.77,M1373488888
32917,409000362497',2018-06-06,NEFT/SBIN118157426112/Indfor,0.0,5000000.0,,2018,6,6,CASH_IN,5000000.0,C804475266
32918,409000362497',2018-06-06,FDRL/INTERNAL FUND TRANSFE,0.0,6000000.0,,2018,6,6,CASH_IN,6000000.0,M322053536
32919,409000362497',2018-06-06,FDRL/INTERNAL FUND TRANSFE,0.0,5000000.0,,2018,6,6,TRANSFER,5000000.0,C1032646412
32920,409000362497',2018-06-06,FDRL/INTERNAL FUND TRANSFE,0.0,1000000.0,,2018,6,6,CHECK_CASHING,1000000.0,M67163119
32921,409000362497',2018-06-06,IMPS 060620184C,4387368.72,0.0,,2018,6,6,PAYEMENT,4387368.72,M338807818
32922,409000362497',2018-06-06,Sweep Trf To: 40900036427,236900.0,0.0,,2018,6,6,PAYEMENT,236900.0,M22040116
32923,409000362497',2018-06-07,IMPS 060620181C,5405798.24,0.0,,2018,6,7,DEBIT,5405798.24,C644345897
32924,409000362497',2018-06-07,IMPS 070620182C,3128107.97,0.0,,2018,6,7,DEBIT,3128107.97,M441799849
32925,409000362497',2018-06-07,IMPS 070620183C,6884602.36,0.0,,2018,6,7,DEBIT,6884602.36,M679970567
32926,409000362497',2018-06-07,FDRL/INTERNAL FUND TRANSFE,0.0,5000000.0,,2018,6,7,TRANSFER,5000000.0,C2123604590
32927,409000362497',2018-06-07,FDRL/INTERNAL FUND TRANSFE,0.0,5000000.0,,2018,6,7,TRANSFER,5000000.0,C1675375648
32928,409000362497',2018-06-07,FDRL/INTERNAL FUND TRANSFE,0.0,5000000.0,,2018,6,7,CHECK_CASHING,5000000.0,C1272615921
32929,409000362497',2018-06-07,IMPS 070620184C,4617578.14,0.0,,2018,6,7,DEBIT,4617578.14,M1661962880
32930,409000362497',2018-06-07,IMPS 815823507255 FROM OX,0.0,200000.0,,2018,6,7,TRANSFER,200000.0,C562195832
32931,409000362497',2018-06-07,IMPS 815823507268 FROM OX,0.0,200000.0,,2018,6,7,CASH_IN,200000.0,C1384210339
32932,409000362497',2018-06-07,IMPS 815823507280 FROM OX,0.0,200000.0,,2018,6,7,TRANSFER,200000.0,M941965389
32933,409000362497',2018-06-07,IMPS 815823507290 FROM OX,0.0,200000.0,,2018,6,7,CASH_IN,200000.0,M886151139
32934,409000362497',2018-06-07,IMPS 815823507298 FROM OX,0.0,200000.0,,2018,6,7,CASH_IN,200000.0,M218340380
32935,409000362497',2018-06-07,IMPS 815823507308 FROM OX,0.0,200000.0,,2018,6,7,TRANSFER,200000.0,C762558455
32936,409000362497',2018-06-07,IMPS 815823507321 FROM OX,0.0,200000.0,,2018,6,7,CASH_IN,200000.0,C2107039064
32937,409000362497',2018-06-07,IMPS 815823507337 FROM OX,0.0,200000.0,,2018,6,7,CHECK_CASHING,200000.0,M1099387558
32938,409000362497',2018-06-07,IMPS 815823507349 FROM OX,0.0,200000.0,,2018,6,7,CHECK_CASHING,200000.0,M1318481682
32939,409000362497',2018-06-07,IMPS 815823507360 FROM OX,0.0,200000.0,,2018,6,7,CHECK_CASHING,200000.0,C2109470512
32940,409000362497',2018-06-07,IMPS 815823507513 FROM OX,0.0,200000.0,,2018,6,7,CASH_IN,200000.0,C1058634310
32941,409000362497',2018-06-07,IMPS 815823507533 FROM OX,0.0,200000.0,,2018,6,7,CHECK_CASHING,200000.0,M1604859165
32942,409000362497',2018-06-07,IMPS 815823507566 FROM OX,0.0,200000.0,,2018,6,7,CASH_IN,200000.0,M1866930448
32943,409000362497',2018-06-07,IMPS 815823507577 FROM OX,0.0,200000.0,,2018,6,7,CASH_IN,200000.0,C790848185
32944,409000362497',2018-06-07,Sweep Trf To: 40900036427,465210.0,0.0,,2018,6,7,CASH_OUT,465210.0,M1819628758
32945,409000362497',2018-06-08,BIGTREE ENTERTAINMENT PRI,946.0,0.0,,2018,6,8,DEBIT,946.0,M1052295785
32946,409000362497',2018-06-08,INDIAIDEAS.COM LTD,46037.0,0.0,,2018,6,8,CASH_OUT,46037.0,C371793088
32947,409000362497',2018-06-08,IRCTC CORPORATE OFFICE AC,71960.0,0.0,,2018,6,8,DEBIT,71960.0,C435224506
32948,409000362497',2018-06-08,PAYU PAYMENTS PRIVATE LIM,34405.0,0.0,,2018,6,8,CHECK_WITHDRAWAL,34405.0,M1013311103
32949,409000362497',2018-06-08,AVENUES INDIA PRIVATE LIM,27880.0,0.0,,2018,6,8,DEBIT,27880.0,M1408605999
32950,409000362497',2018-06-08,FUTURE RETAIL LIMITED (OW,4433.0,0.0,,2018,6,8,PAYEMENT,4433.0,C1786758337
32951,409000362497',2018-06-08,JUST DIAL LIMITED,2574.0,0.0,,2018,6,8,PAYEMENT,2574.0,C1075238398
32952,409000362497',2018-06-08,MEHAR ENTERTAINMENT PRIVA,6683.0,0.0,,2018,6,8,PAYEMENT,6683.0,C10249994
32953,409000362497',2018-06-08,PASFAR TECHNOLOGIES PRIVA,2009.0,0.0,,2018,6,8,PAYEMENT,2009.0,C691636444
32954,409000362497',2018-06-08,ZAAK EPAYMENT SERVICES PR,606.0,0.0,,2018,6,8,DEBIT,606.0,C1940468066
32955,409000362497',2018-06-08,ALT DIGITAL MEDIA ENTERTA,98.0,0.0,,2018,6,8,CASH_OUT,98.0,C836903727
32956,409000362497',2018-06-08,MATRIX CELLULAR (INTERNAT,1614.0,0.0,,2018,6,8,CHECK_WITHDRAWAL,1614.0,C1167066016
32957,409000362497',2018-06-08,AXEL RETAIL PRIVATE LIMIT,269.0,0.0,,2018,6,8,CHECK_WITHDRAWAL,269.0,C1934837365
32958,409000362497',2018-06-08,VOUCHER ACTIVATION SERVIC,6539.0,0.0,,2018,6,8,PAYEMENT,6539.0,C1716892902
32959,409000362497',2018-06-08,Indiaforensic SERVICES INDIA PVT,443554.0,0.0,,2018,6,8,CHECK_WITHDRAWAL,443554.0,C893953614
32960,409000362497',2018-06-08,IMPS 070620181C,3732574.58,0.0,,2018,6,8,CHECK_WITHDRAWAL,3732574.58,C1695946783
32961,409000362497',2018-06-08,IMPS 080620182C,3113898.25,0.0,,2018,6,8,PAYEMENT,3113898.25,C2124522667
32962,409000362497',2018-06-08,IMPS 080620183C,6479141.15,0.0,,2018,6,8,PAYEMENT,6479141.15,C280960713
32963,409000362497',2018-06-08,IMPS 815919758744 FROM OX,0.0,100000.0,,2018,6,8,CASH_IN,100000.0,M70399187
32964,409000362497',2018-06-08,IMPS 815919758787 FROM OX,0.0,200000.0,,2018,6,8,CHECK_CASHING,200000.0,M1825114555
32965,409000362497',2018-06-08,IMPS 815919758836 FROM OX,0.0,200000.0,,2018,6,8,TRANSFER,200000.0,M1908031684
32966,409000362497',2018-06-08,IMPS 815919758916 FROM OX,0.0,200000.0,,2018,6,8,CHECK_CASHING,200000.0,M515838562
32967,409000362497',2018-06-08,IMPS 815919758963 FROM OX,0.0,200000.0,,2018,6,8,TRANSFER,200000.0,M33904410
32968,409000362497',2018-06-08,IMPS 815919759004 FROM OX,0.0,200000.0,,2018,6,8,CASH_IN,200000.0,M605185074
32969,409000362497',2018-06-08,NEFT/SBIN318159310086/Indfor,0.0,4000000.0,,2018,6,8,CASH_IN,4000000.0,M2039759335
32970,409000362497',2018-06-08,IMPS 815919766436 FROM OX,0.0,200000.0,,2018,6,8,CHECK_CASHING,200000.0,M1322800171
32971,409000362497',2018-06-08,IMPS 815919766463 FROM OX,0.0,200000.0,,2018,6,8,CHECK_CASHING,200000.0,M1330222996
32972,409000362497',2018-06-08,IMPS 815919766497 FROM OX,0.0,200000.0,,2018,6,8,CASH_IN,200000.0,M1578887165
32973,409000362497',2018-06-08,IMPS 815919766539 FROM OX,0.0,200000.0,,2018,6,8,TRANSFER,200000.0,M42448007
32974,409000362497',2018-06-08,IMPS 815919766576 FROM OX,0.0,200000.0,,2018,6,8,CASH_IN,200000.0,C1247615506
32975,409000362497',2018-06-08,FDRL/INTERNAL FUND TRANSFE,0.0,15000000.0,,2018,6,8,CHECK_CASHING,15000000.0,M795177482
32976,409000362497',2018-06-08,FDRL/INTERNAL FUND TRANSFE,0.0,7000000.0,,2018,6,8,CHECK_CASHING,7000000.0,C1918034924
32977,409000362497',2018-06-08,IMPS 080620184C,4477099.06,0.0,,2018,6,8,CHECK_WITHDRAWAL,4477099.06,M948940425
32978,409000362497',2018-06-08,Sweep Trf To: 40900036427,618590.0,0.0,,2018,6,8,CHECK_WITHDRAWAL,618590.0,M1654585186
32979,409000362497',2018-06-11,IMPS 080620181C,3523371.93,0.0,,2018,6,11,CHECK_WITHDRAWAL,3523371.93,C257099532
32980,409000362497',2018-06-11,IMPS 090620181C,9901095.71,0.0,,2018,6,11,CHECK_WITHDRAWAL,9901095.71,M1708186339
32981,409000362497',2018-06-11,IMPS 100620181C,370854.85,0.0,,2018,6,11,CHECK_WITHDRAWAL,370854.85,C388583042
32982,409000362497',2018-06-11,IMPS 110620182C,7493316.88,0.0,,2018,6,11,DEBIT,7493316.88,C690195469
32983,409000362497',2018-06-11,BIGTREE ENTERTAINMENT PRI,961.0,0.0,,2018,6,11,CASH_OUT,961.0,M646689858
32984,409000362497',2018-06-11,INDIAIDEAS.COM LTD,43895.0,0.0,,2018,6,11,CHECK_WITHDRAWAL,43895.0,M593948418
32985,409000362497',2018-06-11,IRCTC CORPORATE OFFICE AC,32805.0,0.0,,2018,6,11,CASH_OUT,32805.0,C1241878571
32986,409000362497',2018-06-11,PAYU PAYMENTS PRIVATE LIM,53250.0,0.0,,2018,6,11,DEBIT,53250.0,C541307861
32987,409000362497',2018-06-11,AVENUES INDIA PRIVATE LIM,5462.0,0.0,,2018,6,11,DEBIT,5462.0,C708718126
32988,409000362497',2018-06-11,FUTURE RETAIL LIMITED (OW,3453.0,0.0,,2018,6,11,CASH_OUT,3453.0,C323287038
32989,409000362497',2018-06-11,JUST DIAL LIMITED,496.0,0.0,,2018,6,11,CHECK_WITHDRAWAL,496.0,C1794607688
32990,409000362497',2018-06-11,MEHAR ENTERTAINMENT PRIVA,2074.0,0.0,,2018,6,11,CASH_OUT,2074.0,C1260889084
32991,409000362497',2018-06-11,METRO INFRASYS PRIVATE LI,697.0,0.0,,2018,6,11,PAYEMENT,697.0,C1856036778
32992,409000362497',2018-06-11,Indiaforensic SERVICES INDIA PVT,200065.0,0.0,,2018,6,11,PAYEMENT,200065.0,C1891412311
32993,409000362497',2018-06-11,IMPS 110620183C,10632256.3,0.0,,2018,6,11,CASH_OUT,10632256.3,C1067360446
32994,409000362497',2018-06-11,NEFT/SBIN518162318892/Indfor,0.0,4700000.0,,2018,6,11,CHECK_CASHING,4700000.0,C2007149130
32995,409000362497',2018-06-11,FDRL/INTERNAL FUND TRANSFE,0.0,5000000.0,,2018,6,11,TRANSFER,5000000.0,C2122668216
32996,409000362497',2018-06-11,FDRL/INTERNAL FUND TRANSFE,0.0,15000000.0,,2018,6,11,CHECK_CASHING,15000000.0,C1563929103
32997,409000362497',2018-06-11,FDRL/INTERNAL FUND TRANSFE,0.0,3000000.0,,2018,6,11,CASH_IN,3000000.0,C2120038041
32998,409000362497',2018-06-11,FDRL/INTERNAL FUND TRANSFE,0.0,3000000.0,,2018,6,11,CASH_IN,3000000.0,C2073764942
32999,409000362497',2018-06-11,FDRL/INTERNAL FUND TRANSFE,0.0,1000000.0,,2018,6,11,TRANSFER,1000000.0,C2109470512
33000,409000362497',2018-06-11,FDRL/INTERNAL FUND TRANSFE,0.0,1000000.0,,2018,6,11,CASH_IN,1000000.0,C311901651
33001,409000362497',2018-06-11,IMPS 1106184C,5138321.8,0.0,,2018,6,11,PAYEMENT,5138321.8,C420398953
33002,409000362497',2018-06-11,Sweep Trf To: 40900036427,678786.0,0.0,,2018,6,11,PAYEMENT,678786.0,C1538264524
33003,409000362497',2018-06-12,BIGTREE ENTERTAINMENT PRI,454.0,0.0,,2018,6,12,CHECK_WITHDRAWAL,454.0,C107918665
33004,409000362497',2018-06-12,INDIAIDEAS.COM LTD,87862.0,0.0,,2018,6,12,CASH_OUT,87862.0,C1583408697
33005,409000362497',2018-06-12,IRCTC CORPORATE OFFICE AC,70055.0,0.0,,2018,6,12,CHECK_WITHDRAWAL,70055.0,C1500894076
33006,409000362497',2018-06-12,PAYU PAYMENTS PRIVATE LIM,24633.0,0.0,,2018,6,12,CASH_OUT,24633.0,C766327981
33007,409000362497',2018-06-12,AVENUES INDIA PRIVATE LIM,10073.0,0.0,,2018,6,12,CASH_OUT,10073.0,C635371680
33008,409000362497',2018-06-12,ZAAK EPAYMENT SERVICES PR,243.0,0.0,,2018,6,12,DEBIT,243.0,C1004044328
33009,409000362497',2018-06-12,FUTURE RETAIL LIMITED (OW,7195.0,0.0,,2018,6,12,CASH_OUT,7195.0,M1276741056
33010,409000362497',2018-06-12,PASFAR TECHNOLOGIES PRIVA,6981.0,0.0,,2018,6,12,DEBIT,6981.0,M1718199123
33011,409000362497',2018-06-12,DISH INFRA SERVICES PRIVA,238.0,0.0,,2018,6,12,CHECK_WITHDRAWAL,238.0,C1619434640
33012,409000362497',2018-06-12,JUST DIAL LIMITED,1926.0,0.0,,2018,6,12,PAYEMENT,1926.0,C1151440027
33013,409000362497',2018-06-12,MEHAR ENTERTAINMENT PRIVA,8987.0,0.0,,2018,6,12,CHECK_WITHDRAWAL,8987.0,M1707730521
33014,409000362497',2018-06-12,Indiaforensic SERVICES INDIA PVT,323318.0,0.0,,2018,6,12,DEBIT,323318.0,C175902979
33015,409000362497',2018-06-12,IMPS 110620181C,5405739.69,0.0,,2018,6,12,DEBIT,5405739.69,C2023391825
33016,409000362497',2018-06-12,IMPS 120620182C,3319684.11,0.0,,2018,6,12,CASH_OUT,3319684.11,M834726210
33017,409000362497',2018-06-12,NEFT/000040875056/BIGTREE,52553.0,0.0,,2018,6,12,DEBIT,52553.0,M1420712041
33018,409000362497',2018-06-12,NEFT/000040875666/IRCTC C,28445.0,0.0,,2018,6,12,PAYEMENT,28445.0,C237685833
33019,409000362497',2018-06-12,NEFT/000040875975/AVENUES,5401.0,0.0,,2018,6,12,CHECK_WITHDRAWAL,5401.0,C931773845
33020,409000362497',2018-06-12,NEFT/000040876600/SYNERGI,3133.0,0.0,,2018,6,12,PAYEMENT,3133.0,C2073764942
33021,409000362497',2018-06-12,NEFT/000040876793/ZAAK EP,403.0,0.0,,2018,6,12,DEBIT,403.0,M1558789062
33022,409000362497',2018-06-12,NEFT/000040877023/FUTURE,1017.0,0.0,,2018,6,12,CASH_OUT,1017.0,M240482293
33023,409000362497',2018-06-12,NEFT/P18061247087818/HULI,0.0,10000.0,,2018,6,12,CHECK_CASHING,10000.0,C1045368778
33024,409000362497',2018-06-12,NEFT/000040877238/PASFAR,188.0,0.0,,2018,6,12,CASH_OUT,188.0,C157603305
33025,409000362497',2018-06-12,NEFT/000040877611/JUST DI,700.0,0.0,,2018,6,12,CASH_OUT,700.0,M2131807245
33026,409000362497',2018-06-12,NEFT/000040878024/VOUCHER,2908.0,0.0,,2018,6,12,CHECK_WITHDRAWAL,2908.0,C813163690
33027,409000362497',2018-06-12,TRF TO  1196428  Indiaforensic S,232507.0,0.0,,2018,6,12,CHECK_WITHDRAWAL,232507.0,C940808447
33028,409000362497',2018-06-12,IMPS 120620183C,7746686.25,0.0,,2018,6,12,CHECK_WITHDRAWAL,7746686.25,C709906087
33029,409000362497',2018-06-12,FDRL/INTERNAL FUND TRANSFE,0.0,7000000.0,,2018,6,12,CHECK_CASHING,7000000.0,C1305075214
33030,409000362497',2018-06-12,FDRL/INTERNAL FUND TRANSFE,0.0,7000000.0,,2018,6,12,CHECK_CASHING,7000000.0,C747184469
33031,409000362497',2018-06-12,FDRL/INTERNAL FUND TRANSFE,0.0,7000000.0,,2018,6,12,CASH_IN,7000000.0,C767720637
33032,409000362497',2018-06-12,IMPS 1206184C,4808738.25,0.0,,2018,6,12,PAYEMENT,4808738.25,C998255530
33033,409000362497',2018-06-12,Sweep Trf To: 40900036427,478014.0,0.0,,2018,6,12,PAYEMENT,478014.0,C1243712710
33034,409000362497',2018-06-13,ACH DR NATIONAL PAYMENT C,10000.0,0.0,,2018,6,13,PAYEMENT,10000.0,C1570076320
33035,409000362497',2018-06-13,ACH DR NATIONAL PAYMENT C,2962.3,0.0,,2018,6,13,DEBIT,2962.3,C193553253
33036,409000362497',2018-06-13,IMPS 120620181C,4447682.9,0.0,,2018,6,13,CHECK_WITHDRAWAL,4447682.9,C699026377
33037,409000362497',2018-06-13,IMPS 130620182C,2712569.83,0.0,,2018,6,13,PAYEMENT,2712569.83,C1692142175
33038,409000362497',2018-06-13,IMPS 130620183C,7270844.35,0.0,,2018,6,13,DEBIT,7270844.35,C1231842708
33039,409000362497',2018-06-13,NEFT/SBIN718164297629/Indfor,0.0,2700000.0,,2018,6,13,CASH_IN,2700000.0,C510382951
33040,409000362497',2018-06-13,FDRL/INTERNAL FUND TRANSFE,0.0,15000000.0,,2018,6,13,CASH_IN,15000000.0,C935808590
33041,409000362497',2018-06-13,FDRL/INTERNAL FUND TRANSFE,0.0,1000000.0,,2018,6,13,CHECK_CASHING,1000000.0,C1768641212
33042,409000362497',2018-06-13,FDRL/INTERNAL FUND TRANSFE,0.0,1000000.0,,2018,6,13,TRANSFER,1000000.0,C1611427359
33043,409000362497',2018-06-13,IMPS 1306184C,4359076.36,0.0,,2018,6,13,CHECK_WITHDRAWAL,4359076.36,M334768018
33044,409000362497',2018-06-13,Sweep Trf To: 40900036427,500082.0,0.0,,2018,6,13,CHECK_WITHDRAWAL,500082.0,C777863332
33045,409000362497',2018-06-14,IMPS 130620181C,4270824.8,0.0,,2018,6,14,DEBIT,4270824.8,C1198441233
33046,409000362497',2018-06-14,BIGTREE ENTERTAINMENT PRI,52730.0,0.0,,2018,6,14,PAYEMENT,52730.0,M1134559579
33047,409000362497',2018-06-14,IRCTC CORPORATE OFFICE AC,19860.0,0.0,,2018,6,14,CHECK_WITHDRAWAL,19860.0,M1558921270
33048,409000362497',2018-06-14,PAYU PAYMENTS PRIVATE LIM,16284.0,0.0,,2018,6,14,PAYEMENT,16284.0,C1991252420
33049,409000362497',2018-06-14,AVENUES INDIA PRIVATE LIM,288.0,0.0,,2018,6,14,CHECK_WITHDRAWAL,288.0,C937195105
33050,409000362497',2018-06-14,SYNERGISTIC FINANCIAL NET,1339.0,0.0,,2018,6,14,CHECK_WITHDRAWAL,1339.0,M1750547063
33051,409000362497',2018-06-14,ZAAK EPAYMENT SERVICES PR,129.0,0.0,,2018,6,14,CHECK_WITHDRAWAL,129.0,C1308497108
33052,409000362497',2018-06-14,FUTURE RETAIL LIMITED (OW,454.0,0.0,,2018,6,14,CHECK_WITHDRAWAL,454.0,M1462993597
33053,409000362497',2018-06-14,PASFAR TECHNOLOGIES PRIVA,6685.0,0.0,,2018,6,14,CASH_OUT,6685.0,M1112044738
33054,409000362497',2018-06-14,JUST DIAL LIMITED,145.0,0.0,,2018,6,14,CASH_OUT,145.0,M1328373163
33055,409000362497',2018-06-14,MEHAR ENTERTAINMENT PRIVA,5530.0,0.0,,2018,6,14,DEBIT,5530.0,C5554526
33056,409000362497',2018-06-14,QWIKCILVER SOLUTIONS PRIV,3473.0,0.0,,2018,6,14,PAYEMENT,3473.0,M2024295744
33057,409000362497',2018-06-14,Indiaforensic SERVICES INDIA PVT,199474.0,0.0,,2018,6,14,PAYEMENT,199474.0,M1158742277
33058,409000362497',2018-06-14,IMPS 140620182C,2392291.03,0.0,,2018,6,14,DEBIT,2392291.03,C78018658
33059,409000362497',2018-06-14,BIGTREE ENTERTAINMENT PRI,518.0,0.0,,2018,6,14,DEBIT,518.0,M726420284
33060,409000362497',2018-06-14,IRCTC CORPORATE OFFICE AC,30910.0,0.0,,2018,6,14,DEBIT,30910.0,M2038881758
33061,409000362497',2018-06-14,PAYU PAYMENTS PRIVATE LIM,12582.0,0.0,,2018,6,14,PAYEMENT,12582.0,C444613285
33062,409000362497',2018-06-14,BIDDERBOY CORPORATION,390.0,0.0,,2018,6,14,PAYEMENT,390.0,M1951675497
33063,409000362497',2018-06-14,AVENUES INDIA PRIVATE LIM,5837.0,0.0,,2018,6,14,CHECK_WITHDRAWAL,5837.0,M300896506
33064,409000362497',2018-06-14,FUTURE RETAIL LIMITED (OW,143.0,0.0,,2018,6,14,CASH_OUT,143.0,M1120765537
33065,409000362497',2018-06-14,PASFAR TECHNOLOGIES PRIVA,4347.0,0.0,,2018,6,14,CHECK_WITHDRAWAL,4347.0,C171493374
33066,409000362497',2018-06-14,MEHAR ENTERTAINMENT PRIVA,1959.0,0.0,,2018,6,14,DEBIT,1959.0,C715907650
33067,409000362497',2018-06-14,Indiaforensic SERVICES INDIA PVT,281233.0,0.0,,2018,6,14,CASH_OUT,281233.0,C2042243783
33068,409000362497',2018-06-14,IMPS 140620183C,6355479.46,0.0,,2018,6,14,CHECK_WITHDRAWAL,6355479.46,C29244959
33069,409000362497',2018-06-14,NEFT/SBIN818165157866/Indfor,0.0,2600000.0,,2018,6,14,TRANSFER,2600000.0,C1577744105
33070,409000362497',2018-06-14,FDRL/INTERNAL FUND TRANSFE,0.0,15000000.0,,2018,6,14,CASH_IN,15000000.0,M284580514
33071,409000362497',2018-06-14,FDRL/INTERNAL FUND TRANSFE,0.0,500000.0,,2018,6,14,CASH_IN,500000.0,M1790049291
33072,409000362497',2018-06-14,IMPS 140620184C,4499127.1,0.0,,2018,6,14,CASH_OUT,4499127.1,M238423553
33073,409000362497',2018-06-14,Sweep Trf To: 40900036427,470295.0,0.0,,2018,6,14,CHECK_WITHDRAWAL,470295.0,C1450512920
33074,409000362497',2018-06-15,IMPS 140620181C,4054727.66,0.0,,2018,6,15,PAYEMENT,4054727.66,M1923531508
33075,409000362497',2018-06-15,IMPS 150620182C,2250992.11,0.0,,2018,6,15,DEBIT,2250992.11,C386501381
33076,409000362497',2018-06-15,IMPS 150620183C,6012655.19,0.0,,2018,6,15,PAYEMENT,6012655.19,C229747691
33077,409000362497',2018-06-15,NEFT/SBIN818166998192/Indfor,0.0,5500000.0,,2018,6,15,CASH_IN,5500000.0,M1248881655
33078,409000362497',2018-06-15,NEFT/AXIC181668066368/Indfor,0.0,15000000.0,,2018,6,15,TRANSFER,15000000.0,M1750926016
33079,409000362497',2018-06-15,FDRL/INTERNAL FUND TRANSFE,0.0,7000000.0,,2018,6,15,CASH_IN,7000000.0,M38798233
33080,409000362497',2018-06-15,FDRL/INTERNAL FUND TRANSFE,0.0,8000000.0,,2018,6,15,CHECK_CASHING,8000000.0,M1802269810
33081,409000362497',2018-06-15,IMPS 1506184C,3565829.19,0.0,,2018,6,15,CASH_OUT,3565829.19,M358531786
33082,409000362497',2018-06-15,Sweep Trf To: 40900036427,485416.0,0.0,,2018,6,15,DEBIT,485416.0,M1332400838
33083,409000362497',2018-06-18,BIGTREE ENTERTAINMENT PRI,16819.0,0.0,,2018,6,18,DEBIT,16819.0,M973022804
33084,409000362497',2018-06-18,INDIAIDEAS.COM LTD,188553.0,0.0,,2018,6,18,CHECK_WITHDRAWAL,188553.0,M135447693
33085,409000362497',2018-06-18,IRCTC CORPORATE OFFICE AC,101160.0,0.0,,2018,6,18,CASH_OUT,101160.0,C2122491387
33086,409000362497',2018-06-18,PAYU PAYMENTS PRIVATE LIM,38607.0,0.0,,2018,6,18,CHECK_WITHDRAWAL,38607.0,C351245548
33087,409000362497',2018-06-18,BIDDERBOY CORPORATION,2838.0,0.0,,2018,6,18,PAYEMENT,2838.0,M70837705
33088,409000362497',2018-06-18,MATRIX CELLULAR (INTERNAT,3889.0,0.0,,2018,6,18,CHECK_WITHDRAWAL,3889.0,C539169668
33089,409000362497',2018-06-18,AVENUES INDIA PRIVATE LIM,9989.0,0.0,,2018,6,18,CHECK_WITHDRAWAL,9989.0,M928568829
33090,409000362497',2018-06-18,SYNERGISTIC FINANCIAL NET,879.0,0.0,,2018,6,18,DEBIT,879.0,C602874477
33091,409000362497',2018-06-18,ZAAK EPAYMENT SERVICES PR,3036.0,0.0,,2018,6,18,DEBIT,3036.0,C1778801068
33092,409000362497',2018-06-18,FUTURE RETAIL LIMITED (OW,5044.0,0.0,,2018,6,18,CHECK_WITHDRAWAL,5044.0,M1306213509
33093,409000362497',2018-06-18,METRO INFRASYS PRIVATE LI,697.0,0.0,,2018,6,18,CHECK_WITHDRAWAL,697.0,M320801509
33094,409000362497',2018-06-18,PASFAR TECHNOLOGIES PRIVA,16468.0,0.0,,2018,6,18,PAYEMENT,16468.0,M1412753867
33095,409000362497',2018-06-18,DISH INFRA SERVICES PRIVA,1227.0,0.0,,2018,6,18,PAYEMENT,1227.0,C1949938346
33096,409000362497',2018-06-18,MEHAR ENTERTAINMENT PRIVA,6222.0,0.0,,2018,6,18,DEBIT,6222.0,C407491418
33097,409000362497',2018-06-18,JUST DIAL LIMITED,978.0,0.0,,2018,6,18,DEBIT,978.0,M1954325558
33098,409000362497',2018-06-18,ALT DIGITAL MEDIA ENTERTA,98.0,0.0,,2018,6,18,PAYEMENT,98.0,M78345281
33099,409000362497',2018-06-18,Indiaforensic SERVICES INDIA PVT,525174.0,0.0,,2018,6,18,CASH_OUT,525174.0,M960749370
33100,409000362497',2018-06-18,IMPS 1806183C,6895994.67,0.0,,2018,6,18,CASH_OUT,6895994.67,M390859470
33101,409000362497',2018-06-18,IMPS 150620181C,3893144.21,0.0,,2018,6,18,CHECK_WITHDRAWAL,3893144.21,M1678932257
33102,409000362497',2018-06-18,IMPS 1606181C,10410488.62,0.0,,2018,6,18,PAYEMENT,10410488.62,C2122491387
33103,409000362497',2018-06-18,IMPS 1706181C,6359790.03,0.0,,2018,6,18,DEBIT,6359790.03,C447680780
33104,409000362497',2018-06-18,IMPS 1806182C,3223630.59,0.0,,2018,6,18,CASH_OUT,3223630.59,C1917747929
33105,409000362497',2018-06-18,NEFT/SBIN918169875734/Indfor,0.0,4000000.0,,2018,6,18,CHECK_CASHING,4000000.0,C803648645
33106,409000362497',2018-06-18,FDRL/INTERNAL FUND TRANSFE,0.0,5000000.0,,2018,6,18,CHECK_CASHING,5000000.0,C1032986144
33107,409000362497',2018-06-18,FDRL/INTERNAL FUND TRANSFE,0.0,3000000.0,,2018,6,18,CASH_IN,3000000.0,M726743010
33108,409000362497',2018-06-18,FDRL/INTERNAL FUND TRANSFE,0.0,5000000.0,,2018,6,18,TRANSFER,5000000.0,C1994035663
33109,409000362497',2018-06-18,IMPS 1806184C,4092575.69,0.0,,2018,6,18,CHECK_WITHDRAWAL,4092575.69,M260421261
33110,409000362497',2018-06-18,IMPS 816923434710 FROM OX,0.0,200000.0,,2018,6,18,TRANSFER,200000.0,C1761324386
33111,409000362497',2018-06-18,IMPS 816923434721 FROM OX,0.0,200000.0,,2018,6,18,TRANSFER,200000.0,M1443176615
33112,409000362497',2018-06-18,IMPS 816923434727 FROM OX,0.0,200000.0,,2018,6,18,TRANSFER,200000.0,C1891834647
33113,409000362497',2018-06-18,IMPS 816923434739 FROM OX,0.0,200000.0,,2018,6,18,CASH_IN,200000.0,C1686797378
33114,409000362497',2018-06-18,IMPS 816923434748 FROM OX,0.0,200000.0,,2018,6,18,CASH_IN,200000.0,C1761741722
33115,409000362497',2018-06-18,Sweep Trf To: 40900036427,529140.0,0.0,,2018,6,18,CASH_OUT,529140.0,M1768247972
33116,409000362497',2018-06-19,IMPS 1806181C,4353305.58,0.0,,2018,6,19,CHECK_WITHDRAWAL,4353305.58,M1969367361
33117,409000362497',2018-06-19,IMPS 190620182C,2150031.46,0.0,,2018,6,19,CHECK_WITHDRAWAL,2150031.46,M1565425487
33118,409000362497',2018-06-19,RTGS/YESBH18170494407/IRC,0.0,890785.0,,2018,6,19,CHECK_CASHING,890785.0,C1274461229
33119,409000362497',2018-06-19,IMPS 190620183C,6504074.95,0.0,,2018,6,19,CASH_OUT,6504074.95,C174407284
33120,409000362497',2018-06-19,FDRL/INTERNAL FUND TRANSFE,0.0,5000000.0,,2018,6,19,TRANSFER,5000000.0,C2112921429
33121,409000362497',2018-06-19,FDRL/INTERNAL FUND TRANSFE,0.0,5000000.0,,2018,6,19,TRANSFER,5000000.0,C1945176140
33122,409000362497',2018-06-19,FDRL/INTERNAL FUND TRANSFE,0.0,500000.0,,2018,6,19,TRANSFER,500000.0,C2094777811
33123,409000362497',2018-06-19,FDRL/INTERNAL FUND TRANSFE,0.0,3000000.0,,2018,6,19,TRANSFER,3000000.0,C445613834
33124,409000362497',2018-06-19,NEFT/SBIN118170652046/Indfor,0.0,3200000.0,,2018,6,19,CHECK_CASHING,3200000.0,C341552838
33125,409000362497',2018-06-19,IMPS 1906184C,4072692.44,0.0,,2018,6,19,DEBIT,4072692.44,C1107146140
33126,409000362497',2018-06-19,Sweep Trf To: 40900036427,459350.0,0.0,,2018,6,19,CASH_OUT,459350.0,C265184085
33127,409000362497',2018-06-20,BIGTREE ENTERTAINMENT PRI,237.0,0.0,,2018,6,20,PAYEMENT,237.0,C1090263069
33128,409000362497',2018-06-20,INDIAIDEAS.COM LTD,46571.0,0.0,,2018,6,20,DEBIT,46571.0,C1083142315
33129,409000362497',2018-06-20,IRCTC CORPORATE OFFICE AC,17760.0,0.0,,2018,6,20,DEBIT,17760.0,C1871293699
33130,409000362497',2018-06-20,PAYU PAYMENTS PRIVATE LIM,45058.0,0.0,,2018,6,20,CASH_OUT,45058.0,C1942319984
33131,409000362497',2018-06-20,AVENUES INDIA PRIVATE LIM,2267.0,0.0,,2018,6,20,DEBIT,2267.0,C2078250226
33132,409000362497',2018-06-20,SYNERGISTIC FINANCIAL NET,1559.0,0.0,,2018,6,20,CASH_OUT,1559.0,C1514087105
33133,409000362497',2018-06-20,FUTURE RETAIL LIMITED (OW,386.0,0.0,,2018,6,20,PAYEMENT,386.0,C837153776
33134,409000362497',2018-06-20,PASFAR TECHNOLOGIES PRIVA,5815.0,0.0,,2018,6,20,PAYEMENT,5815.0,C2116153614
33135,409000362497',2018-06-20,MEHAR ENTERTAINMENT PRIVA,230.0,0.0,,2018,6,20,CASH_OUT,230.0,C635281078
33136,409000362497',2018-06-20,JUST DIAL LIMITED,392.0,0.0,,2018,6,20,CASH_OUT,392.0,C1588901702
33137,409000362497',2018-06-20,VOUCHER ACTIVATION SERVIC,999.0,0.0,,2018,6,20,DEBIT,999.0,C715007517
33138,409000362497',2018-06-20,QWIKCILVER SOLUTIONS PRIV,4546.0,0.0,,2018,6,20,CHECK_WITHDRAWAL,4546.0,C1298147262
33139,409000362497',2018-06-20,Indiaforensic SERVICES INDIA PVT,188371.0,0.0,,2018,6,20,PAYEMENT,188371.0,C884166426
33140,409000362497',2018-06-20,BIGTREE ENTERTAINMENT PRI,1845.0,0.0,,2018,6,20,CHECK_WITHDRAWAL,1845.0,C1814290211
33141,409000362497',2018-06-20,INDIAIDEAS.COM LTD,39192.0,0.0,,2018,6,20,PAYEMENT,39192.0,C824009085
33142,409000362497',2018-06-20,IRCTC CORPORATE OFFICE AC,22070.0,0.0,,2018,6,20,DEBIT,22070.0,C1858098329
33143,409000362497',2018-06-20,PAYU PAYMENTS PRIVATE LIM,8073.0,0.0,,2018,6,20,CHECK_WITHDRAWAL,8073.0,C2119889994
33144,409000362497',2018-06-20,AVENUES INDIA PRIVATE LIM,453.0,0.0,,2018,6,20,CHECK_WITHDRAWAL,453.0,C1577420620
33145,409000362497',2018-06-20,FUTURE RETAIL LIMITED (OW,484.0,0.0,,2018,6,20,CASH_OUT,484.0,C1066166621
33146,409000362497',2018-06-20,PASFAR TECHNOLOGIES PRIVA,5183.0,0.0,,2018,6,20,DEBIT,5183.0,C1178471274
33147,409000362497',2018-06-20,MEHAR ENTERTAINMENT PRIVA,9217.0,0.0,,2018,6,20,CHECK_WITHDRAWAL,9217.0,C1028574311
33148,409000362497',2018-06-20,Indiaforensic SERVICES INDIA PVT,158168.0,0.0,,2018,6,20,DEBIT,158168.0,C290555266
33149,409000362497',2018-06-20,IMPS 2006183C,5757638.32,0.0,,2018,6,20,DEBIT,5757638.32,C69221303
33150,409000362497',2018-06-20,IMPS 1906181C,3912322.99,0.0,,2018,6,20,DEBIT,3912322.99,C1876630105
33151,409000362497',2018-06-20,IMPS 2006182C,2242295.51,0.0,,2018,6,20,DEBIT,2242295.51,C1982828534
33152,409000362497',2018-06-20,NEFT/SBIN218171399146/Indfor,0.0,2000000.0,,2018,6,20,CASH_IN,2000000.0,C214774813
33153,409000362497',2018-06-20,FDRL/INTERNAL FUND TRANSFE,0.0,5000000.0,,2018,6,20,CASH_IN,5000000.0,C1781548235
33154,409000362497',2018-06-20,FDRL/INTERNAL FUND TRANSFE,0.0,5000000.0,,2018,6,20,CHECK_CASHING,5000000.0,C554025243
33155,409000362497',2018-06-20,FDRL/INTERNAL FUND TRANSFE,0.0,1000000.0,,2018,6,20,CASH_IN,1000000.0,C656361304
33156,409000362497',2018-06-20,FDRL/INTERNAL FUND TRANSFE,0.0,1000000.0,,2018,6,20,CHECK_CASHING,1000000.0,C977993101
33157,409000362497',2018-06-20,IMPS 2006184C,3249927.93,0.0,,2018,6,20,CASH_OUT,3249927.93,C593210287
33158,409000362497',2018-06-20,Sweep Trf To: 40900036427,411755.0,0.0,,2018,6,20,PAYEMENT,411755.0,C578102596
33159,409000362497',2018-06-21,IMPS 2006181C,4004235.66,0.0,,2018,6,21,PAYEMENT,4004235.66,C1709472302
33160,409000362497',2018-06-21,IMPS 2106182C,2735567.65,0.0,,2018,6,21,PAYEMENT,2735567.65,M696254933
33161,409000362497',2018-06-21,INDIAIDEAS.COM LTD,48342.0,0.0,,2018,6,21,CASH_OUT,48342.0,C459172227
33162,409000362497',2018-06-21,IRCTC CORPORATE OFFICE AC,28625.0,0.0,,2018,6,21,CASH_OUT,28625.0,C1504217374
33163,409000362497',2018-06-21,PAYU PAYMENTS PRIVATE LIM,34441.0,0.0,,2018,6,21,PAYEMENT,34441.0,C2007149130
33164,409000362497',2018-06-21,AVENUES INDIA PRIVATE LIM,3503.0,0.0,,2018,6,21,DEBIT,3503.0,C1677727024
33165,409000362497',2018-06-21,ZAAK EPAYMENT SERVICES PR,1775.0,0.0,,2018,6,21,CASH_OUT,1775.0,C2140532987
33166,409000362497',2018-06-21,FUTURE RETAIL LIMITED (OW,953.0,0.0,,2018,6,21,DEBIT,953.0,C648604330
33167,409000362497',2018-06-21,PASFAR TECHNOLOGIES PRIVA,1209.0,0.0,,2018,6,21,CHECK_WITHDRAWAL,1209.0,C1825051499
33168,409000362497',2018-06-21,HUNGAMA DIGITAL MEDIA ENT,359.0,0.0,,2018,6,21,CASH_OUT,359.0,C64133603
33169,409000362497',2018-06-21,JUST DIAL LIMITED,1315.0,0.0,,2018,6,21,PAYEMENT,1315.0,C1479553213
33170,409000362497',2018-06-21,MEHAR ENTERTAINMENT PRIVA,6567.0,0.0,,2018,6,21,CASH_OUT,6567.0,C527482085
33171,409000362497',2018-06-21,INDIAIDEAS.COM LTD,8845.0,0.0,,2018,6,21,DEBIT,8845.0,C222020906
33172,409000362497',2018-06-21,INDIAIDEAS.COM LTD,52553.0,0.0,,2018,6,21,DEBIT,52553.0,C1335946878
33173,409000362497',2018-06-21,INDIAIDEAS.COM LTD,52730.0,0.0,,2018,6,21,DEBIT,52730.0,M267583302
33174,409000362497',2018-06-21,Indiaforensic SERVICES INDIA PVT,211633.0,0.0,,2018,6,21,PAYEMENT,211633.0,C1481637576
33175,409000362497',2018-06-21,IMPS 2106183C,5526899.68,0.0,,2018,6,21,PAYEMENT,5526899.68,M146986305
33176,409000362497',2018-06-21,NEFT/SBIN318172262096/Indfor,0.0,3000000.0,,2018,6,21,CHECK_CASHING,3000000.0,M2052797491
33177,409000362497',2018-06-21,FDRL/INTERNAL FUND TRANSFE,0.0,8000000.0,,2018,6,21,CASH_IN,8000000.0,C1653390476
33178,409000362497',2018-06-21,FDRL/INTERNAL FUND TRANSFE,0.0,6000000.0,,2018,6,21,CHECK_CASHING,6000000.0,M1744219435
33179,409000362497',2018-06-21,IMPS 2106184C,3883177.2,0.0,,2018,6,21,DEBIT,3883177.2,C1709437931
33180,409000362497',2018-06-21,Sweep Trf To: 40900036427,322888.0,0.0,,2018,6,21,CHECK_WITHDRAWAL,322888.0,M1873237251
33181,409000362497',2018-06-22,IMPS 2106181C,2701193.03,0.0,,2018,6,22,DEBIT,2701193.03,C986473968
33182,409000362497',2018-06-22,IMPS 2206182C,2066048.05,0.0,,2018,6,22,DEBIT,2066048.05,M823751502
33183,409000362497',2018-06-22,IMPS 2206183C,5301826.66,0.0,,2018,6,22,CASH_OUT,5301826.66,M139737848
33184,409000362497',2018-06-22,INDIAIDEAS.COM LTD,2006.0,0.0,,2018,6,22,DEBIT,2006.0,M1425280712
33185,409000362497',2018-06-22,IRCTC CORPORATE OFFICE AC,10985.0,0.0,,2018,6,22,PAYEMENT,10985.0,M5848438
33186,409000362497',2018-06-22,PAYU PAYMENTS PRIVATE LIM,14819.0,0.0,,2018,6,22,PAYEMENT,14819.0,C618155294
33187,409000362497',2018-06-22,AVENUES INDIA PRIVATE LIM,2231.0,0.0,,2018,6,22,CASH_OUT,2231.0,M91290561
33188,409000362497',2018-06-22,ZAAK EPAYMENT SERVICES PR,491.0,0.0,,2018,6,22,DEBIT,491.0,M1827625158
33189,409000362497',2018-06-22,FUTURE RETAIL LIMITED (OW,623.0,0.0,,2018,6,22,PAYEMENT,623.0,M213213338
33190,409000362497',2018-06-22,PASFAR TECHNOLOGIES PRIVA,5472.0,0.0,,2018,6,22,PAYEMENT,5472.0,M137853075
33191,409000362497',2018-06-22,JUST DIAL LIMITED,195.0,0.0,,2018,6,22,PAYEMENT,195.0,C1448067637
33192,409000362497',2018-06-22,MEHAR ENTERTAINMENT PRIVA,4609.0,0.0,,2018,6,22,CHECK_WITHDRAWAL,4609.0,C2103065350
33193,409000362497',2018-06-22,Indiaforensic SERVICES INDIA PVT,148984.0,0.0,,2018,6,22,CHECK_WITHDRAWAL,148984.0,C1272645699
33194,409000362497',2018-06-22,NEFT/SBIN418173025401/Indfor,0.0,3400000.0,,2018,6,22,CHECK_CASHING,3400000.0,M418576194
33195,409000362497',2018-06-22,TRF FROM  Indiaforensic SERVICES,0.0,10000000.0,,2018,6,22,TRANSFER,10000000.0,C1292774338
33196,409000362497',2018-06-22,FDRL/INTERNAL FUND TRANSFE,0.0,15000000.0,,2018,6,22,TRANSFER,15000000.0,C1106744673
33197,409000362497',2018-06-22,FDRL/INTERNAL FUND TRANSFE,0.0,2000000.0,,2018,6,22,TRANSFER,2000000.0,C620638596
33198,409000362497',2018-06-22,IMPS 2206184C,3626549.19,0.0,,2018,6,22,DEBIT,3626549.19,C1339257929
33199,409000362497',2018-06-22,TRF FROM  Indiaforensic SERVICES,0.0,10000000.0,,2018,6,22,TRANSFER,10000000.0,C582320549
33200,409000362497',2018-06-22,Sweep Trf To: 40900036427,338789.0,0.0,,2018,6,22,PAYEMENT,338789.0,M1683669643
33201,409000362497',2018-06-23,Sweep Trf To: 40900036427,20500.0,0.0,,2018,6,23,DEBIT,20500.0,M1838080407
33202,409000362497',2018-06-25,IMPS 2206181C,3750525.09,0.0,,2018,6,25,DEBIT,3750525.09,M1473027439
33203,409000362497',2018-06-25,IMPS 2306181C,14601735.62,0.0,,2018,6,25,CHECK_WITHDRAWAL,14601735.62,M905570887
33204,409000362497',2018-06-25,IMPS 2406181C,7530221.1,0.0,,2018,6,25,CHECK_WITHDRAWAL,7530221.1,C1971344738
33205,409000362497',2018-06-25,IMPS 2506182C,2360212.3,0.0,,2018,6,25,CHECK_WITHDRAWAL,2360212.3,C1320515149
33206,409000362497',2018-06-25,IMPS 2506183C,5082984.55,0.0,,2018,6,25,CASH_OUT,5082984.55,C1880185595
33207,409000362497',2018-06-25,NEFT/SBIN418176970706/Indfor,0.0,1100000.0,,2018,6,25,CHECK_CASHING,1100000.0,M1825401217
33208,409000362497',2018-06-25,TRF FROM  Indiaforensic SERVICES,0.0,15000000.0,,2018,6,25,CHECK_CASHING,15000000.0,M1748703701
33209,409000362497',2018-06-25,TRF FROM  Indiaforensic SERVICES,0.0,700000.0,,2018,6,25,TRANSFER,700000.0,C646183851
33210,409000362497',2018-06-25,IMPS 2506184C,3743456.76,0.0,,2018,6,25,CHECK_WITHDRAWAL,3743456.76,M1146230789
33211,409000362497',2018-06-25,Sweep Trf To: 40900036427,282785.0,0.0,,2018,6,25,CHECK_WITHDRAWAL,282785.0,M1154865135
33212,409000362497',2018-06-26,INDIAIDEAS.COM LTD,88115.0,0.0,,2018,6,26,CASH_OUT,88115.0,C1825634724
33213,409000362497',2018-06-26,IRCTC CORPORATE OFFICE AC,154545.0,0.0,,2018,6,26,CHECK_WITHDRAWAL,154545.0,C2106812355
33214,409000362497',2018-06-26,PAYU PAYMENTS PRIVATE LIM,52314.0,0.0,,2018,6,26,CASH_OUT,52314.0,C2114480990
33215,409000362497',2018-06-26,AVENUES INDIA PRIVATE LIM,24627.0,0.0,,2018,6,26,CHECK_WITHDRAWAL,24627.0,M156050235
33216,409000362497',2018-06-26,ZAAK EPAYMENT SERVICES PR,391.0,0.0,,2018,6,26,DEBIT,391.0,M914071546
33217,409000362497',2018-06-26,FUTURE RETAIL LIMITED (OW,2287.0,0.0,,2018,6,26,CHECK_WITHDRAWAL,2287.0,C1318822808
33218,409000362497',2018-06-26,PASFAR TECHNOLOGIES PRIVA,5971.0,0.0,,2018,6,26,CASH_OUT,5971.0,C713039134
33219,409000362497',2018-06-26,DISH INFRA SERVICES PRIVA,635.0,0.0,,2018,6,26,CASH_OUT,635.0,C459857341
33220,409000362497',2018-06-26,JUST DIAL LIMITED,194.0,0.0,,2018,6,26,PAYEMENT,194.0,M418623258
33221,409000362497',2018-06-26,MEHAR ENTERTAINMENT PRIVA,5991.0,0.0,,2018,6,26,PAYEMENT,5991.0,C1194807938
33222,409000362497',2018-06-26,Indiaforensic SERVICES INDIA PVT,437405.0,0.0,,2018,6,26,CHECK_WITHDRAWAL,437405.0,M334183260
33223,409000362497',2018-06-26,IMPS 2506181C,3389645.66,0.0,,2018,6,26,PAYEMENT,3389645.66,M1045595960
33224,409000362497',2018-06-26,IMPS 2606182C,2075870.05,0.0,,2018,6,26,PAYEMENT,2075870.05,C1829109420
33225,409000362497',2018-06-26,INDIAIDEAS.COM LTD,43099.0,0.0,,2018,6,26,CASH_OUT,43099.0,C1887021195
33226,409000362497',2018-06-26,IRCTC CORPORATE OFFICE AC,44725.0,0.0,,2018,6,26,CHECK_WITHDRAWAL,44725.0,C1467806809
33227,409000362497',2018-06-26,PAYU PAYMENTS PRIVATE LIM,10144.0,0.0,,2018,6,26,PAYEMENT,10144.0,C130777353
33228,409000362497',2018-06-26,AVENUES INDIA PRIVATE LIM,7426.0,0.0,,2018,6,26,DEBIT,7426.0,C653745564
33229,409000362497',2018-06-26,SYNERGISTIC FINANCIAL NET,1936.0,0.0,,2018,6,26,CHECK_WITHDRAWAL,1936.0,C40075281
33230,409000362497',2018-06-26,FUTURE RETAIL LIMITED (OW,342.0,0.0,,2018,6,26,CHECK_WITHDRAWAL,342.0,C1414803985
33231,409000362497',2018-06-26,PASFAR TECHNOLOGIES PRIVA,10334.0,0.0,,2018,6,26,DEBIT,10334.0,C1065349988
33232,409000362497',2018-06-26,JUST DIAL LIMITED,376.0,0.0,,2018,6,26,CHECK_WITHDRAWAL,376.0,C391903689
33233,409000362497',2018-06-26,MEHAR ENTERTAINMENT PRIVA,1267.0,0.0,,2018,6,26,DEBIT,1267.0,C84277455
33234,409000362497',2018-06-26,ALT DIGITAL MEDIA ENTERTA,98.0,0.0,,2018,6,26,CASH_OUT,98.0,C1245522769
33235,409000362497',2018-06-26,Indiaforensic SERVICES INDIA PVT,155889.0,0.0,,2018,6,26,CASH_OUT,155889.0,C1095666481
33236,409000362497',2018-06-26,IMPS 2606183C,6026960.6,0.0,,2018,6,26,CASH_OUT,6026960.6,C1204684191
33237,409000362497',2018-06-26,NEFT/SBIN518177711875/Indfor,0.0,1000000.0,,2018,6,26,TRANSFER,1000000.0,C2067466390
33238,409000362497',2018-06-26,TRF FROM  Indiaforensic SERVICES,0.0,13700000.0,,2018,6,26,TRANSFER,13700000.0,C713987035
33239,409000362497',2018-06-26,IMPS 2606184C,3797371.81,0.0,,2018,6,26,DEBIT,3797371.81,C68113386
33240,409000362497',2018-06-26,Sweep Trf To: 40900036427,186362.0,0.0,,2018,6,26,PAYEMENT,186362.0,C1934837365
33241,409000362497',2018-06-27,IMPS 2606181C,3849364.29,0.0,,2018,6,27,DEBIT,3849364.29,C363040574
33242,409000362497',2018-06-27,IMPS 2706182C,2511177.06,0.0,,2018,6,27,DEBIT,2511177.06,C586009238
33243,409000362497',2018-06-27,IMPS 2706183C,5077892.28,0.0,,2018,6,27,CHECK_WITHDRAWAL,5077892.28,C2014517831
33244,409000362497',2018-06-27,NEFT/000047919167/Indiaforensic,0.0,1200000.0,,2018,6,27,TRANSFER,1200000.0,C14440699
33245,409000362497',2018-06-27,NEFT/000047919471/Indiaforensic,0.0,1500000.0,,2018,6,27,CHECK_CASHING,1500000.0,M1087907954
33246,409000362497',2018-06-27,TRF FROM  Indiaforensic SERVICES,0.0,7400000.0,,2018,6,27,CHECK_CASHING,7400000.0,M1991575959
33247,409000362497',2018-06-27,NEFT/SBIN618178362110/Indfor,0.0,2500000.0,,2018,6,27,CHECK_CASHING,2500000.0,M2056160973
33248,409000362497',2018-06-27,IMPS 2706184C,3134563.9,0.0,,2018,6,27,DEBIT,3134563.9,M104692988
33249,409000362497',2018-06-27,Sweep Trf To: 40900036427,202803.0,0.0,,2018,6,27,DEBIT,202803.0,M1444082923
33250,409000362497',2018-06-28,IMPS 2706181C,2941747.26,0.0,,2018,6,28,CASH_OUT,2941747.26,M852013192
33251,409000362497',2018-06-28,IMPS 2806182C,2278422.4,0.0,,2018,6,28,CHECK_WITHDRAWAL,2278422.4,M237700584
33252,409000362497',2018-06-28,NEFT/000047984775/Indiaforensic,0.0,770000.0,,2018,6,28,CASH_IN,770000.0,M1504149316
33253,409000362497',2018-06-28,NEFT/000047984389/Indiaforensic,0.0,1980000.0,,2018,6,28,CHECK_CASHING,1980000.0,M951543904
33254,409000362497',2018-06-28,INDIAIDEAS.COM LTD,98793.0,0.0,,2018,6,28,DEBIT,98793.0,C21069748
33255,409000362497',2018-06-28,IRCTC CORPORATE OFFICE AC,45550.0,0.0,,2018,6,28,CHECK_WITHDRAWAL,45550.0,C460989529
33256,409000362497',2018-06-28,PAYU PAYMENTS PRIVATE LIM,42343.0,0.0,,2018,6,28,CHECK_WITHDRAWAL,42343.0,M1453202419
33257,409000362497',2018-06-28,AVENUES INDIA PRIVATE LIM,23768.0,0.0,,2018,6,28,CASH_OUT,23768.0,M1281055260
33258,409000362497',2018-06-28,FUTURE RETAIL LIMITED (OW,508.0,0.0,,2018,6,28,DEBIT,508.0,M1940301092
33259,409000362497',2018-06-28,METRO INFRASYS PRIVATE LI,697.0,0.0,,2018,6,28,CASH_OUT,697.0,M101071962
33260,409000362497',2018-06-28,PASFAR TECHNOLOGIES PRIVA,8350.0,0.0,,2018,6,28,CASH_OUT,8350.0,C811696413
33261,409000362497',2018-06-28,MEHAR ENTERTAINMENT PRIVA,6913.0,0.0,,2018,6,28,DEBIT,6913.0,C475231857
33262,409000362497',2018-06-28,ALT DIGITAL MEDIA ENTERTA,98.0,0.0,,2018,6,28,PAYEMENT,98.0,M1639980271
33263,409000362497',2018-06-28,VOUCHER ACTIVATION SERVIC,4183.0,0.0,,2018,6,28,DEBIT,4183.0,M1871363237
33264,409000362497',2018-06-28,DISH INFRA SERVICES PRIVA,225.0,0.0,,2018,6,28,PAYEMENT,225.0,C878374257
33265,409000362497',2018-06-28,Indiaforensic SERVICES INDIA PVT,326044.0,0.0,,2018,6,28,PAYEMENT,326044.0,M1670650711
33266,409000362497',2018-06-28,IMPS 2806183C,5178716.51,0.0,,2018,6,28,PAYEMENT,5178716.51,C363932613
33267,409000362497',2018-06-28,NEFT/SBIN718179133074/Indfor,0.0,2300000.0,,2018,6,28,CHECK_CASHING,2300000.0,C656802017
33268,409000362497',2018-06-28,IMPS 817919608438 FROM OX,0.0,100000.0,,2018,6,28,TRANSFER,100000.0,M1239733022
33269,409000362497',2018-06-28,IMPS 817919608464 FROM OX,0.0,200000.0,,2018,6,28,CHECK_CASHING,200000.0,C460599381
33270,409000362497',2018-06-28,TRF FROM  Indiaforensic SERVICES,0.0,4600000.0,,2018,6,28,CHECK_CASHING,4600000.0,C240779865
33271,409000362497',2018-06-28,FDRL/INTERNAL FUND TRANSFE,0.0,3000000.0,,2018,6,28,CHECK_CASHING,3000000.0,C683605346
33272,409000362497',2018-06-28,FDRL/INTERNAL FUND TRANSFE,0.0,1000000.0,,2018,6,28,CASH_IN,1000000.0,C2103065350
33273,409000362497',2018-06-28,IMPS 280620184C,3358064.91,0.0,,2018,6,28,DEBIT,3358064.91,C2016335685
33274,409000362497',2018-06-28,Sweep Trf To: 40900036427,212489.0,0.0,,2018,6,28,DEBIT,212489.0,C1461788950
33275,409000362497',2018-06-29,NEFT/000042380833/QWIKCIL,4745.0,0.0,,2018,6,29,CHECK_WITHDRAWAL,4745.0,C571113365
33276,409000362497',2018-06-29,IMPS 280620181C,3249234.21,0.0,,2018,6,29,CASH_OUT,3249234.21,C1515979807
33277,409000362497',2018-06-29,IMPS 290620182C,2277860.0,0.0,,2018,6,29,PAYEMENT,2277860.0,C198998678
33278,409000362497',2018-06-29,IMPS 290620183C,5076235.41,0.0,,2018,6,29,CHECK_WITHDRAWAL,5076235.41,C1232925466
33279,409000362497',2018-06-29,NEFT/000048055027/Indiaforensic,0.0,600000.0,,2018,6,29,CASH_IN,600000.0,C798678484
33280,409000362497',2018-06-29,NEFT/000048055433/Indiaforensic,0.0,500000.0,,2018,6,29,TRANSFER,500000.0,C976144053
33281,409000362497',2018-06-29,TRF FROM  Indiaforensic SERVICES,0.0,5900000.0,,2018,6,29,CHECK_CASHING,5900000.0,C312150693
33282,409000362497',2018-06-29,FDRL/INTERNAL FUND TRANSFE,0.0,8000000.0,,2018,6,29,CASH_IN,8000000.0,C1870252780
33283,409000362497',2018-06-29,IMPS 2906184C,3656728.4,0.0,,2018,6,29,PAYEMENT,3656728.4,C777863332
33284,409000362497',2018-06-29,Sweep Trf To: 40900036427,251278.0,0.0,,2018,6,29,PAYEMENT,251278.0,C2051868384
33285,409000362497',2018-06-30,IMPS 2906181C,2409235.89,0.0,,2018,6,30,CASH_OUT,2409235.89,C160284738
33286,409000362497',2018-06-30,IMPS 3006182C,2510897.04,0.0,,2018,6,30,CASH_OUT,2510897.04,C1205844899
33287,409000362497',2018-06-30,INDIAIDEAS.COM LTD,47247.0,0.0,,2018,6,30,CHECK_WITHDRAWAL,47247.0,C560041895
33288,409000362497',2018-06-30,IRCTC CORPORATE OFFICE AC,40800.0,0.0,,2018,6,30,DEBIT,40800.0,C1833904548
33289,409000362497',2018-06-30,PAYU PAYMENTS PRIVATE LIM,21210.0,0.0,,2018,6,30,CASH_OUT,21210.0,C1705175888
33290,409000362497',2018-06-30,AVENUES INDIA PRIVATE LIM,5065.0,0.0,,2018,6,30,CHECK_WITHDRAWAL,5065.0,C1413677222
33291,409000362497',2018-06-30,FUTURE RETAIL LIMITED (OW,166.0,0.0,,2018,6,30,PAYEMENT,166.0,C1257792677
33292,409000362497',2018-06-30,PASFAR TECHNOLOGIES PRIVA,8515.0,0.0,,2018,6,30,DEBIT,8515.0,M2106259815
33293,409000362497',2018-06-30,MEHAR ENTERTAINMENT PRIVA,1383.0,0.0,,2018,6,30,CHECK_WITHDRAWAL,1383.0,M825871986
33294,409000362497',2018-06-30,QWIKCILVER SOLUTIONS PVT,3941.0,0.0,,2018,6,30,DEBIT,3941.0,M279012331
33295,409000362497',2018-06-30,QWIKCILVER SOLUTIONS PVT,7491.0,0.0,,2018,6,30,PAYEMENT,7491.0,C1268693750
33296,409000362497',2018-06-30,MATRIX CELLULAR (INTERNAT,1119.0,0.0,,2018,6,30,CHECK_WITHDRAWAL,1119.0,C174407284
33297,409000362497',2018-06-30,Indiaforensic SERVICES INDIA PVT,164890.0,0.0,,2018,6,30,CASH_OUT,164890.0,M1940139472
33298,409000362497',2018-06-30,IMPS 3006183C,5367516.96,0.0,,2018,6,30,PAYEMENT,5367516.96,M605918251
33299,409000362497',2018-06-30,FDRL/INTERNAL FUND TRANSFE,0.0,15000000.0,,2018,6,30,CHECK_CASHING,15000000.0,M323613514
33300,409000362497',2018-06-30,IMPS 3006184C,3375439.29,0.0,,2018,6,30,CHECK_WITHDRAWAL,3375439.29,C1670297251
33301,409000362497',2018-06-30,Sweep Trf To: 40900036427,183280.0,0.0,,2018,6,30,DEBIT,183280.0,C1163480574
33302,409000362497',2018-07-02,IMPS 3006181C,2880643.31,0.0,,2018,7,2,DEBIT,2880643.31,M1359175201
33303,409000362497',2018-07-02,IMPS 0107181C,2893267.5,0.0,,2018,7,2,PAYEMENT,2893267.5,M982739209
33304,409000362497',2018-07-02,IMPS 0207182C,37966.07,0.0,,2018,7,2,PAYEMENT,37966.07,M489771107
33305,409000362497',2018-07-02,IMPS OW INTER FEE 0207183,5398140.06,0.0,,2018,7,2,CHECK_WITHDRAWAL,5398140.06,M1101216969
33306,409000362497',2018-07-02,FDRL/INTERNAL FUND TRANSFE,0.0,15000000.0,,2018,7,2,CASH_IN,15000000.0,C1718681400
33307,409000362497',2018-07-02,FDRL/INTERNAL FUND TRANSFE,0.0,2000000.0,,2018,7,2,CHECK_CASHING,2000000.0,M1766420673
33308,409000362497',2018-07-02,FDRL/INTERNAL FUND TRANSFE,0.0,500000.0,,2018,7,2,CHECK_CASHING,500000.0,M89065837
33309,409000362497',2018-07-02,FDRL/INTERNAL FUND TRANSFE,0.0,500000.0,,2018,7,2,CASH_IN,500000.0,C1945802665
33310,409000362497',2018-07-02,IMPS 0207184C,4535698.2,0.0,,2018,7,2,CHECK_WITHDRAWAL,4535698.2,M947945281
33311,409000362497',2018-07-02,Sweep Trf To: 40900036427,252950.0,0.0,,2018,7,2,CASH_OUT,252950.0,M210240344
33312,409000362497',2018-07-03,IMPS 0207181C,3952951.11,0.0,,2018,7,3,PAYEMENT,3952951.11,M825161662
33313,409000362497',2018-07-03,IMPS 0307182C,2423959.56,0.0,,2018,7,3,CHECK_WITHDRAWAL,2423959.56,M1894695230
33314,409000362497',2018-07-03,IMPS 0307183C,6638117.79,0.0,,2018,7,3,CASH_OUT,6638117.79,M1140799785
33315,409000362497',2018-07-03,INDIAIDEAS.COM LTD,65292.0,0.0,,2018,7,3,CASH_OUT,65292.0,M2100297228
33316,409000362497',2018-07-03,IRCTC CORPORATE OFFICE AC,149370.0,0.0,,2018,7,3,PAYEMENT,149370.0,M389051766
33317,409000362497',2018-07-03,PAYU PAYMENTS PRIVATE LIM,57781.0,0.0,,2018,7,3,CHECK_WITHDRAWAL,57781.0,M521287606
33318,409000362497',2018-07-03,AVENUES INDIA PRIVATE LIM,21745.0,0.0,,2018,7,3,CASH_OUT,21745.0,M1196527482
33319,409000362497',2018-07-03,FUTURE RETAIL LIMITED (OW,3728.0,0.0,,2018,7,3,DEBIT,3728.0,M796218635
33320,409000362497',2018-07-03,PASFAR TECHNOLOGIES PRIVA,10884.0,0.0,,2018,7,3,CHECK_WITHDRAWAL,10884.0,C978470049
33321,409000362497',2018-07-03,MEHAR ENTERTAINMENT PRIVA,8180.0,0.0,,2018,7,3,PAYEMENT,8180.0,M1135378860
33322,409000362497',2018-07-03,SYNERGISTIC FINANCIAL NET,1660.0,0.0,,2018,7,3,PAYEMENT,1660.0,M1425092341
33323,409000362497',2018-07-03,ZAAK EPAYMENT SERVICES PR,120.0,0.0,,2018,7,3,DEBIT,120.0,C110721357
33324,409000362497',2018-07-03,DISH INFRA SERVICES PRIVA,815.0,0.0,,2018,7,3,CASH_OUT,815.0,M1160698415
33325,409000362497',2018-07-03,JUST DIAL LIMITED,1284.0,0.0,,2018,7,3,PAYEMENT,1284.0,M715058670
33326,409000362497',2018-07-03,DIGIVIVE SERVICES PRIVATE,48.0,0.0,,2018,7,3,DEBIT,48.0,M1043251934
33327,409000362497',2018-07-03,MUZAFFARPUR VIDYUT VITARA,834.0,0.0,,2018,7,3,CASH_OUT,834.0,M1440104580
33328,409000362497',2018-07-03,ALT DIGITAL MEDIA ENTERTA,99.0,0.0,,2018,7,3,PAYEMENT,99.0,M69876432
33329,409000362497',2018-07-03,VOUCHER ACTIVATION SERVIC,15487.0,0.0,,2018,7,3,PAYEMENT,15487.0,C1246297699
33330,409000362497',2018-07-03,QWIKCILVER SOLUTIONS PRIV,1423.0,0.0,,2018,7,3,DEBIT,1423.0,C2062945117
33331,409000362497',2018-07-03,Indiaforensic SERVICES INDIA PVT,576254.0,0.0,,2018,7,3,CASH_OUT,576254.0,C1971344738
33332,409000362497',2018-07-03,NEFT/SBIN318184039995/Indfor,0.0,3600000.0,,2018,7,3,CHECK_CASHING,3600000.0,M434836665
33333,409000362497',2018-07-03,FDRL/INTERNAL FUND TRANSFE,0.0,3000000.0,,2018,7,3,TRANSFER,3000000.0,C1778300121
33334,409000362497',2018-07-03,FDRL/INTERNAL FUND TRANSFE,0.0,3000000.0,,2018,7,3,TRANSFER,3000000.0,M669469024
33335,409000362497',2018-07-03,FDRL/INTERNAL FUND TRANSFE,0.0,3000000.0,,2018,7,3,CHECK_CASHING,3000000.0,M2007040024
33336,409000362497',2018-07-03,FDRL/INTERNAL FUND TRANSFE,0.0,3000000.0,,2018,7,3,CHECK_CASHING,3000000.0,M89928497
33337,409000362497',2018-07-03,IMPS 030720184C,3728844.09,0.0,,2018,7,3,CASH_OUT,3728844.09,C1474346966
33338,409000362497',2018-07-03,Sweep Trf To: 40900036427,270000.0,0.0,,2018,7,3,CASH_OUT,270000.0,M747009327
33339,409000362497',2018-07-04,IMPS 0307181C,3002422.76,0.0,,2018,7,4,CHECK_WITHDRAWAL,3002422.76,M883647558
33340,409000362497',2018-07-04,IMPS 0407182C,2753781.41,0.0,,2018,7,4,DEBIT,2753781.41,C878506901
33341,409000362497',2018-07-04,INDIAIDEAS.COM LTD,67439.0,0.0,,2018,7,4,PAYEMENT,67439.0,C1757877803
33342,409000362497',2018-07-04,IRCTC CORPORATE OFFICE AC,74160.0,0.0,,2018,7,4,DEBIT,74160.0,C1247658278
33343,409000362497',2018-07-04,PAYU PAYMENTS PRIVATE LIM,25870.0,0.0,,2018,7,4,CASH_OUT,25870.0,C1651945012
33344,409000362497',2018-07-04,AVENUES INDIA PRIVATE LIM,1664.0,0.0,,2018,7,4,CASH_OUT,1664.0,C721267591
33345,409000362497',2018-07-04,PASFAR TECHNOLOGIES PRIVA,4542.0,0.0,,2018,7,4,DEBIT,4542.0,C845900933
33346,409000362497',2018-07-04,MEHAR ENTERTAINMENT PRIVA,3226.0,0.0,,2018,7,4,DEBIT,3226.0,C615345603
33347,409000362497',2018-07-04,SYNERGISTIC FINANCIAL NET,1171.0,0.0,,2018,7,4,DEBIT,1171.0,C1517552713
33348,409000362497',2018-07-04,ZAAK EPAYMENT SERVICES PR,121.0,0.0,,2018,7,4,PAYEMENT,121.0,C865922491
33349,409000362497',2018-07-04,JUST DIAL LIMITED,140.0,0.0,,2018,7,4,CHECK_WITHDRAWAL,140.0,C539486713
33350,409000362497',2018-07-04,Indiaforensic SERVICES INDIA PVT,95164.0,0.0,,2018,7,4,PAYEMENT,95164.0,C1373172466
33351,409000362497',2018-07-04,IMPS 0407183C,5817750.66,0.0,,2018,7,4,CASH_OUT,5817750.66,C778559237
33352,409000362497',2018-07-04,FDRL/INTERNAL FUND TRANSFE,0.0,500000.0,,2018,7,4,CASH_IN,500000.0,C1421211318
33353,409000362497',2018-07-04,FDRL/INTERNAL FUND TRANSFE,0.0,5000000.0,,2018,7,4,TRANSFER,5000000.0,C1508275623
33354,409000362497',2018-07-04,FDRL/INTERNAL FUND TRANSFE,0.0,5000000.0,,2018,7,4,TRANSFER,5000000.0,C1030465164
33355,409000362497',2018-07-04,FDRL/INTERNAL FUND TRANSFE,0.0,5000000.0,,2018,7,4,CHECK_CASHING,5000000.0,C1630293008
33356,409000362497',2018-07-04,IMPS 040720184C,3436384.01,0.0,,2018,7,4,CHECK_WITHDRAWAL,3436384.01,C424954008
33357,409000362497',2018-07-04,Sweep Trf To: 40900036427,192911.0,0.0,,2018,7,4,PAYEMENT,192911.0,C1761291320
33358,409000362497',2018-07-05,TDS operative a/c dr for,1114.0,0.0,,2018,7,5,DEBIT,1114.0,C1568059495
33359,409000362497',2018-07-05,IMPS 0407181C,3038796.92,0.0,,2018,7,5,CASH_OUT,3038796.92,C252626745
33360,409000362497',2018-07-05,IMPS 0507182C,2667515.48,0.0,,2018,7,5,CHECK_WITHDRAWAL,2667515.48,C2106643654
33361,409000362497',2018-07-05,IMPS 0507183C,6504685.34,0.0,,2018,7,5,CASH_OUT,6504685.34,C699026377
33362,409000362497',2018-07-05,INDIAIDEAS.COM LTD,27575.0,0.0,,2018,7,5,DEBIT,27575.0,C2119123648
33363,409000362497',2018-07-05,IRCTC CORPORATE OFFICE AC,55785.0,0.0,,2018,7,5,CHECK_WITHDRAWAL,55785.0,C2067546399
33364,409000362497',2018-07-05,PAYU PAYMENTS PRIVATE LIM,5667.0,0.0,,2018,7,5,CASH_OUT,5667.0,C1080993648
33365,409000362497',2018-07-05,AVENUES INDIA PRIVATE LIM,1415.0,0.0,,2018,7,5,CHECK_WITHDRAWAL,1415.0,C1833467691
33366,409000362497',2018-07-05,FUTURE RETAIL LIMITED (OW,30.0,0.0,,2018,7,5,PAYEMENT,30.0,C10249994
33367,409000362497',2018-07-05,PASFAR TECHNOLOGIES PRIVA,3892.0,0.0,,2018,7,5,CASH_OUT,3892.0,C785525865
33368,409000362497',2018-07-05,MEHAR ENTERTAINMENT PRIVA,2765.0,0.0,,2018,7,5,DEBIT,2765.0,C1861188339
33369,409000362497',2018-07-05,Indiaforensic SERVICES INDIA PVT,162715.0,0.0,,2018,7,5,CHECK_WITHDRAWAL,162715.0,C1411451832
33370,409000362497',2018-07-05,FDRL/INTERNAL FUND TRANSFE,0.0,6000000.0,,2018,7,5,TRANSFER,6000000.0,C393450381
33371,409000362497',2018-07-05,FDRL/INTERNAL FUND TRANSFE,0.0,6000000.0,,2018,7,5,CHECK_CASHING,6000000.0,C7881234
33372,409000362497',2018-07-05,FDRL/INTERNAL FUND TRANSFE,0.0,2000000.0,,2018,7,5,CASH_IN,2000000.0,C305259590
33373,409000362497',2018-07-05,FDRL/INTERNAL FUND TRANSFE,0.0,500000.0,,2018,7,5,TRANSFER,500000.0,C79685693
33374,409000362497',2018-07-05,IMPS 818620886077 FROM OX,0.0,200000.0,,2018,7,5,CASH_IN,200000.0,C1623014027
33375,409000362497',2018-07-05,IMPS 818620886118 FROM OX,0.0,200000.0,,2018,7,5,TRANSFER,200000.0,C510508465
33376,409000362497',2018-07-05,IMPS 818620886177 FROM OX,0.0,200000.0,,2018,7,5,CHECK_CASHING,200000.0,C2135727675
33377,409000362497',2018-07-05,IMPS 818620886223 FROM OX,0.0,200000.0,,2018,7,5,CASH_IN,200000.0,C1567038734
33378,409000362497',2018-07-05,IMPS 818620886260 FROM OX,0.0,200000.0,,2018,7,5,CASH_IN,200000.0,C358820318
33379,409000362497',2018-07-05,IMPS 0507184C,2884630.75,0.0,,2018,7,5,CASH_OUT,2884630.75,C1623014027
33380,409000362497',2018-07-05,Sweep Trf To: 40900036427,174830.0,0.0,,2018,7,5,PAYEMENT,174830.0,C786946845
33381,409000362497',2018-07-06,RF For 709003957853,0.0,295430.0,,2018,7,6,CASH_IN,295430.0,C1656107232
33382,409000362497',2018-07-06,IMPS 0507181C,2723463.8,0.0,,2018,7,6,PAYEMENT,2723463.8,C1796712971
33383,409000362497',2018-07-06,IMPS 0607182C,2670787.92,0.0,,2018,7,6,DEBIT,2670787.92,C643658493
33384,409000362497',2018-07-06,IMPS 0607183C,5677400.15,0.0,,2018,7,6,DEBIT,5677400.15,C711496491
33385,409000362497',2018-07-06,FDRL/INTERNAL FUND TRANSFE,0.0,15000000.0,,2018,7,6,CHECK_CASHING,15000000.0,C75629578
33386,409000362497',2018-07-06,IMPS 0607184C,3194495.69,0.0,,2018,7,6,CASH_OUT,3194495.69,C1554690148
33387,409000362497',2018-07-06,Sweep Trf To: 40900036427,239218.0,0.0,,2018,7,6,CHECK_WITHDRAWAL,239218.0,C1246134024
33388,409000362497',2018-07-07,IMPS 0607181C,3405408.34,0.0,,2018,7,7,CHECK_WITHDRAWAL,3405408.34,C1081599606
33389,409000362497',2018-07-07,IMPS 0707182C,2633022.89,0.0,,2018,7,7,CHECK_WITHDRAWAL,2633022.89,C2051868384
33390,409000362497',2018-07-07,IMPS 0707183C,5403630.1,0.0,,2018,7,7,PAYEMENT,5403630.1,C1728766751
33391,409000362497',2018-07-07,RTGS/SBINH18188056993/Indfor,0.0,5700000.0,,2018,7,7,CHECK_CASHING,5700000.0,C980380973
33392,409000362497',2018-07-07,NEFT/SBIN618188879517/Indfor,0.0,2700000.0,,2018,7,7,CASH_IN,2700000.0,C1999812935
33393,409000362497',2018-07-07,FDRL/INTERNAL FUND TRANSFE,0.0,4000000.0,,2018,7,7,TRANSFER,4000000.0,C2046611860
33394,409000362497',2018-07-07,FDRL/INTERNAL FUND TRANSFE,0.0,4000000.0,,2018,7,7,CASH_IN,4000000.0,C1192937442
33395,409000362497',2018-07-07,IMPS 0707184C,3672383.14,0.0,,2018,7,7,DEBIT,3672383.14,C1290601415
33396,409000362497',2018-07-07,Sweep Trf To: 40900036427,190260.0,0.0,,2018,7,7,CHECK_WITHDRAWAL,190260.0,C99219259
33397,409000362497',2018-07-08,IMPS 818914662831 FROM OX,0.0,200000.0,,2018,7,8,TRANSFER,200000.0,C388286025
33398,409000362497',2018-07-08,IMPS 818914662858 FROM OX,0.0,200000.0,,2018,7,8,CHECK_CASHING,200000.0,C1523536343
33399,409000362497',2018-07-08,IMPS 818914662881 FROM OX,0.0,200000.0,,2018,7,8,TRANSFER,200000.0,C1850180796
33400,409000362497',2018-07-08,IMPS 818914662902 FROM OX,0.0,200000.0,,2018,7,8,CHECK_CASHING,200000.0,C257761496
33401,409000362497',2018-07-08,IMPS 818914662921 FROM OX,0.0,200000.0,,2018,7,8,CHECK_CASHING,200000.0,C1564510445
33402,409000362497',2018-07-08,IMPS 818914662933 FROM OX,0.0,200000.0,,2018,7,8,CASH_IN,200000.0,C471811727
33403,409000362497',2018-07-09,IMPS 0707181C,1860830.27,0.0,,2018,7,9,DEBIT,1860830.27,C1019670582
33404,409000362497',2018-07-09,IMPS 0807181C,3640127.37,0.0,,2018,7,9,PAYEMENT,3640127.37,M35750592
33405,409000362497',2018-07-09,IMPS 0907182C,5087653.6,0.0,,2018,7,9,CHECK_WITHDRAWAL,5087653.6,M1849376456
33406,409000362497',2018-07-09,IRCTC CORPORATE OFFICE AC,36795.0,0.0,,2018,7,9,DEBIT,36795.0,C1096984287
33407,409000362497',2018-07-09,IRCTC CORPORATE OFFICE AC,37925.0,0.0,,2018,7,9,DEBIT,37925.0,M1359912484
33408,409000362497',2018-07-09,PAYU PAYMENTS PRIVATE LIM,17356.0,0.0,,2018,7,9,PAYEMENT,17356.0,C787033725
33409,409000362497',2018-07-09,AVENUES INDIA PRIVATE LIM,736.0,0.0,,2018,7,9,DEBIT,736.0,M634113842
33410,409000362497',2018-07-09,FUTURE RETAIL LIMITED (OW,1999.0,0.0,,2018,7,9,DEBIT,1999.0,M1201667103
33411,409000362497',2018-07-09,PASFAR TECHNOLOGIES PRIVA,5062.0,0.0,,2018,7,9,DEBIT,5062.0,C54142591
33412,409000362497',2018-07-09,MEHAR ENTERTAINMENT PRIVA,2996.0,0.0,,2018,7,9,CHECK_WITHDRAWAL,2996.0,C569022831
33413,409000362497',2018-07-09,Indiaforensic SERVICES INDIA PVT,162512.0,0.0,,2018,7,9,CASH_OUT,162512.0,M1370307975
33414,409000362497',2018-07-09,IMPS 0907183C,8406117.02,0.0,,2018,7,9,CASH_OUT,8406117.02,C870064925
33415,409000362497',2018-07-09,INDIAIDEAS.COM LTD,71518.0,0.0,,2018,7,9,DEBIT,71518.0,C1623014027
33416,409000362497',2018-07-09,IRCTC CORPORATE OFFICE AC,159840.0,0.0,,2018,7,9,DEBIT,159840.0,M1724929522
33417,409000362497',2018-07-09,PAYU PAYMENTS PRIVATE LIM,89886.0,0.0,,2018,7,9,CASH_OUT,89886.0,M1789356626
33418,409000362497',2018-07-09,AVENUES INDIA PRIVATE LIM,5916.0,0.0,,2018,7,9,PAYEMENT,5916.0,C1304037800
33419,409000362497',2018-07-09,SYNERGISTIC FINANCIAL NET,537.0,0.0,,2018,7,9,CASH_OUT,537.0,M1164367059
33420,409000362497',2018-07-09,ZAAK EPAYMENT SERVICES PR,763.0,0.0,,2018,7,9,DEBIT,763.0,M97706367
33421,409000362497',2018-07-09,PAYGATE INDIA PRIVATE LIM,518.0,0.0,,2018,7,9,CHECK_WITHDRAWAL,518.0,C79708552
33422,409000362497',2018-07-09,FUTURE RETAIL LIMITED (OW,5581.0,0.0,,2018,7,9,CHECK_WITHDRAWAL,5581.0,C961341325
33423,409000362497',2018-07-09,PASFAR TECHNOLOGIES PRIVA,6863.0,0.0,,2018,7,9,CHECK_WITHDRAWAL,6863.0,C686592713
33424,409000362497',2018-07-09,MEHAR ENTERTAINMENT PRIVA,7604.0,0.0,,2018,7,9,DEBIT,7604.0,C538433035
33425,409000362497',2018-07-09,METRO INFRASYS PRIVATE LI,1395.0,0.0,,2018,7,9,DEBIT,1395.0,C1062254208
33426,409000362497',2018-07-09,JUST DIAL LIMITED,1910.0,0.0,,2018,7,9,CHECK_WITHDRAWAL,1910.0,C315447378
33427,409000362497',2018-07-09,Indiaforensic SERVICES INDIA PVT,435624.0,0.0,,2018,7,9,PAYEMENT,435624.0,C697172013
33428,409000362497',2018-07-09,NEFT/SBIN718190943863/Indfor,0.0,4300000.0,,2018,7,9,CASH_IN,4300000.0,C1340123681
33429,409000362497',2018-07-09,FDRL/INTERNAL FUND TRANSFE,0.0,15000000.0,,2018,7,9,CHECK_CASHING,15000000.0,C1313534832
33430,409000362497',2018-07-09,FDRL/INTERNAL FUND TRANSFE,0.0,5000000.0,,2018,7,9,CASH_IN,5000000.0,C124540047
33431,409000362497',2018-07-09,IMPS 0907184C,4651323.2,0.0,,2018,7,9,CHECK_WITHDRAWAL,4651323.2,C977990184
33432,409000362497',2018-07-09,Sweep Trf To: 40900036427,319515.0,0.0,,2018,7,9,PAYEMENT,319515.0,C620532131
33433,409000362497',2018-07-10,IMPS 0907181C,4708946.53,0.0,,2018,7,10,CASH_OUT,4708946.53,C1346065207
33434,409000362497',2018-07-10,IMPS 1007182C,1976893.96,0.0,,2018,7,10,PAYEMENT,1976893.96,C1359291582
33435,409000362497',2018-07-10,IMPS 1007183C,3347692.63,0.0,,2018,7,10,CHECK_WITHDRAWAL,3347692.63,C741431520
33436,409000362497',2018-07-10,FDRL/INTERNAL FUND TRANSFE,0.0,500000.0,,2018,7,10,CHECK_CASHING,500000.0,C1697258007
33437,409000362497',2018-07-10,FDRL/INTERNAL FUND TRANSFE,0.0,500000.0,,2018,7,10,CHECK_CASHING,500000.0,C1986006160
33438,409000362497',2018-07-10,NEFT/AXIC181915487589/Indfor,0.0,5000000.0,,2018,7,10,CASH_IN,5000000.0,C2041281014
33439,409000362497',2018-07-10,IMPS 1007184C,4823234.48,0.0,,2018,7,10,CHECK_WITHDRAWAL,4823234.48,C1149788645
33440,409000362497',2018-07-10,Sweep Trf To: 40900036427,255090.0,0.0,,2018,7,10,PAYEMENT,255090.0,C1241261398
33441,409000362497',2018-07-11,IMPS 100720181C,4747246.86,0.0,,2018,7,11,CASH_OUT,4747246.86,C1267575834
33442,409000362497',2018-07-11,IMPS 110720182C,2994899.66,0.0,,2018,7,11,DEBIT,2994899.66,C1376144743
33443,409000362497',2018-07-11,IRCTC CORPORATE OFFICE AC,35880.0,0.0,,2018,7,11,CASH_OUT,35880.0,M1204098465
33444,409000362497',2018-07-11,PAYU PAYMENTS PRIVATE LIM,21479.0,0.0,,2018,7,11,PAYEMENT,21479.0,M113123602
33445,409000362497',2018-07-11,AVENUES INDIA PRIVATE LIM,2834.0,0.0,,2018,7,11,CHECK_WITHDRAWAL,2834.0,M978908457
33446,409000362497',2018-07-11,SYNERGISTIC FINANCIAL NET,264.0,0.0,,2018,7,11,DEBIT,264.0,M1528539947
33447,409000362497',2018-07-11,FUTURE RETAIL LIMITED (OW,1080.0,0.0,,2018,7,11,DEBIT,1080.0,C1495761010
33448,409000362497',2018-07-11,PASFAR TECHNOLOGIES PRIVA,620.0,0.0,,2018,7,11,DEBIT,620.0,M1994073115
33449,409000362497',2018-07-11,MEHAR ENTERTAINMENT PRIVA,2304.0,0.0,,2018,7,11,CHECK_WITHDRAWAL,2304.0,M1679240611
33450,409000362497',2018-07-11,JUST DIAL LIMITED,44.0,0.0,,2018,7,11,CHECK_WITHDRAWAL,44.0,C1346667529
33451,409000362497',2018-07-11,Indiaforensic SERVICES INDIA PVT,216217.0,0.0,,2018,7,11,PAYEMENT,216217.0,C741924904
33452,409000362497',2018-07-11,IMPS 1107183C,6030038.59,0.0,,2018,7,11,DEBIT,6030038.59,M295833928
33453,409000362497',2018-07-11,FDRL/INTERNAL FUND TRANSFE,0.0,4000000.0,,2018,7,11,CASH_IN,4000000.0,M506013899
33454,409000362497',2018-07-11,FDRL/INTERNAL FUND TRANSFE,0.0,500000.0,,2018,7,11,CASH_IN,500000.0,M2035893744
33455,409000362497',2018-07-11,FDRL/INTERNAL FUND TRANSFE,0.0,5000000.0,,2018,7,11,CASH_IN,5000000.0,M1789782727
33456,409000362497',2018-07-11,TRF FROM  Indiaforensic SERVICES,0.0,600000.0,,2018,7,11,CHECK_CASHING,600000.0,M545170108
33457,409000362497',2018-07-11,TRF FROM  Indiaforensic SERVICES,0.0,6800000.0,,2018,7,11,CASH_IN,6800000.0,M923867319
33458,409000362497',2018-07-11,IMPS 819220613864 FROM OX,0.0,200000.0,,2018,7,11,CHECK_CASHING,200000.0,M692088761
33459,409000362497',2018-07-11,IMPS 819220613896 FROM OX,0.0,200000.0,,2018,7,11,CASH_IN,200000.0,C1687191050
33460,409000362497',2018-07-11,IMPS 819220613921 FROM OX,0.0,200000.0,,2018,7,11,CASH_IN,200000.0,C1920297459
33461,409000362497',2018-07-11,IMPS 819220613990 FROM OX,0.0,200000.0,,2018,7,11,TRANSFER,200000.0,C382961988
33462,409000362497',2018-07-11,IMPS 819220614030 FROM OX,0.0,200000.0,,2018,7,11,CHECK_CASHING,200000.0,C2109236648
33463,409000362497',2018-07-11,IMPS 1107184C,4283054.45,0.0,,2018,7,11,CASH_OUT,4283054.45,M500439448
33464,409000362497',2018-07-11,Sweep Trf To: 40900036427,267954.0,0.0,,2018,7,11,CASH_OUT,267954.0,C910119139
33465,409000362497',2018-07-12,IRCTC CORPORATE OFFICE AC,38630.0,0.0,,2018,7,12,DEBIT,38630.0,M1586333134
33466,409000362497',2018-07-12,PAYU PAYMENTS PRIVATE LIM,29273.0,0.0,,2018,7,12,CASH_OUT,29273.0,M1546240595
33467,409000362497',2018-07-12,AVENUES INDIA PRIVATE LIM,2105.0,0.0,,2018,7,12,CASH_OUT,2105.0,M1457001192
33468,409000362497',2018-07-12,SYNERGISTIC FINANCIAL NET,979.0,0.0,,2018,7,12,DEBIT,979.0,C2095865954
33469,409000362497',2018-07-12,ZAAK EPAYMENT SERVICES PR,541.0,0.0,,2018,7,12,CHECK_WITHDRAWAL,541.0,C1062650008
33470,409000362497',2018-07-12,FUTURE RETAIL LIMITED (OW,427.0,0.0,,2018,7,12,CASH_OUT,427.0,M1568575874
33471,409000362497',2018-07-12,PASFAR TECHNOLOGIES PRIVA,348.0,0.0,,2018,7,12,CASH_OUT,348.0,C1520928508
33472,409000362497',2018-07-12,JUST DIAL LIMITED,225.0,0.0,,2018,7,12,DEBIT,225.0,C1748042844
33473,409000362497',2018-07-12,MEHAR ENTERTAINMENT PRIVA,2189.0,0.0,,2018,7,12,CASH_OUT,2189.0,C2048578791
33474,409000362497',2018-07-12,VOUCHER ACTIVATION SERVIC,10208.0,0.0,,2018,7,12,CASH_OUT,10208.0,C1776599395
33475,409000362497',2018-07-12,Indiaforensic SERVICES INDIA PVT,185143.0,0.0,,2018,7,12,DEBIT,185143.0,C2094462801
33476,409000362497',2018-07-12,IMPS 1107181C,3991899.17,0.0,,2018,7,12,CASH_OUT,3991899.17,M880936062
33477,409000362497',2018-07-12,IMPS 1207182C,2496839.22,0.0,,2018,7,12,CASH_OUT,2496839.22,M863966203
33478,409000362497',2018-07-12,IMPS 1207183C,5805356.1,0.0,,2018,7,12,PAYEMENT,5805356.1,C188633062
33479,409000362497',2018-07-12,NEFT/SBIN118193917608/Indfor,0.0,1500000.0,,2018,7,12,CASH_IN,1500000.0,M2006613224
33480,409000362497',2018-07-12,FDRL/INTERNAL FUND TRANSFE,0.0,4000000.0,,2018,7,12,CASH_IN,4000000.0,M720863134
33481,409000362497',2018-07-12,FDRL/INTERNAL FUND TRANSFE,0.0,5000000.0,,2018,7,12,TRANSFER,5000000.0,C1653859230
33482,409000362497',2018-07-12,FDRL/INTERNAL FUND TRANSFE,0.0,5000000.0,,2018,7,12,CASH_IN,5000000.0,C1383831706
33483,409000362497',2018-07-12,FDRL/INTERNAL FUND TRANSFE,0.0,500000.0,,2018,7,12,CHECK_CASHING,500000.0,C1554565380
33484,409000362497',2018-07-12,FDRL/INTERNAL FUND TRANSFE,0.0,500000.0,,2018,7,12,CHECK_CASHING,500000.0,C1243712710
33485,409000362497',2018-07-12,IMPS 1207184C,3672900.04,0.0,,2018,7,12,PAYEMENT,3672900.04,C1095587424
33486,409000362497',2018-07-12,Sweep Trf To: 40900036427,180896.0,0.0,,2018,7,12,PAYEMENT,180896.0,C2027640578
33487,409000362497',2018-07-13,IMPS 1207181C,3865249.0,0.0,,2018,7,13,CHECK_WITHDRAWAL,3865249.0,C1075238398
33488,409000362497',2018-07-13,IMPS 1307182C,1746433.48,0.0,,2018,7,13,CASH_OUT,1746433.48,C796028148
33489,409000362497',2018-07-13,INDIAIDEAS.COM LTD,42256.0,0.0,,2018,7,13,DEBIT,42256.0,M2127106583
33490,409000362497',2018-07-13,IRCTC CORPORATE OFFICE AC,42485.0,0.0,,2018,7,13,DEBIT,42485.0,C742410803
33491,409000362497',2018-07-13,PAYU PAYMENTS PRIVATE LIM,35938.0,0.0,,2018,7,13,CHECK_WITHDRAWAL,35938.0,M1248887101
33492,409000362497',2018-07-13,AVENUES INDIA PRIVATE LIM,5421.0,0.0,,2018,7,13,DEBIT,5421.0,M1746588607
33493,409000362497',2018-07-13,METRO INFRASYS PRIVATE LI,697.0,0.0,,2018,7,13,CHECK_WITHDRAWAL,697.0,M493217472
33494,409000362497',2018-07-13,PASFAR TECHNOLOGIES PRIVA,11802.0,0.0,,2018,7,13,DEBIT,11802.0,M605687913
33495,409000362497',2018-07-13,JUST DIAL LIMITED,900.0,0.0,,2018,7,13,CASH_OUT,900.0,M1384809507
33496,409000362497',2018-07-13,MEHAR ENTERTAINMENT PRIVA,2304.0,0.0,,2018,7,13,CASH_OUT,2304.0,C22805895
33497,409000362497',2018-07-13,ALT DIGITAL MEDIA ENTERTA,176.0,0.0,,2018,7,13,CHECK_WITHDRAWAL,176.0,M411338341
33498,409000362497',2018-07-13,Indiaforensic SERVICES INDIA PVT,175287.0,0.0,,2018,7,13,PAYEMENT,175287.0,M1443825780
33499,409000362497',2018-07-13,Indiaforensic SERVICES INDIA PVT,209650.0,0.0,,2018,7,13,CASH_OUT,209650.0,C649265468
33500,409000362497',2018-07-13,INDIAIDEAS.COM LTD,146929.0,0.0,,2018,7,13,PAYEMENT,146929.0,M1810225700
33501,409000362497',2018-07-13,IRCTC CORPORATE OFFICE AC,60990.0,0.0,,2018,7,13,PAYEMENT,60990.0,M1432341083
33502,409000362497',2018-07-13,PAYU PAYMENTS PRIVATE LIM,34599.0,0.0,,2018,7,13,PAYEMENT,34599.0,C132379888
33503,409000362497',2018-07-13,AVENUES INDIA PRIVATE LIM,18629.0,0.0,,2018,7,13,CASH_OUT,18629.0,C111720670
33504,409000362497',2018-07-13,FUTURE RETAIL LIMITED (OW,3563.0,0.0,,2018,7,13,PAYEMENT,3563.0,C1717547480
33505,409000362497',2018-07-13,PASFAR TECHNOLOGIES PRIVA,969.0,0.0,,2018,7,13,CHECK_WITHDRAWAL,969.0,M51167811
33506,409000362497',2018-07-13,JUST DIAL LIMITED,1928.0,0.0,,2018,7,13,DEBIT,1928.0,M1133213404
33507,409000362497',2018-07-13,MEHAR ENTERTAINMENT PRIVA,2650.0,0.0,,2018,7,13,DEBIT,2650.0,M115029622
33508,409000362497',2018-07-13,IMPS 1307183C,5857553.8,0.0,,2018,7,13,PAYEMENT,5857553.8,M416092557
33509,409000362497',2018-07-13,TRF FROM  Indiaforensic SERVICES,0.0,4900000.0,,2018,7,13,CHECK_CASHING,4900000.0,M592085318
33510,409000362497',2018-07-13,FDRL/INTERNAL FUND TRANSFE,0.0,4000000.0,,2018,7,13,CHECK_CASHING,4000000.0,M369157421
33511,409000362497',2018-07-13,FDRL/INTERNAL FUND TRANSFE,0.0,4000000.0,,2018,7,13,CASH_IN,4000000.0,M1985761830
33512,409000362497',2018-07-13,FDRL/INTERNAL FUND TRANSFE,0.0,500000.0,,2018,7,13,CHECK_CASHING,500000.0,M255163194
33513,409000362497',2018-07-13,IMPS 819419145987 FROM OX,0.0,200000.0,,2018,7,13,TRANSFER,200000.0,M1204054100
33514,409000362497',2018-07-13,IMPS 819419146066 FROM OX,0.0,200000.0,,2018,7,13,TRANSFER,200000.0,M320064009
33515,409000362497',2018-07-13,IMPS 819419146102 FROM OX,0.0,200000.0,,2018,7,13,CASH_IN,200000.0,M1245360138
33516,409000362497',2018-07-13,IMPS 819419146130 FROM OX,0.0,200000.0,,2018,7,13,CASH_IN,200000.0,M748650268
33517,409000362497',2018-07-13,IMPS 819419146170 FROM OX,0.0,200000.0,,2018,7,13,CHECK_CASHING,200000.0,M1523656965
33518,409000362497',2018-07-13,IMPS 819419146194 FROM OX,0.0,200000.0,,2018,7,13,TRANSFER,200000.0,M566825708
33519,409000362497',2018-07-13,IMPS 1307184C,4073987.44,0.0,,2018,7,13,CHECK_WITHDRAWAL,4073987.44,M340511491
33520,409000362497',2018-07-13,Sweep Trf To: 40900036427,382617.0,0.0,,2018,7,13,PAYEMENT,382617.0,M1142507621
33521,409000362497',2018-07-16,ACH DR NATIONAL PAYMENT C,10000.0,0.0,,2018,7,16,CHECK_WITHDRAWAL,10000.0,M1129528323
33522,409000362497',2018-07-16,ACH DR NATIONAL PAYMENT C,789.63,0.0,,2018,7,16,CHECK_WITHDRAWAL,789.63,M326973462
33523,409000362497',2018-07-16,IMPS 1307181C,3108118.56,0.0,,2018,7,16,DEBIT,3108118.56,M389000297
33524,409000362497',2018-07-16,IMPS 1407181C,8893982.69,0.0,,2018,7,16,PAYEMENT,8893982.69,M941164126
33525,409000362497',2018-07-16,IMPS 1507181C,3332678.36,0.0,,2018,7,16,CHECK_WITHDRAWAL,3332678.36,C260838211
33526,409000362497',2018-07-16,IMPS 1607182C,1955665.8,0.0,,2018,7,16,CASH_OUT,1955665.8,M497255960
33527,409000362497',2018-07-16,IMPS 1607183C,5481019.7,0.0,,2018,7,16,DEBIT,5481019.7,C873852158
33528,409000362497',2018-07-16,IMPS 1607184C,5028871.65,0.0,,2018,7,16,CASH_OUT,5028871.65,C1635134358
33529,409000362497',2018-07-16,IMPS 819721822729 FROM OX,0.0,200000.0,,2018,7,16,CHECK_CASHING,200000.0,M856901921
33530,409000362497',2018-07-16,IMPS 819721822778 FROM OX,0.0,200000.0,,2018,7,16,CASH_IN,200000.0,M1220267421
33531,409000362497',2018-07-16,IMPS 819721822800 FROM OX,0.0,200000.0,,2018,7,16,CASH_IN,200000.0,M1596351485
33532,409000362497',2018-07-16,IMPS 819721822821 FROM OX,0.0,200000.0,,2018,7,16,CHECK_CASHING,200000.0,M1906449429
33533,409000362497',2018-07-16,IMPS 819721822854 FROM OX,0.0,200000.0,,2018,7,16,CASH_IN,200000.0,C337822079
33534,409000362497',2018-07-16,IMPS 819721822885 FROM OX,0.0,200000.0,,2018,7,16,CHECK_CASHING,200000.0,C344610846
33535,409000362497',2018-07-16,IMPS 819721822924 FROM OX,0.0,200000.0,,2018,7,16,TRANSFER,200000.0,C222882273
33536,409000362497',2018-07-16,IMPS 819721822949 FROM OX,0.0,200000.0,,2018,7,16,CASH_IN,200000.0,C948243200
33537,409000362497',2018-07-16,IMPS 819721822985 FROM OX,0.0,200000.0,,2018,7,16,TRANSFER,200000.0,M416060937
33538,409000362497',2018-07-16,IMPS 819721823005 FROM OX,0.0,200000.0,,2018,7,16,TRANSFER,200000.0,C2088652549
33539,409000362497',2018-07-16,IMPS 819721823238 FROM OX,0.0,200000.0,,2018,7,16,CHECK_CASHING,200000.0,C27489818
33540,409000362497',2018-07-16,IMPS 819721823257 FROM OX,0.0,200000.0,,2018,7,16,CHECK_CASHING,200000.0,M1891932207
33541,409000362497',2018-07-16,IMPS 819721823288 FROM OX,0.0,200000.0,,2018,7,16,CHECK_CASHING,200000.0,M741559174
33542,409000362497',2018-07-16,IMPS 819721823313 FROM OX,0.0,200000.0,,2018,7,16,CASH_IN,200000.0,M1431342900
33543,409000362497',2018-07-16,IMPS 819721823335 FROM OX,0.0,200000.0,,2018,7,16,CASH_IN,200000.0,M605209360
33544,409000362497',2018-07-16,IMPS 819721823365 FROM OX,0.0,200000.0,,2018,7,16,TRANSFER,200000.0,M2134352313
33545,409000362497',2018-07-16,IMPS 819721823393 FROM OX,0.0,200000.0,,2018,7,16,CASH_IN,200000.0,M19264046
33546,409000362497',2018-07-16,IMPS 819721823420 FROM OX,0.0,200000.0,,2018,7,16,CHECK_CASHING,200000.0,M273845662
33547,409000362497',2018-07-16,IMPS 819721823444 FROM OX,0.0,200000.0,,2018,7,16,TRANSFER,200000.0,M1625495588
33548,409000362497',2018-07-16,IMPS 819721823465 FROM OX,0.0,200000.0,,2018,7,16,TRANSFER,200000.0,M1624726865
33549,409000362497',2018-07-16,IMPS 819721823786 FROM OX,0.0,200000.0,,2018,7,16,TRANSFER,200000.0,M524880749
33550,409000362497',2018-07-16,IMPS 819721823810 FROM OX,0.0,200000.0,,2018,7,16,CASH_IN,200000.0,M1230926898
33551,409000362497',2018-07-16,IMPS 819721823835 FROM OX,0.0,200000.0,,2018,7,16,TRANSFER,200000.0,M1629184074
33552,409000362497',2018-07-16,IMPS 819721823866 FROM OX,0.0,200000.0,,2018,7,16,CASH_IN,200000.0,M72268217
33553,409000362497',2018-07-16,IMPS 819721823894 FROM OX,0.0,200000.0,,2018,7,16,CASH_IN,200000.0,M2018084215
33554,409000362497',2018-07-16,IMPS 819721823930 FROM OX,0.0,200000.0,,2018,7,16,TRANSFER,200000.0,M1795033276
33555,409000362497',2018-07-16,IMPS 819721823957 FROM OX,0.0,200000.0,,2018,7,16,CASH_IN,200000.0,M1240971641
33556,409000362497',2018-07-16,IMPS 819721823982 FROM OX,0.0,200000.0,,2018,7,16,CHECK_CASHING,200000.0,M795767038
33557,409000362497',2018-07-16,IMPS 819721824016 FROM OX,0.0,200000.0,,2018,7,16,CASH_IN,200000.0,M691605363
33558,409000362497',2018-07-16,IMPS 819721824044 FROM OX,0.0,200000.0,,2018,7,16,TRANSFER,200000.0,M967292326
33559,409000362497',2018-07-16,IMPS 819721824238 FROM OX,0.0,200000.0,,2018,7,16,CHECK_CASHING,200000.0,M267166859
33560,409000362497',2018-07-16,IMPS 819721824264 FROM OX,0.0,200000.0,,2018,7,16,TRANSFER,200000.0,M2013275310
33561,409000362497',2018-07-16,IMPS 819721824275 FROM OX,0.0,200000.0,,2018,7,16,TRANSFER,200000.0,M127792260
33562,409000362497',2018-07-16,IMPS 819721824298 FROM OX,0.0,200000.0,,2018,7,16,CASH_IN,200000.0,M2003234306
33563,409000362497',2018-07-16,IMPS 819721824327 FROM OX,0.0,200000.0,,2018,7,16,CHECK_CASHING,200000.0,M208742803
33564,409000362497',2018-07-16,IMPS 819721824350 FROM OX,0.0,200000.0,,2018,7,16,CHECK_CASHING,200000.0,C610507909
33565,409000362497',2018-07-16,IMPS 819721824380 FROM OX,0.0,200000.0,,2018,7,16,TRANSFER,200000.0,C1819706577
33566,409000362497',2018-07-16,IMPS 819721824405 FROM OX,0.0,200000.0,,2018,7,16,CHECK_CASHING,200000.0,M1896801713
33567,409000362497',2018-07-16,IMPS 819721824438 FROM OX,0.0,200000.0,,2018,7,16,CHECK_CASHING,200000.0,M113167024
33568,409000362497',2018-07-16,IMPS 819721824461 FROM OX,0.0,200000.0,,2018,7,16,CASH_IN,200000.0,C256516555
33569,409000362497',2018-07-16,IMPS 819721824666 FROM OX,0.0,200000.0,,2018,7,16,CHECK_CASHING,200000.0,C58091972
33570,409000362497',2018-07-16,IMPS 819721824693 FROM OX,0.0,200000.0,,2018,7,16,TRANSFER,200000.0,C512626802
33571,409000362497',2018-07-16,IMPS 819721824730 FROM OX,0.0,200000.0,,2018,7,16,CHECK_CASHING,200000.0,M1564220143
33572,409000362497',2018-07-16,IMPS 819721824760 FROM OX,0.0,200000.0,,2018,7,16,CHECK_CASHING,200000.0,M1536172876
33573,409000362497',2018-07-16,IMPS 819721824780 FROM OX,0.0,200000.0,,2018,7,16,TRANSFER,200000.0,M476730527
33574,409000362497',2018-07-16,IMPS 819721824817 FROM OX,0.0,200000.0,,2018,7,16,CHECK_CASHING,200000.0,M1646961084
33575,409000362497',2018-07-16,IMPS 819721824843 FROM OX,0.0,200000.0,,2018,7,16,CASH_IN,200000.0,M1805180861
33576,409000362497',2018-07-16,IMPS 819721824865 FROM OX,0.0,200000.0,,2018,7,16,TRANSFER,200000.0,M929344670
33577,409000362497',2018-07-16,IMPS 819721824884 FROM OX,0.0,200000.0,,2018,7,16,CHECK_CASHING,200000.0,M2048746110
33578,409000362497',2018-07-16,IMPS 819721824915 FROM OX,0.0,200000.0,,2018,7,16,CASH_IN,200000.0,M1317973795
33579,409000362497',2018-07-16,IMPS 819721825117 FROM OX,0.0,200000.0,,2018,7,16,TRANSFER,200000.0,M569041732
33580,409000362497',2018-07-16,IMPS 819721825139 FROM OX,0.0,200000.0,,2018,7,16,CHECK_CASHING,200000.0,M557974310
33581,409000362497',2018-07-16,IMPS 819721825164 FROM OX,0.0,200000.0,,2018,7,16,CASH_IN,200000.0,M1281872426
33582,409000362497',2018-07-16,IMPS 819721825188 FROM OX,0.0,200000.0,,2018,7,16,CASH_IN,200000.0,M359458440
33583,409000362497',2018-07-16,IMPS 819721825210 FROM OX,0.0,200000.0,,2018,7,16,TRANSFER,200000.0,M1376464003
33584,409000362497',2018-07-16,IMPS 819721825228 FROM OX,0.0,200000.0,,2018,7,16,TRANSFER,200000.0,M812115034
33585,409000362497',2018-07-16,IMPS 819721825255 FROM OX,0.0,200000.0,,2018,7,16,CASH_IN,200000.0,M1639437965
33586,409000362497',2018-07-16,IMPS 819721825290 FROM OX,0.0,200000.0,,2018,7,16,CHECK_CASHING,200000.0,M1141605626
33587,409000362497',2018-07-16,IMPS 819721825318 FROM OX,0.0,200000.0,,2018,7,16,CHECK_CASHING,200000.0,M1844541421
33588,409000362497',2018-07-16,IMPS 819721825358 FROM OX,0.0,200000.0,,2018,7,16,TRANSFER,200000.0,M824688063
33589,409000362497',2018-07-16,IMPS 819721825570 FROM OX,0.0,200000.0,,2018,7,16,CASH_IN,200000.0,M186300992
33590,409000362497',2018-07-16,IMPS 819721825603 FROM OX,0.0,200000.0,,2018,7,16,TRANSFER,200000.0,M821684661
33591,409000362497',2018-07-16,IMPS 819721825627 FROM OX,0.0,200000.0,,2018,7,16,TRANSFER,200000.0,M337100866
33592,409000362497',2018-07-16,IMPS 819721825650 FROM OX,0.0,200000.0,,2018,7,16,TRANSFER,200000.0,C56074101
33593,409000362497',2018-07-16,IMPS 819721825676 FROM OX,0.0,200000.0,,2018,7,16,TRANSFER,200000.0,M1798507943
33594,409000362497',2018-07-16,IMPS 819721825689 FROM OX,0.0,200000.0,,2018,7,16,CHECK_CASHING,200000.0,C976144053
33595,409000362497',2018-07-16,IMPS 819721825716 FROM OX,0.0,200000.0,,2018,7,16,TRANSFER,200000.0,M1629181633
33596,409000362497',2018-07-16,IMPS 819721825759 FROM OX,0.0,200000.0,,2018,7,16,TRANSFER,200000.0,M892819496
33597,409000362497',2018-07-16,IMPS 819721825791 FROM OX,0.0,200000.0,,2018,7,16,CASH_IN,200000.0,C304406966
33598,409000362497',2018-07-16,IMPS 819721825822 FROM OX,0.0,200000.0,,2018,7,16,CHECK_CASHING,200000.0,C1473237843
33599,409000362497',2018-07-16,IMPS 819721826089 FROM OX,0.0,200000.0,,2018,7,16,CASH_IN,200000.0,M927789050
33600,409000362497',2018-07-16,IMPS 819721826123 FROM OX,0.0,200000.0,,2018,7,16,CHECK_CASHING,200000.0,C260445116
33601,409000362497',2018-07-16,IMPS 819721826152 FROM OX,0.0,200000.0,,2018,7,16,CHECK_CASHING,200000.0,M737778018
33602,409000362497',2018-07-16,IMPS 819721826176 FROM OX,0.0,200000.0,,2018,7,16,CHECK_CASHING,200000.0,C1881151365
33603,409000362497',2018-07-16,IMPS 819721826205 FROM OX,0.0,200000.0,,2018,7,16,CHECK_CASHING,200000.0,M100038336
33604,409000362497',2018-07-16,IMPS 819721826235 FROM OX,0.0,200000.0,,2018,7,16,TRANSFER,200000.0,M1301323097
33605,409000362497',2018-07-16,IMPS 819721826265 FROM OX,0.0,200000.0,,2018,7,16,CASH_IN,200000.0,M1521896773
33606,409000362497',2018-07-16,IMPS 819721826290 FROM OX,0.0,200000.0,,2018,7,16,CHECK_CASHING,200000.0,C1383273534
33607,409000362497',2018-07-16,IMPS 819721826313 FROM OX,0.0,200000.0,,2018,7,16,TRANSFER,200000.0,C1885780198
33608,409000362497',2018-07-16,IMPS 819721826348 FROM OX,0.0,200000.0,,2018,7,16,CASH_IN,200000.0,M1746812473
33609,409000362497',2018-07-16,IMPS 819721826597 FROM OX,0.0,200000.0,,2018,7,16,CHECK_CASHING,200000.0,C582410861
33610,409000362497',2018-07-16,IMPS 819721826621 FROM OX,0.0,200000.0,,2018,7,16,CHECK_CASHING,200000.0,C1632268814
33611,409000362497',2018-07-16,IMPS 819721826650 FROM OX,0.0,200000.0,,2018,7,16,CHECK_CASHING,200000.0,C1039865382
33612,409000362497',2018-07-16,IMPS 819721826686 FROM OX,0.0,200000.0,,2018,7,16,CASH_IN,200000.0,C2106812355
33613,409000362497',2018-07-16,IMPS 819721826719 FROM OX,0.0,200000.0,,2018,7,16,CHECK_CASHING,200000.0,C256516555
33614,409000362497',2018-07-16,IMPS 819721826751 FROM OX,0.0,200000.0,,2018,7,16,TRANSFER,200000.0,C403254166
33615,409000362497',2018-07-16,IMPS 819721826786 FROM OX,0.0,200000.0,,2018,7,16,TRANSFER,200000.0,C1750956965
33616,409000362497',2018-07-16,IMPS 819721826809 FROM OX,0.0,200000.0,,2018,7,16,CHECK_CASHING,200000.0,C1832580921
33617,409000362497',2018-07-16,IMPS 819721826837 FROM OX,0.0,200000.0,,2018,7,16,TRANSFER,200000.0,C1404112538
33618,409000362497',2018-07-16,IMPS 819721828442 FROM OX,0.0,200000.0,,2018,7,16,TRANSFER,200000.0,C1219273867
33619,409000362497',2018-07-16,IMPS 819721828461 FROM OX,0.0,200000.0,,2018,7,16,CASH_IN,200000.0,M110509563
33620,409000362497',2018-07-16,IMPS 819721828491 FROM OX,0.0,200000.0,,2018,7,16,CHECK_CASHING,200000.0,C1787190008
33621,409000362497',2018-07-16,IMPS 819721828513 FROM OX,0.0,200000.0,,2018,7,16,CASH_IN,200000.0,M194292616
33622,409000362497',2018-07-16,IMPS 819721828543 FROM OX,0.0,200000.0,,2018,7,16,TRANSFER,200000.0,M401345912
33623,409000362497',2018-07-16,IMPS 819721828566 FROM OX,0.0,200000.0,,2018,7,16,TRANSFER,200000.0,C1088997819
33624,409000362497',2018-07-16,IMPS 819721828594 FROM OX,0.0,200000.0,,2018,7,16,CASH_IN,200000.0,M2047196034
33625,409000362497',2018-07-16,IMPS 819721828614 FROM OX,0.0,200000.0,,2018,7,16,CASH_IN,200000.0,C1985660918
33626,409000362497',2018-07-16,IMPS 819721828631 FROM OX,0.0,200000.0,,2018,7,16,CASH_IN,200000.0,M305029690
33627,409000362497',2018-07-16,IMPS 819721828667 FROM OX,0.0,200000.0,,2018,7,16,CHECK_CASHING,200000.0,C22713217
33628,409000362497',2018-07-16,IMPS 819721829022 FROM OX,0.0,200000.0,,2018,7,16,TRANSFER,200000.0,C810334748
33629,409000362497',2018-07-16,IMPS 819721829047 FROM OX,0.0,200000.0,,2018,7,16,CASH_IN,200000.0,M1011258084
33630,409000362497',2018-07-16,IMPS 819721829071 FROM OX,0.0,200000.0,,2018,7,16,CHECK_CASHING,200000.0,M1009130159
33631,409000362497',2018-07-16,IMPS 819721829095 FROM OX,0.0,200000.0,,2018,7,16,CHECK_CASHING,200000.0,M693909742
33632,409000362497',2018-07-16,IMPS 819721829124 FROM OX,0.0,200000.0,,2018,7,16,TRANSFER,200000.0,M1414524755
33633,409000362497',2018-07-16,IMPS 819721829159 FROM OX,0.0,200000.0,,2018,7,16,CASH_IN,200000.0,C1536728605
33634,409000362497',2018-07-16,IMPS 819721829173 FROM OX,0.0,200000.0,,2018,7,16,CHECK_CASHING,200000.0,M1286205644
33635,409000362497',2018-07-16,IMPS 819721829200 FROM OX,0.0,200000.0,,2018,7,16,TRANSFER,200000.0,C1245689449
33636,409000362497',2018-07-16,IMPS 819721829216 FROM OX,0.0,200000.0,,2018,7,16,TRANSFER,200000.0,M829455374
33637,409000362497',2018-07-16,IMPS 819721829245 FROM OX,0.0,200000.0,,2018,7,16,CASH_IN,200000.0,M1751841817
33638,409000362497',2018-07-16,IMPS 819721829474 FROM OX,0.0,200000.0,,2018,7,16,CHECK_CASHING,200000.0,C151015751
33639,409000362497',2018-07-16,IMPS 819721829492 FROM OX,0.0,200000.0,,2018,7,16,TRANSFER,200000.0,M1709109281
33640,409000362497',2018-07-16,IMPS 819721829519 FROM OX,0.0,200000.0,,2018,7,16,CHECK_CASHING,200000.0,M537861900
33641,409000362497',2018-07-16,IMPS 819721829553 FROM OX,0.0,200000.0,,2018,7,16,CASH_IN,200000.0,M1858171022
33642,409000362497',2018-07-16,IMPS 819721829565 FROM OX,0.0,200000.0,,2018,7,16,CHECK_CASHING,200000.0,M915467455
33643,409000362497',2018-07-16,IMPS 819721829579 FROM OX,0.0,200000.0,,2018,7,16,CHECK_CASHING,200000.0,C971357464
33644,409000362497',2018-07-16,IMPS 819721829594 FROM OX,0.0,200000.0,,2018,7,16,CHECK_CASHING,200000.0,C539486713
33645,409000362497',2018-07-16,IMPS 819721829618 FROM OX,0.0,200000.0,,2018,7,16,CASH_IN,200000.0,C699026377
33646,409000362497',2018-07-16,IMPS 819721829634 FROM OX,0.0,200000.0,,2018,7,16,CHECK_CASHING,200000.0,C1083183526
33647,409000362497',2018-07-16,IMPS 819721830569 FROM OX,0.0,200000.0,,2018,7,16,CHECK_CASHING,200000.0,M176253019
33648,409000362497',2018-07-16,IMPS 819721830597 FROM OX,0.0,200000.0,,2018,7,16,CASH_IN,200000.0,C1544377199
33649,409000362497',2018-07-16,IMPS 819721830618 FROM OX,0.0,200000.0,,2018,7,16,CASH_IN,200000.0,C895798008
33650,409000362497',2018-07-16,IMPS 819721830646 FROM OX,0.0,200000.0,,2018,7,16,CHECK_CASHING,200000.0,C515578013
33651,409000362497',2018-07-16,IMPS 819721830667 FROM OX,0.0,200000.0,,2018,7,16,TRANSFER,200000.0,C1827786059
33652,409000362497',2018-07-16,IMPS 819721830695 FROM OX,0.0,200000.0,,2018,7,16,CASH_IN,200000.0,M2068560711
33653,409000362497',2018-07-16,IMPS 819721830716 FROM OX,0.0,200000.0,,2018,7,16,TRANSFER,200000.0,C736160330
33654,409000362497',2018-07-16,Sweep Trf To: 40900036427,452349.0,0.0,,2018,7,16,DEBIT,452349.0,C1365134973
33655,409000362497',2018-07-17,NEFT/AXIC181987393240/Indfor,0.0,7500000.0,,2018,7,17,CHECK_CASHING,7500000.0,M59395086
33656,409000362497',2018-07-17,IMPS 1607181C,4006130.77,0.0,,2018,7,17,CASH_OUT,4006130.77,C632283006
33657,409000362497',2018-07-17,IMPS 1707182C,2505088.49,0.0,,2018,7,17,PAYEMENT,2505088.49,M1479150414
33658,409000362497',2018-07-17,IMPS 1707183C,5893744.36,0.0,,2018,7,17,CASH_OUT,5893744.36,C479258111
33659,409000362497',2018-07-17,NEFT/SBIN418198843894/Indfor,0.0,3000000.0,,2018,7,17,CASH_IN,3000000.0,C691636444
33660,409000362497',2018-07-17,FDRL/INTERNAL FUND TRANSFE,0.0,500000.0,,2018,7,17,TRANSFER,500000.0,C861958315
33661,409000362497',2018-07-17,FDRL/INTERNAL FUND TRANSFE,0.0,500000.0,,2018,7,17,CHECK_CASHING,500000.0,C1811531351
33662,409000362497',2018-07-17,FDRL/INTERNAL FUND TRANSFE,0.0,500000.0,,2018,7,17,CASH_IN,500000.0,C2099963719
33663,409000362497',2018-07-17,IMPS 1707184C,3388906.61,0.0,,2018,7,17,CASH_OUT,3388906.61,C2029310301
33664,409000362497',2018-07-17,Sweep Trf From: 709002764,0.0,1262619.56,,2018,7,17,CASH_IN,1262619.56,C1007876221
33665,409000362497',2018-07-18,RTGS/UTIBH18199621341/Indfor,0.0,2500000.0,,2018,7,18,CHECK_CASHING,2500000.0,C1046160944
33666,409000362497',2018-07-18,INDIAIDEAS.COM LTD,40780.0,0.0,,2018,7,18,PAYEMENT,40780.0,C421163163
33667,409000362497',2018-07-18,IRCTC CORPORATE OFFICE AC,98665.0,0.0,,2018,7,18,PAYEMENT,98665.0,C728885526
33668,409000362497',2018-07-18,PAYU PAYMENTS PRIVATE LIM,95705.0,0.0,,2018,7,18,PAYEMENT,95705.0,C1350789239
33669,409000362497',2018-07-18,AVENUES INDIA PRIVATE LIM,9967.0,0.0,,2018,7,18,CASH_OUT,9967.0,C1479557064
33670,409000362497',2018-07-18,FUTURE RETAIL LIMITED (OW,5129.0,0.0,,2018,7,18,CHECK_WITHDRAWAL,5129.0,C1413677222
33671,409000362497',2018-07-18,PASFAR TECHNOLOGIES PRIVA,25217.0,0.0,,2018,7,18,PAYEMENT,25217.0,C287577899
33672,409000362497',2018-07-18,DISH INFRA SERVICES PRIVA,681.0,0.0,,2018,7,18,CASH_OUT,681.0,C1161865950
33673,409000362497',2018-07-18,JUST DIAL LIMITED,4563.0,0.0,,2018,7,18,CASH_OUT,4563.0,C20671747
33674,409000362497',2018-07-18,MEHAR ENTERTAINMENT PRIVA,5185.0,0.0,,2018,7,18,DEBIT,5185.0,C2103065350
33675,409000362497',2018-07-18,ZAAK EPAYMENT SERVICES PR,148.0,0.0,,2018,7,18,CHECK_WITHDRAWAL,148.0,C937195105
33676,409000362497',2018-07-18,Indiaforensic SERVICES INDIA PVT,514919.0,0.0,,2018,7,18,CASH_OUT,514919.0,C306206744
33677,409000362497',2018-07-18,IMPS 1707181C,3683087.01,0.0,,2018,7,18,PAYEMENT,3683087.01,C1271057169
33678,409000362497',2018-07-18,IMPS 1807182C,1819126.49,0.0,,2018,7,18,CHECK_WITHDRAWAL,1819126.49,M1273811322
33679,409000362497',2018-07-18,IMPS 1807183C,5635428.05,0.0,,2018,7,18,CASH_OUT,5635428.05,M1122329852
33680,409000362497',2018-07-18,FDRL/INTERNAL FUND TRANSFE,0.0,4000000.0,,2018,7,18,TRANSFER,4000000.0,M1917652055
33681,409000362497',2018-07-18,FDRL/INTERNAL FUND TRANSFE,0.0,4000000.0,,2018,7,18,TRANSFER,4000000.0,M338680114
33682,409000362497',2018-07-18,FDRL/INTERNAL FUND TRANSFE,0.0,4000000.0,,2018,7,18,CASH_IN,4000000.0,M1786201745
33683,409000362497',2018-07-18,IMPS 1807184C,3433864.13,0.0,,2018,7,18,CHECK_WITHDRAWAL,3433864.13,M1503764987
33684,409000362497',2018-07-19,IMPS 1807181C,3083181.74,0.0,,2018,7,19,CHECK_WITHDRAWAL,3083181.74,M1863154202
33685,409000362497',2018-07-19,IMPS 1907182C,1953932.14,0.0,,2018,7,19,CASH_OUT,1953932.14,M1615228075
33686,409000362497',2018-07-19,IMPS 1907183C,4281937.02,0.0,,2018,7,19,CASH_OUT,4281937.02,C1251600325
33687,409000362497',2018-07-19,NEFT/IDIBH18200211457/NFS,0.0,5000.0,,2018,7,19,CASH_IN,5000.0,C1060951315
33688,409000362497',2018-07-19,NEFT/SBIN618200438964/Indfor,0.0,1000000.0,,2018,7,19,TRANSFER,1000000.0,C1511598070
33689,409000362497',2018-07-19,NEFT/AXIC182008498515/Indfor,0.0,2000000.0,,2018,7,19,CASH_IN,2000000.0,C980726513
33690,409000362497',2018-07-19,NEFT/SBIN618200406989/Indfor,0.0,3600000.0,,2018,7,19,CHECK_CASHING,3600000.0,M1631581906
33691,409000362497',2018-07-19,TRF FROM  Indiaforensic SERVICES,0.0,7500000.0,,2018,7,19,CHECK_CASHING,7500000.0,M844983478
33692,409000362497',2018-07-19,IMPS 820019550624 FROM OX,0.0,200000.0,,2018,7,19,CHECK_CASHING,200000.0,M321817217
33693,409000362497',2018-07-19,IMPS 820019550644 FROM OX,0.0,200000.0,,2018,7,19,CASH_IN,200000.0,C300460332
33694,409000362497',2018-07-19,IMPS 820019550665 FROM OX,0.0,200000.0,,2018,7,19,CASH_IN,200000.0,M850660874
33695,409000362497',2018-07-19,IMPS 820019550688 FROM OX,0.0,200000.0,,2018,7,19,CASH_IN,200000.0,M205487512
33696,409000362497',2018-07-19,IMPS 820019550725 FROM OX,0.0,200000.0,,2018,7,19,TRANSFER,200000.0,M298235705
33697,409000362497',2018-07-19,IMPS 820019550753 FROM OX,0.0,200000.0,,2018,7,19,TRANSFER,200000.0,C153634664
33698,409000362497',2018-07-19,IMPS 820019550781 FROM OX,0.0,200000.0,,2018,7,19,CASH_IN,200000.0,C590842329
33699,409000362497',2018-07-19,IMPS 820019550813 FROM OX,0.0,200000.0,,2018,7,19,CHECK_CASHING,200000.0,M1517470926
33700,409000362497',2018-07-19,IMPS 820019550839 FROM OX,0.0,200000.0,,2018,7,19,TRANSFER,200000.0,C1326243087
33701,409000362497',2018-07-19,IMPS 820019550867 FROM OX,0.0,200000.0,,2018,7,19,TRANSFER,200000.0,M1052502637
33702,409000362497',2018-07-19,IMPS 820019551240 FROM OX,0.0,200000.0,,2018,7,19,TRANSFER,200000.0,M505956440
33703,409000362497',2018-07-19,IMPS 820019551256 FROM OX,0.0,200000.0,,2018,7,19,CASH_IN,200000.0,M885806813
33704,409000362497',2018-07-19,IMPS 820019551279 FROM OX,0.0,200000.0,,2018,7,19,CHECK_CASHING,200000.0,M48097684
33705,409000362497',2018-07-19,IMPS 820019551306 FROM OX,0.0,200000.0,,2018,7,19,CASH_IN,200000.0,C849038219
33706,409000362497',2018-07-19,IMPS 820019551341 FROM OX,0.0,200000.0,,2018,7,19,TRANSFER,200000.0,C1704308874
33707,409000362497',2018-07-19,IMPS 820019551377 FROM OX,0.0,200000.0,,2018,7,19,TRANSFER,200000.0,M1139395147
33708,409000362497',2018-07-19,IMPS 820019551406 FROM OX,0.0,200000.0,,2018,7,19,CHECK_CASHING,200000.0,C2035525206
33709,409000362497',2018-07-19,IMPS 820019551439 FROM OX,0.0,200000.0,,2018,7,19,CASH_IN,200000.0,C1958036068
33710,409000362497',2018-07-19,IMPS 820019551469 FROM OX,0.0,200000.0,,2018,7,19,TRANSFER,200000.0,C1449687458
33711,409000362497',2018-07-19,IMPS 820019551499 FROM OX,0.0,200000.0,,2018,7,19,CHECK_CASHING,200000.0,M1790910173
33712,409000362497',2018-07-19,IMPS 820019551862 FROM OX,0.0,200000.0,,2018,7,19,TRANSFER,200000.0,C1423956695
33713,409000362497',2018-07-19,IMPS 820019551905 FROM OX,0.0,200000.0,,2018,7,19,CHECK_CASHING,200000.0,C1656107232
33714,409000362497',2018-07-19,IMPS 820019551927 FROM OX,0.0,200000.0,,2018,7,19,CASH_IN,200000.0,C1554282047
33715,409000362497',2018-07-19,IMPS 820019551948 FROM OX,0.0,200000.0,,2018,7,19,CHECK_CASHING,200000.0,C36856762
33716,409000362497',2018-07-19,IMPS 820019551993 FROM OX,0.0,200000.0,,2018,7,19,TRANSFER,200000.0,C445613834
33717,409000362497',2018-07-19,IMPS 820019552015 FROM OX,0.0,200000.0,,2018,7,19,TRANSFER,200000.0,C2052185144
33718,409000362497',2018-07-19,IMPS 820019552054 FROM OX,0.0,200000.0,,2018,7,19,CASH_IN,200000.0,C305306935
33719,409000362497',2018-07-19,IMPS 820019552091 FROM OX,0.0,200000.0,,2018,7,19,TRANSFER,200000.0,C70895366
33720,409000362497',2018-07-19,IMPS 820019552117 FROM OX,0.0,200000.0,,2018,7,19,CHECK_CASHING,200000.0,C1248712846
33721,409000362497',2018-07-19,IMPS 820019552133 FROM OX,0.0,200000.0,,2018,7,19,TRANSFER,200000.0,C1467301185
33722,409000362497',2018-07-19,IMPS 1907184C,3090632.64,0.0,,2018,7,19,DEBIT,3090632.64,C1293405828
33723,409000362497',2018-07-19,IMPS 820019553723 FROM OX,0.0,200000.0,,2018,7,19,CASH_IN,200000.0,C1520366382
33724,409000362497',2018-07-19,IMPS 820019553760 FROM OX,0.0,200000.0,,2018,7,19,CASH_IN,200000.0,C984049856
33725,409000362497',2018-07-19,IMPS 820019553796 FROM OX,0.0,200000.0,,2018,7,19,TRANSFER,200000.0,C583769148
33726,409000362497',2018-07-19,IMPS 820019553829 FROM OX,0.0,200000.0,,2018,7,19,CASH_IN,200000.0,C259915853
33727,409000362497',2018-07-19,IMPS 820019553857 FROM OX,0.0,200000.0,,2018,7,19,TRANSFER,200000.0,C143580560
33728,409000362497',2018-07-19,IMPS 820019553886 FROM OX,0.0,200000.0,,2018,7,19,CHECK_CASHING,200000.0,C1026194794
33729,409000362497',2018-07-19,IMPS 820019553933 FROM OX,0.0,200000.0,,2018,7,19,CHECK_CASHING,200000.0,C1243680947
33730,409000362497',2018-07-19,Sweep Trf To: 40900036427,333148.0,0.0,,2018,7,19,PAYEMENT,333148.0,C719119378
33731,409000362497',2018-07-19,Repayment credit [7090027,0.0,1716.0,,2018,7,19,CHECK_CASHING,1716.0,C592593207
33732,409000362497',2018-07-20,IMPS 1907181C,3040112.55,0.0,,2018,7,20,DEBIT,3040112.55,C219543946
33733,409000362497',2018-07-20,IMPS 2007182C,1713503.47,0.0,,2018,7,20,CASH_OUT,1713503.47,C961341325
33734,409000362497',2018-07-20,INDIAIDEAS.COM LTD,47533.0,0.0,,2018,7,20,PAYEMENT,47533.0,C1096187131
33735,409000362497',2018-07-20,IRCTC CORPORATE OFFICE AC,42545.0,0.0,,2018,7,20,CHECK_WITHDRAWAL,42545.0,C294900736
33736,409000362497',2018-07-20,PAYU PAYMENTS PRIVATE LIM,44706.0,0.0,,2018,7,20,CHECK_WITHDRAWAL,44706.0,C1816361085
33737,409000362497',2018-07-20,BIDDERBOY CORPORATION,142.0,0.0,,2018,7,20,CASH_OUT,142.0,C1425517471
33738,409000362497',2018-07-20,AVENUES INDIA PRIVATE LIM,8038.0,0.0,,2018,7,20,PAYEMENT,8038.0,C2107703562
33739,409000362497',2018-07-20,FUTURE RETAIL LIMITED (OW,11986.0,0.0,,2018,7,20,PAYEMENT,11986.0,C399387267
33740,409000362497',2018-07-20,PASFAR TECHNOLOGIES PRIVA,5286.0,0.0,,2018,7,20,PAYEMENT,5286.0,C697172013
33741,409000362497',2018-07-20,JUST DIAL LIMITED,1841.0,0.0,,2018,7,20,DEBIT,1841.0,C1030706332
33742,409000362497',2018-07-20,MEHAR ENTERTAINMENT PRIVA,6567.0,0.0,,2018,7,20,PAYEMENT,6567.0,C488044861
33743,409000362497',2018-07-20,ZAAK EPAYMENT SERVICES PR,346.0,0.0,,2018,7,20,CHECK_WITHDRAWAL,346.0,C216084411
33744,409000362497',2018-07-20,VOUCHER ACTIVATION SERVIC,5397.0,0.0,,2018,7,20,PAYEMENT,5397.0,C439078113
33745,409000362497',2018-07-20,IMPS 2007183C,4711780.58,0.0,,2018,7,20,CHECK_WITHDRAWAL,4711780.58,C1335946878
33746,409000362497',2018-07-20,IRCTC CORPORATE OFFICE AC,26270.0,0.0,,2018,7,20,CHECK_WITHDRAWAL,26270.0,C2117043942
33747,409000362497',2018-07-20,PAYU PAYMENTS PRIVATE LIM,16510.0,0.0,,2018,7,20,CASH_OUT,16510.0,C1485668457
33748,409000362497',2018-07-20,AVENUES INDIA PRIVATE LIM,3356.0,0.0,,2018,7,20,DEBIT,3356.0,C306285887
33749,409000362497',2018-07-20,FUTURE RETAIL LIMITED (OW,221.0,0.0,,2018,7,20,CASH_OUT,221.0,C1059781259
33750,409000362497',2018-07-20,PASFAR TECHNOLOGIES PRIVA,15510.0,0.0,,2018,7,20,DEBIT,15510.0,C459172227
33751,409000362497',2018-07-20,JUST DIAL LIMITED,1221.0,0.0,,2018,7,20,DEBIT,1221.0,C1734774007
33752,409000362497',2018-07-20,MEHAR ENTERTAINMENT PRIVA,2996.0,0.0,,2018,7,20,DEBIT,2996.0,M1511278808
33753,409000362497',2018-07-20,ALT DIGITAL MEDIA ENTERTA,98.0,0.0,,2018,7,20,CASH_OUT,98.0,C218013508
33754,409000362497',2018-07-20,Indiaforensic SERVICES INDIA PVT,205990.0,0.0,,2018,7,20,CASH_OUT,205990.0,M1348823876
33755,409000362497',2018-07-20,Indiaforensic SERVICES INDIA PVT,230931.0,0.0,,2018,7,20,CASH_OUT,230931.0,C908804946
33756,409000362497',2018-07-20,NEFT/SBIN718201247981/Indfor,0.0,3200000.0,,2018,7,20,TRANSFER,3200000.0,M936182067
33757,409000362497',2018-07-20,FDRL/INTERNAL FUND TRANSFE,0.0,8000000.0,,2018,7,20,CHECK_CASHING,8000000.0,M432739895
33758,409000362497',2018-07-20,IMPS 2007184C,2538426.86,0.0,,2018,7,20,CHECK_WITHDRAWAL,2538426.86,M2138876774
33759,409000362497',2018-07-20,FDRL/INTERNAL FUND TRANSFE,0.0,500000.0,,2018,7,20,CHECK_CASHING,500000.0,C441129646
33760,409000362497',2018-07-20,FDRL/INTERNAL FUND TRANSFE,0.0,500000.0,,2018,7,20,TRANSFER,500000.0,C1491676195
33761,409000362497',2018-07-20,Sweep Trf To: 40900036427,267033.0,0.0,,2018,7,20,PAYEMENT,267033.0,M1015291825
33762,409000362497',2018-07-21,IMPS 2107183C,4251587.04,0.0,,2018,7,21,CASH_OUT,4251587.04,M603717800
33763,409000362497',2018-07-21,IMPS 2007181C,2927855.49,0.0,,2018,7,21,DEBIT,2927855.49,M1425475975
33764,409000362497',2018-07-21,IMPS 2107182C,1579549.0,0.0,,2018,7,21,PAYEMENT,1579549.0,M256243676
33765,409000362497',2018-07-21,NEFT/SBIN718202878661/Indfor,0.0,3100000.0,,2018,7,21,CASH_IN,3100000.0,M1009448904
33766,409000362497',2018-07-21,FDRL/INTERNAL FUND TRANSFE,0.0,7000000.0,,2018,7,21,CHECK_CASHING,7000000.0,M704991337
33767,409000362497',2018-07-21,FDRL/INTERNAL FUND TRANSFE,0.0,6000000.0,,2018,7,21,CASH_IN,6000000.0,M2047303031
33768,409000362497',2018-07-21,IMPS 2107184C,2517195.02,0.0,,2018,7,21,DEBIT,2517195.02,C1517804467
33769,409000362497',2018-07-21,FDRL/INTERNAL FUND TRANSFE,0.0,500000.0,,2018,7,21,CASH_IN,500000.0,C1030436736
33770,409000362497',2018-07-21,Sweep Trf To: 40900036427,211601.0,0.0,,2018,7,21,CHECK_WITHDRAWAL,211601.0,M388519627
33771,409000362497',2018-07-23,INDIAIDEAS.COM LTD,86681.0,0.0,,2018,7,23,PAYEMENT,86681.0,C420925675
33772,409000362497',2018-07-23,IRCTC CORPORATE OFFICE AC,31720.0,0.0,,2018,7,23,CASH_OUT,31720.0,M1454428450
33773,409000362497',2018-07-23,PAYU PAYMENTS PRIVATE LIM,18500.0,0.0,,2018,7,23,CASH_OUT,18500.0,M918650543
33774,409000362497',2018-07-23,AVENUES INDIA PRIVATE LIM,24405.0,0.0,,2018,7,23,PAYEMENT,24405.0,M646661146
33775,409000362497',2018-07-23,FUTURE RETAIL LIMITED (OW,5941.0,0.0,,2018,7,23,CHECK_WITHDRAWAL,5941.0,C409060521
33776,409000362497',2018-07-23,PASFAR TECHNOLOGIES PRIVA,5041.0,0.0,,2018,7,23,CASH_OUT,5041.0,M568982942
33777,409000362497',2018-07-23,JUST DIAL LIMITED,586.0,0.0,,2018,7,23,CHECK_WITHDRAWAL,586.0,M658328922
33778,409000362497',2018-07-23,MEHAR ENTERTAINMENT PRIVA,3917.0,0.0,,2018,7,23,DEBIT,3917.0,M1195553417
33779,409000362497',2018-07-23,QWIKCILVER SOLUTIONS PRIV,3289.0,0.0,,2018,7,23,PAYEMENT,3289.0,C1330400026
33780,409000362497',2018-07-23,Indiaforensic SERVICES INDIA PVT,201470.0,0.0,,2018,7,23,CASH_OUT,201470.0,M1170792430
33781,409000362497',2018-07-23,IMPS 2107181C,2558078.96,0.0,,2018,7,23,CASH_OUT,2558078.96,C986473968
33782,409000362497',2018-07-23,IMPS 2207181C,6513124.96,0.0,,2018,7,23,DEBIT,6513124.96,M217538412
33783,409000362497',2018-07-23,IMPS 2307182C,1640224.66,0.0,,2018,7,23,PAYEMENT,1640224.66,M2141587892
33784,409000362497',2018-07-23,IMPS 2307183C,4973016.39,0.0,,2018,7,23,CHECK_WITHDRAWAL,4973016.39,C1496194127
33785,409000362497',2018-07-23,INDIAIDEAS.COM LTD,54634.0,0.0,,2018,7,23,CHECK_WITHDRAWAL,54634.0,C1076835071
33786,409000362497',2018-07-23,IRCTC CORPORATE OFFICE AC,76485.0,0.0,,2018,7,23,CASH_OUT,76485.0,M847957326
33787,409000362497',2018-07-23,PAYU PAYMENTS PRIVATE LIM,67110.0,0.0,,2018,7,23,PAYEMENT,67110.0,M1436024792
33788,409000362497',2018-07-23,BIDDERBOY CORPORATION,146.0,0.0,,2018,7,23,CHECK_WITHDRAWAL,146.0,C1099073452
33789,409000362497',2018-07-23,AVENUES INDIA PRIVATE LIM,19101.0,0.0,,2018,7,23,CHECK_WITHDRAWAL,19101.0,M1965485107
33790,409000362497',2018-07-23,SYNERGISTIC FINANCIAL NET,71.0,0.0,,2018,7,23,DEBIT,71.0,M2081488308
33791,409000362497',2018-07-23,ZAAK EPAYMENT SERVICES PR,148.0,0.0,,2018,7,23,DEBIT,148.0,M466737648
33792,409000362497',2018-07-23,FUTURE RETAIL LIMITED (OW,11253.0,0.0,,2018,7,23,CHECK_WITHDRAWAL,11253.0,M1382243595
33793,409000362497',2018-07-23,PASFAR TECHNOLOGIES PRIVA,21213.0,0.0,,2018,7,23,CHECK_WITHDRAWAL,21213.0,M969823330
33794,409000362497',2018-07-23,JUST DIAL LIMITED,21213.0,0.0,,2018,7,23,CASH_OUT,21213.0,M2007527918
33795,409000362497',2018-07-23,MEHAR ENTERTAINMENT PRIVA,15669.0,0.0,,2018,7,23,PAYEMENT,15669.0,M947724555
33796,409000362497',2018-07-23,ALT DIGITAL MEDIA ENTERTA,98.0,0.0,,2018,7,23,PAYEMENT,98.0,M1814409328
33797,409000362497',2018-07-23,Indiaforensic SERVICES INDIA PVT,414063.0,0.0,,2018,7,23,CASH_OUT,414063.0,M373552650
33798,409000362497',2018-07-23,NEFT/SBIN818204505544/Indfor,0.0,3400000.0,,2018,7,23,TRANSFER,3400000.0,M991064720
33799,409000362497',2018-07-23,NEFT/AXIC182049555518/Indfor,0.0,2000000.0,,2018,7,23,CHECK_CASHING,2000000.0,M1256393083
33800,409000362497',2018-07-23,FDRL/INTERNAL FUND TRANSFE,0.0,6000000.0,,2018,7,23,CASH_IN,6000000.0,M934368675
33801,409000362497',2018-07-23,FDRL/INTERNAL FUND TRANSFE,0.0,6000000.0,,2018,7,23,CASH_IN,6000000.0,M1828648319
33802,409000362497',2018-07-23,FDRL/INTERNAL FUND TRANSFE,0.0,500000.0,,2018,7,23,TRANSFER,500000.0,M934773980
33803,409000362497',2018-07-23,IMPS 2307184C,3532196.97,0.0,,2018,7,23,DEBIT,3532196.97,M918495296
33804,409000362497',2018-07-23,IMPS 820420423336 FROM OX,0.0,200000.0,,2018,7,23,CASH_IN,200000.0,M28091341
33805,409000362497',2018-07-23,IMPS 820420423359 FROM OX,0.0,200000.0,,2018,7,23,TRANSFER,200000.0,M1751460459
33806,409000362497',2018-07-23,Sweep Trf To: 40900036427,287748.0,0.0,,2018,7,23,DEBIT,287748.0,M872711303
33807,409000362497',2018-07-24,IMPS 2307181C,3457878.06,0.0,,2018,7,24,PAYEMENT,3457878.06,M1877057614
33808,409000362497',2018-07-24,IMPS 2407182C,1736419.93,0.0,,2018,7,24,CASH_OUT,1736419.93,M947414452
33809,409000362497',2018-07-24,INDIAIDEAS.COM LTD,77360.0,0.0,,2018,7,24,CHECK_WITHDRAWAL,77360.0,M1140463174
33810,409000362497',2018-07-24,IRCTC CORPORATE OFFICE AC,29296.0,0.0,,2018,7,24,CHECK_WITHDRAWAL,29296.0,M1461152533
33811,409000362497',2018-07-24,PAYU PAYMENTS PRIVATE LIM,9615.0,0.0,,2018,7,24,CASH_OUT,9615.0,M1019246362
33812,409000362497',2018-07-24,AVENUES INDIA PRIVATE LIM,11330.0,0.0,,2018,7,24,PAYEMENT,11330.0,C518518143
33813,409000362497',2018-07-24,ZAAK EPAYMENT SERVICES PR,129.0,0.0,,2018,7,24,CASH_OUT,129.0,C1494895909
33814,409000362497',2018-07-24,FUTURE RETAIL LIMITED (OW,98.0,0.0,,2018,7,24,CHECK_WITHDRAWAL,98.0,M2063705517
33815,409000362497',2018-07-24,PASFAR TECHNOLOGIES PRIVA,5260.0,0.0,,2018,7,24,CHECK_WITHDRAWAL,5260.0,C470644341
33816,409000362497',2018-07-24,MEHAR ENTERTAINMENT PRIVA,3917.0,0.0,,2018,7,24,CHECK_WITHDRAWAL,3917.0,M2085525437
33817,409000362497',2018-07-24,Indiaforensic SERVICES INDIA PVT,171307.0,0.0,,2018,7,24,PAYEMENT,171307.0,M263290651
33818,409000362497',2018-07-24,IMPS 2407183C,4272138.75,0.0,,2018,7,24,DEBIT,4272138.75,C678651991
33819,409000362497',2018-07-24,NEFT/BARBS18205421512/BIN,0.0,1800.0,,2018,7,24,CHECK_CASHING,1800.0,C1355760696
33820,409000362497',2018-07-24,NEFT/SBIN918205152689/Indfor,0.0,1500000.0,,2018,7,24,CHECK_CASHING,1500000.0,C109195229
33821,409000362497',2018-07-24,FDRL/INTERNAL FUND TRANSFE,0.0,4000000.0,,2018,7,24,CASH_IN,4000000.0,M1232552045
33822,409000362497',2018-07-24,FDRL/INTERNAL FUND TRANSFE,0.0,6000000.0,,2018,7,24,CHECK_CASHING,6000000.0,M1493066062
33823,409000362497',2018-07-24,FDRL/INTERNAL FUND TRANSFE,0.0,500000.0,,2018,7,24,CHECK_CASHING,500000.0,M843103620
33824,409000362497',2018-07-24,IMPS 2407184C,2552681.2,0.0,,2018,7,24,CHECK_WITHDRAWAL,2552681.2,C350923666
33825,409000362497',2018-07-24,Sweep Trf To: 40900036427,333349.0,0.0,,2018,7,24,CASH_OUT,333349.0,C1913564743
33826,409000362497',2018-07-25,IMPS 2407181C,2808742.72,0.0,,2018,7,25,CASH_OUT,2808742.72,M249666914
33827,409000362497',2018-07-25,IMPS 2507182C,1728215.17,0.0,,2018,7,25,DEBIT,1728215.17,C972829670
33828,409000362497',2018-07-25,IMPS 2507183C,4241790.52,0.0,,2018,7,25,PAYEMENT,4241790.52,M912292491
33829,409000362497',2018-07-25,NEFT/SBIN918206831357/Indfor,0.0,3000000.0,,2018,7,25,CHECK_CASHING,3000000.0,M1308832969
33830,409000362497',2018-07-25,FDRL/INTERNAL FUND TRANSFE,0.0,4000000.0,,2018,7,25,CHECK_CASHING,4000000.0,M1128435643
33831,409000362497',2018-07-25,FDRL/INTERNAL FUND TRANSFE,0.0,4000000.0,,2018,7,25,CASH_IN,4000000.0,M1744230005
33832,409000362497',2018-07-25,IMPS 2507184C,3220781.15,0.0,,2018,7,25,PAYEMENT,3220781.15,M1577912646
33833,409000362497',2018-07-25,FDRL/INTERNAL FUND TRANSFE,0.0,2000000.0,,2018,7,25,CHECK_CASHING,2000000.0,M524546847
33834,409000362497',2018-07-25,Sweep Trf To: 40900036427,231751.0,0.0,,2018,7,25,CHECK_WITHDRAWAL,231751.0,M200358126
33835,409000362497',2018-07-26,IMPS 250720181C,2496618.93,0.0,,2018,7,26,PAYEMENT,2496618.93,M2072223360
33836,409000362497',2018-07-26,IMPS 2607182C,1611662.2,0.0,,2018,7,26,CASH_OUT,1611662.2,C1218365329
33837,409000362497',2018-07-26,IMPS 2607183C,4255220.36,0.0,,2018,7,26,CHECK_WITHDRAWAL,4255220.36,M2146423102
33838,409000362497',2018-07-26,INDIAIDEAS.COM LTD,140117.0,0.0,,2018,7,26,PAYEMENT,140117.0,C40133542
33839,409000362497',2018-07-26,IRCTC CORPORATE OFFICE AC,35210.0,0.0,,2018,7,26,CHECK_WITHDRAWAL,35210.0,M970709457
33840,409000362497',2018-07-26,PAYU PAYMENTS PRIVATE LIM,28182.0,0.0,,2018,7,26,DEBIT,28182.0,M1495040224
33841,409000362497',2018-07-26,AVENUES INDIA PRIVATE LIM,4881.0,0.0,,2018,7,26,CHECK_WITHDRAWAL,4881.0,M739703972
33842,409000362497',2018-07-26,ZAAK EPAYMENT SERVICES PR,1178.0,0.0,,2018,7,26,CASH_OUT,1178.0,C9108707
33843,409000362497',2018-07-26,FUTURE RETAIL LIMITED (OW,1466.0,0.0,,2018,7,26,PAYEMENT,1466.0,C1953886321
33844,409000362497',2018-07-26,METRO INFRASYS PRIVATE LI,697.0,0.0,,2018,7,26,DEBIT,697.0,C590310947
33845,409000362497',2018-07-26,PASFAR TECHNOLOGIES PRIVA,15382.0,0.0,,2018,7,26,CHECK_WITHDRAWAL,15382.0,M86788435
33846,409000362497',2018-07-26,MEHAR ENTERTAINMENT PRIVA,8526.0,0.0,,2018,7,26,DEBIT,8526.0,C1970362900
33847,409000362497',2018-07-26,DISH INFRA SERVICES PRIVA,1460.0,0.0,,2018,7,26,DEBIT,1460.0,M1796828381
33848,409000362497',2018-07-26,ALT DIGITAL MEDIA ENTERTA,294.0,0.0,,2018,7,26,PAYEMENT,294.0,C1743996658
33849,409000362497',2018-07-26,VOUCHER ACTIVATION SERVIC,6804.0,0.0,,2018,7,26,CASH_OUT,6804.0,M1518345411
33850,409000362497',2018-07-26,Indiaforensic SERVICES INDIA PVT,323072.0,0.0,,2018,7,26,DEBIT,323072.0,M809266315
33851,409000362497',2018-07-26,NEFT/SBIN118207656526/Indfor,0.0,3500000.0,,2018,7,26,TRANSFER,3500000.0,M1780104118
33852,409000362497',2018-07-26,IMPS 2607184C,3178959.88,0.0,,2018,7,26,CHECK_WITHDRAWAL,3178959.88,M1018024664
33853,409000362497',2018-07-26,FDRL/INTERNAL FUND TRANSFE,0.0,5000000.0,,2018,7,26,TRANSFER,5000000.0,M84849724
33854,409000362497',2018-07-26,FDRL/INTERNAL FUND TRANSFE,0.0,4000000.0,,2018,7,26,CASH_IN,4000000.0,M218597250
33855,409000362497',2018-07-26,Sweep Trf To: 40900036427,269670.0,0.0,,2018,7,26,CHECK_WITHDRAWAL,269670.0,M1425924758
33856,409000362497',2018-07-27,IMPS 2607181C,2762859.96,0.0,,2018,7,27,PAYEMENT,2762859.96,M1335788902
33857,409000362497',2018-07-27,IMPS 2707182C,1510840.81,0.0,,2018,7,27,CHECK_WITHDRAWAL,1510840.81,M1085389978
33858,409000362497',2018-07-27,IRCTC CORPORATE OFFICE AC,28370.0,0.0,,2018,7,27,DEBIT,28370.0,M608282809
33859,409000362497',2018-07-27,PAYU PAYMENTS PRIVATE LIM,28871.0,0.0,,2018,7,27,DEBIT,28871.0,M169387933
33860,409000362497',2018-07-27,ZAAK EPAYMENT SERVICES PR,179.0,0.0,,2018,7,27,DEBIT,179.0,M1095036714
33861,409000362497',2018-07-27,FUTURE RETAIL LIMITED (OW,210.0,0.0,,2018,7,27,DEBIT,210.0,M1306031827
33862,409000362497',2018-07-27,PASFAR TECHNOLOGIES PRIVA,8655.0,0.0,,2018,7,27,CASH_OUT,8655.0,M268032065
33863,409000362497',2018-07-27,JUST DIAL LIMITED,431.0,0.0,,2018,7,27,PAYEMENT,431.0,M458897350
33864,409000362497',2018-07-27,MEHAR ENTERTAINMENT PRIVA,2535.0,0.0,,2018,7,27,PAYEMENT,2535.0,M558242204
33865,409000362497',2018-07-27,QWIKCILVER SOLUTIONS PRIV,9228.0,0.0,,2018,7,27,CHECK_WITHDRAWAL,9228.0,M733521742
33866,409000362497',2018-07-27,Indiaforensic SERVICES INDIA PVT,137530.0,0.0,,2018,7,27,CASH_OUT,137530.0,M1030268518
33867,409000362497',2018-07-27,IMPS 2707183C,4080173.08,0.0,,2018,7,27,DEBIT,4080173.08,M8690178
33868,409000362497',2018-07-27,IMPS 820819357125 FROM OX,0.0,200000.0,,2018,7,27,TRANSFER,200000.0,M1256361503
33869,409000362497',2018-07-27,IMPS 2707184C,2738959.65,0.0,,2018,7,27,CHECK_WITHDRAWAL,2738959.65,M1187011897
33870,409000362497',2018-07-27,FDRL/INTERNAL FUND TRANSFE,0.0,15000000.0,,2018,7,27,CASH_IN,15000000.0,C1978557426
33871,409000362497',2018-07-27,FDRL/INTERNAL FUND TRANSFE,0.0,5000000.0,,2018,7,27,CASH_IN,5000000.0,M1190220635
33872,409000362497',2018-07-27,Sweep Trf To: 40900036427,277901.0,0.0,,2018,7,27,CASH_OUT,277901.0,M1517412061
33873,409000362497',2018-07-30,IMPS 2707181C,2508460.9,0.0,,2018,7,30,DEBIT,2508460.9,M2006165770
33874,409000362497',2018-07-30,IMPS 2807181C,8113818.2,0.0,,2018,7,30,PAYEMENT,8113818.2,C1753714541
33875,409000362497',2018-07-30,IMPS 2907181C,2295756.23,0.0,,2018,7,30,DEBIT,2295756.23,C1577744105
33876,409000362497',2018-07-30,IMPS 3007182C,3605670.77,0.0,,2018,7,30,CASH_OUT,3605670.77,C1816757085
33877,409000362497',2018-07-30,IMPS 3007183C,5980628.08,0.0,,2018,7,30,CHECK_WITHDRAWAL,5980628.08,C1208635528
33878,409000362497',2018-07-30,FDRL/INTERNAL FUND TRANSFE,0.0,15000000.0,,2018,7,30,CASH_IN,15000000.0,C1734719138
33879,409000362497',2018-07-30,NEFT/AXIC182111506265/Indfor,0.0,3000000.0,,2018,7,30,CHECK_CASHING,3000000.0,C1649944650
33880,409000362497',2018-07-30,FDRL/INTERNAL FUND TRANSFE,0.0,3000000.0,,2018,7,30,CASH_IN,3000000.0,C1023714065
33881,409000362497',2018-07-30,IMPS 3007184C,3746711.14,0.0,,2018,7,30,DEBIT,3746711.14,C323287038
33882,409000362497',2018-07-30,Sweep Trf To: 40900036427,281109.0,0.0,,2018,7,30,PAYEMENT,281109.0,C611621587
33883,409000362497',2018-07-31,IMPS 3007181C,3220735.34,0.0,,2018,7,31,CHECK_WITHDRAWAL,3220735.34,C1916873789
33884,409000362497',2018-07-31,IMPS 3107182C,1498268.23,0.0,,2018,7,31,PAYEMENT,1498268.23,C820910648
33885,409000362497',2018-07-31,INDIAIDEAS.COM LTD,149780.0,0.0,,2018,7,31,CASH_OUT,149780.0,C1638556416
33886,409000362497',2018-07-31,IRCTC CORPORATE OFFICE AC,90615.0,0.0,,2018,7,31,CHECK_WITHDRAWAL,90615.0,C990662375
33887,409000362497',2018-07-31,PAYU PAYMENTS PRIVATE LIM,88818.0,0.0,,2018,7,31,CHECK_WITHDRAWAL,88818.0,C1611427359
33888,409000362497',2018-07-31,AVENUES INDIA PRIVATE LIM,38751.0,0.0,,2018,7,31,DEBIT,38751.0,C1615443145
33889,409000362497',2018-07-31,SYNERGISTIC FINANCIAL NET,548.0,0.0,,2018,7,31,CASH_OUT,548.0,C116956744
33890,409000362497',2018-07-31,ZAAK EPAYMENT SERVICES PR,1374.0,0.0,,2018,7,31,PAYEMENT,1374.0,C1227603646
33891,409000362497',2018-07-31,FUTURE RETAIL LIMITED (OW,9774.0,0.0,,2018,7,31,PAYEMENT,9774.0,C898219424
33892,409000362497',2018-07-31,PASFAR TECHNOLOGIES PRIVA,31289.0,0.0,,2018,7,31,PAYEMENT,31289.0,C1471923369
33893,409000362497',2018-07-31,DISH INFRA SERVICES PRIVA,3755.0,0.0,,2018,7,31,DEBIT,3755.0,C664038638
33894,409000362497',2018-07-31,JUST DIAL LIMITED,4211.0,0.0,,2018,7,31,CASH_OUT,4211.0,C1859795678
33895,409000362497',2018-07-31,MEHAR ENTERTAINMENT PRIVA,15208.0,0.0,,2018,7,31,CASH_OUT,15208.0,C1341257842
33896,409000362497',2018-07-31,MUZAFFARPUR VIDYUT VITARA,1046.0,0.0,,2018,7,31,DEBIT,1046.0,C1985136401
33897,409000362497',2018-07-31,VOUCHER ACTIVATION SERVIC,10469.0,0.0,,2018,7,31,DEBIT,10469.0,M989695575
33898,409000362497',2018-07-31,Indiaforensic SERVICES INDIA PVT,634801.0,0.0,,2018,7,31,DEBIT,634801.0,C1713794884
33899,409000362497',2018-07-31,IMPS 3107183C,3911431.85,0.0,,2018,7,31,CASH_OUT,3911431.85,C880566340
33900,409000362497',2018-07-31,NEFT/KKBK182123027256/BIG,0.0,105283.0,,2018,7,31,CHECK_CASHING,105283.0,M1610530613
33901,409000362497',2018-07-31,FDRL/INTERNAL FUND TRANSFE,0.0,3000000.0,,2018,7,31,CASH_IN,3000000.0,M1264100610
33902,409000362497',2018-07-31,FDRL/INTERNAL FUND TRANSFE,0.0,3000000.0,,2018,7,31,CHECK_CASHING,3000000.0,C504173687
33903,409000362497',2018-07-31,FDRL/INTERNAL FUND TRANSFE,0.0,3000000.0,,2018,7,31,CASH_IN,3000000.0,M294094170
33904,409000362497',2018-07-31,IMPS 3107184C,2876628.08,0.0,,2018,7,31,PAYEMENT,2876628.08,M1214762859
33905,409000362497',2018-07-31,Sweep Trf To: 40900036427,322960.0,0.0,,2018,7,31,PAYEMENT,322960.0,M1886229151
33906,409000362497',2018-07-31,409000362497:Int.Coll:01-,489.04,0.0,,2018,7,31,CHECK_WITHDRAWAL,489.04,C2140998089
33907,409000362497',2018-08-01,IMPS 3107181C,2462380.21,0.0,,2018,8,1,CASH_OUT,2462380.21,M1701818736
33908,409000362497',2018-08-01,IMPS 0108182C,1351635.97,0.0,,2018,8,1,CASH_OUT,1351635.97,M1644812429
33909,409000362497',2018-08-01,INDIAIDEAS.COM LTD,36903.0,0.0,,2018,8,1,PAYEMENT,36903.0,C219416103
33910,409000362497',2018-08-01,IRCTC CORPORATE OFFICE AC,13295.0,0.0,,2018,8,1,DEBIT,13295.0,M1796723001
33911,409000362497',2018-08-01,PAYU PAYMENTS PRIVATE LIM,23882.0,0.0,,2018,8,1,DEBIT,23882.0,M1547967139
33912,409000362497',2018-08-01,COMMDEL CONSULTING SERVIC,24818.0,0.0,,2018,8,1,PAYEMENT,24818.0,C891192830
33913,409000362497',2018-08-01,AVENUES INDIA PRIVATE LIM,12225.0,0.0,,2018,8,1,CASH_OUT,12225.0,C570409417
33914,409000362497',2018-08-01,ZAAK EPAYMENT SERVICES PR,169.0,0.0,,2018,8,1,PAYEMENT,169.0,C170071280
33915,409000362497',2018-08-01,FUTURE RETAIL LIMITED (OW,1279.0,0.0,,2018,8,1,PAYEMENT,1279.0,C1672819316
33916,409000362497',2018-08-01,JUST DIAL LIMITED,105.0,0.0,,2018,8,1,DEBIT,105.0,C1089993541
33917,409000362497',2018-08-01,MEHAR ENTERTAINMENT PRIVA,3111.0,0.0,,2018,8,1,CHECK_WITHDRAWAL,3111.0,C2109236648
33918,409000362497',2018-08-01,BIGTREE ENTERTAINMENT PRI,3826.0,0.0,,2018,8,1,PAYEMENT,3826.0,C1782704802
33919,409000362497',2018-08-01,BIGTREE ENTERTAINMENT PRI,2528.0,0.0,,2018,8,1,CHECK_WITHDRAWAL,2528.0,C1704308874
33920,409000362497',2018-08-01,BIGTREE ENTERTAINMENT PRI,513.0,0.0,,2018,8,1,CASH_OUT,513.0,C1137371968
33921,409000362497',2018-08-01,BIGTREE ENTERTAINMENT PRI,3602.0,0.0,,2018,8,1,CASH_OUT,3602.0,C151400576
33922,409000362497',2018-08-01,BIGTREE ENTERTAINMENT PRI,2982.0,0.0,,2018,8,1,DEBIT,2982.0,C673068808
33923,409000362497',2018-08-01,BIGTREE ENTERTAINMENT PRI,3623.0,0.0,,2018,8,1,DEBIT,3623.0,C2013854563
33924,409000362497',2018-08-01,Indiaforensic SERVICES INDIA PVT,190416.0,0.0,,2018,8,1,PAYEMENT,190416.0,M450157122
33925,409000362497',2018-08-01,IMPS 0108183C,4112673.58,0.0,,2018,8,1,CASH_OUT,4112673.58,C619120762
33926,409000362497',2018-08-01,NEFT/BARBV18213324809/NEF,0.0,7000.0,,2018,8,1,TRANSFER,7000.0,M1598467254
33927,409000362497',2018-08-01,FDRL/INTERNAL FUND TRANSFE,0.0,5000000.0,,2018,8,1,CASH_IN,5000000.0,M1063610758
33928,409000362497',2018-08-01,FDRL/INTERNAL FUND TRANSFE,0.0,5000000.0,,2018,8,1,CASH_IN,5000000.0,C1856036778
33929,409000362497',2018-08-01,FDRL/INTERNAL FUND TRANSFE,0.0,3000000.0,,2018,8,1,TRANSFER,3000000.0,M1229549655
33930,409000362497',2018-08-01,IMPS 0108184C,2999988.57,0.0,,2018,8,1,PAYEMENT,2999988.57,C340130985
33931,409000362497',2018-08-01,Sweep Trf To: 40900036427,222990.0,0.0,,2018,8,1,DEBIT,222990.0,C2085811498
33932,409000362497',2018-08-02,RF For 709001787780,0.0,209432.0,,2018,8,2,CASH_IN,209432.0,C1383446722
33933,409000362497',2018-08-02,IMPS 0108181C,3079356.99,0.0,,2018,8,2,DEBIT,3079356.99,M21887003
33934,409000362497',2018-08-02,IMPS 0208182C,1385766.45,0.0,,2018,8,2,PAYEMENT,1385766.45,M2116216135
33935,409000362497',2018-08-02,IMPS 0208183C,3451892.54,0.0,,2018,8,2,PAYEMENT,3451892.54,C1200233967
33936,409000362497',2018-08-02,NEFT/SBIN718214130398/Indfor,0.0,4000000.0,,2018,8,2,TRANSFER,4000000.0,C1871794198
33937,409000362497',2018-08-02,FDRL/INTERNAL FUND TRANSFE,0.0,6000000.0,,2018,8,2,CHECK_CASHING,6000000.0,M1642321799
33938,409000362497',2018-08-02,IMPS 0208184C,2394477.5,0.0,,2018,8,2,PAYEMENT,2394477.5,M315786408
33939,409000362497',2018-08-02,Sweep Trf To: 40900036427,136295.0,0.0,,2018,8,2,DEBIT,136295.0,M1978680870
33940,409000362497',2018-08-03,IMPS 0208181C,2619729.38,0.0,,2018,8,3,PAYEMENT,2619729.38,M1265032845
33941,409000362497',2018-08-03,IMPS 0308182C,500882.75,0.0,,2018,8,3,CASH_OUT,500882.75,M825607986
33942,409000362497',2018-08-03,INDIAIDEAS.COM LTD,58336.0,0.0,,2018,8,3,DEBIT,58336.0,M1050490094
33943,409000362497',2018-08-03,IRCTC CORPORATE OFFICE AC,20380.0,0.0,,2018,8,3,CASH_OUT,20380.0,C287577899
33944,409000362497',2018-08-03,PAYU PAYMENTS PRIVATE LIM,25478.0,0.0,,2018,8,3,CASH_OUT,25478.0,C915791536
33945,409000362497',2018-08-03,AVENUES INDIA PRIVATE LIM,3443.0,0.0,,2018,8,3,PAYEMENT,3443.0,M2015123807
33946,409000362497',2018-08-03,ZAAK EPAYMENT SERVICES PR,247.0,0.0,,2018,8,3,CHECK_WITHDRAWAL,247.0,C1428469551
33947,409000362497',2018-08-03,FUTURE RETAIL LIMITED (OW,98.0,0.0,,2018,8,3,CASH_OUT,98.0,M1542783877
33948,409000362497',2018-08-03,JUST DIAL LIMITED,980.0,0.0,,2018,8,3,CHECK_WITHDRAWAL,980.0,M2127617874
33949,409000362497',2018-08-03,MEHAR ENTERTAINMENT PRIVA,4954.0,0.0,,2018,8,3,CHECK_WITHDRAWAL,4954.0,C696407327
33950,409000362497',2018-08-03,DISH INFRA SERVICES PRIVA,578.0,0.0,,2018,8,3,CASH_OUT,578.0,M1784680786
33951,409000362497',2018-08-03,QWIKCILVER SOLUTIONS PRIV,4723.0,0.0,,2018,8,3,CASH_OUT,4723.0,C1047181691
33952,409000362497',2018-08-03,Indiaforensic SERVICES INDIA PVT,193585.0,0.0,,2018,8,3,CASH_OUT,193585.0,M923530853
33953,409000362497',2018-08-03,IMPS 0308183C,3776232.43,0.0,,2018,8,3,PAYEMENT,3776232.43,M1559235460
33954,409000362497',2018-08-03,FDRL/INTERNAL FUND TRANSFE,0.0,7000000.0,,2018,8,3,TRANSFER,7000000.0,C1220897602
33955,409000362497',2018-08-03,FDRL/INTERNAL FUND TRANSFE,0.0,2000000.0,,2018,8,3,TRANSFER,2000000.0,M463933195
33956,409000362497',2018-08-03,IMPS 0308184C,2217297.54,0.0,,2018,8,3,PAYEMENT,2217297.54,M227341314
33957,409000362497',2018-08-03,Sweep Trf To: 40900036427,165539.0,0.0,,2018,8,3,CASH_OUT,165539.0,C160284738
33958,409000362497',2018-08-04,IMPS 0308181C,2138013.6,0.0,,2018,8,4,PAYEMENT,2138013.6,M1948584732
33959,409000362497',2018-08-04,INDIAIDEAS.COM LTD,49944.0,0.0,,2018,8,4,CHECK_WITHDRAWAL,49944.0,M1855418355
33960,409000362497',2018-08-04,IRCTC CORPORATE OFFICE AC,18935.0,0.0,,2018,8,4,DEBIT,18935.0,M93788461
33961,409000362497',2018-08-04,PAYU PAYMENTS PRIVATE LIM,38228.0,0.0,,2018,8,4,CHECK_WITHDRAWAL,38228.0,C1184748722
33962,409000362497',2018-08-04,BIDDERBOY CORPORATION,870.0,0.0,,2018,8,4,DEBIT,870.0,M1029622903
33963,409000362497',2018-08-04,AVENUES INDIA PRIVATE LIM,4934.0,0.0,,2018,8,4,CHECK_WITHDRAWAL,4934.0,C589951302
33964,409000362497',2018-08-04,MEHAR ENTERTAINMENT PRIVA,1383.0,0.0,,2018,8,4,DEBIT,1383.0,M1027640320
33965,409000362497',2018-08-04,Indiaforensic SERVICES INDIA PVT,234241.0,0.0,,2018,8,4,PAYEMENT,234241.0,M432054553
33966,409000362497',2018-08-04,IMPS 0408182C,1538330.3,0.0,,2018,8,4,CHECK_WITHDRAWAL,1538330.3,M517162922
33967,409000362497',2018-08-04,IMPS 040820183C,3550621.65,0.0,,2018,8,4,CHECK_WITHDRAWAL,3550621.65,C338863747
33968,409000362497',2018-08-04,NEFT/SBIN918216026316/Indfor,0.0,5200000.0,,2018,8,4,CHECK_CASHING,5200000.0,C457880796
33969,409000362497',2018-08-04,FDRL/INTERNAL FUND TRANSFE,0.0,6000000.0,,2018,8,4,TRANSFER,6000000.0,M910824346
33970,409000362497',2018-08-04,FDRL/INTERNAL FUND TRANSFE,0.0,4000000.0,,2018,8,4,CASH_IN,4000000.0,C587820621
33971,409000362497',2018-08-04,IMPS 0408184C,1955864.33,0.0,,2018,8,4,DEBIT,1955864.33,M981738863
33972,409000362497',2018-08-04,Sweep Trf To: 40900036427,313126.0,0.0,,2018,8,4,PAYEMENT,313126.0,C1957476230
33973,409000362497',2018-08-06,IMPS 0408181C,2737311.51,0.0,,2018,8,6,DEBIT,2737311.51,C1768641212
33974,409000362497',2018-08-06,IMPS 0508181C,5321356.51,0.0,,2018,8,6,CASH_OUT,5321356.51,M2127370348
33975,409000362497',2018-08-06,IMPS 0608182C,1869534.21,0.0,,2018,8,6,DEBIT,1869534.21,C2137632979
33976,409000362497',2018-08-06,IMPS 0608183C,3987090.24,0.0,,2018,8,6,PAYEMENT,3987090.24,M843888676
33977,409000362497',2018-08-06,IMPS 0608184C,1913709.58,0.0,,2018,8,6,CASH_OUT,1913709.58,M1533719064
33978,409000362497',2018-08-06,FDRL/INTERNAL FUND TRANSFE,0.0,4000000.0,,2018,8,6,CHECK_CASHING,4000000.0,C441129646
33979,409000362497',2018-08-06,FDRL/INTERNAL FUND TRANSFE,0.0,6000000.0,,2018,8,6,CASH_IN,6000000.0,C314882858
33980,409000362497',2018-08-06,Sweep Trf To: 40900036427,218651.0,0.0,,2018,8,6,CHECK_WITHDRAWAL,218651.0,M1559772469
33981,409000362497',2018-08-07,IMPS 0608181C,1214550.01,0.0,,2018,8,7,DEBIT,1214550.01,C1066166621
33982,409000362497',2018-08-07,IMPS 0708182C,2122848.67,0.0,,2018,8,7,CASH_OUT,2122848.67,C861985771
33983,409000362497',2018-08-07,IMPS 0708183C,4679802.25,0.0,,2018,8,7,PAYEMENT,4679802.25,M1908425345
33984,409000362497',2018-08-07,FDRL/INTERNAL FUND TRANSFE,0.0,6000000.0,,2018,8,7,CASH_IN,6000000.0,C98585229
33985,409000362497',2018-08-07,IMPS 070820184C,2815664.64,0.0,,2018,8,7,PAYEMENT,2815664.64,M1584195721
33986,409000362497',2018-08-07,Sweep Trf To: 40900036427,179556.0,0.0,,2018,8,7,DEBIT,179556.0,C599968109
33987,409000362497',2018-08-08,RTGS/UTIBH18220639517/Indfor,0.0,5100000.0,,2018,8,8,TRANSFER,5100000.0,M372427734
33988,409000362497',2018-08-08,IMPS 0808182C,1134276.56,0.0,,2018,8,8,PAYEMENT,1134276.56,M1500669527
33989,409000362497',2018-08-08,IMPS 0708181C,1150864.26,0.0,,2018,8,8,CASH_OUT,1150864.26,C753926456
33990,409000362497',2018-08-08,NEFT/BARBY18220033231/BOB,0.0,2000.0,,2018,8,8,CASH_IN,2000.0,M1748657260
33991,409000362497',2018-08-08,IMPS 0808183C,3676318.24,0.0,,2018,8,8,CASH_OUT,3676318.24,M829000056
33992,409000362497',2018-08-08,IMPS 0808184C,2786763.02,0.0,,2018,8,8,PAYEMENT,2786763.02,M2038321170
33993,409000362497',2018-08-08,FDRL/INTERNAL FUND TRANSFE,0.0,4000000.0,,2018,8,8,TRANSFER,4000000.0,M554391443
33994,409000362497',2018-08-08,FDRL/INTERNAL FUND TRANSFE,0.0,6000000.0,,2018,8,8,CASH_IN,6000000.0,C488011624
33995,409000362497',2018-08-08,Sweep Trf To: 40900036427,304692.0,0.0,,2018,8,8,CASH_OUT,304692.0,M2000412333
33996,409000362497',2018-08-09,IMPS 0808181C,1298893.65,0.0,,2018,8,9,CHECK_WITHDRAWAL,1298893.65,C1447760423
33997,409000362497',2018-08-09,IMPS 0908182C,1619105.77,0.0,,2018,8,9,CHECK_WITHDRAWAL,1619105.77,M777507543
33998,409000362497',2018-08-09,IMPS 0908183C,3956530.96,0.0,,2018,8,9,DEBIT,3956530.96,M917934318
33999,409000362497',2018-08-09,IMPS 0908184C,821938.63,0.0,,2018,8,9,DEBIT,821938.63,M1369688104
34000,409000362497',2018-08-09,FDRL/INTERNAL FUND TRANSFE,0.0,8000000.0,,2018,8,9,CHECK_CASHING,8000000.0,M1364877046
34001,409000362497',2018-08-09,Sweep Trf To: 40900036427,242512.0,0.0,,2018,8,9,CASH_OUT,242512.0,M1275769473
34002,409000362497',2018-08-10,IMPS 0908181C,941975.41,0.0,,2018,8,10,PAYEMENT,941975.41,M1350474314
34003,409000362497',2018-08-10,IMPS 1008182C,2510648.32,0.0,,2018,8,10,CHECK_WITHDRAWAL,2510648.32,M1956752511
34004,409000362497',2018-08-10,INDIAIDEAS.COM LTD,194693.0,0.0,,2018,8,10,CHECK_WITHDRAWAL,194693.0,M95783655
34005,409000362497',2018-08-10,IRCTC CORPORATE OFFICE AC,83325.0,0.0,,2018,8,10,CASH_OUT,83325.0,M635312915
34006,409000362497',2018-08-10,PAYU PAYMENTS PRIVATE LIM,124445.0,0.0,,2018,8,10,CASH_OUT,124445.0,M1109706040
34007,409000362497',2018-08-10,AVENUES INDIA PRIVATE LIM,8446.0,0.0,,2018,8,10,CHECK_WITHDRAWAL,8446.0,M1733802030
34008,409000362497',2018-08-10,MEHAR ENTERTAINMENT PRIVA,12904.0,0.0,,2018,8,10,CASH_OUT,12904.0,M335971708
34009,409000362497',2018-08-10,ZAAK EPAYMENT SERVICES PR,496.0,0.0,,2018,8,10,CHECK_WITHDRAWAL,496.0,C1312182967
34010,409000362497',2018-08-10,FUTURE RETAIL LIMITED (OW,5233.0,0.0,,2018,8,10,CASH_OUT,5233.0,M1367037017
34011,409000362497',2018-08-10,METRO INFRASYS PRIVATE LI,1394.0,0.0,,2018,8,10,CASH_OUT,1394.0,M49624919
34012,409000362497',2018-08-10,PASFAR TECHNOLOGIES PRIVA,329.0,0.0,,2018,8,10,CHECK_WITHDRAWAL,329.0,C2057894834
34013,409000362497',2018-08-10,JUST DIAL LIMITED,1155.0,0.0,,2018,8,10,CASH_OUT,1155.0,C512626802
34014,409000362497',2018-08-10,QWIKCILVER SOLUTIONS PRIV,9090.0,0.0,,2018,8,10,CHECK_WITHDRAWAL,9090.0,C1245250850
34015,409000362497',2018-08-10,Indiaforensic SERVICES INDIA PVT,924395.0,0.0,,2018,8,10,CHECK_WITHDRAWAL,924395.0,M1970994616
34016,409000362497',2018-08-10,INDIAIDEAS.COM LTD,106974.0,0.0,,2018,8,10,CHECK_WITHDRAWAL,106974.0,M360996980
34017,409000362497',2018-08-10,IRCTC CORPORATE OFFICE AC,22835.0,0.0,,2018,8,10,CHECK_WITHDRAWAL,22835.0,C1832580921
34018,409000362497',2018-08-10,PAYU PAYMENTS PRIVATE LIM,66530.0,0.0,,2018,8,10,DEBIT,66530.0,C523154252
34019,409000362497',2018-08-10,AVENUES INDIA PRIVATE LIM,2584.0,0.0,,2018,8,10,CASH_OUT,2584.0,C666009404
34020,409000362497',2018-08-10,MEHAR ENTERTAINMENT PRIVA,5300.0,0.0,,2018,8,10,CASH_OUT,5300.0,C1075564985
34021,409000362497',2018-08-10,ZAAK EPAYMENT SERVICES PR,496.0,0.0,,2018,8,10,CASH_OUT,496.0,C1633271169
34022,409000362497',2018-08-10,FUTURE RETAIL LIMITED (OW,4171.0,0.0,,2018,8,10,PAYEMENT,4171.0,C1925300085
34023,409000362497',2018-08-10,ALT DIGITAL MEDIA ENTERTA,441.0,0.0,,2018,8,10,DEBIT,441.0,C1893940428
34024,409000362497',2018-08-10,VOUCHER ACTIVATION SERVIC,13122.0,0.0,,2018,8,10,DEBIT,13122.0,C943901945
34025,409000362497',2018-08-10,Indiaforensic SERVICES INDIA PVT,368968.0,0.0,,2018,8,10,CHECK_WITHDRAWAL,368968.0,C1740764606
34026,409000362497',2018-08-10,IMPS 1008183C,4820768.4,0.0,,2018,8,10,DEBIT,4820768.4,C2114147305
34027,409000362497',2018-08-10,NEFT/SBIN418222964484/Indfor,0.0,5500000.0,,2018,8,10,TRANSFER,5500000.0,C593596322
34028,409000362497',2018-08-10,FDRL/INTERNAL FUND TRANSFE,0.0,15000000.0,,2018,8,10,CASH_IN,15000000.0,C408536992
34029,409000362497',2018-08-10,IMPS 822219633401 FROM OX,0.0,200000.0,,2018,8,10,TRANSFER,200000.0,C1446521801
34030,409000362497',2018-08-10,IMPS 822219633435 FROM OX,0.0,200000.0,,2018,8,10,CHECK_CASHING,200000.0,C248609774
34031,409000362497',2018-08-10,IMPS 822219633488 FROM OX,0.0,200000.0,,2018,8,10,CHECK_CASHING,200000.0,C1506782127
34032,409000362497',2018-08-10,IMPS 822219633527 FROM OX,0.0,200000.0,,2018,8,10,CASH_IN,200000.0,C1247658278
34033,409000362497',2018-08-10,IMPS 822219633555 FROM OX,0.0,200000.0,,2018,8,10,CHECK_CASHING,200000.0,C378081024
34034,409000362497',2018-08-10,IMPS 822219633598 FROM OX,0.0,200000.0,,2018,8,10,CASH_IN,200000.0,C97024831
34035,409000362497',2018-08-10,IMPS 822219633635 FROM OX,0.0,200000.0,,2018,8,10,CHECK_CASHING,200000.0,C1141137903
34036,409000362497',2018-08-10,IMPS 822219633737 FROM OX,0.0,200000.0,,2018,8,10,CHECK_CASHING,200000.0,C1245250850
34037,409000362497',2018-08-10,IMPS 822219633774 FROM OX,0.0,200000.0,,2018,8,10,CASH_IN,200000.0,C1245320780
34038,409000362497',2018-08-10,IMPS 822219633830 FROM OX,0.0,200000.0,,2018,8,10,CASH_IN,200000.0,M1910057095
34039,409000362497',2018-08-10,IMPS 822219634291 FROM OX,0.0,200000.0,,2018,8,10,TRANSFER,200000.0,C1164280115
34040,409000362497',2018-08-10,IMPS 822219634326 FROM OX,0.0,200000.0,,2018,8,10,TRANSFER,200000.0,C2065787664
34041,409000362497',2018-08-10,IMPS 822219634361 FROM OX,0.0,200000.0,,2018,8,10,CHECK_CASHING,200000.0,M205601406
34042,409000362497',2018-08-10,IMPS 822219634397 FROM OX,0.0,200000.0,,2018,8,10,TRANSFER,200000.0,M74734903
34043,409000362497',2018-08-10,IMPS 822219634424 FROM OX,0.0,200000.0,,2018,8,10,CHECK_CASHING,200000.0,C1337306552
34044,409000362497',2018-08-10,IMPS 822219634471 FROM OX,0.0,200000.0,,2018,8,10,CHECK_CASHING,200000.0,M816693603
34045,409000362497',2018-08-10,IMPS 822219634624 FROM OX,0.0,200000.0,,2018,8,10,CASH_IN,200000.0,M1375895088
34046,409000362497',2018-08-10,IMPS 822219634664 FROM OX,0.0,200000.0,,2018,8,10,CHECK_CASHING,200000.0,M1997957334
34047,409000362497',2018-08-10,IMPS 822219634697 FROM OX,0.0,200000.0,,2018,8,10,CHECK_CASHING,200000.0,C385990323
34048,409000362497',2018-08-10,IMPS 822219634981 FROM OX,0.0,200000.0,,2018,8,10,TRANSFER,200000.0,M1279914428
34049,409000362497',2018-08-10,IMPS 1008184C,3283387.26,0.0,,2018,8,10,DEBIT,3283387.26,M741823941
34050,409000362497',2018-08-10,Sweep Trf To: 40900036427,333921.0,0.0,,2018,8,10,CHECK_WITHDRAWAL,333921.0,M1522732369
34051,409000362497',2018-08-13,IMPS 1008181C,2876820.18,0.0,,2018,8,13,DEBIT,2876820.18,M796098845
34052,409000362497',2018-08-13,IMPS 1108181C,6640298.53,0.0,,2018,8,13,PAYEMENT,6640298.53,M318606282
34053,409000362497',2018-08-13,IMPS 1208181C,1873310.85,0.0,,2018,8,13,DEBIT,1873310.85,C586009238
34054,409000362497',2018-08-13,IMPS 1308182C,3081285.61,0.0,,2018,8,13,CHECK_WITHDRAWAL,3081285.61,M505181281
34055,409000362497',2018-08-13,ACH DR NATIONAL PAYMENT C,10000.0,0.0,,2018,8,13,PAYEMENT,10000.0,C1227688628
34056,409000362497',2018-08-13,ACH DR NATIONAL PAYMENT C,388.72,0.0,,2018,8,13,PAYEMENT,388.72,C1973538135
34057,409000362497',2018-08-13,IMPS 1308183C,5541964.74,0.0,,2018,8,13,CHECK_WITHDRAWAL,5541964.74,M1851992088
34058,409000362497',2018-08-13,INDIAIDEAS.COM LTD,64207.0,0.0,,2018,8,13,PAYEMENT,64207.0,C1371191175
34059,409000362497',2018-08-13,IRCTC CORPORATE OFFICE AC,55725.0,0.0,,2018,8,13,DEBIT,55725.0,C1833467691
34060,409000362497',2018-08-13,PAYU PAYMENTS PRIVATE LIM,45594.0,0.0,,2018,8,13,PAYEMENT,45594.0,C1142114051
34061,409000362497',2018-08-13,AVENUES INDIA PRIVATE LIM,6561.0,0.0,,2018,8,13,PAYEMENT,6561.0,M719746970
34062,409000362497',2018-08-13,SYNERGISTIC FINANCIAL NET,117.0,0.0,,2018,8,13,DEBIT,117.0,M35588943
34063,409000362497',2018-08-13,ZAAK EPAYMENT SERVICES PR,396.0,0.0,,2018,8,13,DEBIT,396.0,M1793768624
34064,409000362497',2018-08-13,FUTURE RETAIL LIMITED (OW,3616.0,0.0,,2018,8,13,CASH_OUT,3616.0,C1796516928
34065,409000362497',2018-08-13,JUST DIAL LIMITED,784.0,0.0,,2018,8,13,PAYEMENT,784.0,M720258638
34066,409000362497',2018-08-13,MEHAR ENTERTAINMENT PRIVA,11522.0,0.0,,2018,8,13,CASH_OUT,11522.0,C1846690874
34067,409000362497',2018-08-13,ALT DIGITAL MEDIA ENTERTA,98.0,0.0,,2018,8,13,CASH_OUT,98.0,M381347813
34068,409000362497',2018-08-13,Indiaforensic SERVICES INDIA PVT,435566.0,0.0,,2018,8,13,PAYEMENT,435566.0,C1207124317
34069,409000362497',2018-08-13,IMPS 1308184C,2744026.56,0.0,,2018,8,13,DEBIT,2744026.56,M1475417346
34070,409000362497',2018-08-13,FDRL/INTERNAL FUND TRANSFE,0.0,5000000.0,,2018,8,13,CASH_IN,5000000.0,M676289557
34071,409000362497',2018-08-13,FDRL/INTERNAL FUND TRANSFE,0.0,4000000.0,,2018,8,13,CASH_IN,4000000.0,C296230320
34072,409000362497',2018-08-13,NEFT/SBIN618225092285/Indfor,0.0,4400000.0,,2018,8,13,CHECK_CASHING,4400000.0,C1984192708
34073,409000362497',2018-08-13,Sweep Trf To: 40900036427,571492.0,0.0,,2018,8,13,DEBIT,571492.0,M588220169
34074,409000362497',2018-08-14,IMPS 1308181C,1555090.2,0.0,,2018,8,14,PAYEMENT,1555090.2,M1310119106
34075,409000362497',2018-08-14,IMPS 1408182C,2055231.22,0.0,,2018,8,14,PAYEMENT,2055231.22,M1996306112
34076,409000362497',2018-08-14,IRCTC CORPORATE OFFICE AC,18600.0,0.0,,2018,8,14,DEBIT,18600.0,C932634391
34077,409000362497',2018-08-14,PAYU PAYMENTS PRIVATE LIM,19342.0,0.0,,2018,8,14,PAYEMENT,19342.0,C378081024
34078,409000362497',2018-08-14,AVENUES INDIA PRIVATE LIM,170.0,0.0,,2018,8,14,CHECK_WITHDRAWAL,170.0,C1414529337
34079,409000362497',2018-08-14,SYNERGISTIC FINANCIAL NET,98.0,0.0,,2018,8,14,PAYEMENT,98.0,M244921394
34080,409000362497',2018-08-14,ZAAK EPAYMENT SERVICES PR,198.0,0.0,,2018,8,14,DEBIT,198.0,C1921838990
34081,409000362497',2018-08-14,FUTURE RETAIL LIMITED (OW,496.0,0.0,,2018,8,14,CHECK_WITHDRAWAL,496.0,M1962003556
34082,409000362497',2018-08-14,DISH INFRA SERVICES PRIVA,292.0,0.0,,2018,8,14,PAYEMENT,292.0,C397558782
34083,409000362497',2018-08-14,JUST DIAL LIMITED,2092.0,0.0,,2018,8,14,CHECK_WITHDRAWAL,2092.0,C164799505
34084,409000362497',2018-08-14,MEHAR ENTERTAINMENT PRIVA,8641.0,0.0,,2018,8,14,DEBIT,8641.0,M1786951421
34085,409000362497',2018-08-14,Indiaforensic SERVICES INDIA PVT,189543.0,0.0,,2018,8,14,CHECK_WITHDRAWAL,189543.0,M1656720694
34086,409000362497',2018-08-14,IMPS 1408183C,4189678.0,0.0,,2018,8,14,PAYEMENT,4189678.0,C1513521418
34087,409000362497',2018-08-14,NEFT/SBIN718226042144/Indfor,0.0,2100000.0,,2018,8,14,CHECK_CASHING,2100000.0,M128925478
34088,409000362497',2018-08-14,IMPS 1408184C,2903874.24,0.0,,2018,8,14,CASH_OUT,2903874.24,C1801506216
34089,409000362497',2018-08-14,FDRL/INTERNAL FUND TRANSFE,0.0,15000000.0,,2018,8,14,CASH_IN,15000000.0,C312150693
34090,409000362497',2018-08-14,Sweep Trf To: 40900036427,270273.0,0.0,,2018,8,14,PAYEMENT,270273.0,C1383831706
34091,409000362497',2018-08-16,IMPS 1408181C,973966.16,0.0,,2018,8,16,CHECK_WITHDRAWAL,973966.16,C1918600708
34092,409000362497',2018-08-16,IMPS 1508181C,3629316.9,0.0,,2018,8,16,PAYEMENT,3629316.9,C2071722626
34093,409000362497',2018-08-16,IMPS 1608182C,2166108.96,0.0,,2018,8,16,DEBIT,2166108.96,C1015129370
34094,409000362497',2018-08-16,INDIAIDEAS.COM LTD,161354.0,0.0,,2018,8,16,DEBIT,161354.0,M1561028188
34095,409000362497',2018-08-16,IRCTC CORPORATE OFFICE AC,34735.0,0.0,,2018,8,16,PAYEMENT,34735.0,M2019282008
34096,409000362497',2018-08-16,PAYU PAYMENTS PRIVATE LIM,20322.0,0.0,,2018,8,16,CASH_OUT,20322.0,M348238276
34097,409000362497',2018-08-16,AVENUES INDIA PRIVATE LIM,2899.0,0.0,,2018,8,16,CHECK_WITHDRAWAL,2899.0,M2054817730
34098,409000362497',2018-08-16,ZAAK EPAYMENT SERVICES PR,248.0,0.0,,2018,8,16,CHECK_WITHDRAWAL,248.0,M22175005
34099,409000362497',2018-08-16,FUTURE RETAIL LIMITED (OW,4234.0,0.0,,2018,8,16,DEBIT,4234.0,M1583629440
34100,409000362497',2018-08-16,PASFAR TECHNOLOGIES PRIVA,1665.0,0.0,,2018,8,16,PAYEMENT,1665.0,M1912015543
34101,409000362497',2018-08-16,JUST DIAL LIMITED,4999.0,0.0,,2018,8,16,CASH_OUT,4999.0,M690714370
34102,409000362497',2018-08-16,MEHAR ENTERTAINMENT PRIVA,5415.0,0.0,,2018,8,16,CASH_OUT,5415.0,M1925629994
34103,409000362497',2018-08-16,VOUCHER ACTIVATION SERVIC,4356.0,0.0,,2018,8,16,PAYEMENT,4356.0,M1855267876
34104,409000362497',2018-08-16,QWIKCILVER SOLUTIONS PRIV,27955.0,0.0,,2018,8,16,CHECK_WITHDRAWAL,27955.0,M2136271347
34105,409000362497',2018-08-16,QWIKCILVER SOLUTIONS PVT,9.0,0.0,,2018,8,16,PAYEMENT,9.0,M49778669
34106,409000362497',2018-08-16,Indiaforensic SERVICES INDIA PVT,306527.0,0.0,,2018,8,16,CHECK_WITHDRAWAL,306527.0,M1588494886
34107,409000362497',2018-08-16,IMPS 1608183C,4751485.97,0.0,,2018,8,16,PAYEMENT,4751485.97,M79921557
34108,409000362497',2018-08-16,FDRL/INTERNAL FUND TRANSFE,0.0,7000000.0,,2018,8,16,CASH_IN,7000000.0,M1200688992
34109,409000362497',2018-08-16,NEFT/AXIC182287417104/Indfor,0.0,5500000.0,,2018,8,16,CHECK_CASHING,5500000.0,M1248338377
34110,409000362497',2018-08-16,IMPS 1608184C,2490508.82,0.0,,2018,8,16,DEBIT,2490508.82,M1224645867
34111,409000362497',2018-08-16,Sweep Trf To: 40900036427,450670.0,0.0,,2018,8,16,CHECK_WITHDRAWAL,450670.0,M1869155755
34112,409000362497',2018-08-17,IMPS 1608181C,2213652.4,0.0,,2018,8,17,CHECK_WITHDRAWAL,2213652.4,C1671572721
34113,409000362497',2018-08-17,IMPS 1708182C,1517966.24,0.0,,2018,8,17,PAYEMENT,1517966.24,M1261731166
34114,409000362497',2018-08-17,IMPS 1708183C,2996275.86,0.0,,2018,8,17,PAYEMENT,2996275.86,C593596322
34115,409000362497',2018-08-17,IMPS 1708184C,866239.73,0.0,,2018,8,17,PAYEMENT,866239.73,C17820769
34116,409000362497',2018-08-17,FDRL/INTERNAL FUND TRANSFE,0.0,7000000.0,,2018,8,17,CASH_IN,7000000.0,C1615443145
34117,409000362497',2018-08-17,Sweep Trf To: 40900036427,173151.0,0.0,,2018,8,17,DEBIT,173151.0,C432416411
34118,409000362497',2018-08-18,INDIAIDEAS.COM LTD,83204.0,0.0,,2018,8,18,CASH_OUT,83204.0,C1839671644
34119,409000362497',2018-08-18,IRCTC CORPORATE OFFICE AC,8010.0,0.0,,2018,8,18,CASH_OUT,8010.0,C1469084143
34120,409000362497',2018-08-18,AVENUES INDIA PRIVATE LIM,9193.0,0.0,,2018,8,18,CHECK_WITHDRAWAL,9193.0,C1927693388
34121,409000362497',2018-08-18,DISH INFRA SERVICES PRIVA,1172.0,0.0,,2018,8,18,PAYEMENT,1172.0,C917768476
34122,409000362497',2018-08-18,JUST DIAL LIMITED,2226.0,0.0,,2018,8,18,PAYEMENT,2226.0,C1575675375
34123,409000362497',2018-08-18,MEHAR ENTERTAINMENT PRIVA,5069.0,0.0,,2018,8,18,PAYEMENT,5069.0,C1373467808
34124,409000362497',2018-08-18,Indiaforensic SERVICES INDIA PVT,165659.0,0.0,,2018,8,18,CHECK_WITHDRAWAL,165659.0,C1137247436
34125,409000362497',2018-08-18,IMPS 1708181C,1443050.03,0.0,,2018,8,18,CHECK_WITHDRAWAL,1443050.03,C488044861
34126,409000362497',2018-08-18,IMPS 1808182C,1562863.92,0.0,,2018,8,18,DEBIT,1562863.92,C1395746279
34127,409000362497',2018-08-18,IMPS 1808183C,3827540.65,0.0,,2018,8,18,CHECK_WITHDRAWAL,3827540.65,C1137371968
34128,409000362497',2018-08-18,FDRL/INTERNAL FUND TRANSFE,0.0,4000000.0,,2018,8,18,TRANSFER,4000000.0,C728526866
34129,409000362497',2018-08-18,FDRL/INTERNAL FUND TRANSFE,0.0,7000000.0,,2018,8,18,CHECK_CASHING,7000000.0,C124023321
34130,409000362497',2018-08-18,FDRL/INTERNAL FUND TRANSFE,0.0,500000.0,,2018,8,18,TRANSFER,500000.0,C1185298063
34131,409000362497',2018-08-18,FDRL/INTERNAL FUND TRANSFE,0.0,500000.0,,2018,8,18,CHECK_CASHING,500000.0,C323984287
34132,409000362497',2018-08-18,FDRL/INTERNAL FUND TRANSFE,0.0,500000.0,,2018,8,18,TRANSFER,500000.0,C2109470512
34133,409000362497',2018-08-18,IMPS 1808184C,2148822.41,0.0,,2018,8,18,CHECK_WITHDRAWAL,2148822.41,C1050758685
34134,409000362497',2018-08-18,Sweep Trf To: 40900036427,181061.0,0.0,,2018,8,18,PAYEMENT,181061.0,C1979563377
34135,409000362497',2018-08-20,IMPS 1808181C,2175972.52,0.0,,2018,8,20,CASH_OUT,2175972.52,C910539221
34136,409000362497',2018-08-20,IMPS 1908181C,1983484.66,0.0,,2018,8,20,CHECK_WITHDRAWAL,1983484.66,C1994035663
34137,409000362497',2018-08-20,IMPS 2008182C2C,2138152.01,0.0,,2018,8,20,CASH_OUT,2138152.01,C1277716905
34138,409000362497',2018-08-20,IMPS 2008183C,4872862.15,0.0,,2018,8,20,CHECK_WITHDRAWAL,4872862.15,C383296094
34139,409000362497',2018-08-20,INDIAIDEAS.COM LTD,113293.0,0.0,,2018,8,20,CASH_OUT,113293.0,C1716892902
34140,409000362497',2018-08-20,PAYU PAYMENTS PRIVATE LIM,65029.0,0.0,,2018,8,20,CASH_OUT,65029.0,C580735116
34141,409000362497',2018-08-20,BIDDERBOY CORPORATION,877.0,0.0,,2018,8,20,DEBIT,877.0,C1014154376
34142,409000362497',2018-08-20,AVENUES INDIA PRIVATE LIM,77015.0,0.0,,2018,8,20,CASH_OUT,77015.0,C2042962245
34143,409000362497',2018-08-20,ZAAK EPAYMENT SERVICES PR,298.0,0.0,,2018,8,20,CHECK_WITHDRAWAL,298.0,C575233839
34144,409000362497',2018-08-20,FUTURE RETAIL LIMITED (OW,2621.0,0.0,,2018,8,20,CASH_OUT,2621.0,C503485607
34145,409000362497',2018-08-20,PASFAR TECHNOLOGIES PRIVA,98.0,0.0,,2018,8,20,CASH_OUT,98.0,C1028574311
34146,409000362497',2018-08-20,JUST DIAL LIMITED,5240.0,0.0,,2018,8,20,CHECK_WITHDRAWAL,5240.0,C1329589315
34147,409000362497',2018-08-20,MEHAR ENTERTAINMENT PRIVA,19702.0,0.0,,2018,8,20,CHECK_WITHDRAWAL,19702.0,C258825018
34148,409000362497',2018-08-20,ALT DIGITAL MEDIA ENTERTA,98.0,0.0,,2018,8,20,CHECK_WITHDRAWAL,98.0,C1406749291
34149,409000362497',2018-08-20,Indiaforensic SERVICES INDIA PVT,381654.0,0.0,,2018,8,20,PAYEMENT,381654.0,C1461788950
34150,409000362497',2018-08-20,FDRL/INTERNAL FUND TRANSFE,0.0,6000000.0,,2018,8,20,TRANSFER,6000000.0,C104012589
34151,409000362497',2018-08-20,FDRL/INTERNAL FUND TRANSFE,0.0,4000000.0,,2018,8,20,CASH_IN,4000000.0,C1251686742
34152,409000362497',2018-08-20,FDRL/INTERNAL FUND TRANSFE,0.0,2000000.0,,2018,8,20,CHECK_CASHING,2000000.0,C820920634
34153,409000362497',2018-08-20,IMPS 2008184C,2627084.69,0.0,,2018,8,20,CASH_OUT,2627084.69,C1378215782
34154,409000362497',2018-08-20,Sweep Trf To: 40900036427,376250.0,0.0,,2018,8,20,CHECK_WITHDRAWAL,376250.0,C762558455
34155,409000362497',2018-08-21,IMPS 2008181C,2569800.04,0.0,,2018,8,21,CHECK_WITHDRAWAL,2569800.04,C1955298108
34156,409000362497',2018-08-21,IMPS 2108182C,1329253.17,0.0,,2018,8,21,CASH_OUT,1329253.17,C1813848798
34157,409000362497',2018-08-21,INDIAIDEAS.COM LTD,53191.0,0.0,,2018,8,21,CASH_OUT,53191.0,C982891593
34158,409000362497',2018-08-21,PAYU PAYMENTS PRIVATE LIM,15147.0,0.0,,2018,8,21,DEBIT,15147.0,C160284738
34159,409000362497',2018-08-21,AVENUES INDIA PRIVATE LIM,3410.0,0.0,,2018,8,21,PAYEMENT,3410.0,C1371191175
34160,409000362497',2018-08-21,SYNERGISTIC FINANCIAL NET,3922.0,0.0,,2018,8,21,CASH_OUT,3922.0,C1848759565
34161,409000362497',2018-08-21,FUTURE RETAIL LIMITED (OW,272.0,0.0,,2018,8,21,PAYEMENT,272.0,C1128238842
34162,409000362497',2018-08-21,JUST DIAL LIMITED,586.0,0.0,,2018,8,21,PAYEMENT,586.0,C627675433
34163,409000362497',2018-08-21,MEHAR ENTERTAINMENT PRIVA,8065.0,0.0,,2018,8,21,CHECK_WITHDRAWAL,8065.0,C1522918252
34164,409000362497',2018-08-21,VOUCHER ACTIVATION SERVIC,10381.0,0.0,,2018,8,21,CHECK_WITHDRAWAL,10381.0,C222020906
34165,409000362497',2018-08-21,QWIKCILVER SOLUTIONS PRIV,5257.0,0.0,,2018,8,21,CASH_OUT,5257.0,C1583245323
34166,409000362497',2018-08-21,Indiaforensic SERVICES INDIA PVT,158359.0,0.0,,2018,8,21,DEBIT,158359.0,C1511598070
34167,409000362497',2018-08-21,IMPS 2108183C,3500215.21,0.0,,2018,8,21,CASH_OUT,3500215.21,C560041895
34168,409000362497',2018-08-21,IMPS 2108184C,2682426.57,0.0,,2018,8,21,CASH_OUT,2682426.57,C427998326
34169,409000362497',2018-08-21,FDRL/INTERNAL FUND TRANSFE,0.0,8000000.0,,2018,8,21,CHECK_CASHING,8000000.0,C79685693
34170,409000362497',2018-08-21,FDRL/INTERNAL FUND TRANSFE,0.0,3000000.0,,2018,8,21,CASH_IN,3000000.0,M748195302
34171,409000362497',2018-08-21,Sweep Trf To: 40900036427,226015.0,0.0,,2018,8,21,CASH_OUT,226015.0,M973816239
34172,409000362497',2018-08-22,IMPS 823416590829 FROM OX,0.0,100000.0,,2018,8,22,CASH_IN,100000.0,M1639698970
34173,409000362497',2018-08-22,IMPS 823416590854 FROM OX,0.0,200000.0,,2018,8,22,CHECK_CASHING,200000.0,M9609636
34174,409000362497',2018-08-22,IMPS 823416590884 FROM OX,0.0,200000.0,,2018,8,22,CASH_IN,200000.0,C715907650
34175,409000362497',2018-08-23,IMPS 2108181C,1259078.17,0.0,,2018,8,23,PAYEMENT,1259078.17,M1457903190
34176,409000362497',2018-08-23,IMPS 2208181C,2680764.33,0.0,,2018,8,23,PAYEMENT,2680764.33,M1844055647
34177,409000362497',2018-08-23,IMPS 2308182C,2445060.75,0.0,,2018,8,23,DEBIT,2445060.75,M632266993
34178,409000362497',2018-08-23,PAYU PAYMENTS PRIVATE LIM,43951.0,0.0,,2018,8,23,CASH_OUT,43951.0,M634231269
34179,409000362497',2018-08-23,AVENUES INDIA PRIVATE LIM,5291.0,0.0,,2018,8,23,CHECK_WITHDRAWAL,5291.0,M607605630
34180,409000362497',2018-08-23,ZAAK EPAYMENT SERVICES PR,524.0,0.0,,2018,8,23,PAYEMENT,524.0,M845766133
34181,409000362497',2018-08-23,FUTURE RETAIL LIMITED (OW,463.0,0.0,,2018,8,23,CHECK_WITHDRAWAL,463.0,M1849645183
34182,409000362497',2018-08-23,PASFAR TECHNOLOGIES PRIVA,49.0,0.0,,2018,8,23,CHECK_WITHDRAWAL,49.0,M2046903275
34183,409000362497',2018-08-23,JUST DIAL LIMITED,2601.0,0.0,,2018,8,23,PAYEMENT,2601.0,M1957895581
34184,409000362497',2018-08-23,MEHAR ENTERTAINMENT PRIVA,10024.0,0.0,,2018,8,23,CHECK_WITHDRAWAL,10024.0,M2145152425
34185,409000362497',2018-08-23,Indiaforensic SERVICES INDIA PVT,270285.0,0.0,,2018,8,23,DEBIT,270285.0,M694445132
34186,409000362497',2018-08-23,IMPS 2308183C,4173835.34,0.0,,2018,8,23,DEBIT,4173835.34,M690621938
34187,409000362497',2018-08-23,FDRL/INTERNAL FUND TRANSFE,0.0,500000.0,,2018,8,23,CHECK_CASHING,500000.0,M1493075313
34188,409000362497',2018-08-23,FDRL/INTERNAL FUND TRANSFE,0.0,8000000.0,,2018,8,23,CASH_IN,8000000.0,M682805905
34189,409000362497',2018-08-23,IMPS 2308184C,1684296.65,0.0,,2018,8,23,CHECK_WITHDRAWAL,1684296.65,M1087792692
34190,409000362497',2018-08-23,Sweep Trf To: 40900036427,197236.0,0.0,,2018,8,23,DEBIT,197236.0,M1600614133
34191,409000362497',2018-08-24,IMPS 2308181C,651933.71,0.0,,2018,8,24,DEBIT,651933.71,M1028892469
34192,409000362497',2018-08-24,IMPS 2408182C,1089973.98,0.0,,2018,8,24,CHECK_WITHDRAWAL,1089973.98,M1178051387
34193,409000362497',2018-08-24,IMPS 2408183C,3324965.61,0.0,,2018,8,24,PAYEMENT,3324965.61,M338690096
34194,409000362497',2018-08-24,INDIAIDEAS.COM LTD,110506.0,0.0,,2018,8,24,PAYEMENT,110506.0,M1452632815
34195,409000362497',2018-08-24,PAYU PAYMENTS PRIVATE LIM,14710.0,0.0,,2018,8,24,DEBIT,14710.0,M632416993
34196,409000362497',2018-08-24,AVENUES INDIA PRIVATE LIM,1841.0,0.0,,2018,8,24,DEBIT,1841.0,C394372500
34197,409000362497',2018-08-24,ZAAK EPAYMENT SERVICES PR,198.0,0.0,,2018,8,24,DEBIT,198.0,M1734252862
34198,409000362497',2018-08-24,FUTURE RETAIL LIMITED (OW,5516.0,0.0,,2018,8,24,DEBIT,5516.0,C171736508
34199,409000362497',2018-08-24,METRO INFRASYS PRIVATE LI,697.0,0.0,,2018,8,24,CASH_OUT,697.0,C1647809929
34200,409000362497',2018-08-24,PASFAR TECHNOLOGIES PRIVA,98.0,0.0,,2018,8,24,CASH_OUT,98.0,M1562667753
34201,409000362497',2018-08-24,DISH INFRA SERVICES PRIVA,1523.0,0.0,,2018,8,24,CASH_OUT,1523.0,C643585161
34202,409000362497',2018-08-24,JUST DIAL LIMITED,1584.0,0.0,,2018,8,24,PAYEMENT,1584.0,M502418030
34203,409000362497',2018-08-24,MEHAR ENTERTAINMENT PRIVA,4724.0,0.0,,2018,8,24,CASH_OUT,4724.0,C1649563001
34204,409000362497',2018-08-24,Indiaforensic SERVICES INDIA PVT,149259.0,0.0,,2018,8,24,CHECK_WITHDRAWAL,149259.0,M553299237
34205,409000362497',2018-08-24,NEFT/SBIN418236069325/Indfor,0.0,2600000.0,,2018,8,24,TRANSFER,2600000.0,C474170199
34206,409000362497',2018-08-24,FDRL/INTERNAL FUND TRANSFE,0.0,5000000.0,,2018,8,24,CASH_IN,5000000.0,C1860434997
34207,409000362497',2018-08-24,IMPS 2408184C,1908796.56,0.0,,2018,8,24,CASH_OUT,1908796.56,M79743243
34208,409000362497',2018-08-24,IMPS 823620172372 FROM OX,0.0,200000.0,,2018,8,24,CHECK_CASHING,200000.0,M1015930769
34209,409000362497',2018-08-24,IMPS 823620172399 FROM OX,0.0,200000.0,,2018,8,24,TRANSFER,200000.0,M2045431248
34210,409000362497',2018-08-24,IMPS 823620172423 FROM OX,0.0,200000.0,,2018,8,24,CASH_IN,200000.0,C1067413548
34211,409000362497',2018-08-24,IMPS 823620172457 FROM OX,0.0,200000.0,,2018,8,24,CASH_IN,200000.0,C783723634
34212,409000362497',2018-08-24,IMPS 823620172483 FROM OX,0.0,200000.0,,2018,8,24,CASH_IN,200000.0,C863811613
34213,409000362497',2018-08-24,IMPS 823620172507 FROM OX,0.0,200000.0,,2018,8,24,TRANSFER,200000.0,M882022301
34214,409000362497',2018-08-24,IMPS 823620172527 FROM OX,0.0,200000.0,,2018,8,24,TRANSFER,200000.0,C842729010
34215,409000362497',2018-08-24,IMPS 823620172884 FROM OX,0.0,200000.0,,2018,8,24,TRANSFER,200000.0,C2048360109
34216,409000362497',2018-08-24,IMPS 823620172924 FROM OX,0.0,200000.0,,2018,8,24,CASH_IN,200000.0,C1388182036
34217,409000362497',2018-08-24,IMPS 823620172959 FROM OX,0.0,200000.0,,2018,8,24,TRANSFER,200000.0,M1065951785
34218,409000362497',2018-08-24,IMPS 823620172988 FROM OX,0.0,200000.0,,2018,8,24,CASH_IN,200000.0,M497770581
34219,409000362497',2018-08-24,IMPS 823620173024 FROM OX,0.0,200000.0,,2018,8,24,CHECK_CASHING,200000.0,M1401347367
34220,409000362497',2018-08-24,IMPS 823620173063 FROM OX,0.0,200000.0,,2018,8,24,TRANSFER,200000.0,M571148814
34221,409000362497',2018-08-24,IMPS 823620173096 FROM OX,0.0,200000.0,,2018,8,24,CHECK_CASHING,200000.0,M601053564
34222,409000362497',2018-08-24,IMPS 823620173136 FROM OX,0.0,200000.0,,2018,8,24,CASH_IN,200000.0,M518599547
34223,409000362497',2018-08-24,IMPS 823620173160 FROM OX,0.0,200000.0,,2018,8,24,CASH_IN,200000.0,C395525501
34224,409000362497',2018-08-24,IMPS 823620173193 FROM OX,0.0,200000.0,,2018,8,24,CHECK_CASHING,200000.0,C986657342
34225,409000362497',2018-08-24,IMPS 823620173416 FROM OX,0.0,200000.0,,2018,8,24,CHECK_CASHING,200000.0,C766681183
34226,409000362497',2018-08-24,IMPS 823620173456 FROM OX,0.0,200000.0,,2018,8,24,CASH_IN,200000.0,C1238707698
34227,409000362497',2018-08-24,IMPS 823620173525 FROM OX,0.0,200000.0,,2018,8,24,CASH_IN,200000.0,C527599317
34228,409000362497',2018-08-24,IMPS 823620173731 FROM OX,0.0,200000.0,,2018,8,24,CASH_IN,200000.0,C1778801068
34229,409000362497',2018-08-24,IMPS 823620173831 FROM OX,0.0,200000.0,,2018,8,24,CASH_IN,200000.0,C2106812355
34230,409000362497',2018-08-24,IMPS 823620174107 FROM OX,0.0,200000.0,,2018,8,24,TRANSFER,200000.0,C1060563153
34231,409000362497',2018-08-24,IMPS 823620174137 FROM OX,0.0,200000.0,,2018,8,24,CASH_IN,200000.0,C897209100
34232,409000362497',2018-08-24,IMPS 823620174169 FROM OX,0.0,200000.0,,2018,8,24,TRANSFER,200000.0,C1577420620
34233,409000362497',2018-08-24,Sweep Trf To: 40900036427,143160.0,0.0,,2018,8,24,DEBIT,143160.0,C1971344738
34234,409000362497',2018-08-27,IMPS 2408181C,709081.13,0.0,,2018,8,27,CASH_OUT,709081.13,C1771469594
34235,409000362497',2018-08-27,IMPS 2508181C,1905735.42,0.0,,2018,8,27,CHECK_WITHDRAWAL,1905735.42,C362585233
34236,409000362497',2018-08-27,IMPS 2608181C,1112452.64,0.0,,2018,8,27,CASH_OUT,1112452.64,C1682576062
34237,409000362497',2018-08-27,IMPS 2708182C,1796642.78,0.0,,2018,8,27,CASH_OUT,1796642.78,C1829109420
34238,409000362497',2018-08-27,PAYU PAYMENTS PRIVATE LIM,23178.0,0.0,,2018,8,27,PAYEMENT,23178.0,C58642425
34239,409000362497',2018-08-27,AVENUES INDIA PRIVATE LIM,18134.0,0.0,,2018,8,27,CHECK_WITHDRAWAL,18134.0,C909295153
34240,409000362497',2018-08-27,ZAAK EPAYMENT SERVICES PR,357.0,0.0,,2018,8,27,PAYEMENT,357.0,C1570076320
34241,409000362497',2018-08-27,FUTURE RETAIL LIMITED (OW,4602.0,0.0,,2018,8,27,CASH_OUT,4602.0,C1052117080
34242,409000362497',2018-08-27,JUST DIAL LIMITED,5333.0,0.0,,2018,8,27,PAYEMENT,5333.0,C409975763
34243,409000362497',2018-08-27,MEHAR ENTERTAINMENT PRIVA,15093.0,0.0,,2018,8,27,PAYEMENT,15093.0,C1481468605
34244,409000362497',2018-08-27,Indiaforensic SERVICES INDIA PVT,365840.0,0.0,,2018,8,27,DEBIT,365840.0,C1309400551
34245,409000362497',2018-08-27,IMPS 2708183C,3816509.55,0.0,,2018,8,27,CASH_OUT,3816509.55,C312150693
34246,409000362497',2018-08-27,IMPS 2708184C,1732850.1,0.0,,2018,8,27,DEBIT,1732850.1,C232834050
34247,409000362497',2018-08-27,FDRL/INTERNAL FUND TRANSFE,0.0,6000000.0,,2018,8,27,CASH_IN,6000000.0,C208427878
34248,409000362497',2018-08-27,FDRL/INTERNAL FUND TRANSFE,0.0,1000000.0,,2018,8,27,CHECK_CASHING,1000000.0,C1851668139
34249,409000362497',2018-08-27,Sweep Trf To: 40900036427,214920.0,0.0,,2018,8,27,PAYEMENT,214920.0,C892981061
34250,409000362497',2018-08-28,IMPS 2708181C,1368378.05,0.0,,2018,8,28,DEBIT,1368378.05,C1341043251
34251,409000362497',2018-08-28,IMPS 2808182C,705163.72,0.0,,2018,8,28,DEBIT,705163.72,C1749476584
34252,409000362497',2018-08-28,FDRL/INTERNAL FUND TRANSFE,0.0,1000000.0,,2018,8,28,CASH_IN,1000000.0,C173247103
34253,409000362497',2018-08-28,FDRL/INTERNAL FUND TRANSFE,0.0,1000000.0,,2018,8,28,TRANSFER,1000000.0,C1219273867
34254,409000362497',2018-08-28,IMPS 2808183C,2557538.72,0.0,,2018,8,28,PAYEMENT,2557538.72,C193229257
34255,409000362497',2018-08-28,FDRL/INTERNAL FUND TRANSFE,0.0,5000000.0,,2018,8,28,CHECK_CASHING,5000000.0,M1494575732
34256,409000362497',2018-08-28,FDRL/INTERNAL FUND TRANSFE,0.0,1000000.0,,2018,8,28,TRANSFER,1000000.0,C1608602720
34257,409000362497',2018-08-28,FDRL/INTERNAL FUND TRANSFE,0.0,1000000.0,,2018,8,28,TRANSFER,1000000.0,C1779792798
34258,409000362497',2018-08-28,IMPS 2808184C,1852976.34,0.0,,2018,8,28,CHECK_WITHDRAWAL,1852976.34,M1517655665
34259,409000362497',2018-08-28,Sweep Trf To: 40900036427,215800.0,0.0,,2018,8,28,DEBIT,215800.0,C483287972
34260,409000362497',2018-08-29,INDIAIDEAS.COM LTD,71164.0,0.0,,2018,8,29,CASH_OUT,71164.0,C1860434997
34261,409000362497',2018-08-29,PAYU PAYMENTS PRIVATE LIM,1886.0,0.0,,2018,8,29,DEBIT,1886.0,C1279610437
34262,409000362497',2018-08-29,SYNERGISTIC FINANCIAL NET,1624.0,0.0,,2018,8,29,PAYEMENT,1624.0,C829354638
34263,409000362497',2018-08-29,JUST DIAL LIMITED,2200.0,0.0,,2018,8,29,DEBIT,2200.0,M972227497
34264,409000362497',2018-08-29,MEHAR ENTERTAINMENT PRIVA,4839.0,0.0,,2018,8,29,DEBIT,4839.0,M1237847148
34265,409000362497',2018-08-29,QWIKCILVER SOLUTIONS PRIV,4177.0,0.0,,2018,8,29,DEBIT,4177.0,C1399657787
34266,409000362497',2018-08-29,QWIKCILVER SOLUTIONS PRIV,2653.0,0.0,,2018,8,29,CHECK_WITHDRAWAL,2653.0,M1971162159
34267,409000362497',2018-08-29,Indiaforensic SERVICES INDIA PVT,149560.0,0.0,,2018,8,29,CHECK_WITHDRAWAL,149560.0,M1299231142
34268,409000362497',2018-08-29,IMPS 2808181C,1430230.79,0.0,,2018,8,29,PAYEMENT,1430230.79,C1692014125
34269,409000362497',2018-08-29,IMPS 2908182C,815207.02,0.0,,2018,8,29,DEBIT,815207.02,M1059539452
34270,409000362497',2018-08-29,IMPS 2908183C,2511748.53,0.0,,2018,8,29,CHECK_WITHDRAWAL,2511748.53,C51626955
34271,409000362497',2018-08-29,FDRL/INTERNAL FUND TRANSFE,0.0,500000.0,,2018,8,29,TRANSFER,500000.0,C607702142
34272,409000362497',2018-08-29,FDRL/INTERNAL FUND TRANSFE,0.0,5000000.0,,2018,8,29,CASH_IN,5000000.0,M1143664490
34273,409000362497',2018-08-29,IMPS 2908184C,1888775.29,0.0,,2018,8,29,DEBIT,1888775.29,M390925385
34274,409000362497',2018-08-29,Sweep Trf To: 40900036427,168320.0,0.0,,2018,8,29,CHECK_WITHDRAWAL,168320.0,C721267591
34275,409000362497',2018-08-30,IMPS 2908181C,668799.29,0.0,,2018,8,30,DEBIT,668799.29,C934085675
34276,409000362497',2018-08-30,IMPS 3008182C,1552107.0,0.0,,2018,8,30,DEBIT,1552107.0,M1546691969
34277,409000362497',2018-08-30,INDIAIDEAS.COM LTD,37297.0,0.0,,2018,8,30,DEBIT,37297.0,C829354638
34278,409000362497',2018-08-30,PAYU PAYMENTS PRIVATE LIM,28374.0,0.0,,2018,8,30,CASH_OUT,28374.0,M2105351184
34279,409000362497',2018-08-30,AVENUES INDIA PRIVATE LIM,2026.0,0.0,,2018,8,30,PAYEMENT,2026.0,C1725025770
34280,409000362497',2018-08-30,FUTURE RETAIL LIMITED (OW,3460.0,0.0,,2018,8,30,CHECK_WITHDRAWAL,3460.0,M1023265006
34281,409000362497',2018-08-30,DISH INFRA SERVICES PRIVA,98.0,0.0,,2018,8,30,CHECK_WITHDRAWAL,98.0,C486108916
34282,409000362497',2018-08-30,JUST DIAL LIMITED,980.0,0.0,,2018,8,30,DEBIT,980.0,C1428469551
34283,409000362497',2018-08-30,MEHAR ENTERTAINMENT PRIVA,4839.0,0.0,,2018,8,30,DEBIT,4839.0,C36553668
34284,409000362497',2018-08-30,VOUCHER ACTIVATION SERVIC,4382.0,0.0,,2018,8,30,PAYEMENT,4382.0,M655661121
34285,409000362497',2018-08-30,ZAAK EPAYMENT SERVICES PR,198.0,0.0,,2018,8,30,CHECK_WITHDRAWAL,198.0,C669771073
34286,409000362497',2018-08-30,Indiaforensic SERVICES INDIA PVT,172055.0,0.0,,2018,8,30,PAYEMENT,172055.0,C1120735174
34287,409000362497',2018-08-30,IMPS 3008183C,3028592.36,0.0,,2018,8,30,DEBIT,3028592.36,M939939934
34288,409000362497',2018-08-30,NEFT/N242180143674200/IRC,0.0,724315.0,,2018,8,30,CASH_IN,724315.0,C146305349
34289,409000362497',2018-08-30,FDRL/INTERNAL FUND TRANSFE,0.0,500000.0,,2018,8,30,CHECK_CASHING,500000.0,C1938348365
34290,409000362497',2018-08-30,FDRL/INTERNAL FUND TRANSFE,0.0,1000000.0,,2018,8,30,CHECK_CASHING,1000000.0,C921733929
34291,409000362497',2018-08-30,FDRL/INTERNAL FUND TRANSFE,0.0,1000000.0,,2018,8,30,CHECK_CASHING,1000000.0,M899166161
34292,409000362497',2018-08-30,FDRL/INTERNAL FUND TRANSFE,0.0,1000000.0,,2018,8,30,CASH_IN,1000000.0,C749013731
34293,409000362497',2018-08-30,FDRL/INTERNAL FUND TRANSFE,0.0,5000000.0,,2018,8,30,CHECK_CASHING,5000000.0,C1643217922
34294,409000362497',2018-08-30,IMPS 3008184C,1827586.91,0.0,,2018,8,30,CHECK_WITHDRAWAL,1827586.91,M1858084797
34295,409000362497',2018-08-30,Sweep Trf To: 40900036427,145840.0,0.0,,2018,8,30,CASH_OUT,145840.0,C252626745
34296,409000362497',2018-08-31,IMPS 3008181C,1015870.68,0.0,,2018,8,31,PAYEMENT,1015870.68,C26334874
34297,409000362497',2018-08-31,IMPS 3108182C,1217518.9,0.0,,2018,8,31,PAYEMENT,1217518.9,C1957476230
34298,409000362497',2018-08-31,INDIAIDEAS.COM LTD,59220.0,0.0,,2018,8,31,CHECK_WITHDRAWAL,59220.0,C1921483039
34299,409000362497',2018-08-31,PAYU PAYMENTS PRIVATE LIM,10780.0,0.0,,2018,8,31,CHECK_WITHDRAWAL,10780.0,M793549317
34300,409000362497',2018-08-31,AVENUES INDIA PRIVATE LIM,5666.0,0.0,,2018,8,31,PAYEMENT,5666.0,M1606549065
34301,409000362497',2018-08-31,FUTURE RETAIL LIMITED (OW,1098.0,0.0,,2018,8,31,PAYEMENT,1098.0,M2086402598
34302,409000362497',2018-08-31,MEHAR ENTERTAINMENT PRIVA,4378.0,0.0,,2018,8,31,PAYEMENT,4378.0,C1790096045
34303,409000362497',2018-08-31,ZAAK EPAYMENT SERVICES PR,397.0,0.0,,2018,8,31,PAYEMENT,397.0,C1388298612
34304,409000362497',2018-08-31,ALT DIGITAL MEDIA ENTERTA,98.0,0.0,,2018,8,31,CASH_OUT,98.0,C1432387181
34305,409000362497',2018-08-31,Indiaforensic SERVICES INDIA PVT,111524.0,0.0,,2018,8,31,CASH_OUT,111524.0,C1335946878
34306,409000362497',2018-08-31,IMPS 2308183C,3322538.08,0.0,,2018,8,31,CHECK_WITHDRAWAL,3322538.08,C196598321
34307,409000362497',2018-08-31,FDRL/INTERNAL FUND TRANSFE,0.0,500000.0,,2018,8,31,CHECK_CASHING,500000.0,C1945740508
34308,409000362497',2018-08-31,FDRL/INTERNAL FUND TRANSFE,0.0,500000.0,,2018,8,31,CHECK_CASHING,500000.0,C1669259232
34309,409000362497',2018-08-31,FDRL/INTERNAL FUND TRANSFE,0.0,5000000.0,,2018,8,31,CASH_IN,5000000.0,C432744903
34310,409000362497',2018-08-31,FDRL/INTERNAL FUND TRANSFE,0.0,500000.0,,2018,8,31,TRANSFER,500000.0,C762558455
34311,409000362497',2018-08-31,FDRL/INTERNAL FUND TRANSFE,0.0,500000.0,,2018,8,31,CHECK_CASHING,500000.0,C1146719991
34312,409000362497',2018-08-31,IMPS 3108184C,1031590.33,0.0,,2018,8,31,PAYEMENT,1031590.33,C1268745115
34313,409000362497',2018-08-31,Sweep Trf To: 40900036427,89145.0,0.0,,2018,8,31,CASH_OUT,89145.0,C1872715121
34314,409000362497',2018-09-01,IMPS 3108181C,910446.2,0.0,,2018,9,1,CHECK_WITHDRAWAL,910446.2,C1196307684
34315,409000362497',2018-09-01,IMPS 0109182C,2373661.87,0.0,,2018,9,1,CHECK_WITHDRAWAL,2373661.87,C1898885237
34316,409000362497',2018-09-01,IMPS 0109183C,2822448.28,0.0,,2018,9,1,CASH_OUT,2822448.28,C170503405
34317,409000362497',2018-09-01,FDRL/INTERNAL FUND TRANSFE,0.0,3000000.0,,2018,9,1,TRANSFER,3000000.0,C284399568
34318,409000362497',2018-09-01,FDRL/INTERNAL FUND TRANSFE,0.0,500000.0,,2018,9,1,CHECK_CASHING,500000.0,C2103065350
34319,409000362497',2018-09-01,FDRL/INTERNAL FUND TRANSFE,0.0,5000000.0,,2018,9,1,TRANSFER,5000000.0,C715007517
34320,409000362497',2018-09-01,IMPS 0109184C,750532.98,0.0,,2018,9,1,CHECK_WITHDRAWAL,750532.98,C1355760696
34321,409000362497',2018-09-01,Sweep Trf To: 40900036427,38520.0,0.0,,2018,9,1,CHECK_WITHDRAWAL,38520.0,C235386075
34322,409000362497',2018-09-03,IMPS 0109181C,997147.55,0.0,,2018,9,3,DEBIT,997147.55,C708099852
34323,409000362497',2018-09-03,IMPS 0209181C,1487220.45,0.0,,2018,9,3,CHECK_WITHDRAWAL,1487220.45,C1661048214
34324,409000362497',2018-09-03,IMPS 0309182C,2276026.27,0.0,,2018,9,3,CASH_OUT,2276026.27,C1805037453
34325,409000362497',2018-09-03,IMPS 0309183C,4060257.0,0.0,,2018,9,3,PAYEMENT,4060257.0,M1157000058
34326,409000362497',2018-09-03,FDRL/INTERNAL FUND TRANSFE,0.0,1000000.0,,2018,9,3,TRANSFER,1000000.0,C872618723
34327,409000362497',2018-09-03,FDRL/INTERNAL FUND TRANSFE,0.0,3000000.0,,2018,9,3,CASH_IN,3000000.0,M599302614
34328,409000362497',2018-09-03,FDRL/INTERNAL FUND TRANSFE,0.0,500000.0,,2018,9,3,CHECK_CASHING,500000.0,M882714830
34329,409000362497',2018-09-03,IMPS 824618970476 FROM OX,0.0,200000.0,,2018,9,3,CASH_IN,200000.0,C798678484
34330,409000362497',2018-09-03,IMPS 824618970533 FROM OX,0.0,200000.0,,2018,9,3,CHECK_CASHING,200000.0,M1495879623
34331,409000362497',2018-09-03,IMPS 824618970581 FROM OX,0.0,200000.0,,2018,9,3,CASH_IN,200000.0,M1944653854
34332,409000362497',2018-09-03,IMPS 824618970623 FROM OX,0.0,200000.0,,2018,9,3,TRANSFER,200000.0,M1947743640
34333,409000362497',2018-09-03,IMPS 824618970662 FROM OX,0.0,200000.0,,2018,9,3,CHECK_CASHING,200000.0,M891572280
34334,409000362497',2018-09-03,IMPS 824618970706 FROM OX,0.0,200000.0,,2018,9,3,TRANSFER,200000.0,C1685837139
34335,409000362497',2018-09-03,IMPS 824618970752 FROM OX,0.0,200000.0,,2018,9,3,CHECK_CASHING,200000.0,C439059377
34336,409000362497',2018-09-03,IMPS 824618970792 FROM OX,0.0,200000.0,,2018,9,3,CHECK_CASHING,200000.0,C1225439033
34337,409000362497',2018-09-03,IMPS 824618970829 FROM OX,0.0,200000.0,,2018,9,3,TRANSFER,200000.0,M347021606
34338,409000362497',2018-09-03,IMPS 824618971123 FROM OX,0.0,200000.0,,2018,9,3,CASH_IN,200000.0,C1681202502
34339,409000362497',2018-09-03,IMPS 824618971172 FROM OX,0.0,200000.0,,2018,9,3,TRANSFER,200000.0,M288218427
34340,409000362497',2018-09-03,IMPS 824618971231 FROM OX,0.0,200000.0,,2018,9,3,CHECK_CASHING,200000.0,C423580937
34341,409000362497',2018-09-03,IMPS 824618971275 FROM OX,0.0,200000.0,,2018,9,3,CHECK_CASHING,200000.0,M838696929
34342,409000362497',2018-09-03,IMPS 824618971320 FROM OX,0.0,200000.0,,2018,9,3,CASH_IN,200000.0,M28227105
34343,409000362497',2018-09-03,IMPS 824618971355 FROM OX,0.0,200000.0,,2018,9,3,CHECK_CASHING,200000.0,C2072260217
34344,409000362497',2018-09-03,IMPS 824618971399 FROM OX,0.0,200000.0,,2018,9,3,CHECK_CASHING,200000.0,M885051631
34345,409000362497',2018-09-03,IMPS 824618971429 FROM OX,0.0,200000.0,,2018,9,3,CASH_IN,200000.0,C1060041730
34346,409000362497',2018-09-03,IMPS 824618971469 FROM OX,0.0,200000.0,,2018,9,3,CHECK_CASHING,200000.0,C471811727
34347,409000362497',2018-09-03,IMPS 824618971505 FROM OX,0.0,200000.0,,2018,9,3,TRANSFER,200000.0,M1806091699
34348,409000362497',2018-09-03,IMPS 824618971799 FROM OX,0.0,200000.0,,2018,9,3,CHECK_CASHING,200000.0,M780855612
34349,409000362497',2018-09-03,IMPS 824618971854 FROM OX,0.0,200000.0,,2018,9,3,CASH_IN,200000.0,C1005736508
34350,409000362497',2018-09-03,IMPS 824618971904 FROM OX,0.0,200000.0,,2018,9,3,CHECK_CASHING,200000.0,M202372869
34351,409000362497',2018-09-03,IMPS 824618971960 FROM OX,0.0,200000.0,,2018,9,3,CASH_IN,200000.0,C488766810
34352,409000362497',2018-09-03,IMPS 824618971998 FROM OX,0.0,200000.0,,2018,9,3,CHECK_CASHING,200000.0,M517046942
34353,409000362497',2018-09-03,IMPS 824618973173 FROM OX,0.0,200000.0,,2018,9,3,CHECK_CASHING,200000.0,M823754809
34354,409000362497',2018-09-03,IMPS 0309184C,1292347.48,0.0,,2018,9,3,CASH_OUT,1292347.48,C478278193
34355,409000362497',2018-09-03,Sweep Trf To: 40900036427,132791.0,0.0,,2018,9,3,CHECK_WITHDRAWAL,132791.0,M1125383508
34356,409000362497',2018-09-04,IMPS 0309181C,1229215.85,0.0,,2018,9,4,CASH_OUT,1229215.85,M1434558044
34357,409000362497',2018-09-04,IMPS 040920182C,2243461.6,0.0,,2018,9,4,CHECK_WITHDRAWAL,2243461.6,C1526298704
34358,409000362497',2018-09-04,NEFT/BKIDN18247429613/JOK,0.0,4000.0,,2018,9,4,CHECK_CASHING,4000.0,M1179656308
34359,409000362497',2018-09-04,IMPS 0409183C,2926094.06,0.0,,2018,9,4,PAYEMENT,2926094.06,M480944902
34360,409000362497',2018-09-04,INDIAIDEAS.COM LTD,167435.0,0.0,,2018,9,4,CASH_OUT,167435.0,C444920847
34361,409000362497',2018-09-04,PAYU PAYMENTS PRIVATE LIM,60337.0,0.0,,2018,9,4,DEBIT,60337.0,M1737697114
34362,409000362497',2018-09-04,AVENUES INDIA PRIVATE LIM,28029.0,0.0,,2018,9,4,PAYEMENT,28029.0,C521890235
34363,409000362497',2018-09-04,FUTURE RETAIL LIMITED (OW,1098.0,0.0,,2018,9,4,DEBIT,1098.0,C1525409936
34364,409000362497',2018-09-04,MEHAR ENTERTAINMENT PRIVA,15785.0,0.0,,2018,9,4,CHECK_WITHDRAWAL,15785.0,M834358418
34365,409000362497',2018-09-04,ZAAK EPAYMENT SERVICES PR,990.0,0.0,,2018,9,4,CHECK_WITHDRAWAL,990.0,M365023754
34366,409000362497',2018-09-04,BONUSHUB DIGITAL SOLUTION,100.0,0.0,,2018,9,4,CASH_OUT,100.0,M1365831022
34367,409000362497',2018-09-04,BIDDERBOY CORPORATION,428.0,0.0,,2018,9,4,CHECK_WITHDRAWAL,428.0,M1904123814
34368,409000362497',2018-09-04,Indiaforensic SERVICES INDIA PVT,510826.0,0.0,,2018,9,4,DEBIT,510826.0,C379183927
34369,409000362497',2018-09-04,FDRL/INTERNAL FUND TRANSFE,0.0,5000000.0,,2018,9,4,TRANSFER,5000000.0,C1270974360
34370,409000362497',2018-09-04,FDRL/INTERNAL FUND TRANSFE,0.0,500000.0,,2018,9,4,TRANSFER,500000.0,C1608690046
34371,409000362497',2018-09-04,FDRL/INTERNAL FUND TRANSFE,0.0,3000000.0,,2018,9,4,CHECK_CASHING,3000000.0,C599154405
34372,409000362497',2018-09-04,IMPS 0409184C,1044048.05,0.0,,2018,9,4,CHECK_WITHDRAWAL,1044048.05,M1294261038
34373,409000362497',2018-09-04,Sweep Trf To: 40900036427,177497.0,0.0,,2018,9,4,CHECK_WITHDRAWAL,177497.0,M2038754704
34374,409000362497',2018-09-05,IMPS 0409181C,1439505.3,0.0,,2018,9,5,CHECK_WITHDRAWAL,1439505.3,M1348566777
34375,409000362497',2018-09-05,IMPS 050920182C,2414514.79,0.0,,2018,9,5,CHECK_WITHDRAWAL,2414514.79,C403649458
34376,409000362497',2018-09-05,IMPS 050920183C,2983195.5,0.0,,2018,9,5,CHECK_WITHDRAWAL,2983195.5,M1678010794
34377,409000362497',2018-09-05,INDIAIDEAS.COM LTD,81651.0,0.0,,2018,9,5,CASH_OUT,81651.0,M2039083783
34378,409000362497',2018-09-05,PAYU PAYMENTS PRIVATE LIM,32152.0,0.0,,2018,9,5,PAYEMENT,32152.0,M302798006
34379,409000362497',2018-09-05,AVENUES INDIA PRIVATE LIM,32152.0,0.0,,2018,9,5,CHECK_WITHDRAWAL,32152.0,C1491213790
34380,409000362497',2018-09-05,SYNERGISTIC FINANCIAL NET,1417.0,0.0,,2018,9,5,PAYEMENT,1417.0,M361657716
34381,409000362497',2018-09-05,FUTURE RETAIL LIMITED (OW,3455.0,0.0,,2018,9,5,PAYEMENT,3455.0,M1555710947
34382,409000362497',2018-09-05,MEHAR ENTERTAINMENT PRIVA,3111.0,0.0,,2018,9,5,CASH_OUT,3111.0,C618155294
34383,409000362497',2018-09-05,ZAAK EPAYMENT SERVICES PR,98.0,0.0,,2018,9,5,CHECK_WITHDRAWAL,98.0,M1473603783
34384,409000362497',2018-09-05,QWIKCILVER SOLUTIONS PRIV,2894.0,0.0,,2018,9,5,DEBIT,2894.0,M2017181276
34385,409000362497',2018-09-05,Indiaforensic SERVICES INDIA PVT,16983.0,0.0,,2018,9,5,CHECK_WITHDRAWAL,16983.0,C998292323
34386,409000362497',2018-09-05,FDRL/INTERNAL FUND TRANSFE,0.0,5000000.0,,2018,9,5,CHECK_CASHING,5000000.0,M1903455395
34387,409000362497',2018-09-05,FDRL/INTERNAL FUND TRANSFE,0.0,3000000.0,,2018,9,5,CASH_IN,3000000.0,M335608266
34388,409000362497',2018-09-05,IMPS 050920184C,1070831.4,0.0,,2018,9,5,CASH_OUT,1070831.4,M76158679
34389,409000362497',2018-09-05,Sweep Trf To: 40900036427,79076.0,0.0,,2018,9,5,CHECK_WITHDRAWAL,79076.0,M82860754
34390,409000362497',2018-09-06,IMPS 0509181C,1098745.77,0.0,,2018,9,6,DEBIT,1098745.77,C1616021043
34391,409000362497',2018-09-06,IMPS 060920182C,1983021.21,0.0,,2018,9,6,CASH_OUT,1983021.21,M866860043
34392,409000362497',2018-09-06,IMPS 060920183C,3068575.83,0.0,,2018,9,6,PAYEMENT,3068575.83,M2135594799
34393,409000362497',2018-09-06,FDRL/INTERNAL FUND TRANSFE,0.0,500000.0,,2018,9,6,TRANSFER,500000.0,M1331181323
34394,409000362497',2018-09-06,FDRL/INTERNAL FUND TRANSFE,0.0,5000000.0,,2018,9,6,TRANSFER,5000000.0,M265549857
34395,409000362497',2018-09-06,FDRL/INTERNAL FUND TRANSFE,0.0,1000000.0,,2018,9,6,CHECK_CASHING,1000000.0,M1817129332
34396,409000362497',2018-09-06,IMPS 060920184C,739959.06,0.0,,2018,9,6,PAYEMENT,739959.06,M121549915
34397,409000362497',2018-09-06,Sweep Trf To: 40900036427,82180.0,0.0,,2018,9,6,CASH_OUT,82180.0,M2100546963
34398,409000362497',2018-09-07,IMPS 0609181C,1353266.54,0.0,,2018,9,7,CASH_OUT,1353266.54,M2050457688
34399,409000362497',2018-09-07,IMPS 0709182C,1775792.62,0.0,,2018,9,7,CHECK_WITHDRAWAL,1775792.62,M1698597159
34400,409000362497',2018-09-07,IMPS 0709183C,2592285.07,0.0,,2018,9,7,DEBIT,2592285.07,M1625089912
34401,409000362497',2018-09-07,NEFT/SBIN618250518895/Indfor,0.0,1500000.0,,2018,9,7,TRANSFER,1500000.0,M1672688533
34402,409000362497',2018-09-07,IMPS 0709184C,671627.29,0.0,,2018,9,7,PAYEMENT,671627.29,M1049877641
34403,409000362497',2018-09-07,FDRL/INTERNAL FUND TRANSFE,0.0,3000000.0,,2018,9,7,TRANSFER,3000000.0,M429150167
34404,409000362497',2018-09-07,FDRL/INTERNAL FUND TRANSFE,0.0,3000000.0,,2018,9,7,CHECK_CASHING,3000000.0,M416174040
34405,409000362497',2018-09-07,Sweep Trf To: 40900036427,186650.0,0.0,,2018,9,7,DEBIT,186650.0,M1334828068
34406,409000362497',2018-09-10,IMPS 0709181C,1043736.27,0.0,,2018,9,10,PAYEMENT,1043736.27,C350806217
34407,409000362497',2018-09-10,IMPS 0809181C,903294.35,0.0,,2018,9,10,DEBIT,903294.35,C1730312920
34408,409000362497',2018-09-10,IMPS 0909181C,204399.58,0.0,,2018,9,10,DEBIT,204399.58,M1670919724
34409,409000362497',2018-09-10,IMPS 1009182C,2951440.06,0.0,,2018,9,10,CHECK_WITHDRAWAL,2951440.06,M1480134208
34410,409000362497',2018-09-10,ACH DR NATIONAL PAYMENT C,4312.31,0.0,,2018,9,10,CASH_OUT,4312.31,M368017459
34411,409000362497',2018-09-10,IMPS 1009183C,2359337.22,0.0,,2018,9,10,PAYEMENT,2359337.22,M1215439165
34412,409000362497',2018-09-10,FDRL/INTERNAL FUND TRANSFE,0.0,5000000.0,,2018,9,10,CASH_IN,5000000.0,C2103065350
34413,409000362497',2018-09-10,FDRL/INTERNAL FUND TRANSFE,0.0,3000000.0,,2018,9,10,CASH_IN,3000000.0,M579712757
34414,409000362497',2018-09-10,IMPS 1009184C,653760.56,0.0,,2018,9,10,DEBIT,653760.56,M2045034010
34415,409000362497',2018-09-10,Sweep Trf To: 40900036427,263951.0,0.0,,2018,9,10,CHECK_WITHDRAWAL,263951.0,M1658991135
34416,409000362497',2018-09-11,IMPS 1009181C,635731.23,0.0,,2018,9,11,PAYEMENT,635731.23,M1023731166
34417,409000362497',2018-09-11,INDIAIDEAS.COM LTD,156698.0,0.0,,2018,9,11,CHECK_WITHDRAWAL,156698.0,C514839211
34418,409000362497',2018-09-11,PAYU PAYMENTS PRIVATE LIM,33334.0,0.0,,2018,9,11,CHECK_WITHDRAWAL,33334.0,C188246551
34419,409000362497',2018-09-11,AVENUES INDIA PRIVATE LIM,17006.0,0.0,,2018,9,11,PAYEMENT,17006.0,C2065199032
34420,409000362497',2018-09-11,FUTURE RETAIL LIMITED (OW,2596.0,0.0,,2018,9,11,CASH_OUT,2596.0,M172941748
34421,409000362497',2018-09-11,MEHAR ENTERTAINMENT PRIVA,17397.0,0.0,,2018,9,11,PAYEMENT,17397.0,C1174072748
34422,409000362497',2018-09-11,ZAAK EPAYMENT SERVICES PR,2318.0,0.0,,2018,9,11,CASH_OUT,2318.0,M560089588
34423,409000362497',2018-09-11,VOUCHER ACTIVATION SERVIC,9306.0,0.0,,2018,9,11,PAYEMENT,9306.0,C2022973332
34424,409000362497',2018-09-11,DISH INFRA SERVICES PRIVA,401.0,0.0,,2018,9,11,CASH_OUT,401.0,C128846374
34425,409000362497',2018-09-11,Indiaforensic SERVICES INDIA PVT,538835.0,0.0,,2018,9,11,CHECK_WITHDRAWAL,538835.0,M114188746
34426,409000362497',2018-09-11,IMPS 1109182C,1908590.63,0.0,,2018,9,11,PAYEMENT,1908590.63,M437761672
34427,409000362497',2018-09-11,INDIAIDEAS.COM LTD,42564.0,0.0,,2018,9,11,PAYEMENT,42564.0,M1599721930
34428,409000362497',2018-09-11,PAYU PAYMENTS PRIVATE LIM,25231.0,0.0,,2018,9,11,CHECK_WITHDRAWAL,25231.0,C946589143
34429,409000362497',2018-09-11,AVENUES INDIA PRIVATE LIM,1713.0,0.0,,2018,9,11,DEBIT,1713.0,C531593626
34430,409000362497',2018-09-11,ZAAK EPAYMENT SERVICES PR,278.0,0.0,,2018,9,11,CASH_OUT,278.0,C1007135217
34431,409000362497',2018-09-11,VOUCHER ACTIVATION SERVIC,5718.0,0.0,,2018,9,11,PAYEMENT,5718.0,M1079733488
34432,409000362497',2018-09-11,QWIKCILVER SOLUTIONS PRIV,7694.0,0.0,,2018,9,11,CHECK_WITHDRAWAL,7694.0,M1871108064
34433,409000362497',2018-09-11,Indiaforensic SERVICES INDIA PVT,141433.0,0.0,,2018,9,11,DEBIT,141433.0,C1688071442
34434,409000362497',2018-09-11,IMPS 1109183C,3290529.12,0.0,,2018,9,11,CHECK_WITHDRAWAL,3290529.12,M1132148041
34435,409000362497',2018-09-11,FDRL/INTERNAL FUND TRANSFE,0.0,500000.0,,2018,9,11,TRANSFER,500000.0,M1209838792
34436,409000362497',2018-09-11,FDRL/INTERNAL FUND TRANSFE,0.0,500000.0,,2018,9,11,CHECK_CASHING,500000.0,M625321993
34437,409000362497',2018-09-11,FDRL/INTERNAL FUND TRANSFE,0.0,5000000.0,,2018,9,11,TRANSFER,5000000.0,C1517466717
34438,409000362497',2018-09-11,FDRL/INTERNAL FUND TRANSFE,0.0,500000.0,,2018,9,11,TRANSFER,500000.0,C230816700
34439,409000362497',2018-09-11,FDRL/INTERNAL FUND TRANSFE,0.0,500000.0,,2018,9,11,TRANSFER,500000.0,M193458626
34440,409000362497',2018-09-11,IMPS 1109184C,755408.5,0.0,,2018,9,11,CHECK_WITHDRAWAL,755408.5,M445727398
34441,409000362497',2018-09-11,Sweep Trf To: 40900036427,275406.0,0.0,,2018,9,11,CASH_OUT,275406.0,C1450419757
34442,409000362497',2018-09-12,RF For 709002968591,0.0,327340.0,,2018,9,12,TRANSFER,327340.0,M664177002
34443,409000362497',2018-09-12,IMPS 1109181C,495940.04,0.0,,2018,9,12,PAYEMENT,495940.04,M723456299
34444,409000362497',2018-09-12,IMPS 120920182C,2322234.74,0.0,,2018,9,12,CASH_OUT,2322234.74,C1261309973
34445,409000362497',2018-09-12,INDIAIDEAS.COM LTD,48002.0,0.0,,2018,9,12,CASH_OUT,48002.0,M1532926301
34446,409000362497',2018-09-12,PAYU PAYMENTS PRIVATE LIM,5220.0,0.0,,2018,9,12,DEBIT,5220.0,M111123019
34447,409000362497',2018-09-12,AVENUES INDIA PRIVATE LIM,4961.0,0.0,,2018,9,12,DEBIT,4961.0,M1153714704
34448,409000362497',2018-09-12,ZAAK EPAYMENT SERVICES PR,226.0,0.0,,2018,9,12,DEBIT,226.0,C1216092644
34449,409000362497',2018-09-12,FUTURE RETAIL LIMITED (OW,105.0,0.0,,2018,9,12,DEBIT,105.0,C1247600089
34450,409000362497',2018-09-12,MEHAR ENTERTAINMENT PRIVA,8065.0,0.0,,2018,9,12,CHECK_WITHDRAWAL,8065.0,C1518728219
34451,409000362497',2018-09-12,Indiaforensic SERVICES INDIA PVT,140414.0,0.0,,2018,9,12,PAYEMENT,140414.0,C1149788645
34452,409000362497',2018-09-12,IMPS 120920183C,2870173.59,0.0,,2018,9,12,PAYEMENT,2870173.59,C678651991
34453,409000362497',2018-09-12,FDRL/INTERNAL FUND TRANSFE,0.0,3000000.0,,2018,9,12,CHECK_CASHING,3000000.0,C1545454825
34454,409000362497',2018-09-12,FDRL/INTERNAL FUND TRANSFE,0.0,500000.0,,2018,9,12,TRANSFER,500000.0,C1373172466
34455,409000362497',2018-09-12,FDRL/INTERNAL FUND TRANSFE,0.0,500000.0,,2018,9,12,TRANSFER,500000.0,C769342184
34456,409000362497',2018-09-12,FDRL/INTERNAL FUND TRANSFE,0.0,3000000.0,,2018,9,12,CHECK_CASHING,3000000.0,C1081599606
34457,409000362497',2018-09-12,IMPS 120920184C,741878.36,0.0,,2018,9,12,PAYEMENT,741878.36,C510508465
34458,409000362497',2018-09-12,Sweep Trf To: 40900036427,294313.0,0.0,,2018,9,12,CHECK_WITHDRAWAL,294313.0,C1626759869
34459,409000362497',2018-09-13,IMPS 1209181C,289142.77,0.0,,2018,9,13,PAYEMENT,289142.77,C1200417755
34460,409000362497',2018-09-13,IMPS 1309182C,1883025.85,0.0,,2018,9,13,CASH_OUT,1883025.85,C1359291582
34461,409000362497',2018-09-13,IMPS 130920183C,3176228.2,0.0,,2018,9,13,DEBIT,3176228.2,C1245522769
34462,409000362497',2018-09-13,FDRL/INTERNAL FUND TRANSFE,0.0,7000000.0,,2018,9,13,TRANSFER,7000000.0,C667504652
34463,409000362497',2018-09-13,IMPS 130920184C,952873.45,0.0,,2018,9,13,CHECK_WITHDRAWAL,952873.45,C1825051499
34464,409000362497',2018-09-13,Sweep Trf To: 40900036427,321532.0,0.0,,2018,9,13,PAYEMENT,321532.0,C1759482496
34465,409000362497',2018-09-14,IMPS 1309181C,277577.44,0.0,,2018,9,14,PAYEMENT,277577.44,C1413677222
34466,409000362497',2018-09-14,IMPS 1409182C,2033498.25,0.0,,2018,9,14,CASH_OUT,2033498.25,C990662375
34467,409000362497',2018-09-14,IMPS 140920183C,2723122.6,0.0,,2018,9,14,DEBIT,2723122.6,M1863674684
34468,409000362497',2018-09-14,PAYU PAYMENTS PRIVATE LIM,18304.0,0.0,,2018,9,14,CASH_OUT,18304.0,C1674513830
34469,409000362497',2018-09-14,AVENUES INDIA PRIVATE LIM,20526.0,0.0,,2018,9,14,CASH_OUT,20526.0,M456233878
34470,409000362497',2018-09-14,FUTURE RETAIL LIMITED (OW,869.0,0.0,,2018,9,14,DEBIT,869.0,M1169529303
34471,409000362497',2018-09-14,MEHAR ENTERTAINMENT PRIVA,3226.0,0.0,,2018,9,14,PAYEMENT,3226.0,C960616043
34472,409000362497',2018-09-14,Indiaforensic SERVICES INDIA PVT,275412.0,0.0,,2018,9,14,CHECK_WITHDRAWAL,275412.0,M1965280848
34473,409000362497',2018-09-14,FDRL/INTERNAL FUND TRANSFE,0.0,5000000.0,,2018,9,14,TRANSFER,5000000.0,M373623104
34474,409000362497',2018-09-14,FDRL/INTERNAL FUND TRANSFE,0.0,3000000.0,,2018,9,14,CHECK_CASHING,3000000.0,C549868595
34475,409000362497',2018-09-14,IMPS 140920184C,758526.6,0.0,,2018,9,14,DEBIT,758526.6,C1291664589
34476,409000362497',2018-09-14,Sweep Trf To: 40900036427,217319.0,0.0,,2018,9,14,CASH_OUT,217319.0,C1692434834
34477,409000362497',2018-09-15,IMPS 1409181C,889688.37,0.0,,2018,9,15,PAYEMENT,889688.37,C416519915
34478,409000362497',2018-09-15,IMPS 150920182C,1774992.22,0.0,,2018,9,15,PAYEMENT,1774992.22,C1476152368
34479,409000362497',2018-09-15,IMPS 150920183C,2625363.59,0.0,,2018,9,15,DEBIT,2625363.59,C591862575
34480,409000362497',2018-09-15,FDRL/INTERNAL FUND TRANSFE,0.0,6000000.0,,2018,9,15,CHECK_CASHING,6000000.0,M386342988
34481,409000362497',2018-09-15,IMPS 150920184C,950893.95,0.0,,2018,9,15,DEBIT,950893.95,C222981964
34482,409000362497',2018-09-15,Sweep Trf To: 40900036427,207167.0,0.0,,2018,9,15,CHECK_WITHDRAWAL,207167.0,C515578013
34483,409000362497',2018-09-17,IMPS 1509181C,606851.76,0.0,,2018,9,17,CASH_OUT,606851.76,M131176745
34484,409000362497',2018-09-17,IMPS 1609181C,417493.5,0.0,,2018,9,17,PAYEMENT,417493.5,M874011738
34485,409000362497',2018-09-17,IMPS 1709182C,1721261.87,0.0,,2018,9,17,PAYEMENT,1721261.87,C1712213348
34486,409000362497',2018-09-17,IMPS 1709183C,2885821.71,0.0,,2018,9,17,DEBIT,2885821.71,C368533732
34487,409000362497',2018-09-17,INDIAIDEAS.COM LTD,177022.0,0.0,,2018,9,17,DEBIT,177022.0,C1153596299
34488,409000362497',2018-09-17,PAYU PAYMENTS PRIVATE LIM,20398.0,0.0,,2018,9,17,CASH_OUT,20398.0,C614533232
34489,409000362497',2018-09-17,AVENUES INDIA PRIVATE LIM,14555.0,0.0,,2018,9,17,CHECK_WITHDRAWAL,14555.0,C2076405817
34490,409000362497',2018-09-17,ZAAK EPAYMENT SERVICES PR,406.0,0.0,,2018,9,17,CASH_OUT,406.0,C324470431
34491,409000362497',2018-09-17,FUTURE RETAIL LIMITED (OW,4040.0,0.0,,2018,9,17,CHECK_WITHDRAWAL,4040.0,C2136124320
34492,409000362497',2018-09-17,MEHAR ENTERTAINMENT PRIVA,6798.0,0.0,,2018,9,17,DEBIT,6798.0,C1089993541
34493,409000362497',2018-09-17,DISH INFRA SERVICES PRIVA,94.0,0.0,,2018,9,17,PAYEMENT,94.0,C405804899
34494,409000362497',2018-09-17,Indiaforensic SERVICES INDIA PVT,352227.0,0.0,,2018,9,17,CHECK_WITHDRAWAL,352227.0,M2067061575
34495,409000362497',2018-09-17,FDRL/INTERNAL FUND TRANSFE,0.0,7000000.0,,2018,9,17,TRANSFER,7000000.0,M641737095
34496,409000362497',2018-09-17,IMPS 1709184C,882010.46,0.0,,2018,9,17,CHECK_WITHDRAWAL,882010.46,C720179024
34497,409000362497',2018-09-17,Sweep Trf To: 40900036427,242200.0,0.0,,2018,9,17,CHECK_WITHDRAWAL,242200.0,C648198000
34498,409000362497',2018-09-18,IMPS 1709181C,764232.26,0.0,,2018,9,18,DEBIT,764232.26,M844298744
34499,409000362497',2018-09-18,IMPS 1809182C,970375.96,0.0,,2018,9,18,PAYEMENT,970375.96,M2012255040
34500,409000362497',2018-09-18,INDIAIDEAS.COM LTD,14797.0,0.0,,2018,9,18,CASH_OUT,14797.0,C150091086
34501,409000362497',2018-09-18,PAYU PAYMENTS PRIVATE LIM,30952.0,0.0,,2018,9,18,DEBIT,30952.0,M445963642
34502,409000362497',2018-09-18,AVENUES INDIA PRIVATE LIM,5563.0,0.0,,2018,9,18,CASH_OUT,5563.0,C365897166
34503,409000362497',2018-09-18,FUTURE RETAIL LIMITED (OW,211.0,0.0,,2018,9,18,CASH_OUT,211.0,M157048213
34504,409000362497',2018-09-18,MEHAR ENTERTAINMENT PRIVA,2304.0,0.0,,2018,9,18,CASH_OUT,2304.0,M892204414
34505,409000362497',2018-09-18,QWIKCILVER SOLUTIONS PRIV,3093.0,0.0,,2018,9,18,PAYEMENT,3093.0,C1944110965
34506,409000362497',2018-09-18,Indiaforensic SERVICES INDIA PVT,138569.0,0.0,,2018,9,18,CASH_OUT,138569.0,M757684859
34507,409000362497',2018-09-18,IMPS 1809183C,2989584.71,0.0,,2018,9,18,DEBIT,2989584.71,C1853202598
34508,409000362497',2018-09-18,FDRL/INTERNAL FUND TRANSFE,0.0,1000000.0,,2018,9,18,TRANSFER,1000000.0,M1186899146
34509,409000362497',2018-09-18,FDRL/INTERNAL FUND TRANSFE,0.0,1000000.0,,2018,9,18,TRANSFER,1000000.0,C340130985
34510,409000362497',2018-09-18,FDRL/INTERNAL FUND TRANSFE,0.0,1000000.0,,2018,9,18,TRANSFER,1000000.0,C484967382
34511,409000362497',2018-09-18,FDRL/INTERNAL FUND TRANSFE,0.0,1000000.0,,2018,9,18,CHECK_CASHING,1000000.0,C1701519711
34512,409000362497',2018-09-18,FDRL/INTERNAL FUND TRANSFE,0.0,1000000.0,,2018,9,18,TRANSFER,1000000.0,M1094892192
34513,409000362497',2018-09-18,FDRL/INTERNAL FUND TRANSFE,0.0,1000000.0,,2018,9,18,CHECK_CASHING,1000000.0,M883716258
34514,409000362497',2018-09-18,FDRL/INTERNAL FUND TRANSFE,0.0,1000000.0,,2018,9,18,CASH_IN,1000000.0,M1351459958
34515,409000362497',2018-09-18,IMPS 180920184C,1310892.2,0.0,,2018,9,18,CHECK_WITHDRAWAL,1310892.2,M1706141985
34516,409000362497',2018-09-18,Sweep Trf To: 40900036427,208616.0,0.0,,2018,9,18,DEBIT,208616.0,M676576649
34517,409000362497',2018-09-19,IMPS 1809181C,827762.8,0.0,,2018,9,19,PAYEMENT,827762.8,M234103091
34518,409000362497',2018-09-19,IMPS 1909182C,1486686.06,0.0,,2018,9,19,CASH_OUT,1486686.06,M755048126
34519,409000362497',2018-09-19,IMPS 1909183C,2805848.25,0.0,,2018,9,19,CASH_OUT,2805848.25,M1196595943
34520,409000362497',2018-09-19,FDRL/INTERNAL FUND TRANSFE,0.0,1000000.0,,2018,9,19,CASH_IN,1000000.0,M552891109
34521,409000362497',2018-09-19,FDRL/INTERNAL FUND TRANSFE,0.0,1000000.0,,2018,9,19,CASH_IN,1000000.0,M105708475
34522,409000362497',2018-09-19,FDRL/INTERNAL FUND TRANSFE,0.0,1000000.0,,2018,9,19,TRANSFER,1000000.0,C1692066743
34523,409000362497',2018-09-19,FDRL/INTERNAL FUND TRANSFE,0.0,1000000.0,,2018,9,19,CASH_IN,1000000.0,M684478771
34524,409000362497',2018-09-19,FDRL/INTERNAL FUND TRANSFE,0.0,1000000.0,,2018,9,19,CASH_IN,1000000.0,C514597582
34525,409000362497',2018-09-19,FDRL/INTERNAL FUND TRANSFE,0.0,1000000.0,,2018,9,19,TRANSFER,1000000.0,C804475266
34526,409000362497',2018-09-19,FDRL/INTERNAL FUND TRANSFE,0.0,500000.0,,2018,9,19,CASH_IN,500000.0,C1529115495
34527,409000362497',2018-09-19,IMPS 1909184C,815554.1,0.0,,2018,9,19,CHECK_WITHDRAWAL,815554.1,C2131465140
34528,409000362497',2018-09-19,Sweep Trf To: 40900036427,200850.0,0.0,,2018,9,19,CHECK_WITHDRAWAL,200850.0,C934085675
34529,409000362497',2018-09-20,IMPS 1909181C,622110.25,0.0,,2018,9,20,PAYEMENT,622110.25,C1619402333
34530,409000362497',2018-09-20,IMPS 2009182C,1288308.5,0.0,,2018,9,20,DEBIT,1288308.5,C1065997164
34531,409000362497',2018-09-20,IMPS 2009183C,1381224.77,0.0,,2018,9,20,PAYEMENT,1381224.77,C1816986148
34532,409000362497',2018-09-20,FDRL/INTERNAL FUND TRANSFE,0.0,1000000.0,,2018,9,20,CHECK_CASHING,1000000.0,C664038638
34533,409000362497',2018-09-20,FDRL/INTERNAL FUND TRANSFE,0.0,1000000.0,,2018,9,20,CHECK_CASHING,1000000.0,C267527788
34534,409000362497',2018-09-20,FDRL/INTERNAL FUND TRANSFE,0.0,1000000.0,,2018,9,20,CASH_IN,1000000.0,C1420934487
34535,409000362497',2018-09-20,IMPS 2009184C,395827.98,0.0,,2018,9,20,PAYEMENT,395827.98,C1383454473
34536,409000362497',2018-09-20,Sweep Trf To: 40900036427,56550.0,0.0,,2018,9,20,DEBIT,56550.0,C219543946
34537,409000362497',2018-09-21,IMPS 2009181C,330311.78,0.0,,2018,9,21,PAYEMENT,330311.78,C861958315
34538,409000362497',2018-09-21,IMPS 2109182C,1099399.07,0.0,,2018,9,21,PAYEMENT,1099399.07,C17820769
34539,409000362497',2018-09-21,IMPS 2109183C,2025821.42,0.0,,2018,9,21,CASH_OUT,2025821.42,C2143477943
34540,409000362497',2018-09-21,INDIAIDEAS.COM LTD,16660.0,0.0,,2018,9,21,CHECK_WITHDRAWAL,16660.0,C1306763722
34541,409000362497',2018-09-21,PAYU PAYMENTS PRIVATE LIM,12747.0,0.0,,2018,9,21,DEBIT,12747.0,C2036762590
34542,409000362497',2018-09-21,AVENUES INDIA PRIVATE LIM,21645.0,0.0,,2018,9,21,DEBIT,21645.0,C1842214283
34543,409000362497',2018-09-21,FUTURE RETAIL LIMITED (OW,1140.0,0.0,,2018,9,21,PAYEMENT,1140.0,C2070713570
34544,409000362497',2018-09-21,MEHAR ENTERTAINMENT PRIVA,6682.0,0.0,,2018,9,21,DEBIT,6682.0,C1531514206
34545,409000362497',2018-09-21,VOUCHER ACTIVATION SERVIC,6954.0,0.0,,2018,9,21,CHECK_WITHDRAWAL,6954.0,C1575114306
34546,409000362497',2018-09-21,ZAAK EPAYMENT SERVICES PR,1453.0,0.0,,2018,9,21,PAYEMENT,1453.0,C1385126783
34547,409000362497',2018-09-21,Indiaforensic SERVICES INDIA PVT,260744.0,0.0,,2018,9,21,PAYEMENT,260744.0,C743528393
34548,409000362497',2018-09-21,IMPS 2109184C,842380.22,0.0,,2018,9,21,DEBIT,842380.22,C529351377
34549,409000362497',2018-09-21,IMPS 826420323860 FROM OX,0.0,200000.0,,2018,9,21,CASH_IN,200000.0,C465417823
34550,409000362497',2018-09-21,IMPS 826420323890 FROM OX,0.0,200000.0,,2018,9,21,TRANSFER,200000.0,M536052747
34551,409000362497',2018-09-21,IMPS 826420323911 FROM OX,0.0,200000.0,,2018,9,21,TRANSFER,200000.0,M1323000582
34552,409000362497',2018-09-21,IMPS 826420323935 FROM OX,0.0,200000.0,,2018,9,21,CASH_IN,200000.0,M643895090
34553,409000362497',2018-09-21,IMPS 826420323962 FROM OX,0.0,200000.0,,2018,9,21,CASH_IN,200000.0,M126361857
34554,409000362497',2018-09-21,IMPS 826420323973 FROM OX,0.0,200000.0,,2018,9,21,CHECK_CASHING,200000.0,C731253803
34555,409000362497',2018-09-21,IMPS 826420324001 FROM OX,0.0,200000.0,,2018,9,21,TRANSFER,200000.0,M1663115536
34556,409000362497',2018-09-21,IMPS 826420324022 FROM OX,0.0,200000.0,,2018,9,21,CASH_IN,200000.0,M985628937
34557,409000362497',2018-09-21,IMPS 826420324044 FROM OX,0.0,200000.0,,2018,9,21,CHECK_CASHING,200000.0,M1428124492
34558,409000362497',2018-09-21,IMPS 826420324070 FROM OX,0.0,200000.0,,2018,9,21,CHECK_CASHING,200000.0,C1027043112
34559,409000362497',2018-09-21,IMPS 826420324278 FROM OX,0.0,200000.0,,2018,9,21,CHECK_CASHING,200000.0,C2109236648
34560,409000362497',2018-09-21,IMPS 826420324300 FROM OX,0.0,200000.0,,2018,9,21,CASH_IN,200000.0,C1508456612
34561,409000362497',2018-09-21,IMPS 826420324318 FROM OX,0.0,200000.0,,2018,9,21,TRANSFER,200000.0,C12793273
34562,409000362497',2018-09-21,IMPS 826420324341 FROM OX,0.0,200000.0,,2018,9,21,CASH_IN,200000.0,C1531333864
34563,409000362497',2018-09-21,IMPS 826420324366 FROM OX,0.0,200000.0,,2018,9,21,TRANSFER,200000.0,C1271612900
34564,409000362497',2018-09-21,IMPS 826420324389 FROM OX,0.0,200000.0,,2018,9,21,CHECK_CASHING,200000.0,C1303868418
34565,409000362497',2018-09-21,IMPS 826420324405 FROM OX,0.0,200000.0,,2018,9,21,CHECK_CASHING,200000.0,C667346055
34566,409000362497',2018-09-21,IMPS 826420324431 FROM OX,0.0,200000.0,,2018,9,21,CHECK_CASHING,200000.0,C1696758742
34567,409000362497',2018-09-21,IMPS 826420324452 FROM OX,0.0,200000.0,,2018,9,21,CHECK_CASHING,200000.0,C244095956
34568,409000362497',2018-09-21,IMPS 826420324653 FROM OX,0.0,200000.0,,2018,9,21,CASH_IN,200000.0,C1811531351
34569,409000362497',2018-09-21,IMPS 826420324677 FROM OX,0.0,200000.0,,2018,9,21,CASH_IN,200000.0,C188246551
34570,409000362497',2018-09-21,IMPS 826420324693 FROM OX,0.0,200000.0,,2018,9,21,CASH_IN,200000.0,C222020906
34571,409000362497',2018-09-21,IMPS 826420324715 FROM OX,0.0,200000.0,,2018,9,21,TRANSFER,200000.0,C708099852
34572,409000362497',2018-09-21,IMPS 826420324734 FROM OX,0.0,200000.0,,2018,9,21,CHECK_CASHING,200000.0,C129529297
34573,409000362497',2018-09-21,IMPS 826420324760 FROM OX,0.0,200000.0,,2018,9,21,CHECK_CASHING,200000.0,C1761861940
34574,409000362497',2018-09-21,IMPS 826420324792 FROM OX,0.0,200000.0,,2018,9,21,CASH_IN,200000.0,C1652369868
34575,409000362497',2018-09-21,IMPS 826420324830 FROM OX,0.0,200000.0,,2018,9,21,CASH_IN,200000.0,C1967017653
34576,409000362497',2018-09-21,IMPS 826420324844 FROM OX,0.0,200000.0,,2018,9,21,CHECK_CASHING,200000.0,C1423956695
34577,409000362497',2018-09-21,Sweep Trf To: 40900036427,259681.0,0.0,,2018,9,21,CASH_OUT,259681.0,C450293175
34578,409000362497',2018-09-24,IMPS 2109181C,504440.54,0.0,,2018,9,24,PAYEMENT,504440.54,C2110090153
34579,409000362497',2018-09-24,IMPS 2209181C,828194.76,0.0,,2018,9,24,CHECK_WITHDRAWAL,828194.76,C1111747867
34580,409000362497',2018-09-24,IMPS 2309181C,147228.06,0.0,,2018,9,24,CHECK_WITHDRAWAL,147228.06,M1599127439
34581,409000362497',2018-09-24,IMPS 2409182C,2174984.76,0.0,,2018,9,24,PAYEMENT,2174984.76,C361268035
34582,409000362497',2018-09-24,IMPS 2409183C,1865162.3,0.0,,2018,9,24,PAYEMENT,1865162.3,C681692677
34583,409000362497',2018-09-24,FDRL/INTERNAL FUND TRANSFE,0.0,1000000.0,,2018,9,24,CHECK_CASHING,1000000.0,C25823731
34584,409000362497',2018-09-24,FDRL/INTERNAL FUND TRANSFE,0.0,500000.0,,2018,9,24,CASH_IN,500000.0,M1506086051
34585,409000362497',2018-09-24,FDRL/INTERNAL FUND TRANSFE,0.0,1000000.0,,2018,9,24,CASH_IN,1000000.0,C916869225
34586,409000362497',2018-09-24,FDRL/INTERNAL FUND TRANSFE,0.0,1000000.0,,2018,9,24,TRANSFER,1000000.0,C1703397679
34587,409000362497',2018-09-24,FDRL/INTERNAL FUND TRANSFE,0.0,1000000.0,,2018,9,24,CHECK_CASHING,1000000.0,M114831905
34588,409000362497',2018-09-24,FDRL/INTERNAL FUND TRANSFE,0.0,1000000.0,,2018,9,24,TRANSFER,1000000.0,M1799032158
34589,409000362497',2018-09-24,IMPS 2409184C,365741.65,0.0,,2018,9,24,CASH_OUT,365741.65,M398721900
34590,409000362497',2018-09-24,Sweep Trf To: 40900036427,162800.0,0.0,,2018,9,24,PAYEMENT,162800.0,M88574423
34591,409000362497',2018-09-25,INDIAIDEAS.COM LTD,34353.0,0.0,,2018,9,25,CASH_OUT,34353.0,M825599567
34592,409000362497',2018-09-25,PAYU PAYMENTS PRIVATE LIM,50502.0,0.0,,2018,9,25,CHECK_WITHDRAWAL,50502.0,M388105822
34593,409000362497',2018-09-25,AVENUES INDIA PRIVATE LIM,5576.0,0.0,,2018,9,25,CHECK_WITHDRAWAL,5576.0,M1709082970
34594,409000362497',2018-09-25,FUTURE RETAIL LIMITED (OW,5560.0,0.0,,2018,9,25,PAYEMENT,5560.0,M1564465821
34595,409000362497',2018-09-25,MEHAR ENTERTAINMENT PRIVA,6222.0,0.0,,2018,9,25,CHECK_WITHDRAWAL,6222.0,M533946583
34596,409000362497',2018-09-25,ZAAK EPAYMENT SERVICES PR,149.0,0.0,,2018,9,25,CHECK_WITHDRAWAL,149.0,M663952990
34597,409000362497',2018-09-25,METRO INFRASYS PRIVATE LI,697.0,0.0,,2018,9,25,CASH_OUT,697.0,M416280178
34598,409000362497',2018-09-25,DISH INFRA SERVICES PRIVA,488.0,0.0,,2018,9,25,CASH_OUT,488.0,M2108362104
34599,409000362497',2018-09-25,Indiaforensic SERVICES INDIA PVT,261052.0,0.0,,2018,9,25,CASH_OUT,261052.0,M1895980020
34600,409000362497',2018-09-25,IMPS 2409181C,392889.83,0.0,,2018,9,25,DEBIT,392889.83,M984141860
34601,409000362497',2018-09-25,IMPS 2509182C,1798855.29,0.0,,2018,9,25,PAYEMENT,1798855.29,M63729232
34602,409000362497',2018-09-25,INDIAIDEAS.COM LTD,9235.0,0.0,,2018,9,25,PAYEMENT,9235.0,M240523739
34603,409000362497',2018-09-25,PAYU PAYMENTS PRIVATE LIM,12080.0,0.0,,2018,9,25,PAYEMENT,12080.0,M480922428
34604,409000362497',2018-09-25,AVENUES INDIA PRIVATE LIM,7833.0,0.0,,2018,9,25,CHECK_WITHDRAWAL,7833.0,M1318180956
34605,409000362497',2018-09-25,FUTURE RETAIL LIMITED (OW,984.0,0.0,,2018,9,25,CHECK_WITHDRAWAL,984.0,C831003298
34606,409000362497',2018-09-25,ZAAK EPAYMENT SERVICES PR,981.0,0.0,,2018,9,25,PAYEMENT,981.0,M270922473
34607,409000362497',2018-09-25,QWIKCILVER SOLUTIONS PRIV,2454.0,0.0,,2018,9,25,CHECK_WITHDRAWAL,2454.0,C66893623
34608,409000362497',2018-09-25,Indiaforensic SERVICES INDIA PVT,98899.0,0.0,,2018,9,25,PAYEMENT,98899.0,M1962508574
34609,409000362497',2018-09-25,IMPS 2509183C,2161832.01,0.0,,2018,9,25,CASH_OUT,2161832.01,C1060951315
34610,409000362497',2018-09-25,FDRL/INTERNAL FUND TRANSFE,0.0,5000000.0,,2018,9,25,CHECK_CASHING,5000000.0,C2078448324
34611,409000362497',2018-09-25,FDRL/INTERNAL FUND TRANSFE,0.0,1000000.0,,2018,9,25,CASH_IN,1000000.0,C1738408898
34612,409000362497',2018-09-25,IMPS 2509184C,925448.06,0.0,,2018,9,25,CHECK_WITHDRAWAL,925448.06,M1058878084
34613,409000362497',2018-09-25,Sweep Trf To: 40900036427,261429.0,0.0,,2018,9,25,CASH_OUT,261429.0,C215145189
34614,409000362497',2018-09-26,IMPS 2509181C,539773.52,0.0,,2018,9,26,CASH_OUT,539773.52,M904944776
34615,409000362497',2018-09-26,IMPS 2609182C,1357917.75,0.0,,2018,9,26,CASH_OUT,1357917.75,C1877976610
34616,409000362497',2018-09-26,NEFT/BARBT18269421962/LIJ,0.0,4000.0,,2018,9,26,CHECK_CASHING,4000.0,M465977038
34617,409000362497',2018-09-26,NEFT/BARBT18269422334/LIJ,0.0,5000.0,,2018,9,26,CASH_IN,5000.0,C989796714
34618,409000362497',2018-09-26,IMPS 260920183C,2174689.75,0.0,,2018,9,26,PAYEMENT,2174689.75,M472920784
34619,409000362497',2018-09-26,FDRL/INTERNAL FUND TRANSFE,0.0,5000000.0,,2018,9,26,CHECK_CASHING,5000000.0,M862167060
34620,409000362497',2018-09-26,FDRL/INTERNAL FUND TRANSFE,0.0,500000.0,,2018,9,26,CHECK_CASHING,500000.0,C1045258317
34621,409000362497',2018-09-26,FDRL/INTERNAL FUND TRANSFE,0.0,500000.0,,2018,9,26,CASH_IN,500000.0,C868060023
34622,409000362497',2018-09-26,IMPS 2609184C,1167881.2,0.0,,2018,9,26,CHECK_WITHDRAWAL,1167881.2,M59147101
34623,409000362497',2018-09-26,Sweep Trf To: 40900036427,279055.0,0.0,,2018,9,26,DEBIT,279055.0,M1183812402
34624,409000362497',2018-09-27,INDIAIDEAS.COM LTD,4540.0,0.0,,2018,9,27,DEBIT,4540.0,C1508456612
34625,409000362497',2018-09-27,PAYU PAYMENTS PRIVATE LIM,23294.0,0.0,,2018,9,27,CHECK_WITHDRAWAL,23294.0,C843774579
34626,409000362497',2018-09-27,AVENUES INDIA PRIVATE LIM,4632.0,0.0,,2018,9,27,DEBIT,4632.0,C1083142315
34627,409000362497',2018-09-27,MEHAR ENTERTAINMENT PRIVA,3341.0,0.0,,2018,9,27,CHECK_WITHDRAWAL,3341.0,C2122668216
34628,409000362497',2018-09-27,Indiaforensic SERVICES INDIA PVT,98827.0,0.0,,2018,9,27,CHECK_WITHDRAWAL,98827.0,C1331026587
34629,409000362497',2018-09-27,IMPS 2609181C,516493.24,0.0,,2018,9,27,CHECK_WITHDRAWAL,516493.24,C2073437421
34630,409000362497',2018-09-27,IMPS 2709182C,234042.28,0.0,,2018,9,27,DEBIT,234042.28,C819041667
34631,409000362497',2018-09-27,INDIAIDEAS.COM LTD,38675.0,0.0,,2018,9,27,PAYEMENT,38675.0,M1777945718
34632,409000362497',2018-09-27,PAYU PAYMENTS PRIVATE LIM,12243.0,0.0,,2018,9,27,PAYEMENT,12243.0,M608166491
34633,409000362497',2018-09-27,AVENUES INDIA PRIVATE LIM,1761.0,0.0,,2018,9,27,CHECK_WITHDRAWAL,1761.0,C1647754924
34634,409000362497',2018-09-27,FUTURE RETAIL LIMITED (OW,606.0,0.0,,2018,9,27,CHECK_WITHDRAWAL,606.0,C142825174
34635,409000362497',2018-09-27,DISH INFRA SERVICES PRIVA,98.0,0.0,,2018,9,27,PAYEMENT,98.0,M439325080
34636,409000362497',2018-09-27,MEHAR ENTERTAINMENT PRIVA,2535.0,0.0,,2018,9,27,CHECK_WITHDRAWAL,2535.0,M1919091727
34637,409000362497',2018-09-27,VOUCHER ACTIVATION SERVIC,8716.0,0.0,,2018,9,27,CASH_OUT,8716.0,M419747390
34638,409000362497',2018-09-27,Indiaforensic SERVICES INDIA PVT,128178.0,0.0,,2018,9,27,CASH_OUT,128178.0,C1521704415
34639,409000362497',2018-09-27,IMPS 2709183C,1520665.91,0.0,,2018,9,27,PAYEMENT,1520665.91,M2085738615
34640,409000362497',2018-09-27,FDRL/INTERNAL FUND TRANSFE,0.0,500000.0,,2018,9,27,CHECK_CASHING,500000.0,C2110170737
34641,409000362497',2018-09-27,FDRL/INTERNAL FUND TRANSFE,0.0,500000.0,,2018,9,27,CHECK_CASHING,500000.0,C1019227219
34642,409000362497',2018-09-27,FDRL/INTERNAL FUND TRANSFE,0.0,500000.0,,2018,9,27,CHECK_CASHING,500000.0,C381867730
34643,409000362497',2018-09-27,FDRL/INTERNAL FUND TRANSFE,0.0,3000000.0,,2018,9,27,TRANSFER,3000000.0,C1343134043
34644,409000362497',2018-09-27,IMPS 2709184C,1510093.08,0.0,,2018,9,27,DEBIT,1510093.08,M970087209
34645,409000362497',2018-09-27,Sweep Trf To: 40900036427,102300.0,0.0,,2018,9,27,CASH_OUT,102300.0,C1869228744
34646,409000362497',2018-09-28,IMPS 2709181C,898726.36,0.0,,2018,9,28,DEBIT,898726.36,M987549112
34647,409000362497',2018-09-28,IMPS 2809182C,1325087.95,0.0,,2018,9,28,DEBIT,1325087.95,M1757164889
34648,409000362497',2018-09-28,INDIAIDEAS.COM LTD,25309.0,0.0,,2018,9,28,PAYEMENT,25309.0,C593882688
34649,409000362497',2018-09-28,PAYU PAYMENTS PRIVATE LIM,21559.0,0.0,,2018,9,28,CASH_OUT,21559.0,C1957884855
34650,409000362497',2018-09-28,AVENUES INDIA PRIVATE LIM,3775.0,0.0,,2018,9,28,DEBIT,3775.0,C2134357721
34651,409000362497',2018-09-28,ZAAK EPAYMENT SERVICES PR,327.0,0.0,,2018,9,28,CHECK_WITHDRAWAL,327.0,M819731667
34652,409000362497',2018-09-28,FUTURE RETAIL LIMITED (OW,1365.0,0.0,,2018,9,28,CHECK_WITHDRAWAL,1365.0,M748502663
34653,409000362497',2018-09-28,PASFAR TECHNOLOGIES PRIVA,98.0,0.0,,2018,9,28,CHECK_WITHDRAWAL,98.0,C1082457863
34654,409000362497',2018-09-28,MEHAR ENTERTAINMENT PRIVA,1613.0,0.0,,2018,9,28,CASH_OUT,1613.0,C115141847
34655,409000362497',2018-09-28,Indiaforensic SERVICES INDIA PVT,120266.0,0.0,,2018,9,28,CHECK_WITHDRAWAL,120266.0,C1018394275
34656,409000362497',2018-09-28,IMPS 2809183C,2493041.31,0.0,,2018,9,28,CHECK_WITHDRAWAL,2493041.31,M903897272
34657,409000362497',2018-09-28,FDRL/INTERNAL FUND TRANSFE,0.0,500000.0,,2018,9,28,CASH_IN,500000.0,M839544821
34658,409000362497',2018-09-28,FDRL/INTERNAL FUND TRANSFE,0.0,500000.0,,2018,9,28,CASH_IN,500000.0,C1674644027
34659,409000362497',2018-09-28,FDRL/INTERNAL FUND TRANSFE,0.0,500000.0,,2018,9,28,CHECK_CASHING,500000.0,C443625234
34660,409000362497',2018-09-28,FDRL/INTERNAL FUND TRANSFE,0.0,5000000.0,,2018,9,28,CHECK_CASHING,5000000.0,C271894137
34661,409000362497',2018-09-28,FDRL/INTERNAL FUND TRANSFE,0.0,500000.0,,2018,9,28,CHECK_CASHING,500000.0,C1951379728
34662,409000362497',2018-09-28,IMPS 2809184C,802562.89,0.0,,2018,9,28,CASH_OUT,802562.89,M1581899481
34663,409000362497',2018-09-28,Sweep Trf To: 40900036427,211723.0,0.0,,2018,9,28,CHECK_WITHDRAWAL,211723.0,C1282235415
34664,409000362497',2018-09-29,IMPS 2809181C,601191.28,0.0,,2018,9,29,CASH_OUT,601191.28,C1743854603
34665,409000362497',2018-09-29,IMPS 2909182C,406664.4,0.0,,2018,9,29,PAYEMENT,406664.4,M346659854
34666,409000362497',2018-09-29,IMPS 2909183C,278189.11,0.0,,2018,9,29,PAYEMENT,278189.11,C57222203
34667,409000362497',2018-09-29,FDRL/INTERNAL FUND TRANSFE,0.0,3000000.0,,2018,9,29,TRANSFER,3000000.0,C1918034924
34668,409000362497',2018-09-29,IMPS 2909184C,623344.02,0.0,,2018,9,29,CASH_OUT,623344.02,C1239681028
34669,409000362497',2018-09-29,Sweep Trf To: 40900036427,7700.0,0.0,,2018,9,29,CHECK_WITHDRAWAL,7700.0,M1423306177
34670,409000362497',2018-10-01,IMPS 2909181C,466589.46,0.0,,2018,10,1,CHECK_WITHDRAWAL,466589.46,C476179877
34671,409000362497',2018-10-01,IMPS 3009181C,1197236.1,0.0,,2018,10,1,DEBIT,1197236.1,M1265485855
34672,409000362497',2018-10-01,IMPS 0110182C,3354087.52,0.0,,2018,10,1,PAYEMENT,3354087.52,M997005112
34673,409000362497',2018-10-01,IMPS 0110183C,1441315.99,0.0,,2018,10,1,PAYEMENT,1441315.99,C397558782
34674,409000362497',2018-10-01,FDRL/INTERNAL FUND TRANSFE,0.0,6000000.0,,2018,10,1,CHECK_CASHING,6000000.0,C1151488145
34675,409000362497',2018-10-01,IMPS 0110184C,616117.56,0.0,,2018,10,1,DEBIT,616117.56,C1348373832
34676,409000362497',2018-10-01,Sweep Trf To: 40900036427,220851.0,0.0,,2018,10,1,PAYEMENT,220851.0,M215684470
34677,409000362497',2018-10-03,IMPS 0110181C,338656.67,0.0,,2018,10,3,PAYEMENT,338656.67,M200873209
34678,409000362497',2018-10-03,IMPS 0210181C,369004.48,0.0,,2018,10,3,CHECK_WITHDRAWAL,369004.48,C1827786059
34679,409000362497',2018-10-03,IMPS 0310182C,2178247.5,0.0,,2018,10,3,PAYEMENT,2178247.5,C76005115
34680,409000362497',2018-10-03,IMPS 0310183C,2371836.77,0.0,,2018,10,3,DEBIT,2371836.77,C439078113
34681,409000362497',2018-10-03,IMPS 827618840282 FROM OX,0.0,100000.0,,2018,10,3,TRANSFER,100000.0,C1241968839
34682,409000362497',2018-10-03,FDRL/INTERNAL FUND TRANSFE,0.0,3000000.0,,2018,10,3,CASH_IN,3000000.0,M1767897689
34683,409000362497',2018-10-03,FDRL/INTERNAL FUND TRANSFE,0.0,3000000.0,,2018,10,3,CHECK_CASHING,3000000.0,C875815960
34684,409000362497',2018-10-03,IMPS 0310184C,607457.94,0.0,,2018,10,3,CASH_OUT,607457.94,M1872741497
34685,409000362497',2018-10-03,Sweep Trf To: 40900036427,184575.0,0.0,,2018,10,3,CHECK_WITHDRAWAL,184575.0,C1247600089
34686,409000362497',2018-10-04,INDIAIDEAS.COM LTD,82842.0,0.0,,2018,10,4,CASH_OUT,82842.0,C470217116
34687,409000362497',2018-10-04,PAYU PAYMENTS PRIVATE LIM,68969.0,0.0,,2018,10,4,CASH_OUT,68969.0,C1620621442
34688,409000362497',2018-10-04,AVENUES INDIA PRIVATE LIM,24855.0,0.0,,2018,10,4,CHECK_WITHDRAWAL,24855.0,C1161865950
34689,409000362497',2018-10-04,ZAAK EPAYMENT SERVICES PR,989.0,0.0,,2018,10,4,PAYEMENT,989.0,M20609015
34690,409000362497',2018-10-04,FUTURE RETAIL LIMITED (OW,9834.0,0.0,,2018,10,4,PAYEMENT,9834.0,M2105152537
34691,409000362497',2018-10-04,PASFAR TECHNOLOGIES PRIVA,3917.0,0.0,,2018,10,4,CASH_OUT,3917.0,C254123095
34692,409000362497',2018-10-04,MEHAR ENTERTAINMENT PRIVA,8757.0,0.0,,2018,10,4,PAYEMENT,8757.0,C1429623854
34693,409000362497',2018-10-04,DISH INFRA SERVICES PRIVA,1275.0,0.0,,2018,10,4,DEBIT,1275.0,C1132795252
34694,409000362497',2018-10-04,VOUCHER ACTIVATION SERVIC,7823.0,0.0,,2018,10,4,DEBIT,7823.0,C836878317
34695,409000362497',2018-10-04,Indiaforensic SERVICES INDIA PVT,414089.0,0.0,,2018,10,4,CASH_OUT,414089.0,C979719862
34696,409000362497',2018-10-04,IMPS 0310181C,608032.01,0.0,,2018,10,4,CHECK_WITHDRAWAL,608032.01,C1535686985
34697,409000362497',2018-10-04,IMPS 0410182C,1543893.23,0.0,,2018,10,4,DEBIT,1543893.23,C1227688628
34698,409000362497',2018-10-04,IMPS 0410183C,3238786.68,0.0,,2018,10,4,CHECK_WITHDRAWAL,3238786.68,C2144965730
34699,409000362497',2018-10-04,INDIAIDEAS.COM LTD,6154.0,0.0,,2018,10,4,CHECK_WITHDRAWAL,6154.0,C661442540
34700,409000362497',2018-10-04,PAYU PAYMENTS PRIVATE LIM,1196.0,0.0,,2018,10,4,PAYEMENT,1196.0,C225852166
34701,409000362497',2018-10-04,AVENUES INDIA PRIVATE LIM,9105.0,0.0,,2018,10,4,CASH_OUT,9105.0,C797657283
34702,409000362497',2018-10-04,QWIKCILVER SOLUTIONS PRIV,5536.0,0.0,,2018,10,4,PAYEMENT,5536.0,C1036138670
34703,409000362497',2018-10-04,Indiaforensic SERVICES INDIA PVT,117758.0,0.0,,2018,10,4,CASH_OUT,117758.0,C35126588
34704,409000362497',2018-10-04,IMPS 0410184C,465987.97,0.0,,2018,10,4,PAYEMENT,465987.97,C382961988
34705,409000362497',2018-10-04,FDRL/INTERNAL FUND TRANSFE,0.0,500000.0,,2018,10,4,TRANSFER,500000.0,C981261533
34706,409000362497',2018-10-04,FDRL/INTERNAL FUND TRANSFE,0.0,500000.0,,2018,10,4,CHECK_CASHING,500000.0,C1962165373
34707,409000362497',2018-10-04,FDRL/INTERNAL FUND TRANSFE,0.0,500000.0,,2018,10,4,TRANSFER,500000.0,C2040656033
34708,409000362497',2018-10-04,FDRL/INTERNAL FUND TRANSFE,0.0,500000.0,,2018,10,4,CHECK_CASHING,500000.0,C329829198
34709,409000362497',2018-10-04,FDRL/INTERNAL FUND TRANSFE,0.0,500000.0,,2018,10,4,TRANSFER,500000.0,C644165296
34710,409000362497',2018-10-04,FDRL/INTERNAL FUND TRANSFE,0.0,500000.0,,2018,10,4,CASH_IN,500000.0,C2036762590
34711,409000362497',2018-10-04,FDRL/INTERNAL FUND TRANSFE,0.0,500000.0,,2018,10,4,CHECK_CASHING,500000.0,C357863579
34712,409000362497',2018-10-04,FDRL/INTERNAL FUND TRANSFE,0.0,500000.0,,2018,10,4,CASH_IN,500000.0,M1197129438
34713,409000362497',2018-10-04,IMPS 827723339885 FROM OX,0.0,200000.0,,2018,10,4,CHECK_CASHING,200000.0,M14680673
34714,409000362497',2018-10-04,IMPS 827723339907 FROM OX,0.0,200000.0,,2018,10,4,TRANSFER,200000.0,M1122015967
34715,409000362497',2018-10-04,IMPS 827723339939 FROM OX,0.0,200000.0,,2018,10,4,CHECK_CASHING,200000.0,C284320179
34716,409000362497',2018-10-04,IMPS 827723339965 FROM OX,0.0,200000.0,,2018,10,4,CASH_IN,200000.0,C1494727044
34717,409000362497',2018-10-04,IMPS 827723339992 FROM OX,0.0,200000.0,,2018,10,4,CASH_IN,200000.0,C1857357520
34718,409000362497',2018-10-04,IMPS 827723340013 FROM OX,0.0,200000.0,,2018,10,4,CHECK_CASHING,200000.0,C1539907170
34719,409000362497',2018-10-04,IMPS 827723340033 FROM OX,0.0,200000.0,,2018,10,4,CHECK_CASHING,200000.0,C1503386238
34720,409000362497',2018-10-04,IMPS 827723340057 FROM OX,0.0,200000.0,,2018,10,4,TRANSFER,200000.0,C2049813033
34721,409000362497',2018-10-04,IMPS 827723340108 FROM OX,0.0,200000.0,,2018,10,4,CHECK_CASHING,200000.0,M151898094
34722,409000362497',2018-10-04,IMPS 827723340128 FROM OX,0.0,200000.0,,2018,10,4,CASH_IN,200000.0,C1521704415
34723,409000362497',2018-10-04,Sweep Trf To: 40900036427,191151.0,0.0,,2018,10,4,CHECK_WITHDRAWAL,191151.0,C443298466
34724,409000362497',2018-10-05,TDS operative a/c dr for,1146.0,0.0,,2018,10,5,CHECK_WITHDRAWAL,1146.0,C678279746
34725,409000362497',2018-10-05,RF For 709001931954,0.0,43306.0,,2018,10,5,TRANSFER,43306.0,C998875386
34726,409000362497',2018-10-05,IMPS 0410181C,252890.33,0.0,,2018,10,5,DEBIT,252890.33,C2044342029
34727,409000362497',2018-10-05,IMPS 0510182C,2067231.0,0.0,,2018,10,5,CASH_OUT,2067231.0,M1496549140
34728,409000362497',2018-10-05,INDIAIDEAS.COM LTD,18422.0,0.0,,2018,10,5,PAYEMENT,18422.0,M1046861851
34729,409000362497',2018-10-05,PAYU PAYMENTS PRIVATE LIM,6269.0,0.0,,2018,10,5,CASH_OUT,6269.0,C536171536
34730,409000362497',2018-10-05,AVENUES INDIA PRIVATE LIM,2779.0,0.0,,2018,10,5,PAYEMENT,2779.0,C2037251990
34731,409000362497',2018-10-05,FUTURE RETAIL LIMITED (OW,272.0,0.0,,2018,10,5,CASH_OUT,272.0,C732929122
34732,409000362497',2018-10-05,MEHAR ENTERTAINMENT PRIVA,2765.0,0.0,,2018,10,5,CASH_OUT,2765.0,C559992585
34733,409000362497',2018-10-05,Indiaforensic SERVICES INDIA PVT,92333.0,0.0,,2018,10,5,CASH_OUT,92333.0,C2077672286
34734,409000362497',2018-10-05,IMPS 0510183C,2569479.03,0.0,,2018,10,5,PAYEMENT,2569479.03,C505366143
34735,409000362497',2018-10-05,FDRL/INTERNAL FUND TRANSFE,0.0,1000000.0,,2018,10,5,CASH_IN,1000000.0,C870064925
34736,409000362497',2018-10-05,FDRL/INTERNAL FUND TRANSFE,0.0,1000000.0,,2018,10,5,CASH_IN,1000000.0,C1289453529
34737,409000362497',2018-10-05,FDRL/INTERNAL FUND TRANSFE,0.0,1000000.0,,2018,10,5,CASH_IN,1000000.0,C697172013
34738,409000362497',2018-10-05,FDRL/INTERNAL FUND TRANSFE,0.0,1000000.0,,2018,10,5,TRANSFER,1000000.0,C2078250226
34739,409000362497',2018-10-05,FDRL/INTERNAL FUND TRANSFE,0.0,1000000.0,,2018,10,5,CHECK_CASHING,1000000.0,C2057394816
34740,409000362497',2018-10-05,FDRL/INTERNAL FUND TRANSFE,0.0,1000000.0,,2018,10,5,CHECK_CASHING,1000000.0,C1019227219
34741,409000362497',2018-10-05,FDRL/INTERNAL FUND TRANSFE,0.0,1000000.0,,2018,10,5,CHECK_CASHING,1000000.0,C540431138
34742,409000362497',2018-10-05,IMPS 0510184C,587144.63,0.0,,2018,10,5,DEBIT,587144.63,C1943497629
34743,409000362497',2018-10-05,Sweep Trf To: 40900036427,106450.0,0.0,,2018,10,5,CHECK_WITHDRAWAL,106450.0,C137840913
34744,409000362497',2018-10-06,IMPS 0309181C,824157.27,0.0,,2018,10,6,CHECK_WITHDRAWAL,824157.27,C1474409352
34745,409000362497',2018-10-06,IMPS 0610182C,1728990.17,0.0,,2018,10,6,PAYEMENT,1728990.17,C1691655733
34746,409000362497',2018-10-06,IMPS 0610183C,1675465.78,0.0,,2018,10,6,CHECK_WITHDRAWAL,1675465.78,C1461657245
34747,409000362497',2018-10-06,NEFT/SBIN118279752593/Indfor,0.0,2000000.0,,2018,10,6,TRANSFER,2000000.0,C1240730624
34748,409000362497',2018-10-06,NEFT/AXIC182793391608/Indfor,0.0,4500000.0,,2018,10,6,TRANSFER,4500000.0,C147916733
34749,409000362497',2018-10-06,IMPS 0610184C,91031.11,0.0,,2018,10,6,DEBIT,91031.11,C125722707
34750,409000362497',2018-10-06,Sweep Trf To: 40900036427,88750.0,0.0,,2018,10,6,DEBIT,88750.0,C2129901484
34751,409000362497',2018-10-08,IMPS 0610181C,565922.08,0.0,,2018,10,8,PAYEMENT,565922.08,M1066733031
34752,409000362497',2018-10-08,IMPS 0710181C,265427.97,0.0,,2018,10,8,CHECK_WITHDRAWAL,265427.97,C26334874
34753,409000362497',2018-10-08,IMPS 0810182C,2948850.63,0.0,,2018,10,8,PAYEMENT,2948850.63,M1080778230
34754,409000362497',2018-10-08,INDIAIDEAS.COM LTD,26276.0,0.0,,2018,10,8,CASH_OUT,26276.0,M825097035
34755,409000362497',2018-10-08,PAYU PAYMENTS PRIVATE LIM,11925.0,0.0,,2018,10,8,CASH_OUT,11925.0,C164799505
34756,409000362497',2018-10-08,AVENUES INDIA PRIVATE LIM,2400.0,0.0,,2018,10,8,DEBIT,2400.0,M47381432
34757,409000362497',2018-10-08,FUTURE RETAIL LIMITED (OW,1874.0,0.0,,2018,10,8,CHECK_WITHDRAWAL,1874.0,C1566789241
34758,409000362497',2018-10-08,METRO INFRASYS PRIVATE LI,697.0,0.0,,2018,10,8,PAYEMENT,697.0,C1395746279
34759,409000362497',2018-10-08,MEHAR ENTERTAINMENT PRIVA,2996.0,0.0,,2018,10,8,PAYEMENT,2996.0,C1210180003
34760,409000362497',2018-10-08,ALT DIGITAL MEDIA ENTERTA,98.0,0.0,,2018,10,8,PAYEMENT,98.0,M556210449
34761,409000362497',2018-10-08,Indiaforensic SERVICES INDIA PVT,196435.0,0.0,,2018,10,8,PAYEMENT,196435.0,C1853202598
34762,409000362497',2018-10-08,IMPS 0810183C,2377897.46,0.0,,2018,10,8,CHECK_WITHDRAWAL,2377897.46,C796028148
34763,409000362497',2018-10-08,FDRL/INTERNAL FUND TRANSFE,0.0,1000000.0,,2018,10,8,CASH_IN,1000000.0,C1776971477
34764,409000362497',2018-10-08,FDRL/INTERNAL FUND TRANSFE,0.0,1000000.0,,2018,10,8,TRANSFER,1000000.0,M6124782
34765,409000362497',2018-10-08,FDRL/INTERNAL FUND TRANSFE,0.0,500000.0,,2018,10,8,TRANSFER,500000.0,M88695564
34766,409000362497',2018-10-08,IMPS 0810184C,91248.21,0.0,,2018,10,8,CASH_OUT,91248.21,M37574873
34767,409000362497',2018-10-08,Sweep Trf To: 40900036427,178872.0,0.0,,2018,10,8,PAYEMENT,178872.0,M364735350
34768,409000362497',2018-10-09,IMPS 0810181C,155736.73,0.0,,2018,10,9,PAYEMENT,155736.73,C35617324
34769,409000362497',2018-10-09,IMPS 0910182C,1784165.52,0.0,,2018,10,9,CHECK_WITHDRAWAL,1784165.52,M1001297984
34770,409000362497',2018-10-09,INDIAIDEAS.COM LTD,5128.0,0.0,,2018,10,9,CHECK_WITHDRAWAL,5128.0,C464427867
34771,409000362497',2018-10-09,PAYU PAYMENTS PRIVATE LIM,6321.0,0.0,,2018,10,9,CASH_OUT,6321.0,M907379745
34772,409000362497',2018-10-09,FUTURE RETAIL LIMITED (OW,197.0,0.0,,2018,10,9,CHECK_WITHDRAWAL,197.0,M157563367
34773,409000362497',2018-10-09,QWIKCILVER SOLUTIONS PRIV,4317.0,0.0,,2018,10,9,CASH_OUT,4317.0,M1178056810
34774,409000362497',2018-10-09,Indiaforensic SERVICES INDIA PVT,81143.0,0.0,,2018,10,9,PAYEMENT,81143.0,M611922496
34775,409000362497',2018-10-09,IMPS 0910183C,2727911.07,0.0,,2018,10,9,CASH_OUT,2727911.07,M1260508199
34776,409000362497',2018-10-09,FDRL/INTERNAL FUND TRANSFE,0.0,1000000.0,,2018,10,9,CASH_IN,1000000.0,M2127328416
34777,409000362497',2018-10-09,FDRL/INTERNAL FUND TRANSFE,0.0,5000000.0,,2018,10,9,CASH_IN,5000000.0,M2098464086
34778,409000362497',2018-10-09,IMPS 0910184C,536688.17,0.0,,2018,10,9,CASH_OUT,536688.17,C812586739
34779,409000362497',2018-10-09,Sweep Trf To: 40900036427,329880.0,0.0,,2018,10,9,PAYEMENT,329880.0,C224342296
34780,409000362497',2018-10-10,IMPS 0910181C,412608.67,0.0,,2018,10,10,CHECK_WITHDRAWAL,412608.67,M1214561856
34781,409000362497',2018-10-10,IMPS 1010182C,2429887.21,0.0,,2018,10,10,CHECK_WITHDRAWAL,2429887.21,M1970849542
34782,409000362497',2018-10-10,ACH DR NATIONAL PAYMENT C,5792.33,0.0,,2018,10,10,CASH_OUT,5792.33,M873495238
34783,409000362497',2018-10-10,IMPS 1010183C,2031008.01,0.0,,2018,10,10,CASH_OUT,2031008.01,C1261940778
34784,409000362497',2018-10-10,NEFT/000052843348/INDIAID,20779.0,0.0,,2018,10,10,DEBIT,20779.0,C2084129621
34785,409000362497',2018-10-10,NEFT/000052843486/PAYU PA,7335.0,0.0,,2018,10,10,CASH_OUT,7335.0,M1659727383
34786,409000362497',2018-10-10,NEFT/000052843690/AVENUES,1289.0,0.0,,2018,10,10,CASH_OUT,1289.0,C1627965794
34787,409000362497',2018-10-10,NEFT/000052843869/MEHAR E,1498.0,0.0,,2018,10,10,CHECK_WITHDRAWAL,1498.0,M2114306824
34788,409000362497',2018-10-10,NEFT/000052844103/VOUCHER,4337.0,0.0,,2018,10,10,DEBIT,4337.0,M662731973
34789,409000362497',2018-10-10,TRF TO 1196428  Indiaforensic SE,65843.0,0.0,,2018,10,10,CASH_OUT,65843.0,M1791389949
34790,409000362497',2018-10-10,FDRL/INTERNAL FUND TRANSFE,0.0,1000000.0,,2018,10,10,CHECK_CASHING,1000000.0,M894839760
34791,409000362497',2018-10-10,FDRL/INTERNAL FUND TRANSFE,0.0,5000000.0,,2018,10,10,CASH_IN,5000000.0,M166325623
34792,409000362497',2018-10-10,IMPS 1010184C,362519.66,0.0,,2018,10,10,CHECK_WITHDRAWAL,362519.66,C5608749
34793,409000362497',2018-10-10,Sweep Trf To: 40900036427,494045.0,0.0,,2018,10,10,PAYEMENT,494045.0,M1698909330
34794,409000362497',2018-10-11,IMPS 1010181C,415739.04,0.0,,2018,10,11,PAYEMENT,415739.04,M580153634
34795,409000362497',2018-10-11,IMPS 1110182C,2340226.33,0.0,,2018,10,11,CASH_OUT,2340226.33,C126129101
34796,409000362497',2018-10-11,INDIAIDEAS.COM LTD,18270.0,0.0,,2018,10,11,CASH_OUT,18270.0,C1674899618
34797,409000362497',2018-10-11,PAYU PAYMENTS PRIVATE LIM,28649.0,0.0,,2018,10,11,PAYEMENT,28649.0,M598548672
34798,409000362497',2018-10-11,AVENUES INDIA PRIVATE LIM,606.0,0.0,,2018,10,11,DEBIT,606.0,M458566160
34799,409000362497',2018-10-11,PASFAR TECHNOLOGIES PRIVA,122.0,0.0,,2018,10,11,PAYEMENT,122.0,M2045490142
34800,409000362497',2018-10-11,MEHAR ENTERTAINMENT PRIVA,2765.0,0.0,,2018,10,11,DEBIT,2765.0,C1216092644
34801,409000362497',2018-10-11,Indiaforensic SERVICES INDIA PVT,97773.0,0.0,,2018,10,11,DEBIT,97773.0,C814886797
34802,409000362497',2018-10-11,IMPS 1110183C,2181735.15,0.0,,2018,10,11,CASH_OUT,2181735.15,C486108916
34803,409000362497',2018-10-11,FDRL/INTERNAL FUND TRANSFE,0.0,1000000.0,,2018,10,11,CHECK_CASHING,1000000.0,C645187727
34804,409000362497',2018-10-11,FDRL/INTERNAL FUND TRANSFE,0.0,5000000.0,,2018,10,11,CHECK_CASHING,5000000.0,C2040657244
34805,409000362497',2018-10-11,FDRL/INTERNAL FUND TRANSFE,0.0,1000000.0,,2018,10,11,CHECK_CASHING,1000000.0,C1189861498
34806,409000362497',2018-10-11,IMPS 1110184C,634933.88,0.0,,2018,10,11,DEBIT,634933.88,C1400419820
34807,409000362497',2018-10-11,Sweep Trf To: 40900036427,429091.0,0.0,,2018,10,11,DEBIT,429091.0,C77635419
34808,409000362497',2018-10-12,IMPS 1110181C,688127.62,0.0,,2018,10,12,DEBIT,688127.62,C618390656
34809,409000362497',2018-10-12,IMPS 1210182C,1879593.32,0.0,,2018,10,12,DEBIT,1879593.32,M394853221
34810,409000362497',2018-10-12,IMPS 1210183C,2673006.5,0.0,,2018,10,12,PAYEMENT,2673006.5,C1146719991
34811,409000362497',2018-10-12,INDIAIDEAS.COM LTD,21405.0,0.0,,2018,10,12,CHECK_WITHDRAWAL,21405.0,M306554664
34812,409000362497',2018-10-12,PAYU PAYMENTS PRIVATE LIM,26375.0,0.0,,2018,10,12,CHECK_WITHDRAWAL,26375.0,M1114858486
34813,409000362497',2018-10-12,AVENUES INDIA PRIVATE LIM,302.0,0.0,,2018,10,12,DEBIT,302.0,M911518256
34814,409000362497',2018-10-12,FUTURE RETAIL LIMITED (OW,216.0,0.0,,2018,10,12,PAYEMENT,216.0,M486172197
34815,409000362497',2018-10-12,MEHAR ENTERTAINMENT PRIVA,1037.0,0.0,,2018,10,12,CASH_OUT,1037.0,C260838211
34816,409000362497',2018-10-12,Indiaforensic SERVICES INDIA PVT,117798.0,0.0,,2018,10,12,CHECK_WITHDRAWAL,117798.0,M78924391
34817,409000362497',2018-10-12,IMPS 1210184C,742888.09,0.0,,2018,10,12,CHECK_WITHDRAWAL,742888.09,M1048524951
34818,409000362497',2018-10-12,FDRL/INTERNAL FUND TRANSFE,0.0,1000000.0,,2018,10,12,CHECK_CASHING,1000000.0,M1334950191
34819,409000362497',2018-10-12,FDRL/INTERNAL FUND TRANSFE,0.0,1000000.0,,2018,10,12,CASH_IN,1000000.0,M1173145613
34820,409000362497',2018-10-12,FDRL/INTERNAL FUND TRANSFE,0.0,1000000.0,,2018,10,12,CASH_IN,1000000.0,M1866872276
34821,409000362497',2018-10-12,FDRL/INTERNAL FUND TRANSFE,0.0,2000000.0,,2018,10,12,CHECK_CASHING,2000000.0,M1229328547
34822,409000362497',2018-10-12,FDRL/INTERNAL FUND TRANSFE,0.0,2000000.0,,2018,10,12,CASH_IN,2000000.0,C926192308
34823,409000362497',2018-10-12,Sweep Trf To: 40900036427,306162.0,0.0,,2018,10,12,CASH_OUT,306162.0,C657312979
34824,409000362497',2018-10-15,IMPS 1210181C,538697.04,0.0,,2018,10,15,CASH_OUT,538697.04,C1907989702
34825,409000362497',2018-10-15,IMPS 1310181C,1000633.26,0.0,,2018,10,15,CHECK_WITHDRAWAL,1000633.26,M1885129477
34826,409000362497',2018-10-15,IMPS 1410181C,236997.78,0.0,,2018,10,15,CASH_OUT,236997.78,C871894429
34827,409000362497',2018-10-15,IMPS 1510182C,2948168.35,0.0,,2018,10,15,CHECK_WITHDRAWAL,2948168.35,C2115498160
34828,409000362497',2018-10-15,INDIAIDEAS.COM LTD,44627.0,0.0,,2018,10,15,CASH_OUT,44627.0,M1348794799
34829,409000362497',2018-10-15,PAYU PAYMENTS PRIVATE LIM,10181.0,0.0,,2018,10,15,CASH_OUT,10181.0,M451119163
34830,409000362497',2018-10-15,AVENUES INDIA PRIVATE LIM,9942.0,0.0,,2018,10,15,PAYEMENT,9942.0,M462017258
34831,409000362497',2018-10-15,FUTURE RETAIL LIMITED (OW,1871.0,0.0,,2018,10,15,CHECK_WITHDRAWAL,1871.0,C395114097
34832,409000362497',2018-10-15,MEHAR ENTERTAINMENT PRIVA,5300.0,0.0,,2018,10,15,CHECK_WITHDRAWAL,5300.0,C1223591088
34833,409000362497',2018-10-15,ALT DIGITAL MEDIA ENTERTA,98.0,0.0,,2018,10,15,CASH_OUT,98.0,C1672787330
34834,409000362497',2018-10-15,Indiaforensic SERVICES INDIA PVT,261511.0,0.0,,2018,10,15,CASH_OUT,261511.0,M1848972163
34835,409000362497',2018-10-15,IMPS 1510183C,1767579.3,0.0,,2018,10,15,PAYEMENT,1767579.3,M1322325178
34836,409000362497',2018-10-15,FDRL/INTERNAL FUND TRANSFE,0.0,3000000.0,,2018,10,15,CASH_IN,3000000.0,M1149354816
34837,409000362497',2018-10-15,FDRL/INTERNAL FUND TRANSFE,0.0,2000000.0,,2018,10,15,CASH_IN,2000000.0,M216056499
34838,409000362497',2018-10-15,FDRL/INTERNAL FUND TRANSFE,0.0,2000000.0,,2018,10,15,CASH_IN,2000000.0,M925024094
34839,409000362497',2018-10-15,IMPS 1510184C,750497.85,0.0,,2018,10,15,CASH_OUT,750497.85,C1811531351
34840,409000362497',2018-10-15,Sweep Trf To: 40900036427,539069.0,0.0,,2018,10,15,CASH_OUT,539069.0,C1727565779
34841,409000362497',2018-10-16,IMPS 1510181C,224751.99,0.0,,2018,10,16,CHECK_WITHDRAWAL,224751.99,C1554540309
34842,409000362497',2018-10-16,IMPS 1610182C,2194979.54,0.0,,2018,10,16,CHECK_WITHDRAWAL,2194979.54,C1665979484
34843,409000362497',2018-10-16,INDIAIDEAS.COM LTD,39386.0,0.0,,2018,10,16,CHECK_WITHDRAWAL,39386.0,C919488700
34844,409000362497',2018-10-16,PAYU PAYMENTS PRIVATE LIM,5796.0,0.0,,2018,10,16,CASH_OUT,5796.0,C460247313
34845,409000362497',2018-10-16,AVENUES INDIA PRIVATE LIM,7932.0,0.0,,2018,10,16,CHECK_WITHDRAWAL,7932.0,C569022831
34846,409000362497',2018-10-16,FUTURE RETAIL LIMITED (OW,120.0,0.0,,2018,10,16,CHECK_WITHDRAWAL,120.0,C929452805
34847,409000362497',2018-10-16,METRO INFRASYS PRIVATE LI,697.0,0.0,,2018,10,16,PAYEMENT,697.0,C2116153614
34848,409000362497',2018-10-16,QWIKCILVER SOLUTIONS PRIV,10225.0,0.0,,2018,10,16,PAYEMENT,10225.0,M1324843000
34849,409000362497',2018-10-16,Indiaforensic SERVICES INDIA PVT,91604.0,0.0,,2018,10,16,CHECK_WITHDRAWAL,91604.0,C216890954
34850,409000362497',2018-10-16,IMPS 1610183C,2397855.18,0.0,,2018,10,16,CHECK_WITHDRAWAL,2397855.18,M1372760240
34851,409000362497',2018-10-16,FDRL/INTERNAL FUND TRANSFE,0.0,3000000.0,,2018,10,16,TRANSFER,3000000.0,M820243005
34852,409000362497',2018-10-16,FDRL/INTERNAL FUND TRANSFE,0.0,3000000.0,,2018,10,16,TRANSFER,3000000.0,M986575377
34853,409000362497',2018-10-16,FDRL/INTERNAL FUND TRANSFE,0.0,500000.0,,2018,10,16,CHECK_CASHING,500000.0,M1225602325
34854,409000362497',2018-10-16,IMPS 1610184C,755344.54,0.0,,2018,10,16,CASH_OUT,755344.54,M268803366
34855,409000362497',2018-10-16,Sweep Trf To: 40900036427,196194.0,0.0,,2018,10,16,PAYEMENT,196194.0,M1388130136
34856,409000362497',2018-10-17,IMPS 1710181C,457563.58,0.0,,2018,10,17,DEBIT,457563.58,M1189028859
34857,409000362497',2018-10-17,IMPS 1710182C,1653814.98,0.0,,2018,10,17,CASH_OUT,1653814.98,M1332070434
34858,409000362497',2018-10-17,INDIAIDEAS.COM LTD,29180.0,0.0,,2018,10,17,DEBIT,29180.0,M1912467658
34859,409000362497',2018-10-17,PAYU PAYMENTS PRIVATE LIM,7451.0,0.0,,2018,10,17,CASH_OUT,7451.0,C656400047
34860,409000362497',2018-10-17,AVENUES INDIA PRIVATE LIM,211.0,0.0,,2018,10,17,CHECK_WITHDRAWAL,211.0,C1854820399
34861,409000362497',2018-10-17,FUTURE RETAIL LIMITED (OW,197.0,0.0,,2018,10,17,CASH_OUT,197.0,M1841691753
34862,409000362497',2018-10-17,MEHAR ENTERTAINMENT PRIVA,2765.0,0.0,,2018,10,17,DEBIT,2765.0,C783654411
34863,409000362497',2018-10-17,VOUCHER ACTIVATION SERVIC,2139.0,0.0,,2018,10,17,DEBIT,2139.0,M1367007563
34864,409000362497',2018-10-17,Indiaforensic SERVICES INDIA PVT,107505.0,0.0,,2018,10,17,PAYEMENT,107505.0,M1467683913
34865,409000362497',2018-10-17,IMPS 1710183C,2230643.37,0.0,,2018,10,17,DEBIT,2230643.37,C907770473
34866,409000362497',2018-10-17,FDRL/INTERNAL FUND TRANSFE,0.0,3000000.0,,2018,10,17,CHECK_CASHING,3000000.0,M178011092
34867,409000362497',2018-10-17,FDRL/INTERNAL FUND TRANSFE,0.0,3000000.0,,2018,10,17,CASH_IN,3000000.0,M632611275
34868,409000362497',2018-10-17,IMPS 171020184C,1114640.82,0.0,,2018,10,17,CASH_OUT,1114640.82,M1577495810
34869,409000362497',2018-10-17,Sweep Trf To: 40900036427,142826.0,0.0,,2018,10,17,CASH_OUT,142826.0,C113168226
34870,409000362497',2018-10-18,IMPS 1710181C,581214.52,0.0,,2018,10,18,PAYEMENT,581214.52,C1217639236
34871,409000362497',2018-10-18,IMPS 1810182C,1102286.1,0.0,,2018,10,18,CHECK_WITHDRAWAL,1102286.1,M699100650
34872,409000362497',2018-10-18,IMPS 181020183C,1455638.66,0.0,,2018,10,18,CASH_OUT,1455638.66,C560030461
34873,409000362497',2018-10-18,FDRL/INTERNAL FUND TRANSFE,0.0,2000000.0,,2018,10,18,TRANSFER,2000000.0,C382934088
34874,409000362497',2018-10-18,FDRL/INTERNAL FUND TRANSFE,0.0,2000000.0,,2018,10,18,CHECK_CASHING,2000000.0,M777774288
34875,409000362497',2018-10-18,IMPS 181020184C,411826.89,0.0,,2018,10,18,CASH_OUT,411826.89,M998778388
34876,409000362497',2018-10-18,Sweep Trf To: 40900036427,171590.0,0.0,,2018,10,18,PAYEMENT,171590.0,C1459861371
34877,409000362497',2018-10-19,IMPS 1910182C,578598.77,0.0,,2018,10,19,DEBIT,578598.77,C1383454473
34878,409000362497',2018-10-19,IMPS 1810181C,323455.12,0.0,,2018,10,19,PAYEMENT,323455.12,M839547062
34879,409000362497',2018-10-19,IMPS 191020183C,1567540.59,0.0,,2018,10,19,CASH_OUT,1567540.59,C871895680
34880,409000362497',2018-10-19,FDRL/INTERNAL FUND TRANSFE,0.0,500000.0,,2018,10,19,CASH_IN,500000.0,C842672981
34881,409000362497',2018-10-19,FDRL/INTERNAL FUND TRANSFE,0.0,500000.0,,2018,10,19,CHECK_CASHING,500000.0,M1220573907
34882,409000362497',2018-10-19,FDRL/INTERNAL FUND TRANSFE,0.0,3000000.0,,2018,10,19,CASH_IN,3000000.0,M820218280
34883,409000362497',2018-10-19,IMPS 191020184C,748410.62,0.0,,2018,10,19,DEBIT,748410.62,M558801983
34884,409000362497',2018-10-19,Sweep Trf To: 40900036427,83050.0,0.0,,2018,10,19,CASH_OUT,83050.0,C758888772
34885,409000362497',2018-10-20,IMPS 1910181C,617093.28,0.0,,2018,10,20,CASH_OUT,617093.28,C643658493
34886,409000362497',2018-10-20,IMPS 2010182C,767599.36,0.0,,2018,10,20,CASH_OUT,767599.36,C475231857
34887,409000362497',2018-10-20,IMPS 2010183C,1900584.04,0.0,,2018,10,20,CASH_OUT,1900584.04,C1336996537
34888,409000362497',2018-10-20,FDRL/INTERNAL FUND TRANSFE,0.0,500000.0,,2018,10,20,CASH_IN,500000.0,M1166083872
34889,409000362497',2018-10-20,FDRL/INTERNAL FUND TRANSFE,0.0,2000000.0,,2018,10,20,CASH_IN,2000000.0,M1208116334
34890,409000362497',2018-10-20,FDRL/INTERNAL FUND TRANSFE,0.0,2000000.0,,2018,10,20,CHECK_CASHING,2000000.0,C134822492
34891,409000362497',2018-10-20,IMPS 2010184C,925507.58,0.0,,2018,10,20,DEBIT,925507.58,C515132998
34892,409000362497',2018-10-20,Sweep Trf To: 40900036427,116073.0,0.0,,2018,10,20,CHECK_WITHDRAWAL,116073.0,M869601706
34893,409000362497',2018-10-22,IMPS 2010181C,534092.27,0.0,,2018,10,22,PAYEMENT,534092.27,M1395921315
34894,409000362497',2018-10-22,IMPS 2110181C,333015.74,0.0,,2018,10,22,CHECK_WITHDRAWAL,333015.74,M1493691058
34895,409000362497',2018-10-22,IMPS 2210182C,1244102.61,0.0,,2018,10,22,CASH_OUT,1244102.61,C1629439751
34896,409000362497',2018-10-22,IMPS 2210183C,1995144.78,0.0,,2018,10,22,PAYEMENT,1995144.78,M1338063311
34897,409000362497',2018-10-22,FDRL/INTERNAL FUND TRANSFE,0.0,5000000.0,,2018,10,22,TRANSFER,5000000.0,C467311030
34898,409000362497',2018-10-22,IMPS 2210184C,699989.39,0.0,,2018,10,22,PAYEMENT,699989.39,M256220207
34899,409000362497',2018-10-22,Sweep Trf To: 40900036427,172422.0,0.0,,2018,10,22,PAYEMENT,172422.0,M1212090487
34900,409000362497',2018-10-23,INDIAIDEAS.COM LTD,74004.0,0.0,,2018,10,23,DEBIT,74004.0,M1568790852
34901,409000362497',2018-10-23,PAYU PAYMENTS PRIVATE LIM,57178.0,0.0,,2018,10,23,CHECK_WITHDRAWAL,57178.0,C1981839580
34902,409000362497',2018-10-23,AVENUES INDIA PRIVATE LIM,10094.0,0.0,,2018,10,23,PAYEMENT,10094.0,C1948471365
34903,409000362497',2018-10-23,FUTURE RETAIL LIMITED (OW,2206.0,0.0,,2018,10,23,PAYEMENT,2206.0,M1536355445
34904,409000362497',2018-10-23,MEHAR ENTERTAINMENT PRIVA,19010.0,0.0,,2018,10,23,DEBIT,19010.0,C1870237274
34905,409000362497',2018-10-23,BIDDERBOY CORPORATION,1022.0,0.0,,2018,10,23,CHECK_WITHDRAWAL,1022.0,C448155494
34906,409000362497',2018-10-23,PASFAR TECHNOLOGIES PRIVA,98.0,0.0,,2018,10,23,CHECK_WITHDRAWAL,98.0,M462372115
34907,409000362497',2018-10-23,DISH INFRA SERVICES PRIVA,293.0,0.0,,2018,10,23,DEBIT,293.0,C895798008
34908,409000362497',2018-10-23,Indiaforensic SERVICES INDIA PVT,405838.0,0.0,,2018,10,23,CASH_OUT,405838.0,M1734578348
34909,409000362497',2018-10-23,IMPS 2210181C,388726.05,0.0,,2018,10,23,CASH_OUT,388726.05,C1846530780
34910,409000362497',2018-10-23,IMPS 2310182C,1329128.73,0.0,,2018,10,23,PAYEMENT,1329128.73,M1982079379
34911,409000362497',2018-10-23,PAYU PAYMENTS PRIVATE LIM,9364.0,0.0,,2018,10,23,DEBIT,9364.0,C899358551
34912,409000362497',2018-10-23,AVENUES INDIA PRIVATE LIM,649.0,0.0,,2018,10,23,CHECK_WITHDRAWAL,649.0,C1320515149
34913,409000362497',2018-10-23,QWIKCILVER SOLUTIONS PRIV,17123.0,0.0,,2018,10,23,CHECK_WITHDRAWAL,17123.0,M677975525
34914,409000362497',2018-10-23,Indiaforensic SERVICES (INDIA) P,108364.0,0.0,,2018,10,23,PAYEMENT,108364.0,C2019043622
34915,409000362497',2018-10-23,IMPS 2310183C,2554210.05,0.0,,2018,10,23,CHECK_WITHDRAWAL,2554210.05,C1557753656
34916,409000362497',2018-10-23,FDRL/INTERNAL FUND TRANSFE,0.0,2000000.0,,2018,10,23,CHECK_CASHING,2000000.0,M51906220
34917,409000362497',2018-10-23,FDRL/INTERNAL FUND TRANSFE,0.0,500000.0,,2018,10,23,TRANSFER,500000.0,C1756674523
34918,409000362497',2018-10-23,FDRL/INTERNAL FUND TRANSFE,0.0,3000000.0,,2018,10,23,CASH_IN,3000000.0,M1642888869
34919,409000362497',2018-10-23,IMPS 2310184C,863158.82,0.0,,2018,10,23,CHECK_WITHDRAWAL,863158.82,M1339372025
34920,409000362497',2018-10-23,Sweep Trf To: 40900036427,146086.0,0.0,,2018,10,23,CHECK_WITHDRAWAL,146086.0,C14576684
34921,409000362497',2018-10-24,IMPS 0309181C,451546.14,0.0,,2018,10,24,DEBIT,451546.14,M2055515313
34922,409000362497',2018-10-24,IMPS 2410182C,927629.7,0.0,,2018,10,24,PAYEMENT,927629.7,C1963658928
34923,409000362497',2018-10-24,IMPS 2410183C,1898453.38,0.0,,2018,10,24,PAYEMENT,1898453.38,M1154419875
34924,409000362497',2018-10-24,NEFT/AXIC182978442571/Indfor,0.0,3000000.0,,2018,10,24,TRANSFER,3000000.0,M1200780584
34925,409000362497',2018-10-24,FDRL/INTERNAL FUND TRANSFE,0.0,500000.0,,2018,10,24,TRANSFER,500000.0,M769667423
34926,409000362497',2018-10-24,FDRL/INTERNAL FUND TRANSFE,0.0,1000000.0,,2018,10,24,CHECK_CASHING,1000000.0,M1818687737
34927,409000362497',2018-10-24,IMPS 2410184C,966363.19,0.0,,2018,10,24,CHECK_WITHDRAWAL,966363.19,M1696426547
34928,409000362497',2018-10-24,Sweep Trf To: 40900036427,77549.0,0.0,,2018,10,24,PAYEMENT,77549.0,M1234577960
34929,409000362497',2018-10-25,IMPS 2410181C,329516.48,0.0,,2018,10,25,DEBIT,329516.48,M1344071998
34930,409000362497',2018-10-25,INDIAIDEAS.COM LTD,13158.0,0.0,,2018,10,25,DEBIT,13158.0,M1609904755
34931,409000362497',2018-10-25,PAYU PAYMENTS PRIVATE LIM,14058.0,0.0,,2018,10,25,PAYEMENT,14058.0,M1149544462
34932,409000362497',2018-10-25,FUTURE RETAIL LIMITED (OW,458.0,0.0,,2018,10,25,CASH_OUT,458.0,M1098065208
34933,409000362497',2018-10-25,MEHAR ENTERTAINMENT PRIVA,3456.0,0.0,,2018,10,25,DEBIT,3456.0,M1688618871
34934,409000362497',2018-10-25,Indiaforensic SERVICES INDIA PVT,97797.0,0.0,,2018,10,25,CHECK_WITHDRAWAL,97797.0,M337076518
34935,409000362497',2018-10-25,IMPS 2510182C,1326496.11,0.0,,2018,10,25,PAYEMENT,1326496.11,M1570244756
34936,409000362497',2018-10-25,INDIAIDEAS.COM LTD,10279.0,0.0,,2018,10,25,DEBIT,10279.0,M275114572
34937,409000362497',2018-10-25,PAYU PAYMENTS PRIVATE LIM,12406.0,0.0,,2018,10,25,CASH_OUT,12406.0,C1042860192
34938,409000362497',2018-10-25,AVENUES INDIA PRIVATE LIM,3539.0,0.0,,2018,10,25,CHECK_WITHDRAWAL,3539.0,M124040338
34939,409000362497',2018-10-25,FUTURE RETAIL LIMITED (OW,98.0,0.0,,2018,10,25,CASH_OUT,98.0,M1369964299
34940,409000362497',2018-10-25,MEHAR ENTERTAINMENT PRIVA,2535.0,0.0,,2018,10,25,CHECK_WITHDRAWAL,2535.0,C1756732975
34941,409000362497',2018-10-25,Indiaforensic SERVICES INDIA PVT,115782.0,0.0,,2018,10,25,PAYEMENT,115782.0,C569022831
34942,409000362497',2018-10-25,IMPS 2510183C,2067100.98,0.0,,2018,10,25,CASH_OUT,2067100.98,M976253561
34943,409000362497',2018-10-25,NEFT/SBIN418298792270/Indfor,0.0,2000000.0,,2018,10,25,CHECK_CASHING,2000000.0,C1479450980
34944,409000362497',2018-10-25,FDRL/INTERNAL FUND TRANSFE,0.0,3000000.0,,2018,10,25,TRANSFER,3000000.0,M1471637393
34945,409000362497',2018-10-25,IMPS 2510184C,1173326.75,0.0,,2018,10,25,DEBIT,1173326.75,M415361777
34946,409000362497',2018-10-25,Sweep Trf To: 40900036427,286800.0,0.0,,2018,10,25,CASH_OUT,286800.0,M432752246
34947,409000362497',2018-10-26,IMPS 2510181C,352172.35,0.0,,2018,10,26,CHECK_WITHDRAWAL,352172.35,C108034745
34948,409000362497',2018-10-26,IMPS 2610182C,1144174.91,0.0,,2018,10,26,CASH_OUT,1144174.91,C2132084369
34949,409000362497',2018-10-26,INDIAIDEAS.COM LTD,31786.0,0.0,,2018,10,26,CHECK_WITHDRAWAL,31786.0,C1982422889
34950,409000362497',2018-10-26,PAYU PAYMENTS PRIVATE LIM,18199.0,0.0,,2018,10,26,CHECK_WITHDRAWAL,18199.0,C193625667
34951,409000362497',2018-10-26,FUTURE RETAIL LIMITED (OW,844.0,0.0,,2018,10,26,CHECK_WITHDRAWAL,844.0,C803116137
34952,409000362497',2018-10-26,PASFAR TECHNOLOGIES PRIVA,6855.0,0.0,,2018,10,26,CASH_OUT,6855.0,C1245442940
34953,409000362497',2018-10-26,MEHAR ENTERTAINMENT PRIVA,3456.0,0.0,,2018,10,26,PAYEMENT,3456.0,C1671386208
34954,409000362497',2018-10-26,DIGIVIVE SERVICES PRIVATE,122.0,0.0,,2018,10,26,DEBIT,122.0,C1552859894
34955,409000362497',2018-10-26,Indiaforensic SERVICES INDIA PVT,102403.0,0.0,,2018,10,26,PAYEMENT,102403.0,C1754722089
34956,409000362497',2018-10-26,IMPS 2610183C,1872049.84,0.0,,2018,10,26,DEBIT,1872049.84,C1506782127
34957,409000362497',2018-10-26,FDRL/INTERNAL FUND TRANSFE,0.0,3000000.0,,2018,10,26,TRANSFER,3000000.0,C515132998
34958,409000362497',2018-10-26,FDRL/INTERNAL FUND TRANSFE,0.0,500000.0,,2018,10,26,CHECK_CASHING,500000.0,C151400576
34959,409000362497',2018-10-26,FDRL/INTERNAL FUND TRANSFE,0.0,1000000.0,,2018,10,26,CASH_IN,1000000.0,C1651945012
34960,409000362497',2018-10-26,NEFT/SBIN518299563032/Indfor,0.0,2000000.0,,2018,10,26,CASH_IN,2000000.0,C830831744
34961,409000362497',2018-10-26,IMPS 2610184C,1254012.3,0.0,,2018,10,26,DEBIT,1254012.3,C2145961947
34962,409000362497',2018-10-26,Sweep Trf To: 40900036427,121609.0,0.0,,2018,10,26,PAYEMENT,121609.0,C796028148
34963,409000362497',2018-10-29,IMPS 2610181C,812040.5,0.0,,2018,10,29,CASH_OUT,812040.5,C1219369531
34964,409000362497',2018-10-29,IMPS 2710181C,1028888.01,0.0,,2018,10,29,DEBIT,1028888.01,C2072302823
34965,409000362497',2018-10-29,IMPS 2810181C,206197.47,0.0,,2018,10,29,PAYEMENT,206197.47,C522696444
34966,409000362497',2018-10-29,IMPS 2910182C,1520801.79,0.0,,2018,10,29,CHECK_WITHDRAWAL,1520801.79,C51754444
34967,409000362497',2018-10-29,IMPS 2910183C,2314661.82,0.0,,2018,10,29,CHECK_WITHDRAWAL,2314661.82,C476800120
34968,409000362497',2018-10-29,FDRL/INTERNAL FUND TRANSFE,0.0,2000000.0,,2018,10,29,TRANSFER,2000000.0,C339099861
34969,409000362497',2018-10-29,FDRL/INTERNAL FUND TRANSFE,0.0,3000000.0,,2018,10,29,CHECK_CASHING,3000000.0,M1026635456
34970,409000362497',2018-10-29,IMPS 2910184C,411095.43,0.0,,2018,10,29,DEBIT,411095.43,M822824149
34971,409000362497',2018-10-29,Sweep Trf To: 40900036427,199720.0,0.0,,2018,10,29,PAYEMENT,199720.0,M667168146
34972,409000362497',2018-10-30,IMPS 2910181C,243064.59,0.0,,2018,10,30,PAYEMENT,243064.59,M1926257081
34973,409000362497',2018-10-30,IMPS 3010182C,1018392.5,0.0,,2018,10,30,CHECK_WITHDRAWAL,1018392.5,M1540788391
34974,409000362497',2018-10-30,INDIAIDEAS.COM LTD,72921.0,0.0,,2018,10,30,PAYEMENT,72921.0,M81723650
34975,409000362497',2018-10-30,PAYU PAYMENTS PRIVATE LIM,42288.0,0.0,,2018,10,30,CASH_OUT,42288.0,M1920194110
34976,409000362497',2018-10-30,AVENUES INDIA PRIVATE LIM,7718.0,0.0,,2018,10,30,PAYEMENT,7718.0,C1882485538
34977,409000362497',2018-10-30,FUTURE RETAIL LIMITED (OW,1959.0,0.0,,2018,10,30,CASH_OUT,1959.0,C968014155
34978,409000362497',2018-10-30,MEHAR ENTERTAINMENT PRIVA,6797.0,0.0,,2018,10,30,CHECK_WITHDRAWAL,6797.0,C1681202502
34979,409000362497',2018-10-30,QWIKCILVER SOLUTIONS PRIV,27649.0,0.0,,2018,10,30,PAYEMENT,27649.0,C1481637576
34980,409000362497',2018-10-30,Indiaforensic SERVICES INDIA PVT,237956.0,0.0,,2018,10,30,DEBIT,237956.0,C343069183
34981,409000362497',2018-10-30,IMPS 3010183C,1915229.51,0.0,,2018,10,30,CHECK_WITHDRAWAL,1915229.51,C958956183
34982,409000362497',2018-10-30,NEFT/SBIN718303679585/Indfor,0.0,2000000.0,,2018,10,30,TRANSFER,2000000.0,C1413055366
34983,409000362497',2018-10-30,IMPS 3010184C,963102.8,0.0,,2018,10,30,CASH_OUT,963102.8,C193826743
34984,409000362497',2018-10-30,FDRL/INTERNAL FUND TRANSFE,0.0,3000000.0,,2018,10,30,CASH_IN,3000000.0,M800189681
34985,409000362497',2018-10-30,Sweep Trf To: 40900036427,108400.0,0.0,,2018,10,30,DEBIT,108400.0,M576035588
34986,409000362497',2018-10-31,IMPS 3010181C,486266.82,0.0,,2018,10,31,PAYEMENT,486266.82,M524185094
34987,409000362497',2018-10-31,IMPS 3110182C,543196.26,0.0,,2018,10,31,CASH_OUT,543196.26,M75731838
34988,409000362497',2018-10-31,PAYU PAYMENTS PRIVATE LIM,5359.0,0.0,,2018,10,31,DEBIT,5359.0,M298554490
34989,409000362497',2018-10-31,AVENUES INDIA PRIVATE LIM,4461.0,0.0,,2018,10,31,DEBIT,4461.0,M115369647
34990,409000362497',2018-10-31,MEHAR ENTERTAINMENT PRIVA,2074.0,0.0,,2018,10,31,CASH_OUT,2074.0,M2059471581
34991,409000362497',2018-10-31,Indiaforensic SERVICES INDIA PVT,85019.0,0.0,,2018,10,31,PAYEMENT,85019.0,M1629274029
34992,409000362497',2018-10-31,IMPS 3110183C,92582.57,0.0,,2018,10,31,CHECK_WITHDRAWAL,92582.57,M93025435
34993,409000362497',2018-10-31,FDRL/INTERNAL FUND TRANSFE,0.0,1000000.0,,2018,10,31,CASH_IN,1000000.0,M107059909
34994,409000362497',2018-10-31,FDRL/INTERNAL FUND TRANSFE,0.0,1000000.0,,2018,10,31,TRANSFER,1000000.0,M1594051230
34995,409000362497',2018-10-31,FDRL/INTERNAL FUND TRANSFE,0.0,1000000.0,,2018,10,31,TRANSFER,1000000.0,M1920629802
34996,409000362497',2018-10-31,IMPS 3110184C,680457.58,0.0,,2018,10,31,PAYEMENT,680457.58,M549538829
34997,409000362497',2018-10-31,Sweep Trf To: 40900036427,6414.0,0.0,,2018,10,31,CHECK_WITHDRAWAL,6414.0,M1112365158
34998,409000362497',2018-11-01,IMPS 3110181C,701824.5,0.0,,2018,11,1,CHECK_WITHDRAWAL,701824.5,M276908129
34999,409000362497',2018-11-01,IMPS 0111182C,1599811.86,0.0,,2018,11,1,PAYEMENT,1599811.86,M1679051236
35000,409000362497',2018-11-01,INDIAIDEAS.COM LTD,32911.0,0.0,,2018,11,1,CASH_OUT,32911.0,M310025816
35001,409000362497',2018-11-01,PAYU PAYMENTS PRIVATE LIM,4639.0,0.0,,2018,11,1,DEBIT,4639.0,M222294228
35002,409000362497',2018-11-01,AVENUES INDIA PRIVATE LIM,1509.0,0.0,,2018,11,1,CASH_OUT,1509.0,C1062374131
35003,409000362497',2018-11-01,FUTURE RETAIL LIMITED (OW,143.0,0.0,,2018,11,1,CASH_OUT,143.0,C912252532
35004,409000362497',2018-11-01,DISH INFRA SERVICES PRIVA,29.0,0.0,,2018,11,1,PAYEMENT,29.0,C1567808902
35005,409000362497',2018-11-01,MEHAR ENTERTAINMENT PRIVA,115.0,0.0,,2018,11,1,PAYEMENT,115.0,C635281078
35006,409000362497',2018-11-01,Indiaforensic SERVICES INDIA PVT,67174.0,0.0,,2018,11,1,PAYEMENT,67174.0,C244095956
35007,409000362497',2018-11-01,IMPS 0111183C,2644321.26,0.0,,2018,11,1,DEBIT,2644321.26,C2032924554
35008,409000362497',2018-11-01,FDRL/INTERNAL FUND TRANSFE,0.0,3000000.0,,2018,11,1,TRANSFER,3000000.0,C1698593276
35009,409000362497',2018-11-01,FDRL/INTERNAL FUND TRANSFE,0.0,500000.0,,2018,11,1,CHECK_CASHING,500000.0,C268402121
35010,409000362497',2018-11-01,FDRL/INTERNAL FUND TRANSFE,0.0,2000000.0,,2018,11,1,TRANSFER,2000000.0,C2090186380
35011,409000362497',2018-11-01,IMPS 0111184C,697904.08,0.0,,2018,11,1,DEBIT,697904.08,C1757533511
35012,409000362497',2018-11-01,Sweep Trf To: 40900036427,281461.0,0.0,,2018,11,1,DEBIT,281461.0,C1515979807
35013,409000362497',2018-11-02,IMPS 0111181C,231041.79,0.0,,2018,11,2,CHECK_WITHDRAWAL,231041.79,C489712935
35014,409000362497',2018-11-02,IMPS 0211182C,863272.47,0.0,,2018,11,2,PAYEMENT,863272.47,C1816986148
35015,409000362497',2018-11-02,INDIAIDEAS.COM LTD,20587.0,0.0,,2018,11,2,CHECK_WITHDRAWAL,20587.0,C1220911229
35016,409000362497',2018-11-02,PAYU PAYMENTS PRIVATE LIM,11008.0,0.0,,2018,11,2,DEBIT,11008.0,C26334874
35017,409000362497',2018-11-02,AVENUES INDIA PRIVATE LIM,7569.0,0.0,,2018,11,2,CASH_OUT,7569.0,C1745096940
35018,409000362497',2018-11-02,FUTURE RETAIL LIMITED (OW,207.0,0.0,,2018,11,2,CASH_OUT,207.0,C5554526
35019,409000362497',2018-11-02,PASFAR TECHNOLOGIES PRIVA,183.0,0.0,,2018,11,2,DEBIT,183.0,C1634190383
35020,409000362497',2018-11-02,MEHAR ENTERTAINMENT PRIVA,3802.0,0.0,,2018,11,2,CHECK_WITHDRAWAL,3802.0,C739289034
35021,409000362497',2018-11-02,Indiaforensic SERVICES INDIA PVT,90149.0,0.0,,2018,11,2,DEBIT,90149.0,M812554513
35022,409000362497',2018-11-02,IMPS 0211183C,2611680.43,0.0,,2018,11,2,CASH_OUT,2611680.43,M911245823
35023,409000362497',2018-11-02,FDRL/INTERNAL FUND TRANSFE,0.0,3000000.0,,2018,11,2,CASH_IN,3000000.0,M31714676
35024,409000362497',2018-11-02,FDRL/INTERNAL FUND TRANSFE,0.0,1000000.0,,2018,11,2,CASH_IN,1000000.0,M1585132511
35025,409000362497',2018-11-02,FDRL/INTERNAL FUND TRANSFE,0.0,1000000.0,,2018,11,2,CHECK_CASHING,1000000.0,M255171131
35026,409000362497',2018-11-02,FDRL/INTERNAL FUND TRANSFE,0.0,500000.0,,2018,11,2,CHECK_CASHING,500000.0,M1415298997
35027,409000362497',2018-11-02,IMPS 0211184C,1241019.29,0.0,,2018,11,2,PAYEMENT,1241019.29,M2086518655
35028,409000362497',2018-11-02,Sweep Trf To: 40900036427,159320.0,0.0,,2018,11,2,CHECK_WITHDRAWAL,159320.0,M1779093839
35029,409000362497',2018-11-03,IMPS 0211181C,405701.95,0.0,,2018,11,3,PAYEMENT,405701.95,M1958712904
35030,409000362497',2018-11-03,IMPS 0311182C,1066083.5,0.0,,2018,11,3,CASH_OUT,1066083.5,M676626
35031,409000362497',2018-11-03,IMPS 0311183C,2147817.12,0.0,,2018,11,3,CHECK_WITHDRAWAL,2147817.12,M788474208
35032,409000362497',2018-11-03,FDRL/INTERNAL FUND TRANSFE,0.0,3000000.0,,2018,11,3,CASH_IN,3000000.0,M1944934724
35033,409000362497',2018-11-03,FDRL/INTERNAL FUND TRANSFE,0.0,3000000.0,,2018,11,3,CASH_IN,3000000.0,M1437921269
35034,409000362497',2018-11-03,IMPS 0311184C,919210.23,0.0,,2018,11,3,CHECK_WITHDRAWAL,919210.23,M93027540
35035,409000362497',2018-11-03,Sweep Trf To: 40900036427,230200.0,0.0,,2018,11,3,CHECK_WITHDRAWAL,230200.0,M1321985405
35036,409000362497',2018-11-05,IMPS 0310181C,616536.5,0.0,,2018,11,5,CASH_OUT,616536.5,M636691826
35037,409000362497',2018-11-05,ACH DR NATIONAL PAYMENT C,9161.05,0.0,,2018,11,5,PAYEMENT,9161.05,M455949120
35038,409000362497',2018-11-05,ACH DR NATIONAL PAYMENT C,2637.77,0.0,,2018,11,5,CHECK_WITHDRAWAL,2637.77,M1487817458
35039,409000362497',2018-11-05,IMPS 0411181C,234023.63,0.0,,2018,11,5,CASH_OUT,234023.63,M1176564716
35040,409000362497',2018-11-05,FDRL/INTERNAL FUND TRANSFE,0.0,3000000.0,,2018,11,5,CHECK_CASHING,3000000.0,C1929496638
35041,409000362497',2018-11-05,FDRL/INTERNAL FUND TRANSFE,0.0,3000000.0,,2018,11,5,TRANSFER,3000000.0,M1143037343
35042,409000362497',2018-11-05,IMPS 0511182C,1596238.48,0.0,,2018,11,5,PAYEMENT,1596238.48,C1514834483
35043,409000362497',2018-11-05,IMPS 0511183C,2016415.31,0.0,,2018,11,5,CASH_OUT,2016415.31,M919941402
35044,409000362497',2018-11-05,IMPS 0511184C,805484.75,0.0,,2018,11,5,DEBIT,805484.75,M104603085
35045,409000362497',2018-11-05,Sweep Trf To: 40900036427,315060.0,0.0,,2018,11,5,DEBIT,315060.0,C441129646
35046,409000362497',2018-11-06,IMPS 0511181C,493665.88,0.0,,2018,11,6,PAYEMENT,493665.88,M472225221
35047,409000362497',2018-11-06,IMPS 0611182C,1004503.22,0.0,,2018,11,6,DEBIT,1004503.22,C16880623
35048,409000362497',2018-11-06,IMPS 0611183C,2063323.89,0.0,,2018,11,6,CHECK_WITHDRAWAL,2063323.89,M1886891390
35049,409000362497',2018-11-06,FDRL/INTERNAL FUND TRANSFE,0.0,3000000.0,,2018,11,6,TRANSFER,3000000.0,C1447133976
35050,409000362497',2018-11-06,FDRL/INTERNAL FUND TRANSFE,0.0,1000000.0,,2018,11,6,TRANSFER,1000000.0,C980380973
35051,409000362497',2018-11-06,FDRL/INTERNAL FUND TRANSFE,0.0,1000000.0,,2018,11,6,CASH_IN,1000000.0,C2107268831
35052,409000362497',2018-11-06,IMPS 0611184C,548199.7,0.0,,2018,11,6,CHECK_WITHDRAWAL,548199.7,C932583850
35053,409000362497',2018-11-06,Sweep Trf To: 40900036427,239159.0,0.0,,2018,11,6,CASH_OUT,239159.0,C9108707
35054,409000362497',2018-11-07,IMPS 0611181C,622716.73,0.0,,2018,11,7,CASH_OUT,622716.73,M969462332
35055,409000362497',2018-11-07,IMPS 0711182C,517680.01,0.0,,2018,11,7,CHECK_WITHDRAWAL,517680.01,M411047570
35056,409000362497',2018-11-07,IMPS 0711183C,194472.83,0.0,,2018,11,7,CHECK_WITHDRAWAL,194472.83,M1395864182
35057,409000362497',2018-11-07,IMPS 0711184C,102589.48,0.0,,2018,11,7,CHECK_WITHDRAWAL,102589.48,M308602702
35058,409000362497',2018-11-07,Sweep Trf To: 40900036427,5000.0,0.0,,2018,11,7,CHECK_WITHDRAWAL,5000.0,C1731643198
35059,409000362497',2018-11-08,IMPS 0711181C,50762.73,0.0,,2018,11,8,CHECK_WITHDRAWAL,50762.73,C1084435493
35060,409000362497',2018-11-08,IMPS 0811182C,17236.93,0.0,,2018,11,8,DEBIT,17236.93,M590466816
35061,409000362497',2018-11-08,IMPS 0811183C,51736.82,0.0,,2018,11,8,PAYEMENT,51736.82,C869107435
35062,409000362497',2018-11-08,IMPS 0811184C,113682.88,0.0,,2018,11,8,PAYEMENT,113682.88,M2122305011
35063,409000362497',2018-11-08,Sweep Trf To: 40900036427,13001.0,0.0,,2018,11,8,CHECK_WITHDRAWAL,13001.0,M904805086
35064,409000362497',2018-11-09,IMPS 0811181C,137933.07,0.0,,2018,11,9,CHECK_WITHDRAWAL,137933.07,M347821041
35065,409000362497',2018-11-09,IMPS 0911182C,115204.73,0.0,,2018,11,9,CASH_OUT,115204.73,M1500696812
35066,409000362497',2018-11-09,IMPS 0911183C,99233.27,0.0,,2018,11,9,CASH_OUT,99233.27,M1540960136
35067,409000362497',2018-11-09,IMPS 0911184C,20937.07,0.0,,2018,11,9,CASH_OUT,20937.07,M2022410985
35068,409000362497',2018-11-12,IMPS 0911181C,58014.66,0.0,,2018,11,12,DEBIT,58014.66,M1628700829
35069,409000362497',2018-11-12,IMPS 1011181C,170320.68,0.0,,2018,11,12,CASH_OUT,170320.68,M2091819804
35070,409000362497',2018-11-12,IMPS 1111181C,117928.5,0.0,,2018,11,12,CHECK_WITHDRAWAL,117928.5,M1343349118
35071,409000362497',2018-11-12,IMPS 1211182C,1369530.84,0.0,,2018,11,12,PAYEMENT,1369530.84,M874787059
35072,409000362497',2018-11-12,INDIAIDEAS.COM LTD,154808.0,0.0,,2018,11,12,PAYEMENT,154808.0,C718806769
35073,409000362497',2018-11-12,PAYU PAYMENTS PRIVATE LIM,23796.0,0.0,,2018,11,12,PAYEMENT,23796.0,M427892085
35074,409000362497',2018-11-12,AVENUES INDIA PRIVATE LIM,8469.0,0.0,,2018,11,12,CHECK_WITHDRAWAL,8469.0,C1266435158
35075,409000362497',2018-11-12,FUTURE RETAIL LIMITED (OW,9557.0,0.0,,2018,11,12,CASH_OUT,9557.0,C1791561308
35076,409000362497',2018-11-12,MEHAR ENTERTAINMENT PRIVA,14517.0,0.0,,2018,11,12,CASH_OUT,14517.0,M1786784181
35077,409000362497',2018-11-12,ZAAK EPAYMENT SERVICES PR,626.0,0.0,,2018,11,12,DEBIT,626.0,M1491242134
35078,409000362497',2018-11-12,QWIKCILVER SOLUTIONS PRIV,22150.0,0.0,,2018,11,12,CASH_OUT,22150.0,M391368195
35079,409000362497',2018-11-12,Indiaforensic SERVICES INDIA PVT,605659.0,0.0,,2018,11,12,DEBIT,605659.0,C432744903
35080,409000362497',2018-11-12,IMPS 1211183C,2681441.96,0.0,,2018,11,12,DEBIT,2681441.96,C1570573927
35081,409000362497',2018-11-12,FDRL/INTERNAL FUND TRANSFE,0.0,3000000.0,,2018,11,12,CASH_IN,3000000.0,M103068594
35082,409000362497',2018-11-12,IMPS 1211184C,684465.12,0.0,,2018,11,12,CHECK_WITHDRAWAL,684465.12,C678476618
35083,409000362497',2018-11-12,FDRL/INTERNAL FUND TRANSFE,0.0,3000000.0,,2018,11,12,TRANSFER,3000000.0,C1989511207
35084,409000362497',2018-11-12,Sweep Trf To: 40900036427,262848.0,0.0,,2018,11,12,CHECK_WITHDRAWAL,262848.0,C1452629183
35085,409000362497',2018-11-13,IMPS 1211181C,433993.04,0.0,,2018,11,13,DEBIT,433993.04,C1585932234
35086,409000362497',2018-11-13,IMPS 1311182C,54960.34,0.0,,2018,11,13,CHECK_WITHDRAWAL,54960.34,C43348766
35087,409000362497',2018-11-13,INDIAIDEAS.COM LTD,24008.0,0.0,,2018,11,13,PAYEMENT,24008.0,M308214984
35088,409000362497',2018-11-13,PAYU PAYMENTS PRIVATE LIM,15939.0,0.0,,2018,11,13,PAYEMENT,15939.0,M1904978069
35089,409000362497',2018-11-13,PASFAR TECHNOLOGIES PRIVA,979.0,0.0,,2018,11,13,PAYEMENT,979.0,C1144318801
35090,409000362497',2018-11-13,MEHAR ENTERTAINMENT PRIVA,230.0,0.0,,2018,11,13,CHECK_WITHDRAWAL,230.0,M963078849
35091,409000362497',2018-11-13,QWIKCILVER SOLUTIONS PRIV,22210.0,0.0,,2018,11,13,CASH_OUT,22210.0,M1377869842
35092,409000362497',2018-11-13,Indiaforensic SERVICES INDIA PVT,68059.0,0.0,,2018,11,13,CASH_OUT,68059.0,C547565037
35093,409000362497',2018-11-13,IMPS 1311183C,43992.71,0.0,,2018,11,13,PAYEMENT,43992.71,M720759374
35094,409000362497',2018-11-13,IMPS 1311184C,21204.96,0.0,,2018,11,13,CASH_OUT,21204.96,M1804644471
35095,409000362497',2018-11-13,Sweep Trf To: 40900036427,21058.0,0.0,,2018,11,13,DEBIT,21058.0,C1359044626
35096,409000362497',2018-11-14,IMPS 1311181C,109757.8,0.0,,2018,11,14,CHECK_WITHDRAWAL,109757.8,M169855578
35097,409000362497',2018-11-14,IMPS 1411182C,1222075.59,0.0,,2018,11,14,CASH_OUT,1222075.59,M1649614934
35098,409000362497',2018-11-14,IMPS 1411183C,2115108.78,0.0,,2018,11,14,CHECK_WITHDRAWAL,2115108.78,C769507769
35099,409000362497',2018-11-14,NEFT/000056605899/PAYU PA,3373.0,0.0,,2018,11,14,PAYEMENT,3373.0,C243194708
35100,409000362497',2018-11-14,NEFT/000056606009/MEHAR E,1959.0,0.0,,2018,11,14,CASH_OUT,1959.0,M232773553
35101,409000362497',2018-11-14,Indiaforensic SERVICES INDIA PVT,37591.0,0.0,,2018,11,14,PAYEMENT,37591.0,C1549086472
35102,409000362497',2018-11-14,FDRL/INTERNAL FUND TRANSFE,0.0,3000000.0,,2018,11,14,TRANSFER,3000000.0,C1564588329
35103,409000362497',2018-11-14,FDRL/INTERNAL FUND TRANSFE,0.0,3000000.0,,2018,11,14,CASH_IN,3000000.0,M510522107
35104,409000362497',2018-11-14,IMPS 1411184C,1010061.22,0.0,,2018,11,14,CHECK_WITHDRAWAL,1010061.22,C2038994826
35105,409000362497',2018-11-14,Sweep Trf To: 40900036427,194852.0,0.0,,2018,11,14,DEBIT,194852.0,M2016403773
35106,409000362497',2018-11-15,IMPS 1511182C,701547.38,0.0,,2018,11,15,PAYEMENT,701547.38,C305646302
35107,409000362497',2018-11-15,IMPS 1411181C,487599.76,0.0,,2018,11,15,PAYEMENT,487599.76,C1258643950
35108,409000362497',2018-11-15,IMPS 1511183C,1501555.01,0.0,,2018,11,15,PAYEMENT,1501555.01,C157113649
35109,409000362497',2018-11-15,INDIAIDEAS.COM LTD,16606.0,0.0,,2018,11,15,CASH_OUT,16606.0,C1448147359
35110,409000362497',2018-11-15,PAYU PAYMENTS PRIVATE LIM,27063.0,0.0,,2018,11,15,PAYEMENT,27063.0,C312537393
35111,409000362497',2018-11-15,AVENUES INDIA PRIVATE LIM,1333.0,0.0,,2018,11,15,CHECK_WITHDRAWAL,1333.0,C381350369
35112,409000362497',2018-11-15,ZAAK EPAYMENT SERVICES PR,149.0,0.0,,2018,11,15,CASH_OUT,149.0,C769507769
35113,409000362497',2018-11-15,FUTURE RETAIL LIMITED (OW,1796.0,0.0,,2018,11,15,DEBIT,1796.0,C875761527
35114,409000362497',2018-11-15,METRO INFRASYS PRIVATE LI,697.0,0.0,,2018,11,15,CASH_OUT,697.0,C2052185144
35115,409000362497',2018-11-15,Indiaforensic SERVICES INDIA PVT,82982.0,0.0,,2018,11,15,PAYEMENT,82982.0,C1058634310
35116,409000362497',2018-11-15,FDRL/INTERNAL FUND TRANSFE,0.0,1000000.0,,2018,11,15,CHECK_CASHING,1000000.0,C1347476631
35117,409000362497',2018-11-15,FDRL/INTERNAL FUND TRANSFE,0.0,1000000.0,,2018,11,15,CHECK_CASHING,1000000.0,C1554540309
35118,409000362497',2018-11-15,NEFT/SBIN118319718253/Indfor,0.0,2500000.0,,2018,11,15,CASH_IN,2500000.0,C304406966
35119,409000362497',2018-11-15,IMPS 1511184C,1065150.51,0.0,,2018,11,15,DEBIT,1065150.51,C1353907767
35120,409000362497',2018-11-15,Sweep Trf To: 40900036427,156041.0,0.0,,2018,11,15,CASH_OUT,156041.0,C1249000159
35121,409000362497',2018-11-16,IMPS 1511181C,443815.2,0.0,,2018,11,16,CASH_OUT,443815.2,C540610664
35122,409000362497',2018-11-16,IMPS 1611182C,834366.79,0.0,,2018,11,16,CASH_OUT,834366.79,C1768641212
35123,409000362497',2018-11-16,IMPS 1611183C,1607816.51,0.0,,2018,11,16,CHECK_WITHDRAWAL,1607816.51,C765206415
35124,409000362497',2018-11-16,PAYU PAYMENTS PRIVATE LIM,37364.0,0.0,,2018,11,16,DEBIT,37364.0,C1379289710
35125,409000362497',2018-11-16,AVENUES INDIA PRIVATE LIM,686.0,0.0,,2018,11,16,CHECK_WITHDRAWAL,686.0,C1482979717
35126,409000362497',2018-11-16,FUTURE RETAIL LIMITED (OW,102.0,0.0,,2018,11,16,PAYEMENT,102.0,C701855966
35127,409000362497',2018-11-16,MEHAR ENTERTAINMENT PRIVA,3111.0,0.0,,2018,11,16,PAYEMENT,3111.0,C36553668
35128,409000362497',2018-11-16,Indiaforensic SERVICES INDIA PVT,88322.0,0.0,,2018,11,16,PAYEMENT,88322.0,C619716246
35129,409000362497',2018-11-16,IMPS 1611184C,969595.75,0.0,,2018,11,16,CASH_OUT,969595.75,C1305075214
35130,409000362497',2018-11-16,Sweep Trf To: 40900036427,175730.0,0.0,,2018,11,16,PAYEMENT,175730.0,C1141137903
35131,409000362497',2018-11-17,IMPS 161120181C,209187.43,0.0,,2018,11,17,CASH_OUT,209187.43,C1554622120
35132,409000362497',2018-11-17,IMPS 171120182C,89153.48,0.0,,2018,11,17,CASH_OUT,89153.48,C2051343924
35133,409000362497',2018-11-17,IMPS 171120183C,415653.74,0.0,,2018,11,17,PAYEMENT,415653.74,C1144968432
35134,409000362497',2018-11-17,FDRL/INTERNAL FUND TRANSFE,0.0,1000000.0,,2018,11,17,CASH_IN,1000000.0,C2067466390
35135,409000362497',2018-11-17,FDRL/INTERNAL FUND TRANSFE,0.0,1000000.0,,2018,11,17,TRANSFER,1000000.0,C207471579
35136,409000362497',2018-11-17,IMPS 171120184C,631504.47,0.0,,2018,11,17,DEBIT,631504.47,M1372529436
35137,409000362497',2018-11-17,Sweep Trf To: 40900036427,10010.0,0.0,,2018,11,17,CHECK_WITHDRAWAL,10010.0,M422311415
35138,409000362497',2018-11-19,IMPS 1711181C,263653.43,0.0,,2018,11,19,DEBIT,263653.43,M1704812539
35139,409000362497',2018-11-19,IMPS IW 1811181C,275699.34,0.0,,2018,11,19,DEBIT,275699.34,M1547925754
35140,409000362497',2018-11-19,IMPS IW 1911182C,12521.62,0.0,,2018,11,19,CASH_OUT,12521.62,C181168745
35141,409000362497',2018-11-19,IMPS IW 1911183C,810141.95,0.0,,2018,11,19,CHECK_WITHDRAWAL,810141.95,M453070939
35142,409000362497',2018-11-19,FDRL/INTERNAL FUND TRANSFE,0.0,1000000.0,,2018,11,19,CHECK_CASHING,1000000.0,M197162702
35143,409000362497',2018-11-19,FDRL/INTERNAL FUND TRANSFE,0.0,1000000.0,,2018,11,19,TRANSFER,1000000.0,C1109959414
35144,409000362497',2018-11-19,IMPS 1911184C,548574.07,0.0,,2018,11,19,PAYEMENT,548574.07,M1644382810
35145,409000362497',2018-11-19,Sweep Trf To: 40900036427,6401.0,0.0,,2018,11,19,CASH_OUT,6401.0,C1789550256
35146,409000362497',2018-11-20,IMPS 2011181C,217156.09,0.0,,2018,11,20,DEBIT,217156.09,C1802632685
35147,409000362497',2018-11-20,IMPS IW 2011182C,130688.48,0.0,,2018,11,20,CASH_OUT,130688.48,M321254537
35148,409000362497',2018-11-20,IMPS IW 2011183C,871549.07,0.0,,2018,11,20,DEBIT,871549.07,C1984192708
35149,409000362497',2018-11-20,NEFT/000057189167/INDIAID,73725.0,0.0,,2018,11,20,CASH_OUT,73725.0,M1290736418
35150,409000362497',2018-11-20,NEFT/000057189198/PAYU PA,71569.0,0.0,,2018,11,20,DEBIT,71569.0,C802113875
35151,409000362497',2018-11-20,NEFT/000057189223/AVENUES,6744.0,0.0,,2018,11,20,DEBIT,6744.0,C1059781259
35152,409000362497',2018-11-20,NEFT/000057189269/ZAAK EP,418.0,0.0,,2018,11,20,PAYEMENT,418.0,M956644267
35153,409000362497',2018-11-20,NEFT/000057189353/FUTURE,315.0,0.0,,2018,11,20,DEBIT,315.0,M177861670
35154,409000362497',2018-11-20,NEFT/000057189408/MEHAR E,14517.0,0.0,,2018,11,20,DEBIT,14517.0,M760752242
35155,409000362497',2018-11-20,NEFT/000057189456/ALT DIG,294.0,0.0,,2018,11,20,CHECK_WITHDRAWAL,294.0,C643658493
35156,409000362497',2018-11-20,TRF TO 1196428,323541.0,0.0,,2018,11,20,CHECK_WITHDRAWAL,323541.0,C910119139
35157,409000362497',2018-11-20,FDRL/INTERNAL FUND TRANSFE,0.0,500000.0,,2018,11,20,CASH_IN,500000.0,C746359178
35158,409000362497',2018-11-20,FDRL/INTERNAL FUND TRANSFE,0.0,500000.0,,2018,11,20,TRANSFER,500000.0,M275699484
35159,409000362497',2018-11-20,FDRL/INTERNAL FUND TRANSFE,0.0,500000.0,,2018,11,20,CHECK_CASHING,500000.0,M1716951216
35160,409000362497',2018-11-20,FDRL/INTERNAL FUND TRANSFE,0.0,500000.0,,2018,11,20,TRANSFER,500000.0,M699907561
35161,409000362497',2018-11-20,IMPS 171120184C,738213.58,0.0,,2018,11,20,CHECK_WITHDRAWAL,738213.58,C1467740330
35162,409000362497',2018-11-20,Sweep Trf To: 40900036427,24196.0,0.0,,2018,11,20,CHECK_WITHDRAWAL,24196.0,M745574125
35163,409000362497',2018-11-21,IMPS 2011181C,347528.9,0.0,,2018,11,21,PAYEMENT,347528.9,C639695157
35164,409000362497',2018-11-21,IMPS IW 2111182C,259064.58,0.0,,2018,11,21,DEBIT,259064.58,M1718950042
35165,409000362497',2018-11-21,IMPS 211120183C,664814.3,0.0,,2018,11,21,PAYEMENT,664814.3,M386710821
35166,409000362497',2018-11-21,FDRL/INTERNAL FUND TRANSFE,0.0,500000.0,,2018,11,21,CASH_IN,500000.0,C900505277
35167,409000362497',2018-11-21,FDRL/INTERNAL FUND TRANSFE,0.0,500000.0,,2018,11,21,CHECK_CASHING,500000.0,C285990786
35168,409000362497',2018-11-21,FDRL/INTERNAL FUND TRANSFE,0.0,500000.0,,2018,11,21,CHECK_CASHING,500000.0,M476834622
35169,409000362497',2018-11-21,FDRL/INTERNAL FUND TRANSFE,0.0,500000.0,,2018,11,21,TRANSFER,500000.0,M693300460
35170,409000362497',2018-11-21,IMPS 2111184C,733526.38,0.0,,2018,11,21,DEBIT,733526.38,C1160387631
35171,409000362497',2018-11-21,Sweep Trf To: 40900036427,4100.0,0.0,,2018,11,21,DEBIT,4100.0,M875136897
35172,409000362497',2018-11-22,IMPS 2111181C,121404.66,0.0,,2018,11,22,CASH_OUT,121404.66,M476971592
35173,409000362497',2018-11-22,IMPS 2211182C,315796.76,0.0,,2018,11,22,CHECK_WITHDRAWAL,315796.76,M949888639
35174,409000362497',2018-11-22,IMPS 2211183C,940943.82,0.0,,2018,11,22,CASH_OUT,940943.82,M1341448822
35175,409000362497',2018-11-22,INDIAIDEAS.COM LTD,20405.0,0.0,,2018,11,22,PAYEMENT,20405.0,C489693281
35176,409000362497',2018-11-22,PAYU PAYMENTS PRIVATE LIM,52174.0,0.0,,2018,11,22,PAYEMENT,52174.0,M1581052414
35177,409000362497',2018-11-22,AVENUES INDIA PRIVATE LIM,3582.0,0.0,,2018,11,22,DEBIT,3582.0,M1806575327
35178,409000362497',2018-11-22,ZAAK EPAYMENT SERVICES PR,149.0,0.0,,2018,11,22,CHECK_WITHDRAWAL,149.0,M1706596152
35179,409000362497',2018-11-22,FUTURE RETAIL LIMITED (OW,655.0,0.0,,2018,11,22,CASH_OUT,655.0,C1932505292
35180,409000362497',2018-11-22,MEHAR ENTERTAINMENT PRIVA,5761.0,0.0,,2018,11,22,PAYEMENT,5761.0,M508613635
35181,409000362497',2018-11-22,QWIKCILVER SOLUTIONS PRIV,9068.0,0.0,,2018,11,22,PAYEMENT,9068.0,M153141170
35182,409000362497',2018-11-22,Indiaforensic SERVICES INDIA PVT,166752.0,0.0,,2018,11,22,CASH_OUT,166752.0,M795593206
35183,409000362497',2018-11-22,FDRL/INTERNAL FUND TRANSFE,0.0,1000000.0,,2018,11,22,CHECK_CASHING,1000000.0,M410841108
35184,409000362497',2018-11-22,FDRL/INTERNAL FUND TRANSFE,0.0,1000000.0,,2018,11,22,CASH_IN,1000000.0,M1100779263
35185,409000362497',2018-11-22,IMPS 2211184C,541564.31,0.0,,2018,11,22,DEBIT,541564.31,C2063124058
35186,409000362497',2018-11-22,Sweep Trf To: 40900036427,7820.0,0.0,,2018,11,22,CASH_OUT,7820.0,M1020401632
35187,409000362497',2018-11-23,IMPS 2211181C,45610.87,0.0,,2018,11,23,CHECK_WITHDRAWAL,45610.87,C1701519711
35188,409000362497',2018-11-23,IMPS 2311182C,204285.67,0.0,,2018,11,23,CASH_OUT,204285.67,C2016729324
35189,409000362497',2018-11-23,IMPS 2311183C,834200.15,0.0,,2018,11,23,PAYEMENT,834200.15,M1474522406
35190,409000362497',2018-11-23,FDRL/INTERNAL FUND TRANSFE,0.0,3000000.0,,2018,11,23,CHECK_CASHING,3000000.0,M1051675603
35191,409000362497',2018-11-23,IMPS 2311184C,667338.43,0.0,,2018,11,23,PAYEMENT,667338.43,C1213792973
35192,409000362497',2018-11-23,Sweep Trf To: 40900036427,150.0,0.0,,2018,11,23,DEBIT,150.0,C1332701679
35193,409000362497',2018-11-26,IMPS 2311181C,359908.28,0.0,,2018,11,26,CASH_OUT,359908.28,C1917485266
35194,409000362497',2018-11-26,IMPS 2411181C,1477910.87,0.0,,2018,11,26,DEBIT,1477910.87,M1455686187
35195,409000362497',2018-11-26,IMPS 2511181C,117226.51,0.0,,2018,11,26,PAYEMENT,117226.51,C1389405694
35196,409000362497',2018-11-26,IMPS 2611182C,245109.56,0.0,,2018,11,26,PAYEMENT,245109.56,M204993084
35197,409000362497',2018-11-26,INDIAIDEAS.COM LTD,21541.0,0.0,,2018,11,26,CHECK_WITHDRAWAL,21541.0,M406752933
35198,409000362497',2018-11-26,PAYU PAYMENTS PRIVATE LIM,65775.0,0.0,,2018,11,26,CASH_OUT,65775.0,M390670564
35199,409000362497',2018-11-26,AVENUES INDIA PRIVATE LIM,26813.0,0.0,,2018,11,26,CHECK_WITHDRAWAL,26813.0,C1532727352
35200,409000362497',2018-11-26,FUTURE RETAIL LIMITED (OW,2308.0,0.0,,2018,11,26,DEBIT,2308.0,M1645937188
35201,409000362497',2018-11-26,MEHAR ENTERTAINMENT PRIVA,9793.0,0.0,,2018,11,26,CHECK_WITHDRAWAL,9793.0,M1637086732
35202,409000362497',2018-11-26,Indiaforensic SERVICES INDIA PVT,847618.0,0.0,,2018,11,26,CHECK_WITHDRAWAL,847618.0,M1428761366
35203,409000362497',2018-11-26,IMPS 2611183C,1135437.68,0.0,,2018,11,26,DEBIT,1135437.68,M1327455706
35204,409000362497',2018-11-26,TRF FROM  Indiaforensic SERVICES,0.0,2500000.0,,2018,11,26,CHECK_CASHING,2500000.0,M1950079835
35205,409000362497',2018-11-26,IMPS 2611184C,383565.11,0.0,,2018,11,26,DEBIT,383565.11,M1743305752
35206,409000362497',2018-11-26,Sweep Trf To: 40900036427,5002.0,0.0,,2018,11,26,CASH_OUT,5002.0,M340437373
35207,409000362497',2018-11-27,IMPS 2611181C,283744.89,0.0,,2018,11,27,CHECK_WITHDRAWAL,283744.89,M36191488
35208,409000362497',2018-11-27,INDIAIDEAS.COM LTD,26380.0,0.0,,2018,11,27,PAYEMENT,26380.0,M2008709559
35209,409000362497',2018-11-27,PAYU PAYMENTS PRIVATE LIM,12967.0,0.0,,2018,11,27,DEBIT,12967.0,M107120328
35210,409000362497',2018-11-27,MEHAR ENTERTAINMENT PRIVA,230.0,0.0,,2018,11,27,CASH_OUT,230.0,M1163309961
35211,409000362497',2018-11-27,ALT DIGITAL MEDIA ENTERTA,98.0,0.0,,2018,11,27,CASH_OUT,98.0,M421881907
35212,409000362497',2018-11-27,Indiaforensic SERVICES INDIA PVT,830853.0,0.0,,2018,11,27,CASH_OUT,830853.0,M547187423
35213,409000362497',2018-11-27,IMPS 2711182C,387845.1,0.0,,2018,11,27,DEBIT,387845.1,M107361963
35214,409000362497',2018-11-27,IMPS 2711183C,944221.55,0.0,,2018,11,27,CHECK_WITHDRAWAL,944221.55,M656822686
35215,409000362497',2018-11-27,IMPS 2711184C,680751.07,0.0,,2018,11,27,DEBIT,680751.07,M560216405
35216,409000362497',2018-11-27,TRF FROM  Indiaforensic SERVICES,0.0,2000000.0,,2018,11,27,TRANSFER,2000000.0,M1753942042
35217,409000362497',2018-11-27,Sweep Trf To: 40900036427,1500.0,0.0,,2018,11,27,PAYEMENT,1500.0,M2047181148
35218,409000362497',2018-11-28,IMPS 271120181C,138399.48,0.0,,2018,11,28,PAYEMENT,138399.48,M393465272
35219,409000362497',2018-11-28,IMPS 281120182C,293028.34,0.0,,2018,11,28,PAYEMENT,293028.34,M1722342369
35220,409000362497',2018-11-28,IMPS 2811182C,852205.5,0.0,,2018,11,28,CASH_OUT,852205.5,M243440234
35221,409000362497',2018-11-28,INDIAIDEAS.COM LTD,37262.0,0.0,,2018,11,28,CHECK_WITHDRAWAL,37262.0,M319284611
35222,409000362497',2018-11-28,PAYU PAYMENTS PRIVATE LIM,27667.0,0.0,,2018,11,28,CHECK_WITHDRAWAL,27667.0,M582735505
35223,409000362497',2018-11-28,AVENUES INDIA PRIVATE LIM,1011.0,0.0,,2018,11,28,CASH_OUT,1011.0,C1750918377
35224,409000362497',2018-11-28,FUTURE RETAIL LIMITED (OW,385.0,0.0,,2018,11,28,DEBIT,385.0,C266912553
35225,409000362497',2018-11-28,MEHAR ENTERTAINMENT PRIVA,2074.0,0.0,,2018,11,28,CASH_OUT,2074.0,C836878317
35226,409000362497',2018-11-28,Indiaforensic SERVICES INDIA PVT,800949.0,0.0,,2018,11,28,PAYEMENT,800949.0,M1262614033
35227,409000362497',2018-11-28,TRF FROM  Indiaforensic SERVICES,0.0,2000000.0,,2018,11,28,CASH_IN,2000000.0,M757028579
35228,409000362497',2018-11-28,IMPS 2811184C,599381.03,0.0,,2018,11,28,DEBIT,599381.03,M1234561056
35229,409000362497',2018-11-28,Sweep Trf To: 40900036427,1140.0,0.0,,2018,11,28,CASH_OUT,1140.0,C1959301671
35230,409000362497',2018-11-29,IMPS 2811181C,203915.98,0.0,,2018,11,29,CASH_OUT,203915.98,M225186092
35231,409000362497',2018-11-29,IMPS 2911182C,71455.07,0.0,,2018,11,29,CASH_OUT,71455.07,C188246551
35232,409000362497',2018-11-29,IMPS 2911183C,939155.78,0.0,,2018,11,29,PAYEMENT,939155.78,C787593204
35233,409000362497',2018-11-29,IMPS 2911184C,633071.38,0.0,,2018,11,29,DEBIT,633071.38,C804816022
35234,409000362497',2018-11-29,TRF FROM  Indiaforensic SERVICES,0.0,2000000.0,,2018,11,29,CASH_IN,2000000.0,M877031293
35235,409000362497',2018-11-29,Sweep Trf To: 40900036427,1.0,0.0,,2018,11,29,DEBIT,1.0,C1310255027
35236,409000362497',2018-11-30,IMPS 2911181C,170160.95,0.0,,2018,11,30,CASH_OUT,170160.95,M1209329073
35237,409000362497',2018-11-30,IMPS 3011182C,55943.98,0.0,,2018,11,30,DEBIT,55943.98,C1277501127
35238,409000362497',2018-11-30,IMPS 3011183C,44517.37,0.0,,2018,11,30,DEBIT,44517.37,M328672300
35239,409000362497',2018-11-30,IMPS 3011184C,173058.8,0.0,,2018,11,30,PAYEMENT,173058.8,M1096871773
35240,409000362497',2018-12-01,IMPS 3011181C,39934.27,0.0,,2018,12,1,CHECK_WITHDRAWAL,39934.27,M784862712
35241,409000362497',2018-12-01,IMPS 0112182C,494607.18,0.0,,2018,12,1,PAYEMENT,494607.18,M523676086
35242,409000362497',2018-12-01,IMPS 0112183C,1011349.79,0.0,,2018,12,1,DEBIT,1011349.79,C1452646606
35243,409000362497',2018-12-01,FDRL/INTERNAL FUND TRANSFE,0.0,3000000.0,,2018,12,1,CASH_IN,3000000.0,C1514884249
35244,409000362497',2018-12-01,IMPS 0112184C,243573.3,0.0,,2018,12,1,PAYEMENT,243573.3,C1352176950
35245,409000362497',2018-12-03,IMPS 0112181C,356900.48,0.0,,2018,12,3,CASH_OUT,356900.48,M87747070
35246,409000362497',2018-12-03,IMPS 0212181C,439831.38,0.0,,2018,12,3,DEBIT,439831.38,M1218629567
35247,409000362497',2018-12-03,IMPS 0312182C,435808.68,0.0,,2018,12,3,CASH_OUT,435808.68,C1354426181
35248,409000362497',2018-12-03,INDIAIDEAS.COM LTD,17094.0,0.0,,2018,12,3,CASH_OUT,17094.0,M898639320
35249,409000362497',2018-12-03,PAYU PAYMENTS PRIVATE LIM,60633.0,0.0,,2018,12,3,CHECK_WITHDRAWAL,60633.0,M115715241
35250,409000362497',2018-12-03,AVENUES INDIA PRIVATE LIM,6607.0,0.0,,2018,12,3,CASH_OUT,6607.0,M910358277
35251,409000362497',2018-12-03,FUTURE RETAIL LIMITED (OW,570.0,0.0,,2018,12,3,PAYEMENT,570.0,M2017594068
35252,409000362497',2018-12-03,MEHAR ENTERTAINMENT PRIVA,9793.0,0.0,,2018,12,3,CHECK_WITHDRAWAL,9793.0,M519415846
35253,409000362497',2018-12-03,DIGIVIVE SERVICES PRIVATE,122.0,0.0,,2018,12,3,DEBIT,122.0,C1419886138
35254,409000362497',2018-12-03,Indiaforensic SERVICES INDIA PVT,2427850.0,0.0,,2018,12,3,CASH_OUT,2427850.0,M636108530
35255,409000362497',2018-12-03,IMPS 0312183C,1008802.8,0.0,,2018,12,3,PAYEMENT,1008802.8,C2018250155
35256,409000362497',2018-12-03,FDRL/INTERNAL FUND TRANSFE,0.0,2000000.0,,2018,12,3,CASH_IN,2000000.0,C540846849
35257,409000362497',2018-12-03,FDRL/INTERNAL FUND TRANSFE,0.0,500000.0,,2018,12,3,CHECK_CASHING,500000.0,M1862288098
35258,409000362497',2018-12-03,IMPS 0312184C,299463.01,0.0,,2018,12,3,DEBIT,299463.01,C929266212
35259,409000362497',2018-12-03,Sweep Trf To: 40900036427,8901.0,0.0,,2018,12,3,CASH_OUT,8901.0,C1609896133
35260,409000362497',2018-12-04,IMPS 0312181C,423043.32,0.0,,2018,12,4,PAYEMENT,423043.32,C1313685064
35261,409000362497',2018-12-04,IMPS 0412182C,473543.18,0.0,,2018,12,4,DEBIT,473543.18,M1322458057
35262,409000362497',2018-12-04,INDIAIDEAS.COM LTD,54691.0,0.0,,2018,12,4,CASH_OUT,54691.0,M1117509179
35263,409000362497',2018-12-04,PAYU PAYMENTS PRIVATE LIM,8935.0,0.0,,2018,12,4,CHECK_WITHDRAWAL,8935.0,C263883701
35264,409000362497',2018-12-04,AVENUES INDIA PRIVATE LIM,7586.0,0.0,,2018,12,4,CHECK_WITHDRAWAL,7586.0,M1070894221
35265,409000362497',2018-12-04,FUTURE RETAIL LIMITED (OW,69.0,0.0,,2018,12,4,DEBIT,69.0,M1997603412
35266,409000362497',2018-12-04,DISH INFRA SERVICES PRIVA,39.0,0.0,,2018,12,4,DEBIT,39.0,C513285223
35267,409000362497',2018-12-04,Indiaforensic SERVICES INDIA PVT,81816.0,0.0,,2018,12,4,PAYEMENT,81816.0,C1750956965
35268,409000362497',2018-12-04,IMPS 0412183C,938239.22,0.0,,2018,12,4,DEBIT,938239.22,C273192837
35269,409000362497',2018-12-04,NEFT/SBIN418338355535/Indfor,0.0,2000000.0,,2018,12,4,TRANSFER,2000000.0,M1386963767
35270,409000362497',2018-12-04,IMPS 0412184C,389514.15,0.0,,2018,12,4,CHECK_WITHDRAWAL,389514.15,C1753127766
35271,409000362497',2018-12-04,Sweep Trf To: 40900036427,3000.0,0.0,,2018,12,4,CHECK_WITHDRAWAL,3000.0,C1918631578
35272,409000362497',2018-12-05,IMPS 0412181C,79225.48,0.0,,2018,12,5,CHECK_WITHDRAWAL,79225.48,C728885526
35273,409000362497',2018-12-05,IMPS 0512182C,66889.63,0.0,,2018,12,5,DEBIT,66889.63,C1761324386
35274,409000362497',2018-12-05,IMPS 0512183C,37075.95,0.0,,2018,12,5,CHECK_WITHDRAWAL,37075.95,C116956744
35275,409000362497',2018-12-05,IMPS 0512184C,132452.37,0.0,,2018,12,5,CASH_OUT,132452.37,C1469084143
35276,409000362497',2018-12-06,IMPS 0512181C,72907.26,0.0,,2018,12,6,CASH_OUT,72907.26,C1380252219
35277,409000362497',2018-12-06,IMPS 0612182C,6306.5,0.0,,2018,12,6,CHECK_WITHDRAWAL,6306.5,C1279610437
35278,409000362497',2018-12-06,IMPS 0612183C,590152.25,0.0,,2018,12,6,CASH_OUT,590152.25,C518185827
35279,409000362497',2018-12-06,NEFT/SBIN618340065581/Indfor,0.0,2000000.0,,2018,12,6,TRANSFER,2000000.0,M1635903665
35280,409000362497',2018-12-06,IMPS 0612184C,654708.49,0.0,,2018,12,6,DEBIT,654708.49,C971869545
35281,409000362497',2018-12-07,IMPS 0612181C,459457.41,0.0,,2018,12,7,PAYEMENT,459457.41,C1635341595
35282,409000362497',2018-12-07,IMPS 0712182C,423728.22,0.0,,2018,12,7,DEBIT,423728.22,C1761353343
35283,409000362497',2018-12-07,IMPS 0712183C,831032.24,0.0,,2018,12,7,CHECK_WITHDRAWAL,831032.24,C749672494
35284,409000362497',2018-12-07,FDRL/INTERNAL FUND TRANSFE,0.0,2000000.0,,2018,12,7,TRANSFER,2000000.0,C1540720037
35285,409000362497',2018-12-07,FDRL/INTERNAL FUND TRANSFE,0.0,2000000.0,,2018,12,7,TRANSFER,2000000.0,C16344660
35286,409000362497',2018-12-07,IMPS 0712184C,444738.49,0.0,,2018,12,7,CHECK_WITHDRAWAL,444738.49,C1688071442
35287,409000362497',2018-12-07,Sweep Trf To: 40900036427,8000.0,0.0,,2018,12,7,CHECK_WITHDRAWAL,8000.0,C718992903
35288,409000362497',2018-12-10,IMPS 0712181C,408685.35,0.0,,2018,12,10,DEBIT,408685.35,C1313534832
35289,409000362497',2018-12-10,IMPS 0812181C,1420935.09,0.0,,2018,12,10,CASH_OUT,1420935.09,C1500415712
35290,409000362497',2018-12-10,IMPS 0912181C,125537.15,0.0,,2018,12,10,CASH_OUT,125537.15,C921733929
35291,409000362497',2018-12-10,IMPS 1012182C,374545.88,0.0,,2018,12,10,DEBIT,374545.88,C2127862399
35292,409000362497',2018-12-10,IMPS 1012183C,805530.01,0.0,,2018,12,10,PAYEMENT,805530.01,C516516576
35293,409000362497',2018-12-10,IMPS 1012184C,424635.28,0.0,,2018,12,10,CASH_OUT,424635.28,C1494895909
35294,409000362497',2018-12-10,FDRL/INTERNAL FUND TRANSFE,0.0,2000000.0,,2018,12,10,TRANSFER,2000000.0,C2029406675
35295,409000362497',2018-12-11,INDIAIDEAS.COM LTD,40301.0,0.0,,2018,12,11,PAYEMENT,40301.0,C1318038292
35296,409000362497',2018-12-11,PAYU PAYMENTS PRIVATE LIM,98437.0,0.0,,2018,12,11,DEBIT,98437.0,C1052117080
35297,409000362497',2018-12-11,AVENUES INDIA PRIVATE LIM,2010.0,0.0,,2018,12,11,CHECK_WITHDRAWAL,2010.0,C927008541
35298,409000362497',2018-12-11,MEHAR ENTERTAINMENT PRIVA,11292.0,0.0,,2018,12,11,CHECK_WITHDRAWAL,11292.0,C170133906
35299,409000362497',2018-12-11,QWIKCILVER SOLUTIONS PRIV,21477.0,0.0,,2018,12,11,PAYEMENT,21477.0,C912252532
35300,409000362497',2018-12-11,FUTURE RETAIL LIMITED (OW,490.0,0.0,,2018,12,11,CHECK_WITHDRAWAL,490.0,M373162619
35301,409000362497',2018-12-11,ALT DIGITAL MEDIA ENTERTA,490.0,0.0,,2018,12,11,PAYEMENT,490.0,M506377779
35302,409000362497',2018-12-11,Indiaforensic SERVICES INDIA PVT,1815018.0,0.0,,2018,12,11,DEBIT,1815018.0,M776574910
35303,409000362497',2018-12-11,IMPS 1012181C,126182.14,0.0,,2018,12,11,CHECK_WITHDRAWAL,126182.14,C501402989
35304,409000362497',2018-12-11,IMPS 1112182C,295337.7,0.0,,2018,12,11,CASH_OUT,295337.7,C325203711
35305,409000362497',2018-12-11,TRF TO 1196428  Indiaforensic SE,45620.0,0.0,,2018,12,11,CASH_OUT,45620.0,M1990430447
35306,409000362497',2018-12-11,NEFT/000059512636/INDIAID,14237.0,0.0,,2018,12,11,CHECK_WITHDRAWAL,14237.0,M951406467
35307,409000362497',2018-12-11,NEFT/000059512748/PAYU PA,28331.0,0.0,,2018,12,11,PAYEMENT,28331.0,M1862249899
35308,409000362497',2018-12-11,NEFT/000059512866/QWIKCIL,1532.0,0.0,,2018,12,11,DEBIT,1532.0,C1915091057
35309,409000362497',2018-12-11,IMPS 1112183C,971403.68,0.0,,2018,12,11,PAYEMENT,971403.68,C1963658928
35310,409000362497',2018-12-11,NEFT/SBIN918345764974/Indfor,0.0,2500000.0,,2018,12,11,TRANSFER,2500000.0,C430297016
35311,409000362497',2018-12-11,IMPS 1112184C,538902.15,0.0,,2018,12,11,CASH_OUT,538902.15,M1361057987
35312,409000362497',2018-12-11,Sweep Trf To: 40900036427,10000.0,0.0,,2018,12,11,PAYEMENT,10000.0,M1520271749
35313,409000362497',2018-12-12,IMPS 1112181C,366790.39,0.0,,2018,12,12,DEBIT,366790.39,M557622231
35314,409000362497',2018-12-12,IMPS 1212182C,329376.28,0.0,,2018,12,12,DEBIT,329376.28,C2015806959
35315,409000362497',2018-12-12,IMPS 1212183C,817179.59,0.0,,2018,12,12,PAYEMENT,817179.59,C618018140
35316,409000362497',2018-12-12,INDIAIDEAS.COM LTD,4543.0,0.0,,2018,12,12,CASH_OUT,4543.0,C738480180
35317,409000362497',2018-12-12,PAYU PAYMENTS PRIVATE LIM,1362.0,0.0,,2018,12,12,PAYEMENT,1362.0,M1767142881
35318,409000362497',2018-12-12,AVENUES INDIA PRIVATE LIM,562.0,0.0,,2018,12,12,CHECK_WITHDRAWAL,562.0,C810886151
35319,409000362497',2018-12-12,METRO INFRASYS PRIVATE LI,697.0,0.0,,2018,12,12,CASH_OUT,697.0,C1297215278
35320,409000362497',2018-12-12,MEHAR ENTERTAINMENT PRIVA,1152.0,0.0,,2018,12,12,CASH_OUT,1152.0,M1226279980
35321,409000362497',2018-12-12,Indiaforensic SERVICES INDIA PVT,83706.0,0.0,,2018,12,12,PAYEMENT,83706.0,C1048923726
35322,409000362497',2018-12-12,Indiaforensic MERCHANT PAYMENT,0.0,8316.0,,2018,12,12,CHECK_CASHING,8316.0,C957705094
35323,409000362497',2018-12-12,NEFT/000059642649/INDIAID,4543.0,0.0,,2018,12,12,CHECK_WITHDRAWAL,4543.0,M378442010
35324,409000362497',2018-12-12,NEFT/000059642755/PAYU PA,1362.0,0.0,,2018,12,12,CASH_OUT,1362.0,C1876630105
35325,409000362497',2018-12-12,NEFT/000059642854/AVENUES,562.0,0.0,,2018,12,12,CASH_OUT,562.0,C2006081398
35326,409000362497',2018-12-12,NEFT/000059643122/METRO I,697.0,0.0,,2018,12,12,PAYEMENT,697.0,C1965245761
35327,409000362497',2018-12-12,NEFT/000059643266/MEHAR E,1152.0,0.0,,2018,12,12,CASH_OUT,1152.0,C1290523181
35328,409000362497',2018-12-12,TRF TO 1196428  Indiaforensic SE,83706.0,0.0,,2018,12,12,PAYEMENT,83706.0,C569675628
35329,409000362497',2018-12-12,WRONGLY DEBITED TWICE 121,0.0,83706.0,,2018,12,12,CASH_IN,83706.0,C1320699422
35330,409000362497',2018-12-12,FDRL/INTERNAL FUND TRANSFE,0.0,2000000.0,,2018,12,12,TRANSFER,2000000.0,M301645295
35331,409000362497',2018-12-12,IMPS 1212184C,612008.93,0.0,,2018,12,12,CASH_OUT,612008.93,M1401654700
35332,409000362497',2018-12-13,IMPS 1212181C,71757.91,0.0,,2018,12,13,PAYEMENT,71757.91,C1219273867
35333,409000362497',2018-12-13,IMPS 1312182C,115104.88,0.0,,2018,12,13,PAYEMENT,115104.88,C804475266
35334,409000362497',2018-12-13,TRF TO 1196428  Indiaforensic SE,438286.0,0.0,,2018,12,13,DEBIT,438286.0,C2050019814
35335,409000362497',2018-12-13,NEFT/000059760907/PAYU PA,38862.0,0.0,,2018,12,13,DEBIT,38862.0,C787033725
35336,409000362497',2018-12-13,NEFT/000059761243/AVENUES,387.0,0.0,,2018,12,13,PAYEMENT,387.0,C1083142315
35337,409000362497',2018-12-13,NEFT/000059761419/FUTURE,77.0,0.0,,2018,12,13,CASH_OUT,77.0,C1334973394
35338,409000362497',2018-12-13,NEFT/000059761550/MEHAR E,2074.0,0.0,,2018,12,13,PAYEMENT,2074.0,C623008408
35339,409000362497',2018-12-13,IMPS 1312183C,1110769.22,0.0,,2018,12,13,DEBIT,1110769.22,C1894575391
35340,409000362497',2018-12-13,IMPS 1312184C,542072.82,0.0,,2018,12,13,DEBIT,542072.82,C1357984916
35341,409000362497',2018-12-14,IMPS 1312181C,363059.79,0.0,,2018,12,14,DEBIT,363059.79,C1245689449
35342,409000362497',2018-12-14,IMPS 1412182C,326658.98,0.0,,2018,12,14,PAYEMENT,326658.98,C259443926
35343,409000362497',2018-12-14,IMPS 1412183C,774449.57,0.0,,2018,12,14,DEBIT,774449.57,C411227408
35344,409000362497',2018-12-14,NEFT/000059883157/INDIAID,16847.0,0.0,,2018,12,14,CHECK_WITHDRAWAL,16847.0,M745250038
35345,409000362497',2018-12-14,NEFT/000059883332/PAYU PA,32440.0,0.0,,2018,12,14,DEBIT,32440.0,C1296962409
35346,409000362497',2018-12-14,NEFT/000059883511/AVENUES,119.0,0.0,,2018,12,14,PAYEMENT,119.0,M1367105822
35347,409000362497',2018-12-14,NEFT/000059883722/FUTURE,98.0,0.0,,2018,12,14,DEBIT,98.0,C447680780
35348,409000362497',2018-12-14,NEFT/000059883822/METRO I,697.0,0.0,,2018,12,14,CASH_OUT,697.0,C44870833
35349,409000362497',2018-12-14,NEFT/000059883928/MEHAR E,1959.0,0.0,,2018,12,14,PAYEMENT,1959.0,C1938348365
35350,409000362497',2018-12-14,NEFT/000059884015/DISH IN,98.0,0.0,,2018,12,14,DEBIT,98.0,C1256728724
35351,409000362497',2018-12-14,NEFT/000059884112/ALT DIG,98.0,0.0,,2018,12,14,DEBIT,98.0,C1246370163
35352,409000362497',2018-12-14,TRF TO 1196428  Indiaforensic SE,96794.0,0.0,,2018,12,14,CASH_OUT,96794.0,M2100849641
35353,409000362497',2018-12-14,FDRL/INTERNAL FUND TRANSFE,0.0,2000000.0,,2018,12,14,CHECK_CASHING,2000000.0,M409646330
35354,409000362497',2018-12-14,IMPS 1412184C,614189.18,0.0,,2018,12,14,CHECK_WITHDRAWAL,614189.18,M94390175
35355,409000362497',2018-12-14,Sweep Trf To: 40900036427,5420.0,0.0,,2018,12,14,CHECK_WITHDRAWAL,5420.0,M1612125436
35356,409000362497',2018-12-15,IMPS 1412181C,110162.32,0.0,,2018,12,15,DEBIT,110162.32,M338109783
35357,409000362497',2018-12-15,IMPS 1512182C,245922.41,0.0,,2018,12,15,DEBIT,245922.41,M1552816687
35358,409000362497',2018-12-15,IMPS 1512183C,881300.1,0.0,,2018,12,15,CHECK_WITHDRAWAL,881300.1,M37850268
35359,409000362497',2018-12-15,IMPS 1512184C,694562.91,0.0,,2018,12,15,CASH_OUT,694562.91,M412557992
35360,409000362497',2018-12-15,Sweep Trf To: 40900036427,500.0,0.0,,2018,12,15,DEBIT,500.0,M825690714
35361,409000362497',2018-12-17,FDRL/INTERNAL FUND TRANSFE,0.0,2000000.0,,2018,12,17,CASH_IN,2000000.0,M78616239
35362,409000362497',2018-12-17,IMPS 1512181C,99517.25,0.0,,2018,12,17,PAYEMENT,99517.25,M1344307270
35363,409000362497',2018-12-17,IMPS 1612181C,175631.63,0.0,,2018,12,17,PAYEMENT,175631.63,M1847473242
35364,409000362497',2018-12-17,IMPS 1712182C,292641.76,0.0,,2018,12,17,CASH_OUT,292641.76,M37455493
35365,409000362497',2018-12-17,IMPS 1712183C,746069.26,0.0,,2018,12,17,CHECK_WITHDRAWAL,746069.26,M1828866062
35366,409000362497',2018-12-17,FDRL/INTERNAL FUND TRANSFE,0.0,2000000.0,,2018,12,17,TRANSFER,2000000.0,M232069265
35367,409000362497',2018-12-17,FDRL/INTERNAL FUND TRANSFE,0.0,1000000.0,,2018,12,17,CHECK_CASHING,1000000.0,M138708392
35368,409000362497',2018-12-17,IMPS 1712184C,618140.25,0.0,,2018,12,17,CHECK_WITHDRAWAL,618140.25,M1528591197
35369,409000362497',2018-12-18,TRF TO 1196428  Indiaforensic SE,215205.0,0.0,,2018,12,18,CASH_OUT,215205.0,M1326662449
35370,409000362497',2018-12-18,NEFT/000060244079/INDIAID,23433.0,0.0,,2018,12,18,PAYEMENT,23433.0,M1313876084
35371,409000362497',2018-12-18,NEFT/000060244131/PAYU PA,53212.0,0.0,,2018,12,18,PAYEMENT,53212.0,M1326772088
35372,409000362497',2018-12-18,NEFT/000060244217/AVENUES,5248.0,0.0,,2018,12,18,CASH_OUT,5248.0,M125469278
35373,409000362497',2018-12-18,NEFT/000060244317/SYNERGI,113.0,0.0,,2018,12,18,CASH_OUT,113.0,M748395099
35374,409000362497',2018-12-18,NEFT/000060244359/FUTURE,7094.0,0.0,,2018,12,18,CASH_OUT,7094.0,M133893354
35375,409000362497',2018-12-18,NEFT/000060244387/MEHAR E,23764.0,0.0,,2018,12,18,PAYEMENT,23764.0,M1441280275
35376,409000362497',2018-12-18,NEFT/000060244396/DISH IN,59.0,0.0,,2018,12,18,DEBIT,59.0,M1591555353
35377,409000362497',2018-12-18,IMPS 1712181C,410889.71,0.0,,2018,12,18,CASH_OUT,410889.71,M1713468348
35378,409000362497',2018-12-18,IMPS 1812182C,367786.67,0.0,,2018,12,18,CASH_OUT,367786.67,C1150771473
35379,409000362497',2018-12-18,IMPS 1812183C,754175.52,0.0,,2018,12,18,CASH_OUT,754175.52,C1097564094
35380,409000362497',2018-12-18,FDRL/INTERNAL FUND TRANSFE,0.0,2000000.0,,2018,12,18,CHECK_CASHING,2000000.0,C782432613
35381,409000362497',2018-12-18,IMPS 1812184C,548079.08,0.0,,2018,12,18,CHECK_WITHDRAWAL,548079.08,M734441937
35382,409000362497',2018-12-18,Sweep Trf To: 40900036427,4000.0,0.0,,2018,12,18,PAYEMENT,4000.0,C1281898359
35383,409000362497',2018-12-19,IMPS 1812181C,261833.37,0.0,,2018,12,19,PAYEMENT,261833.37,C365212068
35384,409000362497',2018-12-19,IMPS 1912182C,117099.12,0.0,,2018,12,19,CASH_OUT,117099.12,C1316560467
35385,409000362497',2018-12-19,NEFT/000060364012/INDIAID,30157.0,0.0,,2018,12,19,DEBIT,30157.0,C1040847151
35386,409000362497',2018-12-19,NEFT/000060364082/PAYU PA,3926.0,0.0,,2018,12,19,DEBIT,3926.0,M1886020591
35387,409000362497',2018-12-19,NEFT/000060364231/AVENUES,173.0,0.0,,2018,12,19,CASH_OUT,173.0,C1029125570
35388,409000362497',2018-12-19,NEFT/000060364393/MEHAR E,197.0,0.0,,2018,12,19,CASH_OUT,197.0,M788356028
35389,409000362497',2018-12-19,TRF TO 1196428  Indiaforensic SE,641815.0,0.0,,2018,12,19,DEBIT,641815.0,M31513424
35390,409000362497',2018-12-19,IMPS 1912183C,907123.2,0.0,,2018,12,19,PAYEMENT,907123.2,C659632320
35391,409000362497',2018-12-19,FDRL/INTERNAL FUND TRANSFE,0.0,1000000.0,,2018,12,19,CHECK_CASHING,1000000.0,M752953842
35392,409000362497',2018-12-19,FDRL/INTERNAL FUND TRANSFE,0.0,1000000.0,,2018,12,19,CHECK_CASHING,1000000.0,M1736798405
35393,409000362497',2018-12-19,IMPS 1912184C,675370.94,0.0,,2018,12,19,PAYEMENT,675370.94,C66497191
35394,409000362497',2018-12-20,TRF TO 1196428  Indiaforensic SE,256146.0,0.0,,2018,12,20,CASH_OUT,256146.0,C280663936
35395,409000362497',2018-12-20,NEFT/000060490157/PAYU PA,27947.0,0.0,,2018,12,20,CASH_OUT,27947.0,C1475909248
35396,409000362497',2018-12-20,NEFT/000060490295/AVENUES,142.0,0.0,,2018,12,20,CHECK_WITHDRAWAL,142.0,C434049726
35397,409000362497',2018-12-20,NEFT/000060490355/FUTURE,3377.0,0.0,,2018,12,20,CASH_OUT,3377.0,C214774813
35398,409000362497',2018-12-20,NEFT/000060490393/MEHAR E,8642.0,0.0,,2018,12,20,DEBIT,8642.0,C439051693
35399,409000362497',2018-12-20,IMPS 1912181C,266725.1,0.0,,2018,12,20,CASH_OUT,266725.1,M545476906
35400,409000362497',2018-12-20,IMPS 2012182C,383287.25,0.0,,2018,12,20,CHECK_WITHDRAWAL,383287.25,C13103044
35401,409000362497',2018-12-20,NEFT/000060490431/QWIKCIL,26032.0,0.0,,2018,12,20,CHECK_WITHDRAWAL,26032.0,M2129982875
35402,409000362497',2018-12-20,IMPS 2012183C,713769.39,0.0,,2018,12,20,DEBIT,713769.39,C811969419
35403,409000362497',2018-12-20,FDRL/INTERNAL FUND TRANSFE,0.0,500000.0,,2018,12,20,CHECK_CASHING,500000.0,C1781090157
35404,409000362497',2018-12-20,FDRL/INTERNAL FUND TRANSFE,0.0,2000000.0,,2018,12,20,TRANSFER,2000000.0,M424699938
35405,409000362497',2018-12-20,IMPS 2012184C,680989.27,0.0,,2018,12,20,CASH_OUT,680989.27,C1429623854
35406,409000362497',2018-12-20,Sweep Trf To: 40900036427,8000.0,0.0,,2018,12,20,PAYEMENT,8000.0,C481402298
35407,409000362497',2018-12-21,IMPS 2012181C,306941.4,0.0,,2018,12,21,CHECK_WITHDRAWAL,306941.4,M2117939025
35408,409000362497',2018-12-21,IMPS 2112182C,279615.09,0.0,,2018,12,21,DEBIT,279615.09,M1400614339
35409,409000362497',2018-12-21,TRF TO 1196428  Indiaforensic SE,1392771.0,0.0,,2018,12,21,PAYEMENT,1392771.0,C435265417
35410,409000362497',2018-12-21,NEFT/000060626424/INDIAID,40985.0,0.0,,2018,12,21,CASH_OUT,40985.0,M2029492733
35411,409000362497',2018-12-21,NEFT/000060626609/PAYU PA,27158.0,0.0,,2018,12,21,CHECK_WITHDRAWAL,27158.0,C492997256
35412,409000362497',2018-12-21,NEFT/000060626814/MEHAR E,3401.0,0.0,,2018,12,21,PAYEMENT,3401.0,C1718171891
35413,409000362497',2018-12-21,IMPS 2112183C,869626.0,0.0,,2018,12,21,CHECK_WITHDRAWAL,869626.0,M575841882
35414,409000362497',2018-12-21,NEFT/000060636924/INDIAID,12202.0,0.0,,2018,12,21,CASH_OUT,12202.0,C1706891711
35415,409000362497',2018-12-21,NEFT/000060637159/PAYU PA,18901.0,0.0,,2018,12,21,CASH_OUT,18901.0,C1117816135
35416,409000362497',2018-12-21,NEFT/000060637812/AVENUES,2599.0,0.0,,2018,12,21,PAYEMENT,2599.0,C271397841
35417,409000362497',2018-12-21,NEFT/000060638157/FUTURE,58.0,0.0,,2018,12,21,DEBIT,58.0,C338671335
35418,409000362497',2018-12-21,NEFT/000060638294/MEHAR E,3865.0,0.0,,2018,12,21,DEBIT,3865.0,M410255357
35419,409000362497',2018-12-21,NEFT/000060638453/ALT DIG,176.0,0.0,,2018,12,21,PAYEMENT,176.0,M398167337
35420,409000362497',2018-12-21,TRF TO 1196428  Indiaforensic SE,907015.0,0.0,,2018,12,21,CHECK_WITHDRAWAL,907015.0,C958066125
35421,409000362497',2018-12-21,FDRL/INTERNAL FUND TRANSFE,0.0,2000000.0,,2018,12,21,TRANSFER,2000000.0,M64541439
35422,409000362497',2018-12-21,IMPS 835519811619 FROM OX,0.0,200000.0,,2018,12,21,CASH_IN,200000.0,M1561646304
35423,409000362497',2018-12-21,IMPS 835519811657 FROM OX,0.0,200000.0,,2018,12,21,CHECK_CASHING,200000.0,C1657363827
35424,409000362497',2018-12-21,IMPS 835519811696 FROM OX,0.0,200000.0,,2018,12,21,CHECK_CASHING,200000.0,C279730708
35425,409000362497',2018-12-21,IMPS 835519811739 FROM OX,0.0,200000.0,,2018,12,21,TRANSFER,200000.0,M1803623155
35426,409000362497',2018-12-21,IMPS 835519811780 FROM OX,0.0,200000.0,,2018,12,21,TRANSFER,200000.0,M2107639665
35427,409000362497',2018-12-21,IMPS 2112184C,578240.52,0.0,,2018,12,21,CHECK_WITHDRAWAL,578240.52,C1778404446
35428,409000362497',2018-12-21,IMPS 835520820968 FROM OX,0.0,200000.0,,2018,12,21,CHECK_CASHING,200000.0,C446804469
35429,409000362497',2018-12-21,IMPS 835520820985 FROM OX,0.0,200000.0,,2018,12,21,CASH_IN,200000.0,M2030729006
35430,409000362497',2018-12-21,IMPS 835520821015 FROM OX,0.0,200000.0,,2018,12,21,TRANSFER,200000.0,M880238583
35431,409000362497',2018-12-21,IMPS 835520822440 FROM OX,0.0,100000.0,,2018,12,21,TRANSFER,100000.0,C381350369
35432,409000362497',2018-12-21,IMPS 835520822495 FROM OX,0.0,200000.0,,2018,12,21,CASH_IN,200000.0,M1852402870
35433,409000362497',2018-12-21,IMPS 835520822531 FROM OX,0.0,200000.0,,2018,12,21,CASH_IN,200000.0,M105549077
35434,409000362497',2018-12-21,IMPS 835520822549 FROM OX,0.0,200000.0,,2018,12,21,TRANSFER,200000.0,C192625769
35435,409000362497',2018-12-21,IMPS 835520822576 FROM OX,0.0,200000.0,,2018,12,21,CASH_IN,200000.0,C1476820428
35436,409000362497',2018-12-21,IMPS 835520822606 FROM OX,0.0,200000.0,,2018,12,21,CASH_IN,200000.0,M1757340151
35437,409000362497',2018-12-21,IMPS 835520822651 FROM OX,0.0,200000.0,,2018,12,21,CHECK_CASHING,200000.0,C404279307
35438,409000362497',2018-12-21,Sweep Trf To: 40900036427,8000.0,0.0,,2018,12,21,PAYEMENT,8000.0,C1371191175
35439,409000362497',2018-12-24,IMPS 2112181C,173026.82,0.0,,2018,12,24,PAYEMENT,173026.82,C544181807
35440,409000362497',2018-12-24,IMPS 2212181C,335487.36,0.0,,2018,12,24,CASH_OUT,335487.36,C912252532
35441,409000362497',2018-12-24,IMPS 2312181C,70502.1,0.0,,2018,12,24,CASH_OUT,70502.1,C979719862
35442,409000362497',2018-12-24,IMPS 2412182C,424524.48,0.0,,2018,12,24,PAYEMENT,424524.48,C604555852
35443,409000362497',2018-12-24,IMPS 2412183C,332752.42,0.0,,2018,12,24,CHECK_WITHDRAWAL,332752.42,C703957828
35444,409000362497',2018-12-24,FDRL/INTERNAL FUND TRANSFE,0.0,3000000.0,,2018,12,24,CASH_IN,3000000.0,C1481851679
35445,409000362497',2018-12-24,FDRL/INTERNAL FUND TRANSFE,0.0,3000000.0,,2018,12,24,CHECK_CASHING,3000000.0,C1896985362
35446,409000362497',2018-12-24,IMPS 835818526960 FROM OX,0.0,200000.0,,2018,12,24,CASH_IN,200000.0,C8733802
35447,409000362497',2018-12-24,IMPS 2412184C,48399.68,0.0,,2018,12,24,CASH_OUT,48399.68,C1608303998
35448,409000362497',2018-12-26,IMPS 2412181C,199464.5,0.0,,2018,12,26,CASH_OUT,199464.5,C1315234892
35449,409000362497',2018-12-26,IMPS 2512181C,114684.19,0.0,,2018,12,26,CHECK_WITHDRAWAL,114684.19,C221674877
35450,409000362497',2018-12-26,IMPS 2612182C,9517.91,0.0,,2018,12,26,CASH_OUT,9517.91,C926192308
35451,409000362497',2018-12-26,IMPS 2612183C,777250.36,0.0,,2018,12,26,CHECK_WITHDRAWAL,777250.36,C194988831
35452,409000362497',2018-12-26,TRF TO 1196428  Indiaforensic SE,1749295.0,0.0,,2018,12,26,DEBIT,1749295.0,C529351377
35453,409000362497',2018-12-26,NEFT/000061069402/PAYU PA,3161.0,0.0,,2018,12,26,CHECK_WITHDRAWAL,3161.0,C1025530795
35454,409000362497',2018-12-26,NEFT/000061069505/AVENUES,881.0,0.0,,2018,12,26,CASH_OUT,881.0,C1059781259
35455,409000362497',2018-12-26,NEFT/000061069602/FUTURE,1508.0,0.0,,2018,12,26,DEBIT,1508.0,C1519139616
35456,409000362497',2018-12-26,NEFT/000061069718/PASFAR,49.0,0.0,,2018,12,26,CHECK_WITHDRAWAL,49.0,C1188392295
35457,409000362497',2018-12-26,NEFT/000061069728/DISH IN,48.0,0.0,,2018,12,26,PAYEMENT,48.0,C1556993174
35458,409000362497',2018-12-26,NEFT/000061069766/MEHAR E,12693.0,0.0,,2018,12,26,CASH_OUT,12693.0,C1150771473
35459,409000362497',2018-12-26,FDRL/INTERNAL FUND TRANSFE,0.0,500000.0,,2018,12,26,CASH_IN,500000.0,C1054909747
35460,409000362497',2018-12-26,FDRL/INTERNAL FUND TRANSFE,0.0,1000000.0,,2018,12,26,CASH_IN,1000000.0,C1443373883
35461,409000362497',2018-12-26,FDRL/INTERNAL FUND TRANSFE,0.0,1000000.0,,2018,12,26,CHECK_CASHING,1000000.0,C13103044
35462,409000362497',2018-12-26,FDRL/INTERNAL FUND TRANSFE,0.0,500000.0,,2018,12,26,CHECK_CASHING,500000.0,C529351377
35463,409000362497',2018-12-26,IMPS 2612184C,437347.66,0.0,,2018,12,26,CHECK_WITHDRAWAL,437347.66,C1327907419
35464,409000362497',2018-12-27,NEFT/000061155229/INDIAID,61921.0,0.0,,2018,12,27,CASH_OUT,61921.0,C1136492228
35465,409000362497',2018-12-27,NEFT/000061155382/PAYU PA,11405.0,0.0,,2018,12,27,DEBIT,11405.0,C796796033
35466,409000362497',2018-12-27,NEFT/000061155465/AVENUES,270.0,0.0,,2018,12,27,CHECK_WITHDRAWAL,270.0,C526035976
35467,409000362497',2018-12-27,NEFT/000061155613/FUTURE,188.0,0.0,,2018,12,27,DEBIT,188.0,C1015129370
35468,409000362497',2018-12-27,NEFT/000061155817/MEHAR E,3083.0,0.0,,2018,12,27,CHECK_WITHDRAWAL,3083.0,C510508465
35469,409000362497',2018-12-27,NEFT/000061156078/ALT DIG,196.0,0.0,,2018,12,27,CASH_OUT,196.0,C40133542
35470,409000362497',2018-12-27,TRF TO 1196428  Indiaforensic SE,3540861.0,0.0,,2018,12,27,CHECK_WITHDRAWAL,3540861.0,C1790657739
35471,409000362497',2018-12-27,IMPS 2612181C,396937.1,0.0,,2018,12,27,CASH_OUT,396937.1,C2135727675
35472,409000362497',2018-12-27,IMPS 2712182C,343709.33,0.0,,2018,12,27,PAYEMENT,343709.33,C1417218664
35473,409000362497',2018-12-27,IMPS 2712183C,549828.31,0.0,,2018,12,27,PAYEMENT,549828.31,C915049328
35474,409000362497',2018-12-27,FDRL/INTERNAL FUND TRANSFE,0.0,1000000.0,,2018,12,27,TRANSFER,1000000.0,C1676792692
35475,409000362497',2018-12-27,FDRL/INTERNAL FUND TRANSFE,0.0,500000.0,,2018,12,27,CHECK_CASHING,500000.0,C1739263553
35476,409000362497',2018-12-27,FDRL/INTERNAL FUND TRANSFE,0.0,1000000.0,,2018,12,27,TRANSFER,1000000.0,C1870347515
35477,409000362497',2018-12-27,FDRL/INTERNAL FUND TRANSFE,0.0,500000.0,,2018,12,27,CHECK_CASHING,500000.0,C2090186380
35478,409000362497',2018-12-27,NEFT/000061209620/PAYU PA,8768.0,0.0,,2018,12,27,DEBIT,8768.0,C485423874
35479,409000362497',2018-12-27,NEFT/000061209973/AVENUES,396.0,0.0,,2018,12,27,DEBIT,396.0,C1396755641
35480,409000362497',2018-12-27,NEFT/000061210355/FUTURE,327.0,0.0,,2018,12,27,DEBIT,327.0,C1747948034
35481,409000362497',2018-12-27,NEFT/000061210642/MEHAR E,788.0,0.0,,2018,12,27,DEBIT,788.0,C1029125570
35482,409000362497',2018-12-27,NEFT/000061210948/ALT DIG,196.0,0.0,,2018,12,27,DEBIT,196.0,M542613976
35483,409000362497',2018-12-27,NEFT/000061211120/QWIKCIL,55115.0,0.0,,2018,12,27,CHECK_WITHDRAWAL,55115.0,C1993311391
35484,409000362497',2018-12-27,TRF TO 1196428  Indiaforensic SE,1819734.0,0.0,,2018,12,27,DEBIT,1819734.0,C599726537
35485,409000362497',2018-12-27,IMPS 2712184C,62957.9,0.0,,2018,12,27,DEBIT,62957.9,C1720486997
35486,409000362497',2018-12-28,IMPS 2712181C,257393.3,0.0,,2018,12,28,CASH_OUT,257393.3,M1268916106
35487,409000362497',2018-12-28,IMPS 2812182C,450853.14,0.0,,2018,12,28,DEBIT,450853.14,C664247545
35488,409000362497',2018-12-28,IMPS 2812183C,447232.18,0.0,,2018,12,28,CASH_OUT,447232.18,C991363637
35489,409000362497',2018-12-28,FDRL/INTERNAL FUND TRANSFE,0.0,500000.0,,2018,12,28,CASH_IN,500000.0,M855235846
35490,409000362497',2018-12-28,FDRL/INTERNAL FUND TRANSFE,0.0,1000000.0,,2018,12,28,TRANSFER,1000000.0,C738480180
35491,409000362497',2018-12-28,FDRL/INTERNAL FUND TRANSFE,0.0,1000000.0,,2018,12,28,CHECK_CASHING,1000000.0,C1608828840
35492,409000362497',2018-12-28,IMPS 2812184C,338195.42,0.0,,2018,12,28,PAYEMENT,338195.42,C71364493
35493,409000362497',2018-12-29,IMPS 2812181C,138173.18,0.0,,2018,12,29,PAYEMENT,138173.18,M1844710204
35494,409000362497',2018-12-29,IMPS 2912182C,355452.35,0.0,,2018,12,29,CASH_OUT,355452.35,C421325835
35495,409000362497',2018-12-29,FDRL/INTERNAL FUND TRANSFE,0.0,500000.0,,2018,12,29,CASH_IN,500000.0,M79524199
35496,409000362497',2018-12-29,FDRL/INTERNAL FUND TRANSFE,0.0,1000000.0,,2018,12,29,CASH_IN,1000000.0,C1599334040
35497,409000362497',2018-12-29,FDRL/INTERNAL FUND TRANSFE,0.0,1000000.0,,2018,12,29,CASH_IN,1000000.0,M1032825550
35498,409000362497',2018-12-29,IMPS 2912183C,457180.02,0.0,,2018,12,29,CHECK_WITHDRAWAL,457180.02,M1922212659
35499,409000362497',2018-12-29,IMPS 2912184C,118319.41,0.0,,2018,12,29,CHECK_WITHDRAWAL,118319.41,M338596764
35500,409000362497',2018-12-29,Sweep Trf To: 40900036427,199.0,0.0,,2018,12,29,DEBIT,199.0,M392339739
35501,409000362497',2018-12-31,IMPS 2912181C,69303.39,0.0,,2018,12,31,CHECK_WITHDRAWAL,69303.39,M524251153
35502,409000362497',2018-12-31,IMPS 3012181C,80134.21,0.0,,2018,12,31,CHECK_WITHDRAWAL,80134.21,M497130080
35503,409000362497',2018-12-31,IMPS 311220182C,17988.81,0.0,,2018,12,31,CHECK_WITHDRAWAL,17988.81,M1811244269
35504,409000362497',2018-12-31,IMPS 3112183C,39499.27,0.0,,2018,12,31,CHECK_WITHDRAWAL,39499.27,C916869225
35505,409000362497',2018-12-31,NEFT/000061670350/INDIAID,4476.0,0.0,,2018,12,31,PAYEMENT,4476.0,C28588268
35506,409000362497',2018-12-31,NEFT/000061670450/PAYU PA,13647.0,0.0,,2018,12,31,DEBIT,13647.0,M395184309
35507,409000362497',2018-12-31,NEFT/000061670689/AVENUES,2900.0,0.0,,2018,12,31,CASH_OUT,2900.0,M421301346
35508,409000362497',2018-12-31,NEFT/000061670941/FUTURE,720.0,0.0,,2018,12,31,PAYEMENT,720.0,M1333324957
35509,409000362497',2018-12-31,NEFT/000061671169/MEHAR E,8808.0,0.0,,2018,12,31,CHECK_WITHDRAWAL,8808.0,M1871777911
35510,409000362497',2018-12-31,NEFT/000061671446/DIGIVIV,122.0,0.0,,2018,12,31,PAYEMENT,122.0,C451902366
35511,409000362497',2018-12-31,TRF TO 1196428  Indiaforensic SE,3956623.0,0.0,,2018,12,31,CASH_OUT,3956623.0,M1717170796
35512,409000362497',2018-12-31,FDRL/INTERNAL FUND TRANSFE,0.0,500000.0,,2018,12,31,CHECK_CASHING,500000.0,M201364159
35513,409000362497',2018-12-31,FDRL/INTERNAL FUND TRANSFE,0.0,500000.0,,2018,12,31,CASH_IN,500000.0,C1509514333
35514,409000362497',2018-12-31,FDRL/INTERNAL FUND TRANSFE,0.0,500000.0,,2018,12,31,CASH_IN,500000.0,M1673016453
35515,409000362497',2018-12-31,IMPS 3112184C,60947.43,0.0,,2018,12,31,DEBIT,60947.43,C182468868
35516,409000362497',2018-12-31,Sweep Trf To: 40900036427,7800.0,0.0,,2018,12,31,CHECK_WITHDRAWAL,7800.0,C695758207
35517,A,2018-01-01,INDO GIBL Indiaforensic STL31121,2000.0,0.0,20000.0,2018,1,1,CASH_OUT,2000.0,M2049265342
35518,A,2018-01-01,INDO GIBL Indiaforensic STL30121,4000.0,0.0,16000.0,2018,1,1,PAYEMENT,4000.0,M1823241293
35519,A,2018-01-05,FDRL/INTERNAL FUND TRANSFE,1500.0,0.0,14500.0,2018,1,5,CASH_OUT,1500.0,C2102040020
35520,A,2018-01-05,INDO GIBL Indiaforensic STL04011,2000.0,0.0,12500.0,2018,1,5,PAYEMENT,2000.0,M1613727001
35521,A,2018-01-10,INDO GIBL Indiaforensic STL09011,500.0,0.0,12000.0,2018,1,10,PAYEMENT,500.0,M1691158743
35522,A,2018-01-15,INDO GIBL Indiaforensic STL14011,2000.0,0.0,10000.0,2018,1,15,DEBIT,2000.0,C226391371
35523,A,2018-01-29,FDRL/INTERNAL FUND TRANSFE,0.0,10000.0,20000.0,2018,1,29,TRANSFER,10000.0,C439225767
35524,A,2018-01-30,INDO GIBL Indiaforensic STL29011,1000.0,0.0,19000.0,2018,1,30,CASH_OUT,1000.0,C1662761228
35525,A,2018-02-01,INDO GIBL Indiaforensic STL31011,2000.0,0.0,17000.0,2018,2,1,CASH_OUT,2000.0,M2049265342
35526,A,2018-02-09,INDO GIBL Indiaforensic STL07021,4000.0,0.0,13000.0,2018,2,9,DEBIT,4000.0,M1823241293
35527,A,2018-02-09,INDO GIBL Indiaforensic STL08021,1500.0,0.0,11500.0,2018,2,9,PAYEMENT,1500.0,C2102040020
35528,A,2018-02-16,INDO GIBL Indiaforensic STL09021,2500.0,0.0,9000.0,2018,2,16,PAYEMENT,2500.0,M1613727001
35529,A,2018-02-26,INDO GIBL Indiaforensic STL21021,3000.0,0.0,6000.0,2018,2,26,DEBIT,3000.0,M1691158743
35530,A,2018-02-28,FDRL/INTERNAL FUND TRANSFE,0.0,10000.0,16000.0,2018,2,28,TRANSFER,10000.0,C226391371
35531,A,2018-03-01,FDRL/INTERNAL FUND TRANSFE,2000.0,0.0,14000.0,2018,3,1,DEBIT,2000.0,M2049265342
35532,A,2018-03-01,FDRL/INTERNAL FUND TRANSFE,4000.0,0.0,10000.0,2018,3,1,DEBIT,4000.0,M1823241293
35533,A,2018-03-05,INDO GIBL Indiaforensic STL03031,1500.0,0.0,8500.0,2018,3,5,CHECK_WITHDRAWAL,1500.0,C2102040020
35534,A,2018-03-14,INDO GIBL Indiaforensic STL13031,2000.0,0.0,6500.0,2018,3,14,PAYEMENT,2000.0,M1613727001
35535,A,2018-03-19,INDO GIBL Indiaforensic STL17031,1000.0,0.0,5500.0,2018,3,19,PAYEMENT,1000.0,M1691158743
35536,A,2018-03-19,INDO GIBL Indiaforensic STL18031,10000.0,0.0,,2018,3,19,CHECK_WITHDRAWAL,10000.0,C226391371
35537,A,2018-03-28,FDRL/INTERNAL FUND TRANSFE,0.0,10000.0,5500.0,2018,3,28,TRANSFER,10000.0,C439225767
35538,A,2018-04-05,FDRL/INTERNAL FUND TRANSFE,2000.0,0.0,3500.0,2018,4,5,CASH_OUT,2000.0,M2049265342
35539,A,2018-04-05,FDRL/INTERNAL FUND TRANSFE,4000.0,0.0,,2018,4,5,CHECK_WITHDRAWAL,4000.0,M1823241293
35540,A,2018-04-09,INDO GIBL Indiaforensic STL07041,1700.0,0.0,,2018,4,9,CASH_OUT,1700.0,C2102040020
35541,A,2018-04-09,FDRL/INTERNAL FUND TRANSFE,2000.0,0.0,,2018,4,9,PAYEMENT,2000.0,M1613727001
35542,A,2018-04-16,INDO GIBL Indiaforensic STL13041,3000.0,0.0,,2018,4,16,CASH_OUT,3000.0,M1691158743
35543,A,2018-04-16,INDO GIBL Indiaforensic STL14041,400.0,0.0,,2018,4,16,CASH_OUT,400.0,C226391371
35544,A,2018-04-20,INDO GIBL Indiaforensic STL19041,1000.0,0.0,,2018,4,20,PAYEMENT,1000.0,C439225767
35545,A,2018-04-27,FDRL/INTERNAL FUND TRANSFE,0.0,10000.0,1400.0,2018,4,27,TRANSFER,10000.0,C1662761228
35546,A,2018-05-01,FDRL/INTERNAL FUND TRANSFE,2000.0,0.0,,2018,5,1,CASH_OUT,2000.0,M2049265342
35547,A,2018-05-02,INDO GIBL Indiaforensic STL27041,4000.0,0.0,,2018,5,2,DEBIT,4000.0,M1823241293
35548,A,2018-05-02,INDO GIBL Indiaforensic STL28041,1000.0,0.0,,2018,5,2,PAYEMENT,1000.0,C2102040020
35549,A,2018-05-02,INDO GIBL Indiaforensic STL29041,2300.0,0.0,,2018,5,2,CASH_OUT,2300.0,M1613727001
35550,A,2018-05-05,INDO GIBL Indiaforensic STL04051,1000.0,0.0,,2018,5,5,DEBIT,1000.0,M1691158743
35551,A,2018-05-10,INDO GIBL Indiaforensic STL09051,1000.0,0.0,,2018,5,10,CASH_OUT,1000.0,C226391371
35552,A,2018-05-18,INDO GIBL Indiaforensic STL17051,1500.0,0.0,,2018,5,18,PAYEMENT,1500.0,C439225767
35553,A,2018-05-28,FDRL/INTERNAL FUND TRANSFE,1100.0,0.0,,2018,5,28,CHECK_WITHDRAWAL,1100.0,C1662761228
35554,A,2018-05-29,FDRL/INTERNAL FUND TRANSFE,0.0,15000.0,2500.0,2018,5,29,TRANSFER,15000.0,M33998523
35555,A,2018-06-01,FDRL/INTERNAL FUND TRANSFE,2000.0,0.0,500.0,2018,6,1,CHECK_WITHDRAWAL,2000.0,M2049265342
35556,A,2018-06-01,INDO GIBL Indiaforensic STL31051,4000.0,0.0,,2018,6,1,PAYEMENT,4000.0,M1823241293
35557,A,2018-06-02,INDO GIBL Indiaforensic STL01061,1200.0,0.0,,2018,6,2,PAYEMENT,1200.0,C2102040020
35558,A,2018-06-05,INDO GIBL Indiaforensic STL04061,1600.0,0.0,,2018,6,5,CHECK_WITHDRAWAL,1600.0,M1613727001
35559,A,2018-06-08,INDO GIBL Indiaforensic STL07061,1000.0,0.0,,2018,6,8,CHECK_WITHDRAWAL,1000.0,M1691158743
35560,A,2018-06-15,INDO GIBL Indiaforensic STL14061,1000.0,0.0,,2018,6,15,CHECK_WITHDRAWAL,1000.0,C226391371
35561,A,2018-06-20,INDO GIBL Indiaforensic STL19061,700.0,0.0,,2018,6,20,CASH_OUT,700.0,C439225767
35562,A,2018-06-28,FDRL/INTERNAL FUND TRANSFE,5000.0,0.0,,2018,6,28,CHECK_WITHDRAWAL,5000.0,C1662761228
35563,A,2018-06-29,FDRL/INTERNAL FUND TRANSFE,0.0,12000.0,,2018,6,29,TRANSFER,12000.0,M840088342
35564,A,2018-07-02,FDRL/INTERNAL FUND TRANSFE,2000.0,0.0,,2018,7,2,CHECK_WITHDRAWAL,2000.0,M2049265342
35565,A,2018-07-02,Indfor INCOME INDO REMI30061,4000.0,0.0,,2018,7,2,CHECK_WITHDRAWAL,4000.0,M1823241293
35566,A,2018-07-02,INDO GIBL Indiaforensic STL30061,1400.0,0.0,,2018,7,2,PAYEMENT,1400.0,C2102040020
35567,A,2018-07-02,Indfor INCOME INDO REMI01071,2000.0,0.0,,2018,7,2,CASH_OUT,2000.0,M1613727001
35568,A,2018-07-02,INDO GIBL Indiaforensic STL01071,0.0,20000.0,8600.0,2018,7,2,TRANSFER,20000.0,M1691158743
35569,A,2018-07-05,Indfor INCOME INDO REMI04071,4000.0,0.0,4600.0,2018,7,5,DEBIT,4000.0,C226391371
35570,A,2018-07-09,Indfor INCOME INDO REMI08071,3000.0,0.0,1600.0,2018,7,9,CHECK_WITHDRAWAL,3000.0,C439225767
35571,A,2018-07-17,INDO GIBL Indiaforensic STL16071,2000.0,0.0,,2018,7,17,DEBIT,2000.0,C1662761228
35572,A,2018-07-23,Indfor INCOME INDO REMI22071,840.0,0.0,,2018,7,23,CASH_OUT,840.0,M1622238202
35573,A,2018-07-27,FDRL/INTERNAL FUND TRANSFE,0.0,12000.0,10760.0,2018,7,27,TRANSFER,12000.0,M1509658185
35574,A,2018-07-30,Indfor INCOME INDO REMI27071,2760.0,0.0,8000.0,2018,7,30,DEBIT,2760.0,M1038807193
35575,A,2018-08-01,Indfor INCOME INDO REMI31071,4000.0,0.0,4000.0,2018,8,1,CHECK_WITHDRAWAL,4000.0,M2049265342
35576,A,2018-08-01,INDO GIBL Indiaforensic STL31071,2000.0,0.0,2000.0,2018,8,1,CASH_OUT,2000.0,M1823241293
35577,A,2018-08-01,FDRL/INTERNAL FUND TRANSFE,1800.0,0.0,200.0,2018,8,1,DEBIT,1800.0,C2102040020
35578,A,2018-08-09,Indfor INCOME INDO REMI08081,3000.0,0.0,,2018,8,9,CASH_OUT,3000.0,M1613727001
35579,A,2018-08-16,Indfor INCOME INDO REMI14081,3600.0,0.0,,2018,8,16,CASH_OUT,3600.0,C1662761228
35580,A,2018-08-18,FDRL/INTERNAL FUND TRANSFE,0.0,6000.0,,2018,8,18,TRANSFER,6000.0,M1509658185
35581,A,2018-08-29,FDRL/INTERNAL FUND TRANSFE,0.0,15000.0,14600.0,2018,8,29,TRANSFER,15000.0,C439225767
35582,A,2018-08-29,INDO GIBL Indiaforensic STL28081,6000.0,0.0,8600.0,2018,8,29,CASH_OUT,6000.0,C1662761228
35583,A,2018-09-01,Indfor INCOME INDO REMI31081,3000.0,0.0,5600.0,2018,9,1,CASH_OUT,3000.0,M2049265342
35584,A,2018-09-01,INDO WEIZ STL310818,2000.0,0.0,3600.0,2018,9,1,DEBIT,2000.0,M1823241293
35585,A,2018-09-01,FDRL/INTERNAL FUND TRANSFE,4000.0,0.0,,2018,9,1,CASH_OUT,4000.0,C2102040020
35586,A,2018-09-03,Indfor INCOME INDO REMI01091,1800.0,0.0,,2018,9,3,PAYEMENT,1800.0,M1613727001
35587,A,2018-09-03,INDO GIBL Indiaforensic STL01091,2000.0,0.0,,2018,9,3,PAYEMENT,2000.0,M1691158743
35588,A,2018-09-10,Indfor INCOME INDO REMI07091,3240.0,0.0,,2018,9,10,DEBIT,3240.0,C226391371
35589,A,2018-09-20,FDRL/INTERNAL FUND TRANSFE,9000.0,0.0,,2018,9,20,CHECK_WITHDRAWAL,9000.0,C439225767
35590,A,2018-09-28,FDRL/INTERNAL FUND TRANSFE,0.0,15000.0,,2018,9,28,TRANSFER,15000.0,C1662761228
35591,A,2018-10-01,FDRL/INTERNAL FUND TRANSFE,2000.0,0.0,,2018,10,1,CASH_OUT,2000.0,M2049265342
35592,A,2018-10-01,Indfor INCOME INDO REMI29091,4000.0,0.0,,2018,10,1,CHECK_WITHDRAWAL,4000.0,M1823241293
35593,A,2018-10-01,INDO GIBL Indiaforensic STL29091,1500.0,0.0,,2018,10,1,PAYEMENT,1500.0,C2102040020
35594,A,2018-10-01,Indfor INCOME INDO REMI30091,2000.0,0.0,,2018,10,1,PAYEMENT,2000.0,M1613727001
35595,A,2018-10-01,INDO GIBL Indiaforensic STL30091,5000.0,0.0,,2018,10,1,CHECK_WITHDRAWAL,5000.0,M1691158743
35596,A,2018-10-03,FDRL/INTERNAL FUND TRANSFE,0.0,10000.0,,2018,10,3,TRANSFER,10000.0,C226391371
35597,A,2018-10-06,Indfor INCOME INDO REMI05101,1320.0,0.0,,2018,10,6,DEBIT,1320.0,C439225767
35598,A,2018-10-15,Indfor INCOME INDO REMI12101,1000.0,0.0,,2018,10,15,PAYEMENT,1000.0,C1662761228
35599,A,2018-10-24,Indfor INCOME INDO REMI23101,500.0,0.0,,2018,10,24,CASH_OUT,500.0,C312537393
35600,A,2018-10-29,FDRL/INTERNAL FUND TRANSFE,0.0,16000.0,7240.0,2018,10,29,TRANSFER,16000.0,C2146610568
35601,A,2018-11-01,Indfor INCOME INDO REMI31101,2000.0,0.0,5240.0,2018,11,1,CHECK_WITHDRAWAL,2000.0,M2049265342
35602,A,2018-11-01,INDO GIBL Indiaforensic STL31101,4000.0,0.0,1240.0,2018,11,1,DEBIT,4000.0,M1823241293
35603,A,2018-11-02,Indfor INCOME INDO REMI01111,1800.0,0.0,,2018,11,2,CASH_OUT,1800.0,C2102040020
35604,A,2018-11-02,INDO GIBL Indiaforensic STL01111,2000.0,0.0,,2018,11,2,PAYEMENT,2000.0,M1613727001
35605,A,2018-11-12,Indfor INCOME INDO REMI09111,2040.0,0.0,,2018,11,12,CASH_OUT,2040.0,M1691158743
35606,A,2018-11-16,FDRL/INTERNAL FUND TRANSFE,700.0,0.0,,2018,11,16,CHECK_WITHDRAWAL,700.0,C226391371
35607,A,2018-11-20,FDRL/INTERNAL FUND TRANSFE,500.0,0.0,,2018,11,20,CASH_OUT,500.0,C439225767
35608,A,2018-11-28,FDRL/INTERNAL FUND TRANSFE,0.0,16000.0,10200.0,2018,11,28,TRANSFER,16000.0,C1662761228
35609,A,2018-11-29,Indfor INCOME INDO REMI28111,2160.0,0.0,8040.0,2018,11,29,CHECK_WITHDRAWAL,2160.0,C153634664
35610,A,2018-12-01,Indfor INCOME INDO REMI30111,2000.0,0.0,6040.0,2018,12,1,PAYEMENT,2000.0,M2049265342
35611,A,2018-12-01,INDO GIBL Indiaforensic STL30111,4000.0,0.0,2040.0,2018,12,1,CASH_OUT,4000.0,M1823241293
35612,A,2018-12-01,FDRL/INTERNAL FUND TRANSFE,1800.0,0.0,240.0,2018,12,1,PAYEMENT,1800.0,C2102040020
35613,A,2018-12-07,Indfor INCOME INDO REMI06121,2640.0,0.0,,2018,12,7,PAYEMENT,2640.0,M1613727001
35614,A,2018-12-14,FDRL/INTERNAL FUND TRANSFE,1300.0,0.0,,2018,12,14,CASH_OUT,1300.0,M1691158743
35615,A,2018-12-20,FDRL/INTERNAL FUND TRANSFE,3000.0,0.0,,2018,12,20,PAYEMENT,3000.0,C226391371
35616,A,2018-12-27,Indfor INCOME INDO REMI26121,1320.0,0.0,,2018,12,27,CASH_OUT,1320.0,C439225767
35617,A,2018-12-29,FDRL/INTERNAL FUND TRANSFE,0.0,15000.0,6980.0,2018,12,29,TRANSFER,15000.0,C1662761228
35618,A,2018-12-29,FDRL/INTERNAL FUND TRANSFE,0.0,5000.0,11980.0,2018,12,29,TRANSFER,5000.0,C219416103
35619,A,2018-12-31,Indfor INCOME INDO REMI30121,240.0,0.0,11740.0,2018,12,31,CHECK_WITHDRAWAL,240.0,C932796396
35620,A,2018-12-31,INDO GIBL Indiaforensic STL30121,1200.0,0.0,10540.0,2018,12,31,DEBIT,1200.0,C1069131391
35621,B,2018-01-01,INDO GIBL Indiaforensic STL31121,6000.0,0.0,100000.0,2018,1,1,DEBIT,6000.0,C688425953
35622,B,2018-01-01,INDO GIBL Indiaforensic STL30121,10000.0,0.0,90000.0,2018,1,1,DEBIT,10000.0,C146305349
35623,B,2018-01-02,FDRL/INTERNAL FUND TRANSFE,3000.0,0.0,87000.0,2018,1,2,PAYEMENT,3000.0,C892981061
35624,B,2018-01-08,INDO GIBL Indiaforensic STL04011,30000.0,0.0,57000.0,2018,1,8,DEBIT,30000.0,C679235222
35625,B,2018-01-10,INDO GIBL Indiaforensic STL09011,5000.0,0.0,52000.0,2018,1,10,PAYEMENT,5000.0,C865922491
35626,B,2018-01-18,INDO GIBL Indiaforensic STL14011,7000.0,0.0,45000.0,2018,1,18,PAYEMENT,7000.0,C1973934667
35627,B,2018-01-28,FDRL/INTERNAL FUND TRANSFE,0.0,60000.0,105000.0,2018,1,28,TRANSFER,60000.0,C1034584766
35628,B,2018-02-01,INDO GIBL Indiaforensic STL29011,6000.0,0.0,99000.0,2018,2,1,PAYEMENT,6000.0,C688425953
35629,B,2018-02-01,INDO GIBL Indiaforensic STL31011,10000.0,0.0,89000.0,2018,2,1,CHECK_WITHDRAWAL,10000.0,C146305349
35630,B,2018-02-09,INDO GIBL Indiaforensic STL07021,5000.0,0.0,84000.0,2018,2,9,DEBIT,5000.0,C892981061
35631,B,2018-02-09,INDO GIBL Indiaforensic STL08021,30000.0,0.0,54000.0,2018,2,9,PAYEMENT,30000.0,C679235222
35632,B,2018-02-14,INDO GIBL Indiaforensic STL09021,5000.0,0.0,49000.0,2018,2,14,CASH_OUT,5000.0,C865922491
35633,B,2018-02-20,INDO GIBL Indiaforensic STL21021,2000.0,0.0,47000.0,2018,2,20,CASH_OUT,2000.0,C1973934667
35634,B,2018-02-28,FDRL/INTERNAL FUND TRANSFE,0.0,60000.0,107000.0,2018,2,28,TRANSFER,60000.0,C1034584766
35635,B,2018-03-01,FDRL/INTERNAL FUND TRANSFE,6000.0,0.0,101000.0,2018,3,1,PAYEMENT,6000.0,C688425953
35636,B,2018-03-01,FDRL/INTERNAL FUND TRANSFE,10000.0,0.0,91000.0,2018,3,1,PAYEMENT,10000.0,C146305349
35637,B,2018-03-05,INDO GIBL Indiaforensic STL03031,30000.0,0.0,61000.0,2018,3,5,CASH_OUT,30000.0,C892981061
35638,B,2018-03-14,INDO GIBL Indiaforensic STL13031,9000.0,0.0,52000.0,2018,3,14,CHECK_WITHDRAWAL,9000.0,C679235222
35639,B,2018-03-19,INDO GIBL Indiaforensic STL17031,3000.0,0.0,49000.0,2018,3,19,DEBIT,3000.0,C865922491
35640,B,2018-03-19,INDO GIBL Indiaforensic STL18031,7000.0,0.0,42000.0,2018,3,19,DEBIT,7000.0,C1973934667
35641,B,2018-03-28,FDRL/INTERNAL FUND TRANSFE,0.0,60000.0,102000.0,2018,3,28,TRANSFER,60000.0,C1034584766
35642,B,2018-04-01,FDRL/INTERNAL FUND TRANSFE,6000.0,0.0,96000.0,2018,4,1,PAYEMENT,6000.0,C688425953
35643,B,2018-04-01,FDRL/INTERNAL FUND TRANSFE,10000.0,0.0,86000.0,2018,4,1,PAYEMENT,10000.0,C146305349
35644,B,2018-04-07,INDO GIBL Indiaforensic STL07041,30000.0,0.0,56000.0,2018,4,7,PAYEMENT,30000.0,C892981061
35645,B,2018-04-09,FDRL/INTERNAL FUND TRANSFE,4800.0,0.0,51200.0,2018,4,9,CHECK_WITHDRAWAL,4800.0,C679235222
35646,B,2018-04-15,INDO GIBL Indiaforensic STL13041,2000.0,0.0,49200.0,2018,4,15,CHECK_WITHDRAWAL,2000.0,C865922491
35647,B,2018-04-19,INDO GIBL Indiaforensic STL14041,1000.0,0.0,48200.0,2018,4,19,DEBIT,1000.0,C1973934667
35648,B,2018-04-24,INDO GIBL Indiaforensic STL19041,1000.0,0.0,47200.0,2018,4,24,DEBIT,1000.0,C1034584766
35649,B,2018-04-28,FDRL/INTERNAL FUND TRANSFE,0.0,60000.0,107200.0,2018,4,28,TRANSFER,60000.0,C258825018
35650,B,2018-05-01,FDRL/INTERNAL FUND TRANSFE,6000.0,0.0,101200.0,2018,5,1,CASH_OUT,6000.0,C688425953
35651,B,2018-05-02,INDO GIBL Indiaforensic STL27041,10000.0,0.0,91200.0,2018,5,2,CHECK_WITHDRAWAL,10000.0,C146305349
35652,B,2018-05-05,INDO GIBL Indiaforensic STL28041,30000.0,0.0,61200.0,2018,5,5,PAYEMENT,30000.0,C892981061
35653,B,2018-05-09,INDO GIBL Indiaforensic STL29041,4000.0,0.0,57200.0,2018,5,9,DEBIT,4000.0,C679235222
35654,B,2018-05-12,INDO GIBL Indiaforensic STL04051,5000.0,0.0,52200.0,2018,5,12,DEBIT,5000.0,C865922491
35655,B,2018-05-10,INDO GIBL Indiaforensic STL09051,7000.0,0.0,45200.0,2018,5,10,DEBIT,7000.0,C1973934667
35656,B,2018-05-18,INDO GIBL Indiaforensic STL17051,1500.0,0.0,43700.0,2018,5,18,CASH_OUT,1500.0,C1034584766
35657,B,2018-05-25,FDRL/INTERNAL FUND TRANSFE,20000.0,0.0,23700.0,2018,5,25,DEBIT,20000.0,M1385729103
35658,B,2018-05-28,FDRL/INTERNAL FUND TRANSFE,0.0,60000.0,83700.0,2018,5,28,TRANSFER,60000.0,C276384108
35659,B,2018-06-01,FDRL/INTERNAL FUND TRANSFE,6000.0,0.0,77700.0,2018,6,1,DEBIT,6000.0,C688425953
35660,B,2018-06-01,INDO GIBL Indiaforensic STL31051,10000.0,0.0,67700.0,2018,6,1,CHECK_WITHDRAWAL,10000.0,C146305349
35661,B,2018-06-02,INDO GIBL Indiaforensic STL01061,3000.0,0.0,64700.0,2018,6,2,CHECK_WITHDRAWAL,3000.0,C892981061
35662,B,2018-06-05,INDO GIBL Indiaforensic STL04061,30000.0,0.0,34700.0,2018,6,5,PAYEMENT,30000.0,C679235222
35663,B,2018-06-08,INDO GIBL Indiaforensic STL07061,5000.0,0.0,29700.0,2018,6,8,PAYEMENT,5000.0,C865922491
35664,B,2018-06-15,INDO GIBL Indiaforensic STL14061,7000.0,0.0,22700.0,2018,6,15,CASH_OUT,7000.0,C1973934667
35665,B,2018-06-20,INDO GIBL Indiaforensic STL19061,700.0,0.0,22000.0,2018,6,20,PAYEMENT,700.0,C1034584766
35666,B,2018-06-28,FDRL/INTERNAL FUND TRANSFE,5000.0,0.0,17000.0,2018,6,28,CASH_OUT,5000.0,C83827469
35667,B,2018-06-28,FDRL/INTERNAL FUND TRANSFE,0.0,60000.0,77000.0,2018,6,28,TRANSFER,60000.0,M366590615
35668,B,2018-07-01,FDRL/INTERNAL FUND TRANSFE,6000.0,0.0,71000.0,2018,7,1,CASH_OUT,6000.0,C688425953
35669,B,2018-07-01,Indfor INCOME INDO REMI30061,10000.0,0.0,61000.0,2018,7,1,PAYEMENT,10000.0,C146305349
35670,B,2018-07-07,INDO GIBL Indiaforensic STL30061,33000.0,0.0,28000.0,2018,7,7,CASH_OUT,33000.0,C892981061
35671,B,2018-07-10,Indfor INCOME INDO REMI01071,5000.0,0.0,23000.0,2018,7,10,CHECK_WITHDRAWAL,5000.0,C679235222
35672,B,2018-07-10,INDO GIBL Indiaforensic STL01071,5000.0,0.0,18000.0,2018,7,10,PAYEMENT,5000.0,C865922491
35673,B,2018-07-17,Indfor INCOME INDO REMI04071,7000.0,0.0,11000.0,2018,7,17,DEBIT,7000.0,C1973934667
35674,B,2018-07-09,Indfor INCOME INDO REMI08071,3000.0,0.0,8000.0,2018,7,9,CHECK_WITHDRAWAL,3000.0,C1034584766
35675,B,2018-07-17,INDO GIBL Indiaforensic STL16071,2000.0,0.0,6000.0,2018,7,17,DEBIT,2000.0,C668849042
35676,B,2018-07-25,Indfor INCOME INDO REMI22071,9000.0,0.0,,2018,7,25,DEBIT,9000.0,C1566849174
35677,B,2018-07-27,FDRL/INTERNAL FUND TRANSFE,0.0,60000.0,57000.0,2018,7,27,TRANSFER,60000.0,M359029381
35678,B,2018-08-01,Indfor INCOME INDO REMI27071,6000.0,0.0,51000.0,2018,8,1,DEBIT,6000.0,C688425953
35679,B,2018-08-01,Indfor INCOME INDO REMI31071,10000.0,0.0,41000.0,2018,8,1,CASH_OUT,10000.0,C146305349
35680,B,2018-08-01,INDO GIBL Indiaforensic STL31071,20000.0,0.0,21000.0,2018,8,1,PAYEMENT,20000.0,C892981061
35681,B,2018-08-04,FDRL/INTERNAL FUND TRANSFE,40000.0,0.0,,2018,8,4,CHECK_WITHDRAWAL,40000.0,C679235222
35682,B,2018-08-11,Indfor INCOME INDO REMI08081,5000.0,0.0,,2018,8,11,CASH_OUT,5000.0,C1421211318
35683,B,2018-08-18,Indfor INCOME INDO REMI14081,7000.0,0.0,,2018,8,18,PAYEMENT,7000.0,C1973934667
35684,B,2018-08-18,FDRL/INTERNAL FUND TRANSFE,0.0,20000.0,,2018,8,18,TRANSFER,20000.0,C1034584766
35685,B,2018-08-27,FDRL/INTERNAL FUND TRANSFE,0.0,60000.0,49000.0,2018,8,27,TRANSFER,60000.0,M1216549054
35686,B,2018-09-01,INDO GIBL Indiaforensic STL28081,6000.0,0.0,43000.0,2018,9,1,PAYEMENT,6000.0,C688425953
35687,B,2018-09-01,Indfor INCOME INDO REMI31081,10000.0,0.0,33000.0,2018,9,1,CASH_OUT,10000.0,C146305349
35688,B,2018-09-01,INDO WEIZ STL310818,8000.0,0.0,25000.0,2018,9,1,PAYEMENT,8000.0,C892981061
35689,B,2018-09-01,FDRL/INTERNAL FUND TRANSFE,40000.0,0.0,,2018,9,1,PAYEMENT,40000.0,C679235222
35690,B,2018-09-03,Indfor INCOME INDO REMI01091,5000.0,0.0,,2018,9,3,CHECK_WITHDRAWAL,5000.0,C865922491
35691,B,2018-09-03,INDO GIBL Indiaforensic STL01091,7000.0,0.0,,2018,9,3,DEBIT,7000.0,C1973934667
35692,B,2018-09-14,Indfor INCOME INDO REMI07091,0.0,15000.0,,2018,9,14,TRANSFER,15000.0,C1034584766
35693,B,2018-09-20,FDRL/INTERNAL FUND TRANSFE,9000.0,0.0,,2018,9,20,DEBIT,9000.0,M878279029
35694,B,2018-09-28,FDRL/INTERNAL FUND TRANSFE,0.0,60000.0,39000.0,2018,9,28,TRANSFER,60000.0,C1481468605
35695,B,2018-10-01,FDRL/INTERNAL FUND TRANSFE,6000.0,0.0,33000.0,2018,10,1,DEBIT,6000.0,C688425953
35696,B,2018-10-01,Indfor INCOME INDO REMI29091,10000.0,0.0,23000.0,2018,10,1,DEBIT,10000.0,C146305349
35697,B,2018-10-01,INDO GIBL Indiaforensic STL29091,3000.0,0.0,20000.0,2018,10,1,CHECK_WITHDRAWAL,3000.0,C892981061
35698,B,2018-10-06,Indfor INCOME INDO REMI30091,30000.0,0.0,,2018,10,6,CHECK_WITHDRAWAL,30000.0,C679235222
35699,B,2018-10-08,INDO GIBL Indiaforensic STL30091,5000.0,0.0,,2018,10,8,PAYEMENT,5000.0,C865922491
35700,B,2018-10-15,FDRL/INTERNAL FUND TRANSFE,7000.0,0.0,,2018,10,15,CASH_OUT,7000.0,C1973934667
35701,B,2018-10-28,FDRL/INTERNAL FUND TRANSFE,0.0,60000.0,38000.0,2018,10,28,TRANSFER,60000.0,C1034584766
35702,B,2018-11-01,Indfor INCOME INDO REMI31101,6000.0,0.0,32000.0,2018,11,1,CHECK_WITHDRAWAL,6000.0,C688425953
35703,B,2018-11-01,INDO GIBL Indiaforensic STL31101,10000.0,0.0,22000.0,2018,11,1,CASH_OUT,10000.0,C146305349
35704,B,2018-11-02,Indfor INCOME INDO REMI01111,3000.0,0.0,19000.0,2018,11,2,CASH_OUT,3000.0,C892981061
35705,B,2018-11-09,INDO GIBL Indiaforensic STL01111,30000.0,0.0,,2018,11,9,CHECK_WITHDRAWAL,30000.0,C679235222
35706,B,2018-11-18,Indfor INCOME INDO REMI09111,5000.0,0.0,,2018,11,18,CHECK_WITHDRAWAL,5000.0,C865922491
35707,B,2018-11-20,FDRL/INTERNAL FUND TRANSFE,1000.0,0.0,,2018,11,20,PAYEMENT,1000.0,C1973934667
35708,B,2018-11-28,FDRL/INTERNAL FUND TRANSFE,0.0,60000.0,43000.0,2018,11,28,TRANSFER,60000.0,C1034584766
35709,B,2018-12-01,Indfor INCOME INDO REMI28111,6000.0,0.0,37000.0,2018,12,1,PAYEMENT,6000.0,C688425953
35710,B,2018-12-01,Indfor INCOME INDO REMI30111,10000.0,0.0,27000.0,2018,12,1,CASH_OUT,10000.0,C146305349
35711,B,2018-12-01,INDO GIBL Indiaforensic STL30111,4000.0,0.0,23000.0,2018,12,1,CHECK_WITHDRAWAL,4000.0,C892981061
35712,B,2018-12-04,FDRL/INTERNAL FUND TRANSFE,33000.0,0.0,,2018,12,4,CHECK_WITHDRAWAL,33000.0,C679235222
35713,B,2018-12-07,Indfor INCOME INDO REMI06121,5000.0,0.0,,2018,12,7,PAYEMENT,5000.0,C865922491
35714,B,2018-12-14,FDRL/INTERNAL FUND TRANSFE,3000.0,0.0,,2018,12,14,PAYEMENT,3000.0,C1973934667
35715,B,2018-12-16,FDRL/INTERNAL FUND TRANSFE,5000.0,0.0,,2018,12,16,CASH_OUT,5000.0,C1034584766
35716,B,2018-12-27,Indfor INCOME INDO REMI26121,12000.0,0.0,,2018,12,27,DEBIT,12000.0,C1782113663
35717,B,2018-12-28,FDRL/INTERNAL FUND TRANSFE,0.0,60000.0,25000.0,2018,12,28,TRANSFER,60000.0,C147647618
35718,B,2018-12-28,FDRL/INTERNAL FUND TRANSFE,0.0,30000.0,55000.0,2018,12,28,TRANSFER,30000.0,C577034657
35719,B,2018-12-29,Indfor INCOME INDO REMI30121,0.0,37000.0,92000.0,2018,12,29,TRANSFER,37000.0,C262828207
